,protein_1_len,1_phobic_count,1_philic_count,1_basic_count,1_acidic_count,1_aromatic_count,1_sulfur_count,protein_2_len,2_phobic_count,2_philic_count,2_basic_count,2_acidic_count,2_aromatic_count,2_sulfur_count,protein_interaction
0,568,243,325,98,73,56,44,260,120,140,40,25,30,26,1
1,255,136,119,39,20,32,10,2414,1189,1225,277,178,170,169,1
2,419,175,244,71,73,23,23,538,252,286,77,87,53,30,1
3,885,424,461,143,114,92,32,95,47,48,13,12,10,4,1
4,2322,1315,1007,242,257,220,38,191,99,92,25,24,18,8,1
5,509,341,168,35,32,52,15,335,185,150,46,34,36,13,1
6,399,208,191,57,46,41,20,859,429,430,126,115,64,33,1
7,306,144,162,52,35,40,16,1382,689,693,186,176,167,77,1
8,365,180,185,63,35,48,19,781,418,363,92,90,64,41,1
9,284,128,156,48,29,34,8,770,390,380,104,76,78,32,1
10,536,237,299,116,87,42,17,1139,536,603,162,139,109,50,1
11,368,195,173,52,41,42,15,1464,987,477,137,141,55,31,1
12,165,95,70,18,23,19,11,875,421,454,124,142,98,43,1
13,461,213,248,58,62,54,30,2351,1110,1241,337,269,300,87,1
14,260,136,124,24,41,19,4,272,136,136,32,34,12,12,1
15,1071,549,522,133,127,130,59,548,309,239,73,62,54,13,1
16,377,180,197,45,63,19,17,589,294,295,37,44,27,33,1
17,1272,520,752,235,242,117,54,1129,589,540,134,122,108,46,1
18,2261,1217,1044,271,243,267,101,1562,742,820,219,231,104,46,1
19,153,81,72,22,18,16,8,465,218,247,64,51,50,42,1
20,229,105,124,36,33,12,4,198,80,118,35,31,14,7,1
21,592,283,309,84,137,60,20,144,57,87,38,26,10,4,1
22,208,100,108,27,29,18,9,503,263,240,72,55,51,34,1
23,168,67,101,37,17,13,13,182,84,98,20,52,9,9,1
24,933,536,397,96,90,71,41,2799,1324,1475,369,371,215,124,1
25,664,297,367,88,86,55,47,403,188,215,70,42,41,11,1
26,323,159,164,49,28,38,22,377,202,175,46,50,41,22,1
27,671,364,307,75,71,58,22,217,109,108,34,32,35,7,1
28,589,294,295,37,44,27,33,498,278,220,55,42,63,26,1
29,307,133,174,48,53,27,10,288,157,131,36,35,18,9,1
30,1253,639,614,181,155,164,73,559,296,263,77,69,42,13,1
31,509,341,168,35,32,52,15,797,395,402,107,117,77,22,1
32,385,212,173,57,40,39,21,1313,644,669,169,90,111,43,1
33,404,190,214,55,55,35,27,437,212,225,66,44,44,11,1
34,593,295,298,70,85,48,13,1149,568,581,177,133,101,30,1
35,489,242,247,83,63,62,19,430,192,238,62,67,27,10,1
36,947,482,465,143,107,89,37,297,148,149,64,35,37,15,1
37,630,326,304,82,62,80,31,1332,626,706,182,144,80,41,1
38,216,119,97,33,27,28,7,304,127,177,61,38,31,4,1
39,424,209,215,56,58,45,24,1117,423,694,182,134,88,31,1
40,129,67,62,16,13,17,5,1159,641,518,148,115,114,48,1
41,335,183,152,36,27,45,11,309,161,148,38,34,40,15,1
42,367,195,172,57,54,43,16,217,109,108,34,32,35,7,1
43,401,166,235,70,42,51,30,478,239,239,65,66,65,21,1
44,209,138,71,13,9,16,19,1748,791,957,281,247,173,25,1
45,758,338,420,132,87,67,29,1858,805,1053,271,345,116,41,1
46,1462,711,751,219,222,148,65,393,186,207,58,50,36,22,1
47,499,252,247,74,42,55,14,1050,482,568,136,154,101,41,1
48,412,238,174,41,38,43,19,100,61,39,13,12,10,4,1
49,292,196,96,24,16,43,13,933,493,440,140,108,124,32,1
50,388,234,154,43,35,47,20,193,102,91,23,25,20,10,1
51,587,318,269,76,50,38,21,349,152,197,55,47,27,13,1
52,375,202,173,46,49,41,23,1270,557,713,130,195,57,30,1
53,1202,506,696,209,198,74,44,1907,1008,899,235,224,195,73,1
54,143,79,64,16,25,7,5,2468,1038,1430,333,465,167,62,1
55,1749,913,836,255,245,212,68,390,181,209,57,45,40,25,1
56,386,203,183,50,46,58,17,1255,666,589,145,142,120,82,1
57,245,111,134,47,20,26,10,1980,1084,896,242,235,254,106,1
58,686,345,341,98,106,75,25,211,88,123,38,28,26,10,1
59,390,237,153,41,57,22,16,467,224,243,82,62,45,13,1
60,288,118,170,50,57,18,15,744,384,360,104,96,57,31,1
61,1139,536,603,162,139,109,50,272,149,123,34,35,21,2,1
62,452,224,228,69,56,50,31,241,115,126,35,30,17,14,1
63,432,218,214,57,55,42,11,526,169,357,109,86,69,30,1
64,939,493,446,113,100,87,31,158,82,76,25,26,19,12,1
65,251,144,107,33,23,23,8,525,281,244,69,68,65,25,1
66,737,363,374,119,101,85,41,839,444,395,107,95,104,39,1
67,1182,599,583,162,130,106,41,304,159,145,38,40,32,3,1
68,619,290,329,97,79,62,19,368,177,191,49,35,50,20,1
69,365,180,185,63,35,48,19,393,186,207,58,50,36,22,1
70,512,261,251,79,73,60,21,976,496,480,128,111,121,48,1
71,480,232,248,83,64,51,25,648,307,341,101,58,76,34,1
72,1538,704,834,239,176,120,42,268,140,128,33,39,26,9,1
73,1140,495,645,129,95,128,159,1696,771,925,257,225,149,63,1
74,189,90,99,26,29,17,11,2839,1413,1426,384,301,308,145,1
75,517,295,222,60,55,55,19,357,193,164,49,44,43,18,1
76,463,236,227,64,50,44,29,723,309,414,106,106,41,40,1
77,92,42,50,17,15,13,1,404,231,173,44,43,24,10,1
78,335,148,187,52,26,51,12,476,270,206,62,45,46,30,1
79,130,55,75,21,26,10,3,773,414,359,109,102,93,22,1
80,567,261,306,63,89,29,15,452,239,213,62,46,38,22,1
81,659,325,334,102,85,87,32,672,334,338,110,93,91,41,1
82,723,335,388,90,84,77,74,1455,760,695,205,191,124,40,1
83,285,145,140,37,36,22,11,184,87,97,19,21,12,17,1
84,748,355,393,121,91,95,26,429,223,206,50,32,46,17,1
85,1336,828,508,166,121,152,48,697,373,324,105,83,95,38,1
86,419,212,207,45,28,44,21,1462,711,751,219,222,148,65,1
87,2472,1055,1417,416,458,235,64,329,168,161,41,47,26,7,1
88,508,267,241,43,35,25,17,245,111,134,36,27,18,6,1
89,482,231,251,76,81,64,26,785,374,411,56,42,38,25,1
90,391,206,185,56,36,60,17,326,153,173,63,48,25,8,1
91,179,87,92,25,21,22,11,529,274,255,57,62,38,14,1
92,256,148,108,31,16,29,12,551,298,253,63,65,45,19,1
93,454,224,230,71,39,62,22,194,91,103,17,32,9,6,1
94,1822,879,943,236,227,175,97,5497,2328,3169,872,896,436,168,1
95,756,348,408,101,103,60,40,538,252,286,77,87,53,30,1
96,672,334,338,110,93,91,41,1484,731,753,206,175,187,71,1
97,509,262,247,64,70,64,20,770,374,396,95,91,79,41,1
98,940,464,476,116,135,108,58,386,189,197,54,57,39,16,1
99,583,322,261,73,66,45,26,595,316,279,86,60,65,40,1
100,802,388,414,131,105,96,29,477,232,245,67,64,70,30,1
101,601,308,293,102,51,62,28,910,431,479,138,103,98,41,1
102,276,136,140,39,34,33,9,906,455,451,116,105,87,46,1
103,609,292,317,102,96,64,21,264,121,143,46,24,35,10,1
104,158,85,73,24,18,18,8,654,344,310,80,69,57,15,1
105,777,345,432,128,88,65,39,934,472,462,119,122,87,39,1
106,351,166,185,48,61,24,15,249,114,135,47,33,25,4,1
107,261,144,117,34,22,31,15,1474,756,718,175,158,169,51,1
108,815,418,397,97,62,70,17,1318,552,766,191,268,92,14,1
109,267,161,106,22,25,35,20,254,146,108,28,35,33,8,1
110,724,325,399,98,92,64,24,303,159,144,40,35,35,8,1
111,163,71,92,22,38,11,7,293,156,137,37,36,45,12,1
112,669,351,318,122,84,49,9,221,80,141,48,37,14,10,1
113,339,170,169,32,17,24,13,439,205,234,64,88,41,21,1
114,500,303,197,68,30,40,12,1234,590,644,180,182,95,40,1
115,1074,538,536,190,131,157,35,375,202,173,46,49,41,23,1
116,1577,747,830,213,232,147,57,1134,570,564,152,133,131,69,1
117,235,119,116,31,26,15,13,402,150,252,86,39,57,24,1
118,335,143,192,45,36,32,37,256,105,151,61,39,28,11,1
119,372,192,180,47,41,47,21,201,92,109,27,29,27,8,1
120,158,76,82,18,23,14,8,313,159,154,30,40,23,14,1
121,335,188,147,40,37,30,22,332,170,162,40,42,25,11,1
122,341,190,151,50,41,23,15,219,124,95,22,22,23,5,1
123,1134,539,595,150,146,78,40,149,77,72,37,10,20,5,1
124,1129,589,540,134,122,108,46,288,159,129,27,44,27,15,1
125,357,147,210,48,37,21,47,195,83,112,40,16,19,16,1
126,1390,695,695,180,137,170,71,770,374,396,95,91,79,41,1
127,1706,830,876,265,209,230,63,372,196,176,51,36,51,8,1
128,254,117,137,33,35,38,6,183,91,92,31,21,16,11,1
129,428,226,202,52,60,75,20,331,169,162,40,28,22,14,1
130,185,115,70,19,17,26,6,342,179,163,51,59,34,3,1
131,504,259,245,73,56,45,29,785,374,411,56,42,38,25,1
132,485,273,212,92,63,37,8,930,367,563,181,153,83,48,1
133,477,301,176,52,35,45,24,418,204,214,68,66,38,12,1
134,501,240,261,80,62,49,42,309,149,160,55,33,27,15,1
135,126,70,56,25,10,5,5,1047,587,460,138,119,124,38,1
136,913,412,501,131,100,117,83,165,78,87,23,21,17,8,1
137,377,177,200,63,53,44,16,378,222,156,49,17,45,26,1
138,179,80,99,16,18,24,13,257,118,139,37,26,27,15,1
139,1765,810,955,267,253,180,49,216,119,97,33,27,28,7,1
140,299,148,151,49,35,41,15,375,202,173,46,49,41,23,1
141,225,116,109,29,19,25,6,508,295,213,42,61,53,17,1
142,572,309,263,64,55,47,29,892,420,472,135,146,98,37,1
143,440,268,172,45,42,66,16,267,124,143,45,46,26,4,1
144,178,100,78,23,22,30,6,595,316,279,86,60,65,40,1
145,206,100,106,34,26,11,7,706,300,406,94,74,61,22,1
146,171,85,86,23,16,20,10,490,224,266,80,70,39,32,1
147,1123,554,569,142,130,85,36,706,320,386,111,76,75,51,1
148,201,105,96,31,25,19,11,377,202,175,46,50,41,23,1
149,972,519,453,109,98,120,39,554,269,285,60,67,38,21,1
150,454,191,263,61,66,38,15,785,374,411,56,42,38,25,1
151,33423,16370,17053,4965,4756,2786,883,1960,810,1150,358,377,121,72,1
152,882,432,450,115,111,68,44,582,293,289,94,80,77,32,1
153,602,260,342,94,93,37,8,757,359,398,109,127,80,26,1
154,1441,657,784,140,135,81,73,457,261,196,55,27,57,34,1
155,605,283,322,94,72,64,39,781,418,363,92,90,64,41,1
156,275,155,120,37,31,16,14,245,137,108,34,30,19,10,1
157,446,265,181,51,35,27,17,428,226,202,52,60,75,20,1
158,1170,510,660,142,182,115,84,472,259,213,51,44,56,21,1
159,369,200,169,42,46,39,16,154,78,76,22,25,12,10,1
160,350,180,170,64,46,55,12,858,398,460,126,138,75,39,1
161,1048,564,484,118,122,113,40,272,149,123,46,14,27,16,1
162,106,52,54,18,4,9,8,875,421,454,124,142,98,43,1
163,198,113,85,19,20,26,12,446,176,270,64,79,45,24,1
164,119,62,57,19,4,11,10,355,220,135,43,26,65,20,1
165,246,115,131,15,29,10,32,325,184,141,43,34,22,18,1
166,794,322,472,122,108,79,34,393,186,207,58,50,36,22,1
167,240,167,73,32,12,8,21,140,86,54,17,6,20,7,1
168,211,92,119,33,44,11,7,1893,850,1043,280,340,169,80,1
169,638,305,333,68,90,70,29,256,141,115,24,23,30,9,1
170,410,208,202,59,58,43,26,524,237,287,87,75,54,26,1
171,591,274,317,89,66,75,41,501,216,285,79,70,54,30,1
172,686,375,311,89,80,63,20,506,254,252,57,82,41,17,1
173,1424,650,774,152,124,95,87,920,492,428,100,92,88,49,1
174,467,201,266,71,70,63,27,875,376,499,155,125,53,39,1
175,510,264,246,67,66,38,29,777,345,432,128,88,65,39,1
176,652,332,320,72,59,57,24,982,545,437,119,100,92,40,1
177,783,429,354,100,77,54,25,245,112,133,32,45,20,10,1
178,750,347,403,105,103,83,29,489,235,254,53,69,49,20,1
179,236,145,91,17,19,30,18,976,496,480,128,111,121,48,1
180,677,361,316,81,61,42,22,349,131,218,66,76,22,9,1
181,391,208,183,65,49,57,17,785,374,411,56,42,38,25,1
182,536,278,258,72,63,62,20,730,328,402,126,99,48,23,1
183,860,457,403,118,103,103,36,532,269,263,72,59,59,39,1
184,480,234,246,79,77,65,23,763,361,402,103,144,78,45,1
185,312,180,132,36,22,32,21,247,110,137,34,45,23,10,1
186,401,201,200,64,67,23,7,207,99,108,27,27,21,9,1
187,2169,995,1174,181,165,213,80,1255,666,589,145,142,120,82,1
188,255,134,121,36,40,29,13,2157,1171,986,306,238,131,32,1
189,605,215,390,138,54,75,35,89,42,47,16,12,15,6,1
190,391,208,183,65,49,57,17,601,290,311,92,89,55,30,1
191,183,91,92,21,29,16,10,648,307,341,101,58,76,34,1
192,838,431,407,107,90,107,43,262,123,139,44,32,25,18,1
193,264,126,138,44,26,25,10,117,62,55,24,18,21,2,1
194,512,261,251,79,73,60,21,833,452,381,117,85,71,39,1
195,1265,714,551,172,143,135,43,647,322,325,104,98,54,14,1
196,509,254,255,67,55,52,35,156,64,92,39,19,15,8,1
197,592,295,297,79,70,76,11,1893,850,1043,280,340,169,80,1
198,414,207,207,59,47,54,18,393,186,207,58,50,36,22,1
199,262,150,112,31,33,31,7,331,169,162,40,28,22,14,1
200,540,257,283,81,63,57,24,416,201,215,54,52,39,25,1
201,770,355,415,103,142,75,42,824,403,421,80,150,65,35,1
202,583,248,335,115,111,52,16,1164,531,633,179,157,107,46,1
203,729,391,338,80,64,71,34,101,43,58,18,16,12,7,1
204,360,179,181,63,60,26,12,167,77,90,22,25,11,11,1
205,330,157,173,56,42,51,8,976,496,480,128,111,121,48,1
206,3664,1638,2026,598,519,231,63,441,218,223,69,55,50,27,1
207,485,187,298,95,71,61,25,582,282,300,81,66,71,18,1
208,456,228,228,49,70,32,19,725,365,360,104,111,70,31,1
209,1071,549,522,133,127,130,59,154,78,76,22,25,12,10,1
210,166,95,71,23,21,12,4,648,341,307,78,89,77,21,1
211,977,406,571,151,128,84,47,1254,631,623,152,160,66,44,1
212,1150,645,505,134,112,131,64,545,289,256,75,72,42,22,1
213,456,228,228,49,70,32,19,293,145,148,49,41,25,9,1
214,595,316,279,86,60,65,40,361,184,177,50,53,51,22,1
215,166,81,85,30,27,13,8,247,110,137,34,45,23,10,1
216,452,256,196,32,44,27,11,160,86,74,21,11,16,16,1
217,123,61,62,22,16,18,6,180,69,111,38,33,13,8,1
218,822,374,448,134,118,76,39,745,391,354,85,81,52,39,1
219,854,380,474,137,159,81,31,4563,2219,2344,620,531,527,104,1
220,440,215,225,76,74,29,16,202,102,100,29,35,6,9,1
221,467,226,241,55,48,54,23,521,290,231,76,56,76,18,1
222,363,182,181,33,55,23,11,607,317,290,87,80,73,10,1
223,67,34,33,10,12,6,5,207,105,102,35,27,15,5,1
224,339,170,169,32,17,24,13,628,341,287,77,59,55,31,1
225,240,125,115,34,32,30,8,353,166,187,82,42,41,16,1
226,737,363,374,119,101,85,41,1259,705,554,174,158,123,34,1
227,94,45,49,11,20,10,4,95,49,46,12,16,9,5,1
228,114,70,44,8,11,11,7,327,177,150,40,40,38,18,1
229,292,175,117,37,29,21,14,1064,555,509,111,90,99,32,1
230,151,83,68,18,19,17,7,354,168,186,50,53,39,20,1
231,140,86,54,17,6,20,7,299,140,159,49,44,26,11,1
232,984,461,523,109,89,91,52,377,202,175,46,50,41,23,1
233,736,388,348,88,85,67,28,219,124,95,22,22,23,5,1
234,870,418,452,121,102,109,28,669,340,329,77,61,94,40,1
235,777,408,369,100,96,56,17,184,88,96,24,25,14,9,1
236,165,77,88,28,27,19,10,277,124,153,44,40,35,18,1
237,467,226,241,55,48,54,23,381,191,190,55,61,33,11,1
238,440,214,226,59,62,27,28,312,172,140,41,40,21,8,1
239,359,174,185,54,56,43,16,391,223,168,35,26,47,31,1
240,728,369,359,79,93,97,40,1744,920,824,225,190,178,57,1
241,1014,427,587,195,162,105,40,572,309,263,64,55,47,29,1
242,231,126,105,37,26,29,6,673,317,356,101,85,76,49,1
243,316,161,155,46,50,39,16,1395,627,768,172,263,141,59,1
244,150,74,76,21,22,18,7,206,100,106,28,32,18,8,1
245,306,128,178,49,59,17,9,202,102,100,29,35,6,9,1
246,375,173,202,50,46,43,25,382,169,213,55,47,38,27,1
247,697,373,324,105,83,95,38,603,291,312,98,87,61,28,1
248,497,185,312,63,92,38,28,1102,511,591,171,179,148,52,1
249,211,92,119,33,44,11,7,339,170,169,32,17,24,13,1
250,422,211,211,73,61,43,17,778,367,411,90,85,64,43,1
251,737,363,374,119,101,85,41,738,339,399,102,88,68,35,1
252,963,468,495,155,164,92,40,920,492,428,100,92,88,49,1
253,476,312,164,40,33,59,25,4563,2219,2344,620,531,527,104,1
254,465,225,240,65,44,65,25,316,166,150,45,38,37,13,1
255,1132,553,579,172,143,150,57,794,390,404,103,95,86,23,1
256,360,192,168,55,45,48,16,1020,410,610,220,221,32,13,1
257,264,122,142,33,29,13,13,3969,1703,2266,619,432,259,144,1
258,440,246,194,62,49,41,16,1158,481,677,169,129,86,40,1
259,360,219,141,33,26,65,22,92,44,48,6,8,9,8,1
260,397,184,213,64,39,40,28,467,226,241,55,48,54,23,1
261,2146,1050,1096,330,305,194,74,341,178,163,48,44,42,20,1
262,729,321,408,128,84,63,26,941,448,493,150,118,127,39,1
263,1450,638,812,220,196,18,18,350,180,170,64,46,55,12,1
264,3801,1837,1964,510,442,418,170,149,68,81,15,38,11,10,1
265,470,205,265,71,80,33,11,402,227,175,48,40,35,11,1
266,1446,762,684,193,160,182,67,354,169,185,54,54,41,19,1
267,369,214,155,45,42,25,13,1270,557,713,130,195,57,30,1
268,406,207,199,56,46,68,19,760,391,369,101,109,65,24,1
269,638,344,294,91,55,83,29,649,326,323,83,66,87,38,1
270,105,50,55,14,13,11,7,92,40,52,14,23,13,7,1
271,212,102,110,25,24,17,10,673,317,356,101,85,76,49,1
272,591,263,328,95,90,26,13,572,309,263,64,55,47,29,1
273,168,67,101,37,17,13,13,601,313,288,42,48,25,36,1
274,506,243,263,75,70,39,17,705,396,309,87,48,53,17,1
275,350,183,167,47,30,30,21,261,130,131,27,41,19,16,1
276,405,180,225,72,57,31,12,238,127,111,25,18,33,8,1
277,431,204,227,59,72,41,12,833,452,381,117,85,71,39,1
278,247,127,120,43,20,27,14,1302,637,665,162,150,125,61,1
279,454,223,231,38,45,24,19,636,320,316,79,61,67,31,1
280,357,147,210,48,37,21,47,703,308,395,81,91,66,80,1
281,574,287,287,94,70,63,25,2414,1189,1225,277,178,170,169,1
282,519,244,275,76,90,44,16,505,273,232,70,57,60,33,1
283,445,219,226,61,60,60,21,859,395,464,157,119,59,31,1
284,285,107,178,49,58,27,17,601,313,288,42,48,25,36,1
285,581,299,282,93,81,73,26,1255,708,547,120,68,88,7,1
286,509,254,255,67,55,52,35,628,311,317,111,75,63,18,1
287,473,224,249,82,63,48,24,360,192,168,55,45,48,16,1
288,322,150,172,43,27,25,33,648,307,341,101,58,76,34,1
289,219,104,115,25,31,25,11,465,225,240,65,44,65,25,1
290,502,240,262,78,61,54,32,156,64,92,39,19,15,8,1
291,784,373,411,101,90,91,37,803,346,457,126,171,74,24,1
292,860,427,433,132,100,81,30,1147,483,664,200,195,95,53,1
293,1909,782,1127,297,242,111,65,377,184,193,56,53,44,14,1
294,427,191,236,67,60,41,34,533,297,236,74,57,39,28,1
295,1863,721,1142,262,283,139,74,3830,2000,1830,532,388,418,203,1
296,351,143,208,44,68,23,18,743,341,402,104,89,68,38,1
297,359,153,206,47,43,28,18,400,195,205,63,67,40,18,1
298,181,96,85,25,23,20,7,1957,777,1180,315,263,149,46,1
299,128,58,70,22,14,4,7,760,391,369,101,109,65,24,1
300,189,93,96,24,28,17,12,2302,1030,1272,319,296,220,111,1
301,673,317,356,101,85,76,49,139,62,77,23,6,14,4,1
302,676,333,343,111,89,94,39,1068,539,529,161,134,132,71,1
303,186,84,102,27,29,21,10,512,261,251,79,73,60,21,1
304,928,442,486,139,118,91,43,1863,721,1142,262,283,139,74,1
305,546,267,279,90,69,56,19,2414,1189,1225,277,178,170,169,1
306,1149,568,581,177,133,101,30,609,292,317,102,96,64,21,1
307,168,67,101,37,17,13,13,422,213,209,63,60,35,13,1
308,168,90,78,22,19,13,4,254,107,147,42,37,24,10,1
309,4303,2489,1814,436,369,444,134,313,157,156,39,26,34,29,1
310,705,396,309,87,48,53,17,1290,629,661,191,187,167,55,1
311,1577,747,830,213,232,147,57,651,307,344,74,130,45,18,1
312,909,455,454,137,82,85,68,1207,593,614,151,148,131,95,1
313,281,125,156,44,47,17,7,437,228,209,47,61,26,11,1
314,816,463,353,99,99,61,26,467,261,206,54,49,48,24,1
315,309,154,155,42,44,45,16,676,333,343,111,89,94,39,1
316,96,55,41,13,2,8,5,374,217,157,52,23,67,13,1
317,296,147,149,45,29,30,23,333,171,162,41,44,48,23,1
318,1162,515,647,191,143,97,35,353,196,157,51,39,49,8,1
319,1043,633,410,140,92,102,31,1464,715,749,200,167,181,70,1
320,565,294,271,61,67,39,25,2381,1269,1112,310,279,201,104,1
321,461,207,254,82,66,55,33,432,218,214,57,55,42,11,1
322,585,312,273,57,64,77,25,375,214,161,38,36,24,17,1
323,896,407,489,97,152,70,22,660,332,328,84,73,47,19,1
324,336,154,182,51,48,39,22,2871,1148,1723,496,469,204,98,1
325,502,240,262,78,61,54,32,211,108,103,34,25,26,12,1
326,446,176,270,64,79,45,24,670,358,312,95,75,58,26,1
327,380,184,196,58,52,46,8,1333,646,687,209,179,148,45,1
328,89,42,47,16,12,15,6,78,28,50,12,16,1,2,1
329,1424,650,774,152,124,95,87,101,41,60,18,19,10,5,1
330,564,313,251,74,62,61,22,233,121,112,24,31,30,7,1
331,351,183,168,55,44,33,9,140,86,54,17,6,20,7,1
332,138,63,75,20,22,10,7,292,153,139,39,33,24,21,1
333,438,258,180,49,28,76,28,161,83,78,33,12,17,5,1
334,358,170,188,54,55,20,10,557,349,208,52,43,79,29,1
335,1690,795,895,271,257,150,101,1068,527,541,160,131,112,52,1
336,645,267,378,90,93,65,25,555,253,302,76,69,63,30,1
337,802,388,414,131,105,96,29,271,110,161,33,27,11,8,1
338,136,65,71,33,11,9,6,165,83,82,16,29,11,9,1
339,298,160,138,37,30,22,12,906,485,421,112,98,112,39,1
340,85,44,41,9,6,10,9,686,337,349,96,116,45,19,1
341,490,224,266,80,70,39,32,526,268,258,54,37,55,12,1
342,291,156,135,42,24,28,7,390,191,199,57,49,45,25,1
343,1149,568,581,177,133,101,30,178,100,78,23,22,30,6,1
344,572,353,219,70,42,57,25,538,286,252,80,58,48,14,1
345,346,183,163,51,38,23,6,246,113,133,33,45,22,10,1
346,598,300,298,68,77,59,21,435,212,223,71,56,40,18,1
347,656,358,298,67,47,64,26,327,185,142,43,28,53,29,1
348,456,228,228,49,70,32,19,515,259,256,79,58,46,21,1
349,371,230,141,42,21,41,21,164,87,77,16,18,12,20,1
350,883,470,413,112,99,108,34,1141,582,559,162,151,76,34,1
351,465,225,240,65,44,65,25,128,54,74,30,13,8,7,1
352,1070,558,512,154,134,126,54,363,221,142,36,16,56,25,1
353,254,140,114,17,22,26,19,402,227,175,48,40,35,11,1
354,854,380,474,137,159,81,31,947,482,465,143,107,89,37,1
355,518,262,256,70,52,49,27,446,176,270,64,79,45,24,1
356,141,70,71,16,19,12,6,511,273,238,52,67,62,21,1
357,586,270,316,83,80,59,21,486,236,250,73,67,59,16,1
358,600,254,346,104,100,44,17,221,110,111,28,32,25,11,1
359,355,168,187,55,48,40,15,477,281,196,38,41,63,29,1
360,192,92,100,36,20,14,6,1100,474,626,197,143,126,41,1
361,281,125,156,44,47,17,7,410,188,222,53,52,31,14,1
362,246,108,138,32,44,21,10,614,275,339,108,83,80,31,1
363,293,142,151,49,40,42,17,466,186,280,71,84,30,11,1
364,153,65,88,28,21,20,8,347,190,157,47,38,49,10,1
365,246,115,131,15,29,10,32,379,174,205,71,58,25,14,1
366,526,264,262,77,71,61,27,422,213,209,59,47,42,14,1
367,1424,650,774,152,124,95,87,295,143,152,38,47,22,25,1
368,358,169,189,71,50,39,18,592,265,327,86,85,30,24,1
369,225,113,112,29,45,19,7,509,267,242,79,81,38,20,1
370,767,392,375,113,112,83,13,427,218,209,56,57,53,24,1
371,515,259,256,79,58,46,21,446,176,270,64,79,45,24,1
372,482,235,247,58,45,37,26,464,236,228,64,56,53,28,1
373,912,461,451,127,109,96,48,870,415,455,112,103,93,51,1
374,750,347,403,105,103,83,29,2442,1193,1249,278,183,170,145,1
375,492,238,254,72,56,49,20,822,416,406,111,105,84,44,1
376,224,103,121,34,47,11,9,233,96,137,40,40,13,9,1
377,491,270,221,51,47,53,18,263,146,117,24,21,23,14,1
378,448,199,249,65,54,38,33,813,440,373,117,93,34,19,1
379,989,439,550,142,121,75,29,1336,828,508,166,121,152,48,1
380,1395,627,768,172,263,141,59,465,279,186,48,24,70,25,1
381,390,171,219,73,77,16,6,905,371,534,192,135,81,28,1
382,1657,800,857,249,235,154,51,901,458,443,91,129,86,21,1
383,730,337,393,115,111,91,26,183,96,87,20,28,17,10,1
384,171,88,83,20,21,16,7,435,221,214,72,45,47,19,1
385,1222,648,574,138,139,132,38,601,313,288,42,48,25,36,1
386,281,166,115,34,17,36,16,416,182,234,62,67,37,17,1
387,1164,531,633,179,157,107,46,245,111,134,31,44,20,11,1
388,490,224,266,80,70,39,32,1050,473,577,142,119,87,54,1
389,1179,579,600,140,133,122,53,825,363,462,97,105,72,75,1
390,98,41,57,19,19,8,2,422,211,211,73,61,43,17,1
391,456,228,228,49,70,32,19,564,284,280,71,64,41,13,1
392,834,405,429,112,95,84,34,748,386,362,111,75,71,40,1
393,611,246,365,116,82,71,27,335,155,180,64,48,36,10,1
394,751,312,439,131,115,78,48,567,296,271,88,53,55,30,1
395,245,157,88,25,16,26,10,245,142,103,29,20,21,9,1
396,504,259,245,73,56,45,29,327,177,150,56,20,25,6,1
397,1140,495,645,129,95,128,159,1041,496,545,179,167,97,35,1
398,313,149,164,48,31,30,13,327,177,150,40,40,38,18,1
399,525,274,251,82,74,60,25,817,397,420,120,152,48,17,1
400,497,185,312,63,92,38,28,152,74,78,17,20,16,6,1
401,189,90,99,26,29,17,11,210,115,95,31,22,27,10,1
402,207,107,100,27,25,20,11,635,333,302,99,75,83,28,1
403,671,318,353,83,124,46,34,240,98,142,49,42,23,17,1
404,1338,756,582,155,105,104,44,593,266,327,102,84,69,24,1
405,565,291,274,61,80,59,31,537,276,261,75,68,68,22,1
406,825,427,398,79,95,81,48,493,208,285,75,77,70,40,1
407,326,167,159,46,31,38,13,277,100,177,35,88,30,2,1
408,94,55,39,18,6,18,5,876,473,403,110,106,73,24,1
409,225,116,109,29,19,25,6,972,519,453,109,98,120,39,1
410,794,402,392,96,84,86,30,1198,613,585,156,130,137,44,1
411,392,156,236,40,91,28,16,777,345,432,128,88,65,39,1
412,636,380,256,59,60,65,24,750,347,403,105,103,83,29,1
413,3056,1457,1599,438,389,329,168,490,198,292,65,81,39,27,1
414,1378,680,698,160,154,111,38,709,294,415,132,123,76,23,1
415,815,418,397,97,62,70,17,375,173,202,50,46,43,25,1
416,794,390,404,103,95,86,23,1124,615,509,157,125,128,52,1
417,138,67,71,21,20,15,9,254,117,137,33,35,38,6,1
418,307,133,174,48,53,27,10,454,191,263,61,66,38,15,1
419,440,218,222,58,66,40,24,363,182,181,33,55,23,11,1
420,419,175,244,71,73,23,23,745,366,379,110,93,79,45,1
421,262,151,111,30,17,32,25,590,273,317,78,96,63,20,1
422,346,156,190,54,42,28,13,847,371,476,168,149,64,20,1
423,465,225,240,65,44,65,25,920,492,428,100,92,88,49,1
424,657,293,364,109,75,66,28,2382,1161,1221,237,220,140,50,1
425,1338,506,832,241,229,101,40,525,308,217,60,45,54,12,1
426,511,271,240,64,55,81,23,692,326,366,103,121,67,27,1
427,487,201,286,71,84,26,26,380,187,193,38,51,30,18,1
428,391,165,226,56,104,38,12,496,244,252,70,63,50,24,1
429,4655,2074,2581,545,652,562,399,317,156,161,49,51,18,10,1
430,240,125,115,34,32,30,8,509,262,247,64,70,64,20,1
431,484,254,230,60,66,56,14,107,36,71,27,15,0,1,1
432,593,257,336,76,56,56,96,335,148,187,52,26,51,12,1
433,63,29,34,13,10,4,8,327,177,150,40,40,38,18,1
434,3333,1606,1727,446,357,333,206,201,98,103,26,35,16,5,1
435,298,159,139,39,40,33,15,416,210,206,55,54,39,20,1
436,240,125,115,34,32,30,8,255,144,111,23,27,32,11,1
437,89,42,47,16,12,15,6,364,195,169,50,38,33,12,1
438,501,240,261,80,62,49,42,673,317,356,101,85,76,49,1
439,309,164,145,35,47,30,11,536,237,299,116,87,42,17,1
440,154,75,79,17,24,16,13,4861,2440,2421,597,576,422,237,1
441,709,310,399,95,103,61,30,1447,751,696,161,143,131,46,1
442,186,100,86,23,25,20,9,144,66,78,18,22,20,4,1
443,588,255,333,94,82,58,27,468,238,230,67,69,39,26,1
444,1499,678,821,224,201,126,55,781,418,363,92,90,64,41,1
445,234,133,101,29,25,28,7,248,120,128,43,37,20,6,1
446,211,110,101,31,30,25,8,638,327,311,88,79,77,28,1
447,591,366,225,66,42,76,43,370,176,194,61,30,40,28,1
448,310,156,154,27,43,20,6,168,67,101,37,17,13,13,1
449,508,295,213,42,61,53,17,906,455,451,116,105,87,46,1
450,672,334,338,110,93,91,41,586,254,332,114,111,55,17,1
451,418,220,198,69,51,44,16,764,277,487,158,162,64,31,1
452,736,388,348,88,85,67,28,715,324,391,107,92,71,31,1
453,1273,592,681,199,164,139,39,624,222,402,92,81,39,15,1
454,596,313,283,86,77,64,20,839,446,393,125,110,94,35,1
455,764,277,487,158,162,64,31,391,208,183,65,49,57,17,1
456,372,189,183,60,44,41,18,163,70,93,28,21,17,6,1
457,1785,857,928,246,225,187,93,381,191,190,55,61,33,11,1
458,2045,985,1060,359,339,199,74,653,389,264,69,59,51,19,1
459,445,225,220,47,62,53,26,442,252,190,35,52,20,4,1
460,376,195,181,41,39,52,13,442,208,234,68,49,51,25,1
461,100,50,50,15,13,10,4,288,112,176,55,55,18,15,1
462,604,255,349,100,72,55,26,366,211,155,35,42,24,12,1
463,303,137,166,54,54,31,15,420,189,231,79,67,33,17,1
464,521,267,254,53,68,39,15,576,250,326,93,71,34,15,1
465,297,158,139,47,37,37,9,322,160,162,44,52,33,16,1
466,863,458,405,97,82,63,57,543,287,256,71,66,64,23,1
467,425,210,215,56,43,52,25,843,391,452,139,104,91,34,1
468,698,345,353,104,87,81,50,592,283,309,84,137,60,20,1
469,393,186,207,58,50,36,22,1816,865,951,246,230,189,76,1
470,208,100,108,27,29,18,9,1116,413,703,214,213,53,41,1
471,538,268,270,58,72,42,25,399,201,198,65,45,48,17,1
472,1096,563,533,157,137,120,53,135,61,74,23,22,14,5,1
473,496,272,224,70,58,42,18,504,255,249,56,59,45,13,1
474,377,184,193,56,53,44,14,1106,579,527,121,152,113,45,1
475,351,184,167,59,45,54,9,100,37,63,26,19,0,1,1
476,229,105,124,36,33,12,4,708,334,374,105,96,61,37,1
477,764,409,355,88,73,102,43,185,115,70,19,17,26,6,1
478,372,237,135,38,22,39,26,354,169,185,54,54,41,19,1
479,494,123,371,160,58,29,5,671,318,353,83,124,46,34,1
480,503,263,240,72,55,51,34,501,216,285,79,70,54,30,1
481,277,173,104,26,12,48,19,304,127,177,61,38,31,4,1
482,624,204,420,166,101,32,13,355,179,176,51,45,45,11,1
483,267,161,106,22,25,35,20,825,363,462,97,105,72,75,1
484,592,264,328,86,85,62,41,367,181,186,63,51,37,20,1
485,953,481,472,133,130,77,48,212,135,77,22,13,44,7,1
486,293,142,151,49,40,42,17,671,306,365,114,76,49,19,1
487,687,353,334,84,96,74,31,788,360,428,93,106,67,72,1
488,767,392,375,113,112,83,13,4655,2074,2581,545,652,562,399,1
489,1336,828,508,166,121,152,48,673,329,344,111,95,92,41,1
490,462,157,305,93,51,54,3,601,313,288,42,48,25,36,1
491,98,45,53,16,11,15,3,333,171,162,41,44,48,23,1
492,212,135,77,22,13,44,7,181,96,85,25,23,20,7,1
493,585,312,273,57,64,77,25,1028,576,452,128,139,79,31,1
494,462,251,211,74,53,41,18,376,183,193,50,50,43,21,1
495,745,366,379,110,93,79,45,2524,1232,1292,398,317,186,61,1
496,391,208,183,65,49,57,17,292,140,152,53,40,30,10,1
497,264,122,142,33,29,13,13,536,266,270,58,73,40,25,1
498,376,205,171,56,52,46,12,377,202,175,46,50,41,23,1
499,894,439,455,138,104,106,44,352,166,186,55,59,31,16,1
500,797,382,415,126,94,89,41,189,90,99,26,29,17,11,1
501,120,61,59,17,8,8,5,355,214,141,43,29,63,13,1
502,1067,555,512,141,129,100,36,1074,538,536,154,140,111,51,1
503,360,192,168,55,45,48,16,508,295,213,42,61,53,17,1
504,424,257,167,41,28,46,27,354,169,185,54,54,41,19,1
505,355,220,135,43,26,65,20,529,283,246,66,69,66,25,1
506,1216,552,664,194,189,110,49,205,82,123,38,28,20,15,1
507,98,49,49,14,15,9,2,339,177,162,40,36,51,24,1
508,427,191,236,67,60,41,34,529,283,246,66,69,66,25,1
509,1217,647,570,142,160,129,45,1304,696,608,195,169,122,53,1
510,1503,691,812,145,265,133,35,205,77,128,31,45,12,11,1
511,1037,461,576,146,163,75,44,982,545,437,119,100,92,40,1
512,1049,530,519,102,125,89,48,797,406,391,121,86,64,15,1
513,1417,598,819,223,188,135,58,662,312,350,103,104,59,20,1
514,2017,818,1199,352,379,37,24,504,256,248,78,70,36,9,1
515,390,203,187,58,40,43,19,788,367,421,93,97,71,71,1
516,1087,523,564,146,177,103,33,163,70,93,28,21,17,6,1
517,299,164,135,37,29,28,11,521,289,232,71,58,49,16,1
518,787,386,401,98,95,86,25,2524,1232,1292,398,317,186,61,1
519,803,346,457,126,171,74,24,2768,1380,1388,280,294,291,161,1
520,1863,721,1142,262,283,139,74,229,105,124,36,33,12,4,1
521,925,484,441,112,86,84,31,592,291,301,92,93,71,31,1
522,624,308,316,92,72,68,22,993,492,501,116,119,135,57,1
523,393,186,207,58,50,36,22,341,178,163,48,44,42,20,1
524,989,439,550,142,121,75,29,204,80,124,29,51,10,5,1
525,1302,637,665,162,150,125,61,494,234,260,88,81,61,29,1
526,639,373,266,77,89,68,25,601,313,288,42,48,25,36,1
527,794,390,404,103,95,86,23,360,192,168,55,45,48,16,1
528,184,91,93,26,25,16,7,150,74,76,21,22,18,7,1
529,757,373,384,115,93,95,25,1141,562,579,169,144,135,43,1
530,1893,764,1129,308,323,126,60,392,115,277,117,75,28,17,1
531,122,52,70,24,22,7,6,758,360,398,114,107,51,19,1
532,355,215,140,33,38,27,10,777,387,390,90,87,65,37,1
533,434,237,197,52,64,37,14,413,194,219,77,72,28,11,1
534,426,231,195,51,52,45,24,318,158,160,41,40,31,15,1
535,2390,1131,1259,395,383,203,74,377,202,175,46,50,41,23,1
536,206,86,120,40,13,23,14,499,252,247,74,42,55,14,1
537,671,321,350,95,87,75,34,501,240,261,80,62,49,42,1
538,712,396,316,78,69,65,25,839,427,412,91,83,114,37,1
539,1360,600,760,233,199,123,40,377,184,193,56,53,44,14,1
540,557,279,278,66,70,59,26,562,273,289,76,92,45,24,1
541,360,188,172,49,48,47,17,900,480,420,108,105,96,30,1
542,525,299,226,54,54,51,19,652,272,380,116,113,55,27,1
543,423,247,176,58,55,29,20,5938,2573,3365,858,958,396,195,1
544,1132,553,579,172,143,150,57,223,132,91,18,16,27,17,1
545,1102,511,591,171,179,148,52,566,253,313,84,82,51,32,1
546,603,311,292,102,71,66,23,499,290,209,59,50,50,19,1
547,636,336,300,94,65,58,32,499,250,249,78,81,46,25,1
548,317,153,164,39,30,35,13,395,222,173,48,42,21,8,1
549,129,66,63,23,17,18,4,2477,1186,1291,256,271,249,90,1
550,3056,1457,1599,438,389,329,168,1233,498,735,252,232,88,41,1
551,754,318,436,114,106,58,28,410,208,202,59,58,43,26,1
552,140,86,54,17,6,20,7,87,50,37,16,7,10,5,1
553,546,267,279,90,69,56,19,454,191,263,61,66,38,15,1
554,1970,978,992,245,206,198,80,1863,721,1142,262,283,139,74,1
555,479,228,251,71,57,60,14,540,253,287,73,67,57,20,1
556,246,108,138,32,44,21,10,601,290,311,92,89,55,30,1
557,340,169,171,49,42,31,14,240,125,115,34,32,30,8,1
558,158,85,73,24,18,18,8,1324,609,715,149,119,97,56,1
559,380,187,193,38,51,30,18,505,226,279,68,51,30,15,1
560,208,99,109,28,30,18,9,653,298,355,70,101,64,39,1
561,566,287,279,77,66,34,14,184,86,98,26,26,14,11,1
562,724,334,390,112,109,79,17,502,286,216,56,50,66,32,1
563,242,111,131,35,35,17,13,119,67,52,15,15,7,7,1
564,686,375,311,89,80,63,20,259,143,116,39,37,23,9,1
565,1332,626,706,182,144,80,41,1336,828,508,166,121,152,48,1
566,457,242,215,39,46,53,10,455,218,237,57,51,42,35,1
567,425,198,227,57,69,59,13,412,193,219,70,56,51,26,1
568,660,359,301,81,87,102,31,1516,963,553,148,152,111,26,1
569,898,361,537,182,146,91,40,977,492,485,135,122,116,35,1
570,753,359,394,102,100,85,23,89,45,44,13,4,8,3,1
571,428,226,202,52,60,75,20,770,374,396,95,91,79,41,1
572,546,267,279,90,69,56,19,324,145,179,45,23,32,17,1
573,422,222,200,58,39,62,21,1029,482,547,147,158,71,32,1
574,2414,1189,1225,277,178,170,169,1320,729,591,134,102,121,39,1
575,559,266,293,85,78,74,17,859,395,464,157,119,59,31,1
576,1580,742,838,208,146,144,71,728,358,370,118,100,55,29,1
577,622,299,323,86,86,69,35,376,190,186,48,52,44,25,1
578,380,225,155,52,37,72,11,554,350,204,47,42,66,35,1
579,895,420,475,132,128,52,45,781,418,363,92,90,64,41,1
580,147,81,66,18,18,18,4,1290,597,693,182,182,119,63,1
581,476,227,249,52,59,38,17,1233,523,710,181,185,128,39,1
582,655,349,306,78,59,76,42,728,343,385,116,82,96,57,1
583,155,85,70,17,16,4,8,604,255,349,100,72,55,26,1
584,1308,646,662,157,133,173,54,628,339,289,84,80,87,32,1
585,1290,629,661,191,187,167,55,258,131,127,37,32,20,14,1
586,431,227,204,53,60,58,12,279,106,173,48,35,41,39,1
587,383,204,179,61,32,54,16,1498,731,767,220,175,148,68,1
588,98,55,43,14,1,7,4,246,115,131,15,29,10,32,1
589,204,93,111,35,35,16,11,362,181,181,67,46,43,8,1
590,557,268,289,66,67,70,17,515,253,262,46,83,57,21,1
591,213,84,129,38,27,19,9,295,145,150,41,45,36,18,1
592,164,88,76,27,20,17,6,220,126,94,29,12,34,11,1
593,462,228,234,59,47,37,32,2063,1024,1039,175,117,80,97,1
594,620,396,224,53,44,97,26,443,240,203,66,31,57,27,1
595,95,44,51,14,13,7,4,459,221,238,52,76,33,24,1
596,351,184,167,59,45,54,9,766,386,380,101,81,78,31,1
597,321,187,134,59,29,32,8,294,148,146,35,33,25,14,1
598,458,265,193,55,35,49,27,409,200,209,69,56,44,13,1
599,552,264,288,82,64,48,20,2161,1233,928,269,199,178,42,1
600,1691,1217,474,130,115,73,46,770,355,415,103,142,75,42,1
601,480,244,236,74,47,50,21,339,183,156,43,45,28,17,1
602,312,158,154,45,49,29,14,653,309,344,107,75,49,14,1
603,159,84,75,13,28,10,8,1440,759,681,173,170,178,71,1
604,476,270,206,62,45,46,30,250,105,145,39,27,22,40,1
605,454,209,245,85,78,45,9,592,291,301,92,93,71,31,1
606,508,254,254,74,99,61,12,335,183,152,36,27,45,11,1
607,1473,758,715,205,171,161,65,418,190,228,80,50,45,22,1
608,651,306,345,85,64,61,32,158,85,73,24,18,18,8,1
609,1114,581,533,145,132,126,54,360,192,168,55,45,48,16,1
610,684,288,396,107,90,54,42,2440,1061,1379,377,326,172,62,1
611,381,189,192,74,49,44,13,672,334,338,110,93,91,41,1
612,656,358,298,67,47,64,26,225,125,100,33,32,29,12,1
613,706,354,352,82,61,32,30,592,292,300,56,52,71,17,1
614,247,110,137,34,45,23,10,632,285,347,102,78,43,29,1
615,598,288,310,86,79,46,15,2512,1328,1184,379,280,301,113,1
616,128,65,63,18,13,7,6,598,300,298,68,77,59,21,1
617,810,367,443,115,92,94,59,376,190,186,48,52,44,25,1
618,961,463,498,139,156,62,34,1174,594,580,175,155,126,66,1
619,265,183,82,22,17,41,7,709,373,336,73,72,78,24,1
620,1464,693,771,153,136,91,86,462,233,229,66,49,43,30,1
621,1527,633,894,314,260,134,67,261,130,131,27,41,19,16,1
622,2063,1024,1039,175,117,80,97,609,292,317,102,96,64,21,1
623,237,122,115,30,26,14,6,902,332,570,154,146,75,40,1
624,501,240,261,80,62,49,42,694,260,434,122,92,62,36,1
625,412,223,189,55,55,41,10,509,262,247,64,70,64,20,1
626,583,322,261,73,66,45,26,632,339,293,83,77,59,20,1
627,236,110,126,31,39,10,8,295,145,150,41,45,36,18,1
628,697,373,324,105,83,95,38,770,385,385,78,83,60,16,1
629,489,242,247,83,63,62,19,758,362,396,115,102,35,13,1
630,163,71,92,33,26,5,7,536,237,299,116,87,42,17,1
631,247,110,137,34,45,23,10,362,218,144,48,27,48,19,1
632,445,254,191,67,49,61,10,467,224,243,70,43,67,23,1
633,439,227,212,60,55,58,8,2758,1332,1426,394,384,287,131,1
634,129,49,80,23,22,12,8,233,97,136,32,37,13,23,1
635,1038,470,568,130,123,86,51,445,225,220,47,62,53,26,1
636,648,307,341,101,58,76,34,840,385,455,118,137,66,39,1
637,1190,638,552,162,95,112,18,476,270,206,62,45,46,30,1
638,1085,529,556,149,133,126,54,493,208,285,75,77,70,40,1
639,770,394,376,92,92,98,33,212,88,124,46,24,22,16,1
640,240,154,86,16,14,25,22,393,186,207,58,50,36,22,1
641,933,536,397,96,90,71,41,651,306,345,85,64,61,32,1
642,422,203,219,75,49,40,22,245,112,133,32,45,20,10,1
643,255,130,125,44,18,22,12,423,220,203,51,54,46,17,1
644,220,113,107,31,21,25,12,198,86,112,24,29,25,15,1
645,1253,639,614,181,155,164,73,498,263,235,59,63,36,10,1
646,673,329,344,111,95,92,41,382,200,182,53,36,51,16,1
647,216,102,114,31,29,21,6,467,269,198,46,51,60,18,1
648,584,250,334,80,96,22,13,89,42,47,16,12,15,6,1
649,1539,757,782,214,214,146,83,350,178,172,49,62,29,16,1
650,239,129,110,39,31,33,13,315,156,159,41,43,29,17,1
651,184,78,106,21,25,25,12,292,162,130,43,27,21,12,1
652,894,492,402,95,103,88,42,729,391,338,80,64,71,34,1
653,599,298,301,84,64,72,22,193,85,108,24,37,20,13,1
654,673,329,344,111,95,92,41,78,45,33,12,10,2,5,1
655,255,122,133,35,51,22,13,1807,933,874,248,203,173,71,1
656,445,209,236,63,50,42,28,327,177,150,56,20,25,6,1
657,2549,1331,1218,366,296,271,130,1335,701,634,163,140,140,64,1
658,204,96,108,31,37,20,5,329,181,148,51,31,40,14,1
659,95,44,51,14,13,7,4,356,191,165,46,43,17,11,1
660,583,322,261,73,66,45,26,1400,800,600,158,134,150,65,1
661,588,266,322,99,79,87,28,393,186,207,58,50,36,22,1
662,247,133,114,41,25,41,8,401,167,234,56,71,16,10,1
663,1042,570,472,113,125,91,61,1338,756,582,155,105,104,44,1
664,217,109,108,34,30,34,5,262,144,118,19,39,22,8,1
665,1591,704,887,253,227,156,50,697,373,324,105,83,95,38,1
666,323,162,161,44,28,43,14,906,485,421,112,98,112,39,1
667,589,281,308,69,39,63,20,450,231,219,77,50,76,16,1
668,394,202,192,44,43,38,28,119,54,65,26,14,6,5,1
669,332,170,162,44,38,39,10,2414,1189,1225,277,178,170,169,1
670,376,183,193,50,50,43,21,652,272,380,116,113,55,27,1
671,427,254,173,63,28,46,24,331,170,161,47,39,41,8,1
672,445,219,226,61,60,60,21,671,318,353,83,124,46,34,1
673,525,245,280,59,72,47,21,1124,615,509,157,125,128,52,1
674,820,431,389,109,98,84,30,501,240,261,80,62,49,42,1
675,349,207,142,47,16,57,15,123,67,56,18,15,10,3,1
676,440,218,222,58,66,40,24,367,197,170,49,36,36,18,1
677,390,218,172,48,21,66,17,354,169,185,54,54,41,19,1
678,815,418,397,97,62,70,17,1603,887,716,208,142,131,48,1
679,479,238,241,64,47,62,22,331,169,162,40,28,22,14,1
680,482,221,261,63,74,53,35,276,143,133,34,38,20,15,1
681,1004,498,506,94,59,46,33,646,316,330,89,95,48,17,1
682,557,278,279,75,70,66,31,191,101,90,21,23,28,5,1
683,215,80,135,54,56,21,9,140,86,54,17,6,20,7,1
684,247,110,137,34,45,23,10,881,419,462,132,82,81,24,1
685,198,113,85,19,20,26,12,4967,2501,2466,718,692,594,248,1
686,651,331,320,93,93,51,28,179,78,101,29,22,10,8,1
687,609,292,317,102,96,64,21,3144,1617,1527,367,342,278,136,1
688,775,324,451,130,140,45,15,780,354,426,123,102,45,17,1
689,244,136,108,21,25,25,13,217,109,108,34,32,35,7,1
690,309,179,130,37,19,31,16,245,112,133,32,45,20,10,1
691,245,112,133,32,45,20,10,1242,613,629,174,113,114,53,1
692,199,87,112,31,27,8,15,316,132,184,48,49,14,14,1
693,344,168,176,65,44,33,15,1059,580,479,138,117,67,27,1
694,1591,734,857,229,225,171,75,400,208,192,61,51,36,16,1
695,509,262,247,64,70,64,20,724,334,390,112,109,79,17,1
696,452,236,216,73,54,50,29,44,13,31,9,11,1,2,1
697,1049,585,464,107,108,120,28,822,424,398,107,106,86,46,1
698,501,218,283,86,94,63,15,374,191,183,70,48,61,13,1
699,785,374,411,56,42,38,25,743,366,377,41,37,26,14,1
700,1271,599,672,194,175,118,47,246,113,133,33,45,22,10,1
701,296,147,149,45,29,30,23,255,144,111,23,27,32,11,1
702,305,161,144,39,40,44,17,339,150,189,55,60,34,12,1
703,625,316,309,77,79,54,34,712,396,316,78,69,65,25,1
704,461,207,254,82,66,55,33,533,297,236,74,57,39,28,1
705,540,357,183,68,65,9,11,96,50,46,8,15,6,2,1
706,1597,710,887,241,219,146,69,183,91,92,21,29,16,10,1
707,84,43,41,5,11,6,11,184,102,82,22,15,25,8,1
708,148,93,55,24,3,19,8,1192,579,613,120,215,79,24,1
709,419,197,222,70,51,36,19,1135,624,511,150,118,145,73,1
710,590,279,311,103,83,69,30,418,235,183,48,24,55,30,1
711,156,77,79,45,14,12,2,1038,527,511,118,163,120,52,1
712,158,85,73,24,18,18,8,224,103,121,34,47,11,9,1
713,428,226,202,52,60,75,20,1084,537,547,154,121,92,35,1
714,247,110,137,34,45,23,10,476,233,243,76,61,52,21,1
715,805,261,544,190,124,58,19,743,233,510,148,142,28,17,1
716,160,60,100,23,40,19,11,543,246,297,99,93,50,29,1
717,467,226,241,55,48,54,23,278,111,167,66,66,19,8,1
718,1342,673,669,178,154,137,94,1255,708,547,120,68,88,7,1
719,468,243,225,60,50,34,32,538,252,286,77,87,53,30,1
720,277,124,153,44,40,35,18,605,295,310,74,66,70,36,1
721,603,311,292,102,71,66,23,834,465,369,82,84,81,21,1
722,450,243,207,56,51,71,18,538,252,286,77,87,53,30,1
723,657,342,315,111,68,40,7,1113,480,633,170,173,81,34,1
724,508,267,241,57,49,40,13,1333,646,687,209,179,148,45,1
725,1304,585,719,179,169,154,47,847,402,445,109,91,100,37,1
726,109,57,52,19,7,8,8,372,217,155,45,25,56,21,1
727,591,263,328,95,90,26,13,1007,553,454,106,93,75,34,1
728,1037,461,576,146,163,75,44,165,90,75,36,18,20,6,1
729,72,30,42,12,8,3,4,340,169,171,40,39,36,22,1
730,256,134,122,27,31,31,10,552,285,267,74,51,69,24,1
731,1091,543,548,146,136,110,34,217,109,108,34,32,35,7,1
732,323,195,128,39,22,51,11,178,89,89,26,21,21,10,1
733,513,246,267,71,66,60,35,330,143,187,63,29,52,20,1
734,339,150,189,55,60,34,12,667,294,373,97,80,70,38,1
735,590,306,284,69,82,68,27,606,307,299,92,56,68,30,1
736,224,89,135,46,40,14,14,176,73,103,22,29,13,9,1
737,664,241,423,99,138,66,27,253,148,105,31,15,39,16,1
738,208,99,109,28,30,18,9,262,128,134,40,42,31,10,1
739,631,261,370,110,109,50,26,211,114,97,32,24,19,10,1
740,756,362,394,102,104,73,25,614,275,339,108,83,80,31,1
741,360,192,168,55,45,48,16,817,397,420,120,152,48,17,1
742,951,506,445,107,118,79,40,263,146,117,30,26,25,5,1
743,140,81,59,16,15,15,12,235,149,86,30,21,17,5,1
744,1032,426,606,172,172,80,35,627,289,338,101,73,62,43,1
745,735,426,309,93,60,71,33,698,365,333,108,83,65,21,1
746,684,311,373,109,99,66,16,206,94,112,37,36,18,9,1
747,732,355,377,108,109,79,27,529,264,265,59,68,41,17,1
748,450,241,209,67,58,54,23,509,262,247,64,70,64,20,1
749,289,135,154,37,34,34,17,624,308,316,92,72,68,22,1
750,1221,595,626,201,152,83,31,772,323,449,174,108,68,22,1
751,440,214,226,59,62,27,28,538,252,286,77,87,53,30,1
752,323,159,164,49,28,38,22,280,118,162,35,32,41,37,1
753,675,311,364,111,80,96,30,461,217,244,44,41,27,36,1
754,289,164,125,37,31,35,16,254,107,147,42,37,24,10,1
755,652,342,310,71,68,66,17,365,186,179,48,47,42,13,1
756,299,153,146,32,28,29,12,132,57,75,25,9,6,13,1
757,1168,652,516,155,113,134,68,815,418,397,97,62,70,17,1
758,498,222,276,71,60,63,27,1049,585,464,107,108,120,28,1
759,528,283,245,77,72,63,11,143,79,64,16,25,7,5,1
760,208,96,112,31,32,13,9,215,91,124,23,39,5,5,1
761,470,205,265,71,80,33,11,2871,1148,1723,496,469,204,98,1
762,258,111,147,46,63,17,6,1382,508,874,334,320,98,36,1
763,770,356,414,123,102,66,25,461,227,234,61,47,54,33,1
764,1575,744,831,228,240,141,42,399,216,183,60,53,43,18,1
765,94,45,49,11,20,10,4,470,205,265,71,80,33,11,1
766,662,306,356,90,82,73,28,381,191,190,55,61,33,11,1
767,433,221,212,59,42,47,14,350,200,150,45,47,23,8,1
768,502,240,262,78,61,54,32,278,111,167,66,66,19,8,1
769,322,164,158,46,44,29,7,928,442,486,139,118,91,43,1
770,524,264,260,75,75,40,21,882,462,420,121,79,59,34,1
771,213,86,127,37,33,5,16,222,105,117,37,44,6,18,1
772,195,109,86,25,24,17,6,404,190,214,55,55,35,27,1
773,351,184,167,59,45,54,9,197,95,102,30,26,29,9,1
774,246,108,138,32,44,21,10,1190,537,653,207,186,101,26,1
775,246,108,138,32,44,21,10,1242,613,629,174,113,114,53,1
776,2045,985,1060,359,339,199,74,204,84,120,39,39,18,10,1
777,1102,552,550,174,137,137,45,1005,540,465,133,101,106,55,1
778,160,76,84,45,13,19,7,311,187,124,39,38,35,12,1
779,473,254,219,66,67,41,16,2442,1193,1249,278,183,170,145,1
780,490,224,266,80,70,39,32,2440,1061,1379,377,326,172,62,1
781,303,141,162,42,57,37,20,1366,943,423,137,109,58,19,1
782,440,214,226,64,60,46,23,395,222,173,48,42,21,8,1
783,311,154,157,47,29,34,13,178,88,90,24,21,11,11,1
784,282,135,147,27,37,30,19,335,155,180,64,48,36,10,1
785,197,95,102,30,26,29,9,404,197,207,57,69,33,15,1
786,544,255,289,88,77,36,15,1247,548,699,168,150,140,43,1
787,519,297,222,60,58,46,17,462,228,234,59,47,37,32,1
788,166,79,87,28,33,11,8,654,344,310,80,69,57,15,1
789,396,150,246,103,64,38,3,551,298,253,63,65,45,19,1
790,93,58,35,11,9,6,4,520,305,215,64,47,32,16,1
791,1089,544,545,138,160,117,43,788,360,428,93,106,67,72,1
792,1132,553,579,172,143,150,57,374,227,147,44,22,54,20,1
793,313,178,135,43,18,35,6,360,188,172,49,48,47,17,1
794,505,247,258,72,71,60,27,1690,810,880,248,238,168,67,1
795,535,354,181,39,39,68,23,661,361,300,65,82,57,15,1
796,751,312,439,131,115,78,48,404,210,194,56,38,53,20,1
797,183,78,105,30,31,26,8,686,375,311,89,80,63,20,1
798,446,176,270,64,79,45,24,359,182,177,54,37,41,12,1
799,326,156,170,60,47,43,5,430,192,238,62,67,27,10,1
800,198,102,96,27,20,21,12,193,118,75,20,21,24,6,1
801,559,250,309,79,83,62,36,128,62,66,13,11,17,12,1
802,246,108,138,32,44,21,10,342,178,164,33,38,35,15,1
803,655,269,386,128,129,49,21,206,94,112,37,36,18,9,1
804,743,377,366,87,74,68,30,1347,625,722,182,126,156,57,1
805,456,232,224,69,65,30,19,1117,423,694,182,134,88,31,1
806,892,420,472,135,146,98,37,429,219,210,46,66,42,17,1
807,2322,1315,1007,242,257,220,38,1076,517,559,139,136,72,34,1
808,183,76,107,34,38,14,8,1050,473,577,142,119,87,54,1
809,360,192,168,55,45,48,16,671,326,345,111,77,74,11,1
810,154,75,79,28,23,16,6,875,421,454,124,142,98,43,1
811,651,306,345,85,64,61,32,920,492,428,100,92,88,49,1
812,589,281,308,69,39,63,20,187,80,107,34,36,19,8,1
813,740,313,427,101,135,40,22,536,237,299,116,87,42,17,1
814,217,109,108,34,32,35,7,295,167,128,43,23,17,11,1
815,4128,2104,2024,581,505,453,205,911,445,466,154,121,108,48,1
816,2442,933,1509,388,478,90,56,1270,557,713,130,195,57,30,1
817,1377,579,798,179,169,139,99,707,391,316,111,80,54,30,1
818,1647,794,853,279,235,128,65,851,417,434,109,116,83,28,1
819,380,184,196,58,52,46,8,1074,538,536,154,140,111,51,1
820,1071,549,522,133,127,130,59,1130,614,516,129,138,98,42,1
821,772,364,408,114,106,98,33,341,177,164,57,42,40,18,1
822,563,285,278,79,66,48,27,503,263,240,72,55,51,34,1
823,1382,599,783,208,252,90,39,474,214,260,73,58,53,17,1
824,401,166,235,70,42,51,30,2477,1186,1291,256,271,249,90,1
825,248,130,118,26,28,16,11,474,274,200,59,36,86,31,1
826,534,266,268,86,62,37,14,194,91,103,17,32,9,6,1
827,613,333,280,71,66,47,26,181,96,85,26,23,18,7,1
828,403,188,215,70,42,41,11,464,197,267,87,73,43,20,1
829,759,391,368,103,82,101,45,906,485,421,112,98,112,39,1
830,375,173,202,50,46,43,25,261,137,124,38,37,29,9,1
831,367,195,172,57,54,43,16,538,286,252,80,58,48,14,1
832,605,295,310,74,66,70,36,303,159,144,40,35,35,8,1
833,113,55,58,20,8,8,3,270,133,137,42,37,34,8,1
834,1186,493,693,184,208,88,32,462,258,204,59,41,56,15,1
835,232,127,105,36,22,23,15,454,220,234,73,46,61,19,1
836,584,297,287,89,80,65,17,468,225,243,67,69,68,19,1
837,292,143,149,36,34,30,39,154,75,79,28,23,16,6,1
838,1004,498,506,94,59,46,33,406,212,194,50,52,24,18,1
839,500,270,230,77,56,53,28,1424,650,774,152,124,95,87,1
840,825,422,403,100,90,62,43,2328,1054,1274,377,410,232,62,1
841,466,242,224,66,53,53,13,331,169,162,40,28,22,14,1
842,1805,814,991,257,268,155,59,548,250,298,85,64,56,21,1
843,138,74,64,14,15,8,2,310,156,154,27,43,20,6,1
844,505,275,230,63,57,35,12,149,68,81,15,38,11,10,1
845,490,198,292,65,81,39,27,437,228,209,47,61,26,11,1
846,116,55,61,16,7,18,14,168,67,101,37,17,13,13,1
847,561,210,351,108,77,41,22,114,71,43,8,18,7,4,1
848,287,124,163,52,48,24,16,176,73,103,22,29,13,9,1
849,647,376,271,73,64,41,23,407,217,190,50,44,54,19,1
850,2639,1436,1203,317,307,242,77,193,99,94,31,31,16,12,1
851,638,320,318,97,77,46,26,1516,764,752,179,155,126,55,1
852,1484,731,753,206,175,187,71,489,242,247,83,63,62,19,1
853,248,118,130,54,31,26,5,347,181,166,27,20,12,12,1
854,423,210,213,54,59,50,18,443,240,203,66,31,57,27,1
855,980,580,400,109,103,59,32,425,210,215,56,43,52,25,1
856,677,361,316,81,61,42,22,1893,850,1043,280,340,169,80,1
857,333,192,141,50,48,28,10,699,376,323,79,53,86,41,1
858,143,65,78,32,11,11,11,1620,884,736,194,161,162,80,1
859,740,331,409,125,97,79,35,620,348,272,91,43,59,29,1
860,353,195,158,40,55,30,13,264,109,155,63,48,15,2,1
861,681,249,432,125,168,46,13,291,141,150,62,41,36,9,1
862,1190,638,552,162,95,112,18,380,184,196,58,52,46,8,1
863,199,101,98,22,25,9,12,755,348,407,109,98,49,23,1
864,359,171,188,49,74,45,11,829,366,463,137,130,56,10,1
865,330,77,253,86,52,20,12,414,194,220,76,66,49,16,1
866,245,112,133,32,45,20,10,288,104,184,80,30,39,6,1
867,427,218,209,61,53,45,26,4128,2104,2024,581,505,453,205,1
868,117,68,49,13,17,5,3,2286,1154,1132,338,314,278,103,1
869,212,100,112,34,31,20,10,443,217,226,65,67,40,11,1
870,351,184,167,59,45,54,9,168,76,92,26,21,19,4,1
871,458,222,236,69,39,35,18,412,238,174,41,38,43,19,1
872,190,94,96,25,24,18,5,199,104,95,26,22,14,12,1
873,392,190,202,68,40,19,14,469,253,216,49,51,48,18,1
874,146,74,72,26,25,23,4,245,111,134,31,44,20,11,1
875,589,316,273,83,60,69,25,317,149,168,62,44,27,10,1
876,360,188,172,49,48,47,17,473,224,249,82,63,48,24,1
877,668,343,325,61,79,65,35,583,283,300,73,71,55,23,1
878,1367,690,677,172,175,154,83,1257,662,595,176,142,106,42,1
879,795,444,351,120,97,73,32,769,329,440,116,66,55,22,1
880,353,196,157,36,20,23,9,635,326,309,70,61,77,30,1
881,219,124,95,22,22,23,5,118,52,66,20,15,23,2,1
882,284,169,115,46,19,27,5,246,113,133,33,45,22,10,1
883,1290,629,661,191,187,167,55,1356,672,684,171,172,134,59,1
884,1139,536,603,162,139,109,50,462,247,215,87,45,49,20,1
885,1078,498,580,184,164,96,44,193,99,94,31,31,16,12,1
886,888,478,410,105,73,58,33,847,467,380,117,101,67,24,1
887,177,99,78,22,23,20,10,439,177,262,78,73,40,21,1
888,355,168,187,48,57,30,15,403,220,183,50,40,39,27,1
889,338,168,170,60,38,48,17,476,227,249,52,59,38,17,1
890,330,198,132,40,21,45,13,1279,733,546,143,121,130,49,1
891,579,293,286,68,72,31,47,1143,557,586,198,157,92,32,1
892,233,111,122,38,27,17,8,614,388,226,50,46,105,36,1
893,175,88,87,29,21,18,5,254,107,147,42,37,24,10,1
894,98,48,50,18,4,9,8,374,227,147,44,22,54,20,1
895,360,192,168,55,45,48,16,345,203,142,47,35,31,11,1
896,714,364,350,98,102,91,27,220,127,93,26,19,27,7,1
897,512,261,251,79,73,60,21,508,295,213,42,61,53,17,1
898,1292,592,700,186,169,108,22,906,455,451,116,105,87,46,1
899,673,329,344,111,95,92,41,1212,645,567,145,117,122,72,1
900,312,172,140,41,40,21,8,335,128,207,59,43,24,23,1
901,346,165,181,69,43,22,9,597,246,351,95,98,45,25,1
902,81,41,40,15,13,3,2,236,121,115,26,45,28,6,1
903,282,165,117,26,34,37,11,377,202,175,46,50,41,23,1
904,672,334,338,110,93,91,41,974,509,465,136,121,122,40,1
905,656,358,298,67,47,64,26,206,100,106,34,26,11,7,1
906,465,257,208,51,61,54,23,928,442,486,139,118,91,43,1
907,676,333,343,111,89,94,39,748,386,362,111,75,71,40,1
908,428,214,214,52,62,36,11,240,134,106,34,35,15,13,1
909,571,298,273,81,72,57,25,246,108,138,32,44,21,10,1
910,591,279,312,88,91,52,26,392,218,174,43,42,32,27,1
911,672,334,338,110,93,91,41,683,320,363,117,100,76,32,1
912,239,146,93,30,22,35,9,467,269,198,46,51,60,18,1
913,652,329,323,65,70,51,50,1670,1140,530,173,120,89,53,1
914,140,81,59,16,15,15,12,335,143,192,45,36,32,37,1
915,546,267,279,90,69,56,19,368,158,210,64,61,39,14,1
916,172,89,83,31,24,12,5,706,300,406,94,74,61,22,1
917,4829,2417,2412,551,526,409,214,277,124,153,44,40,35,18,1
918,672,334,338,110,93,91,41,1156,538,618,144,139,117,90,1
919,465,229,236,68,62,40,22,1585,741,844,220,242,103,53,1
920,1770,824,946,245,258,179,60,767,392,375,113,112,83,13,1
921,740,385,355,114,97,91,27,758,362,396,115,102,35,13,1
922,400,208,192,62,44,42,21,245,112,133,32,45,20,10,1
923,414,207,207,59,47,54,18,636,320,316,79,61,67,31,1
924,478,239,239,65,66,65,21,267,129,138,45,40,23,14,1
925,728,343,385,116,82,96,57,417,233,184,47,37,41,24,1
926,434,205,229,51,55,24,13,201,92,109,27,29,27,8,1
927,1508,738,770,194,169,119,53,427,218,209,61,53,45,26,1
928,624,308,316,92,72,68,22,557,268,289,66,67,70,17,1
929,707,295,412,105,105,66,30,465,218,247,64,51,50,42,1
930,1071,549,522,133,127,130,59,750,347,403,105,103,83,29,1
931,446,176,270,64,79,45,24,144,57,87,38,26,10,4,1
932,126,58,68,31,10,10,3,417,217,200,56,39,62,17,1
933,894,459,435,126,109,78,46,414,216,198,51,32,42,28,1
934,720,356,364,90,98,61,22,487,229,258,68,82,41,24,1
935,870,489,381,97,99,76,14,941,448,493,150,118,127,39,1
936,328,158,170,52,68,45,7,975,498,477,144,99,119,58,1
937,656,358,298,67,47,64,26,637,321,316,70,96,30,18,1
938,810,367,443,115,92,94,59,215,80,135,54,56,21,9,1
939,425,210,215,56,43,52,25,781,418,363,92,90,64,41,1
940,691,307,384,93,128,45,19,584,319,265,68,69,73,34,1
941,789,386,403,95,124,83,25,785,391,394,83,116,74,20,1
942,205,99,106,24,29,20,5,897,487,410,92,97,83,31,1
943,95,44,51,14,13,7,4,589,316,273,83,60,69,25,1
944,446,176,270,64,79,45,24,436,165,271,110,40,67,32,1
945,134,64,70,19,24,19,4,105,53,52,23,11,12,6,1
946,413,207,206,68,39,58,43,452,236,216,73,54,50,29,1
947,178,100,78,23,22,30,6,189,90,99,26,29,17,11,1
948,297,158,139,47,37,37,9,218,108,110,28,28,22,10,1
949,445,212,233,60,47,46,31,182,84,98,27,35,18,9,1
950,697,373,324,105,83,95,38,191,99,92,25,24,18,8,1
951,428,248,180,44,39,28,9,352,179,173,54,46,35,22,1
952,551,298,253,63,65,45,19,325,152,173,43,47,28,17,1
953,783,429,354,100,77,54,25,255,122,133,35,51,22,13,1
954,457,237,220,69,44,53,26,296,127,169,55,40,29,17,1
955,465,225,240,65,44,65,25,327,185,142,43,28,53,29,1
956,225,111,114,38,22,25,10,1270,682,588,165,147,136,54,1
957,301,172,129,45,34,39,15,134,64,70,19,24,19,4,1
958,1222,648,574,138,139,132,38,563,313,250,73,61,65,20,1
959,456,228,228,49,70,32,19,605,285,320,89,61,68,26,1
960,1036,511,525,136,89,94,56,392,115,277,117,75,28,17,1
961,305,95,210,88,27,15,9,504,265,239,71,57,40,38,1
962,5938,2573,3365,858,958,396,195,1331,657,674,159,137,182,58,1
963,215,91,124,23,39,5,5,331,169,162,40,28,22,14,1
964,252,146,106,38,23,21,9,468,233,235,65,61,49,34,1
965,99,50,49,18,11,8,6,360,218,142,39,26,50,18,1
966,471,246,225,46,38,52,30,1248,567,681,178,160,113,44,1
967,522,235,287,78,67,60,50,536,278,258,72,63,62,20,1
968,417,235,182,54,46,39,19,377,202,175,46,50,41,23,1
969,2492,894,1598,466,444,164,102,1117,423,694,182,134,88,31,1
970,549,277,272,94,63,60,25,211,114,97,32,24,19,10,1
971,1450,638,812,220,196,18,18,594,276,318,110,79,47,19,1
972,1020,538,482,145,115,111,58,811,400,411,107,87,116,43,1
973,554,254,300,104,58,66,28,601,313,288,42,48,25,36,1
974,598,301,297,76,53,71,36,533,297,236,74,57,39,28,1
975,473,230,243,80,56,52,35,894,420,474,136,146,93,39,1
976,246,128,118,39,34,22,7,365,186,179,48,47,42,13,1
977,585,277,308,92,73,61,32,419,184,235,66,43,50,28,1
978,367,161,206,70,48,41,19,159,84,75,13,28,10,8,1
979,876,472,404,130,93,70,45,168,120,48,7,5,20,7,1
980,368,195,173,52,41,42,15,148,67,81,20,14,18,16,1
981,928,442,486,139,118,91,43,648,307,341,101,58,76,34,1
982,687,353,334,84,96,74,31,375,202,173,46,49,41,23,1
983,1455,760,695,205,191,124,40,1891,1066,825,207,184,181,83,1
984,345,203,142,47,35,31,11,785,374,411,56,42,38,25,1
985,2524,1232,1292,398,317,186,61,706,320,386,111,76,75,51,1
986,524,244,280,64,79,30,17,926,435,491,133,132,85,17,1
987,299,164,135,30,21,29,10,530,256,274,72,57,56,28,1
988,192,90,102,27,16,26,12,623,332,291,58,66,53,15,1
989,220,127,93,26,19,27,7,2491,1175,1316,303,302,273,147,1
990,552,283,269,89,66,68,30,505,244,261,77,65,56,22,1
991,194,90,104,33,17,24,19,224,108,116,31,32,22,8,1
992,346,167,179,56,52,28,13,350,220,130,32,18,45,17,1
993,437,225,212,61,57,66,12,205,101,104,34,25,34,8,1
994,520,261,259,82,76,71,24,219,112,107,24,31,25,9,1
995,140,81,59,16,15,15,12,1948,1039,909,242,227,200,67,1
996,962,430,532,109,142,61,34,990,410,580,140,175,44,36,1
997,548,250,298,85,64,56,21,1290,629,661,191,187,167,55,1
998,350,224,126,34,14,48,18,592,283,309,84,137,60,20,1
999,305,175,130,47,28,34,10,601,313,288,42,48,25,36,1
1000,116,61,55,19,19,9,4,168,120,48,7,5,20,7,1
1001,920,492,428,100,92,88,49,497,185,312,63,92,38,28,1
1002,468,243,225,60,50,34,32,1487,996,491,147,141,50,35,1
1003,509,254,255,67,55,52,35,459,229,230,78,65,59,26,1
1004,518,270,248,63,52,57,33,969,505,464,123,133,92,33,1
1005,1076,517,559,139,136,72,34,778,367,411,90,85,64,43,1
1006,478,220,258,47,69,41,10,119,67,52,15,15,7,7,1
1007,863,458,405,97,82,63,57,217,109,108,34,32,35,7,1
1008,236,110,126,31,39,10,8,941,448,493,150,118,127,39,1
1009,710,361,349,81,98,63,26,591,263,328,95,90,26,13,1
1010,425,210,215,56,43,52,25,757,373,384,115,93,95,25,1
1011,372,189,183,60,44,41,18,918,427,491,113,111,113,33,1
1012,157,105,52,12,12,29,9,580,326,254,74,49,51,23,1
1013,502,240,262,78,61,54,32,246,125,121,33,31,34,18,1
1014,354,166,188,53,55,40,19,243,120,123,30,24,26,13,1
1015,529,264,265,59,68,41,17,255,122,133,35,51,22,13,1
1016,712,380,332,69,74,57,30,516,298,218,62,57,49,19,1
1017,501,218,283,86,94,63,15,240,99,141,53,38,29,15,1
1018,702,409,293,101,71,67,20,324,190,134,41,27,28,9,1
1019,341,170,171,41,66,27,10,360,161,199,72,36,35,13,1
1020,263,159,104,30,27,31,11,205,118,87,24,23,20,20,1
1021,423,247,176,58,55,29,20,676,333,343,111,89,94,39,1
1022,1193,532,661,160,154,90,90,986,465,521,152,132,138,51,1
1023,306,128,178,49,59,17,9,197,92,105,38,16,26,15,1
1024,391,208,183,65,49,57,17,478,239,239,65,66,65,21,1
1025,100,50,50,17,10,5,3,1069,494,575,133,111,110,39,1
1026,202,105,97,28,27,14,6,499,252,247,74,42,55,14,1
1027,1465,806,659,163,141,107,73,68,33,35,11,9,5,6,1
1028,323,159,164,49,28,38,22,246,115,131,15,29,10,32,1
1029,1462,431,1031,359,188,125,33,305,95,210,88,27,15,9,1
1030,593,342,251,73,55,82,29,246,113,133,33,45,22,10,1
1031,134,66,68,24,11,10,6,540,297,243,75,69,67,21,1
1032,558,306,252,75,55,74,23,372,196,176,51,36,51,8,1
1033,781,418,363,92,90,64,41,462,233,229,66,49,43,30,1
1034,352,212,140,37,17,61,20,91,50,41,12,5,10,7,1
1035,140,67,73,13,16,18,8,1071,549,522,133,127,130,59,1
1036,255,109,146,35,32,23,17,149,68,81,15,38,11,10,1
1037,840,385,455,118,137,66,39,413,236,177,41,25,35,19,1
1038,203,109,94,56,14,22,6,1094,543,551,171,121,129,54,1
1039,1009,506,503,146,141,97,55,492,317,175,42,31,63,23,1
1040,394,202,192,44,43,38,28,435,221,214,72,45,47,19,1
1041,270,136,134,38,31,31,4,255,134,121,36,40,29,13,1
1042,240,98,142,49,42,23,17,777,345,432,128,88,65,39,1
1043,267,161,106,22,25,35,20,1210,592,618,157,138,116,85,1
1044,368,195,173,52,41,42,15,1366,943,423,137,109,58,19,1
1045,635,333,302,99,75,83,28,659,325,334,102,85,87,32,1
1046,537,276,261,75,68,68,22,745,391,354,85,81,52,39,1
1047,409,218,191,57,33,46,30,1434,727,707,210,173,161,54,1
1048,690,332,358,94,78,65,30,651,323,328,90,65,64,24,1
1049,461,207,254,82,66,55,33,393,186,207,58,50,36,22,1
1050,367,217,150,51,30,24,12,292,152,140,46,38,35,12,1
1051,760,358,402,112,125,78,26,399,161,238,90,80,44,14,1
1052,788,360,428,93,106,67,72,453,216,237,58,60,67,20,1
1053,466,186,280,71,84,30,11,619,343,276,88,65,84,25,1
1054,510,264,246,67,66,38,29,552,285,267,74,51,69,24,1
1055,488,284,204,43,45,52,21,198,113,85,19,20,26,12,1
1056,1506,722,784,216,177,116,54,1046,459,587,184,168,58,23,1
1057,394,202,192,44,43,38,28,858,461,397,125,114,79,45,1
1058,1134,539,595,150,146,78,40,239,146,93,30,22,35,9,1
1059,703,308,395,81,91,66,80,1247,620,627,134,149,142,58,1
1060,146,80,66,17,15,13,7,458,222,236,69,39,35,18,1
1061,635,333,302,99,75,83,28,448,236,212,53,64,56,24,1
1062,536,278,258,72,63,62,20,416,201,215,54,52,39,25,1
1063,1230,623,607,154,156,94,61,913,408,505,141,125,87,36,1
1064,350,180,170,64,46,55,12,370,196,174,63,52,21,18,1
1065,445,225,220,47,62,53,26,758,362,396,115,102,35,13,1
1066,882,432,450,115,111,68,44,391,208,183,65,49,57,17,1
1067,386,181,205,55,51,57,31,984,516,468,78,45,73,12,1
1068,759,371,388,119,101,63,51,757,373,384,115,93,95,25,1
1069,309,106,203,66,49,25,10,202,102,100,29,35,6,9,1
1070,897,487,410,92,97,83,31,526,264,262,77,71,61,27,1
1071,233,94,139,36,37,15,8,152,87,65,20,19,14,5,1
1072,467,251,216,56,49,79,11,99,48,51,15,7,7,7,1
1073,240,125,115,34,32,30,8,315,169,146,51,49,27,9,1
1074,272,173,99,32,32,11,8,460,263,197,55,53,32,19,1
1075,399,184,215,55,81,29,10,1312,484,828,258,239,86,51,1
1076,529,283,246,66,69,66,25,481,256,225,60,56,48,12,1
1077,676,295,381,94,71,65,24,635,333,302,99,75,83,28,1
1078,1123,554,569,142,130,85,36,1721,838,883,241,218,144,54,1
1079,326,160,166,38,38,33,13,147,78,69,19,15,19,7,1
1080,302,111,191,44,61,23,13,639,322,317,73,82,39,23,1
1081,595,316,279,86,60,65,40,347,212,135,35,32,17,6,1
1082,815,418,397,97,62,70,17,434,237,197,38,34,56,12,1
1083,986,418,568,159,99,110,42,496,272,224,70,58,42,18,1
1084,782,347,435,110,92,74,34,605,295,310,74,66,70,36,1
1085,1246,539,707,245,146,109,52,324,190,134,41,27,28,9,1
1086,656,358,298,67,47,64,26,89,44,45,15,12,15,6,1
1087,361,155,206,43,61,29,18,806,419,387,115,130,57,32,1
1088,1147,483,664,200,195,95,53,606,316,290,82,68,82,20,1
1089,275,140,135,38,32,18,5,393,186,207,58,50,36,22,1
1090,898,467,431,101,127,90,53,144,67,77,28,14,9,8,1
1091,204,93,111,35,35,16,11,1235,584,651,140,226,82,52,1
1092,723,380,343,80,84,47,18,1675,875,800,213,219,196,72,1
1093,519,246,273,78,82,42,16,364,241,123,33,16,38,19,1
1094,671,332,339,103,75,75,31,351,170,181,54,53,37,12,1
1095,551,286,265,93,55,49,15,586,270,316,83,80,59,21,1
1096,233,118,115,26,21,34,8,223,127,96,25,23,33,4,1
1097,574,356,218,61,44,87,39,1150,585,565,162,148,102,36,1
1098,901,458,443,91,129,86,21,1452,733,719,182,161,179,64,1
1099,267,127,140,43,43,25,15,441,175,266,73,88,26,8,1
1100,373,189,184,54,46,50,23,249,111,138,40,30,22,17,1
1101,797,394,403,109,89,83,40,671,321,350,95,87,75,34,1
1102,824,386,438,94,77,81,34,462,228,234,59,47,37,32,1
1103,781,367,414,60,67,43,17,437,228,209,47,61,26,11,1
1104,109,53,56,17,8,13,7,352,212,140,37,17,61,20,1
1105,422,213,209,63,60,35,13,254,107,147,42,37,24,10,1
1106,1430,718,712,205,172,151,64,945,492,453,104,101,94,47,1
1107,981,465,516,126,164,112,38,622,294,328,104,93,42,17,1
1108,524,264,260,75,75,40,21,211,114,97,32,24,19,10,1
1109,219,104,115,43,32,24,11,769,329,440,116,66,55,22,1
1110,581,274,307,75,69,28,24,158,74,84,26,23,18,18,1
1111,603,291,312,98,87,61,28,288,112,176,55,55,18,15,1
1112,311,199,112,30,21,51,21,427,218,209,61,53,45,26,1
1113,146,83,63,19,12,13,8,1744,920,824,223,192,177,58,1
1114,1115,552,563,104,116,115,35,605,295,310,74,66,70,36,1
1115,910,431,479,138,103,98,41,452,256,196,32,44,27,11,1
1116,258,113,145,43,44,16,7,261,108,153,35,37,16,6,1
1117,260,92,168,37,43,18,13,253,123,130,40,46,15,4,1
1118,206,85,121,31,42,6,17,777,387,390,90,87,65,37,1
1119,293,142,151,49,40,42,17,586,240,346,94,110,29,19,1
1120,547,292,255,51,55,46,28,673,317,356,101,85,76,49,1
1121,76,31,45,8,14,3,1,562,283,279,48,32,63,13,1
1122,414,216,198,51,32,42,28,442,230,212,50,58,56,23,1
1123,186,98,88,26,24,27,8,1139,536,603,162,139,109,50,1
1124,651,306,345,85,64,61,32,1074,538,536,154,140,111,51,1
1125,1037,534,503,127,148,121,48,144,67,77,28,14,9,8,1
1126,505,253,252,70,63,70,18,928,442,486,139,118,91,43,1
1127,498,174,324,112,108,33,19,483,215,268,66,70,30,16,1
1128,1336,633,703,182,197,110,52,847,467,380,117,101,67,24,1
1129,202,113,89,16,27,21,11,136,66,70,33,11,9,5,1
1130,505,247,258,72,71,60,27,127,58,69,18,17,10,5,1
1131,439,227,212,60,55,58,8,1047,562,485,141,127,114,41,1
1132,314,108,206,45,75,34,8,709,359,350,107,102,65,20,1
1133,755,348,407,109,98,49,23,202,102,100,29,35,6,9,1
1134,454,191,263,61,66,38,15,160,53,107,31,29,13,3,1
1135,303,175,128,43,36,34,12,164,78,86,28,23,12,8,1
1136,368,185,183,61,41,56,8,261,130,131,27,41,19,16,1
1137,402,222,180,50,39,51,19,4544,2024,2520,579,628,480,403,1
1138,642,271,371,106,111,57,23,172,74,98,32,30,11,7,1
1139,710,357,353,99,79,72,39,1065,533,532,147,148,176,40,1
1140,246,108,138,32,44,21,10,646,304,342,104,93,58,26,1
1141,838,380,458,114,95,68,57,153,81,72,22,18,16,8,1
1142,907,475,432,124,92,65,14,640,315,325,77,55,67,33,1
1143,1394,717,677,194,190,135,53,169,87,82,28,23,20,6,1
1144,977,406,571,151,128,84,47,926,435,491,133,132,85,17,1
1145,671,318,353,83,124,46,34,2472,1057,1415,331,352,159,96,1
1146,473,270,203,63,34,44,18,1192,579,613,120,215,79,24,1
1147,202,86,116,33,29,26,10,354,166,188,53,55,40,19,1
1148,1504,777,727,179,209,162,49,1257,662,595,176,142,106,42,1
1149,459,262,197,46,68,38,11,901,458,443,91,129,86,21,1
1150,643,282,361,94,109,59,24,834,465,369,82,84,81,21,1
1151,796,445,351,96,80,90,38,440,218,222,58,66,40,24,1
1152,326,166,160,49,45,36,12,164,78,86,28,23,12,8,1
1153,167,72,95,31,45,14,5,769,329,440,116,66,55,22,1
1154,663,307,356,100,97,47,22,540,271,269,80,77,51,16,1
1155,1098,519,579,182,159,79,42,248,118,130,54,31,26,5,1
1156,235,94,141,45,37,31,7,359,173,186,55,57,44,16,1
1157,651,311,340,94,75,59,22,393,186,207,58,50,36,22,1
1158,656,358,298,67,47,64,26,729,412,317,85,76,92,36,1
1159,1748,791,957,281,247,173,25,962,500,462,146,134,62,27,1
1160,1412,603,809,184,195,112,45,5497,2328,3169,872,896,436,168,1
1161,205,91,114,31,32,23,12,642,271,371,106,111,57,23,1
1162,326,153,173,63,48,25,8,557,349,208,52,43,79,29,1
1163,2442,1193,1249,278,183,170,145,516,298,218,62,57,49,19,1
1164,433,221,212,59,42,47,14,2471,1130,1341,240,281,219,290,1
1165,172,74,98,32,30,11,7,1881,929,952,259,247,158,57,1
1166,206,85,121,31,42,6,17,116,67,49,13,12,6,5,1
1167,2414,1189,1225,277,178,170,169,327,153,174,41,38,33,13,1
1168,2414,1189,1225,277,178,170,169,441,218,223,69,55,50,27,1
1169,525,281,244,69,68,65,25,921,544,377,99,116,105,32,1
1170,628,315,313,88,95,54,28,499,250,249,78,81,46,25,1
1171,437,225,212,61,57,66,12,72,35,37,10,9,7,6,1
1172,659,325,334,102,85,87,32,421,219,202,68,57,56,13,1
1173,593,266,327,102,84,69,24,1271,599,672,194,175,118,47,1
1174,460,274,186,50,34,69,27,1037,575,462,122,150,82,32,1
1175,1270,557,713,130,195,57,30,977,407,570,162,172,37,21,1
1176,148,64,84,33,19,6,1,505,226,279,68,51,30,15,1
1177,400,187,213,57,46,51,16,144,70,74,15,17,13,10,1
1178,284,109,175,55,79,9,9,864,362,502,142,150,70,19,1
1179,205,100,105,25,25,20,9,116,52,64,24,18,10,5,1
1180,436,236,200,49,55,44,12,377,202,175,46,50,41,22,1
1181,1187,631,556,182,139,152,56,537,276,261,75,68,68,22,1
1182,654,344,310,80,69,57,15,781,418,363,92,90,64,41,1
1183,582,293,289,94,80,77,32,467,221,246,98,68,43,11,1
1184,217,115,102,40,24,26,6,294,122,172,46,65,18,11,1
1185,320,143,177,51,51,24,10,1382,508,874,334,320,98,36,1
1186,380,225,155,52,37,72,11,311,145,166,43,37,45,14,1
1187,404,190,214,55,55,35,27,241,115,126,35,30,17,14,1
1188,1047,562,485,141,127,114,41,450,241,209,67,58,54,23,1
1189,213,109,104,26,26,21,6,503,263,240,72,55,51,34,1
1190,298,160,138,37,30,22,12,346,186,160,48,32,35,14,1
1191,84,43,41,5,11,6,11,589,294,295,37,44,27,33,1
1192,409,268,141,32,26,57,25,272,149,123,46,14,27,16,1
1193,710,361,349,81,98,63,26,4655,2074,2581,545,652,562,399,1
1194,461,208,253,79,76,61,21,1367,690,677,172,175,154,83,1
1195,1164,531,633,179,157,107,46,246,108,138,32,44,21,10,1
1196,606,307,299,92,56,68,30,531,286,245,81,67,42,29,1
1197,920,492,428,100,92,88,49,277,124,153,44,40,35,18,1
1198,201,42,159,19,3,2,75,257,112,145,44,29,23,12,1
1199,350,224,126,34,14,48,18,355,165,190,53,56,42,19,1
1200,670,316,354,84,69,47,24,508,267,241,43,35,25,17,1
1201,1858,927,931,252,216,179,80,323,169,154,47,44,39,20,1
1202,2063,1024,1039,175,117,80,97,461,223,238,66,57,36,23,1
1203,450,215,235,73,72,53,18,593,295,298,70,85,48,13,1
1204,1123,554,569,142,130,85,36,2524,1232,1292,398,317,186,61,1
1205,240,125,115,34,32,30,8,104,48,56,15,15,13,7,1
1206,318,150,168,60,42,32,12,277,124,153,44,40,35,18,1
1207,344,168,176,65,44,33,15,451,222,229,58,55,51,17,1
1208,976,520,456,120,115,109,53,217,109,108,34,32,35,7,1
1209,310,142,168,42,39,24,9,218,133,85,20,19,13,6,1
1210,533,254,279,81,78,52,10,1265,580,685,205,188,166,53,1
1211,740,385,355,114,97,91,27,430,192,238,62,67,27,10,1
1212,494,221,273,64,67,27,23,288,118,170,50,57,18,15,1
1213,631,309,322,106,83,89,33,622,309,313,75,81,76,29,1
1214,294,148,146,35,33,25,14,119,59,60,29,10,6,4,1
1215,1636,915,721,210,173,145,54,859,395,464,157,119,59,31,1
1216,4599,2000,2599,590,655,515,413,357,153,204,84,62,39,2,1
1217,368,175,193,72,43,39,15,292,152,140,46,38,35,12,1
1218,3801,1837,1964,510,442,418,170,215,115,100,27,28,34,16,1
1219,2477,1186,1291,256,271,249,90,2944,1827,1117,338,332,122,35,1
1220,201,108,93,36,21,17,4,981,448,533,142,130,104,32,1
1221,432,181,251,48,75,27,17,624,308,316,92,72,68,22,1
1222,187,92,95,13,51,14,11,2414,1189,1225,277,178,170,169,1
1223,630,326,304,82,62,80,31,190,94,96,24,33,24,6,1
1224,484,272,212,67,43,63,14,815,418,397,97,62,70,17,1
1225,656,358,298,67,47,64,26,367,203,164,42,29,34,12,1
1226,686,375,311,89,80,63,20,333,127,206,66,68,25,14,1
1227,724,334,390,112,109,79,17,1255,666,589,145,142,120,82,1
1228,1047,475,572,176,183,110,39,808,366,442,130,133,66,31,1
1229,1411,472,939,252,262,58,31,215,105,110,26,22,19,9,1
1230,325,149,176,51,49,24,11,780,337,443,112,116,77,28,1
1231,723,335,388,90,84,77,74,2321,1177,1144,236,255,174,254,1
1232,377,171,206,59,58,41,22,522,245,277,78,69,52,21,1
1233,171,88,83,20,21,16,7,592,283,309,84,137,60,20,1
1234,555,348,207,57,42,75,32,256,153,103,19,23,23,8,1
1235,1039,597,442,101,110,106,33,217,109,108,34,32,35,7,1
1236,782,347,435,110,92,74,34,365,170,195,49,30,41,10,1
1237,583,322,261,73,66,45,26,1620,884,736,194,161,162,80,1
1238,1158,481,677,169,129,86,40,1123,554,569,142,130,85,36,1
1239,358,170,188,54,55,20,10,781,418,363,92,90,64,41,1
1240,2414,1189,1225,277,178,170,169,441,216,225,57,66,57,19,1
1241,1539,685,854,166,229,123,67,1411,472,939,252,262,58,31,1
1242,582,293,289,94,80,77,32,482,231,251,76,81,64,26,1
1243,524,264,260,75,75,40,21,191,99,92,25,24,18,8,1
1244,504,237,267,62,66,48,17,475,243,232,67,54,39,15,1
1245,998,496,502,149,146,89,27,245,111,134,36,27,18,6,1
1246,2351,1110,1241,337,269,300,87,461,221,240,70,64,56,32,1
1247,171,91,80,27,13,23,4,371,237,134,31,25,43,17,1
1248,240,125,115,34,32,30,8,908,489,419,114,131,79,46,1
1249,290,138,152,37,50,24,14,666,344,322,91,73,91,20,1
1250,202,102,100,29,35,6,9,306,144,162,52,35,40,16,1
1251,330,208,122,33,18,45,13,354,168,186,50,53,39,20,1
1252,293,142,151,49,40,42,17,467,269,198,46,51,60,18,1
1253,988,492,496,135,112,110,43,989,508,481,139,117,114,41,1
1254,350,180,170,64,46,55,12,502,299,203,57,52,32,11,1
1255,987,515,472,107,110,106,61,1047,562,485,141,127,114,41,1
1256,509,254,255,67,55,52,35,266,133,133,43,28,30,8,1
1257,963,532,431,99,110,105,44,146,74,72,26,25,23,4,1
1258,233,94,139,36,37,15,8,501,240,261,80,62,49,42,1
1259,317,153,164,39,30,35,13,1154,540,614,195,160,138,66,1
1260,913,426,487,136,109,112,43,619,332,287,95,77,74,38,1
1261,1322,633,689,167,189,106,52,1315,720,595,138,136,115,62,1
1262,721,331,390,100,122,92,28,673,329,344,111,95,92,41,1
1263,1395,627,768,172,263,141,59,359,219,140,42,19,56,19,1
1264,680,312,368,98,56,38,27,317,149,168,62,44,27,10,1
1265,671,303,368,93,68,61,26,609,292,317,102,96,64,21,1
1266,666,349,317,87,91,58,20,418,199,219,55,44,22,15,1
1267,1970,978,992,245,206,198,80,163,70,93,28,21,17,6,1
1268,1970,978,992,245,206,198,80,910,462,448,143,126,90,25,1
1269,522,278,244,78,55,49,22,211,114,97,32,24,19,10,1
1270,241,132,109,33,26,27,13,205,118,87,24,23,20,20,1
1271,4128,2104,2024,581,505,453,205,191,85,106,24,34,19,5,1
1272,720,356,364,90,98,61,22,344,168,176,65,44,33,15,1
1273,345,203,142,47,35,31,11,215,80,135,54,56,21,9,1
1274,486,229,257,75,104,49,10,399,216,183,60,53,43,18,1
1275,875,376,499,155,125,53,39,574,269,305,91,63,54,27,1
1276,1140,586,554,130,146,117,49,165,80,85,21,9,18,19,1
1277,1129,500,629,171,148,85,30,1009,506,503,146,141,97,55,1
1278,443,248,195,67,54,40,15,1290,629,661,191,187,167,55,1
1279,1212,645,567,145,117,122,72,361,172,189,51,54,25,4,1
1280,146,75,71,13,32,15,11,1158,481,677,169,129,86,40,1
1281,543,296,247,86,79,60,19,652,332,320,72,59,57,24,1
1282,552,285,267,74,51,69,24,331,169,162,40,28,22,14,1
1283,487,256,231,68,54,59,21,508,267,241,43,35,25,17,1
1284,556,279,277,83,69,71,19,737,363,374,119,101,85,41,1
1285,391,208,183,65,49,57,17,171,94,77,24,28,30,11,1
1286,4391,2256,2135,494,411,423,231,717,469,248,92,67,22,21,1
1287,263,99,164,74,39,22,8,292,162,130,43,27,21,12,1
1288,512,261,251,79,73,60,21,676,333,343,111,89,94,39,1
1289,94,51,43,18,6,4,9,355,220,135,43,26,65,20,1
1290,115,67,48,10,7,12,7,296,147,149,45,29,30,23,1
1291,255,113,142,31,40,18,9,211,83,128,28,35,5,11,1
1292,932,416,516,139,125,92,39,756,362,394,102,104,73,25,1
1293,591,319,272,96,62,43,19,799,377,422,98,95,80,70,1
1294,454,223,231,38,45,24,19,435,225,210,58,46,50,14,1
1295,362,174,188,46,55,35,23,277,122,155,33,33,25,24,1
1296,656,358,298,67,47,64,26,922,418,504,120,120,106,31,1
1297,164,78,86,28,23,12,8,289,139,150,38,44,23,20,1
1298,456,228,228,49,70,32,19,306,155,151,43,34,36,17,1
1299,513,246,267,71,66,60,35,669,351,318,122,84,49,9,1
1300,781,418,363,92,90,64,41,448,275,173,32,53,55,27,1
1301,246,124,122,33,31,25,14,255,134,121,36,40,29,13,1
1302,454,191,263,61,66,38,15,1068,527,541,160,131,112,52,1
1303,298,167,131,47,33,40,8,323,156,167,52,45,39,18,1
1304,693,297,396,87,52,64,27,712,396,316,78,69,65,25,1
1305,794,390,404,103,95,86,23,164,88,76,27,20,17,6,1
1306,431,228,203,66,46,59,15,542,328,214,56,49,45,29,1
1307,1273,592,681,199,164,139,39,440,246,194,62,49,41,16,1
1308,750,347,403,105,103,83,29,536,278,258,72,63,62,20,1
1309,580,302,278,71,66,65,41,288,158,130,59,23,21,10,1
1310,962,502,460,112,122,109,50,1268,612,656,218,195,89,33,1
1311,419,235,184,50,49,53,20,149,52,97,36,36,7,4,1
1312,209,78,131,33,42,11,7,230,115,115,30,33,29,8,1
1313,345,203,142,47,35,31,11,1210,592,618,157,138,116,85,1
1314,830,402,428,80,67,100,80,530,315,215,83,43,78,11,1
1315,787,386,401,98,95,86,25,356,208,148,42,26,57,15,1
1316,245,110,135,42,32,29,9,118,56,62,13,14,6,6,1
1317,345,174,171,46,34,45,28,2040,956,1084,202,190,258,147,1
1318,805,296,509,164,147,44,35,250,105,145,39,27,22,40,1
1319,639,287,352,111,108,44,9,870,489,381,97,99,76,14,1
1320,467,226,241,55,48,54,23,440,218,222,58,66,40,24,1
1321,328,156,172,44,37,44,15,1085,529,556,149,133,126,54,1
1322,1980,963,1017,262,243,179,78,808,366,442,130,133,66,31,1
1323,436,209,227,66,47,52,22,577,251,326,92,84,60,11,1
1324,357,153,204,84,62,39,2,598,300,298,68,77,59,21,1
1325,672,334,338,110,93,91,41,308,159,149,52,41,22,10,1
1326,556,259,297,75,69,63,38,139,62,77,23,6,14,4,1
1327,418,199,219,55,44,22,15,1149,568,581,177,133,101,30,1
1328,261,130,131,27,41,19,16,919,444,475,141,148,62,20,1
1329,672,334,338,110,93,91,41,725,408,317,93,75,90,45,1
1330,235,131,104,32,29,11,11,674,334,340,107,71,74,35,1
1331,664,350,314,96,93,83,24,149,68,81,15,38,11,10,1
1332,199,101,98,22,25,9,12,543,293,250,77,67,40,25,1
1333,247,136,111,20,26,25,10,418,213,205,54,56,49,13,1
1334,368,185,183,61,41,56,8,757,359,398,109,127,80,26,1
1335,740,313,427,101,135,40,22,428,226,202,52,60,75,20,1
1336,501,240,261,80,62,49,42,268,124,144,36,34,12,4,1
1337,656,358,298,67,47,64,26,288,159,129,27,44,27,15,1
1338,699,295,404,132,126,46,28,793,362,431,137,116,58,28,1
1339,547,290,257,94,65,64,28,757,373,384,115,93,95,25,1
1340,388,199,189,50,51,33,14,150,76,74,24,7,23,13,1
1341,168,67,101,37,17,13,13,278,110,168,58,49,29,5,1
1342,676,333,343,111,89,94,39,318,176,142,25,32,35,25,1
1343,913,460,453,117,94,103,34,1675,875,800,213,219,196,72,1
1344,1082,532,550,144,151,79,38,193,102,91,23,25,20,10,1
1345,218,133,85,20,19,13,6,1199,589,610,189,128,167,65,1
1346,933,493,440,140,108,124,32,193,110,83,18,20,15,12,1
1347,1074,538,536,154,140,111,51,1338,633,705,199,151,144,65,1
1348,926,435,491,133,132,85,17,817,425,392,120,102,83,26,1
1349,1037,470,567,145,136,102,47,540,257,283,81,63,57,24,1
1350,293,142,151,49,40,42,17,448,275,173,32,53,55,27,1
1351,385,212,173,57,40,39,21,393,210,183,58,37,34,20,1
1352,355,220,135,43,26,65,20,91,50,41,12,5,10,7,1
1353,347,183,164,55,45,51,16,423,212,211,51,44,48,28,1
1354,657,293,364,109,75,66,28,154,72,82,25,24,5,5,1
1355,1069,494,575,133,111,110,39,431,233,198,54,40,42,12,1
1356,538,268,270,58,72,42,25,604,255,349,100,72,55,26,1
1357,202,103,99,28,20,12,8,1580,742,838,208,146,144,71,1
1358,858,431,427,94,57,54,30,145,70,75,24,16,16,20,1
1359,408,179,229,86,72,32,5,740,313,427,101,135,40,22,1
1360,457,237,220,69,44,53,26,318,165,153,53,37,36,13,1
1361,262,144,118,19,39,22,8,458,222,236,69,39,35,18,1
1362,552,285,267,74,51,69,24,229,105,124,36,33,12,4,1
1363,299,164,135,30,21,29,10,2414,1189,1225,277,178,170,169,1
1364,568,243,325,98,73,56,44,712,380,332,69,74,57,30,1
1365,247,110,137,34,45,23,10,766,386,380,101,81,78,31,1
1366,2472,1055,1417,416,458,235,64,421,192,229,72,54,51,48,1
1367,546,267,279,90,69,56,19,316,156,160,43,42,28,17,1
1368,1378,680,698,160,154,111,38,1529,698,831,198,167,141,122,1
1369,753,423,330,102,65,83,24,429,220,209,64,43,47,21,1
1370,636,336,300,94,65,58,32,611,229,382,121,126,46,5,1
1371,456,228,228,49,70,32,19,694,260,434,122,92,62,36,1
1372,672,334,338,110,93,91,41,187,96,91,30,24,24,4,1
1373,1038,470,568,130,123,86,51,673,329,344,111,95,92,41,1
1374,671,321,350,95,87,75,34,335,128,207,59,43,24,23,1
1375,413,236,177,41,25,35,19,379,203,176,55,48,45,16,1
1376,777,345,432,128,88,65,39,609,292,317,102,96,64,21,1
1377,465,218,247,64,51,50,42,1198,571,627,177,168,97,54,1
1378,1242,613,629,174,113,114,53,745,366,379,110,93,79,45,1
1379,649,326,323,83,66,87,38,288,118,170,50,57,18,15,1
1380,1190,638,552,162,95,112,18,1193,492,701,152,190,66,53,1
1381,1356,672,684,171,172,134,59,897,487,410,92,97,83,31,1
1382,428,226,202,52,60,75,20,307,162,145,38,46,41,15,1
1383,138,74,64,14,15,8,2,478,239,239,65,66,65,21,1
1384,390,191,199,57,49,45,25,255,136,119,39,20,32,10,1
1385,1338,633,705,199,151,144,65,781,418,363,92,90,64,41,1
1386,255,122,133,35,51,22,13,458,245,213,52,43,27,24,1
1387,509,243,266,80,57,45,19,217,109,108,34,32,35,7,1
1388,736,388,348,88,85,67,28,537,315,222,55,46,69,39,1
1389,101,41,60,18,19,10,5,362,174,188,46,55,35,23,1
1390,826,362,464,107,118,71,43,785,374,411,56,42,38,25,1
1391,574,269,305,91,63,54,27,252,121,131,42,34,12,16,1
1392,360,192,168,55,45,48,16,468,233,235,65,61,49,34,1
1393,446,176,270,64,79,45,24,168,120,48,7,5,20,7,1
1394,353,147,206,47,61,30,25,33423,16370,17053,4965,4756,2786,883,1
1395,669,363,306,93,72,74,36,346,183,163,51,38,23,6,1
1396,470,241,229,54,58,59,23,112,54,58,12,9,7,13,1
1397,350,224,126,34,14,48,18,260,138,122,44,30,28,6,1
1398,294,148,146,35,33,25,14,392,205,187,43,33,52,18,1
1399,1474,808,666,160,146,166,60,767,392,375,113,112,83,13,1
1400,211,88,123,38,28,26,10,672,334,338,110,93,91,41,1
1401,239,144,95,20,26,23,13,277,151,126,35,30,24,15,1
1402,400,228,172,43,20,47,24,225,113,112,29,45,19,7,1
1403,454,224,230,71,39,62,22,665,341,324,109,79,38,22,1
1404,400,203,197,30,36,31,10,1117,423,694,182,134,88,31,1
1405,1053,515,538,142,132,84,40,1016,557,459,107,124,57,30,1
1406,488,217,271,71,71,50,32,304,135,169,48,36,38,26,1
1407,1424,650,774,152,124,95,87,423,247,176,58,55,29,20,1
1408,229,105,124,36,33,12,4,796,445,351,96,80,90,38,1
1409,494,123,371,160,58,29,5,526,268,258,54,37,55,12,1
1410,419,212,207,68,55,42,19,406,216,190,59,56,45,15,1
1411,589,281,308,69,39,63,20,441,216,225,57,66,57,19,1
1412,288,169,119,31,27,30,13,267,124,143,45,46,26,4,1
1413,521,290,231,76,56,76,18,467,224,243,70,43,67,23,1
1414,185,115,70,19,17,26,6,216,113,103,26,21,19,9,1
1415,938,484,454,137,100,104,41,1748,791,957,281,247,173,25,1
1416,769,352,417,109,83,88,67,390,203,187,58,40,43,19,1
1417,706,346,360,118,92,98,56,690,333,357,107,89,89,36,1
1418,588,255,333,94,82,58,27,672,334,338,110,93,91,41,1
1419,351,184,167,59,45,54,9,473,245,228,67,52,70,24,1
1420,591,263,328,95,90,26,13,1577,747,830,213,232,147,57,1
1421,186,92,94,28,23,17,11,445,225,220,47,62,53,26,1
1422,2524,1232,1292,398,317,186,61,551,298,253,63,65,45,19,1
1423,510,264,246,67,66,38,29,425,210,215,56,43,52,25,1
1424,351,184,167,59,45,54,9,403,188,215,70,42,41,11,1
1425,633,303,330,95,91,51,13,1863,721,1142,262,283,139,74,1
1426,1321,653,668,186,195,70,35,445,225,220,47,62,53,26,1
1427,1480,789,691,195,151,173,55,404,197,207,57,69,33,15,1
1428,456,243,213,64,44,59,18,521,265,256,69,69,61,26,1
1429,269,134,135,42,35,27,13,386,189,197,54,57,39,16,1
1430,386,181,205,55,51,57,31,680,312,368,98,56,38,27,1
1431,816,463,353,99,99,61,26,431,228,203,66,46,59,15,1
1432,255,122,133,35,51,22,13,1338,756,582,155,105,104,44,1
1433,1692,713,979,325,210,122,58,422,211,211,73,61,43,17,1
1434,467,226,241,55,48,54,23,684,288,396,107,90,54,42,1
1435,609,318,291,80,72,55,36,392,115,277,117,75,28,17,1
1436,1881,929,952,259,247,158,57,911,551,360,92,106,107,29,1
1437,920,492,428,100,92,88,49,609,292,317,102,96,64,21,1
1438,247,135,112,38,18,29,13,273,131,142,35,35,25,12,1
1439,191,99,92,25,24,18,8,372,179,193,50,52,33,6,1
1440,211,114,97,32,24,19,10,1153,588,565,174,128,149,56,1
1441,377,184,193,50,43,33,17,468,212,256,70,45,30,18,1
1442,525,285,240,75,66,36,15,543,265,278,52,37,54,19,1
1443,536,237,299,116,87,42,17,257,148,109,28,20,21,14,1
1444,855,420,435,139,134,109,35,273,126,147,54,49,25,18,1
1445,433,221,212,59,42,47,14,341,154,187,34,36,11,11,1
1446,619,292,327,73,73,61,32,467,240,227,65,65,51,23,1
1447,301,201,100,31,14,34,12,719,364,355,104,100,58,34,1
1448,1290,629,661,191,187,167,55,193,99,94,31,31,16,12,1
1449,4544,2024,2520,579,628,480,403,770,355,415,103,142,75,42,1
1450,861,393,468,150,101,69,35,719,364,355,104,100,58,34,1
1451,556,279,277,83,69,71,19,520,261,259,82,76,71,24,1
1452,1400,800,600,158,134,150,65,724,334,390,112,109,79,17,1
1453,764,409,355,88,73,102,43,354,169,185,54,54,41,19,1
1454,616,304,312,75,71,55,25,1087,485,602,151,151,112,48,1
1455,351,166,185,48,61,24,15,772,363,409,76,120,57,20,1
1456,1332,626,706,182,144,80,41,443,208,235,43,55,51,50,1
1457,1066,587,479,127,108,118,48,123,62,61,17,18,13,8,1
1458,76,31,45,13,14,9,7,641,324,317,88,92,49,14,1
1459,624,308,316,92,72,68,22,1132,553,579,172,143,150,57,1
1460,350,180,170,64,46,55,12,514,332,182,37,36,56,36,1
1461,215,110,105,27,26,24,8,748,355,393,121,91,95,26,1
1462,1379,599,780,214,189,91,33,526,169,357,109,86,69,30,1
1463,154,73,81,24,27,18,9,360,192,168,55,45,48,16,1
1464,242,114,128,44,47,21,3,476,251,225,57,67,57,18,1
1465,394,202,192,44,43,38,28,963,385,578,171,162,62,35,1
1466,346,180,166,55,49,38,6,271,159,112,34,34,33,7,1
1467,601,272,329,100,100,51,22,384,193,191,58,56,42,19,1
1468,436,201,235,54,37,34,20,313,178,135,43,18,35,6,1
1469,219,116,103,36,31,27,9,709,373,336,73,72,78,24,1
1470,451,239,212,53,64,56,22,441,234,207,62,47,64,20,1
1471,325,153,172,62,37,50,39,757,373,384,115,93,95,25,1
1472,740,313,427,101,135,40,22,882,432,450,115,111,68,44,1
1473,425,199,226,54,71,56,11,412,193,219,70,56,51,26,1
1474,142,69,73,20,27,9,6,217,121,96,27,34,18,10,1
1475,684,288,396,107,90,54,42,671,306,365,114,76,49,19,1
1476,2364,1004,1360,406,426,226,79,792,399,393,96,103,85,37,1
1477,308,146,162,42,39,24,12,770,355,415,103,142,75,42,1
1478,697,373,324,105,83,95,38,1242,613,629,174,113,114,53,1
1479,459,212,247,63,48,48,28,267,149,118,45,33,31,14,1
1480,770,356,414,123,102,66,25,589,296,293,99,76,64,29,1
1481,1464,693,771,153,136,91,86,289,143,146,38,18,40,8,1
1482,392,156,236,40,91,28,16,980,381,599,165,159,57,34,1
1483,2442,1193,1249,278,183,170,145,498,249,249,71,50,53,17,1
1484,883,470,413,112,99,108,34,415,209,206,60,67,39,18,1
1485,568,192,376,140,71,85,46,165,80,85,21,9,18,19,1
1486,246,108,138,32,44,21,10,305,95,210,88,27,15,9,1
1487,456,232,224,69,65,30,19,810,367,443,115,92,94,59,1
1488,355,168,187,48,57,30,15,505,268,237,68,59,34,15,1
1489,512,261,251,79,73,60,21,486,229,257,75,104,49,10,1
1490,404,190,214,50,54,35,13,399,181,218,48,56,37,13,1
1491,933,536,397,96,90,71,41,1292,592,700,186,169,108,22,1
1492,464,236,228,64,56,53,28,198,102,96,27,20,21,12,1
1493,1292,592,700,186,169,108,22,1382,689,693,186,176,167,77,1
1494,699,376,323,79,53,86,41,1037,575,462,122,150,82,32,1
1495,380,184,196,58,52,46,8,333,167,166,45,30,34,14,1
1496,146,71,75,20,17,8,7,464,225,239,85,57,65,19,1
1497,705,396,309,87,48,53,17,1047,562,485,141,127,114,41,1
1498,562,265,297,79,56,72,45,483,215,268,66,70,30,16,1
1499,1149,568,581,177,133,101,30,556,300,256,58,73,55,22,1
1500,876,457,419,88,124,67,47,177,68,109,44,21,17,2,1
1501,146,73,73,17,27,17,9,510,256,254,76,65,64,15,1
1502,502,240,262,78,61,54,32,208,100,108,27,29,18,9,1
1503,496,251,245,78,62,61,23,700,348,352,93,115,85,27,1
1504,166,81,85,30,27,13,8,377,202,175,46,50,41,22,1
1505,213,127,86,26,20,33,9,983,487,496,126,115,104,52,1
1506,1132,553,579,172,143,150,57,309,154,155,42,44,45,16,1
1507,533,297,236,74,57,39,28,1158,481,677,169,129,86,40,1
1508,288,159,129,27,44,27,15,443,208,235,43,55,51,50,1
1509,480,234,246,79,77,65,23,766,386,380,101,81,78,31,1
1510,130,55,75,21,26,10,3,421,209,212,53,68,40,22,1
1511,185,83,102,30,19,21,8,499,252,247,74,42,55,14,1
1512,585,299,286,92,73,89,23,913,412,501,131,100,117,83,1
1513,673,317,356,101,85,76,49,882,432,450,115,111,68,44,1
1514,529,274,255,57,62,38,14,524,336,188,45,36,73,23,1
1515,295,161,134,30,40,31,9,1091,543,548,146,136,110,34,1
1516,822,424,398,107,106,86,46,216,94,122,43,17,23,9,1
1517,1647,794,853,279,235,128,65,2285,1219,1066,207,180,178,106,1
1518,538,292,246,69,57,52,39,906,437,469,135,132,49,40,1
1519,522,265,257,35,39,38,8,111,29,82,10,54,0,1,1
1520,684,288,396,107,90,54,42,376,202,174,56,46,50,14,1
1521,118,63,55,18,19,11,5,272,125,147,41,41,22,13,1
1522,501,240,261,80,62,49,42,618,290,328,82,74,69,42,1
1523,923,420,503,128,159,100,49,153,81,72,22,18,16,8,1
1524,870,489,381,97,99,76,14,561,343,218,53,63,37,15,1
1525,80,42,38,12,7,7,4,91,50,41,8,14,4,5,1
1526,429,219,210,46,66,42,17,513,246,267,71,66,60,35,1
1527,221,131,90,32,19,15,7,625,342,283,62,53,56,28,1
1528,334,173,161,52,40,39,12,395,211,184,60,54,44,12,1
1529,776,346,430,103,102,61,40,465,225,240,65,44,65,25,1
1530,510,291,219,58,47,64,19,592,283,309,84,137,60,20,1
1531,976,520,456,120,115,109,53,906,455,451,116,105,87,46,1
1532,332,172,160,50,33,35,9,264,126,138,44,26,25,10,1
1533,672,334,338,110,93,91,41,902,495,407,116,97,111,37,1
1534,277,124,153,44,40,35,18,833,452,381,117,85,71,39,1
1535,247,135,112,25,24,27,13,304,135,169,48,36,38,26,1
1536,459,229,230,78,65,59,26,503,263,240,72,55,51,34,1
1537,454,224,230,71,39,62,22,120,67,53,13,15,9,6,1
1538,185,70,115,37,48,15,5,769,329,440,116,66,55,22,1
1539,941,504,437,119,86,103,44,744,384,360,104,96,57,31,1
1540,624,204,420,166,101,32,13,655,281,374,108,103,61,24,1
1541,323,181,142,40,37,26,16,1217,566,651,215,170,102,23,1
1542,348,187,161,47,39,27,17,552,285,267,74,51,69,24,1
1543,652,332,320,72,59,57,24,277,124,153,44,40,35,18,1
1544,404,197,207,57,69,33,15,559,296,263,77,69,42,13,1
1545,211,114,97,32,24,19,10,446,196,250,73,62,62,19,1
1546,297,141,156,49,46,36,15,208,123,85,23,22,23,11,1
1547,115,67,48,10,7,12,7,760,391,369,101,109,65,24,1
1548,2490,1126,1364,352,325,219,89,351,184,167,59,45,54,9,1
1549,318,176,142,25,32,35,25,622,328,294,75,42,67,31,1
1550,796,445,351,96,80,90,38,427,204,223,38,57,26,32,1
1551,95,44,51,14,13,7,4,317,153,164,34,52,30,14,1
1552,651,306,345,85,64,61,32,551,298,253,63,65,45,19,1
1553,800,416,384,102,105,83,22,349,131,218,66,76,22,9,1
1554,659,325,334,102,85,87,32,562,281,281,80,61,67,23,1
1555,288,158,130,59,23,21,10,742,303,439,88,96,86,23,1
1556,441,218,223,69,55,50,27,462,233,229,66,49,43,30,1
1557,297,158,139,47,37,37,9,622,331,291,69,74,45,21,1
1558,551,299,252,51,62,63,17,624,308,316,92,72,68,22,1
1559,1424,650,774,152,124,95,87,473,230,243,80,56,52,35,1
1560,543,287,256,71,66,64,23,1047,562,485,141,127,114,41,1
1561,673,317,356,101,85,76,49,604,255,349,100,72,55,26,1
1562,154,75,79,17,24,16,13,955,465,490,137,138,119,28,1
1563,145,75,70,18,17,10,9,225,102,123,32,32,31,15,1
1564,107,36,71,27,15,0,1,785,374,411,56,42,38,25,1
1565,241,127,114,34,33,29,12,1117,423,694,182,134,88,31,1
1566,129,59,70,21,19,5,2,167,86,81,21,21,11,11,1
1567,656,358,298,67,47,64,26,1102,511,591,171,179,148,52,1
1568,2468,1038,1430,333,465,167,62,475,235,240,77,58,43,22,1
1569,455,218,237,57,51,42,35,317,153,164,39,30,35,13,1
1570,240,125,115,34,32,30,8,184,91,93,26,25,16,7,1
1571,750,371,379,95,98,86,29,176,106,70,30,15,18,5,1
1572,501,240,261,80,62,49,42,253,140,113,40,22,22,8,1
1573,3911,1465,2446,610,767,240,133,737,363,374,119,101,85,41,1
1574,530,259,271,83,50,54,41,803,358,445,135,117,80,44,1
1575,204,84,120,29,30,16,9,258,111,147,46,63,17,6,1
1576,497,185,312,63,92,38,28,601,313,288,42,48,25,36,1
1577,1863,721,1142,262,283,139,74,743,366,377,41,37,26,14,1
1578,429,223,206,50,32,46,17,187,80,107,34,36,19,8,1
1579,288,118,170,50,57,18,15,116,67,49,13,12,6,5,1
1580,1182,599,583,162,130,106,41,527,273,254,81,61,81,14,1
1581,266,110,156,50,28,43,7,164,61,103,47,19,14,5,1
1582,467,221,246,98,68,43,11,1616,735,881,285,248,153,72,1
1583,412,192,220,71,50,48,23,625,342,283,62,53,56,28,1
1584,443,208,235,43,55,51,50,393,186,207,58,50,36,22,1
1585,211,83,128,28,35,5,11,513,271,242,54,52,44,13,1
1586,648,296,352,139,80,60,22,775,480,295,82,78,58,19,1
1587,1007,503,504,117,105,72,38,920,526,394,79,58,82,41,1
1588,324,145,179,45,23,32,17,482,231,251,76,81,64,26,1
1589,687,351,336,106,67,70,41,520,224,296,69,64,31,29,1
1590,429,227,202,49,51,46,26,204,96,108,31,37,20,5,1
1591,685,323,362,120,80,89,39,191,85,106,24,34,19,5,1
1592,204,109,95,21,35,27,7,148,58,90,23,25,10,4,1
1593,156,72,84,27,24,20,7,431,186,245,79,83,37,18,1
1594,712,396,316,78,69,65,25,540,257,283,81,63,57,24,1
1595,109,57,52,19,7,8,8,288,158,130,59,23,21,10,1
1596,326,182,144,31,32,27,15,100,51,49,12,12,8,4,1
1597,609,279,330,103,98,72,42,392,115,277,117,75,28,17,1
1598,200,105,95,32,22,17,12,325,169,156,32,37,49,20,1
1599,340,172,168,60,50,36,10,303,137,166,54,54,31,15,1
1600,624,204,420,166,101,32,13,707,391,316,111,80,54,30,1
1601,726,312,414,121,73,82,23,593,257,336,76,56,56,96,1
1602,560,254,306,78,67,75,47,1670,1140,530,173,120,89,53,1
1603,1063,530,533,181,121,121,25,1527,633,894,314,260,134,67,1
1604,724,334,390,112,109,79,17,467,269,198,46,51,60,18,1
1605,896,430,466,120,117,85,35,781,418,363,92,90,64,41,1
1606,876,407,469,137,130,73,29,627,289,338,101,73,62,43,1
1607,1721,809,912,268,234,144,50,149,77,72,37,10,20,5,1
1608,1071,549,522,133,127,130,59,1621,750,871,276,243,162,51,1
1609,635,333,302,99,75,83,28,86,52,34,9,8,8,3,1
1610,589,314,275,70,83,44,28,1336,828,508,166,121,152,48,1
1611,702,345,357,54,53,69,15,1392,799,593,150,115,175,56,1
1612,639,322,317,73,82,39,23,862,335,527,136,169,47,28,1
1613,204,119,85,28,18,27,8,168,76,92,26,21,19,4,1
1614,153,73,80,19,15,14,10,189,89,100,24,26,18,15,1
1615,234,133,101,29,25,28,7,261,127,134,42,37,24,11,1
1616,1132,646,486,99,102,71,41,355,169,186,49,37,26,11,1
1617,684,288,396,107,90,54,42,410,200,210,60,54,46,19,1
1618,1332,626,706,182,144,80,41,199,101,98,22,25,9,12,1
1619,979,493,486,161,112,95,31,817,425,392,120,102,83,26,1
1620,335,175,160,45,42,38,13,234,110,124,39,29,23,2,1
1621,95,41,54,15,16,8,5,1417,598,819,223,188,135,58,1
1622,1960,875,1085,287,189,162,66,595,316,279,86,60,65,40,1
1623,267,127,140,43,43,25,15,347,133,214,64,60,29,9,1
1624,260,113,147,42,30,20,8,551,298,253,63,65,45,19,1
1625,616,324,292,96,63,45,20,776,401,375,81,122,54,16,1
1626,1039,597,442,101,110,106,33,866,382,484,116,114,91,28,1
1627,229,120,109,31,30,22,9,360,168,192,57,49,48,19,1
1628,160,67,93,32,37,15,9,663,307,356,100,97,47,22,1
1629,522,235,287,78,67,60,50,582,245,337,79,88,43,34,1
1630,1970,978,992,245,206,198,80,375,202,173,46,49,41,23,1
1631,416,209,207,76,45,50,17,1201,557,644,151,125,117,50,1
1632,1356,576,780,229,198,107,38,1216,552,664,194,189,110,49,1
1633,907,475,432,124,92,65,14,921,455,466,144,127,108,39,1
1634,240,119,121,31,24,10,19,601,313,288,42,48,25,36,1
1635,509,262,247,64,70,64,20,178,91,87,20,21,12,5,1
1636,764,409,355,88,73,102,43,592,283,309,84,137,60,20,1
1637,160,53,107,31,29,13,3,934,472,462,119,122,87,39,1
1638,330,190,140,42,21,30,13,327,172,155,45,44,39,21,1
1639,802,449,353,102,87,82,29,239,126,113,49,18,27,5,1
1640,892,420,472,135,146,98,37,330,143,187,63,29,52,20,1
1641,770,374,396,95,91,79,41,166,93,73,28,15,17,6,1
1642,524,244,280,64,79,30,17,1117,423,694,182,134,88,31,1
1643,651,306,345,85,64,61,32,465,225,240,65,44,65,25,1
1644,466,186,280,71,84,30,11,355,186,169,61,43,28,13,1
1645,2477,1186,1291,256,271,249,90,728,343,385,116,82,96,57,1
1646,360,218,142,39,26,50,18,369,180,189,62,70,24,21,1
1647,457,237,220,69,44,53,26,673,329,344,111,95,92,41,1
1648,307,154,153,39,36,31,12,298,140,158,51,33,21,22,1
1649,220,115,105,31,26,22,18,660,359,301,81,87,102,31,1
1650,201,98,103,26,35,16,5,464,231,233,65,62,49,21,1
1651,1403,702,701,176,173,168,74,193,90,103,26,33,23,11,1
1652,583,322,261,73,66,45,26,845,402,443,137,126,105,47,1
1653,662,322,340,101,89,76,21,522,265,257,35,39,38,8,1
1654,375,183,192,52,48,39,23,313,159,154,30,40,23,14,1
1655,207,89,118,28,26,16,6,745,366,379,110,93,79,45,1
1656,855,422,433,109,97,109,50,529,264,265,63,59,60,35,1
1657,1290,597,693,182,182,119,63,876,473,403,110,106,73,24,1
1658,407,225,182,58,44,44,22,513,274,239,67,66,62,35,1
1659,466,186,280,71,84,30,11,1150,620,530,156,128,161,32,1
1660,33423,16370,17053,4965,4756,2786,883,821,394,427,122,117,109,38,1
1661,510,264,246,67,66,38,29,396,150,246,103,64,38,3,1
1662,360,188,172,49,48,47,17,507,242,265,53,44,31,22,1
1663,1106,579,527,121,152,113,45,461,208,253,79,76,61,21,1
1664,746,361,385,91,92,101,32,485,273,212,52,47,51,17,1
1665,423,220,203,51,54,46,17,301,157,144,31,28,34,9,1
1666,309,164,145,35,47,30,11,482,231,251,76,81,64,26,1
1667,168,67,101,37,17,13,13,313,159,154,30,40,23,14,1
1668,735,352,383,98,77,98,37,595,316,279,86,60,65,40,1
1669,654,399,255,73,58,56,21,512,261,251,79,73,60,21,1
1670,446,176,270,64,79,45,24,740,313,427,101,135,40,22,1
1671,207,107,100,27,25,20,11,710,307,403,117,176,37,9,1
1672,1015,457,558,110,160,49,26,443,248,195,67,54,40,15,1
1673,2490,1126,1364,352,325,219,89,330,178,152,49,35,30,15,1
1674,181,96,85,25,23,20,7,437,225,212,61,57,66,12,1
1675,520,261,259,82,76,71,24,595,316,279,86,60,65,40,1
1676,1863,721,1142,262,283,139,74,1339,494,845,216,298,92,37,1
1677,407,180,227,79,42,32,16,298,167,131,47,33,40,8,1
1678,577,288,289,85,56,40,20,266,137,129,66,21,18,5,1
1679,198,80,118,35,31,14,7,334,172,162,43,39,41,17,1
1680,163,70,93,28,21,17,6,781,418,363,92,90,64,41,1
1681,432,181,251,48,75,27,17,1047,562,485,141,127,114,41,1
1682,158,85,73,24,18,18,8,517,250,267,78,37,64,29,1
1683,1133,583,550,155,127,140,53,259,143,116,39,37,23,9,1
1684,7968,4016,3952,1072,1051,652,307,1941,818,1123,351,358,141,64,1
1685,289,143,146,38,18,40,8,267,147,120,40,24,25,8,1
1686,454,191,263,61,66,38,15,433,221,212,59,42,47,14,1
1687,368,158,210,64,61,39,14,1117,423,694,182,134,88,31,1
1688,297,148,149,64,35,37,15,1115,586,529,124,161,111,69,1
1689,780,337,443,112,116,77,28,1382,689,693,186,176,167,77,1
1690,839,408,431,138,122,105,46,211,114,97,32,24,19,10,1
1691,291,141,150,49,43,26,7,720,357,363,113,85,62,39,1
1692,1863,721,1142,262,283,139,74,309,137,172,51,50,28,14,1
1693,949,512,437,102,124,70,41,402,227,175,48,40,35,11,1
1694,204,96,108,31,37,20,5,845,402,443,137,126,105,47,1
1695,351,184,167,59,45,54,9,206,85,121,31,42,6,17,1
1696,837,399,438,112,144,71,32,2556,1169,1387,248,291,227,275,1
1697,2477,1186,1291,256,271,249,90,467,224,243,70,43,67,23,1
1698,583,322,261,73,66,45,26,593,266,327,102,84,69,24,1
1699,1132,624,508,199,79,127,41,551,298,253,63,65,45,19,1
1700,426,228,198,62,42,47,22,606,279,327,81,70,49,34,1
1701,323,171,152,36,36,47,15,631,332,299,61,104,60,19,1
1702,550,243,307,91,99,70,10,377,202,175,46,50,41,23,1
1703,355,169,186,49,37,26,11,769,329,440,116,66,55,22,1
1704,454,230,224,63,56,38,33,327,177,150,56,20,25,6,1
1705,532,267,265,86,55,64,22,217,109,108,34,32,35,7,1
1706,969,505,464,123,133,92,33,778,367,411,90,85,64,43,1
1707,782,421,361,101,97,82,20,2477,1186,1291,256,271,249,90,1
1708,368,177,191,49,35,50,20,859,395,464,157,119,59,31,1
1709,239,146,93,30,22,35,9,521,265,256,69,69,61,26,1
1710,393,186,207,58,50,36,22,736,388,348,88,85,67,28,1
1711,160,86,74,21,11,16,16,1210,592,618,157,138,116,85,1
1712,3230,1723,1507,361,358,157,75,1464,693,771,153,136,91,86,1
1713,412,218,194,63,51,49,14,292,154,138,46,29,41,7,1
1714,135,69,66,21,14,11,5,398,249,149,40,19,66,25,1
1715,557,268,289,66,67,70,17,542,249,293,82,69,58,31,1
1716,613,333,280,71,66,47,26,831,426,405,101,102,105,32,1
1717,413,194,219,77,72,28,11,2045,985,1060,359,339,199,74,1
1718,457,237,220,69,44,53,26,271,159,112,34,34,33,7,1
1719,581,254,327,100,83,54,20,339,170,169,32,17,24,13,1
1720,586,270,316,83,80,59,21,490,198,292,65,81,39,27,1
1721,303,141,162,42,57,37,20,1487,996,491,147,141,50,35,1
1722,1573,791,782,198,173,148,46,593,295,298,70,85,48,13,1
1723,976,496,480,128,111,121,48,217,109,108,34,32,35,7,1
1724,1158,481,677,169,129,86,40,202,102,100,29,35,6,9,1
1725,377,184,193,50,43,33,17,342,208,134,36,31,29,15,1
1726,1119,621,498,145,144,85,47,1083,566,517,142,128,136,44,1
1727,208,99,109,35,12,30,14,822,424,398,107,106,86,46,1
1728,1186,553,633,177,142,143,61,214,109,105,31,26,25,17,1
1729,537,276,261,75,68,68,22,297,160,137,27,33,26,19,1
1730,359,182,177,54,37,41,12,825,363,462,97,105,72,75,1
1731,168,120,48,7,5,20,7,391,193,198,51,52,49,16,1
1732,4544,2024,2520,579,628,480,403,267,159,108,31,13,22,15,1
1733,747,316,431,143,127,53,21,792,407,385,110,132,82,43,1
1734,355,168,187,48,57,30,15,359,160,199,62,33,27,17,1
1735,424,179,245,65,67,29,11,456,191,265,82,55,45,11,1
1736,648,307,341,101,58,76,34,400,215,185,59,54,33,16,1
1737,614,305,309,96,73,65,24,1441,657,784,140,135,81,73,1
1738,568,193,375,112,83,50,15,585,299,286,92,73,89,23,1
1739,1088,565,523,165,121,122,38,491,227,264,72,82,46,29,1
1740,947,482,465,143,107,89,37,900,484,416,119,110,77,29,1
1741,593,266,327,102,84,69,24,1089,544,545,138,160,117,43,1
1742,269,134,135,42,35,27,13,261,127,134,42,37,24,11,1
1743,485,187,298,95,71,61,25,457,237,220,69,44,53,26,1
1744,854,399,455,127,118,57,39,1721,809,912,268,234,144,50,1
1745,463,259,204,62,55,34,22,587,315,272,84,55,70,32,1
1746,458,222,236,69,39,35,18,261,134,127,39,27,30,11,1
1747,657,293,364,109,75,66,28,1374,679,695,191,193,154,48,1
1748,480,234,246,79,77,65,23,1455,765,690,189,162,166,66,1
1749,2319,934,1385,304,376,173,104,673,287,386,89,111,66,30,1
1750,288,159,129,27,44,27,15,222,128,94,21,24,28,9,1
1751,376,183,193,50,50,43,21,467,250,217,59,52,41,19,1
1752,321,187,134,59,29,32,8,648,341,307,78,89,77,21,1
1753,224,103,121,34,47,11,9,265,119,146,44,52,12,9,1
1754,1464,693,771,153,136,91,86,461,207,254,82,66,55,33,1
1755,125,60,65,22,17,14,5,703,388,315,82,78,81,37,1
1756,225,116,109,29,19,25,6,1047,562,485,141,127,114,41,1
1757,246,115,131,15,29,10,32,623,233,390,145,83,43,20,1
1758,1190,638,552,162,95,112,18,2073,846,1227,304,300,162,111,1
1759,1038,470,568,130,123,86,51,396,192,204,71,41,51,15,1
1760,1132,646,486,99,102,71,41,568,292,276,69,74,59,34,1
1761,796,445,351,96,80,90,38,724,334,390,112,109,79,17,1
1762,277,124,153,44,40,35,18,480,234,246,79,77,65,23,1
1763,409,170,239,75,62,25,10,391,208,183,65,49,57,17,1
1764,217,109,108,34,32,35,7,632,339,293,83,77,59,20,1
1765,412,238,174,41,38,43,19,402,227,175,48,40,35,11,1
1766,335,143,192,45,36,32,37,1187,631,556,182,139,152,56,1
1767,432,188,244,76,81,26,13,666,344,322,91,73,91,20,1
1768,632,326,306,92,71,56,19,690,332,358,94,78,65,30,1
1769,620,324,296,81,68,66,31,641,324,317,88,92,49,14,1
1770,322,160,162,44,52,33,16,648,307,341,101,58,76,34,1
1771,534,266,268,86,62,37,14,483,155,328,138,109,32,9,1
1772,331,169,162,48,51,32,6,452,236,216,73,54,50,29,1
1773,500,236,264,85,69,33,17,609,292,317,102,96,64,21,1
1774,2602,1424,1178,314,320,249,75,825,363,462,97,105,72,75,1
1775,418,226,192,57,57,53,17,300,145,155,53,43,42,9,1
1776,719,270,449,113,122,44,32,480,237,243,64,60,56,33,1
1777,361,189,172,53,42,27,11,729,391,338,80,64,71,34,1
1778,303,137,166,54,54,31,15,641,324,317,88,92,49,14,1
1779,241,106,135,48,29,17,15,1474,756,718,175,158,169,51,1
1780,875,421,454,124,142,98,43,624,334,290,35,40,26,31,1
1781,583,322,261,73,66,45,26,1356,672,684,171,172,134,59,1
1782,204,96,108,31,37,20,5,193,99,94,31,31,16,12,1
1783,487,223,264,81,68,63,15,246,108,138,32,44,21,10,1
1784,979,534,445,83,77,80,24,723,371,352,86,69,80,27,1
1785,525,274,251,82,74,60,25,480,234,246,79,77,65,23,1
1786,393,210,183,55,50,34,19,372,184,188,55,55,30,8,1
1787,557,278,279,75,70,66,31,499,252,247,75,71,65,25,1
1788,377,180,197,37,20,24,8,385,181,204,48,41,52,36,1
1789,86,50,36,9,14,8,7,118,51,67,25,13,6,7,1
1790,565,285,280,72,73,47,31,620,307,313,92,91,92,33,1
1791,822,392,430,125,104,79,24,172,74,98,32,30,11,7,1
1792,158,85,73,24,18,18,8,396,150,246,103,64,38,3,1
1793,709,310,399,95,103,61,30,375,232,143,45,34,67,20,1
1794,586,270,316,83,80,59,21,437,228,209,47,61,26,11,1
1795,341,190,151,50,41,23,15,424,255,169,38,26,27,14,1
1796,298,154,144,44,34,25,11,598,300,298,68,77,59,21,1
1797,570,292,278,80,65,72,23,930,367,563,181,153,83,48,1
1798,930,367,563,181,153,83,48,2045,985,1060,359,339,199,74,1
1799,440,215,225,76,74,29,16,433,220,213,67,68,31,19,1
1800,1588,631,957,275,292,183,66,1102,511,591,171,179,148,52,1
1801,703,308,395,81,91,66,80,330,143,187,63,29,52,20,1
1802,428,226,202,52,60,75,20,950,450,500,110,157,82,50,1
1803,536,209,327,68,127,48,23,785,374,411,56,42,38,25,1
1804,870,436,434,131,114,72,25,695,340,355,79,124,53,13,1
1805,365,222,143,44,24,35,11,205,91,114,31,36,13,8,1
1806,647,322,325,104,98,54,14,686,375,311,89,80,63,20,1
1807,267,159,108,31,13,22,15,397,237,160,47,15,56,21,1
1808,432,218,214,57,55,42,11,458,245,213,52,43,27,24,1
1809,740,331,409,125,97,79,35,147,78,69,20,15,20,7,1
1810,441,218,223,69,55,50,27,2440,1061,1379,377,326,172,62,1
1811,258,141,117,33,29,23,10,622,309,313,75,81,76,29,1
1812,491,270,221,51,47,53,18,810,367,443,115,92,94,59,1
1813,553,261,292,73,79,40,26,404,190,214,55,55,35,27,1
1814,712,396,316,78,69,65,25,659,325,334,102,85,87,32,1
1815,240,125,115,34,32,30,8,422,213,209,63,60,35,13,1
1816,1210,592,618,157,138,116,85,393,210,183,55,50,34,19,1
1817,393,186,207,58,50,36,22,641,324,317,88,92,49,14,1
1818,182,90,92,25,23,14,5,1749,880,869,237,228,214,112,1
1819,724,334,390,112,109,79,17,592,264,328,86,85,62,41,1
1820,593,291,302,81,85,56,20,681,286,395,109,61,69,42,1
1821,230,115,115,29,29,22,14,226,129,97,20,25,26,11,1
1822,119,63,56,18,19,11,3,1117,423,694,182,134,88,31,1
1823,710,375,335,95,94,110,28,485,273,212,52,47,51,17,1
1824,246,115,131,15,29,10,32,458,245,213,52,43,27,24,1
1825,576,250,326,93,71,34,15,637,294,343,97,91,46,17,1
1826,252,146,106,38,23,21,9,441,218,223,69,55,50,27,1
1827,536,278,258,72,63,62,20,596,286,310,90,89,78,37,1
1828,359,173,186,55,57,44,16,353,218,135,38,20,56,11,1
1829,732,355,377,108,109,79,27,1132,624,508,199,79,127,41,1
1830,248,147,101,24,18,29,10,240,134,106,21,17,16,11,1
1831,132,60,72,19,17,17,6,448,236,212,53,64,56,24,1
1832,427,186,241,55,52,42,23,700,348,352,93,115,85,27,1
1833,710,361,349,81,98,63,26,502,236,266,66,66,58,17,1
1834,353,217,136,39,17,44,17,377,177,200,63,53,44,16,1
1835,288,159,129,27,44,27,15,271,159,112,34,34,33,7,1
1836,205,101,104,34,25,34,8,128,58,70,22,14,4,7,1
1837,789,389,400,121,80,92,40,770,390,380,104,76,78,32,1
1838,67,34,33,10,12,6,5,340,163,177,39,38,37,23,1
1839,160,102,58,12,5,28,7,299,140,159,27,59,20,18,1
1840,724,334,390,112,109,79,17,281,166,115,34,17,36,16,1
1841,582,293,289,94,80,77,32,1052,492,560,184,163,103,44,1
1842,461,223,238,66,57,36,23,673,318,355,61,71,40,31,1
1843,531,260,271,97,68,47,11,671,303,368,93,68,61,26,1
1844,429,219,210,46,66,42,17,338,168,170,60,38,48,17,1
1845,134,60,74,19,13,10,7,768,378,390,105,104,63,26,1
1846,298,161,137,47,29,25,15,461,207,254,82,66,55,33,1
1847,267,127,140,43,42,24,9,1105,479,626,182,125,80,29,1
1848,185,115,70,19,17,26,6,249,111,138,40,30,22,17,1
1849,520,236,284,115,52,45,16,1970,978,992,245,206,198,80,1
1850,240,125,115,34,32,30,8,1134,539,595,150,146,78,40,1
1851,837,406,431,108,113,76,26,253,148,105,31,15,39,16,1
1852,394,202,192,44,43,38,28,208,90,118,58,20,20,6,1
1853,370,190,180,60,52,37,13,298,184,114,45,22,45,12,1
1854,1395,627,768,172,263,141,59,479,274,205,57,24,50,24,1
1855,636,320,316,79,61,67,31,215,80,135,54,56,21,9,1
1856,248,144,104,24,30,21,15,245,142,103,29,20,21,9,1
1857,914,453,461,112,115,79,29,183,96,87,20,28,17,10,1
1858,1475,658,817,149,114,120,43,1115,586,529,124,161,111,69,1
1859,219,124,95,22,22,23,5,406,188,218,51,80,47,20,1
1860,462,228,234,59,47,37,32,462,233,229,66,49,43,30,1
1861,755,347,408,101,90,53,29,1912,977,935,247,226,205,65,1
1862,529,274,255,57,62,38,14,551,298,253,63,65,45,19,1
1863,245,112,133,32,45,20,10,1210,592,618,157,138,116,85,1
1864,748,341,407,121,87,96,52,723,335,388,90,84,77,74,1
1865,725,408,317,93,75,90,45,97,50,47,17,14,14,10,1
1866,1339,494,845,216,298,92,37,391,204,187,47,48,38,18,1
1867,815,418,397,97,62,70,17,739,471,268,55,70,34,9,1
1868,158,85,73,24,18,18,8,778,367,411,90,85,64,43,1
1869,1074,538,536,154,140,111,51,586,254,332,114,111,55,17,1
1870,401,198,203,70,29,38,15,548,236,312,88,88,63,25,1
1871,2045,985,1060,359,339,199,74,283,141,142,32,26,23,26,1
1872,639,287,352,111,108,44,9,536,278,258,72,63,62,20,1
1873,1304,585,719,179,169,154,47,586,254,332,114,111,55,17,1
1874,847,402,445,109,91,100,37,1189,559,630,179,147,118,35,1
1875,881,383,498,142,148,77,24,245,112,133,32,45,20,10,1
1876,404,190,214,55,55,35,27,920,492,428,100,92,88,49,1
1877,418,189,229,76,72,45,14,1089,544,545,138,160,117,43,1
1878,540,257,283,81,63,57,24,277,122,155,33,33,25,24,1
1879,213,107,106,28,41,19,5,439,220,219,63,72,25,20,1
1880,1009,506,503,146,141,97,55,724,334,390,112,109,79,17,1
1881,703,351,352,104,96,55,13,411,207,204,60,57,35,21,1
1882,1290,658,632,145,139,94,44,416,209,207,76,45,50,17,1
1883,522,265,257,35,39,38,8,213,91,122,42,30,23,12,1
1884,556,279,277,83,69,71,19,480,234,246,79,77,65,23,1
1885,449,240,209,59,55,63,20,686,375,311,89,80,63,20,1
1886,440,218,222,58,66,40,24,510,252,258,75,60,57,24,1
1887,355,214,141,43,29,63,13,92,44,48,6,8,9,8,1
1888,1050,473,577,142,119,87,54,530,259,271,83,50,54,41,1
1889,392,156,236,40,91,28,16,168,67,101,37,17,13,13,1
1890,702,298,404,134,111,48,18,356,185,171,37,31,17,21,1
1891,703,308,395,81,91,66,80,2477,1186,1291,256,271,249,90,1
1892,163,71,92,22,38,11,7,711,322,389,112,85,68,40,1
1893,556,269,287,86,66,62,22,528,283,245,77,72,63,11,1
1894,847,452,395,100,94,81,36,136,66,70,33,11,9,4,1
1895,671,318,353,83,124,46,34,278,110,168,58,49,29,5,1
1896,502,299,203,57,52,32,11,217,109,108,34,32,35,7,1
1897,744,385,359,125,89,90,23,168,76,92,26,21,19,4,1
1898,482,231,251,76,81,64,26,551,298,253,63,65,45,19,1
1899,870,418,452,121,102,109,28,457,237,220,69,44,53,26,1
1900,466,186,280,71,84,30,11,778,353,425,140,89,92,51,1
1901,901,458,443,91,129,86,21,1242,613,629,174,113,114,53,1
1902,528,340,188,45,41,57,16,239,146,93,30,22,35,9,1
1903,362,178,184,50,63,17,8,1248,584,664,184,164,155,67,1
1904,237,117,120,34,27,24,14,185,115,70,19,17,26,6,1
1905,195,83,112,40,16,19,16,272,124,148,51,36,23,27,1
1906,1174,594,580,175,155,126,66,67,40,27,10,8,7,6,1
1907,835,381,454,133,112,81,44,423,222,201,51,33,41,28,1
1908,461,257,204,48,37,78,28,185,94,91,36,13,17,7,1
1909,924,441,483,131,115,90,38,745,360,385,115,111,63,33,1
1910,1606,753,853,215,227,182,48,670,333,337,95,79,62,21,1
1911,979,480,499,109,108,130,45,252,124,128,49,22,19,13,1
1912,305,161,144,39,40,44,17,500,268,232,65,56,28,17,1
1913,175,91,84,33,18,16,8,3801,1837,1964,510,442,418,170,1
1914,356,161,195,52,57,40,17,149,68,81,15,38,11,10,1
1915,368,141,227,64,61,24,13,387,177,210,53,50,44,20,1
1916,726,340,386,125,100,60,17,204,116,88,16,22,20,12,1
1917,571,294,277,91,70,67,29,1255,708,547,120,68,88,7,1
1918,372,193,179,60,43,29,2,360,192,168,55,45,48,16,1
1919,639,287,352,111,108,44,9,968,498,470,129,133,115,37,1
1920,1023,561,462,117,125,96,48,80,41,39,9,7,5,5,1
1921,316,157,159,45,38,22,19,1441,657,784,140,135,81,73,1
1922,536,278,258,72,63,62,20,595,316,279,86,60,65,40,1
1923,356,199,157,43,58,29,12,150,79,71,19,29,19,6,1
1924,226,118,108,32,30,18,11,303,175,128,43,36,34,12,1
1925,615,225,390,150,71,108,53,215,115,100,27,28,34,16,1
1926,673,329,344,111,95,92,41,1531,691,840,270,226,143,52,1
1927,372,196,176,51,36,51,8,160,76,84,45,13,19,7,1
1928,781,418,363,92,90,64,41,655,328,327,65,54,55,35,1
1929,639,373,266,77,89,68,25,815,418,397,97,62,70,17,1
1930,96,50,46,8,15,6,2,1129,589,540,134,122,108,46,1
1931,246,115,131,15,29,10,32,478,260,218,75,37,60,24,1
1932,222,103,119,38,39,4,17,638,260,378,96,100,53,28,1
1933,635,333,302,99,75,83,28,113,66,47,11,9,6,5,1
1934,269,140,129,27,26,30,19,1247,548,699,168,150,140,43,1
1935,648,307,341,101,58,76,34,369,237,132,33,16,38,18,1
1936,4374,2058,2316,531,605,321,183,96,46,50,17,8,9,11,1
1937,920,492,428,100,92,88,49,403,185,218,67,62,63,19,1
1938,441,175,266,73,88,26,8,1314,648,666,135,166,103,52,1
1939,404,197,207,57,69,33,15,552,285,267,74,51,69,24,1
1940,912,460,452,139,132,89,53,454,191,263,61,66,38,15,1
1941,749,354,395,77,74,76,35,928,455,473,108,90,107,43,1
1942,178,100,78,23,22,30,6,379,203,176,55,48,45,16,1
1943,355,168,187,48,57,30,15,941,504,437,119,86,103,44,1
1944,613,333,280,71,66,47,26,501,285,216,52,55,62,25,1
1945,117,65,52,15,16,10,4,167,89,78,16,14,18,7,1
1946,252,123,129,29,34,31,24,676,319,357,83,86,62,46,1
1947,622,294,328,104,93,42,17,744,331,413,118,114,58,28,1
1948,389,199,190,51,56,41,21,837,444,393,128,89,87,37,1
1949,297,145,152,49,30,23,21,742,303,439,88,96,86,23,1
1950,552,285,267,74,51,69,24,663,397,266,76,58,121,39,1
1951,1182,612,570,142,118,140,62,316,161,155,46,50,39,16,1
1952,360,188,172,49,48,47,17,118,56,62,13,14,6,6,1
1953,1290,597,693,182,182,119,63,466,186,280,71,84,30,11,1
1954,293,134,159,40,27,23,30,285,145,140,37,36,22,11,1
1955,217,115,102,40,24,26,6,654,344,310,80,69,57,15,1
1956,160,101,59,21,18,17,2,247,110,137,34,45,23,10,1
1957,688,323,365,121,69,55,22,1858,805,1053,271,345,116,41,1
1958,262,150,112,31,33,31,7,339,170,169,32,17,24,13,1
1959,1830,904,926,276,245,222,100,303,159,144,40,35,35,8,1
1960,400,207,193,30,36,12,10,532,276,256,57,50,32,19,1
1961,415,219,196,53,55,57,20,790,385,405,121,108,106,39,1
1962,622,299,323,86,86,69,35,464,231,233,65,62,49,21,1
1963,2414,1189,1225,277,178,170,169,1312,484,828,258,239,86,51,1
1964,672,334,338,110,93,91,41,906,455,451,116,105,87,46,1
1965,582,330,252,73,75,68,25,724,650,74,44,3,32,3,1
1966,350,180,170,64,46,55,12,403,185,218,67,62,63,19,1
1967,116,55,61,14,14,18,8,267,127,140,43,43,25,15,1
1968,205,106,99,28,26,23,3,131,66,65,21,14,23,7,1
1969,470,256,214,56,39,47,34,556,259,297,75,69,63,38,1
1970,697,373,324,105,83,95,38,1078,557,521,116,114,144,44,1
1971,195,109,86,25,24,17,6,1036,496,540,151,134,114,72,1
1972,173,110,63,35,6,9,8,799,297,502,183,87,128,55,1
1973,150,109,41,16,6,22,3,155,94,61,21,13,22,8,1
1974,637,335,302,83,77,85,26,342,178,164,33,38,35,15,1
1975,429,219,210,46,66,42,17,178,91,87,20,21,12,5,1
1976,747,333,414,102,64,63,46,472,220,252,59,69,32,20,1
1977,864,429,435,129,118,68,35,695,340,355,79,124,53,13,1
1978,293,142,151,49,40,42,17,267,127,140,43,42,24,9,1
1979,391,189,202,55,56,56,12,247,132,115,24,22,24,13,1
1980,740,377,363,118,94,62,29,760,401,359,96,89,98,22,1
1981,133,72,61,20,17,14,3,437,225,212,61,57,66,12,1
1982,1290,597,693,182,182,119,63,811,361,450,124,107,80,31,1
1983,251,132,119,29,25,32,13,300,157,143,41,25,25,23,1
1984,920,492,428,100,92,88,49,1863,721,1142,262,283,139,74,1
1985,154,75,79,17,24,16,13,922,418,504,120,120,106,31,1
1986,2468,1038,1430,333,465,167,62,433,221,212,59,42,47,14,1
1987,298,160,138,37,30,22,12,918,490,428,114,100,115,41,1
1988,505,268,237,68,59,34,15,377,184,193,56,53,44,14,1
1989,148,94,54,19,15,8,4,437,190,247,82,66,39,20,1
1990,595,292,303,79,83,69,24,1333,646,687,209,179,148,45,1
1991,224,108,116,33,26,32,10,2442,1193,1249,278,183,170,145,1
1992,490,224,266,80,70,39,32,533,297,236,74,57,39,28,1
1993,546,267,279,90,69,56,19,777,408,369,100,96,56,17,1
1994,336,154,182,51,48,39,22,1247,548,699,168,150,140,43,1
1995,769,405,364,97,101,49,35,140,76,64,17,13,13,8,1
1996,817,427,390,100,97,87,32,582,189,393,117,66,66,6,1
1997,453,242,211,59,47,49,11,1007,523,484,116,113,117,43,1
1998,388,234,154,43,35,47,20,1153,535,618,204,158,93,50,1
1999,524,264,260,75,75,40,21,537,276,261,75,68,68,22,1
2000,1181,612,569,107,121,123,43,3075,1459,1616,390,359,298,207,1
2001,928,455,473,108,90,107,43,145,70,75,24,16,16,20,1
2002,684,288,396,107,90,54,42,5938,2573,3365,858,958,396,195,1
2003,577,342,235,63,57,23,37,140,86,54,17,6,20,7,1
2004,724,334,390,112,109,79,17,928,442,486,139,118,91,43,1
2005,1356,672,684,171,172,134,59,624,308,316,92,72,68,22,1
2006,188,97,91,27,16,24,21,1132,646,486,99,102,71,41,1
2007,485,209,276,78,69,37,30,202,102,100,29,35,6,9,1
2008,123,61,62,17,18,17,7,125,67,58,11,11,6,19,1
2009,985,551,434,123,93,91,26,638,260,378,96,100,53,28,1
2010,1290,658,632,145,139,94,44,1395,627,768,172,263,141,59,1
2011,622,299,323,86,86,69,35,866,382,484,116,114,91,28,1
2012,480,259,221,59,54,50,22,105,53,52,23,11,12,6,1
2013,372,179,193,50,52,33,6,353,195,158,40,55,30,13,1
2014,380,185,195,68,54,32,16,437,225,212,61,57,66,12,1
2015,1158,481,677,169,129,86,40,582,293,289,94,80,77,32,1
2016,1972,846,1126,222,330,114,68,1285,724,561,123,127,117,117,1
2017,483,237,246,63,47,25,21,1085,646,439,108,65,36,19,1
2018,603,291,312,97,73,83,22,747,355,392,115,101,97,32,1
2019,160,67,93,32,37,15,9,689,343,346,105,102,81,35,1
2020,188,119,69,24,15,26,12,524,317,207,47,49,43,28,1
2021,672,334,338,110,93,91,41,191,99,92,25,24,18,8,1
2022,519,219,300,86,72,50,39,509,214,295,88,76,57,38,1
2023,392,115,277,117,75,28,17,87,50,37,16,7,10,5,1
2024,246,115,131,15,29,10,32,369,151,218,94,40,58,23,1
2025,2115,838,1277,346,354,90,48,864,362,502,142,150,70,19,1
2026,822,416,406,111,105,84,44,244,116,128,47,19,26,9,1
2027,136,66,70,33,11,9,3,1710,650,1060,338,287,185,46,1
2028,391,189,202,73,47,37,8,632,326,306,92,71,56,19,1
2029,863,470,393,82,72,92,44,217,109,108,34,32,35,7,1
2030,297,158,139,47,37,37,9,215,105,110,27,22,20,9,1
2031,1290,597,693,182,182,119,63,403,220,183,50,40,39,27,1
2032,480,234,246,79,77,65,23,1400,800,600,158,134,150,65,1
2033,272,173,99,32,32,11,8,1272,520,752,235,242,117,54,1
2034,1248,567,681,178,160,113,44,4655,2074,2581,545,652,562,399,1
2035,360,192,168,55,45,48,16,304,127,177,61,38,31,4,1
2036,595,284,311,69,71,35,49,1620,884,736,194,161,162,80,1
2037,456,228,228,49,70,32,19,513,271,242,54,52,44,13,1
2038,403,195,208,68,48,37,16,288,120,168,54,52,21,12,1
2039,749,354,395,77,74,76,35,979,534,445,83,77,80,24,1
2040,564,291,273,77,72,95,21,651,340,311,81,84,80,29,1
2041,374,201,173,51,34,53,24,245,112,133,32,45,20,10,1
2042,145,84,61,16,15,14,4,4544,2024,2520,579,628,480,403,1
2043,155,79,76,26,13,15,6,369,216,153,36,22,46,23,1
2044,621,310,311,100,106,77,27,514,226,288,71,66,63,32,1
2045,915,336,579,185,199,56,29,372,196,176,51,36,51,8,1
2046,585,299,286,92,73,89,23,770,355,415,103,142,75,42,1
2047,1770,759,1011,237,271,163,74,446,265,181,51,35,27,17,1
2048,122,52,70,24,22,7,6,769,329,440,116,66,55,22,1
2049,908,489,419,114,131,79,46,769,329,440,116,66,55,22,1
2050,783,429,354,100,77,54,25,1182,599,583,162,130,106,41,1
2051,680,368,312,86,81,81,34,201,88,113,33,27,20,8,1
2052,990,410,580,140,175,44,36,452,256,196,32,44,27,11,1
2053,396,192,204,71,41,51,15,184,77,107,34,17,14,13,1
2054,480,234,246,79,77,65,23,553,261,292,73,79,40,26,1
2055,149,68,81,15,38,11,10,726,326,400,106,106,57,31,1
2056,676,333,343,111,89,94,39,315,150,165,49,59,23,15,1
2057,902,332,570,154,146,75,40,777,345,432,128,88,65,39,1
2058,672,334,338,110,93,91,41,614,305,309,96,73,65,24,1
2059,710,361,349,81,98,63,26,281,166,115,34,17,36,16,1
2060,641,341,300,101,91,29,22,265,103,162,61,58,25,3,1
2061,751,312,439,131,115,78,48,739,324,415,127,89,76,33,1
2062,1071,549,522,133,127,130,59,1132,624,508,199,79,127,41,1
2063,424,197,227,67,62,43,17,453,279,174,51,48,42,17,1
2064,313,174,139,38,34,39,14,728,369,359,79,93,97,40,1
2065,114,71,43,8,18,7,4,652,272,380,116,113,55,27,1
2066,356,185,171,37,31,17,21,465,261,204,51,35,48,21,1
2067,630,345,285,89,60,41,16,202,102,100,29,35,6,9,1
2068,253,148,105,31,15,39,16,654,317,337,95,111,44,13,1
2069,1307,594,713,179,208,102,41,399,208,191,57,46,41,20,1
2070,936,396,540,96,166,77,29,613,333,280,71,66,47,26,1
2071,822,417,405,111,127,76,34,499,252,247,74,42,55,14,1
2072,881,383,498,142,148,77,24,443,240,203,66,31,57,27,1
2073,1342,673,669,178,154,137,94,2639,1436,1203,317,307,242,77,1
2074,561,210,351,108,77,41,22,609,292,317,102,96,64,21,1
2075,754,182,572,236,122,57,18,247,110,137,34,45,23,10,1
2076,428,248,180,44,39,28,9,217,109,108,34,32,35,7,1
2077,317,153,164,39,30,35,13,619,343,276,88,65,84,25,1
2078,686,375,311,89,80,63,20,524,244,280,64,79,30,17,1
2079,1189,559,630,179,147,118,35,738,339,399,102,88,68,35,1
2080,972,519,453,109,98,120,39,217,109,108,34,32,35,7,1
2081,134,64,70,19,24,19,4,359,204,155,56,33,70,11,1
2082,304,144,160,30,39,26,16,694,315,379,101,87,47,17,1
2083,365,171,194,48,56,36,11,92,40,52,14,23,13,7,1
2084,94,55,39,18,6,18,5,186,92,94,28,23,17,11,1
2085,558,302,256,66,62,65,30,2472,1055,1417,416,458,235,64,1
2086,1395,627,768,172,263,141,59,412,263,149,48,24,45,19,1
2087,590,306,284,69,82,68,27,528,273,255,67,53,29,20,1
2088,506,243,263,75,70,39,17,1434,727,707,210,173,161,54,1
2089,355,165,190,53,56,42,19,460,254,206,58,35,47,28,1
2090,617,402,215,55,42,109,23,288,118,170,50,57,18,15,1
2091,462,228,234,59,47,37,32,292,153,139,39,33,24,21,1
2092,706,458,248,56,38,112,39,288,118,170,50,57,18,15,1
2093,936,451,485,111,97,92,41,756,362,394,102,104,73,25,1
2094,412,260,152,39,24,49,23,363,193,170,52,51,41,14,1
2095,455,242,213,69,50,45,18,532,269,263,72,59,59,39,1
2096,454,224,230,71,39,62,22,376,183,193,50,50,43,21,1
2097,656,358,298,67,47,64,26,342,208,134,36,31,29,15,1
2098,437,228,209,47,61,26,11,785,374,411,56,42,38,25,1
2099,1113,480,633,170,173,81,34,769,329,440,116,66,55,22,1
2100,171,85,86,23,16,20,10,250,123,127,40,28,29,8,1
2101,1390,695,695,180,137,170,71,217,109,108,34,32,35,7,1
2102,581,299,282,93,81,73,26,5179,2082,3097,270,269,273,249,1
2103,428,248,180,44,39,28,9,1863,721,1142,262,283,139,74,1
2104,346,180,166,55,49,38,6,221,111,110,42,35,33,6,1
2105,333,127,206,66,68,25,14,315,150,165,49,59,23,15,1
2106,446,246,200,64,48,54,12,331,169,162,40,28,22,14,1
2107,101,41,60,18,19,10,5,781,367,414,60,67,43,17,1
2108,252,121,131,42,34,12,16,560,260,300,100,58,29,28,1
2109,1685,807,878,256,231,178,50,1960,810,1150,358,377,121,72,1
2110,1163,493,670,214,158,106,42,1011,499,512,157,133,116,48,1
2111,350,181,169,44,52,43,13,118,51,67,25,13,6,7,1
2112,240,125,115,34,32,30,8,204,104,100,26,27,21,11,1
2113,161,76,85,18,21,13,5,709,359,350,107,102,65,20,1
2114,361,184,177,50,53,51,22,769,329,440,116,66,55,22,1
2115,400,203,197,30,36,31,10,630,290,340,102,70,70,37,1
2116,363,182,181,33,55,23,11,377,180,197,45,63,19,17,1
2117,731,281,450,112,113,50,18,901,439,462,133,123,102,45,1
2118,1210,601,609,126,80,120,39,255,136,119,39,20,32,10,1
2119,1210,592,618,157,138,116,85,358,170,188,54,55,20,10,1
2120,1235,637,598,191,162,99,36,334,171,163,48,42,32,18,1
2121,80,44,36,4,1,4,2,830,402,428,80,67,100,80,1
2122,378,222,156,49,17,45,26,359,173,186,55,57,44,16,1
2123,427,210,217,64,66,45,24,456,220,236,67,75,30,21,1
2124,454,191,263,61,66,38,15,345,203,142,47,35,31,11,1
2125,360,192,168,55,45,48,16,854,380,474,137,159,81,31,1
2126,229,105,124,36,33,12,4,1471,709,762,198,184,154,62,1
2127,1087,480,607,155,179,99,28,344,151,193,59,51,30,9,1
2128,894,492,402,95,103,88,42,211,113,98,38,17,25,8,1
2129,390,214,176,60,38,51,17,513,176,337,101,90,31,25,1
2130,1278,593,685,198,201,71,43,638,295,343,90,103,69,20,1
2131,463,236,227,64,50,44,29,252,128,124,46,31,18,8,1
2132,365,180,185,63,35,48,19,514,332,182,37,36,56,36,1
2133,676,333,343,111,89,94,39,238,95,143,37,55,4,4,1
2134,633,305,328,90,56,22,23,832,428,404,131,89,88,38,1
2135,1321,653,668,186,195,70,35,307,150,157,44,23,30,13,1
2136,213,114,99,62,7,2,1,790,343,447,90,191,35,17,1
2137,522,235,287,78,67,60,50,514,283,231,60,60,52,19,1
2138,700,357,343,99,84,88,34,379,203,176,55,48,45,16,1
2139,589,281,308,69,39,63,20,2414,1189,1225,277,178,170,169,1
2140,639,318,321,101,83,74,31,1255,708,547,120,68,88,7,1
2141,187,75,112,41,32,17,11,136,72,64,22,16,7,3,1
2142,710,375,335,95,94,110,28,125,67,58,11,11,6,19,1
2143,348,187,161,50,35,44,9,526,266,260,76,75,53,22,1
2144,206,100,106,34,26,11,7,654,344,310,80,69,57,15,1
2145,1134,538,596,194,129,84,24,1748,791,957,281,247,173,25,1
2146,600,243,357,130,105,19,19,375,202,173,46,49,41,23,1
2147,651,306,345,85,64,61,32,193,94,99,34,17,25,19,1
2148,369,181,188,41,36,54,16,521,279,242,47,50,58,30,1
2149,567,323,244,71,62,62,23,3685,1574,2111,579,580,303,116,1
2150,258,141,117,39,35,27,8,386,191,195,61,54,31,21,1
2151,238,100,138,39,37,16,9,240,167,73,32,12,8,21,1
2152,667,360,307,76,92,46,27,297,158,139,47,37,37,9,1
2153,308,164,144,47,29,33,7,320,163,157,44,44,26,15,1
2154,963,532,431,99,110,105,44,144,63,81,28,32,11,5,1
2155,581,323,258,74,58,48,20,1210,592,618,157,138,116,85,1
2156,465,245,220,71,45,76,25,473,245,228,67,52,70,24,1
2157,298,167,131,47,33,40,8,693,289,404,95,158,61,15,1
2158,459,221,238,72,78,47,16,778,367,411,90,85,64,43,1
2159,416,182,234,62,67,37,17,502,299,203,57,52,32,11,1
2160,547,291,256,74,73,64,31,2758,1332,1426,394,384,287,131,1
2161,516,296,220,79,59,69,16,703,356,347,96,97,38,22,1
2162,712,380,332,69,74,57,30,510,264,246,67,66,38,29,1
2163,386,247,139,34,19,40,28,1037,575,462,122,150,82,32,1
2164,284,105,179,55,81,8,10,476,270,206,62,45,46,30,1
2165,957,385,572,173,168,62,33,504,256,248,78,70,36,9,1
2166,362,233,129,37,17,51,18,355,165,190,53,56,42,19,1
2167,474,208,266,65,69,43,36,377,202,175,46,50,41,23,1
2168,391,203,188,49,48,41,14,769,329,440,116,66,55,22,1
2169,999,425,574,141,122,101,98,988,422,566,141,115,105,101,1
2170,313,157,156,39,26,34,29,1163,417,746,209,145,87,28,1
2171,173,93,80,18,24,12,7,673,317,356,101,85,76,49,1
2172,427,218,209,107,27,31,15,947,482,465,143,107,89,37,1
2173,467,224,243,70,43,67,23,5497,2328,3169,872,896,436,168,1
2174,576,250,326,93,71,34,15,377,184,193,50,43,33,17,1
2175,188,97,91,27,16,24,21,327,177,150,40,40,38,18,1
2176,730,337,393,115,111,91,26,183,91,92,21,29,16,10,1
2177,1190,638,552,162,95,112,18,1684,707,977,256,196,178,72,1
2178,97,55,42,15,13,11,2,700,335,365,83,84,95,33,1
2179,146,75,71,13,32,15,11,777,387,390,90,87,65,37,1
2180,1212,645,567,145,117,122,72,354,137,217,53,57,30,5,1
2181,1190,638,552,162,95,112,18,656,358,298,67,47,64,26,1
2182,644,343,301,96,69,59,28,671,318,353,83,124,46,34,1
2183,1242,613,629,174,113,114,53,822,374,448,134,118,76,39,1
2184,548,250,298,85,64,56,21,395,189,206,63,50,49,28,1
2185,416,210,206,55,54,39,20,236,111,125,37,31,26,18,1
2186,153,71,82,28,20,15,7,213,76,137,63,36,13,2,1
2187,433,221,212,59,42,47,14,969,505,464,123,133,92,33,1
2188,247,110,137,34,45,23,10,644,331,313,90,67,55,16,1
2189,338,188,150,45,41,31,18,938,539,399,104,96,125,43,1
2190,185,83,102,30,19,21,8,565,285,280,72,73,47,31,1
2191,458,222,236,69,39,35,18,220,126,94,29,12,34,11,1
2192,2133,789,1344,342,419,135,88,158,85,73,24,18,18,8,1
2193,469,221,248,49,60,55,21,362,174,188,46,55,35,23,1
2194,101,41,60,18,19,10,5,778,367,411,90,85,64,43,1
2195,411,207,204,60,57,35,21,467,192,275,93,92,34,14,1
2196,393,186,207,58,50,36,22,339,183,156,43,45,28,17,1
2197,360,192,168,55,45,48,16,764,277,487,158,162,64,31,1
2198,509,254,255,67,55,52,35,204,99,105,32,32,22,10,1
2199,589,294,295,37,44,27,33,452,262,190,55,42,58,19,1
2200,4128,2104,2024,581,505,453,205,529,264,265,59,68,41,17,1
2201,367,197,170,49,36,36,18,499,272,227,49,66,66,21,1
2202,1657,800,857,249,235,154,51,781,418,363,92,90,64,41,1
2203,582,189,393,117,66,66,6,672,334,338,110,93,91,41,1
2204,335,148,187,52,26,51,12,443,208,235,43,55,51,50,1
2205,1167,418,749,226,204,88,39,313,149,164,49,40,39,19,1
2206,785,374,411,56,42,38,25,619,292,327,73,73,61,32,1
2207,381,206,175,42,53,36,20,1231,566,665,164,147,154,103,1
2208,1123,554,569,142,130,85,36,255,122,133,35,51,22,13,1
2209,684,288,396,107,90,54,42,650,304,346,80,106,62,28,1
2210,1217,566,651,215,170,102,23,219,124,95,22,22,23,5,1
2211,329,182,147,34,34,40,31,201,42,159,19,3,2,75,1
2212,573,278,295,58,79,37,23,538,252,286,77,87,53,30,1
2213,202,102,100,29,35,6,9,325,133,192,75,62,34,9,1
2214,806,436,370,101,100,76,34,589,316,273,83,60,69,25,1
2215,1887,1054,833,205,169,189,50,476,270,206,62,45,46,30,1
2216,464,206,258,60,50,39,40,197,106,91,43,19,16,12,1
2217,906,455,451,116,105,87,46,556,300,256,58,73,55,22,1
2218,344,181,163,45,49,40,24,356,199,157,43,58,29,12,1
2219,360,218,142,39,26,50,18,309,154,155,42,44,45,16,1
2220,280,136,144,41,34,26,16,482,231,251,76,81,64,26,1
2221,870,489,381,97,99,76,14,120,67,53,13,15,9,6,1
2222,413,227,186,47,64,26,16,239,146,93,30,22,35,9,1
2223,639,287,352,111,108,44,9,543,287,256,71,66,64,23,1
2224,594,274,320,89,63,66,28,1271,599,672,194,175,118,47,1
2225,86,50,36,9,14,8,7,167,79,88,22,26,16,9,1
2226,845,402,443,137,126,105,47,1271,599,672,194,175,118,47,1
2227,522,245,277,78,69,52,21,2871,1148,1723,496,469,204,98,1
2228,277,124,153,44,40,35,18,1147,471,676,229,164,86,37,1
2229,480,234,246,79,77,65,23,709,310,399,95,103,61,30,1
2230,916,442,474,150,133,91,32,323,168,155,47,35,26,9,1
2231,353,200,153,43,18,49,27,355,165,190,53,56,42,19,1
2232,245,122,123,21,32,18,13,189,102,87,28,17,22,5,1
2233,1210,592,618,157,138,116,85,532,276,256,57,50,32,19,1
2234,791,306,485,142,157,21,18,1202,506,696,209,198,74,44,1
2235,748,355,393,121,91,95,26,503,263,240,72,55,51,34,1
2236,377,177,200,63,53,44,16,477,281,196,38,41,63,29,1
2237,339,177,162,40,36,51,24,211,88,123,38,28,26,10,1
2238,2477,1186,1291,256,271,249,90,1690,1173,517,186,130,110,56,1
2239,2376,1263,1113,304,241,264,115,461,207,254,82,66,55,33,1
2240,2419,1042,1377,389,474,238,59,768,378,390,105,104,63,26,1
2241,432,218,214,57,55,42,11,329,182,147,34,34,40,31,1
2242,122,52,70,24,22,7,6,1117,423,694,182,134,88,31,1
2243,478,239,239,65,66,65,21,335,143,192,45,36,32,37,1
2244,668,347,321,89,50,60,41,201,42,159,19,3,2,75,1
2245,277,135,142,39,31,24,6,325,153,172,62,37,50,39,1
2246,373,183,190,49,37,33,18,299,140,159,27,59,20,18,1
2247,254,117,137,33,35,38,6,375,202,173,46,49,41,23,1
2248,751,350,401,119,77,94,40,923,471,452,119,117,119,41,1
2249,1272,651,621,178,194,79,59,930,367,563,181,153,83,48,1
2250,175,91,84,18,14,22,12,323,154,169,52,52,32,9,1
2251,430,218,212,58,47,34,20,436,205,231,39,51,26,20,1
2252,535,251,284,65,78,47,20,309,106,203,66,49,25,10,1
2253,770,356,414,123,102,66,25,544,259,285,76,81,40,20,1
2254,100,37,63,26,19,0,1,349,152,197,55,47,27,13,1
2255,892,397,495,146,63,65,37,218,133,85,20,19,13,6,1
2256,390,191,199,66,49,43,12,559,296,263,77,69,42,13,1
2257,745,391,354,85,81,52,39,1255,708,547,120,68,88,7,1
2258,642,271,371,106,111,57,23,718,283,435,126,127,34,29,1
2259,1382,689,693,186,176,167,77,1132,553,579,172,143,150,57,1
2260,255,126,129,41,37,13,5,790,385,405,121,108,106,39,1
2261,1210,592,618,157,138,116,85,451,239,212,53,64,56,22,1
2262,794,390,404,103,95,86,23,369,181,188,41,36,54,16,1
2263,704,356,348,106,97,82,42,170,82,88,28,23,20,12,1
2264,456,228,228,49,70,32,19,495,233,262,74,59,46,12,1
2265,418,205,213,69,50,29,15,189,93,96,24,28,17,12,1
2266,822,416,406,111,105,84,44,194,94,100,35,19,25,16,1
2267,485,187,298,95,71,61,25,736,388,348,88,85,67,28,1
2268,765,407,358,89,75,90,42,496,247,249,82,69,47,14,1
2269,537,276,261,75,68,68,22,2758,1332,1426,394,384,287,131,1
2270,2414,1189,1225,277,178,170,169,454,214,240,56,71,35,16,1
2271,926,435,491,133,132,85,17,1205,632,573,156,149,102,48,1
2272,137,63,74,19,19,10,7,145,75,70,21,18,18,8,1
2273,89,42,47,16,12,15,6,584,322,262,78,67,62,26,1
2274,287,129,158,48,48,20,9,462,233,229,66,49,43,30,1
2275,223,99,124,24,26,27,33,955,530,425,128,90,75,59,1
2276,156,77,79,45,14,12,2,1115,586,529,124,161,111,69,1
2277,95,44,51,14,13,7,4,366,204,162,47,41,31,23,1
2278,177,67,110,34,24,13,10,788,360,428,93,106,67,72,1
2279,336,154,182,51,48,39,22,551,237,314,95,79,54,17,1
2280,627,314,313,61,59,71,22,601,313,288,42,48,25,36,1
2281,621,273,348,104,102,48,19,632,280,352,111,96,55,16,1
2282,135,65,70,21,25,15,9,422,203,219,75,49,40,22,1
2283,1098,432,666,166,199,76,28,375,202,173,46,49,41,23,1
2284,354,168,186,50,53,39,20,87,48,39,15,9,9,3,1
2285,535,249,286,79,64,55,22,1338,756,582,155,105,104,44,1
2286,5497,2328,3169,872,896,436,168,472,220,252,59,69,32,20,1
2287,380,195,185,37,47,61,19,146,85,61,15,9,12,10,1
2288,207,105,102,35,27,15,5,1484,731,753,206,175,187,71,1
2289,560,348,212,62,55,30,16,573,319,254,60,60,52,32,1
2290,391,208,183,65,49,57,17,229,103,126,28,44,17,5,1
2291,1690,795,895,271,257,150,101,928,442,486,139,118,91,43,1
2292,193,83,110,26,20,16,9,395,187,208,50,67,27,11,1
2293,445,228,217,47,62,53,26,72,35,37,10,9,7,6,1
2294,375,167,208,55,83,44,9,391,208,183,65,49,57,17,1
2295,1527,633,894,314,260,134,67,1052,492,560,184,163,103,44,1
2296,549,303,246,64,54,59,35,288,156,132,37,32,22,11,1
2297,676,333,343,111,89,94,39,750,347,403,105,103,83,29,1
2298,300,140,160,39,35,14,12,236,121,115,26,45,28,6,1
2299,331,169,162,40,28,22,14,271,110,161,33,27,11,8,1
2300,770,390,380,104,76,78,32,160,67,93,32,37,15,9,1
2301,94,45,49,11,20,10,4,432,188,244,76,81,26,13,1
2302,1006,468,538,151,135,82,39,216,119,97,33,27,28,7,1
2303,530,259,271,83,50,54,41,433,226,207,52,60,58,20,1
2304,1118,551,567,128,145,95,36,901,423,478,106,117,83,38,1
2305,556,279,277,83,69,71,19,525,274,251,82,74,60,25,1
2306,447,179,268,81,49,35,29,499,252,247,74,42,55,14,1
2307,819,473,346,75,105,69,16,781,418,363,92,90,64,41,1
2308,1581,684,897,220,153,118,63,444,212,232,74,25,60,24,1
2309,635,333,302,99,75,83,28,550,243,307,91,99,70,10,1
2310,1424,650,774,152,124,95,87,461,223,238,66,57,36,23,1
2311,741,350,391,109,102,75,32,211,126,85,21,20,28,7,1
2312,322,164,158,46,44,29,7,292,152,140,46,38,35,12,1
2313,1342,673,669,178,154,137,94,724,334,390,112,109,79,17,1
2314,1233,498,735,252,232,88,41,719,364,355,104,100,58,34,1
2315,303,159,144,40,35,35,8,1367,690,677,172,175,154,83,1
2316,707,388,319,85,61,68,23,665,297,368,111,107,34,12,1
2317,355,168,187,48,57,30,15,691,307,384,93,128,45,19,1
2318,446,176,270,64,79,45,24,668,347,321,89,50,60,41,1
2319,848,394,454,100,90,101,41,2414,1189,1225,277,178,170,169,1
2320,200,90,110,22,29,10,13,249,111,138,40,30,22,17,1
2321,595,316,279,86,60,65,40,462,233,229,66,49,43,30,1
2322,801,449,352,95,90,100,15,348,187,161,48,41,47,15,1
2323,192,96,96,32,21,18,7,601,313,288,42,48,25,36,1
2324,247,110,137,34,45,23,10,1341,481,860,275,264,57,21,1
2325,281,138,143,50,36,27,16,1434,727,707,210,173,161,54,1
2326,432,218,214,57,55,42,11,115,58,57,10,7,9,22,1
2327,359,185,174,42,48,22,26,769,329,440,116,66,55,22,1
2328,1210,578,632,172,184,94,66,632,326,306,92,71,56,19,1
2329,505,239,266,71,55,50,18,191,85,106,24,34,19,5,1
2330,204,96,108,31,37,20,5,191,99,92,25,24,18,8,1
2331,467,226,241,55,48,54,23,436,199,237,70,55,47,22,1
2332,354,137,217,53,57,30,5,5038,2652,2386,655,729,544,245,1
2333,215,91,124,23,39,5,5,189,102,87,28,17,22,5,1
2334,450,270,180,64,39,33,17,431,219,212,68,46,67,18,1
2335,564,305,259,82,64,57,27,572,312,260,80,65,55,25,1
2336,582,330,252,82,69,87,21,211,112,99,30,15,34,18,1
2337,377,177,200,63,53,44,16,499,252,247,75,71,65,25,1
2338,324,174,150,37,24,35,27,256,153,103,19,23,23,8,1
2339,2471,1130,1341,240,281,219,290,465,225,240,65,44,65,25,1
2340,436,205,231,39,51,26,20,342,185,157,42,27,31,14,1
2341,1009,506,503,146,141,97,55,537,276,261,75,68,68,22,1
2342,276,151,125,44,36,26,9,579,246,333,102,79,41,19,1
2343,521,275,246,51,35,37,28,236,121,115,39,20,44,15,1
2344,601,313,288,42,48,25,36,1222,649,573,136,140,132,36,1
2345,981,465,516,126,164,112,38,573,247,326,98,95,46,22,1
2346,928,442,486,139,118,91,43,134,60,74,19,13,10,7,1
2347,246,108,138,32,44,21,10,1807,933,874,248,203,173,71,1
2348,722,388,334,105,85,68,36,686,375,311,89,80,63,20,1
2349,404,190,214,55,55,35,27,1190,638,552,162,95,112,18,1
2350,365,170,195,49,30,41,10,262,144,118,19,39,22,8,1
2351,928,442,486,139,118,91,43,1616,735,881,285,248,153,72,1
2352,480,244,236,74,47,50,21,1047,562,485,141,127,114,41,1
2353,1377,579,798,179,169,139,99,152,74,78,17,20,16,6,1
2354,201,108,93,36,21,17,4,465,225,240,65,44,65,25,1
2355,505,275,230,63,57,35,12,1434,727,707,210,173,161,54,1
2356,858,441,417,110,135,90,40,736,388,348,88,85,67,28,1
2357,246,106,140,45,26,37,14,609,292,317,102,96,64,21,1
2358,330,157,173,56,42,51,8,539,284,255,75,73,55,26,1
2359,159,84,75,13,28,10,8,595,316,279,86,60,65,40,1
2360,89,42,47,16,12,15,6,2058,933,1125,317,304,250,74,1
2361,508,295,213,42,61,53,17,1400,800,600,158,134,150,65,1
2362,255,109,146,35,32,23,17,149,68,81,15,38,11,10,1
2363,928,442,486,139,118,91,43,295,143,152,38,47,22,25,1
2364,96,50,46,8,15,6,2,103,51,52,15,17,6,5,1
2365,1382,599,783,208,252,90,39,1832,784,1048,330,229,199,102,1
2366,676,333,343,111,89,94,39,372,237,135,38,22,39,26,1
2367,1099,493,606,179,157,108,51,559,296,263,77,69,42,13,1
2368,275,125,150,37,48,27,7,162,77,85,22,16,21,11,1
2369,89,42,47,16,12,15,6,838,431,407,107,90,107,43,1
2370,465,225,240,65,44,65,25,552,285,267,74,51,69,24,1
2371,360,192,168,55,45,48,16,1807,933,874,248,203,173,71,1
2372,441,193,248,78,62,52,27,291,146,145,39,45,22,16,1
2373,476,251,225,57,67,57,18,101,55,46,13,15,12,3,1
2374,253,133,120,40,22,27,13,673,317,356,101,85,76,49,1
2375,780,337,443,112,116,77,28,1132,646,486,99,102,71,41,1
2376,216,109,107,32,26,35,10,797,395,402,107,117,77,22,1
2377,418,199,219,55,44,22,15,502,299,203,57,52,32,11,1
2378,412,216,196,24,48,18,16,3396,1499,1897,325,572,309,90,1
2379,245,111,134,31,44,20,11,467,224,243,70,43,67,23,1
2380,624,204,420,166,101,32,13,344,109,235,100,39,26,5,1
2381,834,405,429,112,95,84,34,303,159,144,40,35,35,8,1
2382,426,228,198,62,42,47,22,334,171,163,48,42,32,18,1
2383,253,125,128,37,39,25,11,864,429,435,129,118,68,35,1
2384,450,233,217,68,45,45,17,393,186,207,58,50,36,22,1
2385,1307,594,713,179,208,102,41,573,247,326,98,95,46,22,1
2386,920,289,631,237,141,98,11,233,121,112,24,31,30,7,1
2387,453,228,225,58,61,40,18,177,99,78,22,23,20,10,1
2388,381,189,192,74,49,44,13,764,409,355,88,73,102,43,1
2389,477,256,221,69,66,70,12,402,222,180,50,39,51,19,1
2390,436,182,254,61,76,49,33,582,330,252,82,69,87,21,1
2391,561,275,286,85,62,87,22,731,340,391,95,83,81,32,1
2392,840,468,372,96,85,121,29,267,124,143,45,46,26,4,1
2393,505,277,228,70,57,45,20,101,41,60,18,19,10,5,1
2394,897,487,410,92,97,83,31,750,347,403,105,103,83,29,1
2395,400,191,209,51,60,30,9,725,365,360,104,111,70,31,1
2396,845,402,443,137,126,105,47,191,99,92,25,24,18,8,1
2397,966,530,436,128,119,134,29,1304,585,719,179,169,154,47,1
2398,1378,680,698,160,154,111,38,204,80,124,29,51,10,5,1
2399,298,154,144,44,34,25,11,1210,592,618,157,138,116,85,1
2400,165,80,85,21,9,18,19,133,69,64,25,18,10,5,1
2401,1208,575,633,187,204,117,41,1290,658,632,145,139,94,44,1
2402,670,316,354,84,69,47,24,414,194,220,76,66,49,16,1
2403,1219,599,620,159,198,155,42,141,69,72,18,17,13,7,1
2404,272,135,137,34,30,31,8,220,106,114,32,26,15,7,1
2405,583,322,261,73,66,45,26,1271,599,672,194,175,118,47,1
2406,1069,512,557,148,126,84,36,440,246,194,62,49,41,16,1
2407,146,71,75,20,17,8,7,1454,780,674,182,120,135,67,1
2408,837,444,393,128,89,87,37,838,386,452,108,132,45,29,1
2409,618,290,328,82,74,69,42,416,201,215,54,52,39,25,1
2410,107,36,71,27,15,0,1,325,152,173,43,47,28,17,1
2411,655,269,386,128,129,49,21,433,237,196,60,52,33,27,1
2412,450,215,235,73,72,53,18,422,213,209,59,47,42,14,1
2413,140,70,70,22,17,9,4,205,106,99,28,26,23,3,1
2414,758,360,398,114,107,51,19,541,279,262,79,82,31,32,1
2415,883,403,480,140,119,85,38,346,183,163,51,38,23,6,1
2416,1210,592,618,157,138,116,85,1255,708,547,120,68,88,7,1
2417,1210,592,618,157,138,116,85,524,237,287,87,75,54,26,1
2418,793,240,553,196,206,28,13,149,68,81,15,38,11,10,1
2419,419,175,244,71,73,23,23,149,77,72,19,15,18,9,1
2420,869,488,381,110,77,78,30,393,186,207,58,50,36,22,1
2421,963,532,431,99,110,105,44,158,85,73,24,18,18,8,1
2422,428,248,180,44,39,28,9,345,203,142,47,35,31,11,1
2423,347,192,155,50,33,28,19,620,348,272,91,43,59,29,1
2424,1278,593,685,198,201,71,43,254,136,118,42,36,28,8,1
2425,534,266,268,86,62,37,14,176,73,103,22,29,13,9,1
2426,461,221,240,70,64,56,32,101,57,44,14,8,6,6,1
2427,501,240,261,80,62,49,42,309,106,203,66,49,25,10,1
2428,654,409,245,88,73,20,24,143,79,64,16,25,7,5,1
2429,651,340,311,81,84,80,29,588,266,322,99,79,87,28,1
2430,651,323,328,90,65,64,24,799,377,422,98,95,80,70,1
2431,1304,585,719,179,169,154,47,509,262,247,64,70,64,20,1
2432,347,212,135,35,32,17,6,425,210,215,56,43,52,25,1
2433,1362,633,729,220,150,93,43,930,367,563,181,153,83,48,1
2434,406,192,214,60,45,45,24,624,222,402,92,81,39,15,1
2435,391,208,183,65,49,57,17,107,36,71,27,15,0,1,1
2436,307,133,174,48,53,27,10,121,57,64,21,10,8,11,1
2437,467,226,241,55,48,54,23,422,213,209,63,60,35,13,1
2438,414,193,221,54,49,45,28,280,136,144,41,34,26,16,1
2439,465,229,236,68,62,40,22,217,98,119,33,32,27,7,1
2440,444,236,208,64,53,51,23,488,217,271,71,71,50,32,1
2441,1074,538,536,154,140,111,51,1134,574,560,157,164,47,48,1
2442,587,315,272,84,55,70,32,331,183,148,36,44,40,21,1
2443,1247,548,699,168,150,140,43,473,212,261,72,64,45,28,1
2444,367,197,170,49,36,36,18,458,222,236,69,39,35,18,1
2445,424,179,245,65,67,29,11,736,320,416,113,97,61,36,1
2446,488,217,271,71,71,50,32,676,319,357,83,86,62,46,1
2447,367,169,198,66,57,42,14,375,202,173,46,49,41,23,1
2448,870,489,381,97,99,76,14,1865,918,947,300,256,217,76,1
2449,400,191,209,51,60,30,9,1242,587,655,276,98,179,46,1
2450,1153,535,618,204,158,93,50,175,90,85,28,21,19,7,1
2451,140,86,54,17,6,20,7,525,299,226,54,54,51,19,1
2452,208,96,112,31,32,13,9,468,243,225,60,50,34,32,1
2453,44,13,31,9,11,1,2,375,202,173,46,49,41,23,1
2454,779,390,389,108,95,95,42,943,462,481,149,135,97,37,1
2455,406,210,196,68,60,25,20,462,233,229,66,49,43,30,1
2456,548,250,298,85,64,56,21,595,316,279,86,60,65,40,1
2457,392,115,277,117,75,28,17,170,35,135,33,25,8,5,1
2458,378,222,156,49,17,45,26,354,169,185,54,54,41,19,1
2459,780,370,410,107,120,75,22,1270,557,713,130,195,57,30,1
2460,184,94,90,31,21,24,9,399,208,191,57,46,41,20,1
2461,557,278,279,75,70,66,31,1403,520,883,252,271,97,43,1
2462,758,360,398,114,107,51,19,292,154,138,46,29,41,7,1
2463,274,142,132,33,34,18,14,154,78,76,23,21,13,5,1
2464,254,115,139,41,31,28,7,440,267,173,52,29,42,12,1
2465,676,333,343,111,89,94,39,413,227,186,45,34,58,23,1
2466,906,474,432,90,125,74,24,2442,1193,1249,278,183,170,145,1
2467,396,268,128,34,12,41,6,318,176,142,25,32,35,25,1
2468,406,202,204,54,54,41,16,393,186,207,58,50,36,22,1
2469,399,216,183,60,53,43,18,418,226,192,57,57,53,17,1
2470,956,456,500,93,144,84,63,1172,521,651,132,180,129,80,1
2471,556,199,357,125,112,22,13,136,65,71,33,11,9,6,1
2472,555,278,277,60,70,48,18,770,355,415,103,142,75,42,1
2473,522,235,287,78,67,60,50,213,88,125,30,20,12,19,1
2474,492,317,175,42,31,63,23,327,177,150,40,40,38,18,1
2475,427,236,191,49,54,46,13,415,217,198,49,51,50,23,1
2476,1049,484,565,120,117,59,26,508,267,241,43,35,25,17,1
2477,1194,646,548,139,125,127,59,2758,1332,1426,394,384,287,131,1
2478,163,70,93,28,21,17,6,331,169,162,40,28,22,14,1
2479,474,258,216,63,48,51,24,304,159,145,38,40,32,3,1
2480,1972,846,1126,222,330,114,68,1863,721,1142,262,283,139,74,1
2481,1356,576,780,229,198,107,38,1234,590,644,180,182,95,40,1
2482,125,63,62,20,16,15,7,2803,1300,1503,392,510,170,57,1
2483,288,118,170,50,57,18,15,599,387,212,44,36,97,35,1
2484,1124,615,509,157,125,128,52,770,374,396,95,91,79,41,1
2485,409,208,201,33,45,23,10,654,295,359,99,88,71,25,1
2486,2468,1038,1430,333,465,167,62,350,181,169,44,52,43,13,1
2487,422,203,219,75,49,40,22,245,111,134,31,44,20,11,1
2488,390,207,183,50,48,38,15,393,186,207,58,50,36,22,1
2489,178,100,78,23,22,30,6,1255,666,589,145,142,120,82,1
2490,334,161,173,55,42,38,16,318,212,106,16,15,41,16,1
2491,298,181,117,43,23,40,12,318,176,142,25,32,35,25,1
2492,782,347,435,110,92,74,34,524,264,260,75,75,40,21,1
2493,607,269,338,99,90,52,21,275,139,136,42,42,43,13,1
2494,4544,2024,2520,579,628,480,403,418,213,205,54,56,49,13,1
2495,1210,592,618,157,138,116,85,252,114,138,41,35,22,12,1
2496,592,264,328,86,85,62,41,501,216,285,79,70,54,30,1
2497,151,84,67,17,17,22,11,1210,592,618,157,138,116,85,1
2498,475,251,224,67,49,48,23,1074,539,535,136,87,87,66,1
2499,1123,554,569,142,130,85,36,117,62,55,24,18,21,2,1
2500,479,227,252,65,79,42,26,606,279,327,81,70,49,34,1
2501,292,175,117,37,29,21,14,938,484,454,137,100,104,41,1
2502,530,259,271,83,50,54,41,327,177,150,56,20,25,6,1
2503,575,301,274,84,65,63,20,164,88,76,27,20,17,6,1
2504,941,504,437,119,86,103,44,961,507,454,130,102,115,37,1
2505,417,212,205,55,50,54,24,463,231,232,66,69,29,18,1
2506,468,215,253,65,60,34,13,529,274,255,57,62,38,14,1
2507,815,418,397,97,62,70,17,204,106,98,35,22,24,6,1
2508,976,496,480,128,111,121,48,228,139,89,24,21,32,18,1
2509,754,318,436,114,106,58,28,2414,1189,1225,277,178,170,169,1
2510,863,417,446,130,112,53,29,205,100,105,25,25,20,9,1
2511,894,420,474,136,146,93,39,714,364,350,98,102,91,27,1
2512,2442,1193,1249,278,183,170,145,740,313,427,101,135,40,22,1
2513,501,240,261,80,62,49,42,554,254,300,104,58,66,28,1
2514,1190,638,552,162,95,112,18,1231,603,628,121,162,109,120,1
2515,393,186,207,58,50,36,22,428,226,202,52,60,75,20,1
2516,442,230,212,50,58,56,23,322,143,179,41,62,23,11,1
2517,667,360,307,76,92,46,27,858,461,397,125,114,79,45,1
2518,226,90,136,43,43,26,7,1117,423,694,182,134,88,31,1
2519,133,69,64,26,12,8,4,327,177,150,40,40,38,18,1
2520,656,358,298,67,47,64,26,495,176,319,116,111,31,24,1
2521,385,179,206,58,56,38,19,579,321,258,74,70,47,22,1
2522,684,288,396,107,90,54,42,3259,1163,2096,526,657,162,86,1
2523,605,283,322,94,72,64,39,147,79,68,20,15,19,8,1
2524,1024,486,538,186,113,94,51,220,101,119,50,22,23,6,1
2525,3056,1457,1599,438,389,329,168,174,87,87,26,16,25,2,1
2526,911,489,422,121,98,97,36,928,442,486,139,118,91,43,1
2527,682,260,422,98,83,42,31,1290,597,693,182,182,119,63,1
2528,228,118,110,32,29,36,13,986,499,487,123,116,98,54,1
2529,437,228,209,47,61,26,11,969,505,464,123,133,92,33,1
2530,330,143,187,63,29,52,20,261,102,159,45,36,31,37,1
2531,703,253,450,130,124,51,32,176,73,103,22,29,13,9,1
2532,2540,1065,1475,426,322,239,78,462,233,229,66,49,43,30,1
2533,163,80,83,25,21,20,10,1024,486,538,186,113,94,51,1
2534,1271,599,672,194,175,118,47,1290,629,661,191,187,167,55,1
2535,393,186,207,58,50,36,22,710,307,403,117,176,37,9,1
2536,209,78,131,33,42,11,7,217,108,109,30,23,28,10,1
2537,1313,644,669,169,90,111,43,330,143,187,63,29,52,20,1
2538,802,388,414,131,105,96,29,304,127,177,61,38,31,4,1
2539,1395,627,768,172,263,141,59,460,274,186,50,34,69,27,1
2540,2261,1217,1044,271,243,267,101,364,189,175,48,40,32,20,1
2541,1893,850,1043,280,340,169,80,497,185,312,63,92,38,28,1
2542,148,64,84,33,19,6,1,505,247,258,72,71,60,27,1
2543,355,186,169,54,41,35,15,1163,615,548,122,109,128,41,1
2544,824,397,427,113,95,82,33,118,51,67,25,13,6,7,1
2545,894,492,402,95,103,88,42,369,181,188,41,36,54,16,1
2546,481,268,213,54,48,53,14,170,80,90,31,22,12,8,1
2547,68,33,35,9,3,4,4,395,186,209,53,48,46,30,1
2548,346,186,160,48,32,35,14,536,278,258,72,63,62,20,1
2549,942,528,414,136,101,87,48,193,99,94,31,31,16,12,1
2550,1261,694,567,159,130,136,70,592,291,301,92,93,71,31,1
2551,835,420,415,104,105,57,47,345,203,142,47,35,31,11,1
2552,502,299,203,57,52,32,11,537,276,261,75,68,68,22,1
2553,498,233,265,83,53,65,23,393,186,207,58,50,36,22,1
2554,673,329,344,111,95,92,41,308,159,149,52,41,22,10,1
2555,1551,789,762,222,210,127,47,191,99,92,25,24,18,8,1
2556,303,175,128,43,36,34,12,307,154,153,39,36,31,12,1
2557,1332,637,695,214,178,117,40,508,267,241,57,49,40,13,1
2558,362,192,170,44,33,17,21,1613,806,807,190,211,180,84,1
2559,330,208,122,44,20,44,12,246,108,138,32,44,21,10,1
2560,406,211,195,55,37,47,16,866,382,484,116,114,91,28,1
2561,1388,535,853,241,239,96,52,1117,423,694,182,134,88,31,1
2562,608,336,272,61,49,78,31,551,298,253,63,65,45,19,1
2563,611,246,365,116,82,71,27,861,393,468,150,101,69,35,1
2564,255,113,142,45,30,24,13,355,169,186,49,37,26,11,1
2565,764,409,355,88,73,102,43,770,374,396,95,91,79,41,1
2566,402,222,180,50,39,51,19,430,192,238,62,67,27,10,1
2567,701,368,333,90,81,39,27,211,114,97,32,24,19,10,1
2568,651,331,320,93,93,51,28,355,169,186,49,37,26,11,1
2569,443,248,195,67,54,40,15,2442,1193,1249,278,183,170,145,1
2570,816,463,353,99,99,61,26,507,242,265,53,44,31,22,1
2571,1212,645,567,145,117,122,72,149,68,81,15,38,11,10,1
2572,596,286,310,90,89,78,37,346,167,179,56,52,28,13,1
2573,552,285,267,74,51,69,24,1068,527,541,160,131,112,52,1
2574,1342,673,669,178,154,137,94,728,385,343,110,102,69,14,1
2575,313,167,146,56,28,30,11,834,405,429,112,95,84,34,1
2576,462,251,211,74,53,41,18,221,110,111,28,32,25,11,1
2577,778,353,425,140,89,92,51,719,301,418,122,132,42,26,1
2578,284,128,156,48,29,34,8,246,115,131,15,29,10,32,1
2579,857,455,402,135,81,104,40,1922,923,999,267,275,215,90,1
2580,255,126,129,36,20,21,29,177,96,81,18,13,25,11,1
2581,501,240,261,80,62,49,42,753,318,435,154,95,56,23,1
2582,458,225,233,67,61,43,33,1441,657,784,140,135,81,73,1
2583,526,210,316,129,48,56,13,221,75,146,68,21,16,5,1
2584,330,159,171,48,38,50,19,301,150,151,41,30,17,11,1
2585,1107,601,506,155,138,104,49,368,177,191,41,56,30,27,1
2586,209,96,113,35,28,22,13,331,177,154,46,38,49,17,1
2587,870,433,437,133,121,95,25,1205,632,573,156,149,102,48,1
2588,1865,943,922,270,209,228,91,304,127,177,61,38,31,4,1
2589,847,402,445,137,119,102,41,572,309,263,64,55,47,29,1
2590,532,276,256,57,50,32,19,272,122,150,33,30,27,26,1
2591,940,425,515,145,122,42,29,377,202,175,46,50,41,23,1
2592,670,333,337,95,79,62,21,863,450,413,116,122,106,41,1
2593,745,366,379,110,93,79,45,551,298,253,63,65,45,19,1
2594,451,237,214,74,59,65,19,1342,673,669,178,154,137,94,1
2595,920,492,428,100,92,88,49,169,87,82,28,23,20,6,1
2596,659,325,334,102,85,87,32,296,154,142,38,38,24,16,1
2597,424,209,215,56,58,45,24,1523,758,765,188,183,157,58,1
2598,486,236,250,73,67,59,16,2843,1104,1739,429,357,178,95,1
2599,160,77,83,14,27,11,10,1608,778,830,243,230,159,74,1
2600,454,224,230,71,39,62,22,876,473,403,110,106,73,24,1
2601,1068,527,541,160,131,112,52,298,167,131,47,33,40,8,1
2602,230,133,97,23,19,20,15,357,169,188,61,53,32,15,1
2603,1065,495,570,197,115,100,36,349,186,163,43,45,51,12,1
2604,731,372,359,101,80,58,21,219,124,95,22,22,23,5,1
2605,231,126,105,37,26,29,6,453,217,236,65,72,29,13,1
2606,451,222,229,72,46,57,17,503,263,240,72,55,51,34,1
2607,921,593,328,104,86,42,23,757,333,424,81,132,61,54,1
2608,377,184,193,50,43,33,17,202,102,100,29,35,6,9,1
2609,441,216,225,57,66,57,19,969,505,464,123,133,92,33,1
2610,359,219,140,42,19,56,19,689,343,346,119,100,86,38,1
2611,248,143,105,25,29,21,13,248,144,104,24,30,21,15,1
2612,1218,499,719,147,141,119,145,1834,823,1011,297,282,151,63,1
2613,366,211,155,35,42,24,12,354,137,217,53,57,30,5,1
2614,430,218,212,58,47,34,20,552,264,288,82,64,48,20,1
2615,743,346,397,91,90,62,10,206,94,112,37,36,18,9,1
2616,481,283,198,37,24,42,15,896,407,489,97,152,70,22,1
2617,776,401,375,81,122,54,16,249,111,138,40,30,22,17,1
2618,561,279,282,85,81,88,24,323,181,142,40,37,26,16,1
2619,872,473,399,124,100,93,27,149,68,81,15,38,11,10,1
2620,876,457,419,88,124,67,47,529,274,255,57,62,38,14,1
2621,338,164,174,45,32,37,13,229,120,109,31,30,22,9,1
2622,624,308,316,92,72,68,22,583,322,261,73,66,45,26,1
2623,504,237,267,62,66,48,17,418,218,200,53,50,39,9,1
2624,1042,530,512,162,150,103,52,272,173,99,32,32,11,8,1
2625,414,211,203,45,44,41,24,873,366,507,127,125,75,21,1
2626,707,386,321,85,83,99,28,99,50,49,18,11,8,6,1
2627,396,192,204,71,41,51,15,955,530,425,128,90,75,59,1
2628,95,47,48,13,12,10,4,334,96,238,104,49,19,2,1
2629,350,200,150,45,47,23,8,168,76,92,26,21,19,4,1
2630,80,42,38,12,7,7,4,133,66,67,21,24,9,2,1
2631,140,86,54,17,6,20,7,947,506,441,105,126,75,14,1
2632,619,332,287,95,77,74,38,304,159,145,38,40,32,3,1
2633,555,278,277,60,70,48,18,769,362,407,99,88,66,67,1
2634,208,80,128,26,22,13,16,236,121,115,26,45,28,6,1
2635,100,50,50,15,13,10,4,297,123,174,51,49,16,10,1
2636,834,405,429,112,95,84,34,1074,538,536,154,140,111,51,1
2637,913,393,520,160,165,87,40,445,219,226,61,60,60,21,1
2638,639,373,266,77,89,68,25,117,62,55,24,18,21,2,1
2639,605,281,324,111,67,40,44,621,301,320,76,64,46,34,1
2640,284,167,117,35,25,28,8,217,115,102,40,24,26,6,1
2641,530,244,286,103,62,42,20,331,169,162,40,28,22,14,1
2642,595,292,303,79,83,69,24,1675,875,800,213,219,196,72,1
2643,313,166,147,47,44,41,10,418,189,229,76,72,45,14,1
2644,546,267,279,90,69,56,19,129,70,59,29,9,7,2,1
2645,802,344,458,156,136,57,24,734,366,368,121,99,63,39,1
2646,465,220,245,88,34,61,23,2442,1193,1249,278,183,170,145,1
2647,1217,496,721,230,214,94,42,1233,498,735,252,232,88,41,1
2648,1721,838,883,241,218,144,54,537,288,249,60,60,61,19,1
2649,183,78,105,30,31,26,8,401,167,234,56,71,16,10,1
2650,1113,401,712,196,186,53,44,293,145,148,49,41,25,9,1
2651,296,147,149,45,29,30,23,742,303,439,88,96,86,23,1
2652,1848,833,1015,304,257,195,71,425,210,215,56,43,52,25,1
2653,673,317,356,101,85,76,49,214,119,95,25,27,18,7,1
2654,1210,592,618,157,138,116,85,178,100,78,23,22,30,6,1
2655,561,300,261,86,73,87,24,760,391,369,101,109,65,24,1
2656,745,391,354,85,81,52,39,1425,670,755,153,189,122,85,1
2657,620,305,315,97,80,87,28,217,109,108,34,32,35,7,1
2658,1591,704,887,253,227,156,50,177,99,78,22,23,20,10,1
2659,619,293,326,98,78,65,22,389,210,179,51,37,43,9,1
2660,333,192,141,50,48,28,10,492,317,175,42,31,63,23,1
2661,166,86,80,24,19,17,10,895,474,421,122,93,69,25,1
2662,748,387,361,90,81,80,48,503,263,240,72,55,51,34,1
2663,728,385,343,110,102,69,14,976,496,480,128,111,121,48,1
2664,777,387,390,90,87,65,37,522,239,283,75,88,45,11,1
2665,310,142,168,42,39,24,9,349,131,218,66,76,22,9,1
2666,553,261,292,73,79,40,26,377,202,175,46,50,41,23,1
2667,412,203,209,65,47,37,18,482,284,198,63,49,40,13,1
2668,427,204,223,38,57,26,32,653,272,381,107,93,59,28,1
2669,2817,1216,1601,379,436,183,115,533,297,236,74,57,39,28,1
2670,323,181,142,40,37,26,16,329,171,158,49,41,31,10,1
2671,1328,661,667,210,147,126,55,476,270,206,62,45,46,30,1
2672,589,294,295,37,44,27,33,627,351,276,78,62,71,32,1
2673,743,233,510,148,142,28,17,985,551,434,123,93,91,26,1
2674,184,95,89,17,21,18,8,193,118,75,20,21,24,6,1
2675,530,183,347,121,98,29,13,2035,1087,948,163,129,96,73,1
2676,220,142,78,15,12,17,15,1748,791,957,281,247,173,25,1
2677,99,50,49,18,11,8,6,101,57,44,14,8,6,6,1
2678,417,212,205,55,50,54,24,400,222,178,56,43,54,12,1
2679,834,405,429,112,95,84,34,476,270,206,62,45,46,30,1
2680,331,169,162,40,28,22,14,706,320,386,111,76,75,51,1
2681,2440,1061,1379,377,326,172,62,468,233,235,65,61,49,34,1
2682,379,218,161,63,36,45,16,2556,1169,1387,248,291,227,275,1
2683,134,63,71,27,9,6,8,378,222,156,39,25,51,25,1
2684,2157,1033,1124,365,281,199,63,377,202,175,46,50,41,23,1
2685,198,98,100,30,21,21,8,622,309,313,75,81,76,29,1
2686,538,286,252,80,58,48,14,3433,1476,1957,522,578,264,123,1
2687,171,94,77,24,28,30,11,131,66,65,21,14,23,7,1
2688,412,216,196,24,48,18,16,830,402,428,80,67,100,80,1
2689,394,240,154,46,36,59,28,776,401,375,81,122,54,16,1
2690,697,373,324,105,83,95,38,736,388,348,88,85,67,28,1
2691,590,279,311,103,83,69,30,424,248,176,45,27,46,23,1
2692,565,285,280,72,73,47,31,824,392,432,106,89,88,32,1
2693,432,219,213,58,51,39,20,632,326,306,92,71,56,19,1
2694,688,330,358,122,97,92,39,446,252,194,41,23,54,35,1
2695,431,219,212,68,46,67,18,513,274,239,67,66,62,35,1
2696,313,159,154,30,40,23,14,694,315,379,101,87,47,17,1
2697,2220,1085,1135,312,304,202,91,525,281,244,69,68,65,25,1
2698,1566,743,823,261,188,151,48,476,270,206,62,45,46,30,1
2699,794,390,404,103,95,86,23,2524,1232,1292,398,317,186,61,1
2700,2414,1189,1225,277,178,170,169,437,212,225,66,44,44,11,1
2701,622,328,294,75,42,67,31,620,348,272,91,43,59,29,1
2702,979,493,486,161,112,95,31,1074,538,536,154,140,111,51,1
2703,1270,682,588,165,147,136,54,331,169,162,40,28,22,14,1
2704,587,311,276,84,66,60,25,467,224,243,70,43,67,23,1
2705,411,207,204,51,38,40,15,399,201,198,65,45,48,17,1
2706,756,362,394,102,104,73,25,1863,721,1142,262,283,139,74,1
2707,1118,471,647,204,164,102,34,217,109,108,34,32,35,7,1
2708,826,362,464,107,118,71,43,379,203,176,55,48,45,16,1
2709,975,400,575,160,162,62,31,1278,593,685,198,201,71,43,1
2710,469,232,237,50,66,41,18,96,50,46,8,15,6,2,1
2711,963,553,410,126,103,79,26,218,121,97,29,26,21,6,1
2712,253,125,128,37,39,25,11,245,112,133,32,45,20,10,1
2713,180,96,84,21,22,17,15,1474,756,718,175,158,169,51,1
2714,393,196,197,56,47,41,26,402,227,175,48,40,35,11,1
2715,172,88,84,24,31,20,12,1020,554,466,118,123,88,53,1
2716,324,154,170,57,40,26,4,433,221,212,59,42,47,14,1
2717,395,189,206,63,50,49,28,782,372,410,127,111,89,36,1
2718,619,290,329,97,79,62,19,2090,1085,1005,167,141,168,40,1
2719,824,397,427,113,95,82,33,582,293,289,94,80,77,32,1
2720,311,182,129,29,28,19,12,593,266,327,102,84,69,24,1
2721,1016,501,515,109,71,76,37,2003,1022,981,195,194,164,229,1
2722,400,191,209,51,60,30,9,703,356,347,96,97,38,22,1
2723,395,195,200,41,55,23,10,180,57,123,39,22,10,8,1
2724,317,153,164,34,52,30,14,900,484,416,119,110,77,29,1
2725,612,330,282,71,54,63,37,892,420,472,135,146,98,37,1
2726,255,122,133,35,51,22,13,168,76,92,26,21,19,4,1
2727,191,95,96,26,17,17,12,447,232,215,55,65,50,25,1
2728,605,295,310,74,66,70,36,544,259,285,76,81,40,20,1
2729,391,208,183,65,49,57,17,1304,585,719,179,169,154,47,1
2730,374,201,173,51,34,53,24,255,122,133,35,51,22,13,1
2731,456,209,247,72,58,40,9,620,305,315,97,80,87,28,1
2732,454,224,230,71,39,62,22,532,269,263,72,59,59,39,1
2733,1388,574,814,247,246,108,61,577,288,289,85,56,40,20,1
2734,460,199,261,72,63,60,9,1049,585,464,107,108,120,28,1
2735,561,292,269,88,68,64,22,993,492,501,116,119,135,57,1
2736,326,153,173,63,48,25,8,556,279,277,83,69,71,19,1
2737,446,176,270,64,79,45,24,510,264,246,67,66,38,29,1
2738,490,224,266,80,70,39,32,443,198,245,68,72,48,19,1
2739,191,99,92,25,24,18,8,782,347,435,110,92,74,34,1
2740,433,221,212,59,42,47,14,435,208,227,68,64,53,23,1
2741,847,402,445,137,119,102,41,1382,689,693,186,176,167,77,1
2742,201,98,103,26,35,16,5,851,446,405,93,94,92,37,1
2743,178,100,78,23,22,30,6,770,355,415,103,142,75,42,1
2744,3056,1457,1599,438,389,329,168,1149,568,581,177,133,101,30,1
2745,160,67,93,32,37,15,9,595,292,303,79,83,69,24,1
2746,379,203,176,55,48,45,16,785,374,411,56,42,38,25,1
2747,1084,537,547,154,121,92,35,1051,432,619,179,147,126,54,1
2748,1487,996,491,147,141,50,35,496,251,245,66,57,39,22,1
2749,493,208,285,75,77,70,40,257,139,118,64,17,24,7,1
2750,671,321,350,95,87,75,34,440,218,222,58,66,40,24,1
2751,500,297,203,66,33,53,15,674,319,355,84,139,50,11,1
2752,1198,571,627,177,168,97,54,354,166,188,53,55,40,19,1
2753,451,238,213,53,64,56,22,313,157,156,39,26,34,29,1
2754,512,216,296,92,68,51,19,1848,833,1015,304,257,195,71,1
2755,283,141,142,32,26,23,26,1158,481,677,169,129,86,40,1
2756,446,252,194,41,23,54,35,374,181,193,63,49,46,20,1
2757,880,355,525,122,139,75,36,778,367,411,90,85,64,43,1
2758,596,313,283,86,77,64,20,941,448,493,150,118,127,39,1
2759,403,188,215,70,42,41,11,177,99,78,22,23,20,10,1
2760,474,224,250,50,72,51,43,920,492,428,100,92,88,49,1
2761,724,334,390,112,109,79,17,495,233,262,64,39,49,32,1
2762,229,103,126,28,44,17,5,265,103,162,61,58,25,3,1
2763,508,251,257,74,53,51,18,979,534,445,83,77,80,24,1
2764,382,190,192,59,48,40,21,205,106,99,28,26,23,3,1
2765,287,124,163,52,48,24,16,162,78,84,28,23,18,3,1
2766,365,186,179,48,47,42,13,592,283,309,84,137,60,20,1
2767,243,120,123,30,24,26,13,537,276,261,75,68,68,22,1
2768,1337,667,670,137,143,140,35,369,181,188,41,36,54,16,1
2769,769,329,440,116,66,55,22,1115,599,516,125,105,95,51,1
2770,504,237,267,62,66,48,17,253,155,98,27,20,22,14,1
2771,262,151,111,30,17,32,25,550,319,231,49,65,35,16,1
2772,425,210,215,56,43,52,25,440,218,222,58,66,40,24,1
2773,870,433,437,133,121,95,25,352,169,183,57,36,47,31,1
2774,537,276,261,75,68,68,22,304,159,145,38,40,32,3,1
2775,290,127,163,47,58,23,12,582,293,289,94,80,77,32,1
2776,1069,512,557,148,126,84,36,507,242,265,53,44,31,22,1
2777,529,274,255,57,62,38,14,1863,721,1142,262,283,139,74,1
2778,2627,1378,1249,361,265,257,96,1132,624,508,199,79,127,41,1
2779,709,310,399,95,103,61,30,520,261,259,82,76,71,24,1
2780,184,86,98,26,26,14,11,1834,823,1011,297,282,151,63,1
2781,288,118,170,50,57,18,15,1549,848,701,182,150,179,69,1
2782,1243,633,610,149,160,87,39,209,138,71,13,9,16,19,1
2783,1706,830,876,265,209,230,63,541,279,262,79,82,31,32,1
2784,923,420,503,128,159,100,49,562,283,279,48,32,63,13,1
2785,360,188,172,49,48,47,17,347,198,149,45,29,29,8,1
2786,802,388,414,101,93,88,35,499,272,227,49,66,66,21,1
2787,361,184,177,50,53,51,22,321,187,134,59,29,32,8,1
2788,870,436,434,131,114,72,25,297,158,139,47,37,37,9,1
2789,505,226,279,68,51,30,15,341,197,144,50,31,15,6,1
2790,582,293,289,94,80,77,32,394,183,211,65,60,35,18,1
2791,656,358,298,67,47,64,26,364,168,196,64,61,27,6,1
2792,391,189,202,73,47,37,8,673,313,360,101,101,46,17,1
2793,104,48,56,15,15,13,7,367,161,206,70,48,41,19,1
2794,158,85,73,24,18,18,8,520,224,296,69,64,31,29,1
2795,425,210,215,56,43,52,25,331,169,162,40,28,22,14,1
2796,1210,592,618,157,138,116,85,1308,652,656,166,153,149,87,1
2797,254,166,88,25,21,22,5,501,240,261,80,62,49,42,1
2798,350,200,150,45,47,23,8,218,127,91,27,23,23,10,1
2799,1616,735,881,285,248,153,72,751,312,439,131,115,78,48,1
2800,953,421,532,131,131,70,37,1046,562,484,139,116,124,51,1
2801,845,402,443,137,126,105,47,732,355,377,108,109,79,27,1
2802,467,221,246,98,68,43,11,490,230,260,78,70,53,18,1
2803,665,297,368,111,107,34,12,724,334,390,112,109,79,17,1
2804,888,478,410,105,73,58,33,632,285,347,102,78,43,29,1
2805,178,86,92,30,21,12,17,707,386,321,85,83,99,28,1
2806,800,365,435,129,102,97,31,462,232,230,78,54,42,23,1
2807,290,130,160,47,43,32,11,731,338,393,114,126,53,17,1
2808,796,440,356,88,65,53,33,526,264,262,77,71,61,27,1
2809,536,278,258,72,63,62,20,745,391,354,85,81,52,39,1
2810,628,311,317,111,75,63,18,467,226,241,55,48,54,23,1
2811,803,358,445,135,117,80,44,267,147,120,40,24,25,8,1
2812,938,484,454,137,100,104,41,543,221,322,78,122,37,12,1
2813,333,127,206,66,68,25,14,1117,423,694,182,134,88,31,1
2814,1225,593,632,158,125,102,38,1412,603,809,184,195,112,45,1
2815,316,157,159,45,38,22,19,519,219,300,86,72,50,39,1
2816,1440,759,681,173,170,178,71,1452,733,719,182,161,179,64,1
2817,95,44,51,14,13,7,4,417,232,185,58,50,29,21,1
2818,146,83,63,19,12,13,8,339,177,162,40,36,51,24,1
2819,407,217,190,50,44,54,19,501,273,228,70,59,30,10,1
2820,824,403,421,80,150,65,35,462,232,230,78,54,42,23,1
2821,2033,877,1156,359,333,106,44,72,33,39,8,2,3,12,1
2822,636,320,316,79,61,67,31,317,153,164,39,30,35,13,1
2823,549,290,259,64,61,62,15,538,293,245,48,66,45,16,1
2824,1447,698,749,214,180,116,46,2339,1260,1079,336,252,279,106,1
2825,424,209,215,56,58,45,24,1242,613,629,174,113,114,53,1
2826,559,281,278,87,70,67,34,1907,1008,899,235,224,195,73,1
2827,467,240,227,65,65,51,23,947,482,465,143,107,89,37,1
2828,736,293,443,95,116,54,43,687,351,336,106,67,70,41,1
2829,393,186,207,58,50,36,22,497,185,312,63,92,38,28,1
2830,509,262,247,64,70,64,20,595,316,279,86,60,65,40,1
2831,427,191,236,67,60,41,34,316,157,159,45,38,22,19,1
2832,446,176,270,64,79,45,24,715,324,391,107,92,71,31,1
2833,235,119,116,31,26,15,13,707,391,316,111,80,54,30,1
2834,660,359,301,81,87,102,31,359,184,175,49,35,32,11,1
2835,1032,574,458,105,83,107,62,165,80,85,21,9,18,19,1
2836,2027,896,1131,340,313,172,86,193,99,94,31,31,16,12,1
2837,367,195,172,57,54,43,16,926,435,491,133,132,85,17,1
2838,189,89,100,39,16,11,3,320,163,157,44,44,26,15,1
2839,415,209,206,60,67,39,18,672,334,338,110,93,91,41,1
2840,940,523,417,160,102,78,32,341,178,163,48,44,42,20,1
2841,1400,800,600,158,134,150,65,551,298,253,63,65,45,19,1
2842,462,233,229,66,49,43,30,969,505,464,123,133,92,33,1
2843,1034,451,583,165,146,104,40,1747,959,788,256,200,123,25,1
2844,669,382,287,67,35,70,16,732,355,377,108,109,79,27,1
2845,354,168,186,50,53,39,20,326,217,109,32,20,43,18,1
2846,178,100,78,23,22,30,6,593,266,327,102,84,69,24,1
2847,522,265,257,35,39,38,8,536,230,306,64,88,40,12,1
2848,326,167,159,46,31,38,13,127,54,73,11,33,15,6,1
2849,778,367,411,90,85,64,43,404,239,165,48,38,38,19,1
2850,111,29,82,10,54,0,1,432,228,204,59,53,43,15,1
2851,351,184,167,59,45,54,9,300,140,160,39,35,14,12,1
2852,453,216,237,58,60,67,20,491,233,258,73,58,56,30,1
2853,335,185,150,46,34,36,13,770,355,415,103,142,75,42,1
2854,109,42,67,25,13,1,1,551,298,253,63,65,45,19,1
2855,467,224,243,70,43,67,23,308,164,144,47,29,33,7,1
2856,1210,592,618,157,138,116,85,512,261,251,79,73,60,21,1
2857,261,127,134,42,37,24,11,246,124,122,33,31,25,14,1
2858,261,143,118,33,24,32,16,1970,978,992,245,206,198,80,1
2859,484,254,230,60,66,56,14,1424,650,774,152,124,95,87,1
2860,2602,1424,1178,314,320,249,75,448,275,173,32,53,55,27,1
2861,1099,586,513,134,145,97,36,433,222,211,68,58,42,23,1
2862,485,209,276,78,69,37,30,293,153,140,45,38,22,15,1
2863,704,356,348,112,94,71,24,455,218,237,57,51,42,35,1
2864,984,509,475,114,109,106,56,377,184,193,56,53,44,14,1
2865,349,183,166,56,55,38,5,361,184,177,50,53,51,22,1
2866,669,323,346,94,89,34,18,197,92,105,38,16,26,15,1
2867,782,382,400,124,131,35,16,327,172,155,45,44,39,21,1
2868,386,181,205,55,51,57,31,1009,506,503,146,141,97,55,1
2869,149,67,82,19,37,11,10,1180,598,582,184,63,87,66,1
2870,900,484,416,119,110,77,29,1123,554,569,142,130,85,36,1
2871,662,306,356,90,82,73,28,404,197,207,57,69,33,15,1
2872,377,177,200,63,53,44,16,381,189,192,74,49,44,13,1
2873,394,202,192,44,43,38,28,825,399,426,128,128,77,32,1
2874,656,358,298,67,47,64,26,168,76,92,26,21,19,4,1
2875,1721,809,912,268,234,144,50,404,177,227,75,68,45,13,1
2876,419,175,244,71,73,23,23,724,320,404,120,147,67,25,1
2877,854,410,444,140,139,101,42,1153,535,618,204,158,93,50,1
2878,815,418,397,97,62,70,17,1099,511,588,139,95,94,34,1
2879,395,195,200,41,55,23,10,2035,1087,948,163,129,96,73,1
2880,178,100,78,23,22,30,6,200,91,109,29,34,24,7,1
2881,672,334,338,110,93,91,41,413,194,219,77,72,28,11,1
2882,390,207,183,50,48,38,15,164,78,86,28,23,12,8,1
2883,345,174,171,46,34,45,28,488,217,271,71,71,50,32,1
2884,164,77,87,33,19,6,7,772,363,409,76,120,57,20,1
2885,787,394,393,113,98,52,19,355,168,187,48,57,30,15,1
2886,2031,983,1048,294,257,230,93,191,99,92,25,24,18,8,1
2887,460,223,237,61,65,45,22,522,235,287,78,67,60,50,1
2888,750,371,379,95,98,86,29,126,70,56,25,10,5,5,1
2889,969,505,464,123,133,92,33,317,153,164,34,52,30,14,1
2890,638,305,333,68,90,70,29,1187,631,556,182,139,152,56,1
2891,158,74,84,26,23,18,18,467,226,241,55,48,54,23,1
2892,605,295,310,74,66,70,36,536,278,258,72,63,62,20,1
2893,1257,647,610,156,146,145,35,130,55,75,21,26,10,3,1
2894,371,230,141,42,21,41,21,409,200,209,69,56,44,13,1
2895,3075,1459,1616,390,359,298,207,4391,2256,2135,494,411,423,231,1
2896,787,386,401,98,95,86,25,164,88,76,27,20,17,6,1
2897,131,66,65,21,14,23,7,644,343,301,96,69,59,28,1
2898,178,100,78,23,22,30,6,253,148,105,31,15,39,16,1
2899,787,386,401,98,95,86,25,307,133,174,48,53,27,10,1
2900,245,111,134,31,44,20,11,695,373,322,80,59,89,39,1
2901,627,289,338,101,73,62,43,3433,1476,1957,522,578,264,123,1
2902,368,183,185,40,42,40,15,427,218,209,61,53,45,26,1
2903,275,125,150,37,48,27,7,67,40,27,10,8,7,6,1
2904,864,429,435,129,118,68,35,217,109,108,34,32,35,7,1
2905,326,176,150,35,22,29,11,2090,1085,1005,167,141,168,40,1
2906,351,184,167,59,45,54,9,136,72,64,22,16,7,3,1
2907,465,245,220,71,45,76,25,672,334,338,110,93,91,41,1
2908,346,168,178,36,43,20,9,425,210,215,56,43,52,25,1
2909,653,326,327,83,96,83,27,926,435,491,133,132,85,17,1
2910,263,159,104,30,27,31,11,703,414,289,75,61,68,26,1
2911,490,260,230,68,53,59,27,680,351,329,93,97,87,27,1
2912,325,181,144,46,31,48,9,281,132,149,38,32,38,14,1
2913,127,66,61,13,14,19,8,216,119,97,33,27,28,7,1
2914,508,267,241,57,49,40,13,2419,1042,1377,389,474,238,59,1
2915,407,217,190,50,44,54,19,436,235,201,62,45,56,17,1
2916,193,92,101,29,32,25,11,445,225,220,47,62,53,26,1
2917,439,227,212,60,55,58,8,888,476,412,98,89,72,61,1
2918,1170,510,660,142,182,115,84,187,97,90,28,25,21,8,1
2919,1342,675,667,162,154,123,39,1358,659,699,129,178,134,63,1
2920,1537,701,836,209,187,129,58,1225,593,632,158,125,102,38,1
2921,419,175,244,71,73,23,23,455,218,237,57,51,42,35,1
2922,461,207,254,82,66,55,33,666,347,319,92,73,63,25,1
2923,261,130,131,27,41,19,16,1616,735,881,285,248,153,72,1
2924,846,425,421,126,97,98,38,303,159,144,40,35,35,8,1
2925,1356,576,780,229,198,107,38,1591,704,887,253,227,156,50,1
2926,247,136,111,20,26,25,10,707,386,321,85,83,99,28,1
2927,451,222,229,72,46,57,17,292,153,139,39,33,24,21,1
2928,2442,1193,1249,278,183,170,145,510,243,267,65,67,44,44,1
2929,350,181,169,44,52,43,13,467,226,241,55,48,54,23,1
2930,304,159,145,38,40,32,3,1338,756,582,155,105,104,44,1
2931,1463,521,942,252,204,105,52,467,269,198,46,51,60,18,1
2932,336,160,176,60,50,46,9,796,390,406,110,117,86,33,1
2933,101,38,63,23,8,9,10,445,225,220,47,62,53,26,1
2934,315,150,165,52,36,22,15,218,108,110,27,29,23,10,1
2935,504,259,245,73,56,45,29,798,287,511,126,125,77,26,1
2936,912,461,451,127,109,96,48,737,363,374,119,101,85,41,1
2937,229,105,124,36,33,12,4,409,208,201,33,45,23,10,1
2938,355,179,176,51,45,45,11,599,308,291,90,68,55,11,1
2939,590,279,311,103,83,69,30,413,227,186,45,34,58,23,1
2940,794,402,392,96,84,86,30,165,78,87,23,21,17,8,1
2941,425,210,215,56,43,52,25,870,415,455,112,103,93,51,1
2942,429,184,245,78,70,44,17,586,273,313,100,79,40,19,1
2943,168,67,101,37,17,13,13,908,489,419,114,131,79,46,1
2944,733,346,387,98,113,66,26,2602,1424,1178,314,320,249,75,1
2945,431,201,230,69,39,55,33,415,217,198,49,51,50,23,1
2946,431,201,230,69,39,55,33,376,190,186,48,52,44,25,1
2947,341,170,171,41,66,27,10,271,159,112,34,34,33,7,1
2948,624,308,316,92,72,68,22,287,137,150,36,37,25,7,1
2949,544,259,285,76,81,40,20,705,396,309,87,48,53,17,1
2950,261,130,131,27,41,19,16,164,78,86,28,23,12,8,1
2951,593,266,327,102,84,69,24,918,427,491,113,111,113,33,1
2952,885,339,546,159,135,81,49,815,382,433,97,50,88,31,1
2953,701,331,370,116,95,59,28,957,346,611,205,175,61,29,1
2954,436,196,240,62,50,59,19,1123,554,569,142,130,85,36,1
2955,624,308,316,92,72,68,22,526,254,272,44,43,49,13,1
2956,1001,483,518,143,134,112,55,341,178,163,48,44,42,20,1
2957,589,314,275,70,83,44,28,199,106,93,29,23,26,7,1
2958,103,56,47,27,7,8,2,377,211,166,45,46,51,20,1
2959,329,182,147,34,34,40,31,318,176,142,25,32,35,25,1
2960,529,274,255,57,62,38,14,393,186,207,58,50,36,22,1
2961,395,198,197,53,50,44,14,770,355,415,103,142,75,42,1
2962,3056,1457,1599,438,389,329,168,1435,649,786,214,181,135,54,1
2963,304,159,145,38,40,32,3,217,109,108,34,32,35,7,1
2964,252,146,106,38,23,21,9,323,181,142,40,37,26,16,1
2965,794,402,392,96,84,86,30,2214,1053,1161,272,286,275,133,1
2966,1431,757,674,122,88,121,33,1102,511,591,171,179,148,52,1
2967,334,171,163,48,42,32,18,1374,679,695,191,193,154,48,1
2968,160,102,58,12,5,28,7,592,283,309,84,137,60,20,1
2969,556,269,287,86,66,62,22,1210,592,618,157,138,116,85,1
2970,616,296,320,69,76,49,48,416,201,215,54,52,39,25,1
2971,584,319,265,72,83,53,22,781,367,414,60,67,43,17,1
2972,1050,473,577,142,119,87,54,427,191,236,67,60,41,34,1
2973,1861,896,965,265,187,156,70,921,455,466,144,127,108,39,1
2974,1581,684,897,220,153,118,63,468,233,235,65,61,49,34,1
2975,263,181,82,19,11,39,8,435,254,181,52,46,48,14,1
2976,158,85,73,24,18,18,8,621,301,320,76,64,46,34,1
2977,340,172,168,60,50,36,10,529,264,265,59,68,41,17,1
2978,659,323,336,80,89,53,18,166,81,85,30,27,13,8,1
2979,103,51,52,15,17,6,5,384,211,173,43,30,60,26,1
2980,676,333,343,111,89,94,39,1822,879,943,236,227,175,97,1
2981,247,110,137,34,45,23,10,2364,1004,1360,406,426,226,79,1
2982,467,226,241,55,48,54,23,470,209,261,84,85,39,23,1
2983,1087,523,564,146,177,103,33,1425,670,755,153,189,122,85,1
2984,1106,579,527,121,152,113,45,794,390,404,103,95,86,23,1
2985,2414,1189,1225,277,178,170,169,700,305,395,111,99,54,18,1
2986,275,139,136,42,42,43,13,187,95,92,27,20,16,8,1
2987,337,171,166,46,27,33,16,280,156,124,36,19,20,13,1
2988,3661,1791,1870,463,425,340,151,784,391,393,105,113,86,21,1
2989,1336,828,508,166,121,152,48,526,268,258,54,37,55,12,1
2990,119,57,62,18,16,17,4,1474,756,718,175,158,169,51,1
2991,346,191,155,52,38,40,13,323,159,164,49,28,38,22,1
2992,396,206,190,41,34,40,16,113,66,47,11,9,6,5,1
2993,561,278,283,75,60,63,25,1858,805,1053,271,345,116,41,1
2994,1332,637,695,214,178,117,40,377,184,193,56,53,44,14,1
2995,314,162,152,56,32,36,26,351,159,192,58,35,35,31,1
2996,1038,527,511,118,163,120,52,144,67,77,28,14,9,8,1
2997,302,138,164,50,36,30,20,613,334,279,90,71,51,17,1
2998,1382,689,693,186,176,167,77,132,62,70,21,20,11,7,1
2999,674,268,406,118,96,70,21,904,436,468,138,146,82,39,1
3000,309,155,154,35,30,28,21,375,202,173,46,49,41,23,1
3001,443,248,195,67,54,40,15,217,109,108,34,32,35,7,1
3002,504,237,267,62,66,48,17,1466,991,475,136,129,59,39,1
3003,271,131,140,47,37,41,11,271,110,161,33,27,11,8,1
3004,560,260,300,100,58,29,28,424,210,214,79,45,42,17,1
3005,163,70,93,28,21,17,6,1906,909,997,280,193,135,72,1
3006,352,169,183,57,36,47,31,647,387,260,69,51,86,38,1
3007,452,224,228,69,56,50,31,480,232,248,83,64,51,25,1
3008,700,305,395,111,99,54,18,432,228,204,59,53,43,15,1
3009,875,421,454,124,142,98,43,719,364,355,104,100,58,34,1
3010,875,421,454,124,142,98,43,106,52,54,18,4,9,8,1
3011,794,402,392,96,84,86,30,391,220,171,49,37,32,14,1
3012,205,91,114,31,36,13,8,147,54,93,26,38,6,5,1
3013,307,154,153,39,36,31,12,568,292,276,69,74,59,34,1
3014,480,256,224,67,55,26,22,150,81,69,23,21,13,5,1
3015,532,291,241,83,36,79,25,1580,742,838,208,146,144,71,1
3016,465,218,247,64,51,50,42,170,88,82,26,29,19,6,1
3017,352,139,213,67,52,15,8,339,183,156,43,45,28,17,1
3018,337,222,115,33,21,38,20,350,215,135,36,21,48,14,1
3019,2442,1193,1249,278,183,170,145,1156,519,637,104,62,66,45,1
3020,123,62,61,17,18,13,8,173,88,85,20,21,9,12,1
3021,331,183,148,36,44,40,21,208,99,109,28,30,18,9,1
3022,2549,1331,1218,366,296,271,130,245,111,134,31,44,20,11,1
3023,253,133,120,40,22,27,13,307,174,133,34,20,27,16,1
3024,1262,653,609,169,165,152,50,751,390,361,116,98,80,34,1
3025,376,199,177,63,46,33,8,211,114,97,32,24,19,10,1
3026,1477,738,739,176,176,145,72,1804,789,1015,274,218,176,63,1
3027,330,143,187,63,29,52,20,777,387,390,90,87,65,37,1
3028,327,185,142,43,28,53,29,601,313,288,42,48,25,36,1
3029,911,423,488,140,150,102,32,1462,652,810,243,199,115,30,1
3030,601,313,288,42,48,25,36,287,146,141,36,28,29,16,1
3031,574,277,297,88,77,58,36,613,333,280,71,66,47,26,1
3032,197,95,102,31,23,18,12,540,257,283,81,63,57,24,1
3033,902,526,376,94,103,78,23,245,111,134,31,44,20,11,1
3034,1269,624,645,183,180,136,52,595,316,279,86,60,65,40,1
3035,824,397,427,113,95,82,33,119,59,60,29,10,6,4,1
3036,224,99,125,27,37,14,3,229,100,129,34,32,15,6,1
3037,413,236,177,41,25,35,19,452,217,235,59,47,60,20,1
3038,456,228,228,49,70,32,19,1105,479,626,182,125,80,29,1
3039,107,36,71,27,15,0,1,505,226,279,68,51,30,15,1
3040,923,420,503,128,159,100,49,154,75,79,28,23,16,6,1
3041,707,295,412,105,105,66,30,620,334,286,82,55,71,25,1
3042,815,418,397,97,62,70,17,245,112,133,32,45,20,10,1
3043,415,205,210,76,52,55,17,624,275,349,93,99,74,22,1
3044,1972,846,1126,222,330,114,68,437,228,209,47,61,26,11,1
3045,952,464,488,143,135,72,21,522,283,239,65,64,76,22,1
3046,179,102,77,23,20,6,3,485,190,295,94,55,57,29,1
3047,274,152,122,37,28,25,9,325,196,129,47,29,37,19,1
3048,325,153,172,62,37,50,39,1210,578,632,172,184,94,66,1
3049,443,248,195,67,54,40,15,412,202,210,64,46,43,34,1
3050,172,88,84,24,31,20,12,647,322,325,104,98,54,14,1
3051,1320,566,754,235,198,122,36,606,279,327,81,70,49,34,1
3052,1086,603,483,147,121,95,40,2322,1315,1007,242,257,220,38,1
3053,870,418,452,121,102,109,28,468,242,226,58,42,49,19,1
3054,334,172,162,43,39,41,17,217,115,102,40,24,26,6,1
3055,968,498,470,129,133,115,37,894,420,474,136,146,93,39,1
3056,1307,594,713,179,208,102,41,657,293,364,109,75,66,28,1
3057,582,285,297,62,57,44,16,552,285,267,74,51,69,24,1
3058,686,345,341,98,106,75,25,341,154,187,34,36,11,11,1
3059,577,217,360,100,116,32,24,194,91,103,17,32,9,6,1
3060,862,409,453,149,125,86,29,416,209,207,76,45,50,17,1
3061,284,111,173,47,34,47,43,105,50,55,16,17,14,10,1
3062,673,329,344,111,95,92,41,495,233,262,64,39,49,32,1
3063,123,58,65,22,14,13,3,360,175,185,73,36,27,7,1
3064,229,134,95,25,13,28,10,255,113,142,45,30,24,13,1
3065,592,291,301,92,93,71,31,847,452,395,100,94,81,36,1
3066,219,104,115,43,32,24,11,425,210,215,56,43,52,25,1
3067,1102,511,591,171,179,148,52,1075,594,481,132,108,101,42,1
3068,375,202,173,46,49,41,23,467,224,243,70,43,67,23,1
3069,613,333,280,71,66,47,26,2214,1053,1161,272,286,275,133,1
3070,445,219,226,61,60,60,21,2157,1171,986,306,238,131,32,1
3071,2442,1193,1249,278,183,170,145,1863,721,1142,262,283,139,74,1
3072,220,126,94,29,12,34,11,1304,585,719,179,169,154,47,1
3073,325,196,129,47,29,37,19,105,53,52,23,11,12,6,1
3074,247,110,137,34,45,23,10,625,293,332,74,71,50,40,1
3075,480,237,243,64,60,56,33,2440,1061,1379,377,326,172,62,1
3076,953,481,472,133,130,77,48,601,313,288,42,48,25,36,1
3077,753,359,394,102,100,85,23,260,169,91,35,34,8,2,1
3078,306,128,178,49,59,17,9,423,218,205,64,55,54,15,1
3079,254,134,120,34,27,26,14,483,235,248,67,62,55,29,1
3080,892,420,472,135,146,98,37,1313,644,669,169,90,111,43,1
3081,262,151,111,30,17,32,25,922,418,504,120,120,106,31,1
3082,462,233,229,66,49,43,30,743,366,377,41,37,26,14,1
3083,601,313,288,42,48,25,36,622,328,294,75,42,67,31,1
3084,1098,519,579,182,159,79,42,793,413,380,105,120,57,23,1
3085,2442,1193,1249,278,183,170,145,427,191,236,67,60,41,34,1
3086,758,360,398,114,107,51,19,136,72,64,22,16,7,3,1
3087,603,311,292,102,71,66,23,331,134,197,61,67,26,13,1
3088,1497,881,616,151,117,94,40,5497,2328,3169,872,896,436,168,1
3089,509,254,255,67,55,52,35,350,168,182,59,50,42,15,1
3090,229,120,109,31,30,22,9,545,269,276,80,76,27,32,1
3091,684,288,396,107,90,54,42,1290,597,693,182,182,119,63,1
3092,298,138,160,50,37,22,6,520,223,297,90,60,48,13,1
3093,476,233,243,76,61,52,21,787,351,436,135,98,82,23,1
3094,392,156,236,40,91,28,16,191,85,106,24,34,19,5,1
3095,262,144,118,19,39,22,8,235,135,100,30,13,25,11,1
3096,428,228,200,55,50,51,25,371,237,134,31,25,43,17,1
3097,1356,672,684,171,172,134,59,1328,661,667,210,147,126,55,1
3098,147,72,75,26,10,17,9,470,277,193,42,40,60,17,1
3099,425,210,215,56,43,52,25,1237,617,620,138,167,92,24,1
3100,672,334,338,110,93,91,41,1074,538,536,190,131,157,35,1
3101,147,79,68,20,15,19,8,180,103,77,22,19,29,8,1
3102,533,254,279,81,78,52,10,217,109,108,34,32,35,7,1
3103,377,214,163,41,22,48,15,422,245,177,50,31,42,22,1
3104,242,119,123,30,40,18,13,327,160,167,56,31,36,15,1
3105,419,189,230,64,49,36,15,808,366,442,130,133,66,31,1
3106,589,316,273,83,60,69,25,366,191,175,37,33,19,19,1
3107,305,166,139,42,38,28,12,315,150,165,49,59,23,15,1
3108,1087,523,564,146,177,103,33,330,159,171,48,38,50,19,1
3109,146,75,71,13,32,15,11,144,57,87,38,26,10,4,1
3110,347,212,135,35,32,17,6,706,320,386,111,76,75,51,1
3111,2261,1217,1044,271,243,267,101,462,224,238,77,75,37,13,1
3112,907,530,377,61,82,63,30,451,238,213,53,64,56,22,1
3113,418,189,229,76,72,45,14,519,244,275,76,90,44,16,1
3114,820,431,389,109,98,84,30,847,467,380,117,101,67,24,1
3115,318,150,168,60,42,32,12,522,245,277,78,69,52,21,1
3116,221,128,93,24,19,15,11,96,50,46,8,15,6,2,1
3117,389,210,179,51,37,43,9,509,262,247,64,70,64,20,1
3118,1074,538,536,154,140,111,51,529,283,246,66,69,66,25,1
3119,637,335,302,83,77,85,26,396,211,185,66,56,48,11,1
3120,556,279,277,83,69,71,19,740,385,355,114,97,91,27,1
3121,291,141,150,49,43,26,7,534,266,268,86,62,37,14,1
3122,379,203,176,55,48,45,16,676,333,343,111,89,94,39,1
3123,495,233,262,74,59,46,12,1382,599,783,208,252,90,39,1
3124,1738,821,917,242,196,181,58,377,184,193,56,53,44,14,1
3125,1654,643,1011,262,282,119,71,1087,480,607,155,179,99,28,1
3126,394,202,192,44,43,38,28,439,220,219,63,72,25,20,1
3127,284,146,138,48,31,43,11,648,341,307,78,89,77,21,1
3128,391,208,183,65,49,57,17,351,183,168,55,44,33,9,1
3129,595,272,323,111,107,54,28,2364,1004,1360,406,426,226,79,1
3130,991,483,508,166,120,94,42,161,88,73,24,5,23,11,1
3131,688,330,358,122,97,92,39,352,212,140,37,17,61,20,1
3132,475,235,240,77,58,43,22,165,76,89,26,24,18,15,1
3133,402,222,180,50,39,51,19,201,94,107,25,31,27,6,1
3134,428,226,202,52,60,75,20,482,231,251,76,81,64,26,1
3135,418,223,195,51,45,49,14,480,196,284,72,74,25,2,1
3136,330,157,173,56,42,51,8,281,166,115,34,17,36,16,1
3137,198,102,96,27,20,21,12,233,121,112,24,31,30,7,1
3138,585,299,286,92,73,89,23,808,419,389,109,87,86,32,1
3139,725,365,360,104,111,70,31,206,94,112,37,36,18,9,1
3140,524,264,260,75,75,40,21,733,346,387,98,113,66,26,1
3141,1016,501,515,109,71,76,37,2414,1189,1225,277,178,170,169,1
3142,316,201,115,29,31,12,6,303,175,128,43,36,34,12,1
3143,784,353,431,56,47,26,18,437,228,209,47,61,26,11,1
3144,796,364,432,161,124,53,30,528,268,260,81,77,36,22,1
3145,4128,2104,2024,581,505,453,205,609,292,317,102,96,64,21,1
3146,255,122,133,35,51,22,13,466,186,280,71,84,30,11,1
3147,724,650,74,44,3,32,3,574,314,260,69,52,78,15,1
3148,810,367,443,115,92,94,59,107,58,49,18,3,2,7,1
3149,1332,659,673,174,170,153,55,226,90,136,43,43,26,7,1
3150,697,373,324,105,83,95,38,372,179,193,50,52,33,6,1
3151,1313,644,669,169,90,111,43,614,263,351,85,84,54,35,1
3152,467,226,241,55,48,54,23,593,283,310,91,57,27,25,1
3153,211,113,98,38,17,25,8,217,109,108,34,32,35,7,1
3154,247,110,137,34,45,23,10,248,119,129,33,48,20,10,1
3155,794,402,392,96,84,86,30,515,256,259,68,58,53,33,1
3156,394,168,226,66,72,29,14,1071,549,522,133,127,130,59,1
3157,323,162,161,53,41,40,13,769,329,440,116,66,55,22,1
3158,448,199,249,65,54,38,33,463,236,227,64,50,44,29,1
3159,1785,857,928,246,225,187,93,512,281,231,69,48,70,23,1
3160,402,270,132,46,9,33,18,152,98,54,21,8,23,10,1
3161,815,418,397,97,62,70,17,985,466,519,153,122,73,26,1
3162,570,318,252,77,48,93,26,375,202,173,46,49,41,23,1
3163,281,154,127,45,31,24,9,437,228,209,47,61,26,11,1
3164,148,63,85,23,22,7,7,747,316,431,143,127,53,21,1
3165,1651,714,937,244,233,158,67,246,113,133,33,45,22,10,1
3166,398,227,171,47,32,44,17,780,304,476,160,173,66,23,1
3167,824,397,427,113,95,82,33,2157,1171,986,306,238,131,32,1
3168,552,285,267,74,51,69,24,324,149,175,49,49,34,6,1
3169,447,194,253,70,67,57,19,309,154,155,42,44,45,16,1
3170,277,124,153,44,40,35,18,1498,615,883,226,244,60,46,1
3171,637,335,302,83,77,85,26,1154,540,614,195,160,138,66,1
3172,458,210,248,39,38,25,16,670,316,354,84,69,47,24,1
3173,1651,714,937,244,233,158,67,255,122,133,35,51,22,13,1
3174,914,453,461,112,115,79,29,409,200,209,69,56,44,13,1
3175,315,150,165,52,36,22,15,207,99,108,34,27,22,9,1
3176,700,305,395,111,99,54,18,2524,1232,1292,398,317,186,61,1
3177,986,465,521,152,132,138,51,955,530,425,128,90,75,59,1
3178,1308,646,662,157,133,173,54,5938,2573,3365,858,958,396,195,1
3179,440,255,185,67,28,24,6,380,184,196,58,52,46,8,1
3180,1032,493,539,160,161,61,38,233,94,139,36,37,15,8,1
3181,351,143,208,44,68,23,18,220,106,114,32,26,15,7,1
3182,609,292,317,102,96,64,21,277,122,155,33,33,25,24,1
3183,686,375,311,89,80,63,20,572,298,274,72,67,52,20,1
3184,979,480,499,109,108,130,45,1132,553,579,172,143,150,57,1
3185,1270,557,713,130,195,57,30,605,281,324,111,67,40,44,1
3186,1154,540,614,195,160,138,66,831,334,497,163,167,49,22,1
3187,718,283,435,126,127,34,29,280,139,141,25,39,26,13,1
3188,622,309,313,75,81,76,29,217,106,111,24,26,27,9,1
3189,454,191,263,61,66,38,15,2414,1189,1225,277,178,170,169,1
3190,1255,666,589,145,142,120,82,1634,828,806,236,195,195,67,1
3191,781,418,363,92,90,64,41,829,424,405,91,131,76,22,1
3192,557,306,251,66,42,52,15,526,268,258,54,37,55,12,1
3193,796,445,351,96,80,90,38,184,86,98,26,26,14,11,1
3194,624,308,316,92,72,68,22,512,261,251,79,73,60,21,1
3195,189,90,99,26,29,17,11,1834,823,1011,297,282,151,63,1
3196,2033,877,1156,359,333,106,44,590,303,287,69,65,46,17,1
3197,971,445,526,116,99,83,109,707,386,321,85,83,99,28,1
3198,314,158,156,39,28,30,17,291,131,160,49,35,32,15,1
3199,1140,495,645,129,95,128,159,4169,1767,2402,595,549,386,80,1
3200,1203,462,741,215,230,40,22,1190,537,653,207,186,101,26,1
3201,205,106,99,28,26,23,3,367,161,206,70,48,41,19,1
3202,613,334,279,90,71,51,17,277,124,153,44,40,35,18,1
3203,247,110,137,34,45,23,10,697,373,324,105,83,95,38,1
3204,480,257,223,74,26,60,27,360,192,168,55,45,48,16,1
3205,853,355,498,122,156,91,29,2414,1189,1225,277,178,170,169,1
3206,875,376,499,155,125,53,39,298,140,158,51,33,21,22,1
3207,1265,424,841,230,200,86,47,667,360,307,76,92,46,27,1
3208,217,105,112,34,32,25,13,1834,823,1011,297,282,151,63,1
3209,1710,650,1060,338,287,185,46,2440,1061,1379,377,326,172,62,1
3210,1482,762,720,156,144,154,52,390,203,187,58,40,43,19,1
3211,191,95,96,26,17,17,12,771,321,450,151,135,43,15,1
3212,236,145,91,17,19,30,18,556,300,256,58,73,55,22,1
3213,292,152,140,46,38,35,12,1342,673,669,178,154,137,94,1
3214,631,315,316,64,57,49,15,770,374,396,95,91,79,41,1
3215,251,122,129,39,39,25,7,782,421,361,101,97,82,20,1
3216,594,274,320,89,63,66,28,1367,690,677,172,175,154,83,1
3217,566,287,279,77,66,34,14,354,166,188,53,55,40,19,1
3218,676,333,343,111,89,94,39,390,191,199,66,49,43,12,1
3219,656,358,298,67,47,64,26,530,246,284,75,67,64,53,1
3220,228,118,110,32,29,36,13,998,514,484,120,122,113,57,1
3221,257,148,109,28,20,21,14,462,233,229,66,49,43,30,1
3222,917,470,447,139,135,88,63,589,294,295,37,44,27,33,1
3223,466,186,280,71,84,30,11,377,184,193,50,43,33,17,1
3224,95,44,51,14,13,7,4,514,278,236,70,62,46,22,1
3225,662,312,350,103,104,59,20,848,461,387,111,102,108,42,1
3226,926,435,491,133,132,85,17,509,262,247,64,70,64,20,1
3227,376,199,177,63,46,33,8,596,286,310,90,89,78,37,1
3228,272,173,99,32,32,11,8,1706,830,876,265,209,230,63,1
3229,219,100,119,32,43,9,10,931,493,438,131,122,95,36,1
3230,458,269,189,56,40,29,7,618,290,328,82,74,69,42,1
3231,396,268,128,34,12,41,6,246,115,131,15,29,10,32,1
3232,948,484,464,134,131,75,27,334,171,163,48,42,32,18,1
3233,110,59,51,27,5,14,4,355,168,187,48,57,30,15,1
3234,1190,638,552,162,95,112,18,395,162,233,63,78,35,15,1
3235,334,172,162,43,39,41,17,115,67,48,10,7,12,7,1
3236,4303,2489,1814,436,369,444,134,1132,553,579,172,143,150,57,1
3237,89,42,47,16,12,15,6,260,133,127,43,32,39,3,1
3238,651,306,345,85,64,61,32,484,254,230,60,66,56,14,1
3239,686,375,311,89,80,63,20,89,47,42,11,5,6,9,1
3240,983,487,496,126,115,104,52,304,159,145,38,40,32,3,1
3241,350,201,149,38,37,38,11,406,219,187,44,39,52,20,1
3242,236,121,115,26,45,28,6,229,105,124,36,33,12,4,1
3243,261,144,117,34,22,31,15,132,65,67,21,9,8,21,1
3244,44,13,31,9,11,1,2,375,202,173,46,49,41,23,1
3245,1093,407,686,158,205,49,31,330,143,187,63,29,52,20,1
3246,184,88,96,24,25,14,9,748,355,393,121,91,95,26,1
3247,312,155,157,38,34,25,15,3685,1574,2111,579,580,303,116,1
3248,531,260,271,97,68,47,11,781,418,363,92,90,64,41,1
3249,925,444,481,131,141,106,36,2090,1085,1005,167,141,168,40,1
3250,1338,756,582,155,105,104,44,764,277,487,158,162,64,31,1
3251,162,73,89,32,19,4,4,772,363,409,76,120,57,20,1
3252,250,122,128,27,23,30,19,391,212,179,40,45,47,10,1
3253,168,90,78,22,19,13,4,367,161,206,70,48,41,19,1
3254,339,170,169,32,17,24,13,249,114,135,47,33,25,4,1
3255,1327,690,637,194,140,130,52,2115,838,1277,346,354,90,48,1
3256,802,388,414,101,93,88,35,149,68,81,15,38,11,10,1
3257,277,124,153,44,40,35,18,437,212,225,66,44,44,11,1
3258,437,225,212,61,57,66,12,131,66,65,21,14,23,7,1
3259,588,331,257,86,71,52,12,522,243,279,85,63,65,17,1
3260,101,45,56,17,17,12,9,94,45,49,11,20,10,4,1
3261,922,491,431,112,92,97,52,149,68,81,15,38,11,10,1
3262,1215,572,643,151,105,127,54,324,174,150,37,24,35,27,1
3263,1102,511,591,171,179,148,52,386,189,197,54,57,39,16,1
3264,225,116,109,29,19,25,6,198,98,100,30,21,21,8,1
3265,529,203,326,125,84,49,10,239,121,118,28,38,15,7,1
3266,438,222,216,67,72,38,14,671,318,353,83,124,46,34,1
3267,837,399,438,112,144,71,32,921,455,466,144,127,108,39,1
3268,542,250,292,91,52,53,24,1477,738,739,176,176,145,72,1
3269,245,112,133,32,45,20,10,601,290,311,92,89,55,30,1
3270,220,142,78,15,12,17,15,218,146,72,15,10,24,17,1
3271,158,72,86,27,14,15,11,244,131,113,34,26,35,16,1
3272,690,310,380,114,85,66,27,551,298,253,63,65,45,19,1
3273,526,264,262,77,71,61,27,502,299,203,57,52,32,11,1
3274,704,342,362,113,91,85,33,283,172,111,39,31,29,8,1
3275,1749,880,869,237,228,214,112,525,299,226,54,54,51,19,1
3276,724,334,390,112,109,79,17,595,316,279,86,60,65,40,1
3277,374,227,147,44,22,54,20,97,52,45,17,5,7,6,1
3278,326,141,185,57,39,33,20,758,360,398,114,107,51,19,1
3279,266,133,133,43,28,30,8,503,263,240,72,55,51,34,1
3280,288,159,129,27,44,27,15,580,339,241,72,47,66,21,1
3281,874,431,443,112,120,79,50,160,60,100,23,40,19,11,1
3282,738,339,399,102,88,68,35,1049,585,464,107,108,120,28,1
3283,191,99,92,25,24,18,8,984,466,518,159,139,97,42,1
3284,272,173,99,32,32,11,8,1393,712,681,174,180,144,55,1
3285,483,215,268,66,70,30,16,648,307,341,101,58,76,34,1
3286,522,235,287,78,67,60,50,470,226,244,81,53,59,39,1
3287,347,212,135,35,32,17,6,380,187,193,38,51,30,18,1
3288,134,60,74,19,13,10,7,255,109,146,35,32,23,17,1
3289,973,527,446,110,137,122,34,255,122,133,35,51,22,13,1
3290,404,190,214,55,55,35,27,467,269,198,46,51,60,18,1
3291,606,307,299,92,56,68,30,331,183,148,36,44,40,21,1
3292,674,334,340,107,71,74,35,1103,651,452,144,118,96,44,1
3293,425,210,215,56,43,52,25,552,285,267,74,51,69,24,1
3294,465,261,204,51,35,48,21,418,248,170,41,31,54,9,1
3295,520,272,248,74,71,44,15,149,68,81,15,38,11,10,1
3296,149,68,81,15,38,11,10,463,267,196,51,36,73,27,1
3297,193,118,75,25,19,10,7,193,118,75,20,21,24,6,1
3298,374,235,139,33,16,72,21,784,391,393,105,113,86,21,1
3299,312,147,165,52,44,12,13,360,188,172,49,48,47,17,1
3300,480,241,239,76,35,54,22,706,320,386,111,76,75,51,1
3301,514,254,260,55,57,56,19,103,56,47,27,7,8,2,1
3302,431,202,229,57,50,50,25,717,381,336,118,103,85,29,1
3303,870,418,452,121,102,109,28,478,215,263,103,72,47,3,1
3304,968,452,516,150,144,79,28,829,424,405,91,131,76,22,1
3305,651,306,345,85,64,61,32,552,285,267,74,51,69,24,1
3306,605,281,324,111,67,40,44,465,228,237,64,42,63,24,1
3307,1599,806,793,213,237,100,45,636,336,300,94,65,58,32,1
3308,493,256,237,64,50,44,39,188,97,91,27,16,24,21,1
3309,191,72,119,40,41,17,8,183,76,107,34,38,14,8,1
3310,185,115,70,19,17,26,6,205,100,105,25,25,20,9,1
3311,551,298,253,63,65,45,19,882,432,450,115,111,68,44,1
3312,425,210,215,56,43,52,25,463,225,238,76,36,59,26,1
3313,961,463,498,139,156,62,34,465,220,245,82,71,60,25,1
3314,1308,652,656,166,153,149,87,787,386,401,98,95,86,25,1
3315,315,150,165,52,36,22,15,220,102,118,26,32,27,10,1
3316,1190,638,552,162,95,112,18,1624,808,816,183,197,132,170,1
3317,91,56,35,17,2,7,7,239,146,93,30,22,35,9,1
3318,585,312,273,57,64,77,25,825,363,462,97,105,72,75,1
3319,1333,646,687,209,179,148,45,723,364,359,107,106,52,14,1
3320,573,278,295,58,79,37,23,353,147,206,47,61,30,25,1
3321,437,190,247,82,66,39,20,210,115,95,22,26,15,7,1
3322,459,221,238,52,56,51,19,537,276,261,75,68,68,22,1
3323,926,435,491,133,132,85,17,1464,715,749,200,167,181,70,1
3324,577,241,336,112,109,47,21,399,222,177,48,44,52,23,1
3325,1573,791,782,198,173,148,46,444,189,255,72,82,45,17,1
3326,613,342,271,69,50,60,41,465,218,247,64,51,50,42,1
3327,266,137,129,66,21,18,5,483,210,273,74,97,45,27,1
3328,512,261,251,79,73,60,21,202,86,116,33,29,26,10,1
3329,795,444,351,120,97,73,32,201,42,159,19,3,2,75,1
3330,136,66,70,33,11,9,3,1647,794,853,279,235,128,65,1
3331,471,246,225,46,38,52,30,287,151,136,51,42,36,7,1
3332,785,419,366,96,94,89,33,355,179,176,51,45,45,11,1
3333,646,304,342,104,93,58,26,391,208,183,65,49,57,17,1
3334,140,86,54,17,6,20,7,527,276,251,64,60,70,20,1
3335,676,333,343,111,89,94,39,605,263,342,73,103,54,18,1
3336,149,77,72,19,15,18,9,518,235,283,94,77,55,22,1
3337,748,355,393,121,91,95,26,391,201,190,52,47,35,24,1
3338,95,44,51,14,13,7,4,295,161,134,30,40,31,9,1
3339,1257,647,610,156,146,145,35,1048,564,484,118,122,113,40,1
3340,344,181,163,61,37,40,14,367,173,194,59,60,32,18,1
3341,674,334,340,107,71,74,35,395,186,209,53,48,46,30,1
3342,1500,804,696,190,172,144,60,648,307,341,101,58,76,34,1
3343,1836,1051,785,185,221,239,110,505,275,230,63,57,35,12,1
3344,149,77,72,19,15,18,9,326,160,166,38,38,33,13,1
3345,953,489,464,126,104,111,44,452,224,228,69,56,50,31,1
3346,1756,697,1059,328,345,110,27,1102,511,591,171,179,148,52,1
3347,179,80,99,16,18,24,13,362,183,179,49,49,41,11,1
3348,671,318,353,83,124,46,34,1893,764,1129,308,323,126,60,1
3349,502,240,262,78,61,54,32,665,297,368,111,107,34,12,1
3350,1304,696,608,195,169,122,53,396,150,246,103,64,38,3,1
3351,620,335,285,70,41,62,33,290,149,141,37,26,41,12,1
3352,419,178,241,59,46,43,47,1363,690,673,185,172,152,62,1
3353,146,75,71,13,32,15,11,778,353,425,140,89,92,51,1
3354,412,223,189,55,55,41,10,1210,592,618,157,138,116,85,1
3355,147,74,73,28,20,24,4,573,316,257,78,80,21,21,1
3356,714,364,350,98,102,91,27,239,116,123,21,58,15,9,1
3357,814,403,411,112,140,94,23,1599,806,793,213,237,100,45,1
3358,218,115,103,32,32,34,11,590,306,284,69,82,68,27,1
3359,530,288,242,49,55,38,22,304,144,160,30,39,26,16,1
3360,322,169,153,40,35,44,17,124,69,55,20,10,5,2,1
3361,300,145,155,53,43,42,9,168,82,86,30,23,19,10,1
3362,192,101,91,25,22,18,9,191,99,92,25,24,18,8,1
3363,593,291,302,81,85,56,20,767,392,375,113,112,83,13,1
3364,606,316,290,82,68,82,20,166,81,85,30,27,13,8,1
3365,372,201,171,52,50,42,13,473,224,249,82,63,48,24,1
3366,166,81,85,30,27,13,8,245,112,133,32,45,20,10,1
3367,355,169,186,49,37,26,11,806,419,387,115,130,57,32,1
3368,219,133,86,18,12,32,18,228,139,89,24,21,32,18,1
3369,258,113,145,43,44,16,7,276,118,158,38,40,16,10,1
3370,361,184,177,50,53,51,22,93,45,48,19,15,14,3,1
3371,426,213,213,60,56,46,24,748,355,393,121,91,95,26,1
3372,321,180,141,47,37,33,12,437,228,209,47,61,26,11,1
3373,530,259,271,83,50,54,41,246,113,133,33,45,22,10,1
3374,603,311,292,102,71,66,23,473,212,261,72,64,45,28,1
3375,170,85,85,15,24,12,11,495,263,232,56,65,66,21,1
3376,143,65,78,32,11,11,11,176,84,92,46,10,28,11,1
3377,504,237,267,62,66,48,17,1474,756,718,175,158,169,51,1
3378,619,290,329,97,79,62,19,240,99,141,53,38,29,15,1
3379,160,86,74,21,11,16,16,267,159,108,31,13,22,15,1
3380,118,47,71,24,14,5,6,226,109,117,38,36,13,11,1
3381,452,256,196,32,44,27,11,234,114,120,33,32,22,11,1
3382,190,94,96,25,24,18,5,200,100,100,23,21,21,9,1
3383,246,123,123,40,31,27,7,467,226,241,55,48,54,23,1
3384,266,133,133,54,19,38,10,503,263,240,72,55,51,34,1
3385,436,246,190,59,45,57,28,511,290,221,67,59,77,22,1
3386,605,281,324,111,67,40,44,465,225,240,65,44,65,25,1
3387,479,274,205,57,24,50,24,217,109,108,34,32,35,7,1
3388,940,464,476,116,135,108,58,640,328,312,94,92,86,20,1
3389,755,390,365,103,84,85,34,503,263,240,72,55,51,34,1
3390,2477,1186,1291,256,271,249,90,272,124,148,51,36,23,27,1
3391,466,242,224,66,53,53,13,785,374,411,56,42,38,25,1
3392,377,171,206,59,58,41,22,467,269,198,46,51,60,18,1
3393,410,222,188,54,49,43,13,712,396,316,78,69,65,25,1
3394,1321,679,642,154,167,133,58,168,67,101,37,17,13,13,1
3395,653,298,355,70,101,64,39,225,114,111,32,29,26,6,1
3396,620,335,285,70,41,62,33,86,52,34,9,8,8,3,1
3397,418,189,229,76,72,45,14,1210,592,618,157,138,116,85,1
3398,1182,612,570,142,118,140,62,191,103,88,23,14,23,10,1
3399,501,218,283,86,94,63,15,793,413,380,105,120,57,23,1
3400,461,227,234,61,47,54,33,2414,1189,1225,277,178,170,169,1
3401,263,159,104,30,27,31,11,234,133,101,29,25,28,7,1
3402,1861,896,965,265,187,156,70,489,242,247,83,63,62,19,1
3403,2045,985,1060,359,339,199,74,339,185,154,41,38,29,13,1
3404,154,75,79,17,24,16,13,446,176,270,64,79,45,24,1
3405,620,299,321,75,60,68,30,1308,646,662,157,133,173,54,1
3406,672,334,338,110,93,91,41,130,55,75,21,26,10,3,1
3407,365,222,143,44,24,35,11,324,190,134,41,27,28,9,1
3408,542,270,272,76,60,61,27,428,214,214,65,67,45,23,1
3409,336,154,182,51,48,39,22,1339,494,845,216,298,92,37,1
3410,370,190,180,60,52,37,13,724,320,404,120,147,67,25,1
3411,1290,597,693,182,182,119,63,644,343,301,96,69,59,28,1
3412,908,488,420,115,97,111,43,781,418,363,92,90,64,41,1
3413,207,108,99,25,15,27,16,225,113,112,29,45,19,7,1
3414,436,201,235,54,37,34,20,446,283,163,51,26,33,19,1
3415,424,219,205,61,40,40,23,427,218,209,56,57,53,24,1
3416,107,56,51,19,16,13,5,1000,510,490,117,123,113,31,1
3417,500,193,307,97,68,32,20,719,270,449,113,122,44,32,1
3418,635,333,302,99,75,83,28,770,374,396,95,91,79,41,1
3419,251,138,113,40,31,14,8,390,207,183,50,48,38,15,1
3420,475,268,207,61,27,56,30,360,218,142,39,26,50,18,1
3421,469,253,216,49,51,48,18,466,199,267,86,59,32,17,1
3422,785,359,426,118,128,84,33,512,261,251,79,73,60,21,1
3423,505,254,251,80,77,60,15,770,374,396,95,91,79,41,1
3424,1162,528,634,193,161,107,74,425,210,215,56,43,52,25,1
3425,1324,609,715,149,119,97,56,439,177,262,78,73,40,21,1
3426,473,259,214,65,43,75,15,1400,800,600,158,134,150,65,1
3427,191,99,92,25,24,18,8,79,38,41,17,8,7,8,1
3428,350,181,169,44,52,43,13,126,66,60,24,10,7,9,1
3429,1225,593,632,158,125,102,38,467,269,198,46,51,60,18,1
3430,473,270,203,63,34,44,18,427,204,223,38,57,26,32,1
3431,686,375,311,89,80,63,20,621,273,348,104,102,48,19,1
3432,469,247,222,70,58,82,13,317,164,153,47,33,47,12,1
3433,1272,520,752,235,242,117,54,326,176,150,35,22,29,11,1
3434,299,158,141,45,31,21,5,1272,520,752,235,242,117,54,1
3435,520,272,248,74,71,44,15,431,228,203,66,46,59,15,1
3436,461,287,174,56,27,82,25,370,176,194,61,30,40,28,1
3437,317,201,116,31,14,38,20,332,198,134,29,17,46,28,1
3438,233,121,112,24,31,30,7,175,86,89,33,25,27,2,1
3439,501,230,271,63,90,50,18,757,373,384,115,93,95,25,1
3440,465,218,247,64,51,50,42,432,218,214,57,55,42,11,1
3441,275,136,139,45,49,19,11,1977,1102,875,235,227,234,91,1
3442,228,92,136,43,39,16,7,163,71,92,22,38,11,7,1
3443,255,122,133,35,51,22,13,1374,679,695,191,193,154,48,1
3444,147,68,79,31,23,8,4,415,205,210,76,52,55,17,1
3445,175,90,85,28,21,19,7,675,305,370,114,109,60,21,1
3446,246,108,138,32,44,21,10,464,224,240,79,71,59,21,1
3447,212,116,96,22,19,24,17,301,150,151,41,30,17,11,1
3448,979,492,487,120,122,89,51,1047,475,572,176,183,110,39,1
3449,596,292,304,92,60,56,19,745,391,354,85,81,52,39,1
3450,330,159,171,48,38,50,19,372,176,196,60,53,47,11,1
3451,870,436,434,131,114,72,25,352,212,140,37,17,61,20,1
3452,337,152,185,49,54,42,21,854,380,474,137,159,81,31,1
3453,189,96,93,24,21,19,17,659,334,325,90,79,72,36,1
3454,339,177,162,40,36,51,24,1474,756,718,175,158,169,51,1
3455,420,197,223,72,57,54,19,1129,589,540,134,122,108,46,1
3456,616,296,320,69,76,49,48,557,240,317,97,74,68,37,1
3457,312,172,140,41,40,21,8,472,220,252,59,69,32,20,1
3458,446,176,270,64,79,45,24,623,233,390,145,83,43,20,1
3459,824,397,427,113,95,82,33,76,42,34,12,8,5,7,1
3460,646,316,330,89,95,48,17,397,186,211,73,63,36,25,1
3461,1501,679,822,251,196,174,67,189,109,80,26,24,9,8,1
3462,159,70,89,22,25,13,10,627,314,313,61,59,71,22,1
3463,1338,756,582,155,105,104,44,1154,540,614,195,160,138,66,1
3464,297,158,139,47,37,37,9,1244,674,570,145,141,131,42,1
3465,263,146,117,24,21,23,14,423,220,203,51,54,46,17,1
3466,365,180,185,63,35,48,19,209,75,134,53,48,20,9,1
3467,466,224,242,68,56,48,16,303,137,166,54,54,31,15,1
3468,794,390,404,103,95,86,23,595,316,279,86,60,65,40,1
3469,391,208,183,65,49,57,17,403,185,218,67,62,63,19,1
3470,149,77,72,19,15,18,9,171,94,77,24,28,30,11,1
3471,211,83,128,28,35,5,11,1480,789,691,195,151,173,55,1
3472,305,166,139,42,38,28,12,413,227,186,45,34,58,23,1
3473,465,228,237,64,42,63,24,707,391,316,111,80,54,30,1
3474,393,186,207,58,50,36,22,858,461,397,125,114,79,45,1
3475,247,127,120,43,20,27,14,277,124,153,44,40,35,18,1
3476,1288,556,732,235,217,98,40,1401,705,696,198,181,114,64,1
3477,412,250,162,40,34,58,26,759,367,392,118,104,66,33,1
3478,161,74,87,17,46,12,13,187,81,106,47,32,10,11,1
3479,953,489,464,126,104,111,44,404,190,214,55,55,35,27,1
3480,237,122,115,30,26,14,6,425,210,215,56,43,52,25,1
3481,163,70,93,28,21,17,6,170,35,135,33,25,8,5,1
3482,267,124,143,45,46,26,4,147,81,66,18,18,18,4,1
3483,1670,1140,530,173,120,89,53,122,69,53,18,16,20,4,1
3484,294,148,146,35,33,25,14,769,329,440,116,66,55,22,1
3485,147,68,79,31,23,8,4,365,180,185,63,35,48,19,1
3486,307,162,145,38,46,41,15,589,314,275,70,83,44,28,1
3487,635,333,302,99,75,83,28,845,402,443,137,126,105,47,1
3488,666,344,322,91,73,91,20,202,102,100,29,35,6,9,1
3489,303,159,144,40,35,35,8,304,159,145,38,40,32,3,1
3490,1406,676,730,210,164,160,73,166,83,83,24,30,18,7,1
3491,736,388,348,88,85,67,28,755,348,407,109,98,49,23,1
3492,472,230,242,82,46,49,19,1712,1175,537,179,142,113,46,1
3493,545,230,315,91,101,50,16,191,99,92,25,24,18,8,1
3494,620,348,272,91,43,59,29,2471,1130,1341,240,281,219,290,1
3495,973,513,460,149,93,103,56,1922,923,999,267,275,215,90,1
3496,712,331,381,111,86,86,34,577,251,326,92,84,60,11,1
3497,1215,652,563,129,142,121,62,685,315,370,108,99,36,9,1
3498,280,97,183,55,48,20,20,757,373,384,115,93,95,25,1
3499,265,177,88,20,14,30,8,246,115,131,15,29,10,32,1
3500,651,306,345,85,64,61,32,864,429,435,129,118,68,35,1
3501,836,407,429,122,89,61,21,1290,629,661,191,187,167,55,1
3502,871,482,389,113,95,109,35,444,189,255,72,82,45,17,1
3503,638,344,294,91,55,83,29,640,339,301,70,64,90,41,1
3504,743,233,510,148,142,28,17,440,246,194,62,49,41,16,1
3505,411,175,236,60,73,47,17,1113,480,633,170,173,81,34,1
3506,261,130,131,27,41,19,16,1186,493,693,184,208,88,32,1
3507,589,314,275,70,83,44,28,216,102,114,31,29,21,6,1
3508,624,308,316,92,72,68,22,1960,810,1150,358,377,121,72,1
3509,986,499,487,123,116,98,54,806,436,370,101,100,76,34,1
3510,213,84,129,38,27,19,9,962,430,532,109,142,61,34,1
3511,810,367,443,115,92,94,59,449,242,207,47,42,39,20,1
3512,199,87,112,31,27,8,15,444,218,226,71,64,37,11,1
3513,219,124,95,22,22,23,5,197,92,105,38,16,26,15,1
3514,394,202,192,44,43,38,28,403,192,211,102,39,49,15,1
3515,510,306,204,82,46,45,20,450,229,221,49,63,54,27,1
3516,464,242,222,61,68,36,17,339,170,169,32,17,24,13,1
3517,397,184,213,64,39,40,28,757,373,384,115,93,95,25,1
3518,1190,638,552,162,95,112,18,4655,2074,2581,545,652,562,399,1
3519,613,354,259,72,72,61,19,894,420,474,136,146,93,39,1
3520,362,174,188,46,55,35,23,522,235,287,78,67,60,50,1
3521,620,305,315,97,80,87,28,552,285,267,74,51,69,24,1
3522,672,334,338,110,93,91,41,848,461,387,111,102,108,42,1
3523,1395,627,768,172,263,141,59,179,76,103,36,32,9,9,1
3524,388,237,151,32,24,38,27,375,173,202,50,46,43,25,1
3525,317,153,164,34,52,30,14,2524,1232,1292,398,317,186,61,1
3526,458,222,236,69,39,35,18,509,262,247,64,70,64,20,1
3527,1149,568,581,177,133,101,30,419,189,230,64,49,36,15,1
3528,131,66,65,21,14,23,7,72,35,37,10,9,7,6,1
3529,546,267,279,90,69,56,19,136,72,64,22,16,7,3,1
3530,3460,1748,1712,369,360,496,190,873,381,492,98,137,76,78,1
3531,489,242,247,83,63,62,19,461,233,228,75,64,36,18,1
3532,690,333,357,107,89,89,36,676,333,343,111,89,94,39,1
3533,1210,592,618,157,138,116,85,162,88,74,18,20,25,10,1
3534,435,221,214,72,45,47,19,323,200,123,33,25,38,18,1
3535,576,250,326,93,71,34,15,632,326,306,92,71,56,19,1
3536,579,330,249,52,27,90,11,1064,555,509,111,90,99,32,1
3537,492,267,225,53,41,67,23,266,124,142,44,21,28,26,1
3538,3075,1459,1616,390,359,298,207,825,363,462,97,105,72,75,1
3539,3911,1465,2446,610,767,240,133,667,360,307,76,92,46,27,1
3540,351,184,167,59,45,54,9,271,110,161,33,27,11,8,1
3541,911,423,488,140,150,102,32,299,164,135,37,29,28,11,1
3542,102,61,41,15,13,8,2,873,366,507,127,125,75,21,1
3543,480,234,246,79,77,65,23,1132,624,508,199,79,127,41,1
3544,474,208,266,65,69,43,36,98,55,43,14,1,7,4,1
3545,859,418,441,129,118,93,31,475,268,207,61,27,56,30,1
3546,621,301,320,76,64,46,34,428,214,214,65,67,45,23,1
3547,473,212,261,72,64,45,28,433,237,196,60,52,33,27,1
3548,293,142,151,49,40,42,17,437,212,225,66,44,44,11,1
3549,146,71,75,20,17,8,7,600,281,319,98,68,38,13,1
3550,798,287,511,126,125,77,26,747,371,376,87,134,54,29,1
3551,654,409,245,88,73,20,24,89,45,44,13,4,8,3,1
3552,526,169,357,109,86,69,30,201,42,159,19,3,2,75,1
3553,620,307,313,92,91,92,33,684,288,396,107,90,54,42,1
3554,613,373,240,74,57,52,20,267,161,106,22,25,35,20,1
3555,635,333,302,99,75,83,28,486,229,257,75,104,49,10,1
3556,435,221,214,72,45,47,19,847,402,445,109,91,100,37,1
3557,1464,987,477,137,141,55,31,742,303,439,88,96,86,23,1
3558,481,189,292,119,69,84,26,73,35,38,14,10,9,4,1
3559,1164,531,633,179,157,107,46,1807,933,874,248,203,173,71,1
3560,1830,904,926,276,245,222,100,845,402,443,137,126,105,47,1
3561,890,512,378,92,95,75,41,537,276,261,75,68,68,22,1
3562,1354,537,817,245,247,117,57,466,186,280,71,84,30,11,1
3563,582,330,252,82,69,87,21,338,169,169,43,38,41,10,1
3564,306,128,178,49,59,17,9,163,70,93,28,21,17,6,1
3565,444,250,194,58,21,60,23,339,170,169,32,17,24,13,1
3566,365,186,179,48,47,42,13,375,125,250,85,76,17,13,1
3567,562,265,297,79,56,72,45,4544,2024,2520,579,628,480,403,1
3568,504,259,245,73,56,45,29,2063,1024,1039,175,117,80,97,1
3569,475,243,232,67,54,39,15,375,202,173,46,49,41,23,1
3570,1455,765,690,189,162,166,66,558,302,256,66,62,65,30,1
3571,772,364,408,114,106,98,33,103,56,47,27,7,8,2,1
3572,1134,574,560,157,164,47,48,637,321,316,70,96,30,18,1
3573,815,418,397,97,62,70,17,216,120,96,21,24,31,13,1
3574,947,441,506,166,143,80,30,404,197,207,57,69,33,15,1
3575,208,101,107,38,28,24,7,418,205,213,69,50,29,15,1
3576,1074,538,536,190,131,157,35,948,484,464,134,131,75,27,1
3577,798,287,511,126,125,77,26,346,174,172,36,43,21,9,1
3578,168,67,101,37,17,13,13,1620,884,736,194,161,162,80,1
3579,382,190,192,59,48,40,21,858,461,397,125,114,79,45,1
3580,255,132,123,34,34,41,9,163,71,92,22,38,11,7,1
3581,442,254,188,54,31,50,30,377,177,200,63,53,44,16,1
3582,1068,494,574,176,155,81,27,377,202,175,46,50,41,23,1
3583,443,208,235,43,55,51,50,518,262,256,70,52,49,27,1
3584,92,40,52,14,23,13,7,758,362,396,115,102,35,13,1
3585,437,225,212,61,57,66,12,559,225,334,106,87,24,12,1
3586,350,224,126,34,14,48,18,359,174,185,54,56,43,16,1
3587,246,108,138,32,44,21,10,430,192,238,62,67,27,10,1
3588,665,297,368,111,107,34,12,906,455,451,116,105,87,46,1
3589,309,179,130,37,19,31,16,245,111,134,31,44,20,11,1
3590,98,48,50,18,4,9,8,352,212,140,37,17,61,20,1
3591,4069,1705,2364,529,749,297,89,351,143,208,44,68,23,18,1
3592,480,234,246,79,77,65,23,1242,613,629,174,113,114,53,1
3593,543,274,269,85,56,34,19,333,127,206,66,68,25,14,1
3594,710,307,403,117,176,37,9,778,367,411,90,85,64,43,1
3595,251,144,107,33,23,23,8,727,389,338,77,54,70,32,1
3596,435,208,227,68,64,53,23,1106,579,527,121,152,113,45,1
3597,806,436,370,101,100,76,34,298,181,117,43,23,40,12,1
3598,440,218,222,58,66,40,24,143,79,64,16,25,7,5,1
3599,587,309,278,67,73,56,34,372,237,135,38,22,39,26,1
3600,834,405,429,112,95,84,34,465,225,240,65,44,65,25,1
3601,553,261,292,73,79,40,26,508,215,293,72,71,42,15,1
3602,1115,570,545,143,121,113,43,297,123,174,51,49,16,10,1
3603,624,204,420,166,101,32,13,221,75,146,68,21,16,5,1
3604,264,121,143,57,32,22,15,1014,490,524,177,137,94,38,1
3605,466,242,224,66,53,53,13,270,136,134,38,31,31,4,1
3606,382,183,199,55,60,38,22,2138,1161,977,258,229,249,95,1
3607,480,234,246,79,77,65,23,756,348,408,101,103,60,40,1
3608,44,13,31,9,11,1,2,377,201,176,46,50,41,23,1
3609,826,362,464,107,118,71,43,160,53,107,31,29,13,3,1
3610,505,272,233,76,66,57,23,316,156,160,34,28,32,14,1
3611,360,218,142,39,26,50,18,418,204,214,68,66,38,12,1
3612,221,131,90,32,19,15,7,851,446,405,93,94,92,37,1
3613,264,122,142,33,29,13,13,1893,850,1043,280,340,169,80,1
3614,551,286,265,79,71,45,24,3144,1617,1527,367,342,278,136,1
3615,585,299,286,92,73,89,23,219,100,119,32,43,9,10,1
3616,882,432,450,115,111,68,44,1425,670,755,153,189,122,85,1
3617,336,154,182,51,48,39,22,508,267,241,43,35,25,17,1
3618,1982,710,1272,353,319,146,76,885,339,546,159,135,81,49,1
3619,2214,993,1221,361,324,190,74,461,227,234,61,47,54,33,1
3620,770,390,380,104,76,78,32,280,156,124,36,19,20,13,1
3621,200,94,106,33,22,18,8,529,274,255,57,62,38,14,1
3622,1786,793,993,213,271,163,159,330,143,187,63,29,52,20,1
3623,741,331,410,101,122,69,32,348,182,166,46,44,37,10,1
3624,392,218,174,43,42,32,27,686,375,311,89,80,63,20,1
3625,585,277,308,92,73,61,32,582,293,289,94,80,77,32,1
3626,235,104,131,29,35,26,10,516,298,218,62,57,49,19,1
3627,467,226,241,55,48,54,23,780,369,411,130,113,79,35,1
3628,1443,776,667,191,175,160,56,2157,1171,986,306,238,131,32,1
3629,616,296,320,69,76,49,48,676,295,381,94,71,65,24,1
3630,537,276,261,75,68,68,22,1126,643,483,147,96,97,36,1
3631,461,197,264,86,97,43,10,604,320,284,80,62,90,28,1
3632,378,154,224,74,84,35,22,433,222,211,68,58,42,23,1
3633,450,242,208,53,63,56,22,245,111,134,31,44,20,11,1
3634,158,71,87,23,21,17,12,132,62,70,21,20,11,7,1
3635,1978,807,1171,323,310,129,70,201,42,159,19,3,2,75,1
3636,115,55,60,25,14,7,7,1132,646,486,99,102,71,41,1
3637,523,346,177,40,25,71,27,661,361,300,65,82,57,15,1
3638,532,267,265,86,55,64,22,1210,592,618,157,138,116,85,1
3639,246,108,138,32,44,21,10,536,278,258,72,63,62,20,1
3640,1273,592,681,199,164,139,39,1105,544,561,165,167,98,40,1
3641,242,112,130,39,41,21,13,538,252,286,77,87,53,30,1
3642,477,232,245,67,64,70,30,479,238,241,64,47,62,22,1
3643,733,346,387,98,113,66,26,1009,506,503,146,141,97,55,1
3644,432,228,204,59,53,43,15,297,158,139,47,37,37,9,1
3645,667,360,307,76,92,46,27,320,159,161,44,54,29,9,1
3646,294,140,154,47,35,22,17,116,67,49,13,12,6,5,1
3647,854,399,455,127,118,57,39,894,420,474,136,146,93,39,1
3648,772,417,355,118,92,80,23,100,37,63,26,19,0,1,1
3649,317,147,170,40,80,41,7,1132,646,486,99,102,71,41,1
3650,458,269,189,56,40,29,7,298,159,139,39,40,33,15,1
3651,537,276,261,75,68,68,22,481,256,225,60,56,48,12,1
3652,1153,535,618,204,158,93,50,181,96,85,25,23,20,7,1
3653,851,446,405,93,94,92,37,426,200,226,75,56,39,24,1
3654,998,496,502,149,146,89,27,467,226,241,55,48,54,23,1
3655,354,188,166,44,31,48,11,136,74,62,22,16,16,2,1
3656,201,42,159,19,3,2,75,632,326,306,92,71,56,19,1
3657,318,192,126,37,22,33,11,317,161,156,40,49,41,11,1
3658,957,385,572,173,168,62,33,1464,693,771,153,136,91,86,1
3659,1150,506,644,154,176,124,52,1068,527,541,160,131,112,52,1
3660,247,110,137,34,45,23,10,646,316,330,89,95,48,17,1
3661,425,199,226,54,71,56,11,2442,1193,1249,278,183,170,145,1
3662,708,303,405,115,115,70,23,1471,709,762,198,184,154,62,1
3663,1308,652,656,166,153,149,87,349,166,183,49,37,25,52,1
3664,656,358,298,67,47,64,26,44,13,31,9,10,1,2,1
3665,1241,670,571,135,139,110,32,512,261,251,79,73,60,21,1
3666,130,70,60,30,9,8,1,806,365,441,134,118,78,44,1
3667,339,170,169,32,17,24,13,462,170,292,69,108,26,16,1
3668,147,78,69,20,15,20,7,326,160,166,38,38,33,13,1
3669,906,455,451,116,105,87,46,246,108,138,32,44,21,10,1
3670,373,194,179,42,54,26,13,922,418,504,120,120,106,31,1
3671,459,262,197,46,68,38,11,906,437,469,135,132,49,40,1
3672,305,95,210,88,27,15,9,344,109,235,100,39,26,5,1
3673,360,192,168,55,45,48,16,744,385,359,125,89,90,23,1
3674,87,48,39,15,9,9,3,217,109,108,34,32,35,7,1
3675,228,139,89,24,21,32,18,1181,612,569,107,121,123,43,1
3676,166,74,92,31,19,21,8,337,189,148,30,32,45,11,1
3677,345,203,142,47,35,31,11,379,203,176,55,48,45,16,1
3678,2220,1085,1135,312,304,202,91,245,111,134,31,44,20,11,1
3679,631,309,322,106,83,89,33,1132,553,579,172,143,150,57,1
3680,283,159,124,41,21,39,17,536,278,258,72,63,62,20,1
3681,390,203,187,58,40,43,19,1170,510,660,142,182,115,84,1
3682,197,82,115,27,22,29,7,531,250,281,72,61,68,31,1
3683,298,138,160,50,37,22,6,598,288,310,86,79,46,15,1
3684,790,352,438,132,87,91,60,246,113,133,33,45,22,10,1
3685,202,113,89,16,27,21,11,204,103,101,16,32,22,8,1
3686,901,458,443,91,129,86,21,781,418,363,92,90,64,41,1
3687,419,184,235,66,43,50,28,526,220,306,95,74,62,41,1
3688,508,267,241,43,35,25,17,224,108,116,31,32,22,8,1
3689,501,285,216,52,55,62,25,505,254,251,80,77,60,15,1
3690,301,150,151,41,30,17,11,233,107,126,40,40,20,16,1
3691,1133,491,642,192,170,61,29,148,63,85,23,22,7,7,1
3692,357,147,210,48,37,21,47,2477,1186,1291,256,271,249,90,1
3693,671,321,350,95,87,75,34,419,175,244,71,73,23,23,1
3694,356,185,171,37,31,17,21,480,320,160,64,49,22,18,1
3695,267,124,143,45,46,26,4,330,148,182,42,35,42,25,1
3696,964,408,556,131,153,76,55,534,266,268,86,62,37,14,1
3697,168,67,101,37,17,13,13,1696,771,925,257,225,149,63,1
3698,481,256,225,60,56,48,12,788,360,428,93,106,67,72,1
3699,555,294,261,76,62,58,23,324,154,170,57,40,26,4,1
3700,585,289,296,102,86,61,18,2005,1074,931,235,243,249,109,1
3701,928,442,486,139,118,91,43,673,317,356,101,85,76,49,1
3702,2201,1053,1148,238,312,200,122,1049,585,464,107,108,120,28,1
3703,476,190,286,116,95,33,11,257,140,117,46,24,15,7,1
3704,1009,506,503,146,141,97,55,676,333,343,111,89,94,39,1
3705,465,228,237,64,42,63,24,364,183,181,53,44,46,14,1
3706,461,207,254,82,66,55,33,295,143,152,38,47,22,25,1
3707,247,128,119,40,21,27,11,299,140,159,27,59,20,18,1
3708,742,429,313,82,86,113,37,3695,1922,1773,449,360,352,261,1
3709,776,356,420,122,103,85,30,437,228,209,47,61,26,11,1
3710,351,166,185,48,61,24,15,605,263,342,73,103,54,18,1
3711,412,193,219,70,56,51,26,136,65,71,33,11,9,6,1
3712,684,288,396,107,90,54,42,437,167,270,126,95,34,10,1
3713,605,283,322,94,72,64,39,745,391,354,85,81,52,39,1
3714,256,125,131,36,39,32,13,341,154,187,34,36,11,11,1
3715,270,136,134,38,31,31,4,331,169,162,40,28,22,14,1
3716,335,128,207,59,43,24,23,1390,695,695,180,137,170,71,1
3717,303,159,144,40,35,35,8,906,455,451,116,105,87,46,1
3718,504,234,270,88,86,55,16,641,324,317,88,92,49,14,1
3719,433,229,204,60,59,53,24,3685,1574,2111,579,580,303,116,1
3720,1927,1023,904,240,218,310,45,592,283,309,84,137,60,20,1
3721,433,229,204,60,59,53,24,837,399,438,112,144,71,32,1
3722,317,153,164,39,30,35,13,620,396,224,53,44,97,26,1
3723,281,166,115,34,17,36,16,163,70,93,28,21,17,6,1
3724,503,263,240,72,55,51,34,814,343,471,133,101,80,41,1
3725,306,128,178,49,59,17,9,521,267,254,53,68,39,15,1
3726,673,317,356,101,85,76,49,396,169,227,74,59,35,17,1
3727,221,72,149,69,39,20,8,240,99,141,53,38,29,15,1
3728,433,226,207,52,60,58,20,2157,1171,986,306,238,131,32,1
3729,558,306,252,75,55,74,23,125,75,50,14,8,18,7,1
3730,186,99,87,30,17,18,8,376,176,200,31,53,27,8,1
3731,628,341,287,77,59,55,31,1464,693,771,153,136,91,86,1
3732,1374,679,695,191,193,154,48,106,54,52,12,9,7,6,1
3733,947,482,465,143,107,89,37,501,240,261,80,62,49,42,1
3734,443,198,245,68,72,48,19,780,369,411,130,113,79,35,1
3735,414,207,207,59,47,54,18,427,218,209,61,53,45,26,1
3736,80,42,38,12,7,7,4,102,49,53,14,21,7,4,1
3737,323,156,167,52,45,39,18,548,250,298,85,64,56,21,1
3738,1362,633,729,220,150,93,43,1147,471,676,229,164,86,37,1
3739,352,212,140,37,17,61,20,99,48,51,15,7,7,7,1
3740,246,115,131,15,29,10,32,197,92,105,38,16,26,15,1
3741,261,126,135,41,36,24,11,273,126,147,54,49,25,18,1
3742,519,219,300,86,72,50,39,482,231,251,76,81,64,26,1
3743,684,288,396,107,90,54,42,428,228,200,47,33,53,14,1
3744,396,219,177,47,42,27,14,656,358,298,67,47,64,26,1
3745,2639,1436,1203,317,307,242,77,359,184,175,49,35,32,11,1
3746,165,77,88,28,27,19,10,1047,562,485,141,127,114,41,1
3747,164,77,87,33,19,6,7,245,111,134,36,27,18,6,1
3748,357,169,188,61,53,32,15,90,46,44,14,15,8,3,1
3749,665,304,361,90,72,63,28,711,344,367,87,109,74,24,1
3750,272,149,123,34,35,21,2,648,307,341,101,58,76,34,1
3751,784,391,393,105,113,86,21,466,186,280,71,84,30,11,1
3752,392,156,236,40,91,28,16,771,331,440,136,104,72,27,1
3753,1412,603,809,184,195,112,45,425,210,215,56,43,52,25,1
3754,318,176,142,25,32,35,25,212,106,106,35,19,15,9,1
3755,153,109,44,10,7,35,5,178,100,78,23,22,30,6,1
3756,98,53,45,14,6,7,6,350,214,136,33,23,49,27,1
3757,220,110,110,27,28,33,14,187,95,92,27,20,16,8,1
3758,97,55,42,15,13,11,2,384,211,173,43,30,60,26,1
3759,722,384,338,94,83,63,35,342,208,134,36,31,29,15,1
3760,575,314,261,62,79,43,24,1271,599,672,194,175,118,47,1
3761,654,317,337,95,111,44,13,1474,756,718,175,158,169,51,1
3762,876,457,419,88,124,67,47,393,186,207,58,50,36,22,1
3763,501,240,261,80,62,49,42,396,169,227,74,59,35,17,1
3764,461,197,264,86,97,43,10,354,166,188,53,55,40,19,1
3765,920,492,428,100,92,88,49,1076,517,559,139,136,72,34,1
3766,832,428,404,131,89,88,38,393,186,207,58,50,36,22,1
3767,406,212,194,50,52,24,18,326,141,185,57,39,33,20,1
3768,424,209,215,56,58,45,24,428,248,180,44,39,28,9,1
3769,504,245,259,64,54,42,14,570,292,278,80,65,72,23,1
3770,922,491,431,112,92,97,52,359,173,186,55,57,44,16,1
3771,205,91,114,31,36,13,8,339,170,169,32,17,24,13,1
3772,1210,578,632,172,184,94,66,755,348,407,109,98,49,23,1
3773,361,184,177,50,53,51,22,178,89,89,26,21,21,10,1
3774,710,307,403,117,176,37,9,350,180,170,64,46,55,12,1
3775,505,178,327,108,131,34,19,377,202,175,46,50,41,23,1
3776,948,484,464,122,113,130,38,468,242,226,58,42,49,19,1
3777,410,189,221,56,52,33,20,822,392,430,125,104,79,24,1
3778,1014,490,524,177,137,94,38,164,78,86,28,23,12,8,1
3779,982,494,488,150,117,91,45,1265,580,685,205,188,166,53,1
3780,392,156,236,40,91,28,16,406,216,190,59,56,45,15,1
3781,558,289,269,83,59,75,19,297,145,152,49,30,23,21,1
3782,216,104,112,27,18,35,20,334,178,156,41,29,37,22,1
3783,1738,821,917,242,196,181,58,724,334,390,112,109,79,17,1
3784,391,208,183,65,49,57,17,217,108,109,30,23,28,10,1
3785,509,295,214,55,41,69,35,317,156,161,49,51,18,10,1
3786,673,313,360,101,101,46,17,201,78,123,38,31,19,4,1
3787,508,268,240,92,58,56,21,976,496,480,128,111,121,48,1
3788,118,56,62,13,14,6,6,400,221,179,51,42,38,16,1
3789,603,311,292,102,71,66,23,263,159,104,30,27,31,11,1
3790,283,142,141,35,29,32,5,417,217,200,70,55,42,16,1
3791,172,80,92,28,22,21,4,815,418,397,97,62,70,17,1
3792,450,241,209,67,58,54,23,529,283,246,66,69,66,25,1
3793,969,505,464,123,133,92,33,349,152,197,55,47,27,13,1
3794,366,211,155,35,42,24,12,694,260,434,122,92,62,36,1
3795,826,423,403,129,93,82,42,440,246,194,62,49,41,16,1
3796,1311,514,797,220,157,168,108,552,285,267,74,51,69,24,1
3797,1362,633,729,220,150,93,43,363,178,185,54,48,21,13,1
3798,695,340,355,79,124,53,13,1675,875,800,213,219,196,72,1
3799,499,252,247,74,42,55,14,620,307,313,92,91,92,33,1
3800,436,235,201,62,45,56,17,390,209,181,59,47,41,26,1
3801,488,296,192,66,54,77,9,418,213,205,54,56,49,13,1
3802,323,198,125,28,25,34,15,721,379,342,89,73,68,25,1
3803,205,103,102,20,32,21,5,1394,717,677,194,190,135,53,1
3804,1382,689,693,186,176,167,77,413,227,186,45,34,58,23,1
3805,669,323,346,94,89,34,18,202,102,100,29,35,6,9,1
3806,425,210,215,56,43,52,25,374,218,156,51,26,64,11,1
3807,103,44,59,16,17,9,5,1417,598,819,223,188,135,58,1
3808,486,254,232,45,33,38,28,476,227,249,52,59,38,17,1
3809,577,288,289,85,56,40,20,445,225,220,47,62,53,26,1
3810,280,114,166,56,28,48,35,508,267,241,43,35,25,17,1
3811,150,79,71,19,29,19,6,275,125,150,37,48,27,7,1
3812,727,259,468,163,157,68,15,346,180,166,55,49,38,6,1
3813,882,432,450,115,111,68,44,425,210,215,56,43,52,25,1
3814,1085,646,439,108,65,36,19,349,131,218,66,76,22,9,1
3815,625,286,339,92,59,83,42,491,270,221,51,47,53,18,1
3816,534,267,267,69,75,58,17,463,244,219,54,58,47,21,1
3817,294,122,172,46,65,18,11,1620,884,736,194,161,162,80,1
3818,568,243,325,98,73,56,44,362,174,188,46,55,35,23,1
3819,480,232,248,73,40,44,30,785,374,411,56,42,38,25,1
3820,616,304,312,75,71,55,25,299,128,171,57,40,13,25,1
3821,516,298,218,62,57,49,19,427,236,191,49,54,46,13,1
3822,399,234,165,50,36,67,22,288,156,132,37,32,22,11,1
3823,622,331,291,69,74,45,21,3418,1378,2040,515,464,318,121,1
3824,900,484,416,119,110,77,29,446,265,181,51,35,27,17,1
3825,1861,896,965,265,187,156,70,906,485,421,112,98,112,39,1
3826,362,183,179,49,49,41,11,1270,557,713,130,195,57,30,1
3827,707,359,348,122,89,63,20,467,224,243,70,43,67,23,1
3828,80,44,36,4,1,4,2,512,261,251,79,73,60,21,1
3829,379,203,176,55,48,45,16,179,76,103,36,32,9,9,1
3830,415,243,172,47,24,76,19,174,89,85,25,16,18,10,1
3831,251,144,107,33,23,23,8,2725,1490,1235,339,333,254,78,1
3832,333,127,206,66,68,25,14,377,184,193,56,53,44,14,1
3833,3661,1791,1870,463,425,340,151,1129,589,540,134,122,108,46,1
3834,346,180,166,55,49,38,6,349,183,166,56,55,38,5,1
3835,1270,682,588,165,147,136,54,361,184,177,50,53,51,22,1
3836,1907,1008,899,235,224,195,73,1242,613,629,174,113,114,53,1
3837,537,276,261,75,68,68,22,781,418,363,92,90,64,41,1
3838,1599,806,793,213,237,100,45,431,186,245,79,83,37,18,1
3839,84,61,23,9,2,13,2,260,138,122,44,30,28,6,1
3840,150,79,71,19,29,19,6,1174,594,580,175,155,126,66,1
3841,711,340,371,106,77,87,55,423,220,203,51,54,46,17,1
3842,930,367,563,181,153,83,48,844,398,446,141,122,70,26,1
3843,595,316,279,86,60,65,40,354,169,185,54,54,41,19,1
3844,309,154,155,42,44,45,16,480,234,246,79,77,65,23,1
3845,215,115,100,27,28,34,16,333,127,206,66,68,25,14,1
3846,429,219,210,46,66,42,17,323,162,161,53,41,40,13,1
3847,279,106,173,48,35,41,39,194,94,100,33,28,14,7,1
3848,423,247,176,58,55,29,20,1441,657,784,140,135,81,73,1
3849,379,203,176,55,48,45,16,741,387,354,118,104,90,27,1
3850,593,257,336,76,56,56,96,267,159,108,31,13,22,15,1
3851,261,139,122,30,33,23,6,619,332,287,95,77,74,38,1
3852,109,50,59,12,12,9,3,439,205,234,64,88,41,21,1
3853,116,55,61,14,14,18,8,638,295,343,90,103,69,20,1
3854,594,274,320,89,63,66,28,638,305,333,68,90,70,29,1
3855,219,134,85,22,27,22,10,273,154,119,34,26,20,11,1
3856,453,255,198,62,49,29,19,360,155,205,77,44,12,5,1
3857,770,385,385,78,83,60,16,297,158,139,47,37,37,9,1
3858,734,340,394,108,99,52,32,2817,1216,1601,379,436,183,115,1
3859,154,72,82,25,24,5,5,134,56,78,17,30,7,7,1
3860,297,158,139,47,37,37,9,763,361,402,103,144,78,45,1
3861,510,264,246,67,66,38,29,876,457,419,88,124,67,47,1
3862,445,235,210,60,31,63,28,97,53,44,13,12,7,5,1
3863,1336,633,703,182,197,110,52,393,210,183,55,50,34,19,1
3864,258,133,125,24,13,30,11,423,220,203,51,54,46,17,1
3865,341,190,151,50,41,23,15,271,159,112,34,34,33,7,1
3866,128,58,70,22,14,4,7,63,29,34,13,10,4,8,1
3867,428,248,180,44,39,28,9,380,187,193,38,51,30,18,1
3868,184,95,89,22,22,19,7,766,386,380,101,81,78,31,1
3869,212,106,106,35,19,15,9,202,102,100,29,35,6,9,1
3870,359,184,175,49,35,32,11,1838,1168,670,185,225,103,35,1
3871,962,430,532,109,142,61,34,198,95,103,29,26,22,8,1
3872,933,493,440,140,108,124,32,672,334,338,110,93,91,41,1
3873,339,183,156,43,45,28,17,2045,985,1060,359,339,199,74,1
3874,749,384,365,108,105,86,31,382,200,182,53,36,51,16,1
3875,391,204,187,47,48,38,18,482,231,251,76,81,64,26,1
3876,2524,1232,1292,398,317,186,61,595,316,279,86,60,65,40,1
3877,482,231,251,76,81,64,26,3664,1638,2026,598,519,231,63,1
3878,743,377,366,87,74,68,30,770,390,380,104,76,78,32,1
3879,499,252,247,74,42,55,14,1944,1018,926,227,203,219,95,1
3880,523,270,253,85,80,39,31,769,329,440,116,66,55,22,1
3881,455,218,237,57,51,42,35,217,109,108,34,32,35,7,1
3882,1474,808,666,160,146,166,60,2347,1234,1113,252,242,302,85,1
3883,277,124,153,44,40,35,18,557,306,251,66,42,52,15,1
3884,344,181,163,61,37,40,14,632,285,347,102,78,43,29,1
3885,1190,638,552,162,95,112,18,617,386,231,60,48,76,38,1
3886,172,88,84,24,31,20,12,1023,561,462,117,125,96,48,1
3887,436,201,235,54,37,34,20,162,73,89,32,19,4,4,1
3888,436,201,235,54,37,34,20,520,224,296,69,64,31,29,1
3889,1048,553,495,125,62,58,31,1312,477,835,230,273,80,35,1
3890,702,298,404,134,111,48,18,2639,1436,1203,317,307,242,77,1
3891,1273,592,681,199,164,139,39,1290,597,693,182,182,119,63,1
3892,925,484,441,112,86,84,31,486,290,196,56,49,49,19,1
3893,651,306,345,85,64,61,32,442,254,188,46,22,40,19,1
3894,154,75,79,17,24,16,13,870,418,452,121,102,109,28,1
3895,246,125,121,33,31,34,18,503,263,240,72,55,51,34,1
3896,480,196,284,72,74,25,2,825,363,462,97,105,72,75,1
3897,586,270,316,83,80,59,21,2089,917,1172,285,306,83,39,1
3898,510,243,267,65,67,44,44,1072,538,534,145,128,106,68,1
3899,486,230,256,70,60,43,34,496,251,245,66,57,39,22,1
3900,1242,613,629,174,113,114,53,1335,701,634,163,140,140,64,1
3901,219,116,103,36,31,27,9,181,96,85,25,23,20,7,1
3902,651,323,328,90,65,64,24,497,185,312,63,92,38,28,1
3903,429,187,242,79,72,28,19,2639,1436,1203,317,307,242,77,1
3904,298,140,158,51,33,21,22,170,35,135,33,25,8,5,1
3905,776,356,420,122,103,85,30,163,71,92,22,38,11,7,1
3906,512,248,264,66,71,49,30,539,241,298,100,64,54,34,1
3907,509,254,255,67,55,52,35,880,355,525,122,139,75,36,1
3908,425,210,215,56,43,52,25,2364,1004,1360,406,426,226,79,1
3909,265,103,162,61,58,25,3,769,329,440,116,66,55,22,1
3910,803,346,457,126,171,74,24,1255,666,589,145,142,120,82,1
3911,933,493,440,140,108,124,32,181,96,85,25,23,20,7,1
3912,734,366,368,121,99,63,39,173,110,63,35,6,9,8,1
3913,787,386,401,98,95,86,25,794,390,404,103,95,86,23,1
3914,1893,764,1129,308,323,126,60,367,161,206,70,48,41,19,1
3915,671,326,345,111,77,74,11,379,203,176,55,48,45,16,1
3916,393,210,183,55,50,34,19,596,286,310,90,89,78,37,1
3917,876,457,419,88,124,67,47,1800,882,918,202,185,186,49,1
3918,447,194,253,70,67,57,19,667,360,307,76,92,46,27,1
3919,575,295,280,89,68,54,18,298,167,131,47,33,40,8,1
3920,977,492,485,135,122,116,35,501,240,261,80,62,49,42,1
3921,686,345,341,93,81,69,30,196,99,97,28,32,17,12,1
3922,1447,698,749,214,180,116,46,354,169,185,54,54,41,19,1
3923,478,256,222,79,44,38,15,393,186,207,58,50,36,22,1
3924,1362,633,729,220,150,93,43,421,206,215,63,57,35,11,1
3925,906,455,451,116,105,87,46,787,386,401,98,95,86,25,1
3926,788,360,428,93,106,67,72,738,339,399,102,88,68,35,1
3927,497,185,312,63,92,38,28,229,105,124,36,33,12,4,1
3928,660,359,301,81,87,102,31,138,73,65,18,9,10,3,1
3929,560,348,212,62,55,30,16,1210,592,618,157,138,116,85,1
3930,1663,835,828,224,213,163,63,330,159,171,38,30,46,25,1
3931,302,138,164,50,36,30,20,147,75,72,22,14,14,6,1
3932,168,120,48,7,5,20,7,219,124,95,22,22,23,5,1
3933,657,305,352,95,81,98,35,950,497,453,146,127,115,43,1
3934,1477,738,739,176,176,145,72,386,216,170,60,41,38,12,1
3935,127,55,72,35,7,15,10,355,220,135,43,26,65,20,1
3936,1435,649,786,214,181,135,54,882,432,450,115,111,68,44,1
3937,382,214,168,49,20,47,23,377,214,163,41,22,48,15,1
3938,2224,1037,1187,288,276,273,74,417,182,235,57,109,50,8,1
3939,1117,423,694,182,134,88,31,466,186,280,71,84,30,11,1
3940,95,41,54,15,16,8,5,640,308,332,91,102,49,21,1
3941,435,222,213,67,49,67,12,861,393,468,150,101,69,35,1
3942,552,264,288,82,64,48,20,822,392,430,125,104,79,24,1
3943,821,387,434,121,131,76,29,230,108,122,44,32,19,9,1
3944,536,278,258,72,63,62,20,1149,568,581,177,133,101,30,1
3945,323,154,169,52,52,32,9,1749,880,869,237,228,214,112,1
3946,168,76,92,26,21,19,4,247,110,137,34,45,23,10,1
3947,639,310,329,91,94,46,15,297,158,139,47,37,37,9,1
3948,137,60,77,23,23,9,6,1581,891,690,189,147,181,64,1
3949,598,301,297,76,53,71,36,510,264,246,67,66,38,29,1
3950,724,320,404,120,147,67,25,770,374,396,95,91,79,41,1
3951,373,194,179,42,54,26,13,605,263,342,73,103,54,18,1
3952,656,358,298,67,47,64,26,441,175,266,73,88,26,8,1
3953,504,269,235,58,62,43,17,433,220,213,67,68,31,19,1
3954,204,93,111,35,35,16,11,288,142,146,52,32,26,8,1
3955,847,402,445,137,119,102,41,191,98,93,26,18,19,9,1
3956,335,185,150,46,34,36,13,422,213,209,63,60,35,13,1
3957,708,290,418,71,143,67,27,147,79,68,20,15,19,8,1
3958,163,70,93,28,21,17,6,473,212,261,72,64,45,28,1
3959,715,355,360,118,79,71,29,125,58,67,20,16,10,5,1
3960,501,293,208,58,58,64,14,327,177,150,40,40,38,18,1
3961,326,140,186,53,36,41,16,2442,1193,1249,278,183,170,145,1
3962,76,31,45,8,14,3,1,358,196,162,58,49,54,9,1
3963,512,261,251,79,73,60,21,375,202,173,46,49,41,23,1
3964,269,140,129,27,26,30,19,454,223,231,38,45,24,19,1
3965,1121,650,471,143,110,132,55,356,171,185,51,59,24,11,1
3966,220,127,93,26,19,27,7,339,170,169,32,17,24,13,1
3967,246,108,138,32,44,21,10,697,373,324,105,83,95,38,1
3968,505,239,266,71,55,50,18,466,242,224,66,53,53,13,1
3969,147,86,61,23,15,22,4,142,80,62,24,12,21,4,1
3970,201,98,103,28,25,19,13,552,285,267,74,51,69,24,1
3971,798,378,420,99,94,71,63,2477,1186,1291,256,271,249,90,1
3972,1431,798,633,201,144,78,29,921,455,466,144,127,108,39,1
3973,555,278,277,60,70,48,18,593,266,327,102,84,69,24,1
3974,636,320,316,79,61,67,31,832,428,404,131,89,88,38,1
3975,683,288,395,125,94,77,39,308,170,138,38,35,45,14,1
3976,473,212,261,72,64,45,28,432,228,204,59,53,43,15,1
3977,604,275,329,95,69,52,25,2524,1232,1292,398,317,186,61,1
3978,686,375,311,89,80,63,20,270,116,154,50,32,34,17,1
3979,939,493,446,113,100,87,31,3144,1617,1527,367,342,278,136,1
3980,377,180,197,45,63,19,17,229,105,124,36,33,12,4,1
3981,255,134,121,36,40,29,13,543,265,278,52,37,54,19,1
3982,589,294,295,37,44,27,33,366,124,242,80,63,25,8,1
3983,278,137,141,47,32,28,20,467,226,241,55,48,54,23,1
3984,876,457,419,88,124,67,47,294,148,146,35,33,25,14,1
3985,415,189,226,69,54,50,21,536,278,258,72,63,62,20,1
3986,392,156,236,40,91,28,16,122,47,75,18,25,5,5,1
3987,545,289,256,75,72,42,22,360,188,172,49,48,47,17,1
3988,95,44,51,14,13,7,4,241,124,117,30,35,24,8,1
3989,1290,629,661,191,187,167,55,659,325,334,102,85,87,32,1
3990,360,192,168,55,45,48,16,654,344,310,80,69,57,15,1
3991,114,71,43,8,18,7,4,171,94,77,24,28,30,11,1
3992,1893,850,1043,280,340,169,80,551,298,253,63,65,45,19,1
3993,769,405,364,97,101,49,35,163,70,93,28,21,17,6,1
3994,672,334,338,110,93,91,41,648,307,341,101,58,76,34,1
3995,502,240,262,78,61,54,32,459,229,230,78,65,59,26,1
3996,2644,1346,1298,391,304,315,148,791,391,400,103,94,59,38,1
3997,345,176,169,34,31,36,11,465,225,240,65,44,65,25,1
3998,470,256,214,56,39,47,34,1158,481,677,169,129,86,40,1
3999,489,253,236,68,68,46,23,1049,493,556,146,138,87,41,1
4000,261,127,134,42,37,24,11,603,311,292,102,71,66,23,1
4001,439,177,262,78,73,40,21,673,317,356,101,85,76,49,1
4002,636,336,300,94,65,58,32,628,315,313,88,95,54,28,1
4003,1338,506,832,241,229,101,40,787,386,401,98,95,86,25,1
4004,538,282,256,58,36,60,31,541,361,180,41,44,41,19,1
4005,443,198,245,68,72,48,19,423,222,201,51,33,41,28,1
4006,1018,547,471,122,122,120,33,1358,659,699,129,178,134,63,1
4007,589,316,273,83,60,69,25,318,164,154,52,43,34,10,1
4008,972,519,453,109,98,120,39,1047,562,485,141,127,114,41,1
4009,215,115,100,27,28,34,16,522,283,239,65,64,76,22,1
4010,459,251,208,67,49,40,23,663,323,340,89,89,76,22,1
4011,606,279,327,81,70,49,34,1158,481,677,169,129,86,40,1
4012,362,233,129,37,17,51,18,546,241,305,61,128,31,26,1
4013,1129,500,629,171,148,85,30,526,264,262,77,71,61,27,1
4014,2442,1193,1249,278,183,170,145,545,230,315,91,101,50,16,1
4015,421,206,215,63,57,35,11,315,118,197,85,57,42,14,1
4016,409,200,209,69,56,44,13,356,208,148,42,26,57,15,1
4017,585,289,296,102,86,61,18,79,43,36,10,10,17,3,1
4018,777,387,390,90,87,65,37,1210,578,632,172,184,94,66,1
4019,756,348,408,101,103,60,40,503,263,240,72,55,51,34,1
4020,190,96,94,21,17,23,10,402,227,175,48,40,35,11,1
4021,288,120,168,54,52,21,12,425,204,221,71,56,45,13,1
4022,673,317,356,101,85,76,49,274,158,116,27,27,22,18,1
4023,372,237,135,38,22,39,26,418,204,214,68,66,38,12,1
4024,382,207,175,55,32,40,13,1247,620,627,134,149,142,58,1
4025,1721,809,912,268,234,144,50,240,125,115,34,32,30,8,1
4026,95,44,51,14,13,7,4,415,219,196,53,55,57,20,1
4027,355,168,187,55,48,40,15,326,217,109,32,20,43,18,1
4028,1105,479,626,182,125,80,29,386,189,197,54,57,39,16,1
4029,375,167,208,55,83,44,9,130,70,60,30,9,8,1,1
4030,95,44,51,14,13,7,4,252,125,127,33,25,26,19,1
4031,517,250,267,78,37,64,29,279,106,173,48,35,41,39,1
4032,402,227,175,48,40,35,11,599,314,285,80,72,58,20,1
4033,351,184,167,59,45,54,9,902,495,407,116,97,111,37,1
4034,631,261,370,110,109,50,26,193,99,94,31,31,16,12,1
4035,595,316,279,86,60,65,40,423,247,176,58,55,29,20,1
4036,497,227,270,70,63,66,30,165,77,88,28,27,19,10,1
4037,175,101,74,20,20,20,9,460,274,186,50,34,69,27,1
4038,412,193,219,70,56,51,26,928,442,486,139,118,91,43,1
4039,825,363,462,97,105,72,75,573,316,257,78,80,21,21,1
4040,473,254,219,66,67,41,16,551,298,253,63,65,45,19,1
4041,489,242,247,83,63,62,19,432,188,244,76,81,26,13,1
4042,295,139,156,48,31,30,17,309,154,155,42,44,45,16,1
4043,1534,735,799,174,152,134,126,558,286,272,76,67,45,30,1
4044,1102,552,550,174,137,137,45,189,90,99,26,29,17,11,1
4045,729,321,408,128,84,63,26,473,212,261,72,64,45,28,1
4046,660,326,334,106,61,71,32,209,78,131,33,42,11,7,1
4047,673,329,344,111,95,92,41,187,96,91,30,24,24,4,1
4048,136,66,70,33,11,9,4,111,29,82,10,54,0,1,1
4049,326,140,186,53,36,41,16,963,532,431,99,110,105,44,1
4050,870,433,437,133,121,95,25,445,255,190,57,53,56,28,1
4051,558,249,309,97,66,52,22,700,305,395,111,99,54,18,1
4052,729,391,338,80,64,71,34,261,121,140,35,48,28,12,1
4053,207,97,110,34,27,22,10,901,458,443,91,129,86,21,1
4054,473,224,249,82,63,48,24,331,169,162,40,28,22,14,1
4055,707,386,321,85,83,99,28,1669,1162,507,154,128,86,51,1
4056,426,237,189,44,44,49,21,595,289,306,87,62,84,40,1
4057,33423,16370,17053,4965,4756,2786,883,149,68,81,15,38,11,10,1
4058,110,67,43,9,10,11,8,1367,690,677,172,175,154,83,1
4059,1738,821,917,242,196,181,58,1484,731,753,206,175,187,71,1
4060,391,189,202,55,56,56,12,329,168,161,48,34,41,16,1
4061,451,222,229,58,55,51,17,1863,721,1142,262,283,139,74,1
4062,652,329,323,65,70,51,50,808,415,393,112,107,81,25,1
4063,577,288,289,85,56,40,20,317,181,136,36,36,26,12,1
4064,673,313,360,101,101,46,17,1192,579,613,120,215,79,24,1
4065,1007,353,654,277,147,70,26,743,233,510,148,142,28,17,1
4066,1006,551,455,115,97,110,41,1834,823,1011,297,282,151,63,1
4067,674,268,406,118,96,70,21,574,269,305,91,63,54,27,1
4068,173,82,91,27,25,28,4,609,279,330,103,98,72,42,1
4069,502,240,262,78,61,54,32,814,343,471,133,101,80,41,1
4070,224,103,121,34,47,11,9,621,301,320,76,64,46,34,1
4071,154,75,79,17,24,16,13,858,441,417,110,135,90,40,1
4072,911,423,488,140,150,102,32,666,347,319,92,73,63,25,1
4073,257,148,109,28,20,21,14,920,492,428,100,92,88,49,1
4074,1992,927,1065,292,228,166,77,3312,1761,1551,403,345,309,127,1
4075,206,92,114,37,36,19,7,149,68,81,15,38,11,10,1
4076,230,130,100,31,16,27,11,419,241,178,57,42,40,21,1
4077,536,278,258,72,63,62,20,1074,538,536,154,140,111,51,1
4078,800,365,435,129,102,97,31,399,208,191,57,46,41,20,1
4079,908,488,420,115,97,111,43,906,474,432,90,125,74,24,1
4080,140,74,66,14,18,19,6,1032,395,637,190,189,71,40,1
4081,1311,514,797,220,157,168,108,465,225,240,65,44,65,25,1
4082,246,115,131,15,29,10,32,683,367,316,87,73,40,17,1
4083,603,311,292,102,71,66,23,163,70,93,28,21,17,6,1
4084,1094,543,551,171,121,129,54,163,71,92,22,38,11,7,1
4085,339,177,162,40,36,51,24,100,61,39,13,12,10,4,1
4086,546,267,279,90,69,56,19,72,35,37,10,9,7,6,1
4087,2045,985,1060,359,339,199,74,543,307,236,43,80,39,13,1
4088,1247,548,699,168,150,140,43,176,84,92,46,10,28,11,1
4089,92,44,48,6,8,9,8,158,76,82,18,23,14,8,1
4090,536,278,258,72,63,62,20,490,224,266,80,70,39,32,1
4091,1068,527,541,160,131,112,52,593,291,302,81,85,56,20,1
4092,102,61,41,15,13,8,2,517,295,222,60,55,55,19,1
4093,350,180,170,64,46,55,12,633,303,330,95,91,51,13,1
4094,1074,538,536,154,140,111,51,1342,673,669,178,154,137,94,1
4095,1253,639,614,181,155,164,73,621,273,348,104,102,48,19,1
4096,536,278,258,72,63,62,20,594,274,320,89,63,66,28,1
4097,473,224,249,82,63,48,24,365,188,177,60,47,48,16,1
4098,824,365,459,121,123,88,50,1308,652,656,166,153,149,87,1
4099,269,127,142,43,24,34,26,594,248,346,104,109,53,5,1
4100,647,324,323,71,95,65,32,512,261,251,79,73,60,21,1
4101,4655,2074,2581,545,652,562,399,91,45,46,9,11,3,9,1
4102,986,561,425,121,106,80,34,184,117,67,22,16,28,7,1
4103,1051,523,528,164,140,126,50,539,317,222,66,42,72,31,1
4104,290,149,141,46,38,33,9,467,224,243,70,43,67,23,1
4105,267,124,143,45,46,26,4,259,118,141,21,29,15,23,1
4106,482,231,251,76,81,64,26,1162,548,614,191,166,142,38,1
4107,240,100,140,28,39,31,16,393,186,207,58,50,36,22,1
4108,1424,650,774,152,124,95,87,163,70,93,28,21,17,6,1
4109,468,243,225,60,50,34,32,281,132,149,38,32,38,14,1
4110,431,245,186,50,23,46,17,2414,1189,1225,277,178,170,169,1
4111,391,208,183,65,49,57,17,156,88,68,29,14,12,11,1
4112,376,187,189,55,48,36,17,328,178,150,36,34,16,14,1
4113,433,214,219,53,70,32,10,341,178,163,48,44,42,20,1
4114,324,174,150,37,24,35,27,1588,631,957,275,292,183,66,1
4115,367,195,172,57,54,43,16,725,339,386,112,122,93,32,1
4116,218,133,85,20,19,13,6,800,416,384,102,105,83,22,1
4117,101,45,56,17,17,12,9,1132,646,486,99,102,71,41,1
4118,409,170,239,75,62,25,10,757,373,384,115,93,95,25,1
4119,524,264,260,75,75,40,21,465,229,236,68,62,40,22,1
4120,939,493,446,113,100,87,31,695,340,355,79,124,53,13,1
4121,684,288,396,107,90,54,42,1627,782,845,204,187,202,108,1
4122,279,170,109,31,24,16,12,186,98,88,26,24,27,8,1
4123,956,475,481,122,128,100,50,670,306,364,95,74,73,45,1
4124,1210,485,725,205,139,79,34,467,224,243,70,43,67,23,1
4125,207,137,70,16,9,23,17,253,151,102,23,23,33,18,1
4126,684,288,396,107,90,54,42,433,220,213,67,68,31,19,1
4127,546,267,279,90,69,56,19,446,265,181,51,35,27,17,1
4128,1441,657,784,140,135,81,73,295,143,152,38,47,22,25,1
4129,963,447,516,120,146,87,74,345,174,171,46,34,45,28,1
4130,391,208,183,65,49,57,17,558,289,269,83,59,75,19,1
4131,377,171,206,59,58,41,22,376,183,193,50,50,43,21,1
4132,835,419,416,119,94,106,40,474,268,206,66,42,45,24,1
4133,304,160,144,39,30,40,14,86,52,34,9,8,8,3,1
4134,594,340,254,77,64,62,21,711,435,276,72,62,51,20,1
4135,181,96,85,26,23,18,7,415,209,206,60,67,39,18,1
4136,270,136,134,38,31,31,4,770,390,380,104,76,78,32,1
4137,794,402,392,96,84,86,30,247,146,101,27,13,4,1,1
4138,755,271,484,113,226,61,20,437,167,270,126,95,34,10,1
4139,761,346,415,114,113,89,35,504,234,270,88,86,55,16,1
4140,283,112,171,48,39,34,15,1210,578,632,172,184,94,66,1
4141,736,388,348,88,85,67,28,335,172,163,54,29,39,13,1
4142,435,208,227,68,64,53,23,595,316,279,86,60,65,40,1
4143,536,278,258,72,63,62,20,530,259,271,83,50,54,41,1
4144,698,345,353,104,87,81,50,297,145,152,49,30,23,21,1
4145,1182,599,583,162,130,106,41,175,91,84,22,18,11,20,1
4146,380,212,168,47,38,19,11,140,76,64,17,13,13,8,1
4147,512,261,251,79,73,60,21,215,115,100,27,28,34,16,1
4148,341,178,163,48,44,42,20,1248,584,664,184,164,155,67,1
4149,1066,587,479,127,108,118,48,593,295,298,70,85,48,13,1
4150,430,198,232,57,46,37,19,270,130,140,43,24,36,10,1
4151,574,273,301,101,74,68,26,2383,1253,1130,323,292,273,107,1
4152,517,196,321,103,98,34,12,433,220,213,67,68,31,19,1
4153,1807,933,874,248,203,173,71,215,105,110,26,22,19,9,1
4154,2477,1186,1291,256,271,249,90,1670,1140,530,173,120,89,53,1
4155,671,318,353,83,124,46,34,94,55,39,18,6,18,5,1
4156,537,272,265,75,83,41,29,354,169,185,54,54,41,19,1
4157,432,228,204,59,53,43,15,1068,527,541,160,131,112,52,1
4158,296,145,151,42,37,27,13,1210,592,618,157,138,116,85,1
4159,341,190,151,50,41,23,15,361,184,177,50,53,51,22,1
4160,435,208,227,68,64,53,23,317,153,164,34,52,30,14,1
4161,545,289,256,75,72,42,22,1212,709,503,137,127,132,42,1
4162,391,208,183,65,49,57,17,169,64,105,23,37,11,3,1
4163,450,241,209,67,58,54,23,413,227,186,45,34,58,23,1
4164,759,391,368,103,82,101,45,1038,470,568,130,123,86,51,1
4165,380,184,196,58,52,46,8,437,225,212,61,57,66,12,1
4166,252,146,106,23,19,25,7,337,164,173,59,34,47,18,1
4167,89,47,42,11,5,6,9,140,86,54,17,6,20,7,1
4168,330,159,171,48,38,50,19,763,343,420,127,70,105,34,1
4169,1165,567,598,134,119,158,63,593,266,327,102,84,69,24,1
4170,249,140,109,34,26,25,12,686,375,311,89,80,63,20,1
4171,247,135,112,38,18,29,13,485,273,212,52,47,51,17,1
4172,201,42,159,19,3,2,75,311,176,135,51,29,37,8,1
4173,501,285,216,52,55,62,25,125,82,43,15,6,20,9,1
4174,979,534,445,83,77,80,24,467,224,243,70,43,67,23,1
4175,330,143,187,63,29,52,20,456,257,199,68,44,60,25,1
4176,340,169,171,40,39,36,22,648,307,341,101,58,76,34,1
4177,225,102,123,32,32,31,15,577,258,319,96,59,48,23,1
4178,862,427,435,139,98,100,59,240,167,73,32,12,8,21,1
4179,217,98,119,38,35,18,9,439,220,219,63,72,25,20,1
4180,1454,780,674,182,120,135,67,778,367,411,90,85,64,43,1
4181,310,142,168,42,39,24,9,161,75,86,24,20,10,7,1
4182,351,184,167,59,45,54,9,198,86,112,24,29,25,15,1
4183,218,146,72,15,10,24,17,1748,791,957,281,247,173,25,1
4184,381,186,195,69,55,46,15,381,196,185,55,57,43,16,1
4185,114,71,43,8,18,7,4,744,384,360,104,96,57,31,1
4186,437,190,247,82,66,39,20,429,184,245,78,70,44,17,1
4187,199,106,93,29,23,26,7,454,191,263,61,66,38,15,1
4188,536,266,270,58,73,40,25,770,374,396,95,91,79,41,1
4189,280,156,124,36,19,20,13,1132,553,579,172,143,150,57,1
4190,1591,734,857,229,225,171,75,2390,1131,1259,395,383,203,74,1
4191,2363,875,1488,361,444,95,53,729,325,404,129,88,64,32,1
4192,393,210,183,44,53,53,23,190,100,90,29,12,20,6,1
4193,250,153,97,26,25,33,8,261,159,102,19,29,41,11,1
4194,1212,645,567,145,117,122,72,1447,698,749,214,180,116,46,1
4195,920,492,428,100,92,88,49,391,204,187,47,48,38,18,1
4196,465,225,240,65,44,65,25,939,493,446,113,100,87,31,1
4197,392,156,236,40,91,28,16,758,360,398,114,107,51,19,1
4198,443,248,195,67,54,40,15,770,374,396,95,91,79,41,1
4199,1425,670,755,153,189,122,85,592,264,328,86,85,62,41,1
4200,128,58,70,22,14,4,7,255,130,125,44,18,22,12,1
4201,1388,574,814,247,246,108,61,1030,368,662,172,188,56,20,1
4202,1508,733,775,216,186,172,60,118,51,67,25,13,6,7,1
4203,467,226,241,55,48,54,23,454,191,263,61,66,38,15,1
4204,246,115,131,15,29,10,32,258,157,101,28,27,21,7,1
4205,345,176,169,34,31,36,11,465,228,237,64,42,63,24,1
4206,494,234,260,88,81,61,29,854,380,474,137,159,81,31,1
4207,412,193,219,70,56,51,26,605,281,324,111,67,40,44,1
4208,562,265,297,79,56,72,45,3075,1459,1616,390,359,298,207,1
4209,815,418,397,97,62,70,17,653,327,326,91,79,55,39,1
4210,582,330,252,82,69,87,21,660,359,301,81,87,102,31,1
4211,815,418,397,97,62,70,17,572,309,263,64,55,47,29,1
4212,335,128,207,59,43,24,23,184,86,98,26,26,14,11,1
4213,582,293,289,94,80,77,32,440,246,194,62,49,41,16,1
4214,2472,1055,1417,416,458,235,64,864,362,502,142,150,70,19,1
4215,354,181,173,52,18,50,15,165,76,89,26,24,18,15,1
4216,1158,481,677,169,129,86,40,603,282,321,74,68,60,38,1
4217,451,225,226,68,57,65,22,271,131,140,47,37,41,11,1
4218,154,75,79,17,24,16,13,708,334,374,105,96,61,37,1
4219,796,445,351,96,80,90,38,632,339,293,83,77,59,20,1
4220,469,225,244,64,69,26,11,1210,592,618,157,138,116,85,1
4221,442,243,199,60,49,65,13,119,57,62,18,16,17,4,1
4222,1012,411,601,177,174,75,32,834,335,499,129,110,84,33,1
4223,71,37,34,11,9,5,5,748,355,393,121,91,95,26,1
4224,562,265,297,79,56,72,45,410,222,188,42,55,52,20,1
4225,193,108,85,24,15,18,9,379,203,176,55,48,45,16,1
4226,750,347,403,105,103,83,29,770,374,396,95,91,79,41,1
4227,534,266,268,86,62,37,14,1132,624,508,199,79,127,41,1
4228,277,173,104,26,12,48,19,1048,564,484,118,122,113,40,1
4229,346,180,166,55,49,38,6,443,248,195,67,54,40,15,1
4230,466,186,280,71,84,30,11,615,339,276,82,76,63,16,1
4231,248,120,128,43,37,20,6,603,311,292,102,71,66,23,1
4232,593,266,327,102,84,69,24,508,215,293,72,71,42,15,1
4233,171,94,77,24,28,30,11,367,161,206,70,48,41,19,1
4234,267,147,120,37,28,35,12,418,213,205,54,56,49,13,1
4235,555,278,277,60,70,48,18,4544,2024,2520,579,628,480,403,1
4236,442,230,212,50,58,56,23,1268,612,656,218,195,89,33,1
4237,175,91,84,22,18,11,20,233,121,112,24,31,30,7,1
4238,181,71,110,34,30,21,7,355,168,187,55,48,40,15,1
4239,747,427,320,107,71,91,25,601,313,288,42,48,25,36,1
4240,379,203,176,55,48,45,16,252,133,119,35,40,29,9,1
4241,442,228,214,44,53,39,18,298,160,138,37,30,22,12,1
4242,303,159,144,40,35,35,8,502,299,203,57,52,32,11,1
4243,288,118,170,50,57,18,15,630,393,237,47,45,100,30,1
4244,777,345,432,128,88,65,39,446,265,181,51,35,27,17,1
4245,242,111,131,35,35,17,13,155,85,70,17,16,4,8,1
4246,826,362,464,107,118,71,43,2414,1189,1225,277,178,170,169,1
4247,693,297,396,87,52,64,27,497,227,270,70,63,66,30,1
4248,1970,978,992,245,206,198,80,127,62,65,13,33,7,6,1
4249,272,135,137,34,30,31,8,552,356,196,60,55,52,22,1
4250,845,402,443,137,126,105,47,1132,553,579,172,143,150,57,1
4251,361,201,160,47,20,49,30,715,355,360,118,79,71,29,1
4252,476,251,225,57,67,57,18,598,300,298,68,77,59,21,1
4253,427,218,209,61,53,45,26,164,78,86,28,23,12,8,1
4254,512,269,243,69,70,62,29,505,273,232,70,57,60,33,1
4255,487,223,264,81,68,63,15,303,187,116,41,23,23,9,1
4256,732,355,377,108,109,79,27,1107,601,506,155,138,104,49,1
4257,277,124,153,44,40,35,18,256,125,131,36,39,32,13,1
4258,872,473,399,124,100,93,27,695,387,308,101,64,77,26,1
4259,593,283,310,91,57,27,25,291,133,158,46,51,21,15,1
4260,154,78,76,22,25,12,10,302,175,127,35,48,25,14,1
4261,4303,2489,1814,436,369,444,134,1134,574,560,157,164,47,48,1
4262,213,91,122,42,30,23,12,340,158,182,51,56,9,7,1
4263,608,301,307,93,71,84,20,765,295,470,200,142,84,27,1
4264,770,374,396,95,91,79,41,1009,506,503,146,141,97,55,1
4265,946,469,477,133,113,62,39,149,68,81,15,38,11,10,1
4266,586,270,316,83,80,59,21,754,318,436,114,106,58,28,1
4267,472,220,252,59,69,32,20,590,303,287,69,65,46,17,1
4268,663,360,303,88,82,80,35,372,199,173,56,45,40,15,1
4269,4544,2024,2520,579,628,480,403,178,100,78,23,22,30,6,1
4270,832,428,404,131,89,88,38,654,344,310,80,69,57,15,1
4271,608,336,272,61,49,78,31,2414,1189,1225,277,178,170,169,1
4272,168,67,101,37,17,13,13,390,237,153,41,57,22,16,1
4273,653,298,355,70,101,64,39,206,100,106,28,32,18,8,1
4274,294,146,148,50,45,51,15,140,86,54,17,6,20,7,1
4275,589,314,275,70,83,44,28,312,172,140,41,40,21,8,1
4276,1374,679,695,191,193,154,48,648,307,341,101,58,76,34,1
4277,1581,684,897,220,153,118,63,598,322,276,67,57,63,26,1
4278,693,359,334,75,54,59,20,247,110,137,34,45,23,10,1
4279,463,238,225,49,35,31,14,209,75,134,53,48,20,9,1
4280,1106,579,527,121,152,113,45,1290,629,661,191,187,167,55,1
4281,525,299,226,62,78,61,13,335,185,150,46,34,36,13,1
4282,451,278,173,71,35,58,12,107,36,71,27,15,0,1,1
4283,245,112,133,32,45,20,10,783,429,354,89,73,68,33,1
4284,429,219,210,46,66,42,17,454,200,254,86,74,43,13,1
4285,297,158,139,47,37,37,9,2758,1332,1426,394,384,287,131,1
4286,986,465,521,152,132,138,51,2146,1050,1096,330,305,194,74,1
4287,495,233,262,74,59,46,12,386,189,197,54,57,39,16,1
4288,1106,579,527,121,152,113,45,787,386,401,98,95,86,25,1
4289,461,208,253,79,76,61,21,928,442,486,139,118,91,43,1
4290,708,334,374,105,96,61,37,176,73,103,22,29,13,9,1
4291,95,47,48,13,12,10,4,133,66,67,21,24,9,2,1
4292,672,334,338,110,93,91,41,976,496,480,128,111,121,48,1
4293,881,383,498,142,148,77,24,906,485,421,112,98,112,39,1
4294,643,338,305,81,72,78,35,806,419,387,115,130,57,32,1
4295,365,180,185,63,35,48,19,300,140,160,39,35,14,12,1
4296,667,360,307,76,92,46,27,207,99,108,27,27,21,9,1
4297,579,321,258,74,70,47,22,536,266,270,58,73,40,25,1
4298,400,191,209,41,40,33,21,255,122,133,35,51,22,13,1
4299,559,239,320,57,73,48,28,403,188,215,70,42,41,11,1
4300,99,34,65,12,1,2,18,769,329,440,116,66,55,22,1
4301,331,169,162,40,28,22,14,595,316,279,86,60,65,40,1
4302,185,70,115,37,48,15,5,136,66,70,33,11,9,5,1
4303,329,171,158,49,41,31,10,261,130,131,27,41,19,16,1
4304,1573,791,782,198,173,148,46,665,297,368,111,107,34,12,1
4305,491,270,221,51,47,53,18,253,143,110,38,26,20,12,1
4306,2058,933,1125,317,304,250,74,377,202,175,46,50,41,23,1
4307,331,183,148,36,44,40,21,205,100,105,25,25,20,9,1
4308,424,209,215,56,58,45,24,390,175,215,53,61,26,22,1
4309,423,210,213,54,59,50,18,413,227,186,45,34,58,23,1
4310,438,242,196,48,33,62,26,176,106,70,30,15,18,5,1
4311,394,202,192,44,43,38,28,243,139,104,41,26,17,9,1
4312,156,72,84,27,24,20,7,449,240,209,59,55,63,20,1
4313,589,314,275,70,83,44,28,858,461,397,125,114,79,45,1
4314,557,306,251,66,42,52,15,351,189,162,39,28,21,16,1
4315,294,122,172,46,65,18,11,1071,549,522,133,127,130,59,1
4316,379,203,176,55,48,45,16,1141,583,558,141,98,91,45,1
4317,124,72,52,14,12,13,6,199,113,86,27,17,10,7,1
4318,101,41,60,18,19,10,5,497,185,312,63,92,38,28,1
4319,816,463,353,99,99,61,26,441,216,225,57,66,57,19,1
4320,586,309,277,81,64,76,25,416,209,207,76,45,50,17,1
4321,871,482,389,113,95,109,35,509,262,247,64,70,64,20,1
4322,745,391,354,85,81,52,39,999,504,495,95,119,78,42,1
4323,446,176,270,64,79,45,24,611,246,365,116,82,71,27,1
4324,223,132,91,18,16,27,17,288,135,153,41,31,36,17,1
4325,155,85,70,17,16,4,8,255,109,146,35,32,23,17,1
4326,173,110,63,35,6,9,8,5890,3314,2576,970,956,293,265,1
4327,700,305,395,111,99,54,18,1014,490,524,177,137,94,38,1
4328,247,110,137,34,45,23,10,462,251,211,74,53,41,18,1
4329,110,49,61,19,7,2,5,1696,771,925,257,225,149,63,1
4330,808,484,324,80,63,76,24,246,115,131,15,29,10,32,1
4331,712,380,332,69,74,57,30,416,201,215,54,52,39,25,1
4332,1367,690,677,172,175,154,83,676,333,343,111,89,94,39,1
4333,672,334,338,110,93,91,41,536,278,258,72,63,62,20,1
4334,928,442,486,139,118,91,43,358,212,146,51,36,33,9,1
4335,160,76,84,19,24,8,5,354,169,185,54,54,41,19,1
4336,1336,828,508,166,121,152,48,189,90,99,26,29,17,11,1
4337,392,203,189,53,66,26,8,486,229,257,75,104,49,10,1
4338,532,269,263,72,59,59,39,454,220,234,73,46,61,19,1
4339,1049,585,464,107,108,120,28,2477,1186,1291,256,271,249,90,1
4340,1113,520,593,168,139,109,49,2758,1332,1426,394,384,287,131,1
4341,1367,690,677,172,175,154,83,1047,562,485,141,127,114,41,1
4342,107,36,71,27,15,0,1,454,230,224,63,56,38,33,1
4343,854,380,474,137,159,81,31,676,333,343,111,89,94,39,1
4344,781,367,414,60,67,43,17,928,442,486,139,118,91,43,1
4345,1052,492,560,184,163,103,44,341,154,187,34,36,11,11,1
4346,594,305,289,86,63,51,21,1114,581,533,145,132,126,54,1
4347,348,172,176,46,34,46,16,652,329,323,65,70,51,50,1
4348,732,385,347,95,69,93,34,656,358,298,67,47,64,26,1
4349,730,328,402,126,99,48,23,697,373,324,105,83,95,38,1
4350,824,365,459,121,123,88,50,233,130,103,26,23,23,6,1
4351,1098,519,579,182,159,79,42,475,235,240,77,58,43,22,1
4352,2817,1216,1601,379,436,183,115,595,316,279,86,60,65,40,1
4353,862,409,453,149,125,86,29,745,391,354,85,81,52,39,1
4354,154,77,77,35,17,20,9,1132,646,486,99,102,71,41,1
4355,218,127,91,27,23,23,10,233,121,112,24,31,30,7,1
4356,313,160,153,51,33,43,23,748,355,393,121,91,95,26,1
4357,163,71,92,22,38,11,7,566,295,271,75,68,74,21,1
4358,465,225,240,65,44,65,25,1113,520,593,168,139,109,49,1
4359,1190,638,552,162,95,112,18,443,208,235,43,55,51,50,1
4360,393,186,207,58,50,36,22,261,127,134,33,24,30,13,1
4361,598,323,275,68,53,60,17,624,308,316,92,72,68,22,1
4362,472,264,208,46,26,50,29,920,492,428,100,92,88,49,1
4363,464,242,222,61,68,36,17,413,183,230,69,55,37,18,1
4364,117,52,65,11,27,7,6,526,257,269,72,63,62,30,1
4365,1549,848,701,182,150,179,69,424,219,205,61,40,40,23,1
4366,898,467,431,101,127,90,53,216,119,97,33,27,28,7,1
4367,484,192,292,118,68,83,22,754,182,572,236,122,57,18,1
4368,605,283,322,94,72,64,39,356,199,157,43,58,29,12,1
4369,208,104,104,20,54,9,5,377,184,193,50,43,33,17,1
4370,504,237,267,62,66,48,17,3695,1922,1773,449,360,352,261,1
4371,382,183,199,55,60,38,22,676,333,343,111,89,94,39,1
4372,764,277,487,158,162,64,31,432,228,204,59,53,43,15,1
4373,71,39,32,7,11,6,4,346,191,155,52,38,40,13,1
4374,428,186,242,76,55,46,12,533,254,279,81,78,52,10,1
4375,362,233,129,37,17,51,18,305,177,128,42,25,39,6,1
4376,247,110,137,34,45,23,10,1338,756,582,155,105,104,44,1
4377,184,91,93,26,25,16,7,163,82,81,15,32,24,7,1
4378,1275,579,696,200,172,125,51,255,122,133,35,51,22,13,1
4379,651,311,340,110,77,73,33,601,290,311,92,89,55,30,1
4380,2414,1189,1225,277,178,170,169,193,107,86,13,20,13,6,1
4381,345,203,142,47,35,31,11,802,388,414,131,105,96,29,1
4382,1863,721,1142,262,283,139,74,445,225,220,47,62,53,26,1
4383,1086,603,483,147,121,95,40,466,239,227,68,54,57,19,1
4384,432,218,214,57,55,42,11,288,155,133,38,33,34,10,1
4385,1102,511,591,171,179,148,52,544,291,253,62,53,35,26,1
4386,480,232,248,83,64,51,25,740,313,427,101,135,40,22,1
4387,276,136,140,39,34,33,9,976,520,456,120,115,109,53,1
4388,247,110,137,34,45,23,10,676,333,343,111,89,94,39,1
4389,949,512,437,102,124,70,41,1270,557,713,130,195,57,30,1
4390,184,95,89,22,22,19,7,1335,701,634,163,140,140,64,1
4391,414,185,229,53,54,49,11,400,195,205,63,67,40,18,1
4392,360,188,172,49,48,47,17,407,207,200,53,36,38,8,1
4393,262,144,118,19,39,22,8,1290,629,661,191,187,167,55,1
4394,854,380,474,137,159,81,31,505,268,237,68,59,34,15,1
4395,245,112,133,32,45,20,10,207,114,93,33,20,31,13,1
4396,247,127,120,43,20,27,14,331,145,186,40,56,16,9,1
4397,686,375,311,89,80,63,20,225,102,123,32,32,31,15,1
4398,231,102,129,35,22,24,13,358,179,179,49,48,49,8,1
4399,379,167,212,54,49,32,33,654,344,310,80,69,57,15,1
4400,366,191,175,37,33,19,19,324,154,170,57,40,26,4,1
4401,365,180,185,63,35,48,19,241,115,126,35,30,17,14,1
4402,449,244,205,68,53,49,12,787,386,401,98,95,86,25,1
4403,261,143,118,33,24,32,16,427,226,201,63,44,66,13,1
4404,525,299,226,54,54,51,19,367,161,206,70,48,41,19,1
4405,415,189,226,69,54,50,21,1179,579,600,140,133,122,53,1
4406,377,184,193,56,53,44,14,502,299,203,57,52,32,11,1
4407,715,322,393,105,82,77,51,667,294,373,97,80,70,38,1
4408,2442,1193,1249,278,183,170,145,508,267,241,43,35,25,17,1
4409,476,251,225,57,67,57,18,110,67,43,9,10,11,8,1
4410,222,110,112,43,30,14,6,215,115,100,27,28,34,16,1
4411,68,34,34,9,2,9,9,2472,1057,1415,331,352,159,96,1
4412,592,291,301,92,93,71,31,147,68,79,31,23,8,4,1
4413,247,110,137,34,45,23,10,444,230,214,46,61,53,26,1
4414,780,337,443,112,116,77,28,1149,568,581,177,133,101,30,1
4415,848,394,454,100,90,101,41,1085,646,439,108,65,36,19,1
4416,301,163,138,49,36,40,11,412,208,204,54,47,42,17,1
4417,258,113,145,43,44,16,7,288,118,170,50,57,18,15,1
4418,205,96,109,32,25,31,5,175,86,89,33,25,27,2,1
4419,434,223,211,39,76,40,19,590,306,284,69,82,68,27,1
4420,975,417,558,161,126,96,44,1434,727,707,210,173,161,54,1
4421,975,498,477,144,99,119,58,165,78,87,23,21,17,8,1
4422,875,421,454,124,142,98,43,170,88,82,26,29,19,6,1
4423,227,127,100,32,24,31,5,271,159,112,34,34,33,7,1
4424,928,442,486,139,118,91,43,1531,691,840,270,226,143,52,1
4425,439,177,262,78,73,40,21,771,321,450,151,135,43,15,1
4426,674,319,355,84,139,50,11,699,295,404,132,126,46,28,1
4427,355,165,190,53,56,42,19,360,218,142,39,26,50,18,1
4428,822,374,448,134,118,76,39,149,68,81,15,38,11,10,1
4429,557,278,279,75,70,66,31,393,210,183,55,50,34,19,1
4430,672,334,338,110,93,91,41,1382,689,693,186,176,167,77,1
4431,901,443,458,134,141,88,40,412,260,152,39,24,49,23,1
4432,2564,1278,1286,414,406,207,64,4377,1898,2479,663,608,331,126,1
4433,393,210,183,55,50,34,19,360,188,172,49,48,47,17,1
4434,500,244,256,66,57,52,27,482,231,251,76,81,64,26,1
4435,401,201,200,64,67,23,7,259,132,127,39,32,28,12,1
4436,465,261,204,51,35,48,21,873,489,384,110,84,59,47,1
4437,1423,620,803,193,207,127,66,166,81,85,30,27,13,8,1
4438,1308,652,656,166,153,149,87,208,107,101,42,22,18,10,1
4439,652,332,320,72,59,57,24,169,64,105,23,37,11,3,1
4440,136,66,70,33,11,9,3,608,336,272,61,49,78,31,1
4441,661,306,355,90,83,91,50,732,373,359,97,96,90,29,1
4442,298,167,131,47,33,40,8,134,60,74,19,13,10,7,1
4443,480,234,246,79,77,65,23,745,366,379,110,93,79,45,1
4444,1150,620,530,156,128,161,32,392,115,277,117,75,28,17,1
4445,1356,576,780,229,198,107,38,697,373,324,105,83,95,38,1
4446,335,185,150,46,34,36,13,204,104,100,26,27,21,11,1
4447,312,123,189,59,43,30,18,402,227,175,48,40,35,11,1
4448,2414,1189,1225,277,178,170,169,327,177,150,40,40,38,18,1
4449,277,124,153,44,40,35,18,512,261,251,79,73,60,21,1
4450,657,305,352,95,81,98,35,3056,1457,1599,438,389,329,168,1
4451,795,305,490,169,178,66,22,245,111,134,31,44,20,11,1
4452,1210,592,618,157,138,116,85,1051,523,528,164,140,126,50,1
4453,896,407,489,97,152,70,22,562,283,279,48,32,63,13,1
4454,324,219,105,25,24,27,14,367,197,170,49,36,36,18,1
4455,170,83,87,23,32,17,9,165,87,78,24,19,22,9,1
4456,806,419,387,115,130,57,32,1215,652,563,129,142,121,62,1
4457,585,277,308,92,73,61,32,1937,899,1038,336,332,181,86,1
4458,1074,538,536,154,140,111,51,750,347,403,105,103,83,29,1
4459,360,215,145,42,26,45,24,374,181,193,63,49,46,20,1
4460,336,154,182,51,48,39,22,255,130,125,44,18,22,12,1
4461,911,423,488,140,150,102,32,593,266,327,102,84,69,24,1
4462,315,150,165,49,59,23,15,144,63,81,28,32,11,5,1
4463,806,436,370,101,100,76,34,239,126,113,49,18,27,5,1
4464,665,304,361,90,72,63,28,427,218,209,61,53,45,26,1
4465,1336,828,508,166,121,152,48,1149,568,581,177,133,101,30,1
4466,918,427,491,113,111,113,33,372,206,166,43,32,49,12,1
4467,815,418,397,97,62,70,17,198,107,91,26,23,25,8,1
4468,465,225,240,65,44,65,25,242,104,138,41,33,37,8,1
4469,414,247,167,52,44,45,20,781,418,363,92,90,64,41,1
4470,271,133,138,45,30,24,10,527,263,264,75,71,41,15,1
4471,668,331,337,108,64,58,29,425,198,227,57,69,59,13,1
4472,467,226,241,55,48,54,23,589,281,308,69,39,63,20,1
4473,1504,777,727,179,209,162,49,1049,585,464,107,108,120,28,1
4474,391,189,202,55,56,56,12,339,177,162,40,36,51,24,1
4475,835,499,336,94,89,96,22,767,392,375,113,112,83,13,1
4476,500,297,203,66,33,53,15,441,216,225,55,67,34,16,1
4477,430,192,238,62,67,27,10,336,154,182,51,48,39,22,1
4478,1613,806,807,190,211,180,84,488,274,214,58,51,38,17,1
4479,317,152,165,43,40,27,26,1118,471,647,204,164,102,34,1
4480,336,134,202,51,64,27,12,361,161,200,43,63,9,19,1
4481,623,298,325,94,59,79,21,393,186,207,58,50,36,22,1
4482,676,346,330,85,72,64,41,124,72,52,14,12,13,6,1
4483,663,338,325,68,71,41,16,480,252,228,55,37,49,20,1
4484,651,306,345,85,64,61,32,733,340,393,111,93,61,25,1
4485,294,146,148,50,45,51,15,327,177,150,40,40,38,18,1
4486,150,81,69,24,23,16,4,346,178,168,57,50,56,9,1
4487,117,35,82,17,21,5,6,3144,1617,1527,367,342,278,136,1
4488,493,208,285,75,77,70,40,1117,423,694,182,134,88,31,1
4489,191,72,119,40,41,17,8,918,357,561,191,150,42,24,1
4490,1132,646,486,99,102,71,41,746,434,312,86,83,66,27,1
4491,639,322,317,73,82,39,23,2491,1175,1316,303,302,273,147,1
4492,465,225,240,65,44,65,25,972,463,509,138,117,91,53,1
4493,678,362,316,89,60,88,24,62,42,20,5,4,13,3,1
4494,2442,1193,1249,278,183,170,145,1130,639,491,87,188,57,41,1
4495,235,106,129,38,39,24,12,290,147,143,34,34,39,13,1
4496,673,313,360,101,101,46,17,213,91,122,42,30,23,12,1
4497,838,431,407,107,90,107,43,435,208,227,68,64,53,23,1
4498,158,71,87,23,21,17,12,149,77,72,37,10,20,5,1
4499,825,422,403,100,90,62,43,2803,1300,1503,392,510,170,57,1
4500,201,101,100,28,28,26,11,147,81,66,18,18,18,4,1
4501,310,161,149,34,31,35,12,1258,648,610,172,159,116,28,1
4502,159,84,75,13,28,10,8,505,247,258,72,71,60,27,1
4503,536,278,258,72,63,62,20,399,222,177,48,44,52,23,1
4504,297,183,114,31,22,46,14,760,461,299,96,53,99,35,1
4505,1356,672,684,171,172,134,59,359,174,185,54,56,43,16,1
4506,253,155,98,27,20,22,14,245,142,103,29,20,21,9,1
4507,204,119,85,28,18,27,8,1248,584,664,184,164,155,67,1
4508,582,293,289,94,80,77,32,499,252,247,74,42,55,14,1
4509,260,133,127,43,32,39,3,726,340,386,125,100,60,17,1
4510,508,215,293,72,71,42,15,217,109,108,34,32,35,7,1
4511,401,204,197,49,33,29,17,467,226,241,55,48,54,23,1
4512,195,100,95,27,20,17,11,456,220,236,67,75,30,21,1
4513,424,179,245,65,67,29,11,780,354,426,123,102,45,17,1
4514,537,272,265,75,83,41,29,359,173,186,55,57,44,16,1
4515,211,113,98,38,17,25,8,1132,553,579,172,143,150,57,1
4516,723,380,343,80,84,47,18,181,96,85,25,23,20,7,1
4517,575,314,261,62,79,43,24,770,355,415,103,142,75,42,1
4518,2477,1186,1291,256,271,249,90,1712,1175,537,179,142,113,46,1
4519,113,55,58,20,8,8,3,826,423,403,129,93,82,42,1
4520,489,242,247,83,63,62,19,307,150,157,44,23,30,13,1
4521,812,456,356,105,74,101,29,1047,562,485,141,127,114,41,1
4522,247,110,137,34,45,23,10,724,334,390,112,109,79,17,1
4523,239,123,116,38,39,24,8,250,114,136,45,42,18,8,1
4524,165,85,80,29,25,16,13,375,202,173,46,49,41,23,1
4525,673,313,360,101,101,46,17,588,255,333,94,82,58,27,1
4526,478,239,239,65,66,65,21,272,124,148,51,36,23,27,1
4527,4640,2231,2409,660,549,437,245,247,110,137,34,45,23,10,1
4528,331,169,162,40,28,22,14,469,221,248,49,60,55,21,1
4529,384,238,146,38,26,66,19,109,50,59,20,7,10,9,1
4530,620,307,313,92,91,92,33,824,392,432,106,89,88,32,1
4531,268,157,111,26,30,28,13,327,172,155,38,41,41,15,1
4532,482,231,251,76,81,64,26,427,215,212,69,35,51,21,1
4533,595,276,319,120,55,77,39,770,374,396,95,91,79,41,1
4534,379,203,176,55,48,45,16,393,210,183,55,50,34,19,1
4535,118,51,67,25,13,6,7,1210,592,618,157,138,116,85,1
4536,620,258,362,106,100,47,28,632,285,347,102,78,43,29,1
4537,525,299,226,54,54,51,19,467,250,217,59,52,41,19,1
4538,146,74,72,16,31,9,4,693,363,330,76,76,69,25,1
4539,394,202,192,44,43,38,28,538,206,332,116,66,81,40,1
4540,357,187,170,51,34,40,23,1152,556,596,146,159,31,39,1
4541,666,347,319,92,73,63,25,499,249,250,79,63,61,22,1
4542,134,64,70,19,24,19,4,680,351,329,93,97,87,27,1
4543,398,196,202,61,45,34,18,297,158,139,47,37,37,9,1
4544,351,184,167,59,45,54,9,1130,614,516,129,138,98,42,1
4545,291,155,136,34,33,29,15,318,156,162,42,29,26,17,1
4546,1089,544,545,138,160,117,43,1106,579,527,121,152,113,45,1
4547,748,355,393,121,91,95,26,986,418,568,159,99,110,42,1
4548,313,178,135,43,18,35,6,631,315,316,64,57,49,15,1
4549,412,193,219,70,56,51,26,1068,527,541,160,131,112,52,1
4550,211,114,97,32,24,19,10,478,223,255,80,81,41,24,1
4551,1669,1162,507,154,128,86,51,617,387,230,65,57,77,16,1
4552,317,149,168,62,44,27,10,2948,1454,1494,327,456,140,81,1
4553,435,221,214,72,45,47,19,417,218,199,46,29,38,20,1
4554,506,272,234,54,43,43,20,563,214,349,128,68,101,41,1
4555,501,273,228,70,59,30,10,509,283,226,69,53,44,21,1
4556,183,91,92,21,29,16,10,465,225,240,65,44,65,25,1
4557,369,176,193,56,53,39,35,58,23,35,14,8,5,7,1
4558,662,322,340,101,89,76,21,1071,549,522,133,127,130,59,1
4559,138,89,49,9,11,11,7,191,85,106,24,34,19,5,1
4560,355,168,187,48,57,30,15,466,186,280,71,84,30,11,1
4561,583,322,261,73,66,45,26,553,261,292,73,79,40,26,1
4562,297,158,139,47,37,37,9,234,129,105,31,22,19,18,1
4563,350,180,170,64,46,55,12,961,463,498,139,156,62,34,1
4564,95,49,46,12,16,9,5,586,254,332,114,111,55,17,1
4565,451,237,214,74,59,65,19,1210,592,618,157,138,116,85,1
4566,95,44,51,14,13,7,4,586,240,346,94,110,29,19,1
4567,454,224,230,71,39,62,22,947,506,441,105,126,75,14,1
4568,1314,648,666,135,166,103,52,338,193,145,34,27,53,17,1
4569,825,422,403,100,90,62,43,302,111,191,44,61,23,13,1
4570,627,351,276,78,62,71,32,246,113,133,33,45,22,10,1
4571,398,203,195,69,51,65,11,427,204,223,38,57,26,32,1
4572,802,344,458,156,136,57,24,341,178,163,48,44,42,20,1
4573,190,94,96,25,24,18,5,497,227,270,70,63,66,30,1
4574,2524,1232,1292,398,317,186,61,500,244,256,66,57,52,27,1
4575,848,461,387,111,102,108,42,931,491,440,127,116,118,44,1
4576,531,279,252,71,57,70,25,2024,765,1259,283,343,137,76,1
4577,3056,1457,1599,438,389,329,168,339,183,156,43,45,28,17,1
4578,159,84,75,13,28,10,8,1608,778,830,243,230,159,74,1
4579,1038,470,568,130,123,86,51,346,192,154,47,29,33,13,1
4580,744,385,359,125,89,90,23,1122,437,685,152,187,105,40,1
4581,462,224,238,77,75,37,13,1480,789,691,195,151,173,55,1
4582,1712,926,786,199,198,156,71,5938,2573,3365,858,958,396,195,1
4583,1308,622,686,204,180,106,50,467,224,243,70,43,67,23,1
4584,1149,568,581,177,133,101,30,1132,553,579,172,143,150,57,1
4585,536,278,258,72,63,62,20,1114,581,533,145,132,126,54,1
4586,617,311,306,94,88,67,27,493,216,277,89,76,61,7,1
4587,724,320,404,120,147,67,25,480,234,246,79,77,65,23,1
4588,747,469,278,60,41,53,23,464,225,239,85,57,65,19,1
4589,509,254,255,67,55,52,35,375,198,177,48,44,45,22,1
4590,802,344,458,156,136,57,24,577,251,326,92,84,60,11,1
4591,552,285,267,74,51,69,24,2414,1189,1225,277,178,170,169,1
4592,585,299,286,92,73,89,23,501,268,233,61,62,58,31,1
4593,277,122,155,33,33,25,24,906,455,451,116,105,87,46,1
4594,475,238,237,73,53,63,17,757,359,398,109,127,80,26,1
4595,982,545,437,119,100,92,40,510,252,258,75,60,57,24,1
4596,677,245,432,129,155,72,11,1313,644,669,169,90,111,43,1
4597,2041,1035,1006,223,274,125,60,976,496,480,128,111,121,48,1
4598,465,225,240,65,44,65,25,425,210,215,56,43,52,25,1
4599,2286,1154,1132,338,314,278,103,1435,649,786,214,181,135,54,1
4600,167,72,95,31,45,14,5,240,125,115,34,32,30,8,1
4601,100,50,50,15,13,10,4,288,118,170,50,57,18,15,1
4602,815,382,433,97,50,88,31,465,225,240,65,44,65,25,1
4603,182,93,89,24,19,18,8,278,131,147,29,30,33,12,1
4604,76,42,34,12,8,5,7,1117,423,694,182,134,88,31,1
4605,1375,695,680,156,173,181,57,1609,694,915,204,241,132,122,1
4606,148,89,59,14,15,15,14,460,274,186,50,34,69,27,1
4607,432,115,317,127,90,24,15,247,110,137,34,45,23,10,1
4608,811,372,439,128,118,93,34,206,94,112,37,36,18,9,1
4609,287,124,163,52,48,24,16,580,339,241,72,47,66,21,1
4610,848,391,457,158,135,115,23,854,380,474,137,159,81,31,1
4611,341,178,163,48,44,42,20,901,458,443,91,129,86,21,1
4612,502,240,262,78,61,54,32,553,261,292,73,79,40,26,1
4613,81,41,40,15,13,3,2,534,267,267,69,75,58,17,1
4614,107,36,71,27,15,0,1,2442,1193,1249,278,183,170,145,1
4615,379,203,176,55,48,45,16,331,193,138,44,37,18,9,1
4616,313,149,164,48,31,30,13,928,442,486,139,118,91,43,1
4617,236,110,126,31,39,10,8,503,263,240,72,55,51,34,1
4618,1009,506,503,146,141,97,55,860,427,433,132,100,81,30,1
4619,2566,1142,1424,414,381,158,90,375,202,173,46,49,41,23,1
4620,503,263,240,72,55,51,34,882,432,450,115,111,68,44,1
4621,377,212,165,56,37,34,21,371,215,156,40,23,58,28,1
4622,91,50,41,8,14,4,5,95,47,48,13,12,10,4,1
4623,432,190,242,85,82,28,11,462,233,229,66,49,43,30,1
4624,223,113,110,31,33,22,12,646,316,330,89,95,48,17,1
4625,2946,1499,1447,365,342,315,119,418,213,205,54,70,38,18,1
4626,243,117,126,26,37,20,9,1290,629,661,191,187,167,55,1
4627,160,86,74,21,11,16,16,440,235,205,34,61,36,13,1
4628,543,246,297,99,93,50,29,253,148,105,31,15,39,16,1
4629,205,100,105,25,25,20,9,386,216,170,60,41,38,12,1
4630,240,125,115,34,32,30,8,160,67,93,32,37,15,9,1
4631,1158,481,677,169,129,86,40,778,367,411,90,85,64,43,1
4632,436,201,235,54,37,34,20,346,205,141,47,34,29,7,1
4633,261,102,159,45,36,31,37,920,492,428,100,92,88,49,1
4634,1210,592,618,157,138,116,85,839,408,431,138,122,105,46,1
4635,244,120,124,34,40,26,8,1102,511,591,171,179,148,52,1
4636,337,177,160,40,43,45,19,841,427,414,112,88,56,25,1
4637,187,92,95,13,51,14,11,497,185,312,63,92,38,28,1
4638,331,169,162,40,28,22,14,446,265,181,51,35,27,17,1
4639,425,210,215,56,43,52,25,504,259,245,73,56,45,29,1
4640,44,13,31,9,10,1,2,375,202,173,46,49,41,23,1
4641,508,214,294,90,39,57,39,331,169,162,40,28,22,14,1
4642,359,173,186,55,57,44,16,460,274,186,50,34,69,27,1
4643,247,110,137,34,45,23,10,2442,933,1509,388,478,90,56,1
4644,442,208,234,68,49,51,25,503,263,240,72,55,51,34,1
4645,361,172,189,51,54,25,4,2758,1332,1426,394,384,287,131,1
4646,277,124,153,44,40,35,18,592,291,301,92,93,71,31,1
4647,822,416,406,111,105,84,44,728,385,343,110,102,69,14,1
4648,3911,1465,2446,610,767,240,133,1150,506,644,154,176,124,52,1
4649,745,366,379,110,93,79,45,781,418,363,92,90,64,41,1
4650,1675,875,800,213,219,196,72,409,200,209,69,56,44,13,1
4651,181,84,97,32,29,19,8,354,166,188,53,55,40,19,1
4652,670,328,342,94,93,65,30,723,377,346,99,98,73,24,1
4653,350,200,150,45,47,23,8,193,118,75,25,19,10,7,1
4654,1382,689,693,186,176,167,77,1074,538,536,154,140,111,51,1
4655,152,87,65,20,19,14,5,403,188,215,70,42,41,11,1
4656,505,296,209,55,50,45,23,416,229,187,61,52,53,19,1
4657,497,227,270,70,63,66,30,499,250,249,78,81,46,25,1
4658,216,119,97,33,27,28,7,501,258,243,52,52,52,24,1
4659,298,154,144,44,34,25,11,737,397,340,87,104,90,14,1
4660,508,295,213,42,61,53,17,787,386,401,98,95,86,25,1
4661,731,383,348,102,84,68,30,1441,657,784,140,135,81,73,1
4662,895,474,421,122,93,69,25,368,195,173,52,41,42,15,1
4663,1441,657,784,140,135,81,73,401,226,175,53,18,38,20,1
4664,334,162,172,34,33,32,21,217,94,123,29,30,23,17,1
4665,4303,2489,1814,436,369,444,134,968,498,470,129,133,115,37,1
4666,406,191,215,63,39,42,25,270,147,123,34,17,39,21,1
4667,686,375,311,89,80,63,20,207,99,108,22,33,20,12,1
4668,272,130,142,58,40,29,4,339,170,169,32,17,24,13,1
4669,787,394,393,113,98,52,19,246,124,122,31,28,25,5,1
4670,132,69,63,16,14,6,15,360,224,136,26,20,50,35,1
4671,225,102,123,32,32,31,15,896,407,489,97,152,70,22,1
4672,323,154,169,52,52,32,9,240,125,115,34,32,30,8,1
4673,262,144,118,19,39,22,8,276,136,140,39,34,33,9,1
4674,2414,1189,1225,277,178,170,169,2948,1454,1494,327,456,140,81,1
4675,220,113,107,37,24,16,7,425,199,226,54,71,56,11,1
4676,667,312,355,100,134,47,20,239,129,110,39,31,33,13,1
4677,504,278,226,58,50,40,19,869,464,405,107,91,89,56,1
4678,585,354,231,66,39,80,42,1613,806,807,190,211,180,84,1
4679,301,150,151,45,47,33,13,855,420,435,139,134,109,35,1
4680,1257,464,793,221,264,75,37,290,127,163,47,58,23,12,1
4681,578,278,300,101,88,67,31,695,373,322,80,59,89,39,1
4682,368,154,214,80,52,41,16,1469,742,727,213,173,93,29,1
4683,876,457,419,88,124,67,47,365,180,185,63,35,48,19,1
4684,176,85,91,24,23,24,7,386,191,195,61,54,31,21,1
4685,1292,592,700,186,169,108,22,1258,648,610,172,159,116,28,1
4686,577,288,289,85,56,40,20,710,307,403,117,176,37,9,1
4687,595,316,279,86,60,65,40,470,256,214,56,39,47,34,1
4688,370,177,193,51,61,32,4,806,419,387,115,130,57,32,1
4689,415,250,165,43,28,50,21,98,46,52,16,6,2,9,1
4690,480,234,246,79,77,65,23,126,57,69,31,10,10,3,1
4691,96,49,47,16,6,10,10,374,210,164,41,22,53,27,1
4692,574,273,301,101,74,68,26,2549,1331,1218,366,296,271,130,1
4693,1257,464,793,221,264,75,37,1273,592,681,199,164,139,39,1
4694,767,392,375,113,112,83,13,1255,666,589,145,142,120,82,1
4695,445,209,236,63,50,42,28,139,62,77,23,6,14,4,1
4696,532,254,278,91,48,23,17,228,72,156,42,27,8,7,1
4697,2363,875,1488,361,444,95,53,360,192,168,55,45,48,16,1
4698,466,186,280,71,84,30,11,309,106,203,66,49,25,10,1
4699,161,75,86,24,20,10,7,1443,776,667,191,175,160,56,1
4700,330,157,173,56,42,51,8,398,174,224,46,58,36,17,1
4701,653,311,342,106,74,52,28,604,275,329,95,69,52,25,1
4702,377,171,206,59,58,41,22,1248,584,664,184,164,155,67,1
4703,784,404,380,127,97,78,27,673,329,344,111,95,92,41,1
4704,327,151,176,48,43,36,10,233,121,112,24,31,30,7,1
4705,205,106,99,28,26,23,3,174,82,92,27,23,26,14,1
4706,136,66,70,33,11,9,3,832,428,404,131,89,88,38,1
4707,567,279,288,75,77,54,25,1038,470,568,130,123,86,51,1
4708,1189,559,630,179,147,118,35,512,261,251,79,73,60,21,1
4709,211,114,97,32,24,19,10,784,373,411,101,90,91,37,1
4710,240,125,115,34,32,30,8,392,218,174,43,42,32,27,1
4711,672,336,336,103,80,47,32,551,237,314,95,79,54,17,1
4712,277,124,153,44,40,35,18,195,97,98,30,36,16,12,1
4713,404,197,207,60,48,47,20,305,168,137,48,35,40,9,1
4714,619,290,329,97,79,62,19,164,61,103,47,19,14,5,1
4715,530,259,271,83,50,54,41,798,287,511,126,125,77,26,1
4716,519,219,300,86,72,50,39,158,85,73,24,18,18,8,1
4717,1304,585,719,179,169,154,47,1132,553,579,172,143,150,57,1
4718,885,424,461,143,114,92,32,950,497,453,146,127,115,43,1
4719,246,115,131,15,29,10,32,780,409,371,125,80,60,34,1
4720,433,237,196,60,52,33,27,473,217,256,59,44,34,21,1
4721,583,322,261,73,66,45,26,446,176,270,64,79,45,24,1
4722,589,314,275,70,83,44,28,499,252,247,75,71,65,25,1
4723,621,301,320,76,64,46,34,267,147,120,40,24,25,8,1
4724,1395,627,768,172,263,141,59,296,151,145,39,25,40,20,1
4725,667,360,307,76,92,46,27,573,316,257,78,80,21,21,1
4726,404,190,214,50,54,35,13,1152,586,566,131,112,117,42,1
4727,917,470,447,139,135,88,63,190,96,94,21,17,23,10,1
4728,246,123,123,40,31,27,7,462,228,234,59,47,37,32,1
4729,436,196,240,62,50,59,19,428,226,202,52,60,75,20,1
4730,2442,1193,1249,278,183,170,145,314,142,172,29,48,21,16,1
4731,770,385,385,78,83,60,16,503,263,240,72,55,51,34,1
4732,247,110,137,34,45,23,10,854,399,455,127,118,57,39,1
4733,554,251,303,88,59,47,25,129,70,59,29,9,7,2,1
4734,1005,422,583,166,179,70,21,906,485,421,112,98,112,39,1
4735,79,38,41,19,11,17,4,240,125,115,34,32,30,8,1
4736,1608,778,830,243,230,159,74,862,409,453,149,125,86,29,1
4737,189,89,100,39,16,11,3,654,344,310,80,69,57,15,1
4738,1139,536,603,162,139,109,50,134,60,74,19,13,10,7,1
4739,146,75,71,13,32,15,11,2430,1065,1365,330,328,190,84,1
4740,178,100,78,23,22,30,6,1382,689,693,186,176,167,77,1
4741,605,295,310,74,66,70,36,360,192,168,55,45,48,16,1
4742,1179,608,571,142,143,126,48,901,458,443,91,129,86,21,1
4743,750,347,403,105,103,83,29,369,181,188,41,36,54,16,1
4744,1068,494,574,176,155,81,27,229,103,126,28,44,17,5,1
4745,128,67,61,19,13,15,4,217,109,108,34,32,35,7,1
4746,401,213,188,64,48,35,18,329,155,174,46,38,29,14,1
4747,968,452,516,150,144,79,28,1337,667,670,137,143,140,35,1
4748,360,192,168,55,45,48,16,1657,800,857,249,235,154,51,1
4749,709,359,350,107,102,65,20,510,252,258,75,60,57,24,1
4750,161,75,86,24,20,10,7,1199,589,610,189,128,167,65,1
4751,504,259,245,73,56,45,29,158,85,73,24,18,18,8,1
4752,466,186,280,71,84,30,11,267,149,118,45,33,31,14,1
4753,912,497,415,126,83,106,48,374,181,193,63,49,46,20,1
4754,746,361,385,91,92,101,32,148,75,73,25,13,9,4,1
4755,1038,527,511,118,163,120,52,297,148,149,64,35,37,15,1
4756,624,308,316,92,72,68,22,847,452,395,100,94,81,36,1
4757,656,358,298,67,47,64,26,65,37,28,11,3,6,5,1
4758,1269,624,645,183,180,136,52,361,184,177,50,53,51,22,1
4759,3830,2000,1830,532,388,418,203,160,53,107,31,29,13,3,1
4760,471,255,216,66,68,81,16,911,493,418,89,140,83,34,1
4761,351,166,185,48,61,24,15,331,169,162,40,28,22,14,1
4762,780,337,443,112,116,77,28,217,109,108,34,32,35,7,1
4763,2224,1037,1187,288,276,273,74,676,319,357,83,86,62,46,1
4764,1192,579,613,120,215,79,24,1384,769,615,178,141,219,56,1
4765,446,176,270,64,79,45,24,1105,479,626,182,125,80,29,1
4766,184,86,98,26,26,14,11,593,295,298,70,85,48,13,1
4767,482,231,251,76,81,64,26,2492,894,1598,466,444,164,102,1
4768,870,415,455,112,103,93,51,426,221,205,71,51,39,21,1
4769,1400,800,600,158,134,150,65,1290,629,661,191,187,167,55,1
4770,361,184,177,50,53,51,22,2146,1050,1096,330,305,194,74,1
4771,480,234,246,79,77,65,23,4128,2104,2024,581,505,453,205,1
4772,279,129,150,43,34,17,13,508,267,241,43,35,25,17,1
4773,938,484,454,137,100,104,41,1960,810,1150,358,377,121,72,1
4774,3336,1358,1978,571,599,203,101,451,222,229,58,55,51,17,1
4775,93,54,39,13,9,9,7,98,53,45,14,6,7,6,1
4776,152,83,69,24,21,12,5,736,367,369,107,97,46,24,1
4777,377,184,193,50,43,33,17,176,73,103,22,29,13,9,1
4778,1079,488,591,112,86,82,35,1223,593,630,161,135,142,71,1
4779,230,144,86,16,11,25,14,1748,791,957,281,247,173,25,1
4780,1290,629,661,191,187,167,55,838,431,407,107,90,107,43,1
4781,802,429,373,68,101,88,23,717,345,372,85,74,69,41,1
4782,575,301,274,84,65,63,20,217,109,108,34,32,35,7,1
4783,737,363,374,119,101,85,41,594,303,291,84,69,72,31,1
4784,158,71,87,23,21,17,12,984,509,475,114,109,106,56,1
4785,158,85,73,24,18,18,8,223,113,110,31,33,22,12,1
4786,166,81,85,30,27,13,8,746,442,304,82,71,99,36,1
4787,1738,821,917,242,196,181,58,781,418,363,92,90,64,41,1
4788,1243,633,610,149,160,87,39,211,138,73,14,11,22,17,1
4789,575,293,282,78,64,40,13,168,120,48,7,5,20,7,1
4790,505,247,258,72,71,60,27,605,263,342,73,103,54,18,1
4791,236,121,115,34,30,15,10,246,125,121,33,31,34,18,1
4792,442,230,212,50,58,56,23,624,323,301,76,67,74,48,1
4793,283,141,142,32,26,23,26,557,240,317,97,74,68,37,1
4794,1156,578,578,130,155,118,39,1800,882,918,202,185,186,49,1
4795,491,283,208,55,61,40,13,553,333,220,61,43,72,36,1
4796,222,103,119,38,39,4,17,249,106,143,48,37,32,10,1
4797,602,299,303,98,81,72,21,215,117,98,43,22,27,5,1
4798,1863,721,1142,262,283,139,74,657,293,364,109,75,66,28,1
4799,361,184,177,50,53,51,22,750,347,403,105,103,83,29,1
4800,208,122,86,27,13,23,7,822,416,406,111,105,84,44,1
4801,288,158,130,59,23,21,10,310,156,154,27,43,20,6,1
4802,1721,838,883,241,218,144,54,1084,537,547,154,121,92,35,1
4803,1337,667,670,137,143,140,35,745,391,354,85,81,52,39,1
4804,672,334,338,110,93,91,41,217,94,123,29,30,23,17,1
4805,303,137,166,54,54,31,15,345,141,204,64,58,13,11,1
4806,545,279,266,74,52,68,24,442,230,212,50,58,56,23,1
4807,443,207,236,76,68,52,28,144,57,87,38,26,10,4,1
4808,351,195,156,47,53,25,14,218,127,91,27,23,23,10,1
4809,684,311,373,109,99,66,16,148,63,85,23,22,7,7,1
4810,369,181,188,41,36,54,16,459,221,238,52,56,51,19,1
4811,530,183,347,121,98,29,13,248,118,130,54,31,26,5,1
4812,437,228,209,47,61,26,11,432,228,204,59,53,43,15,1
4813,509,341,168,35,32,52,15,582,330,252,73,75,68,25,1
4814,201,102,99,25,26,19,7,653,298,355,70,101,64,39,1
4815,182,93,89,24,19,18,8,309,161,148,38,34,40,15,1
4816,256,148,108,31,16,29,12,188,89,99,28,30,23,14,1
4817,574,295,279,78,65,61,22,606,279,327,81,70,49,34,1
4818,2376,1263,1113,304,241,264,115,753,361,392,99,94,66,16,1
4819,452,239,213,62,46,38,22,457,245,212,62,58,57,21,1
4820,91,50,41,8,14,4,5,92,46,46,14,9,8,6,1
4821,263,142,121,27,18,34,14,296,147,149,45,29,30,23,1
4822,608,319,289,94,68,81,28,2169,995,1174,181,165,213,80,1
4823,664,423,241,60,49,85,42,641,324,317,88,92,49,14,1
4824,403,188,215,70,42,41,11,838,386,452,108,132,45,29,1
4825,2488,1087,1401,346,253,162,76,240,98,142,49,42,23,17,1
4826,648,307,341,101,58,76,34,676,333,343,111,89,94,39,1
4827,451,238,213,53,64,56,22,454,191,263,61,66,38,15,1
4828,662,312,350,103,104,59,20,375,202,173,46,49,41,23,1
4829,591,263,328,95,90,26,13,829,366,463,137,130,56,10,1
4830,87,48,39,15,9,9,3,536,278,258,72,63,62,20,1
4831,359,173,186,55,57,44,16,471,246,225,46,38,52,30,1
4832,743,366,377,41,37,26,14,264,126,138,44,26,25,10,1
4833,253,123,130,40,46,15,4,405,189,216,53,60,39,14,1
4834,672,334,338,110,93,91,41,926,425,501,159,147,77,35,1
4835,449,179,270,80,77,49,29,1066,457,609,176,125,104,42,1
4836,1163,493,670,214,158,106,42,219,112,107,24,31,25,9,1
4837,603,348,255,82,70,87,16,233,130,103,26,23,23,6,1
4838,629,338,291,92,57,64,22,104,52,52,18,14,17,4,1
4839,910,462,448,143,126,90,25,439,205,234,64,88,41,21,1
4840,189,90,99,26,29,17,11,2302,1030,1272,319,296,220,111,1
4841,2175,1078,1097,364,275,271,81,1858,805,1053,271,345,116,41,1
4842,755,406,349,92,56,89,36,183,97,86,30,18,20,12,1
4843,254,117,137,33,35,38,6,327,177,150,40,40,38,18,1
4844,595,316,279,86,60,65,40,379,203,176,55,48,45,16,1
4845,583,322,261,73,66,45,26,360,188,172,49,48,47,17,1
4846,277,124,153,44,40,35,18,562,281,281,80,61,67,23,1
4847,191,103,88,23,14,23,10,914,462,452,100,95,84,25,1
4848,327,177,150,40,40,38,18,430,218,212,58,47,34,20,1
4849,597,246,351,95,98,45,25,720,357,363,113,85,62,39,1
4850,365,222,143,44,24,35,11,552,285,267,74,51,69,24,1
4851,1354,537,817,245,247,117,57,193,99,94,31,31,16,12,1
4852,628,324,304,83,85,75,23,748,355,393,121,91,95,26,1
4853,326,170,156,41,39,49,16,380,177,203,45,45,51,13,1
4854,446,176,270,64,79,45,24,117,60,57,20,17,16,5,1
4855,204,103,101,16,32,22,8,136,66,70,33,11,9,5,1
4856,304,159,145,38,40,32,3,377,184,193,56,53,44,14,1
4857,126,70,56,25,10,5,5,540,297,243,75,69,67,21,1
4858,892,397,495,146,63,65,37,440,215,225,76,74,29,16,1
4859,1200,602,598,145,116,110,50,2414,1189,1225,277,178,170,169,1
4860,329,168,161,48,34,41,16,806,436,370,101,100,76,34,1
4861,330,159,171,48,38,50,19,140,86,54,17,6,20,7,1
4862,556,280,276,82,75,63,36,1246,677,569,159,154,108,52,1
4863,173,82,91,23,23,14,12,2912,1266,1646,268,360,243,422,1
4864,435,221,214,72,45,47,19,480,196,284,72,74,25,2,1
4865,335,177,158,45,49,34,13,446,227,219,58,52,45,26,1
4866,646,316,330,89,95,48,17,785,374,411,56,42,38,25,1
4867,441,211,230,67,45,53,14,728,358,370,118,100,55,29,1
4868,1848,833,1015,304,257,195,71,218,102,116,32,31,21,4,1
4869,154,75,79,17,24,16,13,577,217,360,100,116,32,24,1
4870,469,204,265,81,67,30,22,1269,624,645,183,180,136,52,1
4871,89,47,42,11,5,6,9,240,125,115,34,32,30,8,1
4872,579,281,298,91,78,74,27,757,373,384,115,93,95,25,1
4873,1152,459,693,138,343,75,33,150,74,76,21,22,18,7,1
4874,778,367,411,90,85,64,43,298,184,114,45,22,45,12,1
4875,509,254,255,67,55,52,35,210,115,95,31,22,27,10,1
4876,304,135,169,48,36,38,26,467,251,216,56,49,79,11,1
4877,684,288,396,107,90,54,42,719,270,449,113,122,44,32,1
4878,451,209,242,73,53,47,36,513,260,253,71,50,58,23,1
4879,862,409,453,149,125,86,29,2843,1104,1739,429,357,178,95,1
4880,461,207,254,82,66,55,33,798,287,511,126,125,77,26,1
4881,1464,715,749,200,167,181,70,938,484,454,137,100,104,41,1
4882,493,276,217,57,52,46,31,770,355,415,103,142,75,42,1
4883,263,181,82,19,11,39,8,173,82,91,27,25,28,4,1
4884,1273,592,681,199,164,139,39,519,219,300,86,72,50,39,1
4885,67,34,33,10,12,6,5,340,166,174,39,40,36,26,1
4886,164,77,87,33,19,6,7,279,161,118,37,21,22,9,1
4887,581,274,307,75,69,28,24,480,252,228,55,37,49,20,1
4888,505,226,279,68,51,30,15,126,57,69,31,10,10,3,1
4889,4391,2256,2135,494,411,423,231,1231,603,628,121,162,109,120,1
4890,110,49,61,19,7,2,5,1353,661,692,192,197,139,63,1
4891,1873,948,925,245,214,194,85,2135,1170,965,232,246,196,89,1
4892,619,332,287,95,77,74,38,1147,483,664,200,195,95,53,1
4893,3801,1837,1964,510,442,418,170,777,387,390,90,87,65,37,1
4894,777,408,369,100,96,56,17,437,225,212,61,57,66,12,1
4895,245,137,108,34,30,19,10,325,182,143,45,39,38,11,1
4896,1893,850,1043,280,340,169,80,215,80,135,54,56,21,9,1
4897,833,452,381,117,85,71,39,847,467,380,117,101,67,24,1
4898,116,61,55,19,19,9,4,105,63,42,16,10,12,7,1
4899,191,85,106,33,28,16,8,356,199,157,43,58,29,12,1
4900,1374,679,695,191,193,154,48,641,324,317,88,92,49,14,1
4901,240,125,115,34,32,30,8,63,29,34,13,10,4,8,1
4902,414,214,200,57,55,33,12,267,124,143,45,46,26,4,1
4903,885,424,461,143,114,92,32,414,211,203,45,44,41,24,1
4904,806,436,370,101,100,76,34,750,347,403,105,103,83,29,1
4905,299,128,171,57,40,13,25,795,305,490,169,178,66,22,1
4906,545,269,276,80,76,27,32,213,107,106,28,41,19,5,1
4907,599,311,288,91,73,55,32,741,351,390,131,113,84,25,1
4908,1188,607,581,159,139,149,38,825,363,462,97,105,72,75,1
4909,498,174,324,112,108,33,19,430,192,238,62,67,27,10,1
4910,1352,602,750,166,185,81,70,341,178,163,48,44,42,20,1
4911,686,358,328,83,61,71,24,624,308,316,92,72,68,22,1
4912,676,333,343,111,89,94,39,391,206,185,56,36,60,17,1
4913,747,371,376,87,134,54,29,280,156,124,36,19,20,13,1
4914,1253,639,614,181,155,164,73,508,267,241,57,49,40,13,1
4915,535,276,259,78,80,67,18,508,254,254,74,99,61,12,1
4916,461,227,234,61,47,54,33,108,59,49,17,13,12,5,1
4917,410,200,210,60,54,46,19,882,432,450,115,111,68,44,1
4918,469,221,248,49,60,55,21,1647,794,853,279,235,128,65,1
4919,121,74,47,15,9,6,6,460,274,186,50,34,69,27,1
4920,1149,568,581,177,133,101,30,198,80,118,35,31,14,7,1
4921,1132,553,579,172,143,150,57,1106,579,527,121,152,113,45,1
4922,726,312,414,121,73,82,23,1464,693,771,153,136,91,86,1
4923,538,268,270,58,72,42,25,391,203,188,49,34,36,9,1
4924,601,313,288,42,48,25,36,505,271,234,56,57,57,26,1
4925,127,49,78,27,20,6,5,261,130,131,27,41,19,16,1
4926,522,235,287,78,67,60,50,318,145,173,29,38,34,22,1
4927,546,267,279,90,69,56,19,543,293,250,77,67,40,25,1
4928,691,307,384,93,128,45,19,563,255,308,91,111,42,30,1
4929,385,200,185,65,41,41,12,172,77,95,25,34,19,10,1
4930,128,68,60,18,15,17,4,520,261,259,82,76,71,24,1
4931,247,110,137,34,45,23,10,498,198,300,122,70,83,16,1
4932,322,180,142,45,38,28,7,354,188,166,46,40,34,10,1
4933,798,287,511,126,125,77,26,1441,657,784,140,135,81,73,1
4934,583,322,261,73,66,45,26,427,204,223,38,57,26,32,1
4935,374,247,127,36,14,48,14,142,81,61,16,17,14,10,1
4936,1465,806,659,163,141,107,73,460,218,242,72,62,42,26,1
4937,1332,652,680,210,180,155,49,1210,592,618,157,138,116,85,1
4938,150,74,76,21,22,18,7,189,90,99,26,29,17,11,1
4939,377,184,193,56,53,44,14,1447,751,696,161,143,131,46,1
4940,215,115,100,27,28,34,16,113,47,66,14,15,11,17,1
4941,177,67,110,34,24,13,10,462,233,229,66,49,43,30,1
4942,391,208,183,65,49,57,17,721,363,358,87,104,70,28,1
4943,52,24,28,6,4,3,5,482,231,251,76,81,64,26,1
4944,210,102,108,33,33,20,9,67,40,27,10,8,7,6,1
4945,881,383,498,142,148,77,24,400,228,172,43,20,47,24,1
4946,159,77,82,23,9,18,11,371,199,172,39,44,52,15,1
4947,876,457,419,88,124,67,47,604,255,349,100,72,55,26,1
4948,69,29,40,14,9,1,3,201,42,159,19,3,2,75,1
4949,672,334,338,110,93,91,41,522,283,239,65,64,76,22,1
4950,361,177,184,59,51,24,15,436,201,235,54,37,34,20,1
4951,125,78,47,17,6,9,6,328,210,118,29,18,38,15,1
4952,987,515,472,107,110,106,61,1834,823,1011,297,282,151,63,1
4953,1100,474,626,197,143,126,41,1182,599,583,162,130,106,41,1
4954,89,42,47,16,12,15,6,373,189,184,54,46,50,23,1
4955,369,181,188,41,36,54,16,268,157,111,26,30,28,13,1
4956,467,226,241,55,48,54,23,494,234,260,88,81,61,29,1
4957,430,198,232,57,46,37,19,390,191,199,57,49,45,25,1
4958,1424,650,774,152,124,95,87,551,298,253,63,65,45,19,1
4959,351,184,167,59,45,54,9,184,88,96,24,25,14,9,1
4960,522,235,287,78,67,60,50,277,122,155,33,33,25,24,1
4961,267,124,143,45,46,26,4,529,314,215,59,64,39,14,1
4962,480,232,248,83,64,51,25,501,240,261,80,62,49,42,1
4963,290,127,163,47,58,23,12,425,198,227,57,69,59,13,1
4964,508,267,241,57,49,40,13,377,184,193,56,53,44,14,1
4965,558,249,309,97,66,52,22,928,442,486,139,118,91,43,1
4966,335,148,187,52,26,51,12,318,176,142,25,32,35,25,1
4967,377,171,206,46,59,22,6,299,140,159,27,59,20,18,1
4968,860,456,404,104,95,77,27,770,394,376,90,96,78,34,1
4969,365,180,185,63,35,48,19,452,239,213,62,46,38,22,1
4970,537,276,261,75,68,68,22,446,265,181,51,35,27,17,1
4971,815,418,397,97,62,70,17,380,190,190,60,42,28,23,1
4972,404,190,214,55,55,35,27,233,121,112,24,31,30,7,1
4973,372,193,179,60,43,29,2,433,221,212,59,42,47,14,1
4974,398,216,182,52,33,40,15,1690,1173,517,186,130,110,56,1
4975,347,183,164,55,45,51,16,536,237,299,116,87,42,17,1
4976,185,115,70,19,17,26,6,208,99,109,28,30,18,9,1
4977,1979,739,1240,323,363,107,60,928,442,486,139,118,91,43,1
4978,1132,553,579,172,143,150,57,998,496,502,149,146,89,27,1
4979,651,306,345,85,64,61,32,426,228,198,62,42,47,22,1
4980,462,228,234,59,47,37,32,785,374,411,56,42,38,25,1
4981,359,169,190,56,36,35,24,402,205,197,62,48,38,19,1
4982,1142,515,627,56,128,113,16,517,196,321,103,98,34,12,1
4983,246,115,131,15,29,10,32,113,36,77,37,10,14,4,1
4984,672,334,338,110,93,91,41,432,188,244,76,81,26,13,1
4985,305,166,139,42,38,28,12,351,183,168,50,46,37,16,1
4986,758,360,398,114,107,51,19,445,204,241,59,56,34,26,1
4987,238,151,87,21,16,24,24,263,142,121,27,18,34,14,1
4988,443,198,245,68,72,48,19,426,213,213,60,56,46,24,1
4989,277,144,133,36,36,34,15,434,205,229,51,55,24,13,1
4990,812,456,356,105,74,101,29,1149,568,581,177,133,101,30,1
4991,740,313,427,101,135,40,22,1374,679,695,191,193,154,48,1
4992,593,291,302,81,85,56,20,926,435,491,133,132,85,17,1
4993,406,205,201,54,58,34,21,763,368,395,102,69,65,32,1
4994,593,266,327,102,84,69,24,223,132,91,18,16,27,17,1
4995,1463,521,942,252,204,105,52,475,235,240,77,58,43,22,1
4996,246,108,138,32,44,21,10,1214,642,572,175,153,138,47,1
4997,441,216,225,55,67,34,16,443,226,217,67,34,53,10,1
4998,502,240,262,78,61,54,32,243,140,103,33,27,31,12,1
4999,301,150,151,41,30,17,11,1581,684,897,220,153,118,63,1
5000,475,235,240,77,58,43,22,699,326,373,110,125,70,24,1
5001,563,285,278,79,66,48,27,757,373,384,115,93,95,25,1
5002,492,280,212,56,61,30,13,211,115,96,37,19,29,10,1
5003,740,385,355,114,97,91,27,100,37,63,26,19,0,1,1
5004,323,156,167,52,45,39,18,715,355,360,118,79,71,29,1
5005,1464,693,771,153,136,91,86,778,367,411,90,85,64,43,1
5006,226,90,136,43,43,26,7,770,356,414,123,102,66,25,1
5007,488,284,204,43,45,52,21,697,373,324,105,83,95,38,1
5008,437,228,209,47,61,26,11,410,188,222,53,52,31,14,1
5009,171,85,86,23,16,20,10,462,228,234,59,47,37,32,1
5010,501,240,261,80,62,49,42,790,352,438,132,87,91,60,1
5011,726,312,414,121,73,82,23,454,191,263,61,66,38,15,1
5012,205,91,114,31,36,13,8,461,208,253,79,76,61,21,1
5013,787,351,436,135,98,82,23,304,127,177,61,38,31,4,1
5014,2098,953,1145,304,268,226,96,372,192,180,47,41,47,21,1
5015,906,455,451,116,105,87,46,262,144,118,19,39,22,8,1
5016,583,322,261,73,66,45,26,793,240,553,196,206,28,13,1
5017,131,74,57,17,14,12,4,240,167,73,32,12,8,21,1
5018,1691,1159,532,160,109,95,46,359,184,175,49,35,32,11,1
5019,673,313,360,101,101,46,17,291,141,150,49,43,26,7,1
5020,261,127,134,33,24,30,13,277,122,155,33,33,25,24,1
5021,969,505,464,123,133,92,33,1863,721,1142,262,283,139,74,1
5022,825,363,462,97,105,72,75,347,168,179,44,51,35,23,1
5023,1063,578,485,116,121,117,39,825,363,462,97,105,72,75,1
5024,327,160,167,56,31,36,15,2414,1189,1225,277,178,170,169,1
5025,369,216,153,36,22,46,23,2161,1233,928,269,199,178,42,1
5026,351,184,167,59,45,54,9,574,298,276,79,75,79,40,1
5027,211,92,119,33,44,11,7,349,131,218,66,76,22,9,1
5028,1106,579,527,121,152,113,45,536,278,258,72,63,62,20,1
5029,672,327,345,78,112,74,33,583,322,261,73,66,45,26,1
5030,434,201,233,58,46,38,19,159,102,57,14,13,23,7,1
5031,351,184,167,59,45,54,9,477,232,245,67,64,70,30,1
5032,335,143,192,45,36,32,37,4544,2024,2520,579,628,480,403,1
5033,113,59,54,12,8,9,13,355,214,141,43,29,63,13,1
5034,384,238,146,38,26,66,19,99,49,50,16,8,7,8,1
5035,582,285,297,62,57,44,16,1162,515,647,191,143,97,35,1
5036,354,188,166,44,31,48,11,510,252,258,75,60,57,24,1
5037,365,170,195,49,30,41,10,243,120,123,30,24,26,13,1
5038,119,53,66,33,8,7,6,458,222,236,69,39,35,18,1
5039,505,247,258,72,71,60,27,2649,1430,1219,377,299,266,102,1
5040,391,208,183,65,49,57,17,495,233,262,64,39,49,32,1
5041,441,216,225,57,66,57,19,536,278,258,72,63,62,20,1
5042,651,331,320,93,93,51,28,218,115,103,32,32,34,11,1
5043,492,238,254,72,56,49,20,593,266,327,102,84,69,24,1
5044,288,158,130,59,23,21,10,806,436,370,101,100,76,34,1
5045,1032,426,606,172,172,80,35,1134,539,595,150,146,78,40,1
5046,393,186,207,58,50,36,22,609,292,317,102,96,64,21,1
5047,317,153,164,39,30,35,13,897,487,410,92,97,83,31,1
5048,1292,592,700,186,169,108,22,1834,823,1011,297,282,151,63,1
5049,1800,882,918,202,185,186,49,325,159,166,39,40,41,14,1
5050,191,72,119,40,41,17,8,295,161,134,30,40,31,9,1
5051,1190,638,552,162,95,112,18,1722,774,948,199,192,158,167,1
5052,1712,926,786,199,198,156,71,859,395,464,157,119,59,31,1
5053,168,72,96,30,17,16,11,408,197,211,74,44,53,16,1
5054,590,330,260,79,69,56,13,982,545,437,119,100,92,40,1
5055,1270,682,588,165,147,136,54,240,167,73,32,12,8,21,1
5056,111,51,60,20,21,10,11,239,110,129,32,32,24,10,1
5057,826,423,403,129,93,82,42,985,551,434,123,93,91,26,1
5058,291,155,136,34,33,29,15,243,140,103,23,17,25,23,1
5059,398,257,141,43,19,29,19,354,169,185,54,54,41,19,1
5060,441,189,252,73,50,47,23,341,178,163,48,44,42,20,1
5061,1441,657,784,140,135,81,73,1130,614,516,129,138,98,42,1
5062,998,379,619,167,176,57,23,1332,626,706,182,144,80,41,1
5063,536,278,258,72,63,62,20,468,242,226,58,42,49,19,1
5064,546,267,279,90,69,56,19,1124,441,683,148,189,72,43,1
5065,1054,453,601,183,183,107,35,525,308,217,60,45,54,12,1
5066,353,147,206,47,61,30,25,95,41,54,15,16,8,5,1
5067,504,255,249,56,59,45,13,360,188,172,49,48,47,17,1
5068,2639,1436,1203,317,307,242,77,918,490,428,114,100,115,41,1
5069,1273,592,681,199,164,139,39,411,209,202,69,43,18,15,1
5070,592,291,301,92,93,71,31,584,307,277,54,63,53,10,1
5071,1338,756,582,155,105,104,44,1124,615,509,157,125,128,52,1
5072,312,143,169,55,61,12,11,757,373,384,115,93,95,25,1
5073,729,321,408,128,84,63,26,299,128,171,57,40,13,25,1
5074,313,157,156,39,26,34,29,256,153,103,19,23,23,8,1
5075,461,221,240,70,64,56,32,2224,1037,1187,288,276,273,74,1
5076,310,142,168,42,39,24,9,1199,589,610,189,128,167,65,1
5077,1042,530,512,162,150,103,52,958,451,507,165,135,97,41,1
5078,466,186,280,71,84,30,11,543,221,322,78,122,37,12,1
5079,159,84,75,13,28,10,8,454,224,230,71,39,62,22,1
5080,496,251,245,78,62,61,23,357,161,196,55,59,24,9,1
5081,140,81,59,16,15,15,12,313,159,154,30,40,23,14,1
5082,513,246,267,71,66,60,35,120,67,53,13,15,9,6,1
5083,860,427,433,132,100,81,30,561,343,218,53,63,37,15,1
5084,712,331,381,111,86,86,34,719,364,355,104,100,58,34,1
5085,913,408,505,141,125,87,36,920,492,428,100,92,88,49,1
5086,459,224,235,67,60,39,17,551,298,253,63,65,45,19,1
5087,200,90,110,22,29,10,13,969,505,464,123,133,92,33,1
5088,512,261,251,79,73,60,21,847,402,445,109,91,100,37,1
5089,168,67,101,37,17,13,13,361,161,200,43,63,9,19,1
5090,502,252,250,68,63,40,14,724,334,390,112,109,79,17,1
5091,739,359,380,83,95,53,38,825,363,462,97,105,72,75,1
5092,2477,1186,1291,256,271,249,90,412,238,174,41,38,43,19,1
5093,277,124,153,44,40,35,18,416,201,215,54,52,39,25,1
5094,263,142,121,27,18,34,14,261,159,102,19,29,41,11,1
5095,1627,782,845,204,187,202,108,258,126,132,42,32,19,26,1
5096,1504,777,727,179,209,162,49,920,492,428,100,92,88,49,1
5097,371,199,172,39,44,52,15,1132,553,579,172,143,150,57,1
5098,75,32,43,12,13,6,3,377,184,193,56,53,44,14,1
5099,218,115,103,32,32,34,11,240,125,115,34,32,30,8,1
5100,247,110,137,34,45,23,10,673,329,344,111,95,92,41,1
5101,807,359,448,114,99,93,33,619,332,287,95,77,74,38,1
5102,1085,646,439,108,65,36,19,785,374,411,56,42,38,25,1
5103,151,83,68,18,19,17,7,355,165,190,53,56,42,19,1
5104,206,122,84,17,29,13,4,1304,585,719,179,169,154,47,1
5105,648,307,341,101,58,76,34,1382,689,693,186,176,167,77,1
5106,963,455,508,127,130,115,48,1068,527,541,160,131,112,52,1
5107,671,321,350,95,87,75,34,657,293,364,109,75,66,28,1
5108,1338,506,832,241,229,101,40,245,112,133,32,45,20,10,1
5109,637,335,302,83,77,85,26,1087,523,564,146,177,103,33,1
5110,724,334,390,112,109,79,17,656,336,320,86,90,73,37,1
5111,1219,599,620,159,198,155,42,254,122,132,37,37,24,12,1
5112,1730,801,929,328,213,219,64,2541,1299,1242,306,302,121,98,1
5113,536,278,258,72,63,62,20,1255,708,547,120,68,88,7,1
5114,228,118,110,32,29,36,13,984,509,475,114,109,106,56,1
5115,455,218,237,57,51,42,35,635,333,302,99,75,83,28,1
5116,788,390,398,94,118,80,18,790,384,406,93,120,79,16,1
5117,112,65,47,14,4,6,6,438,258,180,49,28,76,28,1
5118,1771,864,907,239,217,158,63,531,260,271,97,68,47,11,1
5119,1074,538,536,154,140,111,51,1132,553,579,172,143,150,57,1
5120,246,115,131,15,29,10,32,1832,784,1048,330,229,199,102,1
5121,485,273,212,52,47,51,17,656,358,298,67,47,64,26,1
5122,458,225,233,67,61,43,33,149,68,81,15,38,11,10,1
5123,441,216,225,57,66,57,19,2440,1061,1379,377,326,172,62,1
5124,659,325,334,102,85,87,32,737,363,374,119,101,85,41,1
5125,370,216,154,56,27,72,12,1970,978,992,245,206,198,80,1
5126,194,91,103,17,32,9,6,731,338,393,114,126,53,17,1
5127,514,178,336,126,103,31,20,202,102,100,29,35,6,9,1
5128,158,85,73,24,18,18,8,1061,440,621,189,149,153,72,1
5129,574,277,297,88,77,58,36,637,321,316,70,96,30,18,1
5130,255,111,144,31,25,21,28,416,201,215,54,52,39,25,1
5131,954,521,433,135,118,78,26,445,225,220,47,62,53,26,1
5132,1270,682,588,165,147,136,54,339,170,169,32,17,24,13,1
5133,482,231,251,76,81,64,26,969,505,464,123,133,92,33,1
5134,412,223,189,55,55,41,10,1047,562,485,141,127,114,41,1
5135,543,287,256,71,66,64,23,976,496,480,128,111,121,48,1
5136,433,229,204,60,59,53,24,926,435,491,133,132,85,17,1
5137,377,184,193,56,53,44,14,419,274,145,41,23,28,27,1
5138,1005,422,583,166,179,70,21,400,228,172,43,20,47,24,1
5139,255,134,121,36,40,29,13,248,120,128,43,37,20,6,1
5140,89,42,47,16,12,15,6,503,260,243,46,56,33,16,1
5141,221,75,146,68,21,16,5,482,152,330,126,83,51,19,1
5142,2045,985,1060,359,339,199,74,245,138,107,26,19,35,16,1
5143,1524,843,681,177,141,158,69,586,240,346,94,110,29,19,1
5144,362,233,129,37,17,51,18,267,145,122,38,30,32,13,1
5145,585,289,296,102,86,61,18,671,318,353,83,124,46,34,1
5146,436,209,227,66,47,52,22,252,121,131,42,34,12,16,1
5147,134,63,71,27,9,6,8,350,214,136,33,23,49,27,1
5148,574,269,305,91,63,54,27,904,436,468,138,146,82,39,1
5149,162,88,74,15,15,20,11,661,324,337,71,58,85,28,1
5150,324,174,150,37,24,35,27,313,196,117,20,28,46,13,1
5151,724,325,399,98,92,64,24,304,159,145,38,40,32,3,1
5152,545,269,276,80,76,27,32,351,183,168,50,46,37,16,1
5153,191,101,90,21,23,28,5,665,297,368,111,107,34,12,1
5154,616,296,320,69,76,49,48,606,279,327,81,70,49,34,1
5155,385,181,204,48,41,52,36,577,241,336,112,109,47,21,1
5156,524,237,287,87,75,54,26,920,492,428,100,92,88,49,1
5157,538,252,286,77,87,53,30,795,305,490,169,178,66,22,1
5158,502,299,203,57,52,32,11,591,263,328,95,90,26,13,1
5159,613,333,280,71,66,47,26,308,170,138,38,35,45,14,1
5160,593,295,298,70,85,48,13,705,396,309,87,48,53,17,1
5161,745,351,394,88,95,68,56,757,373,384,115,93,95,25,1
5162,380,184,196,58,52,46,8,325,153,172,62,37,50,39,1
5163,499,252,247,74,42,55,14,503,263,240,72,55,51,34,1
5164,577,217,360,100,116,32,24,207,99,108,34,27,22,9,1
5165,391,208,183,65,49,57,17,118,56,62,13,14,6,6,1
5166,628,311,317,111,75,63,18,503,263,240,72,55,51,34,1
5167,944,495,449,126,125,55,47,467,224,243,70,43,67,23,1
5168,297,144,153,47,29,34,13,737,363,374,119,101,85,41,1
5169,456,228,228,49,70,32,19,229,115,114,27,30,16,9,1
5170,270,137,133,30,28,27,11,686,375,311,89,80,63,20,1
5171,261,143,118,33,24,32,16,920,492,428,100,92,88,49,1
5172,416,210,206,55,54,39,20,466,186,280,71,84,30,11,1
5173,261,120,141,34,28,30,17,202,102,100,29,35,6,9,1
5174,1152,586,566,131,112,117,42,1663,835,828,224,213,163,63,1
5175,194,112,82,26,13,17,8,131,66,65,21,14,23,7,1
5176,224,108,116,33,26,32,10,318,176,142,25,32,35,25,1
5177,454,230,224,63,56,38,33,257,148,109,28,20,21,14,1
5178,757,373,384,115,93,95,25,496,272,224,70,58,42,18,1
5179,673,329,344,111,95,92,41,478,239,239,65,66,65,21,1
5180,76,42,34,12,8,5,7,92,46,46,14,9,8,6,1
5181,356,199,157,36,43,28,12,154,78,76,23,21,13,5,1
5182,4599,2000,2599,590,655,515,413,335,143,192,45,36,32,37,1
5183,667,360,307,76,92,46,27,309,154,155,42,44,45,16,1
5184,587,279,308,88,71,49,31,307,150,157,44,23,30,13,1
5185,119,57,62,18,16,17,4,1132,646,486,99,102,71,41,1
5186,360,192,168,55,45,48,16,239,146,93,30,22,35,9,1
5187,145,75,70,22,18,10,5,531,260,271,97,68,47,11,1
5188,96,50,46,8,15,6,2,483,268,215,65,56,55,23,1
5189,330,178,152,49,35,30,15,219,124,95,22,22,23,5,1
5190,173,82,91,23,23,14,12,1541,713,828,176,147,151,250,1
5191,142,60,82,20,28,13,5,172,98,74,20,21,22,8,1
5192,2442,1193,1249,278,183,170,145,778,367,411,90,85,64,43,1
5193,393,186,207,58,50,36,22,546,267,279,90,69,56,19,1
5194,2027,896,1131,340,313,172,86,193,96,97,32,31,16,11,1
5195,187,81,106,47,32,10,11,278,111,167,66,66,19,8,1
5196,375,173,202,50,46,43,25,156,74,82,24,18,16,22,1
5197,466,186,280,71,84,30,11,424,179,245,65,67,29,11,1
5198,208,99,109,28,30,18,9,1093,407,686,158,205,49,31,1
5199,1970,978,992,245,206,198,80,1270,682,588,165,147,136,54,1
5200,815,418,397,97,62,70,17,448,210,238,75,57,22,9,1
5201,480,234,246,79,77,65,23,497,185,312,63,92,38,28,1
5202,492,238,254,72,56,49,20,596,286,310,90,89,78,37,1
5203,690,320,370,120,99,80,31,2843,1104,1739,429,357,178,95,1
5204,623,233,390,145,83,43,20,202,102,100,29,35,6,9,1
5205,2440,1061,1379,377,326,172,62,920,492,428,100,92,88,49,1
5206,2322,1315,1007,242,257,220,38,1270,557,713,130,195,57,30,1
5207,5938,2573,3365,858,958,396,195,2230,752,1478,421,460,118,67,1
5208,1657,800,857,249,235,154,51,377,202,175,46,50,41,23,1
5209,622,299,323,86,86,69,35,400,195,205,51,49,46,30,1
5210,938,484,454,137,100,104,41,817,425,392,120,102,83,26,1
5211,622,331,291,69,74,45,21,395,195,200,41,55,23,10,1
5212,412,238,174,41,38,43,19,2768,1380,1388,280,294,291,161,1
5213,926,435,491,133,132,85,17,908,488,420,115,97,111,43,1
5214,150,79,71,19,29,19,6,67,40,27,10,8,7,6,1
5215,549,303,246,64,54,59,35,462,224,238,77,75,37,13,1
5216,998,496,502,149,146,89,27,414,194,220,76,66,49,16,1
5217,427,164,263,62,80,14,10,1657,800,857,249,235,154,51,1
5218,255,106,149,46,40,21,10,121,51,70,22,20,11,6,1
5219,400,208,192,62,44,42,21,341,154,187,34,36,11,11,1
5220,1063,578,485,116,121,117,39,478,239,239,65,66,65,21,1
5221,897,487,410,92,97,83,31,258,141,117,33,29,23,10,1
5222,117,58,59,17,17,12,2,763,354,409,101,90,63,26,1
5223,553,261,292,73,79,40,26,759,326,433,115,95,61,29,1
5224,1573,791,782,198,173,148,46,424,191,233,76,73,49,13,1
5225,707,388,319,85,61,68,23,217,109,108,34,32,35,7,1
5226,635,333,302,99,75,83,28,256,153,103,19,23,23,8,1
5227,412,193,219,70,56,51,26,1139,536,603,162,139,109,50,1
5228,671,318,353,83,124,46,34,466,186,280,71,84,30,11,1
5229,429,219,210,46,66,42,17,377,184,193,50,43,33,17,1
5230,398,200,198,68,43,51,14,854,380,474,137,159,81,31,1
5231,593,291,302,81,85,56,20,144,57,87,38,26,10,4,1
5232,341,170,171,41,66,27,10,641,341,300,101,91,29,22,1
5233,916,344,572,168,220,47,10,317,156,161,49,51,18,10,1
5234,235,119,116,31,26,15,13,91,50,41,8,14,4,5,1
5235,399,208,191,57,46,41,20,360,188,172,49,48,47,17,1
5236,255,122,133,35,51,22,13,1100,474,626,197,143,126,41,1
5237,556,279,277,83,69,71,19,914,453,461,112,115,79,29,1
5238,913,412,501,131,100,117,83,560,348,212,62,55,30,16,1
5239,593,305,288,86,67,76,23,1013,457,556,124,157,81,26,1
5240,92,40,52,14,23,13,7,94,45,49,11,20,10,4,1
5241,240,125,115,34,32,30,8,601,313,288,42,48,25,36,1
5242,1770,824,946,245,258,179,60,247,110,137,34,45,23,10,1
5243,535,251,284,65,78,47,20,769,329,440,116,66,55,22,1
5244,593,266,327,102,84,69,24,1210,592,618,157,138,116,85,1
5245,392,156,236,40,91,28,16,1393,712,681,174,180,144,55,1
5246,178,91,87,20,21,12,5,178,88,90,24,21,11,11,1
5247,668,331,337,108,64,58,29,425,199,226,54,71,56,11,1
5248,1613,806,807,190,211,180,84,564,313,251,74,62,61,22,1
5249,344,159,185,47,50,35,23,358,192,166,49,48,49,16,1
5250,288,140,148,59,33,27,12,418,220,198,69,51,44,16,1
5251,213,107,106,28,41,19,5,2477,1186,1291,256,271,249,90,1
5252,1135,624,511,150,118,145,73,356,199,157,43,58,29,12,1
5253,466,186,280,71,84,30,11,412,203,209,65,47,37,18,1
5254,722,388,334,105,85,68,36,110,49,61,19,7,2,5,1
5255,1893,850,1043,280,340,169,80,1139,536,603,162,139,109,50,1
5256,538,252,286,77,87,53,30,239,146,93,30,22,35,9,1
5257,419,189,230,64,49,36,15,101,41,60,18,19,10,5,1
5258,767,392,375,113,112,83,13,575,318,257,65,65,70,24,1
5259,351,184,167,59,45,54,9,582,313,269,69,53,55,21,1
5260,415,242,173,53,21,70,21,196,113,83,26,17,11,6,1
5261,629,301,328,65,69,77,27,662,340,322,67,72,71,35,1
5262,618,289,329,97,86,70,17,607,303,304,86,78,66,26,1
5263,142,69,73,20,27,9,6,125,58,67,20,16,10,5,1
5264,1047,562,485,141,127,114,41,573,316,257,78,80,21,21,1
5265,928,442,486,139,118,91,43,824,392,432,106,89,88,32,1
5266,794,390,404,103,95,86,23,1308,652,656,166,153,149,87,1
5267,435,208,227,68,64,53,23,700,348,352,93,115,85,27,1
5268,387,222,165,47,43,33,24,420,242,178,51,38,49,11,1
5269,180,115,65,17,12,9,9,266,137,129,35,29,37,10,1
5270,770,374,396,95,91,79,41,280,156,124,36,19,20,13,1
5271,391,208,183,65,49,57,17,482,231,251,76,81,64,26,1
5272,906,485,421,112,98,112,39,902,495,407,116,97,111,37,1
5273,725,408,317,93,75,90,45,149,68,81,15,38,11,10,1
5274,264,122,142,33,29,13,13,345,203,142,47,35,31,11,1
5275,2639,1436,1203,317,307,242,77,672,334,338,110,93,91,41,1
5276,496,251,245,78,62,61,23,355,168,187,55,48,40,15,1
5277,1455,765,690,189,162,166,66,1863,721,1142,262,283,139,74,1
5278,267,159,108,31,13,22,15,499,251,248,69,59,61,22,1
5279,503,263,240,72,55,51,34,305,156,149,37,39,42,5,1
5280,828,405,423,114,106,78,33,245,111,134,31,44,20,11,1
5281,1068,539,529,161,134,132,71,509,262,247,64,70,64,20,1
5282,913,393,520,160,165,87,40,315,154,161,34,51,30,11,1
5283,760,391,369,101,109,65,24,507,273,234,59,60,49,19,1
5284,366,191,175,37,33,19,19,464,242,222,61,68,36,17,1
5285,340,172,168,60,50,36,10,504,234,270,88,86,55,16,1
5286,515,259,256,79,58,46,21,703,356,347,96,97,38,22,1
5287,1798,844,954,277,212,142,53,156,64,92,39,19,15,8,1
5288,495,233,262,74,59,46,12,597,246,351,95,98,45,25,1
5289,873,366,507,127,125,75,21,160,67,93,32,37,15,9,1
5290,1006,551,455,115,97,110,41,217,109,108,34,32,35,7,1
5291,902,461,441,133,113,105,37,3336,1358,1978,571,599,203,101,1
5292,870,415,455,112,103,93,51,213,107,106,28,41,19,5,1
5293,1581,684,897,220,153,118,63,1454,780,674,182,120,135,67,1
5294,327,172,155,45,44,39,21,404,197,207,57,69,33,15,1
5295,539,273,266,74,59,66,24,743,341,402,104,89,68,38,1
5296,3911,1465,2446,610,767,240,133,416,209,207,76,45,50,17,1
5297,606,279,327,81,70,49,34,522,235,287,78,67,60,50,1
5298,160,67,93,32,37,15,9,870,436,434,131,114,72,25,1
5299,236,120,116,40,28,17,7,249,111,138,40,30,22,17,1
5300,609,279,330,103,98,72,42,261,144,117,34,22,31,15,1
5301,512,261,251,79,73,60,21,1265,580,685,205,188,166,53,1
5302,335,177,158,45,49,34,13,493,275,218,64,36,49,30,1
5303,984,461,523,109,89,91,52,778,367,411,90,85,64,43,1
5304,360,188,172,49,48,47,17,1424,650,774,152,124,95,87,1
5305,589,314,275,70,83,44,28,938,484,454,137,100,104,41,1
5306,107,56,51,19,16,13,5,261,130,131,27,41,19,16,1
5307,2414,1189,1225,277,178,170,169,556,259,297,75,69,63,38,1
5308,542,250,292,91,52,53,24,221,110,111,28,32,25,11,1
5309,253,148,105,31,15,39,16,573,316,257,78,80,21,21,1
5310,204,119,85,25,24,19,12,561,281,280,80,71,36,14,1
5311,741,374,367,103,105,75,32,2090,1085,1005,167,141,168,40,1
5312,482,231,251,76,81,64,26,412,193,219,70,56,51,26,1
5313,112,41,71,35,18,8,4,370,177,193,51,61,32,4,1
5314,465,218,247,64,51,50,42,921,455,466,144,127,108,39,1
5315,113,54,59,10,12,13,7,283,142,141,35,29,32,5,1
5316,410,200,210,60,54,46,19,401,226,175,53,18,38,20,1
5317,656,358,298,67,47,64,26,474,197,277,80,67,52,13,1
5318,589,314,275,70,83,44,28,206,100,106,28,32,18,8,1
5319,288,159,129,27,44,27,15,98,55,43,14,1,7,4,1
5320,639,287,352,111,108,44,9,286,130,156,42,43,38,7,1
5321,791,391,400,103,94,59,38,148,63,85,23,22,7,7,1
5322,2570,1286,1284,337,338,294,120,441,189,252,73,50,47,23,1
5323,339,177,162,40,36,51,24,317,156,161,49,51,18,10,1
5324,890,432,458,127,107,99,50,116,67,49,13,12,6,5,1
5325,228,139,89,24,21,32,18,128,62,66,13,11,17,12,1
5326,312,143,169,55,61,12,11,465,225,240,65,44,65,25,1
5327,491,270,221,51,47,53,18,732,373,359,97,96,90,29,1
5328,605,295,310,74,66,70,36,660,332,328,84,73,47,19,1
5329,450,232,218,58,54,42,20,485,190,295,94,55,57,29,1
5330,101,41,60,18,19,10,5,765,295,470,200,142,84,27,1
5331,490,224,266,80,70,39,32,1581,684,897,220,153,118,63,1
5332,714,364,350,98,102,91,27,469,254,215,65,50,63,21,1
5333,1084,537,547,154,121,92,35,245,112,133,32,45,20,10,1
5334,1158,481,677,169,129,86,40,848,394,454,100,90,101,41,1
5335,116,31,85,17,7,4,22,318,176,142,25,32,35,25,1
5336,651,311,340,110,77,73,33,351,183,168,55,44,33,9,1
5337,2377,1284,1093,292,257,254,116,601,313,288,42,48,25,36,1
5338,184,94,90,31,21,24,9,427,218,209,61,53,45,26,1
5339,576,250,326,93,71,34,15,450,190,260,70,77,56,26,1
5340,552,283,269,89,66,68,30,725,339,386,112,122,93,32,1
5341,745,391,354,85,81,52,39,894,417,477,114,123,89,38,1
5342,353,194,159,67,35,52,11,403,220,183,57,39,45,11,1
5343,295,179,116,31,28,28,16,318,176,142,25,32,35,25,1
5344,880,429,451,117,103,78,30,1102,552,550,174,137,137,45,1
5345,71,37,34,11,9,5,5,466,247,219,51,32,49,26,1
5346,530,259,271,83,50,54,41,470,256,214,56,39,47,34,1
5347,417,217,200,56,39,62,17,226,120,106,68,8,2,1,1
5348,560,260,300,100,58,29,28,575,305,270,74,87,73,25,1
5349,480,234,246,79,77,65,23,632,339,293,83,77,59,20,1
5350,1265,580,685,205,188,166,53,280,133,147,44,38,40,12,1
5351,784,373,411,101,90,91,37,215,80,135,54,56,21,9,1
5352,672,334,338,110,93,91,41,193,99,94,31,31,16,12,1
5353,1455,760,695,205,191,124,40,781,418,363,92,90,64,41,1
5354,1382,599,783,208,252,90,39,669,323,346,94,89,34,18,1
5355,627,305,322,102,84,58,19,671,306,365,114,76,49,19,1
5356,817,397,420,120,152,48,17,475,268,207,61,27,56,30,1
5357,119,67,52,15,15,7,7,320,163,157,44,44,26,15,1
5358,246,115,131,15,29,10,32,566,295,271,75,68,74,21,1
5359,870,436,434,131,114,72,25,751,416,335,104,75,130,20,1
5360,146,71,75,20,17,8,7,560,279,281,113,64,58,15,1
5361,1069,512,557,148,126,84,36,1084,537,547,154,121,92,35,1
5362,4684,2161,2523,779,782,304,101,2472,1055,1417,416,458,235,64,1
5363,190,94,96,25,24,18,5,551,298,253,63,65,45,19,1
5364,304,125,179,61,31,44,10,201,42,159,19,3,2,75,1
5365,4391,2256,2135,494,411,423,231,288,158,130,59,23,21,10,1
5366,951,506,445,107,118,79,40,694,260,434,122,92,62,36,1
5367,377,180,197,45,63,19,17,624,334,290,35,40,26,31,1
5368,712,327,385,86,54,64,31,501,240,261,80,62,49,42,1
5369,227,120,107,30,29,28,13,393,210,183,55,50,34,19,1
5370,480,196,284,72,74,25,2,453,242,211,59,47,49,11,1
5371,3695,1922,1773,449,360,352,261,628,330,298,73,73,50,25,1
5372,307,133,174,48,53,27,10,464,237,227,64,66,33,12,1
5373,393,186,207,58,50,36,22,209,75,134,53,48,20,9,1
5374,212,102,110,25,24,17,10,352,166,186,55,59,31,16,1
5375,503,229,274,79,65,52,35,1071,549,522,133,127,130,59,1
5376,367,199,168,62,44,34,8,331,193,138,44,37,18,9,1
5377,788,360,428,93,106,67,72,1366,943,423,137,109,58,19,1
5378,3056,1457,1599,438,389,329,168,951,506,445,107,118,79,40,1
5379,789,362,427,90,82,70,35,467,224,243,70,43,67,23,1
5380,190,94,96,25,24,18,5,224,123,101,29,25,18,8,1
5381,435,222,213,67,49,67,12,808,366,442,130,133,66,31,1
5382,105,51,54,13,17,12,8,397,186,211,73,63,36,25,1
5383,193,105,88,33,16,9,4,149,68,81,15,38,11,10,1
5384,415,223,192,47,45,58,17,329,157,172,35,55,30,19,1
5385,1858,805,1053,271,345,116,41,375,202,173,46,49,41,23,1
5386,908,489,419,114,131,79,46,504,269,235,58,62,43,17,1
5387,546,267,279,90,69,56,19,749,374,375,99,108,98,37,1
5388,598,322,276,67,57,63,26,113,66,47,11,8,12,7,1
5389,216,109,107,32,26,35,10,711,340,371,106,77,87,55,1
5390,248,130,118,26,28,16,11,417,182,235,57,109,50,8,1
5391,238,138,100,31,15,38,11,383,204,179,61,32,54,16,1
5392,1462,711,751,219,222,148,65,1014,490,524,177,137,94,38,1
5393,1863,721,1142,262,283,139,74,729,325,404,129,88,64,32,1
5394,433,229,204,60,59,53,24,505,275,230,63,57,35,12,1
5395,372,189,183,60,44,41,18,593,257,336,76,56,56,96,1
5396,2472,1055,1417,416,458,235,64,916,442,474,150,133,91,32,1
5397,796,445,351,96,80,90,38,435,208,227,68,64,53,23,1
5398,1417,598,819,223,188,135,58,956,405,551,170,171,64,35,1
5399,398,203,195,58,43,54,16,180,89,91,20,28,17,11,1
5400,488,217,271,71,71,50,32,2224,1037,1187,288,276,273,74,1
5401,1190,537,653,207,186,101,26,665,297,368,111,107,34,12,1
5402,303,187,116,41,23,23,9,393,186,207,58,50,36,22,1
5403,245,112,133,32,45,20,10,369,237,132,33,16,38,18,1
5404,1140,495,645,129,95,128,159,1698,875,823,222,219,173,64,1
5405,949,512,437,102,124,70,41,1675,875,800,213,219,196,72,1
5406,1187,631,556,182,139,152,56,906,455,451,116,105,87,46,1
5407,326,166,160,49,45,36,12,166,95,71,23,21,12,4,1
5408,345,165,180,45,43,39,17,101,41,60,18,19,10,5,1
5409,277,145,132,41,32,22,10,396,181,215,52,47,48,19,1
5410,1255,666,589,145,142,120,82,1207,593,614,151,148,131,95,1
5411,514,254,260,55,57,56,19,428,226,202,52,60,75,20,1
5412,2639,1436,1203,317,307,242,77,418,204,214,68,66,38,12,1
5413,93,45,48,19,15,14,3,393,186,207,58,50,36,22,1
5414,391,204,187,47,48,38,18,280,136,144,41,34,26,16,1
5415,998,496,502,149,146,89,27,508,267,241,43,35,25,17,1
5416,326,182,144,43,29,50,28,503,263,240,72,55,51,34,1
5417,211,114,97,32,24,19,10,736,388,348,88,85,67,28,1
5418,446,265,181,51,35,27,17,379,203,176,55,48,45,16,1
5419,351,185,166,45,57,51,14,792,398,394,109,96,90,39,1
5420,344,201,143,42,39,41,14,1113,401,712,196,186,53,44,1
5421,593,321,272,64,84,33,20,393,186,207,58,50,36,22,1
5422,245,122,123,21,32,18,13,256,134,122,29,42,14,7,1
5423,390,191,199,57,49,45,25,393,223,170,44,36,32,14,1
5424,276,143,133,34,38,20,15,235,119,116,31,26,15,13,1
5425,158,83,75,22,14,17,9,672,334,338,110,93,91,41,1
5426,923,471,452,119,117,119,41,749,398,351,118,77,87,29,1
5427,552,285,267,74,51,69,24,720,356,364,90,98,61,22,1
5428,2663,1073,1590,548,499,192,64,192,106,86,27,21,20,10,1
5429,330,208,122,44,20,44,12,245,112,133,32,45,20,10,1
5430,1039,597,442,101,110,106,33,191,85,106,24,34,19,5,1
5431,676,333,343,111,89,94,39,198,112,86,20,36,16,5,1
5432,1477,738,739,176,176,145,72,252,128,124,38,21,34,12,1
5433,708,384,324,97,86,87,30,313,157,156,39,26,34,29,1
5434,659,323,336,80,89,53,18,375,202,173,46,49,41,23,1
5435,590,279,311,103,83,69,30,391,223,168,35,26,47,31,1
5436,277,122,155,33,33,25,24,178,100,78,23,22,30,6,1
5437,1395,627,768,172,263,141,59,360,218,142,39,26,50,18,1
5438,207,97,110,34,27,22,10,206,94,112,37,36,18,9,1
5439,901,439,462,133,123,102,45,211,114,97,32,24,19,10,1
5440,744,385,359,125,89,90,23,345,203,142,47,35,31,11,1
5441,329,155,174,46,38,29,14,556,307,249,74,53,63,18,1
5442,234,108,126,42,40,15,9,1615,835,780,189,208,172,86,1
5443,1922,923,999,267,275,215,90,366,184,182,46,42,23,18,1
5444,566,263,303,83,87,74,31,303,175,128,43,36,34,12,1
5445,771,441,330,89,76,57,29,767,392,375,113,112,83,13,1
5446,222,123,99,32,20,32,6,110,49,61,19,7,2,5,1
5447,575,317,258,48,62,49,55,622,299,323,86,86,69,35,1
5448,444,255,189,60,46,54,16,147,81,66,18,18,18,4,1
5449,672,334,338,110,93,91,41,706,333,373,102,96,64,24,1
5450,279,106,173,48,35,41,39,780,414,366,112,89,73,38,1
5451,690,327,363,115,91,54,31,246,113,133,33,45,22,10,1
5452,859,398,461,96,109,89,57,317,153,164,39,30,35,13,1
5453,165,89,76,17,12,8,16,116,55,61,16,7,18,14,1
5454,324,149,175,49,49,34,6,128,54,74,30,13,8,7,1
5455,636,320,316,79,61,67,31,425,210,215,56,43,52,25,1
5456,312,164,148,54,29,25,15,1186,493,693,184,208,88,32,1
5457,756,362,394,102,104,73,25,588,255,333,94,82,58,27,1
5458,815,418,397,97,62,70,17,546,267,279,90,69,56,19,1
5459,901,458,443,91,129,86,21,968,452,516,150,144,79,28,1
5460,918,427,491,113,111,113,33,1187,631,556,182,139,152,56,1
5461,336,154,182,51,48,39,22,443,217,226,65,67,40,11,1
5462,353,195,158,40,55,30,13,596,286,310,90,89,78,37,1
5463,505,272,233,76,66,57,23,239,146,93,30,22,35,9,1
5464,247,110,137,34,45,23,10,505,244,261,77,65,56,22,1
5465,3957,1683,2274,560,659,267,109,2364,1004,1360,406,426,226,79,1
5466,1392,695,697,162,160,139,74,828,459,369,95,92,107,25,1
5467,379,203,176,55,48,45,16,1807,933,874,248,203,173,71,1
5468,645,366,279,102,68,94,18,138,73,65,18,9,10,3,1
5469,346,178,168,57,42,33,12,246,107,139,55,33,27,11,1
5470,759,391,368,103,82,101,45,246,115,131,15,29,10,32,1
5471,1001,422,579,185,180,51,32,293,140,153,39,44,41,19,1
5472,336,221,115,22,17,40,16,99,49,50,16,8,7,8,1
5473,496,269,227,67,55,37,19,1149,568,581,177,133,101,30,1
5474,392,228,164,53,36,41,17,919,376,543,129,122,55,30,1
5475,1214,498,716,197,180,121,65,327,177,150,40,40,38,18,1
5476,189,96,93,24,21,19,17,377,184,193,50,43,33,17,1
5477,1255,708,547,120,68,88,7,512,261,251,79,73,60,21,1
5478,245,122,123,21,32,18,13,395,169,226,73,54,38,9,1
5479,3685,1574,2111,579,580,303,116,377,202,175,46,50,41,22,1
5480,501,240,261,80,62,49,42,517,212,305,87,78,75,41,1
5481,222,105,117,37,44,6,18,216,102,114,31,29,21,6,1
5482,462,251,211,74,53,41,18,290,127,163,47,58,23,12,1
5483,360,192,168,55,45,48,16,409,200,209,69,56,44,13,1
5484,229,134,95,25,13,28,10,636,380,256,59,60,65,24,1
5485,843,422,421,127,113,79,31,522,235,287,78,67,60,50,1
5486,201,78,123,42,47,19,8,216,119,97,33,27,28,7,1
5487,272,141,131,45,29,36,9,476,270,206,62,45,46,30,1
5488,758,421,337,95,73,116,28,461,221,240,70,64,56,32,1
5489,476,233,243,76,61,52,21,229,105,124,36,33,12,4,1
5490,155,66,89,24,25,9,14,462,233,229,66,49,43,30,1
5491,355,165,190,53,56,42,19,246,115,131,15,29,10,32,1
5492,360,192,168,55,45,48,16,483,215,268,66,70,30,16,1
5493,673,317,356,101,85,76,49,1123,554,569,142,130,85,36,1
5494,193,108,85,24,15,18,9,497,257,240,71,63,62,16,1
5495,2768,1380,1388,280,294,291,161,592,283,309,84,137,60,20,1
5496,758,421,337,95,73,116,28,461,213,248,58,62,54,30,1
5497,736,388,348,88,85,67,28,753,318,435,154,95,56,23,1
5498,655,281,374,108,103,61,24,677,336,341,92,89,77,29,1
5499,827,422,405,111,104,94,28,377,202,175,46,50,41,23,1
5500,598,316,282,81,83,71,21,163,71,92,22,38,11,7,1
5501,696,327,369,80,67,58,30,1308,652,656,166,153,149,87,1
5502,247,110,137,34,45,23,10,636,336,300,94,65,58,32,1
5503,501,240,261,80,62,49,42,461,217,244,44,41,27,36,1
5504,298,167,131,47,33,40,8,393,186,207,58,50,36,22,1
5505,1124,615,509,157,125,128,52,1189,559,630,179,147,118,35,1
5506,510,246,264,80,71,15,18,356,199,157,43,58,29,12,1
5507,786,367,419,126,108,87,29,889,476,413,135,104,78,32,1
5508,598,322,276,67,57,63,26,1279,669,610,164,162,104,55,1
5509,1508,733,775,216,186,172,60,280,142,138,35,37,22,13,1
5510,248,119,129,33,48,20,10,1807,933,874,248,203,173,71,1
5511,593,305,288,91,83,54,24,126,66,60,24,10,7,9,1
5512,1594,660,934,251,272,117,77,1009,506,503,146,141,97,55,1
5513,350,180,170,64,46,55,12,399,194,205,49,102,52,8,1
5514,209,125,84,20,22,22,6,334,172,162,43,39,41,17,1
5515,288,138,150,82,22,25,5,577,288,289,85,56,40,20,1
5516,676,295,381,94,71,65,24,512,261,251,79,73,60,21,1
5517,619,332,287,95,77,74,38,290,149,141,37,26,41,12,1
5518,192,101,91,25,22,18,9,552,285,267,74,51,69,24,1
5519,595,316,279,86,60,65,40,628,341,287,77,59,55,31,1
5520,630,345,285,89,60,41,16,246,115,131,15,29,10,32,1
5521,1257,525,732,216,210,79,52,1907,1008,899,235,224,195,73,1
5522,2442,1193,1249,278,183,170,145,1580,742,838,208,146,144,71,1
5523,2442,1193,1249,278,183,170,145,391,208,183,65,49,57,17,1
5524,298,160,138,37,30,22,12,879,466,413,103,85,111,54,1
5525,462,233,229,66,49,43,30,526,268,258,54,37,55,12,1
5526,676,295,381,94,71,65,24,536,278,258,72,63,62,20,1
5527,420,218,202,47,49,52,15,1154,540,614,195,160,138,66,1
5528,476,251,225,57,67,57,18,2109,999,1110,332,294,187,89,1
5529,445,225,220,47,62,53,26,364,195,169,50,38,33,12,1
5530,756,444,312,95,64,60,17,894,420,474,136,146,93,39,1
5531,433,170,263,67,52,48,23,467,224,243,70,43,67,23,1
5532,464,206,258,60,50,39,40,211,101,110,40,27,17,12,1
5533,1591,704,887,253,227,156,50,346,186,160,48,32,35,14,1
5534,332,172,160,50,33,35,9,770,390,380,104,76,78,32,1
5535,344,168,176,65,44,33,15,487,229,258,68,82,41,24,1
5536,360,188,172,49,48,47,17,163,71,92,33,26,5,7,1
5537,1137,543,594,179,140,113,38,934,472,462,119,122,87,39,1
5538,290,127,163,47,58,23,12,1084,537,547,154,121,92,35,1
5539,208,99,109,28,30,18,9,1278,593,685,198,201,71,43,1
5540,324,154,170,57,40,26,4,221,111,110,42,35,33,6,1
5541,360,188,172,49,48,47,17,748,360,388,101,89,82,36,1
5542,390,208,182,47,53,32,12,437,225,212,61,57,66,12,1
5543,261,127,134,42,37,24,11,248,120,128,43,37,20,6,1
5544,220,126,94,29,12,34,11,1290,629,661,191,187,167,55,1
5545,358,170,188,54,55,20,10,359,173,186,55,57,44,16,1
5546,239,146,93,30,22,35,9,1042,570,472,113,125,91,61,1
5547,1014,490,524,177,137,94,38,551,298,253,63,65,45,19,1
5548,542,249,293,82,69,58,31,1586,815,771,196,135,138,67,1
5549,220,113,107,37,24,16,7,2440,1061,1379,377,326,172,62,1
5550,699,334,365,108,80,70,20,617,311,306,94,88,67,27,1
5551,985,518,467,123,111,76,49,216,113,103,26,21,19,9,1
5552,221,110,111,28,32,25,11,367,161,206,70,48,41,19,1
5553,257,132,125,39,27,26,10,465,225,240,65,44,65,25,1
5554,526,264,262,77,71,61,27,375,202,173,46,49,41,23,1
5555,259,118,141,21,29,15,23,619,343,276,88,65,84,25,1
5556,956,405,551,170,171,64,35,605,281,324,111,67,40,44,1
5557,1190,638,552,162,95,112,18,2229,1036,1193,337,286,161,62,1
5558,464,242,222,61,68,36,17,847,372,475,141,134,77,27,1
5559,401,167,234,56,71,16,10,131,74,57,17,14,12,4,1
5560,1077,501,576,138,159,111,48,2089,917,1172,285,306,83,39,1
5561,400,207,193,30,36,12,10,577,241,336,112,109,47,21,1
5562,827,446,381,111,88,81,45,201,42,159,19,3,2,75,1
5563,1185,585,600,180,174,113,58,359,173,186,55,57,44,16,1
5564,212,88,124,46,24,22,16,427,230,197,48,28,60,37,1
5565,906,455,451,116,105,87,46,972,519,453,109,98,120,39,1
5566,255,122,133,35,51,22,13,815,418,397,97,62,70,17,1
5567,190,94,96,25,24,18,5,199,96,103,31,26,19,4,1
5568,145,76,69,31,13,14,4,350,215,135,36,21,48,14,1
5569,442,228,214,44,53,39,18,921,455,466,144,127,108,39,1
5570,178,100,78,23,22,30,6,920,492,428,100,92,88,49,1
5571,255,122,133,35,51,22,13,536,278,258,72,63,62,20,1
5572,536,278,258,72,63,62,20,246,113,133,33,45,22,10,1
5573,490,224,266,80,70,39,32,2063,1024,1039,175,117,80,97,1
5574,334,172,162,43,39,41,17,664,389,275,68,60,105,35,1
5575,465,257,208,51,61,54,23,821,387,434,121,131,76,29,1
5576,460,223,237,61,65,45,22,296,154,142,38,38,24,16,1
5577,596,286,310,90,89,78,37,191,99,92,25,24,18,8,1
5578,482,231,251,76,81,64,26,718,283,435,126,127,34,29,1
5579,806,436,370,101,100,76,34,1450,754,696,207,197,145,54,1
5580,498,174,324,112,108,33,19,590,303,287,69,65,46,17,1
5581,443,248,195,67,54,40,15,1047,562,485,141,127,114,41,1
5582,540,271,269,80,77,51,16,175,88,87,29,29,23,6,1
5583,619,332,287,95,77,74,38,262,144,118,19,39,22,8,1
5584,107,58,49,17,4,2,6,336,221,115,22,17,40,16,1
5585,276,143,133,34,38,20,15,103,51,52,15,17,6,5,1
5586,1382,599,783,208,252,90,39,875,376,499,155,125,53,39,1
5587,700,335,365,83,84,95,33,121,74,47,15,9,6,6,1
5588,191,72,119,40,41,17,8,1050,473,577,142,119,87,54,1
5589,391,208,183,65,49,57,17,551,298,253,63,65,45,19,1
5590,551,298,253,63,65,45,19,900,484,416,119,110,77,29,1
5591,202,102,100,29,35,6,9,351,195,156,47,53,25,14,1
5592,938,484,454,137,100,104,41,894,420,474,136,146,93,39,1
5593,130,55,75,21,26,10,3,538,252,286,77,87,53,30,1
5594,2157,1171,986,306,238,131,32,866,382,484,116,114,91,28,1
5595,241,124,117,25,35,21,12,248,120,128,43,37,20,6,1
5596,1342,675,667,162,154,123,39,1304,679,625,153,158,131,35,1
5597,847,402,445,137,119,102,41,1210,592,618,157,138,116,85,1
5598,3056,1457,1599,438,389,329,168,118,56,62,13,14,6,6,1
5599,110,53,57,14,15,4,6,197,95,102,31,23,18,12,1
5600,740,313,427,101,135,40,22,497,185,312,63,92,38,28,1
5601,1581,684,897,220,153,118,63,246,113,133,33,45,22,10,1
5602,1084,537,547,154,121,92,35,706,320,386,111,76,75,51,1
5603,147,79,68,20,15,19,8,1247,548,699,168,150,140,43,1
5604,440,235,205,34,61,36,13,336,154,182,51,48,39,22,1
5605,815,382,433,97,50,88,31,401,226,175,53,18,38,20,1
5606,1290,629,661,191,187,167,55,610,281,329,54,62,65,58,1
5607,815,418,397,97,62,70,17,144,63,81,28,32,11,4,1
5608,185,70,115,37,48,15,5,1050,473,577,142,119,87,54,1
5609,902,332,570,154,146,75,40,158,74,84,26,23,18,18,1
5610,208,96,112,31,32,13,9,592,291,301,92,93,71,31,1
5611,370,152,218,67,59,22,23,239,121,118,28,38,15,7,1
5612,788,390,398,94,118,80,18,327,177,150,40,40,38,18,1
5613,198,113,85,19,20,26,12,2138,1161,977,258,229,249,95,1
5614,897,487,410,92,97,83,31,508,295,213,42,61,53,17,1
5615,399,208,191,48,57,53,17,313,149,164,49,40,39,19,1
5616,350,224,126,34,14,48,18,340,162,178,40,39,35,22,1
5617,538,252,286,77,87,53,30,379,203,176,55,48,45,16,1
5618,3433,1476,1957,522,578,264,123,895,474,421,122,93,69,25,1
5619,404,190,214,50,54,35,13,547,292,255,51,55,46,28,1
5620,346,168,178,36,43,20,9,2414,1189,1225,277,178,170,169,1
5621,504,234,270,88,86,55,16,551,237,314,95,79,54,17,1
5622,815,418,397,97,62,70,17,2715,1447,1268,409,320,193,113,1
5623,595,316,279,86,60,65,40,551,298,253,63,65,45,19,1
5624,673,317,356,101,85,76,49,889,450,439,119,104,81,27,1
5625,1113,520,593,168,139,109,49,1770,824,946,245,258,179,60,1
5626,112,59,53,12,17,14,8,161,73,88,23,22,15,8,1
5627,4128,2104,2024,581,505,453,205,215,80,135,54,56,21,9,1
5628,236,145,91,17,19,30,18,1919,871,1048,315,265,148,61,1
5629,484,254,230,60,66,56,14,297,191,106,30,28,25,10,1
5630,443,248,195,67,54,40,15,451,237,214,74,59,65,19,1
5631,543,296,247,86,79,60,19,423,218,205,64,55,54,15,1
5632,380,191,189,45,29,34,17,238,95,143,37,55,4,4,1
5633,140,86,54,17,6,20,7,316,156,160,43,42,28,17,1
5634,613,333,280,71,66,47,26,181,96,85,25,23,20,7,1
5635,775,443,332,109,86,86,20,467,224,243,70,43,67,23,1
5636,777,385,392,112,82,100,28,467,224,243,70,43,67,23,1
5637,194,91,103,17,32,9,6,392,115,277,117,75,28,17,1
5638,803,346,457,126,171,74,24,391,208,183,65,49,57,17,1
5639,862,427,435,139,98,100,59,282,135,147,36,49,25,10,1
5640,770,356,414,123,102,66,25,777,345,432,128,88,65,39,1
5641,352,212,140,37,17,61,20,92,49,43,7,8,10,9,1
5642,1009,506,503,146,141,97,55,619,332,287,95,77,74,38,1
5643,391,203,188,49,34,36,9,134,60,74,19,13,10,7,1
5644,770,390,380,104,76,78,32,399,201,198,65,45,48,17,1
5645,429,227,202,49,51,46,26,454,191,263,61,66,38,15,1
5646,225,129,96,32,33,20,8,193,99,94,31,31,16,12,1
5647,955,465,490,137,138,119,28,193,83,110,26,20,16,9,1
5648,392,115,277,117,75,28,17,415,134,281,114,65,27,7,1
5649,676,333,343,111,89,94,39,479,228,251,79,78,64,24,1
5650,258,141,117,33,29,23,10,672,334,338,110,93,91,41,1
5651,317,153,164,39,30,35,13,537,276,261,75,68,68,22,1
5652,228,72,156,42,27,8,7,336,140,196,51,44,27,18,1
5653,906,455,451,116,105,87,46,1114,581,533,145,132,126,54,1
5654,552,285,267,74,51,69,24,530,259,271,83,50,54,41,1
5655,3664,1638,2026,598,519,231,63,153,81,72,22,18,16,8,1
5656,585,299,286,92,73,89,23,395,197,198,44,57,27,18,1
5657,979,492,487,120,122,89,51,313,160,153,51,33,43,23,1
5658,745,391,354,85,81,52,39,500,268,232,65,56,28,17,1
5659,328,184,144,47,24,23,9,426,228,198,62,42,47,22,1
5660,466,186,280,71,84,30,11,99,34,65,12,1,2,18,1
5661,247,127,120,43,20,27,14,336,134,202,51,64,27,12,1
5662,951,506,445,107,118,79,40,423,218,205,64,55,54,15,1
5663,350,180,170,64,46,55,12,378,154,224,74,84,35,22,1
5664,646,298,348,91,110,63,33,351,184,167,59,45,54,9,1
5665,586,309,277,81,64,76,25,625,298,327,90,78,57,33,1
5666,803,346,457,126,171,74,24,786,378,408,101,79,104,35,1
5667,613,373,240,74,57,52,20,228,139,89,24,21,32,18,1
5668,391,208,183,65,49,57,17,826,362,464,107,118,71,43,1
5669,1181,612,569,107,121,123,43,825,363,462,97,105,72,75,1
5670,316,161,155,46,50,39,16,770,356,414,123,102,66,25,1
5671,456,232,224,69,65,30,19,429,227,202,49,51,46,26,1
5672,184,86,98,26,26,14,11,675,311,364,111,80,96,30,1
5673,606,279,327,81,70,49,34,745,366,379,110,93,79,45,1
5674,801,449,352,95,90,100,15,698,345,353,104,87,81,50,1
5675,922,418,504,120,120,106,31,1978,807,1171,323,310,129,70,1
5676,177,100,77,22,17,20,11,342,155,187,66,58,29,10,1
5677,430,198,232,57,46,37,19,1976,810,1166,364,387,134,59,1
5678,2414,1189,1225,277,178,170,169,323,183,140,45,20,27,16,1
5679,795,305,490,169,178,66,22,611,246,365,116,82,71,27,1
5680,427,218,209,61,53,45,26,1242,613,629,174,113,114,53,1
5681,351,184,167,59,45,54,9,433,221,212,59,42,47,14,1
5682,164,90,74,26,16,19,8,189,90,99,26,29,17,11,1
5683,1314,648,666,135,166,103,52,785,419,366,105,90,64,31,1
5684,987,515,472,107,110,106,61,217,109,108,34,32,35,7,1
5685,395,186,209,53,48,46,30,487,223,264,81,68,63,15,1
5686,326,151,175,50,39,36,17,537,276,261,75,68,68,22,1
5687,354,192,162,46,43,30,20,261,130,131,27,41,19,16,1
5688,806,436,370,101,100,76,34,419,226,193,58,38,39,22,1
5689,243,140,103,33,27,31,12,465,225,240,65,44,65,25,1
5690,1937,899,1038,336,332,181,86,1647,794,853,279,235,128,65,1
5691,524,295,229,69,58,36,12,597,243,354,97,105,63,20,1
5692,476,233,243,76,61,52,21,609,292,317,102,96,64,21,1
5693,425,177,248,60,62,33,16,1102,511,591,171,179,148,52,1
5694,2133,789,1344,342,419,135,88,651,306,345,85,64,61,32,1
5695,255,113,142,45,30,24,13,295,145,150,41,45,36,18,1
5696,531,226,305,81,83,56,33,912,460,452,139,132,89,53,1
5697,635,333,302,99,75,83,28,143,79,64,16,25,7,5,1
5698,499,252,247,75,71,65,25,854,380,474,137,159,81,31,1
5699,4655,2074,2581,545,652,562,399,143,65,78,32,11,11,11,1
5700,538,292,246,69,57,52,39,870,489,381,97,99,76,14,1
5701,688,323,365,121,69,55,22,191,99,92,25,24,18,8,1
5702,1322,598,724,141,94,53,37,3418,1378,2040,515,464,318,121,1
5703,461,227,234,61,47,54,33,780,337,443,112,116,77,28,1
5704,913,443,470,127,120,103,45,596,286,310,90,89,78,37,1
5705,277,124,153,44,40,35,18,782,421,361,101,97,82,20,1
5706,220,113,107,37,24,16,7,3144,1617,1527,367,342,278,136,1
5707,504,247,257,85,57,59,20,202,102,100,29,35,6,9,1
5708,335,177,158,45,49,34,13,312,149,163,43,45,17,15,1
5709,910,524,386,106,97,73,26,202,102,100,29,35,6,9,1
5710,546,267,279,90,69,56,19,482,231,251,76,81,64,26,1
5711,191,103,88,23,14,23,10,513,362,151,36,25,97,33,1
5712,135,65,70,21,25,15,9,582,293,289,94,80,77,32,1
5713,257,176,81,21,11,44,12,467,269,198,46,51,60,18,1
5714,548,252,296,65,93,42,28,863,450,413,116,122,106,41,1
5715,330,143,187,63,29,52,20,693,289,404,95,158,61,15,1
5716,596,286,310,90,89,78,37,712,396,316,78,69,65,25,1
5717,146,71,75,20,17,8,7,246,123,123,40,31,27,7,1
5718,205,106,99,28,26,23,3,175,86,89,33,25,27,2,1
5719,175,86,89,33,25,27,2,173,82,91,27,25,28,4,1
5720,412,238,174,41,38,43,19,258,126,132,42,32,19,26,1
5721,140,76,64,17,13,13,8,375,202,173,46,49,41,23,1
5722,1124,567,557,118,143,120,51,154,78,76,22,25,12,10,1
5723,680,312,368,98,56,38,27,876,473,403,110,106,73,24,1
5724,425,210,215,56,43,52,25,1627,782,845,204,187,202,108,1
5725,379,203,176,55,48,45,16,648,307,341,101,58,76,34,1
5726,484,254,230,60,66,56,14,305,174,131,38,35,31,10,1
5727,2725,1490,1235,339,333,254,78,264,130,134,38,33,26,10,1
5728,569,288,281,86,69,74,24,180,89,91,20,28,17,11,1
5729,1464,715,749,200,167,181,70,921,455,466,144,127,108,39,1
5730,1190,638,552,162,95,112,18,451,267,184,43,39,50,7,1
5731,403,188,215,70,42,41,11,393,186,207,58,50,36,22,1
5732,233,121,112,24,31,30,7,184,95,89,17,21,18,8,1
5733,1785,857,928,246,225,187,93,473,256,217,66,47,64,20,1
5734,248,129,119,31,32,27,11,700,348,352,93,115,85,27,1
5735,427,218,209,61,53,45,26,609,292,317,102,96,64,21,1
5736,456,220,236,67,75,30,21,428,214,214,65,67,45,23,1
5737,391,208,183,65,49,57,17,789,362,427,90,82,70,35,1
5738,462,232,230,78,54,42,23,160,77,83,14,27,11,10,1
5739,1462,652,810,243,199,115,30,740,385,355,114,97,91,27,1
5740,915,336,579,185,199,56,29,1710,650,1060,338,287,185,46,1
5741,201,42,159,19,3,2,75,113,36,77,37,10,14,4,1
5742,134,64,70,19,24,19,4,512,276,236,69,49,67,24,1
5743,455,218,237,57,51,42,35,756,348,408,101,103,60,40,1
5744,174,82,92,27,23,26,14,205,96,109,32,25,31,5,1
5745,277,124,153,44,40,35,18,551,237,314,95,79,54,17,1
5746,1079,582,497,151,133,133,47,260,133,127,43,32,39,3,1
5747,361,172,189,51,54,25,4,5038,2652,2386,655,729,544,245,1
5748,2414,1189,1225,277,178,170,169,412,193,219,70,56,51,26,1
5749,1621,752,869,171,356,65,23,307,150,157,44,23,30,13,1
5750,906,437,469,135,132,49,40,901,458,443,91,129,86,21,1
5751,346,183,163,51,38,23,6,191,99,92,25,24,18,8,1
5752,350,224,126,34,14,48,18,417,182,235,57,109,50,8,1
5753,920,492,428,100,92,88,49,1262,653,609,169,165,152,50,1
5754,450,215,235,73,72,53,18,1106,579,527,121,152,113,45,1
5755,2080,1094,986,284,295,253,78,346,167,179,56,52,28,13,1
5756,207,99,108,22,33,20,12,1117,423,694,182,134,88,31,1
5757,529,274,255,57,62,38,14,391,203,188,49,34,36,9,1
5758,1290,597,693,182,182,119,63,345,176,169,34,31,36,11,1
5759,846,425,421,126,97,98,38,217,109,108,34,32,35,7,1
5760,327,177,150,40,40,38,18,423,212,211,51,44,48,28,1
5761,2063,1024,1039,175,117,80,97,505,247,258,72,71,60,27,1
5762,374,136,238,70,77,16,15,1038,470,568,130,123,86,51,1
5763,1140,495,645,129,95,128,159,1738,821,917,242,196,181,58,1
5764,526,264,262,77,71,61,27,770,374,396,95,91,79,41,1
5765,663,323,340,89,89,76,22,914,453,461,112,115,79,29,1
5766,96,50,46,8,15,6,2,582,285,297,62,57,44,16,1
5767,853,400,453,137,109,88,42,1052,492,560,184,163,103,44,1
5768,404,190,214,55,55,35,27,758,362,396,115,102,35,13,1
5769,215,117,98,43,22,27,5,654,344,310,80,69,57,15,1
5770,151,84,67,17,17,22,11,973,527,446,110,137,122,34,1
5771,745,366,379,110,93,79,45,724,320,404,120,147,67,25,1
5772,432,181,251,48,75,27,17,533,254,279,81,78,52,10,1
5773,729,321,408,128,84,63,26,489,250,239,66,57,47,26,1
5774,341,154,187,34,36,11,11,2045,985,1060,359,339,199,74,1
5775,601,313,288,42,48,25,36,1154,405,749,164,255,63,65,1
5776,172,88,84,24,31,20,12,498,289,209,62,41,63,18,1
5777,262,78,184,78,28,32,4,526,268,258,54,37,55,12,1
5778,1997,972,1025,262,209,239,52,1390,695,695,180,137,170,71,1
5779,475,235,240,77,58,43,22,248,118,130,54,31,26,5,1
5780,560,279,281,113,64,58,15,985,551,434,123,93,91,26,1
5781,883,470,413,112,99,108,34,744,384,360,104,96,57,31,1
5782,892,420,472,135,146,98,37,210,106,104,29,23,20,4,1
5783,1382,689,693,186,176,167,77,535,249,286,79,64,55,22,1
5784,777,387,390,90,87,65,37,755,348,407,109,98,49,23,1
5785,686,375,311,89,80,63,20,1893,764,1129,308,323,126,60,1
5786,2524,1232,1292,398,317,186,61,468,233,235,65,61,49,34,1
5787,361,184,177,50,53,51,22,1441,657,784,140,135,81,73,1
5788,705,396,309,87,48,53,17,466,186,280,71,84,30,11,1
5789,464,242,222,61,68,36,17,845,402,443,137,126,105,47,1
5790,118,60,58,22,9,8,9,673,329,344,111,95,92,41,1
5791,193,118,75,20,21,24,6,91,56,35,17,2,7,7,1
5792,451,222,229,72,46,57,17,255,122,133,35,51,22,13,1
5793,501,240,261,80,62,49,42,1442,606,836,212,158,111,47,1
5794,571,341,230,50,44,61,33,401,167,234,56,71,16,10,1
5795,270,137,133,30,28,27,11,771,321,450,151,135,43,15,1
5796,218,127,91,27,23,23,10,208,104,104,20,54,9,5,1
5797,451,209,242,73,53,47,36,408,197,211,74,44,53,16,1
5798,392,229,163,46,43,50,16,445,235,210,66,50,59,17,1
5799,712,380,332,69,74,57,30,392,155,237,68,61,34,16,1
5800,461,223,238,66,57,36,23,158,85,73,24,18,18,8,1
5801,246,108,138,32,44,21,10,693,359,334,75,54,59,20,1
5802,469,204,265,81,67,30,22,501,240,261,80,62,49,42,1
5803,781,418,363,92,90,64,41,382,183,199,55,60,38,22,1
5804,1261,694,567,159,130,136,70,1091,602,489,143,101,144,67,1
5805,659,325,334,102,85,87,32,1265,580,685,205,188,166,53,1
5806,2524,1232,1292,398,317,186,61,598,322,276,67,57,63,26,1
5807,686,375,311,89,80,63,20,466,186,280,71,84,30,11,1
5808,1577,747,830,213,232,147,57,1253,639,614,181,155,164,73,1
5809,901,458,443,91,129,86,21,1134,574,560,157,164,47,48,1
5810,103,56,47,27,7,8,2,652,272,380,116,113,55,27,1
5811,873,381,492,98,137,76,78,317,156,161,49,51,18,10,1
5812,593,266,327,102,84,69,24,379,203,176,55,48,45,16,1
5813,484,264,220,59,62,68,15,508,267,241,43,35,25,17,1
5814,210,102,108,33,33,20,9,249,114,135,47,33,25,4,1
5815,1721,809,912,268,234,144,50,165,80,85,21,9,18,19,1
5816,281,138,143,50,36,27,16,340,162,178,40,39,35,22,1
5817,4128,2104,2024,581,505,453,205,512,261,251,79,73,60,21,1
5818,561,210,351,108,77,41,22,524,270,254,84,72,70,23,1
5819,593,266,327,102,84,69,24,509,262,247,64,70,64,20,1
5820,714,364,350,98,102,91,27,470,205,265,71,80,33,11,1
5821,487,247,240,73,42,42,22,391,201,190,52,47,35,24,1
5822,1475,658,817,149,114,120,43,962,502,460,112,122,109,50,1
5823,743,346,397,91,90,62,10,206,92,114,37,36,19,7,1
5824,770,390,380,104,76,78,32,104,48,56,15,15,13,7,1
5825,395,186,209,53,48,46,30,490,230,260,78,70,53,18,1
5826,198,80,118,35,31,14,7,432,228,204,59,53,43,15,1
5827,368,195,173,52,41,42,15,390,203,187,58,40,43,19,1
5828,89,42,47,16,12,15,6,140,86,54,17,6,20,7,1
5829,769,362,407,99,88,66,67,317,153,164,39,30,35,13,1
5830,211,113,98,38,17,25,8,993,492,501,116,119,135,57,1
5831,948,484,464,134,131,75,27,501,240,261,80,62,49,42,1
5832,391,208,183,65,49,57,17,308,159,149,52,41,22,10,1
5833,1069,512,557,148,126,84,36,95,41,54,15,16,8,5,1
5834,509,341,168,35,32,52,15,606,316,290,81,91,60,25,1
5835,148,87,61,20,13,21,11,460,274,186,50,34,69,27,1
5836,647,324,323,101,80,76,43,624,222,402,92,81,39,15,1
5837,851,446,405,93,94,92,37,592,264,328,86,85,62,41,1
5838,284,111,173,47,34,47,43,279,106,173,48,35,41,39,1
5839,770,390,380,104,76,78,32,1347,625,722,182,126,156,57,1
5840,1770,824,946,245,258,179,60,439,227,212,60,55,58,8,1
5841,552,285,267,74,51,69,24,137,60,77,37,4,10,6,1
5842,815,418,397,97,62,70,17,2054,882,1172,361,347,147,68,1
5843,261,143,118,33,24,32,16,462,157,305,93,51,54,3,1
5844,1937,899,1038,336,332,181,86,482,231,251,76,81,64,26,1
5845,95,73,22,2,13,14,4,401,167,234,56,71,16,10,1
5846,248,119,129,33,48,20,10,249,111,138,40,30,22,17,1
5847,320,143,177,51,51,24,10,431,186,245,79,83,37,18,1
5848,938,484,454,137,100,104,41,489,242,247,83,63,62,19,1
5849,392,203,189,44,42,33,22,440,215,225,76,74,29,16,1
5850,1342,675,667,162,154,123,39,298,160,138,37,30,22,12,1
5851,321,180,141,47,37,33,12,413,206,207,38,55,19,10,1
5852,482,224,258,71,62,52,39,462,233,229,66,49,43,30,1
5853,199,113,86,27,17,10,7,1024,486,538,186,113,94,51,1
5854,241,106,135,36,48,22,13,246,108,138,32,44,21,10,1
5855,1269,624,645,183,180,136,52,429,227,202,49,51,46,26,1
5856,969,505,464,123,133,92,33,149,77,72,19,15,18,9,1
5857,194,90,104,33,17,24,19,2328,1054,1274,377,410,232,62,1
5858,376,183,193,50,50,43,21,873,366,507,127,125,75,21,1
5859,985,445,540,164,146,68,36,204,99,105,32,32,22,10,1
5860,733,346,387,98,113,66,26,445,225,220,47,62,53,26,1
5861,246,120,126,42,27,25,5,770,390,380,104,76,78,32,1
5862,1186,493,693,184,208,88,32,656,358,298,67,47,64,26,1
5863,586,270,316,83,80,59,21,497,185,312,63,92,38,28,1
5864,467,221,246,98,68,43,11,422,203,219,75,49,40,22,1
5865,391,208,183,65,49,57,17,225,113,112,29,45,19,7,1
5866,448,236,212,53,64,56,24,454,191,263,61,66,38,15,1
5867,496,247,249,82,69,47,14,246,113,133,33,45,22,10,1
5868,446,252,194,41,23,54,35,355,165,190,53,56,42,19,1
5869,641,324,317,88,92,49,14,274,157,117,40,29,40,8,1
5870,1084,537,547,154,121,92,35,255,122,133,35,51,22,13,1
5871,1086,603,483,147,121,95,40,217,109,108,34,32,35,7,1
5872,456,209,247,72,58,40,9,624,308,316,92,72,68,22,1
5873,829,366,463,137,130,56,10,533,254,279,81,78,52,10,1
5874,483,215,268,66,70,30,16,318,150,168,60,42,32,12,1
5875,335,177,158,45,49,34,13,1074,539,535,136,87,87,66,1
5876,673,328,345,107,112,63,27,1474,756,718,175,158,169,51,1
5877,245,112,133,32,45,20,10,626,333,293,64,55,61,15,1
5878,194,82,112,28,24,19,6,323,198,125,28,25,34,15,1
5879,1258,648,610,172,159,116,28,671,326,345,111,77,74,11,1
5880,126,57,69,31,10,10,3,384,196,188,42,43,32,20,1
5881,317,153,164,39,30,35,13,1484,731,753,206,175,187,71,1
5882,1149,568,581,177,133,101,30,1290,629,661,191,187,167,55,1
5883,595,316,279,86,60,65,40,841,427,414,112,88,56,25,1
5884,706,320,386,111,76,75,51,1243,633,610,149,160,87,39,1
5885,198,80,118,35,31,14,7,246,108,138,32,44,21,10,1
5886,324,154,170,57,40,26,4,526,268,258,54,37,55,12,1
5887,357,193,164,49,44,43,18,113,79,34,12,4,18,3,1
5888,1106,579,527,121,152,113,45,1634,828,806,236,195,195,67,1
5889,367,181,186,39,34,36,43,359,184,175,49,35,32,11,1
5890,393,186,207,58,50,36,22,317,153,164,34,52,30,14,1
5891,603,311,292,102,71,66,23,239,144,95,20,26,23,13,1
5892,3144,1617,1527,367,342,278,136,217,109,108,34,32,35,7,1
5893,446,265,181,51,35,27,17,463,231,232,66,69,29,18,1
5894,1075,505,570,158,104,86,18,366,211,155,35,42,24,12,1
5895,267,124,143,45,46,26,4,227,130,97,32,25,22,12,1
5896,613,334,279,90,71,51,17,395,222,173,48,42,21,8,1
5897,1186,553,633,177,142,143,61,239,121,118,28,38,15,7,1
5898,486,199,287,79,91,52,18,444,189,255,72,82,45,17,1
5899,246,115,131,15,29,10,32,354,181,173,52,18,50,15,1
5900,902,332,570,154,146,75,40,440,246,194,62,49,41,16,1
5901,136,65,71,33,11,9,6,538,268,270,58,72,42,25,1
5902,822,402,420,125,107,82,26,1338,756,582,155,105,104,44,1
5903,470,277,193,42,40,60,17,142,80,62,24,12,21,4,1
5904,96,50,46,8,15,6,2,157,72,85,46,9,12,5,1
5905,536,278,258,72,63,62,20,526,254,272,44,43,49,13,1
5906,418,226,192,57,57,53,17,901,458,443,91,129,86,21,1
5907,501,257,244,65,53,57,28,393,215,178,44,56,49,15,1
5908,415,228,187,44,44,48,15,498,277,221,51,46,70,22,1
5909,723,371,352,86,69,80,27,928,455,473,108,90,107,43,1
5910,318,176,142,25,32,35,25,600,319,281,94,67,72,37,1
5911,233,130,103,26,23,23,6,359,184,175,49,35,32,11,1
5912,201,108,93,36,21,17,4,503,263,240,72,55,51,34,1
5913,552,285,267,74,51,69,24,242,104,138,41,33,37,8,1
5914,2045,985,1060,359,339,199,74,376,205,171,56,52,46,12,1
5915,703,308,395,81,91,66,80,225,102,123,32,32,31,15,1
5916,211,83,128,28,35,5,11,593,305,288,91,83,54,24,1
5917,750,347,403,105,103,83,29,529,264,265,59,68,41,17,1
5918,560,260,300,100,58,29,28,164,78,86,28,23,12,8,1
5919,900,484,416,119,110,77,29,998,496,502,149,146,89,27,1
5920,277,124,153,44,40,35,18,521,265,256,69,69,61,26,1
5921,1290,658,632,145,139,94,44,415,203,212,77,44,49,18,1
5922,1419,759,660,198,135,147,51,798,378,420,99,94,71,63,1
5923,536,278,258,72,63,62,20,1484,731,753,206,175,187,71,1
5924,692,305,387,100,97,78,30,3056,1457,1599,438,389,329,168,1
5925,695,264,431,172,114,51,23,246,115,131,15,29,10,32,1
5926,100,37,63,26,19,0,1,90,41,49,26,14,0,1,1
5927,274,158,116,27,27,22,18,168,120,48,7,5,20,7,1
5928,430,218,212,58,47,34,20,186,97,89,26,28,13,5,1
5929,797,394,403,109,89,83,40,756,348,408,101,103,60,40,1
5930,1257,647,610,156,146,145,35,1049,585,464,107,108,120,28,1
5931,128,52,76,27,25,11,8,158,74,84,26,23,18,18,1
5932,469,242,227,66,48,48,26,606,279,327,81,70,49,34,1
5933,160,80,80,20,14,25,11,839,427,412,91,83,114,37,1
5934,395,195,200,41,55,23,10,228,72,156,42,27,8,7,1
5935,559,296,263,77,69,42,13,377,184,193,56,53,44,14,1
5936,589,314,275,70,83,44,28,309,154,155,42,44,45,16,1
5937,520,274,246,55,70,57,16,200,105,95,32,22,17,12,1
5938,247,110,137,34,45,23,10,1202,506,696,209,198,74,44,1
5939,982,494,488,150,117,91,45,217,109,108,34,32,35,7,1
5940,212,107,105,32,25,22,7,748,355,393,121,91,95,26,1
5941,272,149,123,34,35,21,2,1068,527,541,160,131,112,52,1
5942,624,204,420,166,101,32,13,710,307,403,117,176,37,9,1
5943,1241,670,571,135,139,110,32,537,276,261,75,68,68,22,1
5944,469,224,245,67,77,34,17,151,78,73,37,12,15,2,1
5945,787,386,401,98,95,86,25,551,299,252,51,62,63,17,1
5946,283,141,142,32,26,23,26,289,135,154,37,34,34,17,1
5947,451,267,184,43,39,50,7,418,248,170,41,31,54,9,1
5948,262,114,148,46,44,30,16,551,298,253,63,65,45,19,1
5949,595,316,279,86,60,65,40,1807,933,874,248,203,173,71,1
5950,213,86,127,37,33,5,16,99,47,52,12,16,6,2,1
5951,522,283,239,65,64,76,22,543,287,256,71,66,64,23,1
5952,335,172,163,40,29,31,15,529,283,246,66,69,66,25,1
5953,671,318,353,83,124,46,34,284,97,187,68,38,42,16,1
5954,926,435,491,133,132,85,17,4655,2074,2581,545,652,562,399,1
5955,185,81,104,32,23,19,9,2440,1061,1379,377,326,172,62,1
5956,410,200,210,60,54,46,19,331,169,162,40,28,22,14,1
5957,928,442,486,139,118,91,43,271,131,140,47,37,41,11,1
5958,476,270,206,62,45,46,30,784,373,411,101,90,91,37,1
5959,313,160,153,51,33,43,23,552,285,267,74,51,69,24,1
5960,509,262,247,64,70,64,20,575,301,274,84,65,63,20,1
5961,1321,679,642,154,167,133,58,858,417,441,93,124,75,26,1
5962,350,180,170,64,46,55,12,241,115,126,35,30,17,14,1
5963,781,418,363,92,90,64,41,2414,1189,1225,277,178,170,169,1
5964,685,319,366,80,66,70,71,2003,1022,981,195,194,164,229,1
5965,465,218,247,64,51,50,42,493,275,218,64,36,49,30,1
5966,391,208,183,65,49,57,17,113,47,66,14,15,11,17,1
5967,2442,1193,1249,278,183,170,145,272,141,131,45,29,36,9,1
5968,1222,601,621,182,145,115,52,355,169,186,49,37,26,11,1
5969,1332,652,680,210,180,155,49,1149,568,581,177,133,101,30,1
5970,760,405,355,112,95,92,29,297,158,139,47,37,37,9,1
5971,418,189,229,76,72,45,14,1382,689,693,186,176,167,77,1
5972,1311,514,797,220,157,168,108,591,300,291,70,45,59,30,1
5973,468,243,225,60,50,34,32,398,200,198,68,43,51,14,1
5974,522,239,283,75,88,45,11,1165,567,598,134,119,158,63,1
5975,2261,1217,1044,271,243,267,101,1349,534,815,216,198,111,41,1
5976,201,42,159,19,3,2,75,223,76,147,49,29,31,5,1
5977,393,186,207,58,50,36,22,207,93,114,20,33,19,10,1
5978,168,67,101,37,17,13,13,508,254,254,74,99,61,12,1
5979,517,289,228,61,56,64,17,482,274,208,53,49,63,24,1
5980,161,83,78,33,12,17,5,325,169,156,32,37,49,20,1
5981,3333,1606,1727,446,357,333,206,562,265,297,79,56,72,45,1
5982,221,111,110,42,35,33,6,330,151,179,68,36,56,9,1
5983,183,89,94,27,24,20,8,81,41,40,15,13,3,2,1
5984,140,86,54,17,6,20,7,207,99,108,22,33,20,12,1
5985,128,52,76,27,25,11,8,201,42,159,19,3,2,75,1
5986,556,279,277,83,69,71,19,427,232,195,58,46,55,17,1
5987,277,124,153,44,40,35,18,193,85,108,24,37,20,13,1
5988,562,282,280,76,80,43,12,390,191,199,66,49,43,12,1
5989,460,251,209,61,48,43,21,416,182,234,62,67,37,17,1
5990,393,186,207,58,50,36,22,343,165,178,57,48,36,14,1
5991,267,127,140,43,42,24,9,721,367,354,92,86,76,27,1
5992,525,274,251,82,74,60,25,790,385,405,121,108,106,39,1
5993,729,321,408,128,84,63,26,269,127,142,43,24,34,26,1
5994,1038,470,568,130,123,86,51,467,240,227,65,65,51,23,1
5995,2440,1061,1379,377,326,172,62,462,228,234,59,47,37,32,1
5996,234,93,141,42,26,17,15,155,74,81,23,19,20,5,1
5997,748,355,393,121,91,95,26,684,288,396,107,90,54,42,1
5998,2261,1217,1044,271,243,267,101,540,271,269,80,77,51,16,1
5999,177,67,110,34,24,13,10,859,395,464,157,119,59,31,1
6000,616,304,312,75,71,55,25,390,237,153,41,57,22,16,1
6001,1074,538,536,154,140,111,51,537,276,261,75,68,68,22,1
6002,393,186,207,58,50,36,22,781,367,414,60,67,43,17,1
6003,181,71,110,34,30,21,7,354,166,188,53,55,40,19,1
6004,985,551,434,123,93,91,26,440,246,194,62,49,41,16,1
6005,309,179,130,37,19,31,16,247,110,137,34,45,23,10,1
6006,561,280,281,88,58,89,27,400,193,207,53,69,48,14,1
6007,471,255,216,66,68,81,16,4544,2024,2520,579,628,480,403,1
6008,692,326,366,103,121,67,27,289,139,150,38,44,23,20,1
6009,445,209,236,63,50,42,28,257,148,109,28,20,21,14,1
6010,1059,508,551,129,112,135,36,296,154,142,38,38,24,16,1
6011,326,181,145,50,31,28,24,465,225,240,65,44,65,25,1
6012,289,143,146,40,35,28,9,529,314,215,59,64,39,14,1
6013,91,50,41,8,14,4,5,355,179,176,51,45,45,11,1
6014,509,262,247,64,70,64,20,262,144,118,19,39,22,8,1
6015,432,217,215,52,49,34,16,317,147,170,40,80,41,7,1
6016,596,313,283,86,77,64,20,1327,690,637,194,140,130,52,1
6017,624,308,316,92,72,68,22,911,423,488,140,150,102,32,1
6018,601,313,288,42,48,25,36,236,92,144,25,25,28,36,1
6019,1215,652,563,129,142,121,62,448,236,212,53,64,56,24,1
6020,729,266,463,185,136,34,8,5038,2652,2386,655,729,544,245,1
6021,449,244,205,68,53,49,12,794,390,404,103,95,86,23,1
6022,738,339,399,102,88,68,35,1290,629,661,191,187,167,55,1
6023,277,100,177,35,88,30,2,136,65,71,33,11,9,6,1
6024,502,240,262,78,61,54,32,401,213,188,64,48,35,18,1
6025,1425,670,755,153,189,122,85,1132,646,486,99,102,71,41,1
6026,160,86,74,21,11,16,16,748,341,407,121,87,96,52,1
6027,369,181,188,41,36,54,16,551,299,252,51,62,63,17,1
6028,154,75,79,17,24,16,13,1539,685,854,166,229,123,67,1
6029,1257,647,610,156,146,145,35,858,417,441,93,124,75,26,1
6030,700,357,343,99,84,88,34,217,109,108,34,32,35,7,1
6031,834,405,429,112,95,84,34,467,226,241,55,48,54,23,1
6032,303,141,162,42,57,37,20,810,367,443,115,92,94,59,1
6033,225,129,96,32,33,20,8,191,95,96,26,17,17,12,1
6034,940,464,476,116,135,108,58,365,210,155,46,30,24,12,1
6035,211,114,97,32,24,19,10,672,334,338,110,93,91,41,1
6036,333,127,206,66,68,25,14,452,230,222,64,61,31,27,1
6037,672,334,338,110,93,91,41,2725,1490,1235,339,333,254,78,1
6038,317,153,164,34,52,30,14,217,108,109,30,23,28,10,1
6039,472,259,213,51,44,56,21,1091,543,548,146,136,110,34,1
6040,191,99,92,25,24,18,8,140,86,54,17,6,20,7,1
6041,441,216,225,57,66,57,19,425,210,215,56,43,52,25,1
6042,928,442,486,139,118,91,43,415,217,198,49,51,50,23,1
6043,509,254,255,67,55,52,35,213,109,104,26,26,21,6,1
6044,432,218,214,57,55,42,11,180,95,85,30,20,29,10,1
6045,122,47,75,18,25,5,5,181,95,86,21,22,18,9,1
6046,361,184,177,50,53,51,22,372,196,176,51,36,51,8,1
6047,1272,520,752,235,242,117,54,276,143,133,34,38,20,15,1
6048,245,112,133,32,45,20,10,591,319,272,96,62,43,19,1
6049,743,366,377,41,37,26,14,1097,526,571,131,134,120,43,1
6050,346,191,155,52,38,40,13,548,250,298,85,64,56,21,1
6051,1980,963,1017,262,243,179,78,219,111,108,28,36,19,9,1
6052,103,51,52,15,17,6,5,95,47,48,13,12,10,4,1
6053,472,222,250,46,61,33,23,301,157,144,31,28,34,9,1
6054,435,208,227,68,64,53,23,1242,613,629,174,113,114,53,1
6055,594,274,320,89,63,66,28,1106,579,527,121,152,113,45,1
6056,95,44,51,14,13,7,4,750,347,403,105,103,83,29,1
6057,615,312,303,86,54,75,45,626,333,293,64,55,61,15,1
6058,338,168,170,60,38,48,17,323,171,152,36,36,47,15,1
6059,424,198,226,57,46,41,19,928,442,486,139,118,91,43,1
6060,393,215,178,44,56,49,15,413,227,186,45,34,58,23,1
6061,1542,682,860,290,158,120,47,277,100,177,35,88,30,2,1
6062,437,225,212,36,34,32,39,256,125,131,36,39,32,13,1
6063,246,115,131,15,29,10,32,145,63,82,17,18,6,8,1
6064,119,57,62,18,16,17,4,417,182,235,57,109,50,8,1
6065,344,201,143,42,39,41,14,467,224,243,70,43,67,23,1
6066,625,342,283,62,53,56,28,431,219,212,68,46,67,18,1
6067,393,210,183,55,50,34,19,428,248,180,44,39,28,9,1
6068,248,119,129,33,48,20,10,729,321,408,128,84,63,26,1
6069,516,290,226,79,54,84,28,393,186,207,58,50,36,22,1
6070,228,92,136,43,39,16,7,94,45,49,11,20,10,4,1
6071,525,237,288,121,59,105,20,245,142,103,29,20,21,9,1
6072,620,305,315,97,80,87,28,906,455,451,116,105,87,46,1
6073,365,180,185,63,35,48,19,375,202,173,46,49,41,23,1
6074,760,391,369,101,109,65,24,233,106,127,34,48,21,7,1
6075,769,362,407,99,88,66,67,427,186,241,55,52,42,23,1
6076,464,225,239,85,57,65,19,323,156,167,52,45,39,18,1
6077,211,113,98,38,17,25,8,356,208,148,42,26,57,15,1
6078,699,376,323,79,53,86,41,141,83,58,15,10,10,17,1
6079,979,535,444,123,99,79,34,165,87,78,24,19,22,9,1
6080,351,184,167,59,45,54,9,181,71,110,34,30,21,7,1
6081,313,183,130,24,16,47,25,170,89,81,28,24,18,9,1
6082,1174,579,595,174,135,132,42,536,278,258,72,63,62,20,1
6083,325,159,166,42,43,48,15,592,264,328,86,85,62,41,1
6084,1581,684,897,220,153,118,63,427,191,236,67,60,41,34,1
6085,624,308,316,92,72,68,22,1124,615,509,157,125,128,52,1
6086,684,288,396,107,90,54,42,2961,1467,1494,392,384,307,154,1
6087,424,230,194,56,42,53,18,633,303,330,95,91,51,13,1
6088,7968,4016,3952,1072,1051,652,307,1881,929,952,259,247,158,57,1
6089,667,360,307,76,92,46,27,198,110,88,27,27,24,4,1
6090,1339,494,845,216,298,92,37,476,233,243,76,61,52,21,1
6091,940,464,476,116,135,108,58,984,516,468,78,45,73,12,1
6092,705,396,309,87,48,53,17,140,81,59,16,15,15,12,1
6093,175,88,87,29,21,18,5,984,516,468,78,45,73,12,1
6094,275,140,135,38,32,18,5,443,198,245,68,72,48,19,1
6095,651,311,340,110,77,73,33,315,150,165,49,59,23,15,1
6096,267,147,120,37,28,35,12,253,141,112,28,21,33,20,1
6097,223,138,85,22,21,38,5,2671,1322,1349,379,345,290,135,1
6098,301,172,129,45,34,39,15,105,53,52,23,11,12,6,1
6099,1566,743,823,261,188,151,48,498,231,267,72,61,54,29,1
6100,2813,1331,1482,320,339,261,290,1464,987,477,137,141,55,31,1
6101,530,244,286,103,62,42,20,595,316,279,86,60,65,40,1
6102,664,350,314,96,93,83,24,358,170,188,54,55,20,10,1
6103,462,251,211,74,53,41,18,601,313,288,42,48,25,36,1
6104,352,212,140,37,17,61,20,354,166,188,53,55,40,19,1
6105,598,322,276,67,57,63,26,740,385,355,114,97,91,27,1
6106,295,139,156,48,31,30,17,393,186,207,58,50,36,22,1
6107,1046,562,484,139,116,124,51,508,267,241,43,35,25,17,1
6108,132,67,65,22,15,17,5,655,311,344,69,73,60,28,1
6109,1129,589,540,134,122,108,46,1017,498,519,136,107,82,52,1
6110,249,114,135,47,33,25,4,380,187,193,38,51,30,18,1
6111,429,219,210,46,66,42,17,316,161,155,56,39,34,14,1
6112,424,230,194,56,42,53,18,672,334,338,110,93,91,41,1
6113,553,362,191,42,29,59,32,519,246,273,78,82,42,16,1
6114,1139,536,603,162,139,109,50,410,208,202,59,58,43,26,1
6115,1771,864,907,239,217,158,63,838,431,407,107,90,107,43,1
6116,2414,1189,1225,277,178,170,169,313,178,135,43,18,35,6,1
6117,672,334,338,110,93,91,41,748,386,362,111,75,71,40,1
6118,870,415,455,112,103,93,51,445,219,226,61,60,60,21,1
6119,351,184,167,59,45,54,9,193,99,94,31,31,16,12,1
6120,1084,537,547,154,121,92,35,425,199,226,54,71,56,11,1
6121,593,266,327,102,84,69,24,838,431,407,107,90,107,43,1
6122,416,210,206,55,54,39,20,604,282,322,76,74,69,35,1
6123,380,212,168,47,38,19,11,318,176,142,25,32,35,25,1
6124,859,345,514,129,135,60,31,2175,1078,1097,364,275,271,81,1
6125,255,134,121,36,40,29,13,164,78,86,28,23,12,8,1
6126,432,229,203,54,43,47,21,698,365,333,108,83,65,21,1
6127,605,352,253,69,59,54,15,191,101,90,21,23,28,5,1
6128,885,424,461,143,114,92,32,374,180,194,53,55,36,18,1
6129,1132,553,579,172,143,150,57,648,307,341,101,58,76,34,1
6130,1210,592,618,157,138,116,85,864,362,502,142,150,70,19,1
6131,462,251,211,74,53,41,18,264,122,142,33,29,13,13,1
6132,236,121,115,26,45,28,6,1354,537,817,245,247,117,57,1
6133,2843,1104,1739,429,357,178,95,781,418,363,92,90,64,41,1
6134,504,256,248,78,70,36,9,246,113,133,33,45,22,10,1
6135,484,254,230,60,66,56,14,1290,597,693,182,182,119,63,1
6136,794,390,404,103,95,86,23,216,121,95,38,27,25,6,1
6137,1117,423,694,182,134,88,31,240,98,142,49,42,23,17,1
6138,1591,704,887,253,227,156,50,672,334,338,110,93,91,41,1
6139,873,366,507,127,125,75,21,428,214,214,65,67,45,23,1
6140,361,184,177,50,53,51,22,1424,650,774,152,124,95,87,1
6141,297,158,139,47,37,37,9,165,77,88,28,27,19,10,1
6142,596,292,304,92,60,56,19,781,418,363,92,90,64,41,1
6143,154,75,79,28,23,16,6,493,208,285,75,77,70,40,1
6144,1462,711,751,219,222,148,65,298,167,131,47,33,40,8,1
6145,246,108,138,32,44,21,10,887,385,502,144,122,110,34,1
6146,1356,576,780,229,198,107,38,1701,747,954,263,224,165,53,1
6147,548,250,298,85,64,56,21,437,228,209,47,61,26,11,1
6148,313,166,147,47,44,41,10,524,237,287,87,75,54,26,1
6149,941,448,493,150,118,127,39,570,281,289,86,70,58,22,1
6150,327,172,155,45,44,39,21,1074,538,536,154,140,111,51,1
6151,221,111,110,42,35,33,6,496,209,287,113,55,72,14,1
6152,1105,479,626,182,125,80,29,703,356,347,96,97,38,22,1
6153,956,403,553,147,135,99,87,815,418,397,97,62,70,17,1
6154,640,279,361,102,83,69,21,345,203,142,47,35,31,11,1
6155,1106,579,527,121,152,113,45,724,334,390,112,109,79,17,1
6156,482,223,259,74,67,39,12,582,293,289,94,80,77,32,1
6157,131,66,65,21,14,23,7,757,359,398,109,127,80,26,1
6158,1651,798,853,203,199,137,50,450,229,221,49,63,54,27,1
6159,196,110,86,23,15,14,16,822,417,405,111,127,76,34,1
6160,1069,512,557,148,126,84,36,482,231,251,76,81,64,26,1
6161,1119,647,472,144,100,118,61,1091,602,489,143,101,144,67,1
6162,366,184,182,46,42,23,18,859,438,421,142,80,105,43,1
6163,802,388,414,131,105,96,29,505,226,279,68,51,30,15,1
6164,2817,1216,1601,379,436,183,115,404,197,207,57,69,33,15,1
6165,247,110,137,34,45,23,10,1430,614,816,229,197,128,71,1
6166,1049,493,556,146,138,87,41,166,81,85,30,27,13,8,1
6167,391,208,183,65,49,57,17,2383,1253,1130,323,292,273,107,1
6168,863,458,405,97,82,63,57,888,478,410,105,73,58,33,1
6169,620,258,362,106,100,47,28,703,356,347,96,97,38,22,1
6170,2325,914,1411,411,434,135,74,312,172,140,41,40,21,8,1
6171,711,322,389,112,85,68,40,503,263,240,72,55,51,34,1
6172,210,102,108,33,33,20,9,592,295,297,79,70,76,11,1
6173,375,167,208,55,83,44,9,126,57,69,31,10,10,3,1
6174,781,418,363,92,90,64,41,969,505,464,123,133,92,33,1
6175,795,444,351,120,97,73,32,306,156,150,47,37,21,3,1
6176,176,74,102,20,29,7,7,339,170,169,32,17,24,13,1
6177,447,194,253,70,67,57,19,1336,828,508,166,121,152,48,1
6178,1719,754,965,277,258,158,80,686,334,352,107,93,73,43,1
6179,442,208,234,68,49,51,25,592,264,328,86,85,62,41,1
6180,2136,1063,1073,317,308,223,90,246,108,138,32,44,21,10,1
6181,598,322,276,67,57,63,26,882,432,450,115,111,68,44,1
6182,327,175,152,48,45,36,16,580,339,241,72,47,66,21,1
6183,391,208,183,65,49,57,17,245,111,134,31,44,20,11,1
6184,778,353,425,140,89,92,51,395,222,173,48,42,21,8,1
6185,404,177,227,75,68,45,13,1640,855,785,215,212,201,77,1
6186,863,450,413,116,122,106,41,189,102,87,28,17,22,5,1
6187,350,200,150,45,47,23,8,212,130,82,31,20,22,9,1
6188,585,354,231,66,39,80,42,380,184,196,56,35,44,36,1
6189,538,268,270,58,72,42,25,264,122,142,33,29,13,13,1
6190,1290,597,693,182,182,119,63,715,359,356,125,96,59,36,1
6191,631,309,322,106,83,89,33,481,256,225,60,56,48,12,1
6192,120,61,59,17,8,8,5,352,212,140,37,17,61,20,1
6193,149,68,81,15,38,11,10,532,267,265,86,55,64,22,1
6194,433,221,212,59,42,47,14,520,224,296,69,64,31,29,1
6195,304,160,144,39,30,40,14,164,88,76,27,20,17,6,1
6196,3661,1791,1870,463,425,340,151,467,224,243,70,43,67,23,1
6197,416,210,206,55,54,39,20,573,316,257,78,80,21,21,1
6198,464,242,222,61,68,36,17,671,326,345,111,77,74,11,1
6199,113,66,47,11,9,6,5,188,89,99,23,15,29,9,1
6200,660,347,313,94,72,82,29,547,300,247,68,60,55,30,1
6201,352,212,140,37,17,61,20,1074,538,536,154,140,111,51,1
6202,1278,593,685,198,201,71,43,1056,432,624,159,165,73,36,1
6203,777,345,432,128,88,65,39,431,202,229,57,50,50,25,1
6204,1480,789,691,195,151,173,55,592,283,309,84,137,60,20,1
6205,483,236,247,82,60,43,18,331,169,162,40,28,22,14,1
6206,465,225,240,65,44,65,25,757,373,384,115,93,95,25,1
6207,1099,620,479,124,108,127,48,545,289,256,75,72,42,22,1
6208,219,116,103,66,7,2,1,183,76,107,34,38,14,8,1
6209,339,170,169,32,17,24,13,570,261,309,78,72,60,23,1
6210,595,339,256,64,36,54,24,270,136,134,38,31,31,4,1
6211,3144,1617,1527,367,342,278,136,335,185,150,46,34,36,13,1
6212,573,247,326,98,95,46,22,723,309,414,106,106,41,40,1
6213,267,161,106,22,25,35,20,1032,526,506,129,117,119,47,1
6214,656,358,298,67,47,64,26,391,212,179,40,45,47,10,1
6215,461,197,264,86,97,43,10,354,168,186,50,53,39,20,1
6216,478,304,174,41,37,35,11,360,201,159,38,38,34,13,1
6217,589,294,295,37,44,27,33,454,273,181,49,58,33,11,1
6218,648,307,341,101,58,76,34,766,386,380,101,81,78,31,1
6219,184,86,98,26,26,14,11,650,304,346,80,106,62,28,1
6220,148,87,61,20,13,21,11,474,274,200,59,36,86,31,1
6221,579,250,329,90,61,62,45,158,85,73,24,18,18,8,1
6222,185,107,78,20,29,10,4,432,218,214,57,55,42,11,1
6223,211,113,98,38,17,25,8,311,187,124,39,38,35,12,1
6224,274,158,116,27,27,22,18,219,124,95,22,22,23,5,1
6225,408,179,229,86,72,32,5,410,200,210,60,54,46,19,1
6226,583,322,261,73,66,45,26,551,299,252,51,62,63,17,1
6227,142,60,82,20,28,13,5,210,102,108,33,33,20,9,1
6228,518,262,256,70,52,49,27,202,102,100,29,35,6,9,1
6229,1257,647,610,156,146,145,35,583,248,335,115,111,52,16,1
6230,351,184,167,59,45,54,9,4544,2024,2520,579,628,480,403,1
6231,815,418,397,97,62,70,17,418,248,170,41,31,54,9,1
6232,740,377,363,118,94,62,29,563,271,292,72,91,34,27,1
6233,125,46,79,24,16,12,2,288,157,131,36,35,18,9,1
6234,624,204,420,166,101,32,13,163,70,93,28,21,17,6,1
6235,169,64,105,23,37,11,3,642,316,326,80,79,72,28,1
6236,1978,807,1171,323,310,129,70,202,102,100,29,35,6,9,1
6237,686,375,311,89,80,63,20,204,104,100,26,27,21,11,1
6238,496,269,227,67,55,37,19,1114,581,533,145,132,126,54,1
6239,434,201,233,58,46,38,19,390,191,199,57,49,45,25,1
6240,454,191,263,61,66,38,15,588,266,322,99,79,87,28,1
6241,410,186,224,72,57,52,22,2468,1038,1430,333,465,167,62,1
6242,536,230,306,64,88,40,12,529,264,265,59,68,41,17,1
6243,930,367,563,181,153,83,48,510,264,246,67,66,38,29,1
6244,671,318,353,83,124,46,34,235,149,86,30,21,17,5,1
6245,465,197,268,73,60,56,33,671,321,350,95,87,75,34,1
6246,552,264,288,82,64,48,20,191,99,92,25,24,18,8,1
6247,84,42,42,12,3,8,13,571,341,230,50,44,61,33,1
6248,605,281,324,111,67,40,44,1215,572,643,151,105,127,54,1
6249,465,257,208,51,61,54,23,198,80,118,35,31,14,7,1
6250,351,195,156,47,53,25,14,455,218,237,57,51,42,35,1
6251,1190,638,552,162,95,112,18,969,435,534,92,82,102,154,1
6252,1163,615,548,122,109,128,41,1663,835,828,224,213,163,63,1
6253,683,288,395,125,94,77,39,443,208,235,43,55,51,50,1
6254,276,118,158,38,40,16,10,1411,472,939,252,262,58,31,1
6255,347,181,166,27,20,12,12,1863,721,1142,262,283,139,74,1
6256,303,159,144,40,35,35,8,833,452,381,117,85,71,39,1
6257,328,156,172,44,37,44,15,1050,482,568,136,154,101,41,1
6258,982,494,488,150,117,91,45,303,159,144,40,35,35,8,1
6259,181,71,110,34,30,21,7,328,191,137,36,13,55,21,1
6260,789,376,413,101,116,66,40,860,456,404,104,95,77,27,1
6261,570,292,278,80,65,72,23,724,334,390,112,109,79,17,1
6262,632,326,306,92,71,56,19,395,222,173,48,42,21,8,1
6263,507,287,220,43,36,24,7,1214,612,602,169,173,98,35,1
6264,714,364,350,98,102,91,27,1523,709,814,204,150,128,122,1
6265,1299,517,782,209,222,93,37,641,341,300,101,91,29,22,1
6266,848,461,387,111,102,108,42,149,68,81,15,38,11,10,1
6267,480,234,246,79,77,65,23,1528,652,876,225,211,122,62,1
6268,211,114,97,32,24,19,10,724,334,390,112,109,79,17,1
6269,911,423,488,140,150,102,32,576,250,326,93,71,34,15,1
6270,593,266,327,102,84,69,24,863,470,393,82,72,92,44,1
6271,126,56,70,31,10,10,3,322,143,179,41,62,23,11,1
6272,310,142,168,42,39,24,9,264,122,142,33,29,13,13,1
6273,290,127,163,47,58,23,12,411,171,240,61,81,30,15,1
6274,303,159,144,40,35,35,8,508,295,213,42,61,53,17,1
6275,632,350,282,82,58,111,42,206,85,121,31,42,6,17,1
6276,119,67,52,15,15,7,7,1177,666,511,131,99,88,35,1
6277,714,364,350,98,102,91,27,1464,987,477,137,141,55,31,1
6278,701,368,333,90,81,39,27,304,159,145,38,40,32,3,1
6279,351,183,168,55,44,33,9,367,161,206,70,48,41,19,1
6280,350,180,170,64,46,55,12,143,79,64,16,25,7,5,1
6281,620,305,315,97,80,87,28,1265,580,685,205,188,166,53,1
6282,592,292,300,56,52,71,17,355,165,190,53,56,42,19,1
6283,497,185,312,63,92,38,28,689,343,346,119,100,86,38,1
6284,401,166,235,70,42,51,30,2813,1331,1482,320,339,261,290,1
6285,331,169,162,40,28,22,14,1464,693,771,153,136,91,86,1
6286,394,202,192,44,43,38,28,437,225,212,61,57,66,12,1
6287,540,257,283,81,63,57,24,618,290,328,82,74,69,42,1
6288,1068,539,529,161,134,132,71,189,93,96,24,28,17,12,1
6289,2414,1189,1225,277,178,170,169,1441,657,784,140,135,81,73,1
6290,800,416,384,102,105,83,22,1199,589,610,189,128,167,65,1
6291,379,203,176,55,48,45,16,839,439,400,101,86,102,43,1
6292,676,333,343,111,89,94,39,201,105,96,31,25,19,11,1
6293,605,295,310,74,66,70,36,4303,2489,1814,436,369,444,134,1
6294,465,218,247,64,51,50,42,248,120,128,43,37,20,6,1
6295,641,318,323,69,61,41,19,437,212,225,66,44,44,11,1
6296,1210,592,618,157,138,116,85,448,236,212,53,64,56,24,1
6297,432,218,214,57,55,42,11,205,104,101,28,28,35,13,1
6298,418,226,192,57,57,53,17,151,75,76,21,22,9,5,1
6299,158,71,87,23,21,17,12,1356,672,684,171,172,134,59,1
6300,815,418,397,97,62,70,17,411,194,217,57,50,32,19,1
6301,998,514,484,120,122,113,57,1834,823,1011,297,282,151,63,1
6302,1106,579,527,121,152,113,45,1047,562,485,141,127,114,41,1
6303,397,210,187,42,37,29,18,355,213,142,36,28,63,17,1
6304,365,186,179,48,47,42,13,119,57,62,18,16,17,4,1
6305,283,112,171,48,39,34,15,2923,1529,1394,308,341,287,114,1
6306,271,161,110,32,34,27,14,432,218,214,57,55,42,11,1
6307,677,361,316,81,61,42,22,1085,646,439,108,65,36,19,1
6308,123,61,62,22,16,18,6,360,174,186,59,38,46,15,1
6309,299,176,123,43,17,19,20,156,92,64,22,10,15,8,1
6310,198,80,118,35,31,14,7,217,109,108,34,32,35,7,1
6311,432,218,214,57,55,42,11,309,154,155,42,44,45,16,1
6312,462,251,211,74,53,41,18,673,317,356,101,85,76,49,1
6313,624,308,316,92,72,68,22,643,373,270,91,43,113,21,1
6314,859,345,514,129,135,60,31,221,110,111,28,32,25,11,1
6315,736,388,348,88,85,67,28,213,91,122,42,30,23,12,1
6316,468,225,243,67,69,68,19,406,200,206,58,65,57,16,1
6317,425,210,215,56,43,52,25,429,223,206,50,32,46,17,1
6318,3144,1617,1527,367,342,278,136,545,230,315,91,101,50,16,1
6319,1262,653,609,169,165,152,50,1512,737,775,238,209,156,57,1
6320,677,310,367,103,93,70,26,354,168,186,50,53,39,20,1
6321,1233,498,735,252,232,88,41,821,387,434,121,131,76,29,1
6322,290,127,163,47,58,23,12,539,269,270,60,71,41,23,1
6323,1395,627,768,172,263,141,59,229,112,117,42,23,13,10,1
6324,2490,1126,1364,352,325,219,89,335,128,207,59,43,24,23,1
6325,582,293,289,94,80,77,32,519,219,300,86,72,50,39,1
6326,246,108,138,32,44,21,10,508,248,260,71,56,50,19,1
6327,161,75,86,24,20,10,7,1893,850,1043,280,340,169,80,1
6328,672,334,338,110,93,91,41,314,108,206,45,75,34,8,1
6329,435,221,214,72,45,47,19,736,388,348,88,85,67,28,1
6330,1691,1159,532,160,109,95,46,252,124,128,49,22,19,13,1
6331,418,204,214,61,41,52,21,460,223,237,61,65,45,22,1
6332,556,279,277,83,69,71,19,553,261,292,73,79,40,26,1
6333,956,473,483,140,88,89,78,1474,756,718,175,158,169,51,1
6334,1297,697,600,160,143,146,66,1382,689,693,186,176,167,77,1
6335,452,262,190,61,45,54,19,298,167,131,47,33,40,8,1
6336,396,189,207,24,19,47,18,928,455,473,108,90,107,43,1
6337,191,85,106,24,34,19,5,966,459,507,123,145,83,39,1
6338,483,300,183,49,25,19,6,204,106,98,35,22,24,6,1
6339,101,41,60,18,19,10,5,740,313,427,101,135,40,22,1
6340,488,284,204,43,45,52,21,672,334,338,110,93,91,41,1
6341,497,185,312,63,92,38,28,595,316,279,86,60,65,40,1
6342,894,492,402,95,103,88,42,217,109,108,34,32,35,7,1
6343,1261,548,713,194,177,102,54,183,91,92,21,29,16,10,1
6344,583,322,261,73,66,45,26,236,145,91,17,19,30,18,1
6345,379,203,176,55,48,45,16,399,206,193,57,45,41,17,1
6346,364,216,148,36,20,50,30,1544,670,874,236,239,128,49,1
6347,525,274,251,82,74,60,25,470,226,244,81,53,59,39,1
6348,2472,1055,1417,416,458,235,64,416,228,188,63,25,40,20,1
6349,267,147,120,37,28,35,12,314,108,206,45,75,34,8,1
6350,863,418,445,127,114,70,31,719,364,355,104,100,58,34,1
6351,824,397,427,113,95,82,33,294,148,146,35,33,25,14,1
6352,237,112,125,19,57,25,10,240,167,73,32,12,8,21,1
6353,958,451,507,165,135,97,41,245,137,108,34,30,19,10,1
6354,522,235,287,78,67,60,50,516,298,218,62,57,49,19,1
6355,217,109,108,34,32,35,7,258,131,127,37,32,20,14,1
6356,525,281,244,69,68,65,25,927,527,400,104,123,119,43,1
6357,293,153,140,45,38,22,15,235,119,116,31,26,15,13,1
6358,526,228,298,79,74,45,21,196,99,97,28,32,17,12,1
6359,359,174,185,54,56,43,16,413,227,186,45,34,58,23,1
6360,356,142,214,55,47,29,16,191,72,119,40,41,17,8,1
6361,1149,568,581,177,133,101,30,758,362,396,115,102,35,13,1
6362,482,231,251,76,81,64,26,320,163,157,44,44,26,15,1
6363,512,261,251,79,73,60,21,481,256,225,60,56,48,12,1
6364,1430,718,712,205,172,151,64,931,475,456,111,105,93,46,1
6365,415,242,173,53,21,70,21,1037,575,462,122,150,82,32,1
6366,972,501,471,125,156,106,39,178,89,89,26,21,21,10,1
6367,1208,569,639,154,126,112,33,450,194,256,57,75,45,22,1
6368,164,88,76,27,20,17,6,243,120,123,30,24,26,13,1
6369,1331,657,674,159,137,182,58,1040,562,478,125,101,103,32,1
6370,1094,543,551,171,121,129,54,776,356,420,122,103,85,30,1
6371,923,471,452,119,117,119,41,785,412,373,114,84,95,38,1
6372,553,319,234,56,37,54,18,215,80,135,54,56,21,9,1
6373,876,473,403,110,106,73,24,482,223,259,74,67,39,12,1
6374,522,245,277,78,69,52,21,538,252,286,77,87,53,30,1
6375,667,360,307,76,92,46,27,551,298,253,63,65,45,19,1
6376,700,305,395,111,99,54,18,1162,515,647,191,143,97,35,1
6377,1202,506,696,209,198,74,44,957,346,611,205,175,61,29,1
6378,248,130,118,26,28,16,11,652,329,323,65,70,51,50,1
6379,204,119,85,28,18,27,8,239,146,93,30,22,35,9,1
6380,839,427,412,91,83,114,37,296,154,142,38,38,24,16,1
6381,619,332,287,95,77,74,38,676,295,381,94,71,65,24,1
6382,2322,1315,1007,242,257,220,38,245,142,103,29,20,21,9,1
6383,750,347,403,105,103,83,29,325,152,173,43,47,28,17,1
6384,418,205,213,69,50,29,15,487,229,258,68,82,41,24,1
6385,522,269,253,67,43,60,29,493,246,247,60,49,56,25,1
6386,1749,880,869,237,228,214,112,72,35,37,10,9,7,6,1
6387,475,235,240,77,58,43,22,614,348,266,68,49,51,16,1
6388,243,154,89,26,23,28,5,579,310,269,45,57,66,42,1
6389,213,107,106,28,41,19,5,1029,403,626,222,126,141,67,1
6390,491,232,259,80,65,54,21,623,320,303,103,85,75,15,1
6391,505,296,209,55,50,45,23,90,46,44,14,15,8,3,1
6392,517,295,222,60,55,55,19,245,122,123,21,32,18,13,1
6393,318,176,142,25,32,35,25,201,42,159,19,3,2,75,1
6394,840,411,429,122,101,79,34,719,364,355,104,100,58,34,1
6395,825,422,403,100,90,62,43,313,196,117,20,28,46,13,1
6396,528,228,300,60,119,43,28,327,172,155,38,41,41,15,1
6397,185,107,78,20,29,10,4,589,294,295,37,44,27,33,1
6398,837,444,393,128,89,87,37,443,207,236,76,68,52,28,1
6399,247,132,115,24,22,24,13,491,270,221,51,47,53,18,1
6400,501,240,261,80,62,49,42,604,282,322,76,74,69,35,1
6401,483,209,274,83,78,52,22,369,167,202,66,59,39,20,1
6402,283,142,141,35,29,32,5,921,462,459,140,126,83,55,1
6403,330,157,173,56,42,51,8,317,153,164,39,30,35,13,1
6404,778,398,380,131,85,69,24,601,290,311,92,89,55,30,1
6405,245,137,108,34,30,19,10,1246,677,569,159,154,108,52,1
6406,346,180,166,55,49,38,6,632,326,306,92,71,56,19,1
6407,446,176,270,64,79,45,24,318,165,153,53,37,36,13,1
6408,427,164,263,62,80,14,10,404,197,207,57,69,33,15,1
6409,330,143,187,63,29,52,20,769,351,418,130,127,50,31,1
6410,215,117,98,28,19,15,8,2048,855,1193,297,287,191,93,1
6411,255,130,125,44,18,22,12,739,359,380,83,95,53,38,1
6412,605,295,310,74,66,70,36,537,276,261,75,68,68,22,1
6413,458,225,233,67,61,43,33,252,146,106,38,23,21,9,1
6414,471,221,250,87,68,42,25,271,131,140,47,37,41,11,1
6415,272,141,131,45,29,36,9,430,198,232,57,46,37,19,1
6416,269,134,135,42,35,27,13,234,133,101,29,25,28,7,1
6417,532,267,265,86,55,64,22,976,496,480,128,111,121,48,1
6418,608,336,272,61,49,78,31,1464,693,771,153,136,91,86,1
6419,436,182,254,61,76,49,33,477,256,221,69,66,70,12,1
6420,215,91,124,23,39,5,5,769,329,440,116,66,55,22,1
6421,456,220,236,67,75,30,21,235,119,116,31,26,15,13,1
6422,536,237,299,116,87,42,17,928,442,486,139,118,91,43,1
6423,396,226,170,26,35,47,18,238,117,121,32,27,22,14,1
6424,294,148,146,35,33,25,14,240,167,73,32,12,8,21,1
6425,217,109,108,34,32,35,7,537,276,261,75,68,68,22,1
6426,377,184,193,50,43,33,17,225,125,100,33,32,29,12,1
6427,480,243,237,75,59,51,25,377,202,175,46,50,41,23,1
6428,871,437,434,112,113,83,49,511,247,264,75,73,43,24,1
6429,400,221,179,51,42,38,16,395,186,209,53,48,46,30,1
6430,449,242,207,47,42,39,20,1466,991,475,136,129,59,39,1
6431,536,278,258,72,63,62,20,128,62,66,13,11,17,12,1
6432,272,124,148,51,36,23,27,252,128,124,46,31,18,8,1
6433,446,246,200,64,48,54,12,461,257,204,63,49,50,29,1
6434,947,482,465,143,107,89,37,187,96,91,30,24,24,4,1
6435,2024,765,1259,283,343,137,76,240,98,142,49,42,23,17,1
6436,1100,581,519,144,149,78,42,211,114,97,32,24,19,10,1
6437,423,212,211,51,44,48,28,606,307,299,92,56,68,30,1
6438,163,70,93,28,21,17,6,410,208,202,59,58,43,26,1
6439,1907,1008,899,235,224,195,73,509,262,247,64,70,64,20,1
6440,824,365,459,121,123,88,50,913,426,487,136,109,112,43,1
6441,549,244,305,105,79,39,19,393,186,207,58,50,36,22,1
6442,670,333,337,95,79,62,21,716,354,362,102,87,77,30,1
6443,3056,1457,1599,438,389,329,168,391,204,187,47,48,38,18,1
6444,227,132,95,31,19,31,11,503,263,240,72,55,51,34,1
6445,308,164,144,47,29,33,7,707,295,412,105,105,66,30,1
6446,527,257,270,72,68,50,28,768,354,414,133,106,79,42,1
6447,119,57,62,18,16,17,4,383,204,179,61,32,54,16,1
6448,258,126,132,38,22,29,8,411,208,203,63,44,52,19,1
6449,294,148,146,35,33,25,14,118,51,67,25,13,6,7,1
6450,370,152,218,67,59,22,23,202,102,100,29,35,6,9,1
6451,683,365,318,89,69,56,25,1670,1140,530,173,120,89,53,1
6452,241,115,126,35,30,17,14,239,146,93,30,22,35,9,1
6453,521,266,255,89,61,68,13,1150,585,565,162,148,102,36,1
6454,815,418,397,97,62,70,17,837,381,456,123,109,65,25,1
6455,2016,1107,909,214,229,238,111,906,455,451,116,105,87,46,1
6456,871,482,389,113,95,109,35,543,287,256,71,66,64,23,1
6457,103,49,54,21,21,10,2,454,191,263,61,66,38,15,1
6458,461,221,240,70,64,56,32,1065,533,532,147,148,176,40,1
6459,218,108,110,28,28,22,10,596,286,310,90,89,78,37,1
6460,624,308,316,92,72,68,22,225,99,126,25,24,20,10,1
6461,673,329,344,111,95,92,41,690,333,357,107,89,89,36,1
6462,288,104,184,80,30,39,6,427,204,223,38,57,26,32,1
6463,340,166,174,39,40,36,26,75,37,38,11,9,5,8,1
6464,346,191,155,52,38,40,13,437,228,209,47,61,26,11,1
6465,421,246,175,51,27,44,19,745,379,366,86,76,92,43,1
6466,2871,1218,1653,290,374,238,414,724,650,74,44,3,32,3,1
6467,832,428,404,131,89,88,38,349,152,197,55,47,27,13,1
6468,315,150,165,52,36,22,15,219,104,115,25,31,25,11,1
6469,603,311,292,102,71,66,23,294,122,172,46,65,18,11,1
6470,322,164,158,46,44,29,7,785,374,411,56,42,38,25,1
6471,128,58,70,22,14,4,7,275,140,135,38,32,18,5,1
6472,379,197,182,52,38,53,32,371,230,141,42,21,41,21,1
6473,1272,520,752,235,242,117,54,145,72,73,36,14,16,8,1
6474,365,170,195,49,30,41,10,132,67,65,22,15,17,5,1
6475,672,334,338,110,93,91,41,348,226,122,23,20,59,25,1
6476,330,159,171,48,38,50,19,338,168,170,60,38,48,17,1
6477,595,316,279,86,60,65,40,404,239,165,48,38,38,19,1
6478,1015,457,558,110,160,49,26,1894,962,932,232,209,205,90,1
6479,609,292,317,102,96,64,21,327,182,145,43,29,35,21,1
6480,211,88,123,38,28,26,10,646,316,330,89,95,48,17,1
6481,351,166,185,48,61,24,15,454,209,245,85,78,45,9,1
6482,376,199,177,63,46,33,8,1356,576,780,229,198,107,38,1
6483,429,219,210,46,66,42,17,793,400,393,113,92,120,37,1
6484,522,235,287,78,67,60,50,456,211,245,75,68,36,25,1
6485,148,64,84,33,19,6,1,462,233,229,66,49,43,30,1
6486,498,198,300,122,70,83,16,435,208,227,68,64,53,23,1
6487,86,50,36,9,14,8,7,92,46,46,14,9,8,6,1
6488,151,60,91,24,34,15,2,853,401,452,121,118,74,38,1
6489,851,417,434,109,116,83,28,1454,780,674,182,120,135,67,1
6490,330,157,173,56,42,51,8,421,195,226,73,71,34,15,1
6491,501,218,283,86,94,63,15,202,102,100,29,35,6,9,1
6492,450,241,209,67,58,54,23,481,256,225,60,56,48,12,1
6493,442,252,190,35,52,20,4,143,65,78,32,11,11,11,1
6494,660,359,301,81,87,102,31,354,193,161,51,41,58,13,1
6495,355,165,190,53,56,42,19,350,215,135,36,21,48,14,1
6496,824,365,459,121,123,88,50,211,112,99,30,15,34,18,1
6497,400,195,205,63,67,40,18,630,345,285,89,60,41,16,1
6498,1544,670,874,236,239,128,49,377,177,200,63,53,44,16,1
6499,959,496,463,144,132,75,35,621,301,320,76,64,46,34,1
6500,250,114,136,45,42,18,8,1134,574,560,157,164,47,48,1
6501,76,31,45,8,14,3,1,351,184,167,59,45,54,9,1
6502,1113,480,633,170,173,81,34,531,260,271,97,68,47,11,1
6503,399,184,215,55,81,29,10,500,236,264,85,69,33,17,1
6504,456,220,236,67,75,30,21,245,137,108,34,30,19,10,1
6505,466,242,224,66,53,53,13,323,183,140,45,20,27,16,1
6506,120,61,59,17,8,8,5,374,227,147,44,22,54,20,1
6507,724,334,390,112,109,79,17,864,429,435,129,118,68,35,1
6508,1116,539,577,149,161,115,43,504,234,270,88,86,55,16,1
6509,304,159,145,38,40,32,3,815,418,397,97,62,70,17,1
6510,355,215,140,33,38,27,10,390,207,183,50,48,38,15,1
6511,318,176,142,25,32,35,25,313,176,137,35,27,29,16,1
6512,862,335,527,136,169,47,28,1807,933,874,248,203,173,71,1
6513,289,139,150,38,44,23,20,198,80,118,35,31,14,7,1
6514,247,110,137,34,45,23,10,743,233,510,148,142,28,17,1
6515,868,448,420,108,103,76,25,543,287,256,71,66,64,23,1
6516,864,362,502,142,150,70,19,245,111,134,31,44,20,11,1
6517,490,198,292,65,81,39,27,245,112,133,32,45,20,10,1
6518,1425,670,755,153,189,122,85,503,263,240,72,55,51,34,1
6519,1105,544,561,165,167,98,40,345,203,142,47,35,31,11,1
6520,533,254,279,81,78,52,10,635,333,302,99,75,83,28,1
6521,617,255,362,105,108,61,23,505,268,237,68,59,34,15,1
6522,854,367,487,127,113,59,59,418,213,205,54,70,38,18,1
6523,370,197,173,63,40,40,23,412,216,196,24,48,18,16,1
6524,198,98,100,30,21,21,8,508,295,213,42,61,53,17,1
6525,453,187,266,64,83,32,26,307,162,145,38,46,41,15,1
6526,439,227,212,60,55,58,8,193,99,94,31,31,16,12,1
6527,261,144,117,34,22,31,15,177,68,109,44,21,17,2,1
6528,358,170,188,54,55,20,10,1089,544,545,138,160,117,43,1
6529,501,240,261,80,62,49,42,1158,481,677,169,129,86,40,1
6530,755,349,406,131,80,68,28,246,108,138,32,44,21,10,1
6531,458,177,281,90,69,48,9,1756,697,1059,328,345,110,27,1
6532,589,300,289,78,66,72,34,928,442,486,139,118,91,43,1
6533,318,176,142,25,32,35,25,281,138,143,50,36,27,16,1
6534,1356,576,780,229,198,107,38,686,334,352,107,93,73,43,1
6535,114,66,48,13,7,3,7,360,218,142,39,26,50,18,1
6536,101,41,60,18,19,10,5,189,109,80,26,24,9,8,1
6537,272,133,139,40,35,33,8,574,273,301,101,74,68,26,1
6538,1170,510,660,142,182,115,84,304,135,169,48,36,38,26,1
6539,595,292,303,79,83,69,24,1086,603,483,147,121,95,40,1
6540,522,235,287,78,67,60,50,953,493,460,122,133,87,47,1
6541,394,202,192,44,43,38,28,901,458,443,91,129,86,21,1
6542,596,313,283,86,77,64,20,973,522,451,140,134,124,39,1
6543,1058,557,501,128,128,115,43,329,168,161,41,47,26,7,1
6544,136,72,64,22,16,7,3,487,223,264,81,68,63,15,1
6545,219,134,85,22,27,22,10,1424,650,774,152,124,95,87,1
6546,617,255,362,105,108,61,23,3911,1465,2446,610,767,240,133,1
6547,881,419,462,132,82,81,24,430,192,238,62,67,27,10,1
6548,651,323,328,90,65,64,24,697,373,324,105,83,95,38,1
6549,623,320,303,103,85,75,15,636,336,300,94,65,58,32,1
6550,360,219,141,33,26,65,22,689,343,346,119,100,86,38,1
6551,245,137,108,34,30,19,10,866,488,378,112,74,129,30,1
6552,956,403,553,147,135,99,87,1464,987,477,137,141,55,31,1
6553,1115,599,516,125,105,95,51,814,450,364,91,114,69,12,1
6554,199,106,93,29,23,26,7,551,268,283,88,78,82,30,1
6555,272,141,131,45,29,36,9,430,218,212,58,47,34,20,1
6556,1009,506,503,146,141,97,55,143,79,64,16,25,7,5,1
6557,522,235,287,78,67,60,50,376,192,184,50,50,41,16,1
6558,1822,879,943,236,227,175,97,246,108,138,32,44,21,10,1
6559,1798,844,954,277,212,142,53,834,483,351,102,83,103,22,1
6560,504,234,270,88,86,55,16,256,125,131,34,27,24,14,1
6561,93,45,48,19,15,14,3,769,329,440,116,66,55,22,1
6562,387,217,170,49,47,44,14,290,157,133,40,28,24,15,1
6563,819,411,408,108,86,90,58,1091,543,548,146,136,110,34,1
6564,335,183,152,40,26,54,23,381,206,175,37,39,29,37,1
6565,367,181,186,39,34,36,43,368,195,173,52,41,42,15,1
6566,589,296,293,99,76,64,29,369,237,132,33,16,38,18,1
6567,794,402,392,96,84,86,30,373,183,190,49,45,41,19,1
6568,616,323,293,98,71,31,15,582,293,289,94,80,77,32,1
6569,729,351,378,111,98,58,18,1863,721,1142,262,283,139,74,1
6570,396,213,183,68,44,47,18,1230,644,586,198,125,123,61,1
6571,1202,506,696,209,198,74,44,1464,693,771,153,136,91,86,1
6572,1038,527,511,118,163,120,52,216,119,97,33,27,28,7,1
6573,1025,527,498,120,122,142,40,509,341,168,35,32,52,15,1
6574,301,150,151,41,30,17,11,177,95,82,18,11,25,10,1
6575,626,345,281,62,76,66,25,921,593,328,104,86,42,23,1
6576,462,233,229,66,49,43,30,601,313,288,42,48,25,36,1
6577,1085,529,556,149,133,126,54,499,252,247,74,42,55,14,1
6578,1090,543,547,157,132,116,35,218,108,110,27,29,23,10,1
6579,433,221,212,59,42,47,14,295,143,152,38,47,22,25,1
6580,854,380,474,137,159,81,31,716,364,352,107,80,75,26,1
6581,540,209,331,134,57,96,44,246,115,131,15,29,10,32,1
6582,314,151,163,42,61,39,16,117,60,57,20,17,16,5,1
6583,838,385,453,110,137,78,28,474,274,200,59,36,86,31,1
6584,953,481,472,133,130,77,48,338,179,159,44,45,42,16,1
6585,651,331,320,93,93,51,28,168,90,78,22,19,13,4,1
6586,351,184,167,59,45,54,9,377,177,200,63,53,44,16,1
6587,454,191,263,61,66,38,15,882,432,450,115,111,68,44,1
6588,215,80,135,54,56,21,9,349,152,197,55,47,27,13,1
6589,331,152,179,34,30,35,12,624,308,316,92,72,68,22,1
6590,159,77,82,23,9,18,11,459,221,238,52,56,51,19,1
6591,655,328,327,65,54,55,35,747,371,376,87,134,54,29,1
6592,204,103,101,16,32,22,8,1017,498,519,136,107,82,52,1
6593,418,235,183,48,24,55,30,164,87,77,16,18,12,20,1
6594,298,160,138,37,30,22,12,797,499,298,63,54,106,46,1
6595,360,188,172,49,48,47,17,217,109,108,34,32,35,7,1
6596,189,88,101,31,29,18,10,149,68,81,15,38,11,10,1
6597,1941,818,1123,351,358,141,64,1009,506,503,146,141,97,55,1
6598,240,166,74,32,12,8,15,393,186,207,58,50,36,22,1
6599,211,83,128,28,35,5,11,1721,809,912,268,234,144,50,1
6600,599,341,258,76,60,94,31,461,197,264,86,97,43,10,1
6601,228,92,136,43,39,16,7,313,157,156,39,26,34,29,1
6602,1948,1039,909,242,227,200,67,240,125,115,34,32,30,8,1
6603,1150,585,565,162,148,102,36,1484,731,753,206,175,187,71,1
6604,267,147,120,40,24,25,8,358,212,146,51,36,33,9,1
6605,926,435,491,133,132,85,17,352,169,183,57,36,47,31,1
6606,491,270,221,51,47,53,18,94,58,36,10,9,7,8,1
6607,240,99,141,53,38,29,15,864,362,502,142,150,70,19,1
6608,483,258,225,70,53,54,20,215,115,100,27,28,34,16,1
6609,396,226,170,26,35,47,18,244,135,109,36,24,20,10,1
6610,275,140,135,38,32,18,5,605,263,342,73,103,54,18,1
6611,168,120,48,7,5,20,7,560,244,316,92,118,47,12,1
6612,1477,738,739,176,176,145,72,835,499,336,94,89,96,22,1
6613,673,317,356,101,85,76,49,778,367,411,90,85,64,43,1
6614,365,193,172,46,50,47,13,294,146,148,50,45,51,15,1
6615,167,79,88,22,26,16,9,92,46,46,14,9,8,6,1
6616,465,225,240,65,44,65,25,303,137,166,54,54,31,15,1
6617,271,161,110,32,34,27,14,161,96,65,8,7,16,16,1
6618,155,85,70,17,16,4,8,377,180,197,45,63,19,17,1
6619,592,275,317,100,86,57,31,118,51,67,25,13,6,7,1
6620,524,274,250,79,59,66,16,716,354,362,102,87,77,30,1
6621,574,277,297,88,77,58,36,587,326,261,70,61,67,21,1
6622,227,127,100,32,24,31,5,588,331,257,86,71,52,12,1
6623,457,242,215,39,46,53,10,239,146,93,30,22,35,9,1
6624,323,181,142,40,37,26,16,176,73,103,22,29,13,9,1
6625,196,110,86,23,15,14,16,185,83,102,30,19,21,8,1
6626,410,200,210,60,54,46,19,940,417,523,190,146,85,26,1
6627,740,313,427,101,135,40,22,1215,572,643,151,105,127,54,1
6628,870,433,437,133,121,95,25,732,366,366,108,86,74,41,1
6629,205,82,123,38,28,20,15,342,200,142,39,18,55,20,1
6630,732,355,377,108,109,79,27,261,130,131,27,41,19,16,1
6631,1273,592,681,199,164,139,39,706,320,386,111,76,75,51,1
6632,1320,599,721,177,156,104,47,1014,427,587,195,162,105,40,1
6633,211,113,98,38,17,25,8,1124,578,546,149,127,122,61,1
6634,561,292,269,88,68,64,22,845,402,443,137,126,105,47,1
6635,1706,830,876,265,209,230,63,802,423,379,111,86,98,32,1
6636,431,233,198,54,40,42,12,711,344,367,87,109,74,24,1
6637,605,352,253,69,59,54,15,272,124,148,51,36,23,27,1
6638,510,291,219,58,47,64,19,654,317,337,95,111,44,13,1
6639,465,246,219,54,47,62,19,112,54,58,12,9,7,13,1
6640,906,437,469,135,132,49,40,892,420,472,135,146,98,37,1
6641,537,276,261,75,68,68,22,217,109,108,34,30,34,5,1
6642,74,32,42,13,18,2,6,348,226,122,23,20,59,25,1
6643,424,170,254,69,56,47,28,1270,557,713,130,195,57,30,1
6644,228,118,110,32,29,36,13,1037,537,500,134,118,107,63,1
6645,928,442,486,139,118,91,43,437,228,209,47,61,26,11,1
6646,2639,1436,1203,317,307,242,77,825,363,462,97,105,72,75,1
6647,762,363,399,127,85,83,31,245,112,133,32,45,20,10,1
6648,415,189,226,69,54,50,21,1210,592,618,157,138,116,85,1
6649,370,194,176,51,57,43,17,1434,727,707,210,173,161,54,1
6650,331,170,161,47,39,41,8,272,133,139,40,35,33,8,1
6651,158,85,73,24,18,18,8,669,340,329,77,61,94,40,1
6652,837,410,427,126,130,104,33,390,160,230,69,67,25,14,1
6653,601,308,293,102,51,62,28,126,57,69,31,10,10,3,1
6654,508,251,257,74,53,51,18,754,301,453,139,95,99,45,1
6655,170,83,87,30,19,14,16,412,195,217,79,48,36,29,1
6656,359,150,209,57,75,29,12,551,298,253,63,65,45,19,1
6657,360,192,168,55,45,48,16,455,218,237,57,51,42,35,1
6658,357,147,210,48,37,21,47,67,40,27,10,8,7,6,1
6659,500,242,258,53,48,44,18,686,360,326,79,81,96,36,1
6660,780,304,476,160,173,66,23,526,210,316,129,48,56,13,1
6661,3056,1457,1599,438,389,329,168,1972,846,1126,222,330,114,68,1
6662,738,400,338,102,98,109,25,310,129,181,45,65,22,13,1
6663,205,82,123,38,28,20,15,359,173,186,55,57,44,16,1
6664,870,433,437,133,121,95,25,367,195,172,57,54,43,16,1
6665,167,89,78,16,14,18,7,1474,756,718,175,158,169,51,1
6666,268,140,128,33,39,26,9,2843,1104,1739,429,357,178,95,1
6667,1202,506,696,209,198,74,44,1186,567,619,161,156,122,49,1
6668,771,331,440,136,104,72,27,304,127,177,61,38,31,4,1
6669,1255,666,589,145,142,120,82,1822,879,943,236,227,175,97,1
6670,244,116,128,47,19,26,9,806,436,370,101,100,76,34,1
6671,1805,814,991,257,268,155,59,1270,557,713,130,195,57,30,1
6672,221,110,111,28,32,25,11,247,127,120,43,20,27,14,1
6673,412,260,152,39,24,49,23,894,420,474,136,146,93,39,1
6674,195,83,112,40,16,19,16,1019,522,497,159,138,142,40,1
6675,247,110,137,34,45,23,10,1687,770,917,282,226,181,79,1
6676,624,308,316,92,72,68,22,508,295,213,42,61,53,17,1
6677,703,354,349,84,81,40,25,519,300,219,47,32,75,21,1
6678,354,172,182,49,56,14,11,2035,1087,948,163,129,96,73,1
6679,277,124,153,44,40,35,18,530,183,347,121,98,29,13,1
6680,377,184,193,56,53,44,14,281,166,115,34,17,36,16,1
6681,392,156,236,40,91,28,16,226,90,136,43,43,26,7,1
6682,247,110,137,34,45,23,10,496,247,249,82,69,47,14,1
6683,307,162,145,38,46,41,15,339,150,189,55,60,34,12,1
6684,1257,662,595,176,142,106,42,217,109,108,34,32,35,7,1
6685,1462,740,722,212,204,175,73,3312,1761,1551,403,345,309,127,1
6686,209,124,85,23,11,20,13,589,294,295,37,44,27,33,1
6687,349,186,163,43,45,51,12,278,148,130,36,29,25,16,1
6688,527,262,265,62,73,39,49,3014,1575,1439,349,344,289,135,1
6689,255,134,121,36,40,29,13,240,167,73,32,12,8,21,1
6690,208,101,107,38,28,24,7,914,453,461,112,115,79,29,1
6691,470,289,181,58,47,45,25,339,177,162,40,36,51,24,1
6692,765,295,470,200,142,84,27,391,208,183,65,49,57,17,1
6693,564,313,251,74,62,61,22,582,293,289,94,80,77,32,1
6694,360,219,141,33,26,65,22,94,48,46,16,7,8,6,1
6695,604,275,329,95,69,52,25,205,104,101,28,28,35,13,1
6696,593,291,302,81,85,56,20,575,218,357,135,58,89,41,1
6697,2413,1178,1235,229,243,289,146,375,226,149,39,38,19,14,1
6698,428,226,202,52,60,75,20,1158,481,677,169,129,86,40,1
6699,700,265,435,134,106,16,3,345,203,142,47,35,31,11,1
6700,1149,568,581,177,133,101,30,246,113,133,33,45,22,10,1
6701,752,381,371,96,77,80,44,728,369,359,79,93,97,40,1
6702,190,74,116,34,29,11,11,107,36,71,27,15,0,1,1
6703,364,185,179,58,53,48,15,362,156,206,74,42,36,22,1
6704,195,100,95,27,20,17,11,235,119,116,31,26,15,13,1
6705,372,187,185,55,36,45,21,375,202,173,46,49,41,23,1
6706,328,184,144,47,24,23,9,217,115,102,40,24,26,6,1
6707,496,256,240,78,67,75,13,326,153,173,63,48,25,8,1
6708,578,278,300,101,88,67,31,391,223,168,35,26,47,31,1
6709,1441,657,784,140,135,81,73,339,170,169,32,17,24,13,1
6710,868,448,420,108,103,76,25,368,170,198,59,64,29,13,1
6711,391,208,183,65,49,57,17,316,161,155,46,50,39,16,1
6712,316,157,159,45,38,22,19,443,226,217,67,34,53,10,1
6713,759,365,394,134,108,85,35,1140,586,554,130,146,117,49,1
6714,636,320,316,79,61,67,31,427,218,209,61,53,45,26,1
6715,1193,551,642,202,182,100,61,467,224,243,70,43,67,23,1
6716,385,179,206,58,56,38,19,393,186,207,58,50,36,22,1
6717,1826,840,986,285,310,175,78,339,170,169,32,17,24,13,1
6718,700,335,365,83,84,95,33,2477,1186,1291,256,271,249,90,1
6719,558,286,272,76,67,45,30,770,355,415,103,142,75,42,1
6720,173,110,63,35,6,9,8,209,78,131,33,42,11,7,1
6721,177,68,109,44,21,17,2,212,102,110,25,24,17,10,1
6722,263,146,117,30,26,25,5,318,176,142,25,32,35,25,1
6723,54,26,28,11,4,3,3,350,200,150,45,47,23,8,1
6724,218,127,91,27,23,23,10,241,115,126,35,30,17,14,1
6725,297,158,139,47,37,37,9,466,186,280,71,84,30,11,1
6726,1599,806,793,213,237,100,45,156,72,84,27,24,20,7,1
6727,633,303,330,95,91,51,13,318,164,154,52,43,34,10,1
6728,205,104,101,28,28,35,13,172,74,98,32,30,11,7,1
6729,976,496,480,128,111,121,48,2302,1030,1272,319,296,220,111,1
6730,639,368,271,72,51,38,38,526,268,258,54,37,55,12,1
6731,331,165,166,52,34,48,22,100,61,39,13,12,10,4,1
6732,784,353,431,56,47,26,18,785,374,411,56,42,38,25,1
6733,904,443,461,118,89,124,30,450,241,209,67,58,54,23,1
6734,348,166,182,65,33,46,20,246,128,118,39,34,22,7,1
6735,404,190,214,55,55,35,27,1014,490,524,177,137,94,38,1
6736,1220,481,739,252,271,65,30,144,63,81,28,32,11,5,1
6737,883,470,413,112,99,108,34,894,479,415,117,93,119,38,1
6738,956,405,551,170,171,64,35,261,130,131,27,41,19,16,1
6739,512,261,251,79,73,60,21,223,132,91,18,16,27,17,1
6740,656,358,298,67,47,64,26,588,331,257,86,71,52,12,1
6741,3801,1837,1964,510,442,418,170,730,442,288,104,88,42,68,1
6742,515,337,178,45,38,64,34,632,285,347,102,78,43,29,1
6743,512,261,251,79,73,60,21,143,79,64,16,25,7,5,1
6744,149,77,72,19,15,18,9,180,103,77,22,19,29,8,1
6745,234,93,141,42,26,17,15,288,158,130,59,23,21,10,1
6746,2843,1104,1739,429,357,178,95,433,221,212,59,42,47,14,1
6747,237,122,115,30,26,14,6,482,231,251,76,81,64,26,1
6748,288,138,150,82,22,25,5,947,482,465,143,107,89,37,1
6749,242,112,130,39,41,21,13,522,245,277,78,69,52,21,1
6750,2881,1254,1627,442,386,273,102,468,233,235,65,61,49,34,1
6751,175,90,85,28,21,19,7,155,115,40,8,7,12,8,1
6752,456,228,228,49,70,32,19,430,192,238,62,67,27,10,1
6753,417,217,200,56,39,62,17,724,650,74,44,3,32,3,1
6754,149,77,72,19,15,18,9,1863,721,1142,262,283,139,74,1
6755,476,270,206,62,45,46,30,780,359,421,160,78,169,16,1
6756,461,287,174,56,27,82,25,365,191,174,61,32,31,30,1
6757,270,130,140,48,44,37,12,1447,751,696,161,143,131,46,1
6758,154,75,79,28,23,16,6,465,218,247,64,51,50,42,1
6759,216,104,112,27,18,35,20,113,66,47,11,9,6,5,1
6760,1035,499,536,150,164,78,24,594,274,320,89,63,66,28,1
6761,247,135,112,38,18,29,13,178,80,98,34,13,16,11,1
6762,219,134,85,22,27,22,10,1464,693,771,153,136,91,86,1
6763,667,360,307,76,92,46,27,189,109,80,26,24,9,8,1
6764,933,493,440,140,108,124,32,593,295,298,70,85,48,13,1
6765,502,299,203,57,52,32,11,377,202,175,46,50,41,22,1
6766,1066,587,479,127,108,118,48,220,115,105,31,26,22,18,1
6767,928,442,486,139,118,91,43,1505,681,824,201,204,73,32,1
6768,919,376,543,129,122,55,30,229,105,124,36,33,12,4,1
6769,871,437,434,112,113,83,49,953,481,472,133,130,77,48,1
6770,469,247,222,70,58,82,13,1487,996,491,147,141,50,35,1
6771,709,294,415,132,123,76,23,1710,650,1060,338,287,185,46,1
6772,486,217,269,110,62,23,10,215,80,135,54,56,21,9,1
6773,689,343,346,119,100,86,38,187,96,91,30,24,24,4,1
6774,386,189,197,54,57,39,16,300,144,156,45,34,32,10,1
6775,359,163,196,47,78,47,9,217,109,108,34,32,35,7,1
6776,5938,2573,3365,858,958,396,195,1304,679,625,153,158,131,35,1
6777,684,288,396,107,90,54,42,2524,1232,1292,398,317,186,61,1
6778,577,342,235,63,57,23,37,717,381,336,118,103,85,29,1
6779,673,318,355,61,71,40,31,756,348,408,101,103,60,40,1
6780,392,156,236,40,91,28,16,559,239,320,57,73,48,28,1
6781,364,216,148,36,20,50,30,354,166,188,53,55,40,19,1
6782,89,42,47,16,12,15,6,1265,690,575,169,177,129,59,1
6783,964,408,556,131,153,76,55,470,226,244,81,53,59,39,1
6784,350,200,150,45,47,23,8,211,126,85,21,20,28,7,1
6785,498,278,220,55,42,63,26,529,305,224,59,55,75,27,1
6786,770,374,396,95,91,79,41,1089,544,545,138,160,117,43,1
6787,95,44,51,14,13,7,4,702,298,404,134,111,48,18,1
6788,424,197,227,67,62,43,17,426,228,198,62,42,47,22,1
6789,672,334,338,110,93,91,41,365,186,179,48,47,42,13,1
6790,799,377,422,98,95,80,70,2639,1436,1203,317,307,242,77,1
6791,462,251,211,74,53,41,18,147,81,66,18,18,18,4,1
6792,93,45,48,19,15,14,3,140,86,54,17,6,20,7,1
6793,756,265,491,129,127,51,17,530,259,271,83,50,54,41,1
6794,232,111,121,23,29,17,9,769,329,440,116,66,55,22,1
6795,240,166,74,32,12,8,15,769,329,440,116,66,55,22,1
6796,1194,543,651,190,197,65,43,1257,525,732,216,210,79,52,1
6797,870,415,455,112,103,93,51,407,230,177,53,42,34,20,1
6798,164,88,76,27,20,17,6,495,233,262,64,39,49,32,1
6799,883,403,480,140,119,85,38,191,98,93,26,18,19,9,1
6800,396,240,156,62,41,43,11,700,343,357,110,83,81,47,1
6801,751,312,439,131,115,78,48,202,102,100,29,35,6,9,1
6802,204,104,100,26,27,21,11,1749,880,869,237,228,214,112,1
6803,580,248,332,106,94,43,25,377,202,175,46,50,41,23,1
6804,2442,1193,1249,278,183,170,145,551,298,253,63,65,45,19,1
6805,346,193,153,64,27,41,14,305,164,141,43,23,47,18,1
6806,185,115,70,19,17,26,6,193,99,94,31,31,16,12,1
6807,852,472,380,99,79,70,27,377,184,193,50,43,33,17,1
6808,351,184,167,59,45,54,9,657,335,322,92,65,64,29,1
6809,427,218,209,61,53,45,26,2468,1038,1430,333,465,167,62,1
6810,601,313,288,42,48,25,36,283,142,141,33,39,20,7,1
6811,1336,828,508,166,121,152,48,2839,1413,1426,384,301,308,145,1
6812,1358,659,699,129,178,134,63,3396,1499,1897,325,572,309,90,1
6813,860,378,482,101,123,82,74,654,317,337,95,111,44,13,1
6814,168,76,92,26,21,19,4,740,385,355,114,97,91,27,1
6815,396,226,170,26,35,47,18,1474,756,718,175,158,169,51,1
6816,808,484,324,80,63,76,24,201,42,159,19,3,2,75,1
6817,339,177,162,40,36,51,24,1132,646,486,99,102,71,41,1
6818,832,428,404,131,89,88,38,631,315,316,64,57,49,15,1
6819,325,188,137,36,26,22,20,240,132,108,16,13,30,12,1
6820,312,172,140,41,40,21,8,1430,718,712,205,172,151,64,1
6821,1719,754,965,277,258,158,80,647,324,323,101,80,76,43,1
6822,249,90,159,29,89,12,4,536,266,270,58,73,40,25,1
6823,204,104,100,26,27,21,11,841,329,512,137,163,35,26,1
6824,527,262,265,62,73,39,49,694,360,334,90,88,77,32,1
6825,1272,520,752,235,242,117,54,297,148,149,64,35,37,15,1
6826,341,190,151,50,41,23,15,212,106,106,35,19,15,9,1
6827,2033,877,1156,359,333,106,44,584,307,277,54,63,53,10,1
6828,1905,975,930,281,233,189,67,1140,495,645,129,95,128,159,1
6829,770,390,380,104,76,78,32,231,126,105,37,26,29,6,1
6830,895,437,458,150,156,60,30,425,210,215,56,43,52,25,1
6831,740,313,427,101,135,40,22,662,312,350,103,104,59,20,1
6832,727,346,381,106,100,75,41,191,98,93,26,18,19,9,1
6833,480,234,246,79,77,65,23,815,418,397,97,62,70,17,1
6834,885,424,461,143,114,92,32,191,85,106,24,34,19,5,1
6835,285,165,120,31,29,17,9,233,120,113,38,32,20,15,1
6836,394,202,192,44,43,38,28,854,380,474,137,159,81,31,1
6837,2556,1169,1387,248,291,227,275,500,244,256,66,57,52,27,1
6838,1354,537,817,245,247,117,57,193,96,97,32,31,16,11,1
6839,576,250,326,93,71,34,15,1041,496,545,179,167,97,35,1
6840,881,383,498,142,148,77,24,902,495,407,116,97,111,37,1
6841,501,285,216,52,55,62,25,709,373,336,73,72,78,24,1
6842,162,88,74,18,20,25,10,446,246,200,46,32,53,25,1
6843,592,291,301,92,93,71,31,416,210,206,55,54,39,20,1
6844,336,192,144,30,36,40,14,903,437,466,117,112,108,32,1
6845,103,56,47,27,7,8,2,140,71,69,33,11,14,2,1
6846,390,191,199,66,49,43,12,825,427,398,79,95,81,48,1
6847,621,273,348,104,102,48,19,769,329,440,116,66,55,22,1
6848,391,208,183,65,49,57,17,306,128,178,49,59,17,9,1
6849,529,274,255,57,62,38,14,649,304,345,99,80,67,40,1
6850,146,71,75,20,17,8,7,989,513,476,125,106,92,60,1
6851,391,208,183,65,49,57,17,127,49,78,27,20,6,5,1
6852,524,237,287,87,75,54,26,425,210,215,56,43,52,25,1
6853,456,228,228,49,70,32,19,1978,807,1171,323,310,129,70,1
6854,514,248,266,105,68,38,20,286,148,138,29,51,25,6,1
6855,380,187,193,38,51,30,18,150,60,90,27,16,6,3,1
6856,928,442,486,139,118,91,43,497,185,312,63,92,38,28,1
6857,64,42,22,9,1,9,8,839,427,412,91,83,114,37,1
6858,896,407,489,97,152,70,22,907,530,377,61,82,63,30,1
6859,221,110,111,28,32,25,11,690,327,363,115,91,54,31,1
6860,478,223,255,80,81,41,24,551,237,314,95,79,54,17,1
6861,381,184,197,40,33,33,21,2489,1251,1238,288,234,283,178,1
6862,502,240,262,78,61,54,32,840,446,394,113,101,111,42,1
6863,162,67,95,32,17,15,11,538,300,238,45,67,66,23,1
6864,229,111,118,33,26,13,13,465,225,240,65,44,65,25,1
6865,218,108,110,28,28,22,10,393,186,207,58,50,36,22,1
6866,412,195,217,79,48,36,29,1338,633,705,199,151,144,65,1
6867,724,353,371,94,95,71,31,729,391,338,80,64,71,34,1
6868,624,204,420,166,101,32,13,501,218,283,86,94,63,15,1
6869,572,309,263,64,55,47,29,845,402,443,137,126,105,47,1
6870,656,358,298,67,47,64,26,429,219,210,46,66,42,17,1
6871,635,326,309,70,61,77,30,1338,756,582,155,105,104,44,1
6872,463,225,238,76,36,59,26,393,186,207,58,50,36,22,1
6873,301,157,144,31,28,34,9,2442,1193,1249,278,183,170,145,1
6874,420,218,202,47,49,52,15,1132,553,579,172,143,150,57,1
6875,576,250,326,93,71,34,15,205,104,101,28,28,35,13,1
6876,295,122,173,52,42,22,10,1162,548,614,191,166,142,38,1
6877,450,243,207,56,51,71,18,522,245,277,78,69,52,21,1
6878,822,402,420,125,107,82,26,481,256,225,60,56,48,12,1
6879,351,184,167,59,45,54,9,573,316,257,78,80,21,21,1
6880,2701,1334,1367,380,349,299,139,759,391,368,103,82,101,45,1
6881,443,208,235,43,55,51,50,309,106,203,66,49,25,10,1
6882,333,167,166,45,30,34,14,415,209,206,60,67,39,18,1
6883,870,436,434,131,114,72,25,595,292,303,79,83,69,24,1
6884,771,321,450,151,135,43,15,3144,1617,1527,367,342,278,136,1
6885,245,122,123,21,32,18,13,317,153,164,39,30,35,13,1
6886,95,44,51,14,13,7,4,543,293,250,77,67,40,25,1
6887,502,240,262,78,61,54,32,128,54,74,30,13,8,7,1
6888,170,83,87,23,32,17,9,521,265,256,69,69,61,26,1
6889,792,399,393,96,103,85,37,779,370,409,111,105,73,37,1
6890,400,174,226,67,50,28,14,452,256,196,32,44,27,11,1
6891,4391,2256,2135,494,411,423,231,540,248,292,77,62,61,33,1
6892,585,312,273,57,64,77,25,135,73,62,15,16,15,8,1
6893,241,115,126,35,30,17,14,246,108,138,32,44,21,10,1
6894,365,173,192,47,47,29,14,218,127,91,27,23,23,10,1
6895,201,78,123,42,47,19,8,452,239,213,62,46,38,22,1
6896,1009,506,503,146,141,97,55,782,421,361,101,97,82,20,1
6897,430,192,238,62,67,27,10,293,142,151,49,40,42,17,1
6898,429,219,210,46,66,42,17,673,317,356,101,85,76,49,1
6899,245,112,133,32,45,20,10,648,307,341,101,58,76,34,1
6900,444,255,189,60,46,54,16,677,300,377,85,79,61,40,1
6901,498,263,235,59,63,36,10,508,267,241,57,49,40,13,1
6902,514,226,288,71,66,63,32,928,442,486,139,118,91,43,1
6903,740,385,355,114,97,91,27,90,41,49,26,14,0,1,1
6904,685,315,370,108,99,36,9,989,439,550,142,121,75,29,1
6905,802,449,353,102,87,82,29,208,122,86,27,13,23,7,1
6906,1453,611,842,208,192,128,79,936,451,485,111,97,92,41,1
6907,2542,1268,1274,303,318,128,104,668,338,330,85,95,68,18,1
6908,619,290,329,97,79,62,19,140,67,73,13,16,18,8,1
6909,317,156,161,49,51,18,10,200,99,101,31,24,26,6,1
6910,395,204,191,51,48,54,20,535,301,234,66,61,53,21,1
6911,1073,539,534,153,134,136,51,491,283,208,55,61,40,13,1
6912,263,159,104,30,27,31,11,255,134,121,36,40,29,13,1
6913,665,341,324,92,88,59,27,107,56,51,19,16,13,5,1
6914,781,418,363,92,90,64,41,1324,609,715,149,119,97,56,1
6915,727,294,433,143,118,69,50,1970,978,992,245,206,198,80,1
6916,586,270,316,83,80,59,21,446,196,250,73,62,62,19,1
6917,340,162,178,40,39,35,22,1123,554,569,142,130,85,36,1
6918,276,143,133,34,38,20,15,293,153,140,45,38,22,15,1
6919,201,108,93,36,21,17,4,254,136,118,42,36,28,8,1
6920,429,219,210,46,66,42,17,256,141,115,32,22,32,8,1
6921,767,392,375,113,112,83,13,1584,831,753,197,161,142,83,1
6922,538,252,286,77,87,53,30,2045,985,1060,359,339,199,74,1
6923,604,255,349,100,72,55,26,251,129,122,33,22,13,11,1
6924,514,254,260,55,57,56,19,2440,1061,1379,377,326,172,62,1
6925,197,99,98,35,27,14,6,433,229,204,60,59,53,24,1
6926,561,292,269,88,68,64,22,217,109,108,34,32,35,7,1
6927,216,119,97,33,27,28,7,503,263,240,72,55,51,34,1
6928,133,66,67,21,24,9,2,241,124,117,30,35,24,8,1
6929,1861,896,965,265,187,156,70,1484,731,753,206,175,187,71,1
6930,125,52,73,23,23,6,4,769,329,440,116,66,55,22,1
6931,136,72,64,22,16,7,3,437,225,212,61,57,66,12,1
6932,184,83,101,25,21,16,24,769,362,407,99,88,66,67,1
6933,922,491,431,112,92,97,52,451,239,212,53,64,56,22,1
6934,1849,931,918,245,220,158,90,339,170,169,32,17,24,13,1
6935,323,198,125,28,25,34,15,354,169,185,54,54,41,19,1
6936,334,161,173,55,42,38,16,151,79,72,15,12,14,8,1
6937,504,237,267,62,66,48,17,207,108,99,25,15,27,16,1
6938,1344,728,616,152,150,96,35,211,114,97,32,24,19,10,1
6939,445,228,217,47,62,53,26,451,222,229,58,55,51,17,1
6940,422,256,166,37,21,47,23,165,78,87,23,21,17,8,1
6941,656,358,298,67,47,64,26,331,145,186,40,56,16,9,1
6942,771,321,450,151,135,43,15,467,250,217,64,49,63,39,1
6943,126,57,69,31,10,10,3,111,29,82,10,54,0,1,1
6944,437,230,207,41,55,27,13,414,194,220,76,66,49,16,1
6945,815,382,433,97,50,88,31,480,252,228,55,37,49,20,1
6946,333,192,141,50,48,28,10,1049,585,464,107,108,120,28,1
6947,557,240,317,97,74,68,37,595,284,311,69,71,35,49,1
6948,832,428,404,131,89,88,38,295,143,152,38,47,22,25,1
6949,515,250,265,67,60,58,29,254,117,137,33,35,38,6,1
6950,309,163,146,56,38,36,11,2948,1454,1494,327,456,140,81,1
6951,1106,579,527,121,152,113,45,1210,592,618,157,138,116,85,1
6952,2024,765,1259,283,343,137,76,647,282,365,104,90,53,27,1
6953,195,86,109,31,37,19,5,815,478,337,104,80,103,27,1
6954,156,88,68,29,14,12,11,2472,1055,1417,416,458,235,64,1
6955,508,267,241,43,35,25,17,654,344,310,80,69,57,15,1
6956,638,300,338,83,53,81,49,427,186,241,55,52,42,23,1
6957,1477,738,739,176,176,145,72,921,455,466,144,127,108,39,1
6958,622,309,313,75,81,76,29,619,332,287,95,77,74,38,1
6959,624,204,420,166,101,32,13,353,196,157,51,39,49,8,1
6960,312,172,140,41,40,21,8,416,201,215,54,52,39,25,1
6961,1154,540,614,195,160,138,66,624,308,316,92,72,68,22,1
6962,156,72,84,27,24,20,7,415,219,196,53,55,57,20,1
6963,390,191,199,66,49,43,12,348,187,161,50,35,44,9,1
6964,183,96,87,20,28,17,10,405,189,216,53,60,39,14,1
6965,433,222,211,68,58,42,23,765,351,414,118,102,65,32,1
6966,552,285,267,74,51,69,24,128,54,74,30,13,8,7,1
6967,183,89,94,27,24,20,8,463,244,219,54,58,47,21,1
6968,525,245,280,59,72,47,21,168,120,48,7,5,20,7,1
6969,947,506,441,105,126,75,14,467,250,217,59,52,41,19,1
6970,933,536,397,96,90,71,41,551,298,253,63,65,45,19,1
6971,459,229,230,78,65,59,26,307,150,157,44,23,30,13,1
6972,277,122,155,33,33,25,24,825,427,398,79,95,81,48,1
6973,271,133,138,45,30,24,10,303,151,152,45,37,21,14,1
6974,476,235,241,62,57,34,22,575,290,285,67,70,28,9,1
6975,400,187,213,57,46,51,16,745,366,379,110,93,79,45,1
6976,467,226,241,55,48,54,23,413,206,207,38,55,19,10,1
6977,476,270,206,62,45,46,30,280,118,162,35,32,41,37,1
6978,591,286,305,80,74,68,17,2209,1117,1092,287,282,231,96,1
6979,200,89,111,26,25,17,7,4544,2024,2520,579,628,480,403,1
6980,1242,613,629,174,113,114,53,822,402,420,125,107,82,26,1
6981,624,308,316,92,72,68,22,509,262,247,64,70,64,20,1
6982,740,385,355,114,97,91,27,136,65,71,33,11,9,6,1
6983,574,295,279,78,65,61,22,419,175,244,71,73,23,23,1
6984,279,106,173,48,35,41,39,719,364,355,104,100,58,34,1
6985,1545,828,717,186,149,176,58,583,248,335,115,111,52,16,1
6986,1152,459,693,138,343,75,33,294,122,172,46,65,18,11,1
6987,639,368,271,72,51,38,38,731,383,348,102,84,68,30,1
6988,419,175,244,71,73,23,23,655,269,386,128,129,49,21,1
6989,433,221,212,59,42,47,14,205,77,128,31,45,12,11,1
6990,1269,550,719,188,162,102,50,247,110,137,34,45,23,10,1
6991,501,240,261,80,62,49,42,775,407,368,122,100,97,32,1
6992,551,286,265,79,71,45,24,788,420,368,93,89,98,23,1
6993,1242,613,629,174,113,114,53,1271,599,672,194,175,118,47,1
6994,1377,579,798,179,169,139,99,684,288,396,107,90,54,42,1
6995,430,192,238,62,67,27,10,202,102,100,29,35,6,9,1
6996,646,316,330,89,95,48,17,928,442,486,139,118,91,43,1
6997,493,208,285,75,77,70,40,437,225,212,61,57,66,12,1
6998,103,44,59,16,17,9,5,358,212,146,51,36,33,9,1
6999,269,165,104,24,19,27,7,443,208,235,43,55,51,50,1
7000,235,104,131,29,35,26,10,839,427,412,91,83,114,37,1
7001,1336,828,508,166,121,152,48,641,324,317,88,92,49,14,1
7002,217,98,119,38,35,18,9,778,367,411,90,85,64,43,1
7003,344,181,163,61,37,40,14,165,77,88,28,27,19,10,1
7004,733,438,295,95,79,67,32,440,246,194,62,49,41,16,1
7005,372,189,183,60,44,41,18,424,198,226,57,46,41,19,1
7006,597,282,315,81,64,75,43,1744,920,824,225,190,178,57,1
7007,762,363,399,127,85,83,31,393,210,183,55,50,34,19,1
7008,333,167,166,45,30,34,14,983,487,496,126,115,104,52,1
7009,306,167,139,42,51,23,8,577,288,289,85,56,40,20,1
7010,685,301,384,98,68,70,86,513,260,253,71,50,58,23,1
7011,979,535,444,123,99,79,34,1647,794,853,222,218,151,65,1
7012,672,334,338,110,93,91,41,357,169,188,61,53,32,15,1
7013,466,186,280,71,84,30,11,269,134,135,42,35,27,13,1
7014,482,224,258,71,62,52,39,335,185,150,46,34,36,13,1
7015,672,334,338,110,93,91,41,681,337,344,108,92,71,34,1
7016,621,273,348,104,102,48,19,392,115,277,117,75,28,17,1
7017,684,311,373,109,99,66,16,924,441,483,131,115,90,38,1
7018,589,294,295,37,44,27,33,323,198,125,28,25,34,15,1
7019,868,448,420,108,103,76,25,665,297,368,111,107,34,12,1
7020,477,239,238,63,58,45,16,475,243,232,67,54,39,15,1
7021,443,248,195,67,54,40,15,450,229,221,49,63,54,27,1
7022,686,375,311,89,80,63,20,144,62,82,29,8,19,17,1
7023,313,161,152,33,32,54,15,710,357,353,99,79,72,39,1
7024,1207,593,614,151,148,131,95,217,109,108,34,32,35,7,1
7025,466,242,224,66,53,53,13,254,115,139,41,31,28,7,1
7026,748,361,387,124,86,72,17,425,210,215,56,43,52,25,1
7027,1412,603,809,184,195,112,45,582,273,309,85,67,34,19,1
7028,380,175,205,57,64,28,11,426,228,198,62,42,47,22,1
7029,509,245,264,85,71,56,22,261,130,131,27,41,19,16,1
7030,215,105,110,26,22,19,9,709,310,399,95,103,61,30,1
7031,868,448,420,108,103,76,25,148,89,59,14,15,15,14,1
7032,3926,1976,1950,509,420,258,98,957,346,611,205,175,61,29,1
7033,326,176,150,35,22,29,11,215,80,135,54,56,21,9,1
7034,783,348,435,150,109,62,21,331,169,162,40,28,22,14,1
7035,334,171,163,48,42,32,18,522,235,287,78,67,60,50,1
7036,622,309,313,75,81,76,29,165,87,78,24,19,22,9,1
7037,815,382,433,97,50,88,31,497,185,312,63,92,38,28,1
7038,1037,461,576,146,163,75,44,1248,584,664,184,164,155,67,1
7039,158,85,73,24,18,18,8,492,317,175,42,31,63,23,1
7040,2063,1024,1039,175,117,80,97,518,241,277,87,53,58,30,1
7041,787,394,393,113,98,52,19,748,341,407,121,87,96,52,1
7042,1190,638,552,162,95,112,18,913,412,501,131,100,117,83,1
7043,790,352,438,132,87,91,60,712,380,332,69,74,57,30,1
7044,808,366,442,130,133,66,31,603,311,292,102,71,66,23,1
7045,480,234,246,79,77,65,23,552,285,267,74,51,69,24,1
7046,1290,597,693,182,182,119,63,564,264,300,79,84,65,26,1
7047,375,202,173,46,49,41,23,377,202,175,46,50,41,22,1
7048,146,71,75,20,17,8,7,1287,561,726,185,223,144,51,1
7049,400,191,209,51,60,30,9,1978,807,1171,323,310,129,70,1
7050,690,327,363,115,91,54,31,207,99,108,34,27,22,9,1
7051,556,269,287,86,66,62,22,705,396,309,87,48,53,17,1
7052,346,183,163,51,38,23,6,467,261,206,54,49,48,24,1
7053,740,404,336,113,77,87,34,299,140,159,27,59,20,18,1
7054,497,227,270,70,63,66,30,229,105,124,36,33,12,4,1
7055,961,463,498,139,156,62,34,342,178,164,33,38,35,15,1
7056,277,124,153,44,40,35,18,901,458,443,91,129,86,21,1
7057,622,331,291,69,74,45,21,703,356,347,96,97,38,22,1
7058,379,203,176,55,48,45,16,401,204,197,49,33,29,17,1
7059,636,284,352,108,101,40,23,92,40,52,14,23,13,7,1
7060,131,66,65,21,14,23,7,301,150,151,41,30,17,11,1
7061,1102,511,591,171,179,148,52,393,186,207,58,50,36,22,1
7062,483,274,209,54,39,45,13,758,362,396,115,102,35,13,1
7063,101,41,60,18,19,10,5,455,218,237,57,51,42,35,1
7064,719,364,355,104,100,58,34,821,387,434,121,131,76,29,1
7065,987,515,472,107,110,106,61,218,121,97,29,26,21,6,1
7066,2089,917,1172,285,306,83,39,754,318,436,114,106,58,28,1
7067,409,200,209,69,56,44,13,537,315,222,55,46,69,39,1
7068,624,308,316,92,72,68,22,356,208,148,42,26,57,15,1
7069,479,239,240,54,75,46,18,636,336,300,94,65,58,32,1
7070,358,170,188,54,55,20,10,413,227,186,45,34,58,23,1
7071,246,108,138,32,44,21,10,1367,690,677,172,175,154,83,1
7072,317,153,164,34,52,30,14,776,356,420,122,103,85,30,1
7073,505,247,258,72,71,60,27,462,233,229,66,49,43,30,1
7074,673,317,356,101,85,76,49,513,246,267,71,66,60,35,1
7075,254,166,88,25,21,22,5,416,201,215,54,52,39,25,1
7076,355,214,141,43,29,63,13,1154,540,614,195,160,138,66,1
7077,305,155,150,45,36,35,11,1129,589,540,134,122,108,46,1
7078,282,152,130,35,27,13,21,412,195,217,79,48,36,29,1
7079,932,471,461,137,86,84,32,872,473,399,124,100,93,27,1
7080,2045,985,1060,359,339,199,74,770,356,414,123,102,66,25,1
7081,952,464,488,143,135,72,21,211,138,73,14,11,22,17,1
7082,761,346,415,114,113,89,35,315,150,165,49,59,23,15,1
7083,1150,585,565,162,148,102,36,1997,972,1025,262,209,239,52,1
7084,984,509,475,114,109,106,56,346,186,160,48,32,35,14,1
7085,247,110,137,34,45,23,10,1210,494,716,205,174,107,41,1
7086,685,301,384,98,68,70,86,408,197,211,74,44,53,16,1
7087,247,110,137,34,45,23,10,1242,613,629,174,113,114,53,1
7088,350,180,170,64,46,55,12,178,100,78,23,22,30,6,1
7089,480,234,246,79,77,65,23,514,278,236,70,62,46,22,1
7090,379,184,195,51,61,49,8,189,90,99,26,29,17,11,1
7091,466,242,224,66,53,53,13,2718,1148,1570,384,286,195,88,1
7092,628,341,287,77,59,55,31,551,298,253,63,65,45,19,1
7093,947,482,465,143,107,89,37,522,235,287,78,67,60,50,1
7094,425,210,215,56,43,52,25,2556,1169,1387,248,291,227,275,1
7095,175,88,87,29,29,23,6,168,67,101,37,17,13,13,1
7096,595,316,279,86,60,65,40,298,161,137,47,29,25,15,1
7097,464,242,222,61,68,36,17,915,336,579,185,199,56,29,1
7098,282,135,147,36,49,25,10,245,142,103,29,20,21,9,1
7099,1133,491,642,192,170,61,29,513,246,267,71,66,60,35,1
7100,694,360,334,90,88,77,32,652,323,329,99,90,65,20,1
7101,462,232,230,78,54,42,23,1374,679,695,191,193,154,48,1
7102,1009,506,503,146,141,97,55,1154,540,614,195,160,138,66,1
7103,724,334,390,112,109,79,17,631,309,322,106,83,89,33,1
7104,2416,1280,1136,140,374,175,47,483,265,218,71,50,76,17,1
7105,817,425,392,120,102,83,26,653,326,327,83,96,83,27,1
7106,401,198,203,70,29,38,15,318,176,142,25,32,35,25,1
7107,178,89,89,36,22,18,7,455,229,226,66,62,63,29,1
7108,4684,2161,2523,779,782,304,101,1858,805,1053,271,345,116,41,1
7109,389,195,194,68,60,30,17,202,102,100,29,35,6,9,1
7110,154,66,88,31,17,14,9,215,115,100,27,28,34,16,1
7111,290,127,163,47,58,23,12,1893,850,1043,280,340,169,80,1
7112,327,177,150,40,40,38,18,778,367,411,90,85,64,43,1
7113,437,230,207,41,55,27,13,928,442,486,139,118,91,43,1
7114,391,208,183,65,49,57,17,149,68,81,15,38,11,10,1
7115,834,405,429,112,95,84,34,304,159,145,38,40,32,3,1
7116,425,210,215,56,43,52,25,317,181,136,36,36,26,12,1
7117,290,130,160,47,43,32,11,159,84,75,13,28,10,8,1
7118,632,339,293,83,77,59,20,537,276,261,75,68,68,22,1
7119,975,518,457,141,122,75,26,261,130,131,27,41,19,16,1
7120,552,285,267,74,51,69,24,193,107,86,13,20,13,6,1
7121,103,56,47,27,7,8,2,514,254,260,55,57,56,19,1
7122,551,233,318,103,99,64,23,505,268,237,68,59,34,15,1
7123,1544,738,806,239,217,145,91,489,253,236,73,36,62,17,1
7124,788,360,428,93,106,67,72,866,382,484,116,114,91,28,1
7125,651,323,328,90,65,64,24,673,329,344,111,95,92,41,1
7126,266,139,127,33,26,34,12,309,161,148,38,34,40,15,1
7127,435,225,210,58,46,50,14,400,191,209,41,40,33,21,1
7128,1170,510,660,142,182,115,84,359,184,175,49,35,32,11,1
7129,491,272,219,55,66,36,6,211,109,102,33,27,24,11,1
7130,323,169,154,47,44,39,20,1425,670,755,153,189,122,85,1
7131,134,61,73,26,33,4,8,288,118,170,50,57,18,15,1
7132,665,341,324,109,79,38,22,643,282,361,94,109,59,24,1
7133,551,237,314,95,79,54,17,770,374,396,95,91,79,41,1
7134,1201,557,644,151,125,117,50,1290,658,632,145,139,94,44,1
7135,357,214,143,30,32,27,13,279,135,144,40,52,40,5,1
7136,350,180,170,64,46,55,12,297,160,137,27,33,26,19,1
7137,602,299,303,98,81,72,21,1202,506,696,209,198,74,44,1
7138,723,335,388,90,84,77,74,2556,1169,1387,248,291,227,275,1
7139,381,191,190,55,61,33,11,303,175,128,43,36,34,12,1
7140,313,157,156,39,26,34,29,902,332,570,154,146,75,40,1
7141,179,107,72,30,19,24,7,371,237,134,31,25,43,17,1
7142,418,204,214,68,66,38,12,317,153,164,34,52,30,14,1
7143,217,94,123,29,30,23,17,370,232,138,36,23,42,21,1
7144,1256,528,728,154,185,81,64,392,115,277,117,75,28,17,1
7145,729,391,338,80,64,71,34,1390,695,695,180,137,170,71,1
7146,33423,16370,17053,4965,4756,2786,883,6669,2978,3691,1310,930,829,237,1
7147,767,392,375,113,112,83,13,3144,1617,1527,367,342,278,136,1
7148,165,77,88,28,27,19,10,416,210,206,55,54,39,20,1
7149,504,245,259,64,54,42,14,323,198,125,28,25,34,15,1
7150,183,78,105,30,31,26,8,397,180,217,61,59,39,13,1
7151,295,122,173,52,42,22,10,454,191,263,61,66,38,15,1
7152,481,256,225,60,56,48,12,377,184,193,56,53,44,14,1
7153,543,296,247,86,79,60,19,509,341,168,35,32,52,15,1
7154,583,322,261,73,66,45,26,839,439,400,101,86,102,43,1
7155,390,191,199,57,49,45,25,330,182,148,47,27,40,11,1
7156,725,372,353,100,88,78,25,250,129,121,36,28,23,10,1
7157,181,75,106,35,26,11,9,467,250,217,59,52,41,19,1
7158,622,299,323,86,86,69,35,207,114,93,33,20,31,13,1
7159,351,184,167,59,45,54,9,657,293,364,109,75,66,28,1
7160,280,118,162,35,32,41,37,858,431,427,94,57,54,30,1
7161,225,116,109,29,19,25,6,918,427,491,113,111,113,33,1
7162,360,188,172,49,48,47,17,360,192,168,55,45,48,16,1
7163,63,29,34,13,10,4,8,367,161,206,70,48,41,19,1
7164,363,182,181,33,55,23,11,940,417,523,190,146,85,26,1
7165,981,483,498,144,151,106,38,1490,775,715,193,156,142,81,1
7166,235,104,131,29,35,26,10,712,380,332,69,74,57,30,1
7167,552,264,288,82,64,48,20,140,86,54,17,6,20,7,1
7168,877,504,373,99,80,86,40,354,168,186,50,53,39,20,1
7169,4303,2489,1814,436,369,444,134,901,458,443,91,129,86,21,1
7170,509,262,247,64,70,64,20,750,347,403,105,103,83,29,1
7171,639,322,317,73,82,39,23,390,207,183,50,48,38,15,1
7172,235,104,131,29,35,26,10,596,289,307,86,75,71,33,1
7173,81,41,40,15,13,3,2,776,356,420,122,103,85,30,1
7174,687,351,336,106,67,70,41,190,74,116,34,29,11,11,1
7175,1268,621,647,168,152,110,56,1471,709,762,198,184,154,62,1
7176,595,289,306,87,62,84,40,375,202,173,46,49,41,23,1
7177,393,186,207,58,50,36,22,333,127,206,66,68,25,14,1
7178,360,188,172,67,48,52,12,340,162,178,40,39,35,22,1
7179,1007,353,654,277,147,70,26,248,118,130,54,31,26,5,1
7180,341,175,166,48,43,35,18,233,130,103,26,23,23,6,1
7181,416,201,215,54,52,39,25,461,217,244,44,41,27,36,1
7182,448,281,167,47,37,45,13,366,183,183,48,47,36,17,1
7183,71,39,32,7,11,6,4,395,189,206,63,50,49,28,1
7184,643,282,361,94,109,59,24,595,233,362,143,66,94,47,1
7185,764,277,487,158,162,64,31,1893,850,1043,280,340,169,80,1
7186,931,464,467,109,126,119,42,412,195,217,79,48,36,29,1
7187,367,161,206,70,48,41,19,264,122,142,33,29,13,13,1
7188,913,393,520,160,165,87,40,320,143,177,51,51,24,10,1
7189,89,42,47,16,12,15,6,780,414,366,112,89,73,38,1
7190,447,222,225,71,54,44,25,1158,481,677,169,129,86,40,1
7191,963,553,410,126,103,79,26,208,101,107,38,28,24,7,1
7192,639,322,317,73,82,39,23,831,426,405,101,102,105,32,1
7193,395,226,169,57,44,32,8,1194,646,548,139,125,127,59,1
7194,226,118,108,32,30,18,11,497,185,312,63,92,38,28,1
7195,525,299,226,54,54,51,19,465,225,240,65,44,65,25,1
7196,356,197,159,50,43,29,17,479,233,246,68,66,36,21,1
7197,674,268,406,118,96,70,21,577,251,326,92,84,60,11,1
7198,482,231,251,76,81,64,26,1257,464,793,221,264,75,37,1
7199,656,358,298,67,47,64,26,134,66,68,24,11,10,6,1
7200,275,140,135,38,32,18,5,527,257,270,72,68,50,28,1
7201,3259,1163,2096,526,657,162,86,70,42,28,12,7,12,4,1
7202,624,204,420,166,101,32,13,1047,475,572,176,183,110,39,1
7203,291,162,129,40,21,32,16,202,102,100,29,35,6,9,1
7204,384,238,146,38,26,66,19,150,80,70,26,5,20,7,1
7205,672,336,336,103,80,47,32,219,124,95,22,22,23,5,1
7206,277,124,153,44,40,35,18,785,374,411,56,42,38,25,1
7207,671,364,307,75,71,58,22,1072,518,554,124,130,94,37,1
7208,394,220,174,50,28,53,21,245,111,134,31,44,20,11,1
7209,360,188,172,49,48,47,17,400,208,192,62,44,42,21,1
7210,246,115,131,15,29,10,32,319,122,197,62,46,32,10,1
7211,267,124,143,45,46,26,4,348,184,164,48,38,47,14,1
7212,1098,519,579,182,159,79,42,449,240,209,59,55,63,20,1
7213,480,252,228,55,37,49,20,295,143,152,38,47,22,25,1
7214,217,121,96,27,34,18,10,721,379,342,89,73,68,25,1
7215,502,299,203,57,52,32,11,926,435,491,133,132,85,17,1
7216,415,250,165,43,28,50,21,101,57,44,14,8,6,6,1
7217,1960,810,1150,358,377,121,72,615,339,276,82,76,63,16,1
7218,1190,638,552,162,95,112,18,2004,839,1165,291,300,148,108,1
7219,342,178,164,33,38,35,15,240,167,73,32,12,8,21,1
7220,1307,594,713,179,208,102,41,969,505,464,123,133,92,33,1
7221,418,205,213,69,50,29,15,189,88,101,31,29,18,10,1
7222,477,256,221,69,66,70,12,359,184,175,49,35,32,11,1
7223,854,399,455,127,118,57,39,729,391,338,80,64,71,34,1
7224,651,306,345,85,64,61,32,595,316,279,86,60,65,40,1
7225,381,191,190,55,61,33,11,249,111,138,40,30,22,17,1
7226,456,243,213,64,44,59,18,419,274,145,41,23,28,27,1
7227,386,191,195,61,54,31,21,390,207,183,50,48,38,15,1
7228,519,246,273,78,82,42,16,467,298,169,36,20,63,28,1
7229,664,389,275,68,60,105,35,213,107,106,28,41,19,5,1
7230,467,226,241,55,48,54,23,1354,537,817,245,247,117,57,1
7231,146,75,71,13,32,15,11,304,144,160,54,31,22,10,1
7232,427,218,209,61,53,45,26,360,188,172,49,48,47,17,1
7233,1011,499,512,157,133,116,48,2803,1300,1503,392,510,170,57,1
7234,1891,1066,825,207,184,181,83,217,105,112,34,32,25,13,1
7235,583,322,261,73,66,45,26,4544,2024,2520,579,628,480,403,1
7236,107,36,71,27,15,0,1,619,289,330,67,77,36,19,1
7237,395,198,197,55,55,36,10,365,173,192,47,47,29,14,1
7238,601,313,288,42,48,25,36,467,224,243,70,43,67,23,1
7239,651,340,311,81,84,80,29,1135,624,511,150,118,145,73,1
7240,1068,539,529,161,134,132,71,525,274,251,82,74,60,25,1
7241,824,403,421,80,150,65,35,352,179,173,54,46,35,22,1
7242,767,392,375,113,112,83,13,537,276,261,75,68,68,22,1
7243,480,257,223,74,26,60,27,358,212,146,51,36,33,9,1
7244,782,382,400,124,131,35,16,1332,626,706,182,144,80,41,1
7245,220,126,94,29,12,34,11,288,135,153,41,31,36,17,1
7246,433,220,213,67,68,31,19,368,141,227,64,61,24,13,1
7247,825,399,426,128,128,77,32,2414,1189,1225,277,178,170,169,1
7248,246,115,131,15,29,10,32,205,104,101,28,28,35,13,1
7249,222,103,119,38,39,4,17,222,105,117,37,44,6,18,1
7250,335,185,150,46,34,36,13,755,372,383,101,125,80,31,1
7251,540,279,261,57,49,56,30,794,402,392,96,84,86,30,1
7252,155,79,76,26,13,15,6,418,255,163,42,31,42,22,1
7253,5038,2652,2386,655,729,544,245,94,45,49,11,20,10,4,1
7254,471,255,216,66,68,81,16,211,112,99,30,15,34,18,1
7255,211,92,119,33,44,11,7,800,416,384,102,105,83,22,1
7256,813,440,373,117,93,34,19,445,225,220,47,62,53,26,1
7257,365,193,172,46,50,47,13,445,173,272,82,76,40,20,1
7258,646,316,330,89,95,48,17,428,226,202,52,60,75,20,1
7259,870,489,381,97,99,76,14,217,109,108,34,32,35,7,1
7260,697,373,324,105,83,95,38,78,45,33,12,10,2,5,1
7261,264,130,134,38,33,26,10,521,265,256,69,69,61,26,1
7262,315,150,165,52,36,22,15,221,110,111,28,32,25,11,1
7263,538,274,264,84,67,52,35,475,223,252,72,66,51,26,1
7264,369,167,202,66,59,39,20,288,118,170,50,57,18,15,1
7265,520,261,259,82,76,71,24,509,341,168,35,32,52,15,1
7266,159,102,57,14,13,23,7,359,219,140,42,19,56,19,1
7267,459,251,208,67,49,40,23,189,90,99,26,29,17,11,1
7268,215,80,135,54,56,21,9,240,125,115,34,32,30,8,1
7269,246,108,138,32,44,21,10,1338,756,582,155,105,104,44,1
7270,568,193,375,112,83,50,15,821,387,434,121,131,76,29,1
7271,594,274,320,89,63,66,28,1132,553,579,172,143,150,57,1
7272,349,186,163,43,45,51,12,1133,491,642,192,170,61,29,1
7273,297,158,139,47,37,37,9,1531,691,840,270,226,143,52,1
7274,212,120,92,29,27,24,10,177,82,95,24,37,9,12,1
7275,582,293,289,94,80,77,32,411,209,202,69,43,18,15,1
7276,1149,568,581,177,133,101,30,724,334,390,112,109,79,17,1
7277,530,288,242,49,55,38,22,985,551,434,123,93,91,26,1
7278,344,181,163,45,49,40,24,2035,1087,948,163,129,96,73,1
7279,558,303,255,86,64,65,18,476,227,249,52,59,38,17,1
7280,345,203,142,47,35,31,11,361,172,189,51,54,25,4,1
7281,1231,494,737,194,214,84,34,534,285,249,87,77,59,16,1
7282,360,188,172,49,48,47,17,353,194,159,67,35,52,11,1
7283,400,193,207,53,69,48,14,1167,418,749,226,204,88,39,1
7284,360,192,168,55,45,48,16,1333,646,687,209,179,148,45,1
7285,184,95,89,22,22,19,7,1807,933,874,248,203,173,71,1
7286,3969,1703,2266,619,432,259,144,792,396,396,101,70,87,30,1
7287,1290,597,693,182,182,119,63,327,160,167,56,31,36,15,1
7288,718,283,435,126,127,34,29,445,198,247,85,67,38,19,1
7289,1505,681,824,201,204,73,32,826,423,403,129,93,82,42,1
7290,635,326,309,70,61,77,30,583,322,261,73,66,45,26,1
7291,657,293,364,109,75,66,28,255,122,133,35,51,22,13,1
7292,150,79,71,19,29,19,6,142,60,82,20,28,13,5,1
7293,686,345,341,93,81,69,30,193,99,94,31,31,16,12,1
7294,2061,822,1239,312,324,170,85,3144,1617,1527,367,342,278,136,1
7295,193,92,101,29,32,25,11,1675,875,800,213,219,196,72,1
7296,391,208,183,65,49,57,17,204,80,124,29,51,10,5,1
7297,295,147,148,36,24,36,11,407,244,163,42,32,50,12,1
7298,767,305,462,120,135,38,25,208,99,109,28,30,18,9,1
7299,211,83,128,28,35,5,11,295,145,150,41,45,36,18,1
7300,1948,1039,909,242,227,200,67,225,102,123,32,32,31,15,1
7301,561,292,269,88,68,64,22,665,297,368,111,107,34,12,1
7302,3685,1574,2111,579,580,303,116,505,275,230,63,57,35,12,1
7303,898,467,431,101,127,90,53,136,65,71,33,11,9,6,1
7304,1130,639,491,87,188,57,41,536,278,258,72,63,62,20,1
7305,285,109,176,54,80,9,9,97,46,51,12,17,11,8,1
7306,682,260,422,98,83,42,31,605,281,324,111,67,40,44,1
7307,639,287,352,111,108,44,9,416,182,234,62,67,37,17,1
7308,508,251,257,74,53,51,18,129,50,79,43,16,6,9,1
7309,456,209,247,72,58,40,9,377,184,193,56,53,44,14,1
7310,1970,978,992,245,206,198,80,294,148,146,35,33,25,14,1
7311,245,122,123,21,32,18,13,288,138,150,82,22,25,5,1
7312,339,170,169,32,17,24,13,3144,1617,1527,367,342,278,136,1
7313,288,118,170,50,57,18,15,834,335,499,129,110,84,33,1
7314,551,298,253,63,65,45,19,692,326,366,103,121,67,27,1
7315,233,121,112,24,31,30,7,246,128,118,39,34,22,7,1
7316,264,130,134,38,33,26,10,727,389,338,77,54,70,32,1
7317,2442,1193,1249,278,183,170,145,207,128,79,26,17,19,9,1
7318,433,221,212,59,42,47,14,1255,708,547,120,68,88,7,1
7319,294,148,146,35,33,25,14,239,146,93,30,22,35,9,1
7320,611,246,365,116,82,71,27,719,301,418,122,132,42,26,1
7321,502,240,262,78,61,54,32,375,198,177,48,44,45,22,1
7322,524,237,287,87,75,54,26,255,122,133,35,51,22,13,1
7323,403,188,215,70,42,41,11,601,290,311,92,89,55,30,1
7324,414,200,214,67,36,42,22,255,111,144,31,25,21,28,1
7325,249,114,135,47,33,25,4,267,147,120,40,24,25,8,1
7326,336,221,115,22,17,40,16,94,48,46,16,7,8,6,1
7327,443,241,202,57,43,67,18,1207,593,614,151,148,131,95,1
7328,1496,760,736,217,184,151,41,211,114,97,32,24,19,10,1
7329,504,259,245,73,56,45,29,1441,657,784,140,135,81,73,1
7330,822,417,405,112,97,88,40,2109,999,1110,332,294,187,89,1
7331,436,201,235,54,37,34,20,301,157,144,31,28,34,9,1
7332,400,195,205,63,67,40,18,1505,681,824,201,204,73,32,1
7333,340,158,182,51,56,9,7,253,123,130,40,46,15,4,1
7334,419,184,235,66,43,50,28,509,214,295,88,76,57,38,1
7335,345,171,174,42,42,25,9,87,50,37,16,7,10,5,1
7336,415,209,206,60,67,39,18,354,140,214,55,50,31,18,1
7337,1009,506,503,146,141,97,55,1608,778,830,243,230,159,74,1
7338,864,362,502,142,150,70,19,400,228,172,43,20,47,24,1
7339,583,322,261,73,66,45,26,619,332,287,95,77,74,38,1
7340,666,344,322,91,73,91,20,329,196,133,38,30,24,16,1
7341,651,311,340,94,75,59,22,194,112,82,26,13,17,8,1
7342,638,300,338,83,53,81,49,655,349,306,78,59,76,42,1
7343,205,114,91,25,24,20,15,953,481,472,133,130,77,48,1
7344,671,303,368,93,68,61,26,320,163,157,44,44,26,15,1
7345,551,299,252,51,62,63,17,635,333,302,99,75,83,28,1
7346,753,359,394,102,100,85,23,165,78,87,23,21,17,8,1
7347,1344,728,616,152,150,96,35,193,99,94,31,31,16,12,1
7348,1241,697,544,169,156,125,39,260,133,127,43,32,39,3,1
7349,505,254,251,80,77,60,15,417,182,235,57,109,50,8,1
7350,317,153,164,39,30,35,13,340,162,178,40,39,35,22,1
7351,979,493,486,161,112,95,31,926,435,491,133,132,85,17,1
7352,655,281,374,108,103,61,24,240,99,141,53,38,29,15,1
7353,395,189,206,63,50,49,28,760,405,355,112,95,92,29,1
7354,258,141,117,33,29,23,10,706,346,360,118,92,98,56,1
7355,475,235,240,77,58,43,22,213,91,122,42,30,23,12,1
7356,432,228,204,59,53,43,15,298,167,131,47,33,40,8,1
7357,1273,592,681,199,164,139,39,582,328,254,78,48,35,9,1
7358,126,57,69,31,10,10,3,687,353,334,84,96,74,31,1
7359,461,207,254,82,66,55,33,1992,927,1065,292,228,166,77,1
7360,501,240,261,80,62,49,42,309,159,150,47,43,43,13,1
7361,356,185,171,37,31,17,21,306,156,150,47,37,21,3,1
7362,154,75,79,17,24,16,13,1285,578,707,239,191,136,57,1
7363,595,316,279,86,60,65,40,403,190,213,63,52,48,21,1
7364,839,427,412,91,83,114,37,233,94,139,36,37,15,8,1
7365,586,270,316,83,80,59,21,529,274,255,57,62,38,14,1
7366,330,77,253,86,52,20,12,2414,1189,1225,277,178,170,169,1
7367,921,455,466,144,127,108,39,310,156,154,27,43,20,6,1
7368,1255,666,589,145,142,120,82,1132,553,579,172,143,150,57,1
7369,433,221,212,59,42,47,14,520,261,259,82,76,71,24,1
7370,500,193,307,97,68,32,20,1140,495,645,129,95,128,159,1
7371,1333,646,687,209,179,148,45,593,295,298,70,85,48,13,1
7372,589,294,295,37,44,27,33,537,272,265,75,83,41,29,1
7373,1254,631,623,152,160,66,44,870,436,434,131,114,72,25,1
7374,826,362,464,107,118,71,43,213,107,106,28,41,19,5,1
7375,1087,485,602,151,151,112,48,1462,711,751,219,222,148,65,1
7376,812,427,385,109,81,69,35,161,73,88,23,22,15,8,1
7377,247,110,137,34,45,23,10,634,281,353,143,94,59,29,1
7378,465,225,240,65,44,65,25,953,493,460,122,133,87,47,1
7379,553,261,292,73,79,40,26,595,272,323,111,107,54,28,1
7380,430,240,190,60,42,34,30,517,250,267,78,37,64,29,1
7381,540,271,269,80,77,51,16,119,54,65,26,14,6,5,1
7382,529,264,265,59,68,41,17,400,208,192,62,44,42,21,1
7383,211,110,101,31,30,25,8,601,313,288,42,48,25,36,1
7384,1863,721,1142,262,283,139,74,536,266,270,58,73,40,25,1
7385,5202,2614,2588,543,451,623,272,1670,1140,530,173,120,89,53,1
7386,832,391,441,119,87,92,59,253,148,105,31,15,39,16,1
7387,277,124,153,44,40,35,18,339,183,156,43,45,28,17,1
7388,689,343,346,119,100,86,38,143,79,64,16,25,7,5,1
7389,674,248,426,169,95,56,16,425,210,215,56,43,52,25,1
7390,419,212,207,68,55,42,19,240,125,115,34,32,30,8,1
7391,729,391,338,80,64,71,34,963,477,486,134,143,123,38,1
7392,140,76,64,17,13,13,8,1919,871,1048,315,265,148,61,1
7393,335,177,158,45,49,34,13,315,118,197,85,57,42,14,1
7394,994,474,520,129,130,108,69,745,366,379,110,93,79,45,1
7395,666,329,337,90,90,54,19,1425,670,755,153,189,122,85,1
7396,892,420,472,135,146,98,37,536,278,258,72,63,62,20,1
7397,767,392,375,113,112,83,13,445,255,190,57,53,56,28,1
7398,1047,562,485,141,127,114,41,976,496,480,128,111,121,48,1
7399,787,394,393,113,98,52,19,909,455,454,137,82,85,68,1
7400,520,224,296,69,64,31,29,2414,1189,1225,277,178,170,169,1
7401,1201,557,644,151,125,117,50,586,309,277,81,64,76,25,1
7402,2319,934,1385,304,376,173,104,4967,2501,2466,718,692,594,248,1
7403,456,228,228,49,70,32,19,505,231,274,64,68,30,40,1
7404,450,231,219,77,50,76,16,339,170,169,32,17,24,13,1
7405,200,91,109,23,35,13,7,401,167,234,56,71,16,10,1
7406,370,197,173,63,40,40,23,371,215,156,40,23,58,28,1
7407,756,348,408,101,103,60,40,781,418,363,92,90,64,41,1
7408,1417,598,819,223,188,135,58,439,177,262,78,73,40,21,1
7409,866,382,484,116,114,91,28,732,373,359,97,96,90,29,1
7410,317,153,164,39,30,35,13,798,378,420,99,94,71,63,1
7411,215,80,135,54,56,21,9,500,244,256,66,57,52,27,1
7412,529,283,246,66,69,66,25,143,79,64,16,25,7,5,1
7413,325,184,141,43,34,22,18,437,228,209,47,61,26,11,1
7414,606,307,299,92,56,68,30,1500,804,696,190,172,144,60,1
7415,595,339,256,64,36,54,24,1581,684,897,220,153,118,63,1
7416,2045,985,1060,359,339,199,74,226,90,136,43,43,26,7,1
7417,2016,1107,909,214,229,238,111,538,286,252,80,58,48,14,1
7418,645,290,355,95,114,56,38,445,198,247,85,67,38,19,1
7419,1042,530,512,162,150,103,52,291,146,145,39,45,22,16,1
7420,653,389,264,69,59,51,19,323,156,167,52,45,39,18,1
7421,1125,581,544,135,124,137,47,140,76,64,17,13,13,8,1
7422,671,303,368,93,68,61,26,356,161,195,52,57,40,17,1
7423,719,301,418,122,132,42,26,1978,807,1171,323,310,129,70,1
7424,512,269,243,69,70,62,29,1336,736,600,137,136,163,69,1
7425,537,276,261,75,68,68,22,533,254,279,81,78,52,10,1
7426,189,109,80,26,24,9,8,740,313,427,101,135,40,22,1
7427,402,222,180,50,39,51,19,267,159,108,31,13,22,15,1
7428,953,492,461,134,124,122,38,215,105,110,26,22,19,9,1
7429,561,210,351,108,77,41,22,732,355,377,108,109,79,27,1
7430,109,42,67,25,13,1,1,425,210,215,56,43,52,25,1
7431,821,387,434,121,131,76,29,240,98,142,49,42,23,17,1
7432,504,249,255,69,70,43,12,288,158,130,59,23,21,10,1
7433,67,34,33,10,12,6,5,926,435,491,133,132,85,17,1
7434,506,233,273,81,69,52,22,839,408,431,138,122,105,46,1
7435,871,482,389,113,95,109,35,149,68,81,15,38,11,10,1
7436,210,89,121,51,34,11,6,278,111,167,66,66,19,8,1
7437,289,125,164,51,55,17,10,603,291,312,98,87,61,28,1
7438,335,128,207,59,43,24,23,769,329,440,116,66,55,22,1
7439,672,334,338,110,93,91,41,377,202,175,46,50,41,23,1
7440,648,307,341,101,58,76,34,283,142,141,35,29,32,5,1
7441,241,106,135,48,29,17,15,1464,987,477,137,141,55,31,1
7442,1496,760,736,217,184,151,41,217,109,108,34,32,35,7,1
7443,423,218,205,64,55,54,15,673,313,360,101,101,46,17,1
7444,403,188,215,70,42,41,11,642,271,371,106,111,57,23,1
7445,1174,594,580,175,155,126,66,275,125,150,37,48,27,7,1
7446,338,192,146,41,29,22,14,510,294,216,64,46,43,24,1
7447,392,156,236,40,91,28,16,854,399,455,127,118,57,39,1
7448,382,183,199,55,60,38,22,2339,1260,1079,336,252,279,106,1
7449,279,106,173,48,35,41,39,508,267,241,43,35,25,17,1
7450,246,108,138,32,44,21,10,1834,823,1011,297,282,151,63,1
7451,247,110,137,34,45,23,10,445,225,220,47,62,53,26,1
7452,331,177,154,46,38,49,17,202,86,116,33,29,26,10,1
7453,513,246,267,71,66,60,35,836,370,466,126,96,72,30,1
7454,1290,597,693,182,182,119,63,294,146,148,50,45,51,15,1
7455,894,492,402,95,103,88,42,594,305,289,86,63,51,21,1
7456,418,245,173,49,22,59,20,409,200,209,69,56,44,13,1
7457,493,240,253,72,62,59,15,377,202,175,46,50,41,23,1
7458,464,249,215,73,42,65,12,193,99,94,31,31,16,12,1
7459,815,418,397,97,62,70,17,501,240,261,80,62,49,42,1
7460,508,267,241,43,35,25,17,428,248,180,44,39,28,9,1
7461,671,326,345,111,77,74,11,1149,568,581,177,133,101,30,1
7462,339,170,169,32,17,24,13,551,298,253,63,65,45,19,1
7463,246,115,131,15,29,10,32,313,176,137,35,27,29,16,1
7464,476,233,243,76,61,52,21,759,365,394,134,108,85,35,1
7465,209,78,131,33,42,11,7,821,387,434,121,131,76,29,1
7466,427,218,209,61,53,45,26,443,198,245,68,72,48,19,1
7467,281,154,127,45,31,24,9,146,75,71,13,32,15,11,1
7468,920,492,428,100,92,88,49,551,298,253,63,65,45,19,1
7469,1599,806,793,213,237,100,45,790,385,405,121,108,106,39,1
7470,810,367,443,115,92,94,59,357,169,188,61,53,32,15,1
7471,694,360,334,90,88,77,32,377,184,193,50,43,33,17,1
7472,246,115,131,15,29,10,32,412,299,113,31,15,36,11,1
7473,950,497,453,146,127,115,43,414,211,203,45,44,41,24,1
7474,391,208,183,65,49,57,17,331,169,162,40,28,22,14,1
7475,481,249,232,72,72,58,15,1078,557,521,116,114,144,44,1
7476,389,199,190,51,56,41,21,867,370,497,129,143,76,62,1
7477,1152,459,693,138,343,75,33,699,295,404,132,126,46,28,1
7478,393,186,207,58,50,36,22,92,40,52,14,23,13,7,1
7479,686,375,311,89,80,63,20,856,415,441,133,128,51,39,1
7480,193,99,94,31,31,16,12,736,388,348,88,85,67,28,1
7481,147,68,79,31,23,8,4,455,215,240,87,55,59,23,1
7482,1698,875,823,222,219,173,64,108,51,57,16,12,16,11,1
7483,920,492,428,100,92,88,49,323,156,167,52,45,39,18,1
7484,640,297,343,120,68,68,39,301,150,151,41,30,17,11,1
7485,906,455,451,116,105,87,46,903,437,466,117,112,108,32,1
7486,964,408,556,131,153,76,55,518,262,256,70,52,49,27,1
7487,673,317,356,101,85,76,49,991,537,454,134,99,80,34,1
7488,501,240,261,80,62,49,42,208,96,112,31,32,13,9,1
7489,298,167,131,47,33,40,8,119,67,52,15,15,7,7,1
7490,191,95,96,26,17,17,12,769,329,440,116,66,55,22,1
7491,553,309,244,75,60,39,14,402,227,175,48,40,35,11,1
7492,670,333,337,95,79,62,21,426,228,198,62,42,47,22,1
7493,802,370,432,134,111,81,31,193,99,94,31,31,16,12,1
7494,672,334,338,110,93,91,41,495,233,262,64,39,49,32,1
7495,1190,638,552,162,95,112,18,335,185,150,46,34,36,13,1
7496,656,358,298,67,47,64,26,223,115,108,30,29,24,10,1
7497,525,237,288,121,59,105,20,866,382,484,116,114,91,28,1
7498,355,165,190,53,56,42,19,472,263,209,57,39,60,29,1
7499,673,313,360,101,101,46,17,259,118,141,43,38,32,10,1
7500,285,148,137,31,42,42,16,158,83,75,22,14,17,9,1
7501,1142,515,627,56,128,113,16,180,115,65,17,12,9,9,1
7502,790,385,405,121,108,106,39,1001,422,579,185,180,51,32,1
7503,647,387,260,69,51,86,38,355,169,186,57,41,46,29,1
7504,387,207,180,61,25,59,21,362,183,179,49,49,41,11,1
7505,246,108,138,32,44,21,10,2426,1147,1279,307,320,114,128,1
7506,476,251,225,57,67,57,18,131,66,65,21,14,23,7,1
7507,234,129,105,31,22,19,18,164,78,86,28,23,12,8,1
7508,987,515,472,107,110,106,61,415,209,206,60,67,39,18,1
7509,1278,593,685,198,201,71,43,277,124,153,44,40,35,18,1
7510,712,380,332,69,74,57,30,522,235,287,78,67,60,50,1
7511,330,143,187,63,29,52,20,202,102,100,29,35,6,9,1
7512,418,226,192,57,57,53,17,550,243,307,91,99,70,10,1
7513,150,81,69,24,23,16,4,301,150,151,41,30,17,11,1
7514,323,173,150,43,50,34,10,273,131,142,35,35,25,12,1
7515,753,346,407,122,101,94,33,149,68,81,15,38,11,10,1
7516,370,176,194,61,30,40,28,1615,835,780,189,208,172,86,1
7517,589,294,295,37,44,27,33,236,118,118,26,20,18,7,1
7518,470,255,215,68,49,83,15,2040,956,1084,202,190,258,147,1
7519,480,252,228,55,37,49,20,2524,1232,1292,398,317,186,61,1
7520,538,252,286,77,87,53,30,592,291,301,92,93,71,31,1
7521,1225,593,632,158,125,102,38,448,275,173,32,53,55,27,1
7522,278,121,157,47,50,19,8,808,366,442,130,133,66,31,1
7523,282,135,147,36,49,25,10,576,250,326,93,71,34,15,1
7524,195,86,109,31,37,19,5,896,503,393,114,90,101,28,1
7525,183,78,105,30,31,26,8,863,470,393,82,72,92,44,1
7526,113,47,66,14,15,11,17,336,154,182,51,48,39,22,1
7527,656,358,298,67,47,64,26,289,155,134,44,36,43,12,1
7528,146,75,71,13,32,15,11,202,102,100,29,35,6,9,1
7529,355,214,141,43,29,63,13,99,48,51,15,7,7,7,1
7530,429,187,242,79,72,28,19,433,222,211,68,58,42,23,1
7531,243,113,130,38,35,16,12,118,67,51,13,13,7,7,1
7532,516,298,218,62,57,49,19,510,264,246,67,66,38,29,1
7533,334,162,172,34,33,32,21,210,83,127,29,30,20,18,1
7534,255,130,125,44,18,22,12,499,251,248,69,59,61,22,1
7535,776,356,420,122,103,85,30,424,198,226,57,46,41,19,1
7536,269,140,129,27,26,30,19,922,418,504,120,120,106,31,1
7537,934,386,548,132,120,98,72,622,299,323,86,86,69,35,1
7538,2442,1193,1249,278,183,170,145,591,300,291,70,45,59,30,1
7539,191,99,92,25,24,18,8,769,329,440,116,66,55,22,1
7540,889,450,439,119,104,81,27,757,373,384,115,93,95,25,1
7541,467,226,241,55,48,54,23,488,274,214,58,51,38,17,1
7542,1785,857,928,246,225,187,93,474,255,219,61,47,63,23,1
7543,179,80,99,16,18,24,13,233,102,131,35,22,24,13,1
7544,151,84,67,17,17,22,11,780,414,366,112,89,73,38,1
7545,317,185,132,34,23,48,12,473,217,256,59,44,34,21,1
7546,317,153,164,34,52,30,14,619,293,326,98,78,65,22,1
7547,173,82,91,23,23,14,12,2871,1218,1653,290,374,238,414,1
7548,148,87,61,20,13,21,11,141,69,72,18,17,13,7,1
7549,661,361,300,65,82,57,15,825,363,462,97,105,72,75,1
7550,744,385,359,125,89,90,23,380,187,193,38,51,30,18,1
7551,271,133,138,45,30,24,10,430,237,193,56,36,33,24,1
7552,347,181,166,27,20,12,12,876,457,419,88,124,67,47,1
7553,1210,592,618,157,138,116,85,1686,829,857,235,189,190,57,1
7554,287,154,133,33,27,36,15,374,184,190,52,38,48,11,1
7555,568,243,325,98,73,56,44,947,482,465,143,107,89,37,1
7556,683,294,389,110,104,54,22,1608,778,830,243,230,159,74,1
7557,288,142,146,52,32,26,8,928,442,486,139,118,91,43,1
7558,330,77,253,86,52,20,12,437,167,270,126,95,34,10,1
7559,227,124,103,33,21,16,19,467,224,243,70,43,67,23,1
7560,246,115,131,15,29,10,32,408,205,203,80,40,55,23,1
7561,881,419,462,132,82,81,24,467,224,243,70,43,67,23,1
7562,975,518,457,141,122,75,26,363,178,185,54,48,21,13,1
7563,433,221,212,59,42,47,14,1074,538,536,154,140,111,51,1
7564,372,206,166,43,32,49,12,318,176,142,25,32,35,25,1
7565,848,394,454,100,90,101,41,339,170,169,32,17,24,13,1
7566,546,267,279,90,69,56,19,205,101,104,34,25,34,8,1
7567,785,412,373,114,84,95,38,1058,557,501,128,128,115,43,1
7568,327,182,145,43,29,35,21,1425,670,755,153,189,122,85,1
7569,1292,592,700,186,169,108,22,1134,574,560,157,164,47,48,1
7570,241,106,135,48,29,17,15,1106,579,527,121,152,113,45,1
7571,1073,539,534,153,134,136,51,115,65,50,9,15,7,8,1
7572,1591,704,887,253,227,156,50,742,303,439,88,96,86,23,1
7573,133,66,67,21,24,9,2,169,87,82,28,23,20,6,1
7574,204,93,111,35,35,16,11,445,225,220,47,62,53,26,1
7575,581,302,279,73,72,53,37,496,251,245,66,57,39,22,1
7576,187,93,94,23,37,24,10,320,163,157,44,44,26,15,1
7577,595,272,323,111,107,54,28,742,303,439,88,96,86,23,1
7578,335,128,207,59,43,24,23,586,254,332,114,111,55,17,1
7579,1084,537,547,154,121,92,35,2524,1232,1292,398,317,186,61,1
7580,1190,638,552,162,95,112,18,318,176,142,25,32,35,25,1
7581,642,271,371,106,111,57,23,277,128,149,40,47,15,6,1
7582,656,358,298,67,47,64,26,145,75,70,21,27,20,4,1
7583,798,287,511,126,125,77,26,778,367,411,90,85,64,43,1
7584,832,428,404,131,89,88,38,320,163,157,44,44,26,15,1
7585,1189,559,630,179,147,118,35,217,109,108,34,32,35,7,1
7586,840,385,455,118,137,66,39,232,111,121,23,29,17,9,1
7587,247,110,137,34,45,23,10,1807,933,874,248,203,173,71,1
7588,979,535,444,123,99,79,34,540,306,234,74,52,43,22,1
7589,318,162,156,53,50,32,13,395,222,173,48,42,21,8,1
7590,504,269,235,58,62,43,17,440,215,225,76,74,29,16,1
7591,298,167,131,47,33,40,8,347,181,166,27,20,12,12,1
7592,503,285,218,72,45,64,22,503,286,217,76,44,66,22,1
7593,447,222,225,71,54,44,25,673,318,355,61,71,40,31,1
7594,440,218,222,58,66,40,24,414,216,198,51,32,42,28,1
7595,767,392,375,113,112,83,13,732,366,366,108,86,74,41,1
7596,1140,586,554,130,146,117,49,676,330,346,106,80,83,33,1
7597,443,226,217,67,34,53,10,339,170,169,32,17,24,13,1
7598,802,449,353,102,87,82,29,770,374,396,95,91,79,41,1
7599,1102,511,591,171,179,148,52,501,240,261,80,62,49,42,1
7600,597,312,285,80,80,71,37,244,120,124,34,40,26,8,1
7601,423,222,201,60,51,51,11,951,506,445,107,118,79,40,1
7602,420,205,215,60,44,52,21,712,396,316,78,69,65,25,1
7603,920,492,428,100,92,88,49,410,208,202,59,58,43,26,1
7604,620,307,313,92,91,92,33,499,252,247,75,71,65,25,1
7605,223,93,130,38,27,39,10,89,42,47,16,12,15,6,1
7606,540,271,269,80,77,51,16,291,146,145,39,45,22,16,1
7607,760,410,350,89,81,128,25,335,143,192,45,36,32,37,1
7608,870,489,381,97,99,76,14,1258,648,610,172,159,116,28,1
7609,353,217,136,39,17,44,17,354,169,185,54,54,41,19,1
7610,641,324,317,88,92,49,14,613,334,279,90,71,51,17,1
7611,2041,1035,1006,223,274,125,60,180,103,77,22,19,29,8,1
7612,245,112,133,32,45,20,10,523,249,274,92,64,58,21,1
7613,423,218,205,64,55,54,15,1311,690,621,158,161,128,51,1
7614,832,428,404,131,89,88,38,1441,657,784,140,135,81,73,1
7615,802,388,414,131,105,96,29,100,37,63,26,19,0,1,1
7616,425,199,226,54,71,56,11,785,374,411,56,42,38,25,1
7617,2406,1132,1274,362,272,192,66,416,201,215,54,52,39,25,1
7618,648,307,341,101,58,76,34,393,210,183,55,50,34,19,1
7619,134,56,78,17,30,7,7,375,202,173,46,49,41,23,1
7620,765,407,358,89,75,90,42,504,247,257,85,57,59,20,1
7621,465,225,240,65,44,65,25,632,312,320,110,56,73,18,1
7622,433,221,212,59,42,47,14,406,187,219,55,64,24,9,1
7623,199,108,91,25,10,34,16,309,158,151,27,32,29,14,1
7624,442,254,188,46,22,40,19,461,257,204,63,49,50,29,1
7625,1265,580,685,205,188,166,53,1338,633,705,199,151,144,65,1
7626,574,303,271,59,55,60,22,179,92,87,23,18,16,12,1
7627,351,184,167,59,45,54,9,394,202,192,44,43,38,28,1
7628,414,194,220,76,66,49,16,785,374,411,56,42,38,25,1
7629,590,279,311,103,83,69,30,143,79,64,16,25,7,5,1
7630,1178,661,517,166,140,126,48,338,192,146,41,29,22,14,1
7631,375,202,173,46,49,41,23,375,202,173,46,49,41,23,1
7632,314,108,206,45,75,34,8,313,159,154,30,40,23,14,1
7633,902,495,407,116,97,111,37,1657,800,857,249,235,154,51,1
7634,210,115,95,22,26,15,7,191,99,92,25,24,18,8,1
7635,885,339,546,159,135,81,49,183,76,107,34,38,14,8,1
7636,504,237,267,62,66,48,17,241,124,117,30,35,24,8,1
7637,1139,536,603,162,139,109,50,719,364,355,104,100,58,34,1
7638,148,93,55,24,3,19,8,568,292,276,69,74,59,34,1
7639,501,273,228,70,59,30,10,2414,1189,1225,277,178,170,169,1
7640,376,183,193,50,50,43,21,247,127,120,43,20,27,14,1
7641,676,333,343,111,89,94,39,462,251,211,74,53,41,18,1
7642,701,331,370,116,95,59,28,1186,567,619,161,156,122,49,1
7643,510,306,204,82,46,45,20,295,143,152,38,47,22,25,1
7644,663,338,325,68,71,41,16,882,432,450,115,111,68,44,1
7645,593,305,288,91,83,54,24,288,118,170,50,57,18,15,1
7646,756,368,388,114,99,89,30,687,353,334,84,96,74,31,1
7647,412,238,174,41,38,43,19,339,177,162,40,36,51,24,1
7648,229,105,124,36,33,12,4,261,130,131,27,41,19,16,1
7649,677,323,354,101,109,45,31,339,170,169,32,17,24,13,1
7650,317,153,164,34,52,30,14,1332,659,673,174,170,153,55,1
7651,309,154,155,42,44,45,16,963,455,508,126,110,68,29,1
7652,277,124,153,44,40,35,18,586,240,346,94,110,29,19,1
7653,235,135,100,30,13,25,11,509,262,247,64,70,64,20,1
7654,635,333,302,99,75,83,28,583,322,261,73,66,45,26,1
7655,232,108,124,33,27,19,16,520,279,241,62,72,35,25,1
7656,433,229,204,60,59,53,24,538,286,252,80,58,48,14,1
7657,854,376,478,136,112,72,29,467,224,243,70,43,67,23,1
7658,261,143,118,33,24,32,16,406,211,195,55,37,47,16,1
7659,265,119,146,44,52,12,9,951,497,454,142,127,49,24,1
7660,350,180,170,64,46,55,12,1103,536,567,171,156,81,43,1
7661,430,192,238,62,67,27,10,777,387,390,90,87,65,37,1
7662,684,288,396,107,90,54,42,3574,1733,1841,371,392,414,304,1
7663,388,199,189,50,51,33,14,523,273,250,80,62,40,14,1
7664,217,105,112,34,32,25,13,914,453,461,112,115,79,29,1
7665,3969,1703,2266,619,432,259,144,281,166,115,34,17,36,16,1
7666,2414,1189,1225,277,178,170,169,4861,2440,2421,597,576,422,237,1
7667,225,102,123,32,32,31,15,135,61,74,23,22,14,5,1
7668,449,244,205,68,53,49,12,451,237,214,74,59,65,19,1
7669,588,255,333,94,82,58,27,574,277,297,88,77,58,36,1
7670,247,136,111,20,26,25,10,770,355,415,103,142,75,42,1
7671,342,178,164,33,38,35,15,86,50,36,9,14,8,7,1
7672,278,111,167,66,66,19,8,202,102,100,29,35,6,9,1
7673,360,192,168,55,45,48,16,640,279,361,102,83,69,21,1
7674,307,150,157,44,23,30,13,892,420,472,135,146,98,37,1
7675,333,171,162,41,44,48,23,431,201,230,69,39,55,33,1
7676,672,334,338,110,93,91,41,372,237,135,38,22,39,26,1
7677,385,181,204,48,41,52,36,586,254,332,114,111,55,17,1
7678,391,208,183,65,49,57,17,502,299,203,57,52,32,11,1
7679,305,175,130,47,28,34,10,105,53,52,23,11,12,6,1
7680,297,145,152,49,30,23,21,810,367,443,115,92,94,59,1
7681,340,169,171,49,42,31,14,261,130,131,27,41,19,16,1
7682,1107,601,506,155,138,104,49,1117,423,694,182,134,88,31,1
7683,608,336,272,61,49,78,31,997,441,556,152,165,92,41,1
7684,1484,731,753,206,175,187,71,987,515,472,107,110,106,61,1
7685,901,439,462,133,123,102,45,208,99,109,28,30,18,9,1
7686,875,376,499,155,125,53,39,202,102,100,29,35,6,9,1
7687,647,324,323,101,80,76,43,316,201,115,29,31,12,6,1
7688,478,256,222,79,44,38,15,292,152,140,46,38,35,12,1
7689,292,152,140,46,38,35,12,668,338,330,85,95,68,18,1
7690,508,215,293,72,71,42,15,592,291,301,92,93,71,31,1
7691,465,230,235,68,64,48,24,360,188,172,49,48,47,17,1
7692,223,93,130,38,27,39,10,493,240,253,72,62,59,15,1
7693,145,75,70,22,18,10,5,239,146,93,30,22,35,9,1
7694,984,461,523,109,89,91,52,920,492,428,100,92,88,49,1
7695,419,197,222,70,51,36,19,346,180,166,52,55,36,13,1
7696,2758,1332,1426,394,384,287,131,512,261,251,79,73,60,21,1
7697,412,223,189,55,55,41,10,1189,559,630,179,147,118,35,1
7698,920,492,428,100,92,88,49,876,473,403,110,106,73,24,1
7699,443,248,195,67,54,40,15,217,109,108,34,30,34,5,1
7700,390,183,207,56,50,52,12,333,171,162,41,44,48,23,1
7701,597,291,306,104,92,80,29,176,73,103,22,29,13,9,1
7702,2045,985,1060,359,339,199,74,2472,1057,1415,331,352,159,96,1
7703,260,133,127,43,32,39,3,815,478,337,104,80,103,27,1
7704,233,94,139,36,37,15,8,145,75,70,18,17,10,9,1
7705,487,247,240,73,42,42,22,673,317,356,101,85,76,49,1
7706,595,316,279,86,60,65,40,439,202,237,80,53,35,15,1
7707,915,336,579,185,199,56,29,105,53,52,23,11,12,6,1
7708,505,268,237,68,59,34,15,380,212,168,47,38,19,11,1
7709,377,187,190,51,44,46,26,191,99,92,25,24,18,8,1
7710,998,514,484,120,122,113,57,207,124,83,22,19,24,11,1
7711,677,303,374,79,63,55,28,440,246,194,62,49,41,16,1
7712,1047,562,485,141,127,114,41,273,152,121,42,30,35,11,1
7713,4377,1898,2479,663,608,331,126,208,96,112,31,32,13,9,1
7714,654,317,337,95,111,44,13,627,314,313,61,59,71,22,1
7715,635,333,302,99,75,83,28,529,283,246,66,69,66,25,1
7716,1151,493,658,157,141,108,62,440,246,194,62,49,41,16,1
7717,2524,1232,1292,398,317,186,61,848,394,454,100,90,101,41,1
7718,350,169,181,52,54,42,20,425,244,181,38,26,60,26,1
7719,264,122,142,33,29,13,13,925,484,441,112,86,84,31,1
7720,298,140,158,51,33,21,22,304,144,160,54,31,22,10,1
7721,422,213,209,63,60,35,13,437,225,212,61,57,66,12,1
7722,794,390,404,103,95,86,23,778,367,411,90,85,64,43,1
7723,351,184,167,59,45,54,9,399,206,193,57,45,41,17,1
7724,379,218,161,63,36,45,16,2471,1130,1341,240,281,219,290,1
7725,393,186,207,58,50,36,22,473,212,261,72,64,45,28,1
7726,407,218,189,34,41,23,17,329,159,170,46,51,34,15,1
7727,593,266,327,102,84,69,24,906,455,451,116,105,87,46,1
7728,1190,638,552,162,95,112,18,5147,2557,2590,501,472,455,607,1
7729,860,378,482,101,123,82,74,101,57,44,14,8,6,6,1
7730,693,297,396,87,52,64,27,616,296,320,69,76,49,48,1
7731,359,198,161,51,28,54,13,631,332,299,61,104,60,19,1
7732,152,87,65,20,19,14,5,428,228,200,50,45,43,17,1
7733,508,170,338,102,103,37,17,341,178,163,48,44,42,20,1
7734,990,410,580,140,175,44,36,1516,764,752,179,155,126,55,1
7735,356,161,195,52,57,40,17,283,172,111,39,31,29,8,1
7736,2440,1061,1379,377,326,172,62,505,247,258,72,71,60,27,1
7737,933,493,440,140,108,124,32,1290,629,661,191,187,167,55,1
7738,141,83,58,15,10,10,17,116,55,61,16,7,18,14,1
7739,360,201,159,38,38,34,13,209,75,134,53,48,20,9,1
7740,391,208,183,65,49,57,17,427,191,236,67,60,41,34,1
7741,729,266,463,185,136,34,8,699,213,486,145,213,115,19,1
7742,912,497,415,126,83,106,48,2639,1436,1203,317,307,242,77,1
7743,400,208,192,62,44,42,21,480,234,246,79,77,65,23,1
7744,462,232,230,78,54,42,23,859,429,430,126,115,64,33,1
7745,1058,557,501,128,128,115,43,709,326,383,109,93,50,17,1
7746,240,125,115,34,32,30,8,525,299,226,54,54,51,19,1
7747,1379,599,780,214,189,91,33,681,286,395,109,61,69,42,1
7748,101,41,60,18,19,10,5,281,166,115,34,17,36,16,1
7749,425,210,215,56,43,52,25,655,328,327,65,54,55,35,1
7750,514,226,288,71,66,63,32,1139,536,603,162,139,109,50,1
7751,351,184,167,59,45,54,9,1434,727,707,210,173,161,54,1
7752,239,146,93,30,22,35,9,298,167,131,47,33,40,8,1
7753,170,80,90,31,22,12,8,256,148,108,31,16,29,12,1
7754,770,356,414,123,102,66,25,216,119,97,33,27,28,7,1
7755,228,105,123,38,29,25,9,815,418,397,97,62,70,17,1
7756,307,162,145,38,46,41,15,44,13,31,9,11,1,2,1
7757,1149,568,581,177,133,101,30,454,223,231,38,45,24,19,1
7758,546,279,267,94,60,32,22,432,228,204,59,53,43,15,1
7759,512,261,251,79,73,60,21,230,115,115,29,29,22,14,1
7760,653,326,327,83,96,83,27,921,455,466,144,127,108,39,1
7761,362,233,129,37,17,51,18,2639,1436,1203,317,307,242,77,1
7762,360,180,180,54,54,41,14,606,279,327,81,70,49,34,1
7763,592,275,317,100,86,57,31,824,397,427,113,95,82,33,1
7764,379,174,205,71,58,25,14,541,279,262,79,82,31,32,1
7765,2639,1436,1203,317,307,242,77,610,281,329,54,62,65,58,1
7766,2174,1054,1120,240,247,216,112,1368,742,626,179,129,189,73,1
7767,414,194,220,76,66,49,16,454,191,263,61,66,38,15,1
7768,806,436,370,101,100,76,34,483,215,268,66,70,30,16,1
7769,443,248,195,67,54,40,15,624,308,316,92,72,68,22,1
7770,209,78,131,33,42,11,7,313,148,165,45,33,36,11,1
7771,384,238,146,38,26,66,19,98,48,50,18,4,9,8,1
7772,377,177,200,63,53,44,16,384,241,143,45,18,40,23,1
7773,2220,1085,1135,312,304,202,91,521,265,256,56,44,35,12,1
7774,826,362,464,107,118,71,43,789,362,427,90,82,70,35,1
7775,727,259,468,163,157,68,15,288,104,184,80,30,39,6,1
7776,217,94,123,29,30,23,17,503,263,240,72,55,51,34,1
7777,744,385,359,125,89,90,23,725,339,386,112,122,93,32,1
7778,441,218,223,69,55,50,27,463,236,227,64,50,44,29,1
7779,444,189,255,72,82,45,17,3144,1617,1527,367,342,278,136,1
7780,358,204,154,57,41,36,14,351,166,185,48,61,24,15,1
7781,1074,538,536,154,140,111,51,450,241,209,67,58,54,23,1
7782,299,158,141,45,31,21,5,507,242,265,53,44,31,22,1
7783,185,115,70,19,17,26,6,986,561,425,121,106,80,34,1
7784,393,186,207,58,50,36,22,493,208,285,75,77,70,40,1
7785,297,158,139,47,37,37,9,152,74,78,17,20,16,6,1
7786,822,392,430,125,104,79,24,320,171,149,40,29,30,14,1
7787,770,390,380,104,76,78,32,215,80,135,54,56,21,9,1
7788,1255,666,589,145,142,120,82,93,44,49,10,13,6,3,1
7789,858,417,441,124,101,85,41,288,118,170,50,57,18,15,1
7790,245,122,123,21,32,18,13,643,294,349,92,97,53,35,1
7791,2045,985,1060,359,339,199,74,359,160,199,62,33,27,17,1
7792,416,209,207,76,45,50,17,1255,586,669,167,149,113,59,1
7793,757,373,384,115,93,95,25,229,105,124,36,33,12,4,1
7794,1627,782,845,204,187,202,108,810,367,443,115,92,94,59,1
7795,277,124,153,44,40,35,18,255,122,133,35,51,22,13,1
7796,81,38,43,11,12,5,5,596,292,304,92,60,56,19,1
7797,228,118,110,32,29,36,13,976,520,456,120,115,109,53,1
7798,360,192,168,55,45,48,16,562,265,297,79,56,72,45,1
7799,984,461,523,109,89,91,52,854,380,474,137,159,81,31,1
7800,1434,727,707,210,173,161,54,288,153,135,42,35,32,8,1
7801,569,278,291,84,72,64,15,2175,1078,1097,364,275,271,81,1
7802,894,459,435,126,109,78,46,423,222,201,51,33,41,28,1
7803,462,251,211,74,53,41,18,1447,698,749,214,180,116,46,1
7804,245,111,134,31,44,20,11,641,324,317,88,92,49,14,1
7805,2472,1055,1417,416,458,235,64,375,202,173,46,49,41,23,1
7806,249,114,135,47,33,25,4,331,169,162,40,28,22,14,1
7807,480,234,246,79,77,65,23,299,158,141,45,31,21,5,1
7808,116,58,58,13,14,7,8,418,255,163,42,31,42,22,1
7809,519,258,261,87,78,59,22,677,323,354,101,109,45,31,1
7810,204,103,101,16,32,22,8,559,274,285,75,63,52,16,1
7811,502,240,262,78,61,54,32,748,387,361,90,81,80,48,1
7812,816,463,353,99,99,61,26,246,108,138,32,44,21,10,1
7813,522,235,287,78,67,60,50,904,443,461,118,89,124,30,1
7814,94,45,49,11,20,10,4,562,309,253,70,65,58,17,1
7815,283,142,141,35,29,32,5,116,55,61,14,14,18,8,1
7816,297,158,139,47,37,37,9,437,228,209,47,61,26,11,1
7817,628,341,287,77,59,55,31,109,42,67,25,13,1,1,1
7818,593,266,327,102,84,69,24,622,309,313,75,81,76,29,1
7819,436,196,240,62,50,59,19,1084,537,547,154,121,92,35,1
7820,910,462,448,143,126,90,25,291,120,171,63,39,26,6,1
7821,2032,995,1037,320,281,137,88,403,188,215,70,42,41,11,1
7822,597,312,285,80,80,71,37,1058,557,501,128,128,115,43,1
7823,93,45,48,19,15,14,3,212,107,105,32,25,22,7,1
7824,547,292,255,51,55,46,28,586,254,332,114,111,55,17,1
7825,906,455,451,116,105,87,46,304,159,145,38,40,32,3,1
7826,963,385,578,171,162,62,35,977,407,570,162,172,37,21,1
7827,799,377,422,98,95,80,70,381,166,215,58,38,28,44,1
7828,308,146,162,42,39,24,12,1675,875,800,213,219,196,72,1
7829,505,254,251,80,77,60,15,365,186,179,48,47,42,13,1
7830,870,489,381,97,99,76,14,1149,568,581,177,133,101,30,1
7831,781,367,414,60,67,43,17,482,231,251,76,81,64,26,1
7832,264,156,108,27,27,31,14,465,225,240,65,44,65,25,1
7833,2803,1300,1503,392,510,170,57,375,202,173,46,49,41,23,1
7834,175,91,84,19,21,21,10,198,102,96,27,20,21,12,1
7835,372,206,166,43,32,49,12,201,42,159,19,3,2,75,1
7836,362,225,137,43,22,30,11,2157,1171,986,306,238,131,32,1
7837,337,189,148,30,32,45,11,489,235,254,53,69,49,20,1
7838,729,321,408,128,84,63,26,274,133,141,46,30,29,12,1
7839,94,58,36,10,9,7,8,253,155,98,27,20,22,14,1
7840,1074,538,536,190,131,157,35,375,202,173,46,49,41,23,1
7841,195,83,112,40,16,19,16,258,126,132,42,32,19,26,1
7842,1233,498,735,252,232,88,41,1147,471,676,229,164,86,37,1
7843,1382,599,783,208,252,90,39,1105,479,626,182,125,80,29,1
7844,393,186,207,58,50,36,22,616,304,312,75,71,55,25,1
7845,770,390,380,104,76,78,32,525,299,226,54,54,51,19,1
7846,146,75,71,13,32,15,11,575,295,280,89,68,54,18,1
7847,2063,1024,1039,175,117,80,97,437,228,209,47,61,26,11,1
7848,700,305,395,111,99,54,18,410,208,202,59,58,43,26,1
7849,640,308,332,91,102,49,21,353,166,187,82,42,41,16,1
7850,107,58,49,14,16,14,4,520,261,259,82,76,71,24,1
7851,725,419,306,75,67,105,26,338,193,145,34,27,53,17,1
7852,426,204,222,73,63,49,9,245,112,133,32,45,20,10,1
7853,465,251,214,58,45,71,23,117,62,55,24,18,21,2,1
7854,1140,495,645,129,95,128,159,780,409,371,125,80,60,34,1
7855,247,110,137,34,45,23,10,341,154,187,54,46,38,13,1
7856,646,355,291,99,62,72,21,393,210,183,55,50,34,19,1
7857,428,248,180,44,39,28,9,134,60,74,19,13,10,7,1
7858,1290,629,661,191,187,167,55,976,496,480,128,111,121,48,1
7859,862,409,453,149,125,86,29,426,228,198,62,42,47,22,1
7860,178,100,78,23,22,30,6,461,217,244,44,41,27,36,1
7861,832,428,404,131,89,88,38,2948,1454,1494,327,456,140,81,1
7862,708,334,374,105,96,61,37,229,116,113,34,27,27,15,1
7863,1124,615,509,157,125,128,52,827,422,405,111,104,94,28,1
7864,639,397,242,64,37,64,30,293,194,99,32,17,47,10,1
7865,204,99,105,32,32,22,10,748,355,393,121,91,95,26,1
7866,534,267,267,69,75,58,17,770,355,415,103,142,75,42,1
7867,92,49,43,7,8,10,9,99,50,49,18,11,8,6,1
7868,1748,791,957,281,247,173,25,382,200,182,53,36,51,16,1
7869,1068,559,509,158,132,122,57,273,131,142,35,35,25,12,1
7870,896,407,489,97,152,70,22,982,545,437,119,100,92,40,1
7871,140,76,64,17,13,13,8,724,334,390,112,109,79,17,1
7872,580,302,278,71,66,65,41,183,97,86,30,18,20,12,1
7873,363,221,142,36,16,56,25,1306,707,599,165,147,199,44,1
7874,1152,586,566,131,112,117,42,272,149,123,46,14,27,16,1
7875,699,334,365,108,80,70,20,839,446,393,125,110,94,35,1
7876,593,291,302,81,85,56,20,780,359,421,160,78,169,16,1
7877,2442,1193,1249,278,183,170,145,446,265,181,51,35,27,17,1
7878,236,145,91,17,19,30,18,1032,526,506,129,117,119,47,1
7879,610,281,329,54,62,65,58,742,303,439,88,96,86,23,1
7880,1214,498,716,197,180,121,65,985,551,434,123,93,91,26,1
7881,370,197,173,63,40,40,23,355,205,150,35,19,62,24,1
7882,193,83,110,26,20,16,9,170,88,82,26,29,19,6,1
7883,777,387,390,90,87,65,37,684,311,373,109,99,66,16,1
7884,767,392,375,113,112,83,13,1308,652,656,166,153,149,87,1
7885,1706,830,876,265,209,230,63,483,155,328,138,109,32,9,1
7886,578,318,260,70,50,80,17,476,190,286,116,95,33,11,1
7887,317,164,153,47,33,47,12,824,365,459,121,123,88,50,1
7888,1336,633,703,182,197,110,52,1374,679,695,191,193,154,48,1
7889,806,436,370,101,100,76,34,217,109,108,34,32,35,7,1
7890,576,250,326,93,71,34,15,284,111,173,47,34,47,43,1
7891,589,294,295,37,44,27,33,930,367,563,181,153,83,48,1
7892,2033,877,1156,359,333,106,44,639,337,302,75,65,52,12,1
7893,335,185,150,46,34,36,13,313,157,156,39,26,34,29,1
7894,1782,715,1067,211,414,58,30,413,227,186,45,34,58,23,1
7895,490,205,285,119,63,82,23,290,98,192,78,21,27,4,1
7896,89,42,47,16,12,15,6,839,439,400,101,86,102,43,1
7897,321,173,148,47,27,39,17,2556,1169,1387,248,291,227,275,1
7898,1225,593,632,158,125,102,38,550,243,307,91,99,70,10,1
7899,575,293,282,78,64,40,13,239,146,93,30,22,35,9,1
7900,708,334,374,105,96,61,37,156,64,92,39,19,15,8,1
7901,386,163,223,51,51,28,14,413,206,207,38,55,19,10,1
7902,465,225,240,65,44,65,25,1580,742,838,208,146,144,71,1
7903,667,312,355,100,134,47,20,426,221,205,71,51,39,21,1
7904,142,77,65,24,16,12,6,864,362,502,142,150,70,19,1
7905,391,189,202,73,47,37,8,346,180,166,55,49,38,6,1
7906,429,219,210,46,66,42,17,387,178,209,59,70,45,22,1
7907,291,120,171,63,39,26,6,1493,672,821,258,211,146,47,1
7908,655,281,374,108,103,61,24,248,118,130,54,31,26,5,1
7909,512,261,251,79,73,60,21,229,105,124,36,33,12,4,1
7910,1455,760,695,205,191,124,40,1225,593,632,158,125,102,38,1
7911,1390,695,695,180,137,170,71,1290,629,661,191,187,167,55,1
7912,792,398,394,109,96,90,39,389,207,182,53,58,52,18,1
7913,1149,568,581,177,133,101,30,304,159,145,38,40,32,3,1
7914,1037,461,576,146,163,75,44,122,52,70,24,22,7,6,1
7915,520,224,296,69,64,31,29,744,385,359,125,89,90,23,1
7916,913,426,487,136,109,112,43,806,419,387,115,130,57,32,1
7917,1302,637,665,162,150,125,61,806,419,387,115,130,57,32,1
7918,506,243,263,75,70,39,17,580,293,287,74,47,52,24,1
7919,1142,515,627,56,128,113,16,103,65,38,12,7,11,2,1
7920,1190,638,552,162,95,112,18,2778,1487,1291,317,245,311,226,1
7921,229,105,124,36,33,12,4,778,367,411,90,85,64,43,1
7922,535,276,259,78,80,67,18,2157,1171,986,306,238,131,32,1
7923,364,192,172,49,36,39,14,508,267,241,43,35,25,17,1
7924,254,117,137,33,35,38,6,304,144,160,54,31,22,10,1
7925,477,301,176,52,35,45,24,217,109,108,34,32,35,7,1
7926,620,334,286,82,55,71,25,427,204,223,38,57,26,32,1
7927,2644,1346,1298,391,304,315,148,476,233,243,76,61,52,21,1
7928,295,143,152,38,47,22,25,1147,471,676,229,164,86,37,1
7929,912,461,451,127,109,96,48,659,325,334,102,85,87,32,1
7930,953,377,576,203,197,65,29,915,336,579,185,199,56,29,1
7931,672,334,338,110,93,91,41,624,308,316,92,72,68,22,1
7932,577,342,235,63,57,23,37,2045,985,1060,359,339,199,74,1
7933,392,156,236,40,91,28,16,1506,722,784,216,177,116,54,1
7934,750,347,403,105,103,83,29,455,218,237,57,51,42,35,1
7935,297,158,139,47,37,37,9,490,198,292,65,81,39,27,1
7936,788,420,368,93,89,98,23,339,183,156,43,45,28,17,1
7937,379,203,176,55,48,45,16,740,385,355,114,97,91,27,1
7938,670,333,337,95,79,62,21,113,54,59,10,12,13,7,1
7939,350,180,170,64,46,55,12,351,183,168,55,44,33,9,1
7940,931,491,440,127,116,118,44,2671,1322,1349,379,345,290,135,1
7941,1050,482,568,136,154,101,41,951,506,445,107,118,79,40,1
7942,385,179,206,58,56,38,19,454,191,263,61,66,38,15,1
7943,218,115,103,32,32,34,11,673,317,356,101,85,76,49,1
7944,480,234,246,79,77,65,23,467,226,241,55,48,54,23,1
7945,297,183,114,31,22,46,14,873,366,507,127,125,75,21,1
7946,859,429,430,126,115,64,33,847,467,380,117,101,67,24,1
7947,380,184,196,58,52,46,8,471,231,240,76,58,44,8,1
7948,1220,633,587,137,114,114,44,325,159,166,39,40,41,14,1
7949,434,237,197,52,64,37,14,137,60,77,23,23,9,6,1
7950,595,272,323,111,107,54,28,298,160,138,37,30,22,12,1
7951,593,305,288,86,67,76,23,255,113,142,31,40,18,9,1
7952,532,301,231,64,58,56,17,535,301,234,66,61,53,21,1
7953,1290,629,661,191,187,167,55,537,276,261,75,68,68,22,1
7954,1691,1159,532,160,109,95,46,2477,1186,1291,256,271,249,90,1
7955,168,67,101,37,17,13,13,114,71,43,8,18,7,4,1
7956,707,391,316,111,80,54,30,282,163,119,40,23,25,17,1
7957,425,224,201,58,56,40,16,217,109,108,34,32,35,7,1
7958,379,203,176,55,48,45,16,744,385,359,125,89,90,23,1
7959,456,228,228,49,70,32,19,309,106,203,66,49,25,10,1
7960,352,212,140,37,17,61,20,178,116,62,22,11,15,8,1
7961,358,170,188,54,55,20,10,1480,789,691,195,151,173,55,1
7962,1692,713,979,325,210,122,58,220,102,118,26,32,27,10,1
7963,522,285,237,68,38,73,29,131,81,50,17,3,5,8,1
7964,767,392,375,113,112,83,13,543,287,256,71,66,64,23,1
7965,586,254,332,114,111,55,17,375,202,173,46,49,41,23,1
7966,789,362,427,90,82,70,35,595,316,279,86,60,65,40,1
7967,832,428,404,131,89,88,38,601,290,311,92,89,55,30,1
7968,495,232,263,84,61,39,11,1149,568,581,177,133,101,30,1
7969,344,151,193,59,51,30,9,220,106,114,32,26,15,7,1
7970,906,455,451,116,105,87,46,245,112,133,32,45,20,10,1
7971,603,282,321,74,68,60,38,920,492,428,100,92,88,49,1
7972,391,208,183,65,49,57,17,493,284,209,76,29,48,30,1
7973,651,331,320,93,93,51,28,289,164,125,37,31,35,16,1
7974,548,250,298,85,64,56,21,834,335,499,129,110,84,33,1
7975,1094,611,483,101,89,103,52,767,410,357,91,78,91,41,1
7976,264,121,143,57,32,22,15,510,252,258,75,60,57,24,1
7977,817,397,420,120,152,48,17,173,110,63,35,6,9,8,1
7978,908,489,419,114,131,79,46,455,218,237,57,51,42,35,1
7979,245,112,133,32,45,20,10,473,212,261,72,64,45,28,1
7980,613,334,279,90,71,51,17,1113,480,633,170,173,81,34,1
7981,1147,483,664,200,195,95,53,233,94,139,36,37,15,8,1
7982,537,276,261,75,68,68,22,2315,1086,1229,231,306,248,64,1
7983,362,233,129,37,17,51,18,354,169,185,54,54,41,19,1
7984,258,141,117,33,29,23,10,673,329,344,111,95,92,41,1
7985,695,307,388,117,101,38,15,201,102,99,25,26,19,7,1
7986,192,92,100,36,20,14,6,177,95,82,18,11,25,10,1
7987,360,192,168,55,45,48,16,384,206,178,52,35,39,21,1
7988,764,347,417,97,137,74,28,307,162,145,38,46,41,15,1
7989,198,102,96,27,20,21,12,666,420,246,60,67,36,21,1
7990,215,117,98,43,22,27,5,320,163,157,44,44,26,15,1
7991,150,74,76,21,22,18,7,184,95,89,22,22,19,7,1
7992,429,219,210,46,66,42,17,638,260,378,96,100,53,28,1
7993,1328,661,667,210,147,126,55,1036,511,525,136,89,94,56,1
7994,350,180,170,64,46,55,12,435,208,227,68,64,53,23,1
7995,733,346,387,98,113,66,26,2725,1490,1235,339,333,254,78,1
7996,219,124,95,22,22,23,5,496,295,201,57,42,52,19,1
7997,91,50,41,12,5,10,7,3396,1499,1897,325,572,309,90,1
7998,624,308,316,92,72,68,22,1271,599,672,194,175,118,47,1
7999,608,336,272,61,49,78,31,326,167,159,46,31,38,13,1
8000,202,99,103,24,25,19,12,728,343,385,116,82,96,57,1
8001,295,158,137,42,34,38,14,249,111,138,40,30,22,17,1
8002,2416,1280,1136,140,374,175,47,354,193,161,51,41,58,13,1
8003,247,110,137,34,45,23,10,1675,875,800,213,219,196,72,1
8004,298,167,131,47,33,40,8,358,212,146,51,36,33,9,1
8005,963,455,508,126,110,68,29,331,169,162,40,28,22,14,1
8006,763,447,316,83,69,119,23,845,402,443,137,126,105,47,1
8007,1357,505,852,245,256,70,35,647,322,325,104,98,54,14,1
8008,277,141,136,35,21,16,22,470,226,244,81,53,59,39,1
8009,986,499,487,123,116,98,54,537,276,261,75,68,68,22,1
8010,257,140,117,46,24,15,7,146,74,72,26,25,23,4,1
8011,426,228,198,62,42,47,22,2414,1189,1225,277,178,170,169,1
8012,2224,1037,1187,288,276,273,74,423,220,203,51,54,46,17,1
8013,247,110,137,34,45,23,10,332,175,157,46,43,41,9,1
8014,969,505,464,123,133,92,33,745,366,379,110,93,79,45,1
8015,2442,1193,1249,278,183,170,145,3144,1617,1527,367,342,278,136,1
8016,845,402,443,137,126,105,47,1210,592,618,157,138,116,85,1
8017,1447,698,749,214,180,116,46,381,220,161,43,34,47,16,1
8018,592,264,328,86,85,62,41,625,342,283,62,53,56,28,1
8019,683,294,389,110,104,54,22,862,409,453,149,125,86,29,1
8020,628,324,304,83,85,75,23,503,263,240,72,55,51,34,1
8021,841,329,512,137,163,35,26,922,491,431,112,92,97,52,1
8022,537,288,249,60,60,61,19,499,252,247,75,71,65,25,1
8023,226,109,117,38,36,13,11,118,45,73,24,20,7,4,1
8024,573,271,302,56,64,55,18,739,471,268,55,70,34,9,1
8025,311,182,129,27,33,40,20,176,84,92,29,18,19,10,1
8026,300,140,160,39,35,14,12,341,154,187,34,36,11,11,1
8027,712,396,316,78,69,65,25,1152,586,566,131,112,117,42,1
8028,1647,794,853,279,235,128,65,1093,407,686,158,205,49,31,1
8029,638,305,333,68,90,70,29,593,266,327,102,84,69,24,1
8030,378,154,224,74,84,35,22,745,366,379,110,93,79,45,1
8031,217,109,108,34,32,35,7,164,88,76,27,20,17,6,1
8032,2063,1024,1039,175,117,80,97,4128,2104,2024,581,505,453,205,1
8033,233,120,113,38,32,20,15,128,54,74,30,13,8,7,1
8034,677,245,432,129,155,72,11,292,163,129,50,27,46,16,1
8035,576,250,326,93,71,34,15,410,208,202,59,58,43,26,1
8036,441,201,240,70,58,55,24,1032,526,506,129,117,119,47,1
8037,205,94,111,29,31,16,7,131,66,65,21,14,23,7,1
8038,536,278,258,72,63,62,20,147,74,73,28,20,24,4,1
8039,341,167,174,48,47,31,8,180,93,87,24,22,19,8,1
8040,498,263,235,59,63,36,10,537,276,261,75,68,68,22,1
8041,815,418,397,97,62,70,17,580,339,241,72,47,66,21,1
8042,427,186,241,55,52,42,23,644,329,315,70,64,50,11,1
8043,247,110,137,34,45,23,10,288,104,184,80,30,39,6,1
8044,604,255,349,100,72,55,26,428,226,202,52,60,75,20,1
8045,815,418,397,97,62,70,17,873,366,507,127,125,75,21,1
8046,593,266,327,102,84,69,24,526,254,272,44,43,49,13,1
8047,1235,636,599,162,145,137,50,467,224,243,70,43,67,23,1
8048,828,405,423,114,106,78,33,247,110,137,34,45,23,10,1
8049,655,281,374,108,103,61,24,272,94,178,76,33,19,4,1
8050,1187,631,556,182,139,152,56,845,402,443,137,126,105,47,1
8051,555,278,277,60,70,48,18,799,377,422,98,95,80,70,1
8052,432,219,213,58,51,39,20,323,181,142,40,37,26,16,1
8053,922,418,504,120,120,106,31,168,120,48,7,5,20,7,1
8054,509,243,266,80,57,45,19,1290,629,661,191,187,167,55,1
8055,767,392,375,113,112,83,13,89,42,47,16,12,15,6,1
8056,753,395,358,93,72,71,16,172,83,89,26,25,18,7,1
8057,448,281,167,47,37,45,13,871,437,434,112,113,83,49,1
8058,422,203,219,75,49,40,22,248,119,129,33,48,20,10,1
8059,847,402,445,109,91,100,37,627,314,313,61,59,71,22,1
8060,748,355,393,121,91,95,26,528,245,283,79,96,53,14,1
8061,345,141,204,64,58,13,11,208,107,101,42,22,18,10,1
8062,847,402,445,137,119,102,41,1290,629,661,191,187,167,55,1
8063,377,201,176,46,50,41,23,402,227,175,48,40,35,11,1
8064,991,483,508,166,120,94,42,755,347,408,101,90,53,29,1
8065,639,397,242,64,37,64,30,193,88,105,29,32,25,9,1
8066,777,408,369,100,96,56,17,686,375,311,89,80,63,20,1
8067,392,156,236,40,91,28,16,205,91,114,31,36,13,8,1
8068,225,111,114,38,22,25,10,755,271,484,113,226,61,20,1
8069,398,196,202,61,45,34,18,298,167,131,47,33,40,8,1
8070,1307,594,713,179,208,102,41,454,191,263,61,66,38,15,1
8071,888,478,410,105,73,58,33,1030,495,535,154,106,116,49,1
8072,580,339,241,72,47,66,21,659,334,325,90,79,72,36,1
8073,246,108,138,32,44,21,10,728,385,343,110,102,69,14,1
8074,812,456,356,105,74,101,29,2419,1042,1377,389,474,238,59,1
8075,499,290,209,59,50,50,19,239,146,93,30,22,35,9,1
8076,575,295,280,89,68,54,18,616,304,312,75,71,55,25,1
8077,591,279,312,88,91,52,26,171,94,77,24,28,30,11,1
8078,1573,791,782,198,173,148,46,352,166,186,55,59,31,16,1
8079,345,203,142,47,35,31,11,271,131,140,47,37,41,11,1
8080,298,154,144,44,34,25,11,543,293,250,77,67,40,25,1
8081,1271,599,672,194,175,118,47,1047,562,485,141,127,114,41,1
8082,1337,667,670,137,143,140,35,781,418,363,92,90,64,41,1
8083,490,198,292,65,81,39,27,245,111,134,31,44,20,11,1
8084,770,356,414,123,102,66,25,1690,810,880,248,238,168,67,1
8085,1018,547,471,122,122,120,33,1040,562,478,125,101,103,32,1
8086,283,112,171,48,39,34,15,785,374,411,56,42,38,25,1
8087,354,168,186,50,53,39,20,450,275,175,57,32,48,15,1
8088,418,223,195,51,45,49,14,323,200,123,33,25,38,18,1
8089,593,266,327,102,84,69,24,787,386,401,98,95,86,25,1
8090,700,369,331,85,84,82,28,708,364,344,79,84,66,28,1
8091,913,407,506,133,143,80,24,216,102,114,31,29,21,6,1
8092,592,292,300,56,52,71,17,284,128,156,48,29,34,8,1
8093,400,195,205,63,67,40,18,412,260,152,39,24,49,23,1
8094,462,251,211,74,53,41,18,231,126,105,37,26,29,6,1
8095,642,299,343,96,77,75,31,595,316,279,86,60,65,40,1
8096,976,496,480,128,111,121,48,787,386,401,98,95,86,25,1
8097,356,175,181,58,40,33,26,1147,471,676,229,164,86,37,1
8098,122,52,70,24,22,7,6,131,66,65,21,14,23,7,1
8099,504,237,267,62,66,48,17,462,251,211,74,53,41,18,1
8100,545,269,276,80,76,27,32,609,292,317,102,96,64,21,1
8101,461,223,238,66,57,36,23,463,236,227,64,50,44,29,1
8102,468,212,256,70,45,30,18,292,162,130,43,27,21,12,1
8103,4544,2024,2520,579,628,480,403,357,153,204,84,62,39,2,1
8104,243,140,103,33,27,31,12,503,263,240,72,55,51,34,1
8105,480,252,228,55,37,49,20,292,153,139,39,33,24,21,1
8106,482,231,251,76,81,64,26,489,253,236,73,36,62,17,1
8107,651,323,328,90,65,64,24,572,298,274,72,67,52,20,1
8108,225,116,109,29,19,25,6,525,281,244,69,68,65,25,1
8109,785,374,411,56,42,38,25,331,193,138,44,37,18,9,1
8110,390,191,199,57,49,45,25,388,245,143,45,25,41,16,1
8111,419,189,230,64,49,36,15,616,304,312,75,71,55,25,1
8112,732,355,377,108,109,79,27,1187,631,556,182,139,152,56,1
8113,202,103,99,28,20,12,8,320,163,157,44,44,26,15,1
8114,624,308,316,92,72,68,22,504,245,259,64,54,42,14,1
8115,350,180,170,64,46,55,12,250,164,86,22,15,30,4,1
8116,2524,1232,1292,398,317,186,61,505,247,258,72,71,60,27,1
8117,2041,1035,1006,223,274,125,60,211,138,73,14,11,22,17,1
8118,546,265,281,101,64,38,16,112,59,53,12,17,14,8,1
8119,345,141,204,64,58,13,11,233,121,112,24,31,30,7,1
8120,509,243,266,80,57,45,19,551,299,252,51,62,63,17,1
8121,657,293,364,109,75,66,28,378,154,224,74,84,35,22,1
8122,176,73,103,22,29,13,9,684,311,373,109,99,66,16,1
8123,728,385,343,110,102,69,14,972,519,453,109,98,120,39,1
8124,1177,666,511,131,99,88,35,702,298,404,134,111,48,18,1
8125,181,75,106,35,26,11,9,806,436,370,101,100,76,34,1
8126,1455,765,690,189,162,166,66,1105,544,561,165,167,98,40,1
8127,1232,497,735,204,201,64,53,1162,515,647,191,143,97,35,1
8128,619,332,287,95,77,74,38,533,254,279,81,78,52,10,1
8129,300,212,88,26,7,38,11,359,173,186,55,57,44,16,1
8130,427,210,217,64,66,45,24,428,214,214,65,67,45,23,1
8131,287,146,141,36,28,29,16,1247,548,699,168,150,140,43,1
8132,478,239,239,65,66,65,21,402,222,180,50,39,51,19,1
8133,355,168,187,55,48,40,15,663,323,340,89,89,76,22,1
8134,938,484,454,137,100,104,41,1675,875,800,213,219,196,72,1
8135,299,158,141,45,31,21,5,428,226,202,52,60,75,20,1
8136,510,262,248,60,64,44,17,1834,823,1011,297,282,151,63,1
8137,1696,771,925,257,225,149,63,322,143,179,41,62,23,11,1
8138,429,219,210,46,66,42,17,147,78,69,19,15,19,7,1
8139,636,336,300,94,65,58,32,356,185,171,37,31,17,21,1
8140,320,163,157,44,44,26,15,414,216,198,51,32,42,28,1
8141,271,120,151,41,31,24,10,335,143,192,57,61,30,10,1
8142,463,244,219,54,58,47,21,81,41,40,15,13,3,2,1
8143,158,83,75,22,14,17,9,250,123,127,40,28,29,8,1
8144,419,226,193,58,38,39,22,503,263,240,72,55,51,34,1
8145,398,200,198,68,43,51,14,848,394,454,100,90,101,41,1
8146,462,251,211,74,53,41,18,180,96,84,21,22,17,15,1
8147,464,242,222,61,68,36,17,330,157,173,56,42,51,8,1
8148,168,67,101,37,17,13,13,1051,523,528,164,140,126,50,1
8149,595,272,323,111,107,54,28,777,387,390,90,87,65,37,1
8150,467,226,241,55,48,54,23,434,205,229,51,55,24,13,1
8151,328,160,168,37,34,35,12,132,67,65,22,15,17,5,1
8152,320,159,161,44,54,29,9,375,202,173,46,49,41,23,1
8153,510,264,246,67,66,38,29,399,201,198,65,45,48,17,1
8154,351,184,167,59,45,54,9,2138,1161,977,258,229,249,95,1
8155,2442,1193,1249,278,183,170,145,1464,693,771,153,136,91,86,1
8156,375,226,149,39,38,19,14,359,184,175,49,35,32,11,1
8157,626,333,293,64,55,61,15,830,402,428,80,67,100,80,1
8158,778,353,425,140,89,92,51,446,176,270,64,79,45,24,1
8159,504,252,252,65,55,51,14,509,245,264,85,71,56,22,1
8160,179,92,87,23,20,22,12,552,285,267,74,51,69,24,1
8161,118,51,67,25,13,6,7,437,225,212,61,57,66,12,1
8162,313,160,153,51,33,43,23,525,274,251,82,74,60,25,1
8163,1573,791,782,198,173,148,46,217,109,108,34,32,35,7,1
8164,112,59,53,12,17,14,8,942,423,519,130,126,104,50,1
8165,731,372,359,101,80,58,21,467,224,243,70,43,67,23,1
8166,350,180,170,64,46,55,12,107,36,71,27,15,0,1,1
8167,2109,999,1110,332,294,187,89,439,202,237,80,53,35,15,1
8168,440,218,222,58,66,40,24,540,265,275,87,59,74,25,1
8169,259,132,127,39,32,28,12,552,285,267,74,51,69,24,1
8170,272,124,148,51,36,23,27,1132,646,486,99,102,71,41,1
8171,351,184,167,59,45,54,9,411,267,144,55,23,24,21,1
8172,326,153,173,63,48,25,8,911,423,488,140,150,102,32,1
8173,132,60,72,19,17,17,6,205,123,82,22,8,31,5,1
8174,1190,638,552,162,95,112,18,3801,1837,1964,510,442,418,170,1
8175,476,227,249,52,59,38,17,275,140,135,38,32,18,5,1
8176,985,551,434,123,93,91,26,435,225,210,58,46,50,14,1
8177,214,109,105,31,26,25,17,503,263,240,72,55,51,34,1
8178,610,284,326,99,98,58,38,429,219,210,46,66,42,17,1
8179,380,212,168,47,38,19,11,140,81,59,16,15,15,12,1
8180,635,333,302,99,75,83,28,374,184,190,52,38,48,11,1
8181,706,354,352,82,61,32,30,425,210,215,56,43,52,25,1
8182,603,311,292,102,71,66,23,1382,599,783,208,252,90,39,1
8183,432,218,214,57,55,42,11,1093,587,506,99,76,106,41,1
8184,294,148,146,35,33,25,14,86,50,36,9,14,8,7,1
8185,113,47,66,14,15,11,17,105,53,52,23,11,12,6,1
8186,326,153,173,63,48,25,8,1234,590,644,180,182,95,40,1
8187,389,199,190,51,56,41,21,498,233,265,83,53,65,23,1
8188,355,166,189,54,54,39,17,355,214,141,43,29,63,13,1
8189,1914,892,1022,272,267,143,79,672,334,338,110,93,91,41,1
8190,182,71,111,45,36,11,13,278,111,167,66,66,19,8,1
8191,563,299,264,78,79,68,26,200,91,109,29,34,24,7,1
8192,422,211,211,73,61,43,17,447,222,225,71,54,44,25,1
8193,313,178,135,43,18,35,6,433,221,212,59,42,47,14,1
8194,236,110,126,31,39,10,8,1233,635,598,187,149,146,51,1
8195,982,545,437,119,100,92,40,467,224,243,70,43,67,23,1
8196,382,179,203,58,54,29,19,476,220,256,65,65,41,21,1
8197,764,409,355,88,73,102,43,354,168,186,50,53,39,20,1
8198,426,228,198,62,42,47,22,360,188,172,49,48,47,17,1
8199,767,392,375,113,112,83,13,1445,702,743,197,178,171,55,1
8200,1298,591,707,196,168,124,58,1893,764,1129,308,323,126,60,1
8201,1085,646,439,108,65,36,19,300,140,160,39,35,14,12,1
8202,321,173,148,47,27,39,17,723,335,388,90,84,77,74,1
8203,615,339,276,82,76,63,16,1174,594,580,175,155,126,66,1
8204,171,85,86,23,16,20,10,292,150,142,31,43,39,16,1
8205,205,100,105,25,25,20,9,656,292,364,79,102,69,35,1
8206,686,375,311,89,80,63,20,175,88,87,29,21,18,5,1
8207,592,291,301,92,93,71,31,748,386,362,111,75,71,40,1
8208,1424,650,774,152,124,95,87,745,366,379,110,93,79,45,1
8209,439,177,262,78,73,40,21,3056,1457,1599,438,389,329,168,1
8210,886,440,446,116,140,95,45,326,161,165,55,43,21,12,1
8211,692,305,387,100,97,78,30,1972,846,1126,222,330,114,68,1
8212,2157,1171,986,306,238,131,32,418,248,170,41,31,54,9,1
8213,623,233,390,145,83,43,20,457,237,220,69,44,53,26,1
8214,404,239,165,48,38,38,19,414,216,198,51,32,42,28,1
8215,296,147,149,45,29,30,23,260,144,116,30,34,38,9,1
8216,981,483,498,144,151,106,38,1393,712,681,174,180,144,55,1
8217,451,238,213,53,64,56,22,317,153,164,34,52,30,14,1
8218,355,168,187,48,57,30,15,439,177,262,78,73,40,21,1
8219,825,422,403,100,90,62,43,1675,875,800,213,219,196,72,1
8220,1190,638,552,162,95,112,18,201,42,159,19,3,2,75,1
8221,1590,726,864,270,237,126,59,941,459,482,167,140,82,38,1
8222,199,101,98,29,25,18,6,452,224,228,69,56,50,31,1
8223,583,322,261,73,66,45,26,290,149,141,37,26,41,12,1
8224,1570,771,799,241,181,137,41,540,306,234,74,52,43,22,1
8225,98,45,53,16,11,15,3,412,238,174,41,38,43,19,1
8226,505,254,251,80,77,60,15,492,317,175,42,31,63,23,1
8227,414,211,203,52,49,40,19,501,240,261,80,62,49,42,1
8228,1434,727,707,210,173,161,54,477,301,176,52,35,45,24,1
8229,240,125,115,34,32,30,8,315,154,161,34,51,30,11,1
8230,802,429,373,68,101,88,23,625,298,327,90,78,57,33,1
8231,462,251,211,74,53,41,18,471,238,233,66,63,62,19,1
8232,740,313,427,101,135,40,22,1102,511,591,171,179,148,52,1
8233,61,16,45,8,4,0,21,402,227,175,48,40,35,11,1
8234,1374,679,695,191,193,154,48,204,84,120,29,30,16,9,1
8235,753,318,435,154,95,56,23,112,59,53,12,17,14,8,1
8236,794,390,404,103,95,86,23,352,212,140,37,17,61,20,1
8237,1332,626,706,182,144,80,41,1484,731,753,206,175,187,71,1
8238,245,112,133,32,45,20,10,412,203,209,69,57,68,21,1
8239,277,122,155,33,33,25,24,1124,615,509,157,125,128,52,1
8240,429,219,210,46,66,42,17,180,95,85,30,20,29,10,1
8241,480,234,246,79,77,65,23,1863,721,1142,262,283,139,74,1
8242,208,96,112,31,32,13,9,208,104,104,20,54,9,5,1
8243,350,214,136,33,23,49,27,98,48,50,18,4,9,8,1
8244,780,337,443,112,116,77,28,386,181,205,55,51,57,31,1
8245,728,385,343,110,102,69,14,1068,559,509,158,132,122,57,1
8246,419,207,212,78,40,46,23,331,169,162,40,28,22,14,1
8247,224,124,100,30,34,11,6,770,390,380,104,76,78,32,1
8248,410,200,210,60,54,46,19,462,233,229,66,49,43,30,1
8249,496,251,245,78,62,61,23,220,117,103,26,39,14,13,1
8250,425,210,215,56,43,52,25,1141,583,558,141,98,91,45,1
8251,1203,685,518,142,99,112,42,889,524,365,111,79,88,42,1
8252,522,235,287,78,67,60,50,440,218,222,58,66,40,24,1
8253,1338,756,582,155,105,104,44,624,308,316,92,72,68,22,1
8254,440,218,222,58,66,40,24,117,60,57,24,19,21,2,1
8255,179,80,99,16,18,24,13,231,102,129,35,22,24,13,1
8256,858,417,441,93,124,75,26,211,101,110,40,27,17,12,1
8257,1669,1162,507,154,128,86,51,2944,1827,1117,338,332,122,35,1
8258,191,101,90,21,23,28,5,281,166,115,34,17,36,16,1
8259,300,140,160,39,35,14,12,2442,1193,1249,278,183,170,145,1
8260,579,246,333,102,79,41,19,579,250,329,90,61,62,45,1
8261,493,230,263,73,47,47,13,421,206,215,63,57,35,11,1
8262,502,240,262,78,61,54,32,833,389,444,126,111,85,31,1
8263,454,191,263,61,66,38,15,928,442,486,139,118,91,43,1
8264,467,226,241,55,48,54,23,344,201,143,42,39,41,14,1
8265,706,320,386,111,76,75,51,2414,1189,1225,277,178,170,169,1
8266,507,242,265,53,44,31,22,320,163,157,44,44,26,15,1
8267,469,247,222,70,58,82,13,742,303,439,88,96,86,23,1
8268,467,226,241,55,48,54,23,334,172,162,43,39,41,17,1
8269,313,157,156,39,26,34,29,1447,751,696,161,143,131,46,1
8270,236,91,145,44,36,17,12,636,336,300,94,65,58,32,1
8271,391,208,183,65,49,57,17,299,153,146,32,28,29,12,1
8272,624,204,420,166,101,32,13,731,383,348,102,84,68,30,1
8273,89,42,47,16,12,15,6,1855,852,1003,329,264,184,83,1
8274,512,256,256,77,64,66,24,503,263,240,72,55,51,34,1
8275,362,225,137,43,22,30,11,109,50,59,20,7,10,9,1
8276,634,317,317,79,67,76,28,1327,690,637,194,140,130,52,1
8277,828,393,435,105,110,81,33,738,358,380,106,99,62,25,1
8278,1092,562,530,126,91,125,84,2489,1251,1238,288,234,283,178,1
8279,378,192,186,49,36,45,23,144,70,74,15,17,13,10,1
8280,1256,595,661,153,143,106,130,390,203,187,58,40,43,19,1
8281,1190,537,653,207,186,101,26,915,336,579,185,199,56,29,1
8282,636,288,348,94,77,65,30,870,415,455,112,103,93,51,1
8283,1189,559,630,179,147,118,35,825,427,398,79,95,81,48,1
8284,775,324,451,130,140,45,15,1943,846,1097,301,257,135,77,1
8285,1048,564,484,118,122,113,40,825,363,462,97,105,72,75,1
8286,278,146,132,43,27,22,11,282,135,147,27,37,30,19,1
8287,794,402,392,96,84,86,30,4544,2024,2520,579,628,480,403,1
8288,780,359,421,160,78,169,16,201,42,159,19,3,2,75,1
8289,235,135,100,30,13,25,11,1304,585,719,179,169,154,47,1
8290,689,343,346,119,100,86,38,372,237,135,38,22,39,26,1
8291,433,221,212,59,42,47,14,781,418,363,92,90,64,41,1
8292,3097,1431,1666,473,433,300,121,193,99,94,31,31,16,12,1
8293,1098,552,546,157,133,110,58,395,195,200,41,55,23,10,1
8294,609,292,317,102,96,64,21,738,339,399,102,88,68,35,1
8295,525,274,251,82,74,60,25,725,339,386,112,122,93,32,1
8296,406,210,196,68,60,25,20,785,374,411,56,42,38,25,1
8297,432,218,214,57,55,42,11,1004,457,547,150,150,74,52,1
8298,391,165,226,56,104,38,12,393,186,207,58,50,36,22,1
8299,181,71,110,34,30,21,7,149,68,81,15,38,11,10,1
8300,463,238,225,49,35,31,14,609,292,317,102,96,64,21,1
8301,394,199,195,61,52,55,26,361,184,177,50,53,51,22,1
8302,825,399,426,128,128,77,32,1336,828,508,166,121,152,48,1
8303,136,65,71,33,11,9,6,904,436,468,138,146,82,39,1
8304,250,130,120,40,32,19,13,1914,768,1146,327,268,227,120,1
8305,632,285,347,102,78,43,29,227,105,122,37,29,19,12,1
8306,1278,593,685,198,201,71,43,2390,1131,1259,395,383,203,74,1
8307,295,135,160,48,43,29,11,631,309,322,106,83,89,33,1
8308,464,242,222,61,68,36,17,325,184,141,43,34,22,18,1
8309,371,174,197,53,56,43,15,2414,1189,1225,277,178,170,169,1
8310,400,207,193,30,36,12,10,740,313,427,101,135,40,22,1
8311,316,156,160,34,28,32,14,224,123,101,23,24,33,6,1
8312,355,186,169,54,41,35,15,374,235,139,33,16,72,21,1
8313,576,250,326,93,71,34,15,276,150,126,43,32,33,9,1
8314,814,370,444,121,108,85,36,1074,538,536,154,140,111,51,1
8315,2045,985,1060,359,339,199,74,222,106,116,31,27,27,15,1
8316,623,233,390,145,83,43,20,176,73,103,22,29,13,9,1
8317,598,301,297,76,53,71,36,334,172,162,43,39,41,17,1
8318,529,264,265,59,68,41,17,2442,1193,1249,278,183,170,145,1
8319,2442,1193,1249,278,183,170,145,413,236,177,41,25,35,19,1
8320,380,187,193,38,51,30,18,347,198,149,45,29,29,8,1
8321,781,418,363,92,90,64,41,124,62,62,17,14,7,5,1
8322,592,295,297,79,70,76,11,349,131,218,66,76,22,9,1
8323,103,56,47,27,7,8,2,165,83,82,16,29,11,9,1
8324,557,268,289,66,67,70,17,189,89,100,24,26,18,15,1
8325,334,162,172,34,33,32,21,388,195,193,54,48,35,23,1
8326,839,427,412,91,83,114,37,858,448,410,98,83,122,29,1
8327,229,105,124,36,33,12,4,1255,666,589,145,142,120,82,1
8328,460,199,261,72,63,60,9,1048,564,484,118,122,113,40,1
8329,400,195,205,63,67,40,18,418,204,214,68,66,38,12,1
8330,4684,2161,2523,779,782,304,101,577,241,336,112,109,47,21,1
8331,815,418,397,97,62,70,17,1097,588,509,128,86,84,31,1
8332,190,94,96,25,24,18,5,183,92,91,26,28,17,7,1
8333,380,184,196,58,52,46,8,553,261,292,73,79,40,26,1
8334,201,98,103,26,35,16,5,2477,1186,1291,256,271,249,90,1
8335,593,266,327,102,84,69,24,1390,695,695,180,137,170,71,1
8336,1134,539,595,150,146,78,40,963,455,508,127,130,115,48,1
8337,520,223,297,90,60,48,13,2512,1328,1184,379,280,301,113,1
8338,806,436,370,101,100,76,34,1117,423,694,182,134,88,31,1
8339,464,237,227,64,66,33,12,160,53,107,31,29,13,3,1
8340,145,75,70,22,18,10,5,1117,423,694,182,134,88,31,1
8341,1070,558,512,154,134,126,54,724,334,390,112,109,79,17,1
8342,428,226,202,52,60,75,20,605,281,324,111,67,40,44,1
8343,310,156,154,27,43,20,6,99,50,49,18,11,8,6,1
8344,1049,585,464,107,108,120,28,1516,963,553,148,152,111,26,1
8345,744,385,359,125,89,90,23,595,316,279,86,60,65,40,1
8346,1464,693,771,153,136,91,86,598,322,276,67,57,63,26,1
8347,900,484,416,119,110,77,29,288,138,150,82,22,25,5,1
8348,177,99,78,22,23,20,10,318,164,154,52,43,34,10,1
8349,489,242,247,83,63,62,19,529,264,265,59,68,41,17,1
8350,160,60,100,23,40,19,11,551,237,314,95,79,54,17,1
8351,1480,789,691,195,151,173,55,737,363,374,119,101,85,41,1
8352,1328,661,667,210,147,126,55,1050,561,489,138,91,90,41,1
8353,459,221,238,52,56,51,19,1154,540,614,195,160,138,66,1
8354,695,264,431,172,114,51,23,1382,599,783,208,252,90,39,1
8355,677,323,354,101,109,45,31,1068,527,541,160,131,112,52,1
8356,743,341,402,104,89,68,38,957,436,521,138,126,101,41,1
8357,1210,592,618,157,138,116,85,1255,666,589,145,142,120,82,1
8358,586,273,313,100,79,40,19,434,189,245,76,69,43,18,1
8359,339,177,162,40,36,51,24,195,83,112,40,16,19,16,1
8360,287,153,134,36,26,32,11,1117,423,694,182,134,88,31,1
8361,281,154,127,45,31,24,9,271,131,140,47,37,41,11,1
8362,793,413,380,105,120,57,23,425,210,215,56,43,52,25,1
8363,672,334,338,110,93,91,41,394,183,211,65,60,35,18,1
8364,360,192,168,55,45,48,16,665,304,361,90,72,63,28,1
8365,1321,679,642,154,167,133,58,1040,562,478,125,101,103,32,1
8366,425,210,215,56,43,52,25,299,110,189,54,75,17,4,1
8367,422,203,219,75,49,40,22,246,113,133,33,45,22,10,1
8368,1395,627,768,172,263,141,59,390,237,153,41,57,22,16,1
8369,247,110,137,34,45,23,10,730,442,288,104,88,42,68,1
8370,579,281,298,91,78,74,27,1227,545,682,218,202,121,49,1
8371,686,375,311,89,80,63,20,525,299,226,54,54,51,19,1
8372,1248,584,664,184,164,155,67,641,324,317,88,92,49,14,1
8373,1342,673,669,178,154,137,94,317,152,165,43,40,27,26,1
8374,982,545,437,119,100,92,40,583,322,261,73,66,45,26,1
8375,162,93,69,24,19,17,7,589,314,275,70,83,44,28,1
8376,2524,1232,1292,398,317,186,61,743,366,377,41,37,26,14,1
8377,255,122,133,35,51,22,13,1367,690,677,172,175,154,83,1
8378,356,208,148,42,26,57,15,593,266,327,102,84,69,24,1
8379,372,184,188,55,55,30,8,452,236,216,73,54,50,29,1
8380,475,243,232,67,54,39,15,374,181,193,55,58,48,23,1
8381,24,14,10,4,2,1,2,462,251,211,74,53,41,18,1
8382,1038,422,616,183,175,75,32,1030,368,662,172,188,56,20,1
8383,1970,978,992,245,206,198,80,261,137,124,38,37,29,9,1
8384,1446,762,684,193,160,182,67,354,166,188,53,55,40,19,1
8385,714,364,350,98,102,91,27,241,115,126,35,30,17,14,1
8386,326,153,173,63,48,25,8,413,227,186,45,34,58,23,1
8387,376,183,193,50,50,43,21,367,161,206,70,48,41,19,1
8388,301,170,131,38,23,35,11,848,461,387,111,102,108,42,1
8389,75,37,38,11,9,5,8,395,186,209,53,48,46,30,1
8390,323,162,161,53,41,40,13,162,77,85,22,16,21,11,1
8391,1447,698,749,214,180,116,46,400,215,185,59,54,33,16,1
8392,1721,809,912,268,234,144,50,1032,426,606,172,172,80,35,1
8393,255,126,129,36,20,21,29,416,201,215,54,52,39,25,1
8394,1730,801,929,328,213,219,64,901,443,458,134,141,88,40,1
8395,956,403,553,147,135,99,87,1691,1159,532,160,109,95,46,1
8396,390,220,170,55,37,44,19,332,180,152,46,36,28,14,1
8397,346,180,166,55,49,38,6,361,184,177,50,53,51,22,1
8398,570,318,252,77,48,93,26,348,187,161,50,35,44,9,1
8399,582,293,289,94,80,77,32,1257,464,793,221,264,75,37,1
8400,326,143,183,53,53,24,5,666,344,322,91,73,91,20,1
8401,202,102,100,29,35,6,9,694,260,434,122,92,62,36,1
8402,454,223,231,38,45,24,19,825,399,426,128,128,77,32,1
8403,790,343,447,90,191,35,17,392,115,277,117,75,28,17,1
8404,468,238,230,67,69,39,26,24,14,10,4,2,1,2,1
8405,622,299,323,86,86,69,35,352,183,169,41,40,38,26,1
8406,76,42,34,12,8,5,7,167,79,88,22,26,16,9,1
8407,396,181,215,52,47,48,19,395,189,206,63,50,49,28,1
8408,631,315,316,64,57,49,15,104,52,52,18,14,17,4,1
8409,673,329,344,111,95,92,41,475,247,228,62,45,75,24,1
8410,656,358,298,67,47,64,26,639,310,329,91,94,46,15,1
8411,1132,553,579,172,143,150,57,635,326,309,70,61,77,30,1
8412,1172,545,627,156,135,85,96,986,465,521,152,132,138,51,1
8413,103,44,59,16,17,9,5,410,200,210,60,54,46,19,1
8414,518,264,254,58,55,42,23,671,321,350,95,87,75,34,1
8415,1241,670,571,135,139,110,32,536,278,258,72,63,62,20,1
8416,489,253,236,68,68,46,23,300,145,155,53,43,42,9,1
8417,655,281,374,108,103,61,24,304,127,177,61,38,31,4,1
8418,316,157,159,45,38,22,19,904,436,468,138,146,82,39,1
8419,589,316,273,83,60,69,25,353,196,157,51,39,49,8,1
8420,524,281,243,71,58,63,21,568,243,325,98,73,56,44,1
8421,176,122,54,8,7,30,9,204,84,120,29,30,16,9,1
8422,798,385,413,120,115,79,30,355,179,176,51,45,45,11,1
8423,703,414,289,75,61,68,26,338,179,159,44,45,42,16,1
8424,209,125,84,20,22,22,6,527,257,270,72,68,50,28,1
8425,186,98,88,26,24,27,8,1068,527,541,160,131,112,52,1
8426,624,222,402,92,81,39,15,158,74,84,26,23,18,18,1
8427,1084,537,547,154,121,92,35,463,231,232,66,69,29,18,1
8428,448,229,219,60,50,46,16,624,308,316,92,72,68,22,1
8429,1447,814,633,171,141,183,58,433,237,196,60,52,33,27,1
8430,301,149,152,40,39,34,10,245,112,133,32,45,20,10,1
8431,1222,648,574,138,139,132,38,1270,557,713,130,195,57,30,1
8432,617,340,277,73,64,81,29,188,114,74,18,19,29,8,1
8433,453,216,237,58,60,67,20,661,306,355,90,83,91,50,1
8434,914,453,461,112,115,79,29,189,90,99,26,29,17,11,1
8435,1139,536,603,162,139,109,50,298,167,131,47,33,40,8,1
8436,1497,881,616,151,117,94,40,4684,2161,2523,779,782,304,101,1
8437,619,290,329,97,79,62,19,1800,882,918,202,185,186,49,1
8438,328,184,144,47,24,23,9,467,224,243,70,43,67,23,1
8439,261,126,135,41,36,24,11,546,285,261,71,49,47,24,1
8440,530,259,271,83,50,54,41,425,210,215,56,43,52,25,1
8441,149,68,81,15,38,11,10,415,242,173,53,21,70,21,1
8442,353,196,157,51,39,49,8,391,208,183,65,49,57,17,1
8443,418,205,213,69,50,29,15,204,99,105,32,32,22,10,1
8444,380,196,184,59,27,65,16,858,417,441,93,124,75,26,1
8445,337,152,185,49,54,42,21,378,154,224,74,84,35,22,1
8446,710,307,403,117,176,37,9,143,65,78,32,11,11,11,1
8447,900,484,416,119,110,77,29,419,175,244,71,73,23,23,1
8448,656,358,298,67,47,64,26,486,192,294,91,79,32,19,1
8449,933,536,397,96,90,71,41,803,358,445,135,117,80,44,1
8450,576,250,326,93,71,34,15,853,355,498,122,156,91,29,1
8451,302,138,164,50,36,30,20,316,156,160,43,42,28,17,1
8452,236,110,126,31,39,10,8,232,101,131,44,34,19,8,1
8453,148,64,84,33,19,6,1,149,68,81,15,38,11,10,1
8454,325,186,139,49,36,20,5,303,147,156,49,49,20,8,1
8455,916,344,572,168,220,47,10,1020,410,610,220,221,32,13,1
8456,1241,670,571,135,139,110,32,543,287,256,71,66,64,23,1
8457,168,76,92,26,21,19,4,311,187,124,39,38,35,12,1
8458,623,316,307,81,82,51,25,5938,2573,3365,858,958,396,195,1
8459,938,484,454,137,100,104,41,740,385,355,114,97,91,27,1
8460,565,286,279,84,50,59,46,1063,578,485,116,121,117,39,1
8461,2541,1299,1242,306,302,121,98,798,378,420,99,94,71,63,1
8462,663,323,340,89,89,76,22,1834,823,1011,297,282,151,63,1
8463,1822,879,943,236,227,175,97,1390,695,695,180,137,170,71,1
8464,379,203,176,55,48,45,16,562,265,297,79,56,72,45,1
8465,330,143,187,63,29,52,20,836,408,428,112,85,88,45,1
8466,345,176,169,34,31,36,11,285,148,137,31,42,42,16,1
8467,586,273,313,100,79,40,19,826,362,464,107,118,71,43,1
8468,390,191,199,66,49,43,12,1274,669,605,185,172,116,43,1
8469,435,208,227,68,64,53,23,1271,599,672,194,175,118,47,1
8470,178,89,89,26,21,21,10,405,218,187,49,45,45,22,1
8471,835,419,416,119,94,106,40,1274,669,605,185,172,116,43,1
8472,265,119,146,44,52,12,9,233,96,137,40,40,13,9,1
8473,330,143,187,63,29,52,20,528,252,276,97,68,58,22,1
8474,740,313,427,101,135,40,22,582,293,289,94,80,77,32,1
8475,429,219,210,46,66,42,17,1261,548,713,194,177,102,54,1
8476,579,250,329,90,61,62,45,776,356,420,122,103,85,30,1
8477,101,41,60,18,19,10,5,815,382,433,97,50,88,31,1
8478,517,274,243,64,62,59,15,1356,576,780,229,198,107,38,1
8479,628,341,287,77,59,55,31,520,224,296,69,64,31,29,1
8480,172,74,98,32,30,11,7,239,121,118,28,38,15,7,1
8481,312,172,140,41,40,21,8,618,290,328,82,74,69,42,1
8482,562,326,236,76,58,71,15,660,359,301,81,87,102,31,1
8483,374,187,187,51,52,40,27,93,63,30,8,4,7,5,1
8484,672,327,345,78,112,74,33,578,248,330,90,80,63,39,1
8485,898,370,528,163,107,80,48,341,178,163,48,44,42,20,1
8486,136,66,70,33,11,9,5,412,193,219,70,56,51,26,1
8487,288,159,129,27,44,27,15,274,158,116,27,27,22,18,1
8488,1215,572,643,151,105,127,54,920,492,428,100,92,88,49,1
8489,1691,1217,474,130,115,73,46,2477,1186,1291,256,271,249,90,1
8490,246,115,131,15,29,10,32,613,263,350,106,75,51,28,1
8491,191,95,96,26,17,17,12,1159,641,518,148,115,114,48,1
8492,357,187,170,51,34,40,23,291,131,160,49,35,32,15,1
8493,824,403,421,80,150,65,35,243,113,130,45,22,25,10,1
8494,394,202,192,44,43,38,28,447,194,253,70,67,57,19,1
8495,235,119,116,31,26,15,13,275,155,120,37,31,16,14,1
8496,624,308,316,92,72,68,22,781,418,363,92,90,64,41,1
8497,219,104,115,43,32,24,11,757,373,384,115,93,95,25,1
8498,267,147,120,37,28,35,12,281,166,115,34,17,36,16,1
8499,238,151,87,15,14,35,18,1091,543,548,146,136,110,34,1
8500,424,209,215,56,58,45,24,1087,536,551,123,115,122,55,1
8501,399,208,191,48,57,53,17,1167,418,749,226,204,88,39,1
8502,372,196,176,51,36,51,8,330,159,171,48,38,50,19,1
8503,473,230,243,80,56,52,35,420,165,255,84,99,47,14,1
8504,345,183,162,37,34,33,16,253,148,105,31,15,39,16,1
8505,1848,833,1015,304,257,195,71,216,102,114,31,29,21,6,1
8506,1140,495,645,129,95,128,159,594,274,320,89,63,66,28,1
8507,143,81,62,28,9,8,1,1863,721,1142,262,283,139,74,1
8508,2477,1186,1291,256,271,249,90,684,288,396,107,90,54,42,1
8509,466,186,280,71,84,30,11,516,296,220,79,59,69,16,1
8510,454,230,224,63,56,38,33,533,297,236,74,57,39,28,1
8511,356,199,157,36,43,28,12,2414,1189,1225,277,178,170,169,1
8512,64,42,22,9,1,9,8,374,210,164,41,22,53,27,1
8513,500,244,256,66,57,52,27,450,129,321,128,70,43,15,1
8514,476,190,286,116,95,33,11,433,221,212,59,42,47,14,1
8515,160,77,83,14,27,11,10,164,78,86,28,23,12,8,1
8516,337,171,166,46,27,33,16,215,117,98,43,22,27,5,1
8517,317,153,164,39,30,35,13,673,329,344,111,95,92,41,1
8518,919,538,381,111,98,103,41,380,184,196,58,52,46,8,1
8519,1893,850,1043,280,340,169,80,517,196,321,103,98,34,12,1
8520,1102,552,550,174,137,137,45,512,261,251,79,73,60,21,1
8521,1342,673,669,178,154,137,94,1210,592,618,157,138,116,85,1
8522,351,195,156,47,53,25,14,468,243,225,60,50,34,32,1
8523,356,185,171,37,31,17,21,557,306,251,66,42,52,15,1
8524,153,73,80,19,15,14,10,551,299,252,51,62,63,17,1
8525,1190,638,552,162,95,112,18,553,247,306,71,82,34,20,1
8526,370,216,154,56,27,72,12,249,114,135,47,33,25,4,1
8527,397,224,173,47,26,39,19,631,315,316,64,57,49,15,1
8528,508,215,293,72,71,42,15,796,445,351,96,80,90,38,1
8529,103,56,47,27,7,8,2,553,261,292,73,79,40,26,1
8530,240,166,74,32,12,8,15,321,187,134,59,29,32,8,1
8531,636,320,316,79,61,67,31,207,93,114,20,33,19,10,1
8532,1273,592,681,199,164,139,39,111,29,82,10,54,0,1,1
8533,572,353,219,70,42,57,25,2725,1490,1235,339,333,254,78,1
8534,101,41,60,18,19,10,5,1141,583,558,141,98,91,45,1
8535,172,74,98,32,30,11,7,142,69,73,20,27,9,6,1
8536,426,228,198,62,42,47,22,352,179,173,54,46,35,22,1
8537,423,198,225,43,47,36,41,568,243,325,98,73,56,44,1
8538,2442,1193,1249,278,183,170,145,436,201,235,54,37,36,18,1
8539,1463,521,942,252,204,105,52,221,75,146,68,21,16,5,1
8540,373,194,179,42,54,26,13,164,77,87,33,19,6,7,1
8541,138,69,69,28,7,10,10,140,86,54,17,6,20,7,1
8542,1257,662,595,176,142,106,42,592,291,301,92,93,71,31,1
8543,204,99,105,32,32,22,10,552,285,267,74,51,69,24,1
8544,465,228,237,64,42,63,24,575,225,350,106,74,68,29,1
8545,748,355,393,121,91,95,26,592,283,309,84,137,60,20,1
8546,543,307,236,43,80,39,13,1117,423,694,182,134,88,31,1
8547,442,207,235,51,72,50,19,641,341,300,101,91,29,22,1
8548,3144,1617,1527,367,342,278,136,101,41,60,18,19,10,5,1
8549,595,316,279,86,60,65,40,462,228,234,59,47,37,32,1
8550,928,442,486,139,118,91,43,164,78,86,28,23,12,8,1
8551,690,327,363,115,91,54,31,219,104,115,25,31,25,11,1
8552,467,226,241,55,48,54,23,234,122,112,40,18,18,9,1
8553,680,340,340,70,62,51,24,740,308,432,79,66,53,28,1
8554,1722,774,948,199,192,158,167,297,145,152,49,30,23,21,1
8555,246,108,138,32,44,21,10,708,334,374,105,96,61,37,1
8556,211,114,97,32,24,19,10,1608,778,830,243,230,159,74,1
8557,896,407,489,97,152,70,22,1721,809,912,268,234,144,50,1
8558,490,198,292,65,81,39,27,248,119,129,33,48,20,10,1
8559,1071,549,522,133,127,130,59,452,239,213,62,46,38,22,1
8560,808,366,442,130,133,66,31,1970,978,992,245,206,198,80,1
8561,163,70,93,28,21,17,6,246,115,131,15,29,10,32,1
8562,447,222,225,71,54,44,25,462,228,234,59,47,37,32,1
8563,745,391,354,85,81,52,39,618,290,328,82,74,69,42,1
8564,828,463,365,94,86,65,21,341,178,163,48,44,42,20,1
8565,259,123,136,36,40,33,12,262,151,111,30,17,32,25,1
8566,672,334,338,110,93,91,41,280,156,124,36,19,20,13,1
8567,75,32,43,12,13,6,3,1134,570,564,152,133,131,69,1
8568,700,357,343,99,84,88,34,536,278,258,72,63,62,20,1
8569,825,399,426,128,128,77,32,495,233,262,64,39,49,32,1
8570,336,192,144,30,36,40,14,1247,548,699,168,150,140,43,1
8571,298,140,158,51,33,21,22,292,162,130,43,27,21,12,1
8572,461,207,254,82,66,55,33,443,198,245,68,72,48,19,1
8573,543,293,250,77,67,40,25,437,225,212,61,57,66,12,1
8574,313,150,163,51,38,25,21,700,348,352,93,115,85,27,1
8575,796,408,388,95,124,82,19,906,474,432,90,125,74,24,1
8576,719,343,376,108,78,92,29,168,76,92,26,21,19,4,1
8577,204,103,101,16,32,22,8,787,351,436,135,98,82,23,1
8578,855,420,435,139,134,109,35,396,181,215,52,47,48,19,1
8579,138,67,71,21,20,15,9,694,315,379,101,87,47,17,1
8580,299,158,141,45,31,21,5,111,29,82,10,54,0,1,1
8581,191,99,92,25,24,18,8,480,234,246,79,77,65,23,1
8582,343,165,178,57,48,36,14,636,284,352,108,101,40,23,1
8583,626,272,354,96,80,71,36,318,164,154,52,43,34,10,1
8584,777,387,390,90,87,65,37,703,356,347,96,97,38,22,1
8585,267,147,120,37,28,35,12,810,367,443,115,92,94,59,1
8586,433,229,204,60,59,53,24,817,425,392,120,102,83,26,1
8587,646,304,342,104,93,58,26,542,249,293,82,69,58,31,1
8588,417,231,186,55,39,44,12,465,225,240,65,44,65,25,1
8589,257,148,109,28,20,21,14,357,187,170,51,34,40,23,1
8590,351,184,167,59,45,54,9,551,298,253,63,65,45,19,1
8591,2442,1193,1249,278,183,170,145,764,277,487,158,162,64,31,1
8592,333,192,141,50,48,28,10,537,273,264,62,60,74,27,1
8593,933,493,440,140,108,124,32,446,252,194,41,23,54,35,1
8594,760,461,299,96,53,99,35,484,259,225,69,44,60,21,1
8595,368,170,198,59,64,29,13,304,144,160,54,31,22,10,1
8596,2041,1035,1006,223,274,125,60,400,228,172,43,20,47,24,1
8597,129,56,73,17,14,19,18,165,89,76,17,12,8,16,1
8598,845,402,443,137,126,105,47,526,169,357,109,86,69,30,1
8599,476,233,243,76,61,52,21,215,115,100,27,28,34,16,1
8600,293,142,151,49,40,42,17,1302,637,665,162,150,125,61,1
8601,982,494,488,150,117,91,45,315,129,186,51,29,24,29,1
8602,1551,835,716,216,164,221,53,933,491,442,118,103,99,46,1
8603,326,149,177,51,51,28,10,381,191,190,55,61,33,11,1
8604,632,280,352,111,96,55,16,729,391,338,80,64,71,34,1
8605,160,86,74,21,11,16,16,505,275,230,63,57,35,12,1
8606,930,367,563,181,153,83,48,591,263,328,95,90,26,13,1
8607,467,226,241,55,48,54,23,1168,535,633,185,154,122,51,1
8608,1209,574,635,191,154,67,31,2785,1411,1374,427,355,296,115,1
8609,1308,652,656,166,153,149,87,817,425,392,120,102,83,26,1
8610,864,413,451,105,125,76,16,562,283,279,48,32,63,13,1
8611,207,124,83,22,19,24,11,976,520,456,120,115,109,53,1
8612,1234,590,644,180,182,95,40,149,68,81,15,38,11,10,1
8613,757,373,384,115,93,95,25,646,304,342,104,93,58,26,1
8614,1190,537,653,207,186,101,26,906,437,469,135,132,49,40,1
8615,976,496,480,128,111,121,48,1102,552,550,174,137,137,45,1
8616,455,218,237,57,51,42,35,593,266,327,102,84,69,24,1
8617,122,52,70,24,22,7,6,1395,627,768,172,263,141,59,1
8618,290,149,141,37,26,41,12,223,127,96,25,23,33,4,1
8619,714,364,350,98,102,91,27,190,96,94,21,17,23,10,1
8620,502,240,262,78,61,54,32,1141,562,579,169,144,135,43,1
8621,847,402,445,109,91,100,37,1205,632,573,156,149,102,48,1
8622,2556,1169,1387,248,291,227,275,125,58,67,20,16,10,5,1
8623,347,212,135,35,32,17,6,1863,721,1142,262,283,139,74,1
8624,368,158,210,64,61,39,14,240,125,115,34,32,30,8,1
8625,297,191,106,30,28,25,10,201,42,159,19,3,2,75,1
8626,553,275,278,56,76,60,20,206,109,97,24,16,28,10,1
8627,113,59,54,12,8,9,13,355,220,135,43,26,65,20,1
8628,826,362,464,107,118,71,43,398,200,198,68,43,51,14,1
8629,394,207,187,52,42,37,24,1336,828,508,166,121,152,48,1
8630,605,283,322,94,72,64,39,552,285,267,74,51,69,24,1
8631,619,332,287,95,77,74,38,537,276,261,75,68,68,22,1
8632,1290,597,693,182,182,119,63,389,176,213,81,59,24,7,1
8633,2414,1189,1225,277,178,170,169,673,317,356,101,85,76,49,1
8634,444,259,185,45,33,65,25,391,208,183,65,49,57,17,1
8635,2649,1430,1219,377,299,266,102,468,233,235,65,61,49,34,1
8636,433,221,212,59,42,47,14,410,208,202,59,58,43,26,1
8637,830,394,436,99,90,64,85,417,182,235,57,109,50,8,1
8638,119,67,52,15,15,7,7,706,300,406,94,74,61,22,1
8639,2045,985,1060,359,339,199,74,168,67,101,37,17,13,13,1
8640,1254,631,623,152,160,66,44,1585,840,745,184,152,155,100,1
8641,145,84,61,16,15,14,4,375,202,173,46,49,41,23,1
8642,256,153,103,19,23,23,8,127,49,78,27,20,6,5,1
8643,394,202,192,44,43,38,28,463,231,232,66,69,29,18,1
8644,586,236,350,124,109,66,24,165,82,83,24,20,20,8,1
8645,1085,529,556,149,133,126,54,118,56,62,13,14,6,6,1
8646,764,377,387,93,85,84,37,918,427,491,113,111,113,33,1
8647,303,158,145,47,40,41,12,501,285,216,52,55,62,25,1
8648,296,154,142,38,38,24,16,811,400,411,107,87,116,43,1
8649,297,158,139,47,37,37,9,990,410,580,140,175,44,36,1
8650,577,277,300,71,59,64,24,781,418,363,92,90,64,41,1
8651,980,537,443,125,99,98,50,621,404,217,61,42,73,21,1
8652,253,148,105,31,15,39,16,651,331,320,93,93,51,28,1
8653,714,364,350,98,102,91,27,233,121,112,24,31,30,7,1
8654,2089,917,1172,285,306,83,39,393,186,207,58,50,36,22,1
8655,1269,624,645,183,180,136,52,296,154,142,38,38,24,16,1
8656,432,181,251,48,75,27,17,217,109,108,34,32,35,7,1
8657,867,369,498,145,139,78,36,579,330,249,52,27,90,11,1
8658,461,207,254,82,66,55,33,2440,1061,1379,377,326,172,62,1
8659,1333,646,687,209,179,148,45,243,117,126,26,37,20,9,1
8660,213,88,125,30,20,12,19,419,175,244,71,73,23,23,1
8661,303,187,116,41,23,23,9,798,393,405,112,80,83,33,1
8662,669,348,321,83,80,55,23,213,107,106,28,41,19,5,1
8663,234,129,105,31,22,19,18,205,91,114,31,36,13,8,1
8664,215,80,135,54,56,21,9,280,156,124,36,19,20,13,1
8665,386,163,223,51,51,28,14,437,230,207,41,55,27,13,1
8666,581,254,327,100,83,54,20,331,169,162,40,28,22,14,1
8667,1311,514,797,220,157,168,108,413,236,177,41,25,35,19,1
8668,825,427,398,79,95,81,48,1132,553,579,172,143,150,57,1
8669,359,203,156,42,19,45,26,190,96,94,21,17,23,10,1
8670,743,341,402,104,89,68,38,538,286,252,80,58,48,14,1
8671,605,283,322,94,72,64,39,624,334,290,35,40,26,31,1
8672,715,355,360,118,79,71,29,365,173,192,47,47,29,14,1
8673,113,66,47,11,8,12,7,326,181,145,50,31,28,24,1
8674,1231,603,628,121,162,109,120,1247,620,627,134,149,142,58,1
8675,255,122,133,35,51,22,13,430,192,238,62,67,27,10,1
8676,976,496,480,128,111,121,48,673,329,344,111,95,92,41,1
8677,925,432,493,137,135,106,43,193,99,94,31,31,16,12,1
8678,593,305,288,91,83,54,24,294,148,146,35,33,25,14,1
8679,568,243,325,98,73,56,44,393,210,183,55,50,34,19,1
8680,889,476,413,135,104,78,32,814,370,444,121,108,85,36,1
8681,423,247,176,58,55,29,20,252,146,106,38,23,21,9,1
8682,313,166,147,47,44,41,10,164,78,86,28,23,12,8,1
8683,75,32,43,12,13,6,3,1253,639,614,181,155,164,73,1
8684,294,148,146,35,33,25,14,126,66,60,24,10,7,9,1
8685,1190,638,552,162,95,112,18,816,332,484,106,106,89,103,1
8686,1336,828,508,166,121,152,48,781,418,363,92,90,64,41,1
8687,618,307,311,73,54,46,18,272,173,99,32,32,11,8,1
8688,219,104,115,43,32,24,11,467,226,241,55,48,54,23,1
8689,1676,860,816,208,192,204,56,1663,835,828,224,213,163,63,1
8690,756,368,388,114,99,89,30,206,94,112,37,36,18,9,1
8691,1134,574,560,157,164,47,48,610,281,329,54,62,65,58,1
8692,158,85,73,24,18,18,8,457,237,220,69,44,53,26,1
8693,669,351,318,122,84,49,9,512,261,251,79,73,60,21,1
8694,440,282,158,38,21,38,24,1037,575,462,122,150,82,32,1
8695,255,122,133,35,51,22,13,1531,691,840,270,226,143,52,1
8696,205,91,114,31,36,13,8,251,129,122,33,22,13,11,1
8697,404,197,207,57,69,33,15,425,210,215,56,43,52,25,1
8698,1464,693,771,153,136,91,86,361,184,177,50,53,51,22,1
8699,508,254,254,74,99,61,12,2768,1380,1388,280,294,291,161,1
8700,338,169,169,43,38,41,10,2416,1280,1136,140,374,175,47,1
8701,425,210,215,56,43,52,25,1124,441,683,148,189,72,43,1
8702,140,81,59,16,15,15,12,359,157,202,47,52,24,17,1
8703,598,323,275,68,53,60,17,374,184,190,52,38,48,11,1
8704,95,44,51,14,13,7,4,272,149,123,34,35,21,2,1
8705,638,305,333,68,90,70,29,258,141,117,33,29,23,10,1
8706,538,252,286,77,87,53,30,241,115,126,35,30,17,14,1
8707,427,218,209,61,53,45,26,331,169,162,40,28,22,14,1
8708,1194,646,548,139,125,127,59,689,343,346,119,100,86,38,1
8709,848,461,387,111,102,108,42,108,59,49,17,13,12,5,1
8710,352,212,140,37,17,61,20,109,50,59,20,7,10,9,1
8711,863,418,445,127,114,70,31,821,387,434,121,131,76,29,1
8712,560,260,300,100,58,29,28,454,191,263,61,66,38,15,1
8713,699,376,323,79,53,86,41,358,170,188,54,55,20,10,1
8714,1873,948,925,245,214,194,85,1073,522,551,160,110,125,52,1
8715,923,471,452,119,117,119,41,170,83,87,30,19,14,16,1
8716,1275,579,696,200,172,125,51,1118,471,647,204,164,102,34,1
8717,655,281,374,108,103,61,24,344,109,235,100,39,26,5,1
8718,737,363,374,119,101,85,41,377,202,175,46,50,41,22,1
8719,345,203,142,47,35,31,11,928,442,486,139,118,91,43,1
8720,493,230,263,73,47,47,13,824,392,432,106,89,88,32,1
8721,943,496,447,112,98,101,59,834,465,369,82,84,81,21,1
8722,1023,527,496,148,122,132,46,453,255,198,62,49,29,19,1
8723,680,308,372,81,72,70,40,636,320,316,79,61,67,31,1
8724,2440,1061,1379,377,326,172,62,577,277,300,71,59,64,24,1
8725,540,271,269,80,77,51,16,958,451,507,165,135,97,41,1
8726,193,118,75,20,21,24,6,241,115,126,35,30,17,14,1
8727,480,234,246,79,77,65,23,435,208,227,68,64,53,23,1
8728,327,180,147,40,30,54,12,119,57,62,18,16,17,4,1
8729,510,264,246,67,66,38,29,432,190,242,85,82,28,11,1
8730,456,228,228,49,70,32,19,456,191,265,82,55,45,11,1
8731,598,301,297,76,53,71,36,462,233,229,66,49,43,30,1
8732,627,316,311,91,76,69,29,1072,518,554,124,130,94,37,1
8733,1177,666,511,131,99,88,35,2442,1193,1249,278,183,170,145,1
8734,483,236,247,82,60,43,18,1177,666,511,131,99,88,35,1
8735,1154,540,614,195,160,138,66,749,374,375,99,108,98,37,1
8736,104,48,56,15,15,13,7,327,177,150,40,40,38,18,1
8737,1308,646,662,157,133,173,54,921,455,466,144,127,108,39,1
8738,933,536,397,96,90,71,41,518,262,256,70,52,49,27,1
8739,361,155,206,43,61,29,18,494,233,261,87,57,46,18,1
8740,252,124,128,49,22,19,13,1097,526,571,131,134,120,43,1
8741,229,105,124,36,33,12,4,661,334,327,91,71,80,31,1
8742,632,339,293,83,77,59,20,659,325,334,102,85,87,32,1
8743,221,80,141,48,37,14,10,360,161,199,72,36,35,13,1
8744,586,270,316,83,80,59,21,602,299,303,98,81,72,21,1
8745,1129,500,629,171,148,85,30,665,297,368,111,107,34,12,1
8746,808,484,324,80,63,76,24,338,179,159,44,45,42,16,1
8747,490,224,266,80,70,39,32,2442,1193,1249,278,183,170,145,1
8748,158,74,84,26,23,18,18,327,149,178,47,49,38,11,1
8749,397,201,196,64,44,58,17,318,167,151,48,39,48,24,1
8750,902,526,376,94,103,78,23,442,254,188,46,22,40,19,1
8751,351,184,167,59,45,54,9,2261,1217,1044,271,243,267,101,1
8752,473,215,258,80,61,28,6,330,159,171,48,38,50,19,1
8753,382,207,175,55,32,40,13,2477,1186,1291,256,271,249,90,1
8754,478,260,218,51,60,66,18,1170,510,660,142,182,115,84,1
8755,470,226,244,81,53,59,39,461,227,234,61,47,54,33,1
8756,870,489,381,97,99,76,14,537,276,261,75,68,68,22,1
8757,480,234,246,79,77,65,23,490,198,292,65,81,39,27,1
8758,347,198,149,45,29,29,8,1863,721,1142,262,283,139,74,1
8759,295,146,149,50,42,24,10,2442,1193,1249,278,183,170,145,1
8760,1075,594,481,132,108,101,42,757,359,398,109,127,80,26,1
8761,424,209,215,56,58,45,24,501,240,261,80,62,49,42,1
8762,681,322,359,100,87,71,26,282,135,147,27,37,30,19,1
8763,729,391,338,80,64,71,34,760,401,359,96,89,98,22,1
8764,989,439,550,142,121,75,29,817,425,392,120,102,83,26,1
8765,516,227,289,75,36,54,28,572,309,263,64,55,47,29,1
8766,881,419,462,132,82,81,24,1118,551,567,128,145,95,36,1
8767,304,171,133,42,35,42,9,707,295,412,105,105,66,30,1
8768,684,300,384,101,106,67,20,921,455,466,144,127,108,39,1
8769,609,292,317,102,96,64,21,147,79,68,24,17,17,11,1
8770,466,186,280,71,84,30,11,876,397,479,168,168,84,24,1
8771,126,57,69,31,10,10,3,165,83,82,16,29,11,9,1
8772,724,325,399,98,92,64,24,508,215,293,72,71,42,15,1
8773,123,62,61,17,18,13,8,207,99,108,34,27,22,9,1
8774,340,215,125,44,30,33,13,986,499,487,123,116,98,54,1
8775,200,99,101,31,24,26,6,372,206,166,43,32,49,12,1
8776,1162,515,647,191,143,97,35,372,196,176,51,36,51,8,1
8777,907,530,377,61,82,63,30,951,506,445,107,118,79,40,1
8778,418,189,229,76,72,45,14,503,259,244,73,53,52,28,1
8779,802,449,353,102,87,82,29,207,94,113,44,20,25,10,1
8780,355,164,191,61,34,47,17,163,71,92,22,38,11,7,1
8781,331,152,179,34,30,35,12,593,266,327,102,84,69,24,1
8782,366,211,155,35,42,24,12,553,261,292,73,79,40,26,1
8783,411,235,176,65,41,53,11,700,343,357,110,83,81,47,1
8784,81,41,40,15,13,3,2,230,113,117,31,40,28,10,1
8785,292,152,140,46,38,35,12,415,189,226,69,54,50,21,1
8786,210,89,121,51,34,11,6,1627,782,845,204,187,202,108,1
8787,415,217,198,49,51,50,23,241,132,109,33,26,27,13,1
8788,651,306,345,85,64,61,32,101,41,60,18,19,10,5,1
8789,828,393,435,105,110,81,33,980,481,499,131,107,85,44,1
8790,834,465,369,82,84,81,21,418,248,170,41,31,54,9,1
8791,604,275,329,95,69,52,25,2440,1061,1379,377,326,172,62,1
8792,1804,789,1015,274,218,176,63,767,392,375,113,112,83,13,1
8793,2003,1022,981,195,194,164,229,448,275,173,32,53,55,27,1
8794,319,153,166,61,52,26,12,1320,599,721,177,156,104,47,1
8795,458,269,189,56,40,29,7,770,355,415,103,142,75,42,1
8796,411,209,202,69,43,18,15,425,199,226,54,71,56,11,1
8797,794,390,404,103,95,86,23,1210,592,618,157,138,116,85,1
8798,1336,828,508,166,121,152,48,1858,805,1053,271,345,116,41,1
8799,757,373,384,115,93,95,25,619,293,326,98,78,65,22,1
8800,377,187,190,51,44,46,26,189,88,101,31,29,18,10,1
8801,490,198,292,65,81,39,27,497,185,312,63,92,38,28,1
8802,1149,568,581,177,133,101,30,770,355,415,103,142,75,42,1
8803,503,298,205,62,28,20,4,377,184,193,56,53,44,14,1
8804,638,305,333,68,90,70,29,217,109,108,34,32,35,7,1
8805,467,226,241,55,48,54,23,636,320,316,79,61,67,31,1
8806,3230,1723,1507,361,358,157,75,2442,1193,1249,278,183,170,145,1
8807,237,118,119,38,30,39,11,465,220,245,82,71,60,25,1
8808,510,264,246,67,66,38,29,2472,1057,1415,331,352,159,96,1
8809,233,130,103,26,23,23,6,256,148,108,31,16,29,12,1
8810,464,224,240,79,71,59,21,443,217,226,65,67,40,11,1
8811,527,263,264,75,71,41,15,503,263,240,72,55,51,34,1
8812,924,521,403,99,98,62,35,448,275,173,32,53,55,27,1
8813,208,104,104,20,54,9,5,452,224,228,69,56,50,31,1
8814,181,64,117,46,41,5,4,211,90,121,49,27,14,11,1
8815,546,267,279,90,69,56,19,991,537,454,134,99,80,34,1
8816,575,301,274,84,65,63,20,976,496,480,128,111,121,48,1
8817,2414,1189,1225,277,178,170,169,497,185,312,63,92,38,28,1
8818,673,317,356,101,85,76,49,462,228,234,59,47,37,32,1
8819,712,396,316,78,69,65,25,592,291,301,92,93,71,31,1
8820,653,326,327,83,96,83,27,87,50,37,16,7,10,5,1
8821,1115,586,529,124,161,111,69,2090,1085,1005,167,141,168,40,1
8822,456,228,228,49,70,32,19,390,207,183,50,48,38,15,1
8823,1097,588,509,128,86,84,31,635,326,309,70,61,77,30,1
8824,442,208,234,68,49,51,25,396,192,204,71,41,51,15,1
8825,716,364,352,107,80,75,26,378,154,224,74,84,35,22,1
8826,673,331,342,109,71,75,36,189,90,99,26,29,17,11,1
8827,205,114,91,25,24,20,15,505,268,237,68,59,34,15,1
8828,374,191,183,70,48,61,13,592,291,301,92,93,71,31,1
8829,429,187,242,79,72,28,19,1124,578,546,149,127,122,61,1
8830,560,244,316,92,118,47,12,390,207,183,50,48,38,15,1
8831,502,240,262,78,61,54,32,451,222,229,72,46,57,17,1
8832,333,192,141,50,48,28,10,923,471,452,119,117,119,41,1
8833,465,225,240,65,44,65,25,1050,493,557,157,129,104,49,1
8834,651,306,345,85,64,61,32,393,186,207,58,50,36,22,1
8835,101,41,60,18,19,10,5,1177,666,511,131,99,88,35,1
8836,177,93,84,20,28,17,6,871,437,434,112,113,83,49,1
8837,462,251,211,74,53,41,18,426,224,202,48,38,53,13,1
8838,437,225,212,61,57,66,12,596,256,340,100,87,43,18,1
8839,595,272,323,111,107,54,28,781,418,363,92,90,64,41,1
8840,926,435,491,133,132,85,17,495,263,232,56,65,66,21,1
8841,209,129,80,18,13,20,12,172,112,60,18,12,17,8,1
8842,468,233,235,65,61,49,34,165,83,82,16,29,11,9,1
8843,1210,592,618,157,138,116,85,777,387,390,90,87,65,37,1
8844,633,262,371,76,137,64,22,1881,929,952,259,247,158,57,1
8845,261,127,134,42,37,24,11,752,381,371,96,77,80,44,1
8846,298,160,138,37,30,22,12,1337,667,670,137,143,140,35,1
8847,277,124,153,44,40,35,18,611,229,382,121,126,46,5,1
8848,911,423,488,140,150,102,32,513,283,230,61,63,50,24,1
8849,236,123,113,36,33,26,8,864,429,435,129,118,68,35,1
8850,480,234,246,79,77,65,23,676,295,381,94,71,65,24,1
8851,282,135,147,27,37,30,19,380,185,195,68,54,32,16,1
8852,539,273,266,74,59,66,24,3685,1574,2111,579,580,303,116,1
8853,140,76,64,17,13,13,8,1834,823,1011,297,282,151,63,1
8854,1005,422,583,166,179,70,21,142,77,65,24,16,12,6,1
8855,217,109,108,34,32,35,7,313,196,117,20,28,46,13,1
8856,870,433,437,133,121,95,25,1034,451,583,165,146,104,40,1
8857,537,276,261,75,68,68,22,189,90,99,26,29,17,11,1
8858,734,366,368,121,99,63,39,246,115,131,15,29,10,32,1
8859,743,341,402,104,89,68,38,377,202,175,46,50,41,23,1
8860,931,464,467,109,126,119,42,170,83,87,30,19,14,16,1
8861,873,366,507,127,125,75,21,510,264,246,67,66,38,29,1
8862,127,66,61,13,14,19,8,392,115,277,117,75,28,17,1
8863,246,108,138,32,44,21,10,815,478,337,104,80,103,27,1
8864,1102,511,591,171,179,148,52,480,244,236,74,47,50,21,1
8865,350,180,170,64,46,55,12,104,48,56,15,15,13,7,1
8866,503,263,240,72,55,51,34,453,228,225,72,42,59,13,1
8867,777,345,432,128,88,65,39,393,186,207,58,50,36,22,1
8868,858,398,460,126,138,75,39,646,316,330,89,95,48,17,1
8869,251,144,107,33,23,23,8,892,420,472,135,146,98,37,1
8870,428,226,202,52,60,75,20,295,143,152,38,47,22,25,1
8871,224,103,121,34,47,11,9,222,105,117,37,44,6,18,1
8872,578,289,289,90,73,80,24,412,216,196,24,48,18,16,1
8873,930,411,519,138,137,86,24,601,313,288,42,48,25,36,1
8874,218,102,116,32,31,21,4,419,175,244,71,73,23,23,1
8875,240,125,115,34,32,30,8,294,146,148,50,45,51,15,1
8876,737,363,374,119,101,85,41,1212,645,567,145,117,122,72,1
8877,480,252,228,55,37,49,20,289,139,150,38,44,23,20,1
8878,508,254,254,74,99,61,12,1464,987,477,137,141,55,31,1
8879,518,241,277,87,53,58,30,118,56,62,13,14,6,6,1
8880,376,183,193,50,50,43,21,686,375,311,89,80,63,20,1
8881,1170,510,660,142,182,115,84,866,382,484,116,114,91,28,1
8882,1400,800,600,158,134,150,65,246,108,138,32,44,21,10,1
8883,769,352,417,109,83,88,67,1048,564,484,118,122,113,40,1
8884,241,146,95,34,20,21,5,624,308,316,92,72,68,22,1
8885,670,333,337,95,79,62,21,391,208,183,65,49,57,17,1
8886,390,191,199,66,49,43,12,952,547,405,95,90,126,35,1
8887,433,221,212,59,42,47,14,737,374,363,100,95,103,29,1
8888,656,358,298,67,47,64,26,264,130,134,38,33,26,10,1
8889,283,142,141,35,29,32,5,233,121,112,24,31,30,7,1
8890,455,242,213,69,50,45,18,465,228,237,64,42,63,24,1
8891,167,79,88,22,26,16,9,126,66,60,24,10,7,9,1
8892,461,217,244,44,41,27,36,205,123,82,22,8,31,5,1
8893,208,115,93,31,27,22,19,146,71,75,20,17,8,7,1
8894,418,215,203,62,45,64,19,427,218,209,56,57,53,24,1
8895,1071,549,522,133,127,130,59,505,226,279,68,51,30,15,1
8896,328,173,155,43,36,24,17,376,183,193,50,50,43,21,1
8897,1588,631,957,275,292,183,66,501,240,261,80,62,49,42,1
8898,235,104,131,29,35,26,10,364,222,142,33,18,57,22,1
8899,161,75,86,24,20,10,7,1085,646,439,108,65,36,19,1
8900,204,86,118,38,21,23,15,425,210,215,56,43,52,25,1
8901,208,104,104,39,20,26,15,2490,1126,1364,352,325,219,89,1
8902,232,127,105,36,22,23,15,408,197,211,74,44,53,16,1
8903,156,64,92,39,19,15,8,552,285,267,74,51,69,24,1
8904,357,153,204,84,62,39,2,546,241,305,61,128,31,26,1
8905,263,136,127,29,24,19,31,426,200,226,75,56,39,24,1
8906,320,159,161,44,54,29,9,417,212,205,55,50,54,24,1
8907,433,221,212,59,42,47,14,855,359,496,142,153,53,24,1
8908,204,84,120,29,30,16,9,226,100,126,32,33,21,11,1
8909,646,316,330,89,95,48,17,356,208,148,42,26,57,15,1
8910,403,220,183,57,39,45,11,380,187,193,38,51,30,18,1
8911,1718,735,983,266,225,130,68,928,442,486,139,118,91,43,1
8912,476,270,206,62,45,46,30,2426,1147,1279,307,320,114,128,1
8913,142,72,70,16,20,17,11,173,82,91,27,25,28,4,1
8914,424,198,226,57,46,41,19,432,228,204,59,53,43,15,1
8915,214,108,106,53,20,27,15,186,99,87,30,17,18,8,1
8916,1037,461,576,146,163,75,44,277,124,153,44,40,35,18,1
8917,943,496,447,112,98,101,59,565,336,229,66,42,88,39,1
8918,2261,1217,1044,271,243,267,101,2041,1035,1006,223,274,125,60,1
8919,812,427,385,109,81,69,35,112,59,53,12,17,14,8,1
8920,372,237,135,38,22,39,26,409,200,209,69,56,44,13,1
8921,429,219,210,46,66,42,17,344,160,184,50,42,38,14,1
8922,759,326,433,115,95,61,29,544,259,285,76,81,40,20,1
8923,802,388,414,131,105,96,29,118,56,62,13,14,6,6,1
8924,1412,603,809,184,195,112,45,767,392,375,113,112,83,13,1
8925,1390,695,695,180,137,170,71,273,152,121,42,30,35,11,1
8926,553,261,292,73,79,40,26,376,249,127,47,23,43,16,1
8927,598,322,276,67,57,63,26,802,388,414,131,105,96,29,1
8928,392,156,236,40,91,28,16,2472,1057,1415,331,352,159,96,1
8929,142,80,62,21,6,12,3,537,276,261,75,68,68,22,1
8930,158,74,84,26,23,18,18,1210,578,632,172,184,94,66,1
8931,646,298,348,91,110,63,33,694,315,379,101,87,47,17,1
8932,335,185,150,46,34,36,13,947,506,441,105,126,75,14,1
8933,2376,1263,1113,304,241,264,115,292,150,142,31,43,39,16,1
8934,168,67,101,37,17,13,13,358,180,178,57,55,39,11,1
8935,255,122,133,35,51,22,13,292,163,129,50,27,46,16,1
8936,557,278,279,75,70,66,31,583,248,335,115,111,52,16,1
8937,785,374,411,56,42,38,25,1863,721,1142,262,283,139,74,1
8938,530,259,271,83,50,54,41,942,412,530,145,152,88,32,1
8939,1013,482,531,145,141,141,56,955,530,425,128,90,75,59,1
8940,1154,540,614,195,160,138,66,1187,631,556,182,139,152,56,1
8941,502,240,262,78,61,54,32,503,263,240,72,55,51,34,1
8942,379,203,176,55,48,45,16,360,188,172,49,48,47,17,1
8943,521,265,256,56,44,35,12,785,374,411,56,42,38,25,1
8944,68,33,35,11,9,5,6,1500,793,707,169,159,117,70,1
8945,695,264,431,172,114,51,23,202,102,100,29,35,6,9,1
8946,313,159,154,30,40,23,14,167,94,73,22,11,23,4,1
8947,976,496,480,128,111,121,48,536,226,310,93,63,62,26,1
8948,824,414,410,106,107,91,45,522,235,287,78,67,60,50,1
8949,1848,833,1015,304,257,195,71,213,109,104,26,26,21,6,1
8950,2442,1193,1249,278,183,170,145,803,358,445,135,117,80,44,1
8951,722,384,338,94,83,63,35,502,299,203,57,52,32,11,1
8952,1100,474,626,197,143,126,41,1573,791,782,198,173,148,46,1
8953,524,270,254,84,72,70,23,2414,1189,1225,277,178,170,169,1
8954,1782,715,1067,211,414,58,30,689,343,346,119,100,86,38,1
8955,606,279,327,81,70,49,34,833,452,381,117,85,71,39,1
8956,674,319,355,84,139,50,11,641,324,317,88,92,49,14,1
8957,351,183,168,55,44,33,9,302,138,164,50,36,30,20,1
8958,299,164,135,37,29,28,11,727,389,338,77,54,70,32,1
8959,351,184,167,59,45,54,9,295,158,137,42,34,38,14,1
8960,515,253,262,46,83,57,21,317,153,164,39,30,35,13,1
8961,289,125,164,51,55,17,10,258,113,145,43,44,16,7,1
8962,514,283,231,60,60,52,19,427,236,191,49,54,46,13,1
8963,1651,714,937,244,233,158,67,193,99,94,31,31,16,12,1
8964,833,452,381,117,85,71,39,280,133,147,44,38,40,12,1
8965,975,429,546,161,171,45,21,201,102,99,25,26,19,7,1
8966,462,251,211,74,53,41,18,401,204,197,49,33,29,17,1
8967,309,164,145,35,47,30,11,362,183,179,49,49,41,11,1
8968,684,288,396,107,90,54,42,574,309,265,67,69,59,17,1
8969,1050,482,568,136,154,101,41,1608,778,830,243,230,159,74,1
8970,292,154,138,46,29,41,7,480,234,246,79,77,65,23,1
8971,340,172,168,60,50,36,10,274,157,117,40,29,40,8,1
8972,1132,553,579,172,143,150,57,489,235,254,53,69,49,20,1
8973,873,366,507,127,125,75,21,347,181,166,27,20,12,12,1
8974,130,71,59,30,9,8,1,165,83,82,16,29,11,9,1
8975,637,327,310,86,58,70,31,334,172,162,43,39,41,17,1
8976,1278,593,685,198,201,71,43,1427,542,885,246,269,69,46,1
8977,352,212,140,37,17,61,20,354,168,186,50,53,39,20,1
8978,527,253,274,67,66,70,30,1115,586,529,124,161,111,69,1
8979,546,279,267,94,60,32,22,297,158,139,47,37,37,9,1
8980,832,428,404,131,89,88,38,1051,432,619,179,147,126,54,1
8981,163,71,92,33,26,5,7,347,212,135,35,32,17,6,1
8982,1336,633,703,182,197,110,52,427,218,209,61,53,45,26,1
8983,598,323,275,68,53,60,17,442,243,199,60,49,65,13,1
8984,839,427,412,91,83,114,37,375,214,161,38,36,24,17,1
8985,689,343,346,119,100,86,38,115,65,50,12,21,4,2,1
8986,269,134,135,42,35,27,13,576,250,326,93,71,34,15,1
8987,904,318,586,264,81,35,10,526,268,258,54,37,55,12,1
8988,483,236,247,82,60,43,18,556,259,297,75,69,63,38,1
8989,590,279,311,103,83,69,30,134,72,62,14,28,8,4,1
8990,635,333,302,99,75,83,28,624,308,316,92,72,68,22,1
8991,764,409,355,88,73,102,43,724,334,390,112,109,79,17,1
8992,1441,657,784,140,135,81,73,433,226,207,52,60,58,20,1
8993,632,339,293,83,77,59,20,457,237,220,69,44,53,26,1
8994,588,255,333,94,82,58,27,669,323,346,94,89,34,18,1
8995,279,135,144,40,52,40,5,271,126,145,33,38,31,10,1
8996,155,74,81,23,19,20,5,350,180,170,64,46,55,12,1
8997,229,105,124,36,33,12,4,168,120,48,7,5,20,7,1
8998,4128,2104,2024,581,505,453,205,745,366,379,110,93,79,45,1
8999,425,210,215,56,43,52,25,345,203,142,47,35,31,11,1
9000,1338,756,582,155,105,104,44,233,121,112,24,31,30,7,1
9001,920,492,428,100,92,88,49,875,421,454,124,142,98,43,1
9002,920,492,428,100,92,88,49,714,260,454,140,97,120,54,1
9003,834,390,444,133,114,109,34,822,402,420,125,107,82,26,1
9004,757,373,384,115,93,95,25,401,213,188,64,48,35,18,1
9005,304,159,145,38,40,32,3,318,176,142,25,32,35,25,1
9006,536,278,258,72,63,62,20,858,417,441,124,101,85,41,1
9007,623,320,303,103,85,75,15,1382,689,693,186,176,167,77,1
9008,425,210,215,56,43,52,25,832,428,404,131,89,88,38,1
9009,215,117,98,53,11,16,8,401,198,203,70,29,38,15,1
9010,360,192,168,55,45,48,16,691,307,384,93,128,45,19,1
9011,234,129,105,31,22,19,18,686,375,311,89,80,63,20,1
9012,114,71,43,8,18,7,4,1047,598,449,117,93,81,38,1
9013,148,75,73,25,13,9,4,384,221,163,45,21,59,23,1
9014,862,335,527,136,169,47,28,218,108,110,28,28,22,10,1
9015,605,283,322,94,72,64,39,825,399,426,128,128,77,32,1
9016,297,141,156,32,18,31,15,520,224,296,69,64,31,29,1
9017,712,396,316,78,69,65,25,470,226,244,81,53,59,39,1
9018,350,213,137,39,21,53,22,355,166,189,54,54,39,17,1
9019,446,246,200,64,48,54,12,341,197,144,50,31,15,6,1
9020,863,470,393,82,72,92,44,509,262,247,64,70,64,20,1
9021,315,129,186,51,29,24,29,906,455,451,116,105,87,46,1
9022,189,90,99,26,29,17,11,766,386,380,101,81,78,31,1
9023,557,245,312,81,96,72,48,154,75,79,28,23,16,6,1
9024,330,143,187,63,29,52,20,669,323,346,94,89,34,18,1
9025,361,210,151,34,25,36,13,55,36,19,8,3,7,2,1
9026,1807,933,874,248,203,173,71,974,509,465,136,121,122,40,1
9027,1014,490,524,177,137,94,38,609,292,317,102,96,64,21,1
9028,277,124,153,44,40,35,18,675,311,364,111,80,96,30,1
9029,360,192,168,55,45,48,16,920,492,428,100,92,88,49,1
9030,635,333,302,99,75,83,28,556,300,256,58,73,55,22,1
9031,628,341,287,77,59,55,31,1270,557,713,130,195,57,30,1
9032,314,142,172,29,48,21,16,410,188,222,53,52,31,14,1
9033,2492,894,1598,466,444,164,102,926,437,489,135,107,113,42,1
9034,480,234,246,79,77,65,23,788,360,428,93,106,67,72,1
9035,822,416,406,111,105,84,44,561,292,269,88,68,64,22,1
9036,392,115,277,117,75,28,17,247,110,137,34,45,23,10,1
9037,429,219,210,46,66,42,17,133,55,78,22,22,13,9,1
9038,1190,638,552,162,95,112,18,749,361,388,107,115,73,27,1
9039,440,246,194,62,49,41,16,928,442,486,139,118,91,43,1
9040,509,254,255,67,55,52,35,565,264,301,101,73,72,15,1
9041,390,207,183,50,48,38,15,464,167,297,90,81,33,9,1
9042,1217,496,721,230,214,94,42,221,80,141,48,37,14,10,1
9043,758,360,398,114,107,51,19,601,313,288,42,48,25,36,1
9044,201,42,159,19,3,2,75,383,201,182,44,37,32,51,1
9045,1464,693,771,153,136,91,86,303,175,128,43,36,34,12,1
9046,269,134,135,42,35,27,13,72,35,37,10,9,7,6,1
9047,1158,481,677,169,129,86,40,461,257,204,63,49,50,29,1
9048,769,405,364,97,101,49,35,89,42,47,16,12,15,6,1
9049,589,340,249,75,53,85,35,620,381,239,56,62,84,26,1
9050,517,204,313,98,78,13,7,1497,881,616,151,117,94,40,1
9051,322,160,162,44,52,33,16,926,435,491,133,132,85,17,1
9052,902,495,407,116,97,111,37,892,420,472,135,146,98,37,1
9053,448,275,173,32,53,55,27,198,113,85,19,20,26,12,1
9054,1357,505,852,245,256,70,35,193,99,94,31,31,16,12,1
9055,89,44,45,15,12,15,6,184,95,89,17,21,18,8,1
9056,450,232,218,58,54,42,20,348,134,214,80,57,41,15,1
9057,1074,538,536,154,140,111,51,635,333,302,99,75,83,28,1
9058,191,91,100,28,33,23,12,330,143,187,63,29,52,20,1
9059,726,312,414,121,73,82,23,57,29,28,15,6,18,3,1
9060,791,306,485,142,157,21,18,1257,525,732,216,210,79,52,1
9061,470,230,240,67,60,42,16,963,447,516,120,146,87,74,1
9062,948,484,464,134,131,75,27,193,99,94,31,31,16,12,1
9063,627,314,313,61,59,71,22,647,282,365,104,90,53,27,1
9064,490,224,266,80,70,39,32,246,113,133,33,45,22,10,1
9065,672,334,338,110,93,91,41,1480,789,691,195,151,173,55,1
9066,2414,1189,1225,277,178,170,169,393,186,207,58,50,36,22,1
9067,639,306,333,54,62,66,25,284,128,156,48,29,34,8,1
9068,847,402,445,137,119,102,41,583,322,261,73,66,45,26,1
9069,484,254,230,60,66,56,14,250,164,86,22,15,30,4,1
9070,536,209,327,68,127,48,23,482,231,251,76,81,64,26,1
9071,607,311,296,73,81,33,33,211,114,97,32,24,19,10,1
9072,795,375,420,102,92,81,30,117,60,57,20,17,16,5,1
9073,397,186,211,73,63,36,25,1480,789,691,195,151,173,55,1
9074,1019,522,497,159,138,142,40,778,367,411,90,85,64,43,1
9075,2351,1110,1241,337,269,300,87,146,73,73,17,27,17,9,1
9076,211,92,119,33,44,11,7,1199,589,610,189,128,167,65,1
9077,264,122,142,33,29,13,13,1058,557,501,128,128,115,43,1
9078,277,141,136,35,21,16,22,416,201,215,54,52,39,25,1
9079,561,210,351,108,77,41,22,217,104,113,48,21,20,9,1
9080,551,352,199,46,43,77,26,519,246,273,78,82,42,16,1
9081,255,130,125,44,18,22,12,119,53,66,33,8,7,6,1
9082,341,178,163,48,44,42,20,3911,1465,2446,610,767,240,133,1
9083,221,131,90,32,19,15,7,592,264,328,86,85,62,41,1
9084,475,251,224,67,49,48,23,485,273,212,52,47,51,17,1
9085,346,174,172,36,43,21,9,1863,721,1142,262,283,139,74,1
9086,1049,516,533,139,101,136,46,296,154,142,38,38,24,16,1
9087,418,204,214,61,41,52,21,712,396,316,78,69,65,25,1
9088,769,405,364,97,101,49,35,448,236,212,53,64,56,24,1
9089,333,171,162,41,44,48,23,391,189,202,55,56,56,12,1
9090,860,349,511,166,166,58,19,729,391,338,80,64,71,34,1
9091,465,228,237,64,42,63,24,4967,2501,2466,718,692,594,248,1
9092,333,127,206,66,68,25,14,240,125,115,34,32,30,8,1
9093,609,281,328,80,82,67,41,1051,523,528,164,140,126,50,1
9094,325,153,172,62,37,50,39,44,13,31,9,11,1,2,1
9095,339,170,169,32,17,24,13,183,91,92,31,21,16,11,1
9096,449,232,217,53,64,57,22,922,491,431,112,92,97,52,1
9097,303,201,102,34,29,45,19,333,167,166,45,30,34,14,1
9098,279,106,173,48,35,41,39,272,124,148,51,36,23,27,1
9099,651,311,340,110,77,73,33,304,127,177,61,38,31,4,1
9100,392,199,193,63,35,49,21,502,240,262,78,61,54,32,1
9101,433,221,212,59,42,47,14,355,179,176,51,45,45,11,1
9102,126,56,70,31,10,10,3,806,365,441,134,118,78,44,1
9103,333,171,162,50,34,19,8,457,261,196,55,27,57,34,1
9104,817,425,392,120,102,83,26,1836,1051,785,185,221,239,110,1
9105,672,334,338,110,93,91,41,689,343,346,119,100,86,38,1
9106,95,44,51,14,13,7,4,573,316,257,78,80,21,21,1
9107,923,476,447,144,105,96,38,204,99,105,32,32,22,10,1
9108,539,279,260,72,64,19,24,377,202,175,46,50,41,23,1
9109,894,479,415,117,93,119,38,415,209,206,60,67,39,18,1
9110,248,118,130,54,31,26,5,437,167,270,126,95,34,10,1
9111,422,213,209,63,60,35,13,1290,597,693,182,182,119,63,1
9112,838,431,407,107,90,107,43,537,276,261,75,68,68,22,1
9113,822,424,398,107,106,86,46,2181,1144,1037,284,248,272,103,1
9114,303,159,144,40,35,35,8,1089,544,545,138,160,117,43,1
9115,211,88,123,38,28,26,10,697,373,324,105,83,95,38,1
9116,451,222,229,72,46,57,17,483,209,274,83,78,52,22,1
9117,359,173,186,55,57,44,16,590,298,292,73,45,71,25,1
9118,448,236,212,53,64,56,24,758,362,396,115,102,35,13,1
9119,339,170,169,32,17,24,13,778,367,411,90,85,64,43,1
9120,433,222,211,68,58,42,23,552,283,269,89,66,68,30,1
9121,509,262,247,64,70,64,20,620,305,315,97,80,87,28,1
9122,380,165,215,47,72,26,14,592,291,301,92,93,71,31,1
9123,655,281,374,108,103,61,24,51,10,41,25,0,5,8,1
9124,452,236,216,73,54,50,29,1030,368,662,172,188,56,20,1
9125,307,133,174,48,53,27,10,1863,721,1142,262,283,139,74,1
9126,957,346,611,205,175,61,29,1194,543,651,190,197,65,43,1
9127,1159,570,589,136,157,90,41,601,313,288,42,48,25,36,1
9128,652,342,310,71,68,66,17,366,183,183,48,47,36,17,1
9129,431,227,204,53,60,58,12,419,175,244,71,73,23,23,1
9130,2045,985,1060,359,339,199,74,226,100,126,32,33,21,11,1
9131,271,120,151,41,31,24,10,233,121,112,24,31,30,7,1
9132,756,348,408,101,103,60,40,923,469,454,122,139,74,22,1
9133,896,407,489,97,152,70,22,864,429,435,129,118,68,35,1
9134,231,141,90,28,20,22,16,660,326,334,106,61,71,32,1
9135,326,186,140,46,44,35,11,168,76,92,26,21,19,4,1
9136,403,220,183,57,39,45,11,331,169,162,40,28,22,14,1
9137,101,41,60,18,19,10,5,510,252,258,75,60,57,24,1
9138,677,245,432,129,155,72,11,2146,1050,1096,330,305,194,74,1
9139,265,119,146,44,52,12,9,219,100,119,32,43,9,10,1
9140,569,327,242,64,54,54,16,219,133,86,18,12,32,18,1
9141,527,253,274,67,66,70,30,1043,479,564,200,131,123,62,1
9142,420,202,218,67,43,51,15,441,211,230,67,45,53,14,1
9143,85,44,41,9,6,10,9,61,18,43,9,3,0,21,1
9144,184,86,98,26,26,14,11,671,332,339,103,75,75,31,1
9145,770,390,380,104,76,78,32,120,67,53,13,15,9,6,1
9146,278,131,147,29,30,33,12,654,317,337,95,111,44,13,1
9147,418,205,213,69,50,29,15,189,90,99,26,29,17,11,1
9148,551,237,314,95,79,54,17,1154,540,614,195,160,138,66,1
9149,584,319,265,72,83,53,22,784,353,431,56,47,26,18,1
9150,977,406,571,151,128,84,47,653,326,327,83,96,83,27,1
9151,95,44,51,14,13,7,4,693,360,333,100,88,62,26,1
9152,453,255,198,62,49,29,19,591,319,272,96,62,43,19,1
9153,620,307,313,92,91,92,33,205,99,106,24,29,20,5,1
9154,424,209,215,56,58,45,24,505,226,279,68,51,30,15,1
9155,815,418,397,97,62,70,17,351,191,160,41,51,53,15,1
9156,1045,374,671,217,143,103,29,393,186,207,58,50,36,22,1
9157,442,254,188,54,31,50,30,238,117,121,32,27,22,14,1
9158,268,157,111,26,30,28,13,791,306,485,142,157,21,18,1
9159,308,170,138,38,35,45,14,203,97,106,30,22,18,10,1
9160,228,105,123,38,29,25,9,461,245,216,55,62,54,25,1
9161,337,193,144,49,18,41,21,422,245,177,50,31,42,22,1
9162,450,241,209,67,58,54,23,544,295,249,84,56,49,14,1
9163,113,61,52,13,15,7,5,398,249,149,40,19,66,25,1
9164,941,448,493,150,118,127,39,261,108,153,35,37,16,6,1
9165,2524,1232,1292,398,317,186,61,414,216,198,51,32,42,28,1
9166,173,110,63,35,6,9,8,710,307,403,117,176,37,9,1
9167,1321,679,642,154,167,133,58,1257,647,610,156,146,145,35,1
9168,440,246,194,62,49,41,16,482,231,251,76,81,64,26,1
9169,398,257,141,43,19,29,19,381,189,192,74,49,44,13,1
9170,702,298,404,134,111,48,18,1207,593,614,151,148,131,95,1
9171,325,186,139,49,36,20,5,358,212,146,51,36,33,9,1
9172,379,203,176,55,48,45,16,512,261,251,79,73,60,21,1
9173,2556,1169,1387,248,291,227,275,1247,723,524,122,144,121,38,1
9174,186,84,102,27,29,21,10,164,88,76,27,20,17,6,1
9175,524,244,280,64,79,30,17,1412,603,809,184,195,112,45,1
9176,308,170,138,38,35,45,14,458,222,236,69,39,35,18,1
9177,152,98,54,13,10,21,9,402,227,175,48,40,35,11,1
9178,437,241,196,49,48,61,24,183,91,92,21,29,16,10,1
9179,425,199,226,54,71,56,11,1863,721,1142,262,283,139,74,1
9180,338,156,182,58,39,39,15,1531,691,840,270,226,143,52,1
9181,137,63,74,20,22,14,6,585,289,296,102,86,61,18,1
9182,930,367,563,181,153,83,48,3703,1708,1995,456,428,305,162,1
9183,461,207,254,82,66,55,33,99,35,64,25,18,0,1,1
9184,1585,741,844,220,242,103,53,406,205,201,54,58,34,21,1
9185,593,291,302,81,85,56,20,513,246,267,71,66,60,35,1
9186,2477,1186,1291,256,271,249,90,930,367,563,181,153,83,48,1
9187,431,201,230,69,39,55,33,2491,1175,1316,303,302,273,147,1
9188,2030,1006,1024,306,249,263,107,448,275,173,32,53,55,27,1
9189,1190,537,653,207,186,101,26,522,283,239,65,64,76,22,1
9190,462,258,204,59,41,56,15,782,372,410,127,111,89,36,1
9191,1210,592,618,157,138,116,85,1023,561,462,117,125,96,48,1
9192,462,251,211,74,53,41,18,99,34,65,12,1,2,18,1
9193,706,354,352,82,61,32,30,552,285,267,74,51,69,24,1
9194,320,143,177,51,51,24,10,352,167,185,49,44,37,16,1
9195,541,273,268,67,48,48,30,806,419,387,115,130,57,32,1
9196,255,122,133,35,51,22,13,246,113,133,33,45,22,10,1
9197,1049,585,464,107,108,120,28,1210,592,618,157,138,116,85,1
9198,467,226,241,55,48,54,23,949,512,437,102,124,70,41,1
9199,247,110,137,34,45,23,10,361,184,177,50,53,51,22,1
9200,1290,597,693,182,182,119,63,280,121,159,60,45,22,12,1
9201,574,269,305,91,63,54,27,164,78,86,28,23,12,8,1
9202,139,75,64,17,17,23,9,357,169,188,61,53,32,15,1
9203,433,226,207,52,60,58,20,2063,1024,1039,175,117,80,97,1
9204,147,84,63,23,14,21,5,142,80,62,24,12,21,4,1
9205,447,232,215,55,65,50,25,191,99,92,25,24,18,8,1
9206,358,170,188,54,55,20,10,586,254,332,114,111,55,17,1
9207,784,391,393,105,113,86,21,906,437,469,135,132,49,40,1
9208,433,222,211,68,58,42,23,393,186,207,58,50,36,22,1
9209,329,155,174,46,38,29,14,324,145,179,45,23,32,17,1
9210,346,186,160,40,37,34,21,2491,1175,1316,303,302,273,147,1
9211,205,91,114,31,36,13,8,176,74,102,20,29,7,7,1
9212,1265,424,841,230,200,86,47,589,314,275,70,83,44,28,1
9213,919,376,543,129,122,55,30,860,427,433,132,100,81,30,1
9214,339,170,169,32,17,24,13,300,140,160,39,35,14,12,1
9215,909,455,454,137,82,85,68,424,191,233,76,73,49,13,1
9216,318,176,142,25,32,35,25,496,295,201,57,42,52,19,1
9217,373,164,209,51,45,44,21,624,222,402,92,81,39,15,1
9218,427,186,241,55,52,42,23,652,329,323,65,70,51,50,1
9219,358,170,188,54,55,20,10,593,342,251,73,55,82,29,1
9220,277,124,153,44,40,35,18,687,353,334,84,96,74,31,1
9221,114,71,43,8,18,7,4,94,55,39,18,6,18,5,1
9222,1194,543,651,190,197,65,43,1912,977,935,247,226,205,65,1
9223,593,305,288,91,83,54,24,240,167,73,32,12,8,21,1
9224,216,104,112,27,18,35,20,244,131,113,35,27,33,15,1
9225,533,254,279,81,78,52,10,906,455,451,116,105,87,46,1
9226,1447,698,749,214,180,116,46,1234,590,644,180,182,95,40,1
9227,876,457,419,88,124,67,47,971,516,455,114,115,116,35,1
9228,240,125,115,34,32,30,8,512,261,251,79,73,60,21,1
9229,529,274,255,57,62,38,14,391,201,190,52,47,35,24,1
9230,593,321,272,64,84,33,20,659,325,334,102,85,87,32,1
9231,253,123,130,40,46,15,4,654,344,310,80,69,57,15,1
9232,63,29,34,13,10,4,8,769,329,440,116,66,55,22,1
9233,247,110,137,34,45,23,10,552,264,288,82,64,48,20,1
9234,546,267,279,90,69,56,19,241,127,114,34,33,29,12,1
9235,475,223,252,72,66,51,26,377,184,193,50,43,33,17,1
9236,433,221,212,59,42,47,14,843,391,452,139,104,91,34,1
9237,412,195,217,79,48,36,29,987,515,472,107,110,106,61,1
9238,547,255,292,85,84,37,12,926,435,491,133,132,85,17,1
9239,546,267,279,90,69,56,19,235,149,86,30,21,17,5,1
9240,44,13,31,9,11,1,2,377,202,175,46,50,41,23,1
9241,875,421,454,124,142,98,43,505,272,233,76,66,57,23,1
9242,264,121,143,57,32,22,15,222,123,99,32,20,32,6,1
9243,483,274,209,54,39,45,13,605,295,310,74,66,70,36,1
9244,247,118,129,49,39,17,6,309,144,165,54,39,25,12,1
9245,870,415,455,112,103,93,51,160,53,107,31,29,13,3,1
9246,611,246,365,116,82,71,27,304,138,166,53,32,34,13,1
9247,1258,531,727,218,216,108,35,246,113,133,33,45,22,10,1
9248,624,334,290,35,40,26,31,930,367,563,181,153,83,48,1
9249,102,49,53,14,21,7,4,126,66,60,24,10,7,9,1
9250,616,215,401,150,61,95,40,800,365,435,129,102,97,31,1
9251,375,173,202,50,46,43,25,402,205,197,62,48,38,19,1
9252,1009,506,503,146,141,97,55,635,333,302,99,75,83,28,1
9253,1272,520,752,235,242,117,54,3661,1791,1870,463,425,340,151,1
9254,205,135,70,21,16,24,4,193,110,83,19,17,20,8,1
9255,621,273,348,104,102,48,19,383,204,179,61,32,54,16,1
9256,704,373,331,74,153,34,10,443,240,203,66,31,57,27,1
9257,493,222,271,44,53,45,51,330,143,187,63,29,52,20,1
9258,297,158,139,47,37,37,9,202,105,97,28,27,14,6,1
9259,111,51,60,20,21,10,11,427,204,223,38,57,26,32,1
9260,377,177,200,63,53,44,16,369,237,132,33,16,38,18,1
9261,845,412,433,146,103,112,18,822,392,430,125,104,79,24,1
9262,707,295,412,105,105,66,30,1243,652,591,154,126,159,64,1
9263,172,74,98,32,30,11,7,276,118,158,38,40,16,10,1
9264,1123,554,569,142,130,85,36,685,315,370,108,99,36,9,1
9265,963,385,578,171,162,62,35,211,83,128,28,35,5,11,1
9266,465,225,240,65,44,65,25,814,343,471,133,101,80,41,1
9267,424,198,226,57,46,41,19,646,304,342,104,93,58,26,1
9268,173,88,85,20,21,9,12,1117,423,694,182,134,88,31,1
9269,938,484,454,137,100,104,41,870,433,437,133,121,95,25,1
9270,628,311,317,111,75,63,18,552,285,267,74,51,69,24,1
9271,613,333,280,71,66,47,26,277,144,133,36,36,34,15,1
9272,176,73,103,22,29,13,9,148,63,85,23,22,7,7,1
9273,346,180,166,52,55,36,13,1432,652,780,217,205,131,81,1
9274,212,93,119,30,27,21,14,298,167,131,47,33,40,8,1
9275,380,184,196,58,52,46,8,346,186,160,48,32,35,14,1
9276,179,90,89,26,9,16,6,502,236,266,66,66,58,17,1
9277,749,360,389,91,122,59,37,4655,2074,2581,545,652,562,399,1
9278,2803,1300,1503,392,510,170,57,2468,1038,1430,333,465,167,62,1
9279,826,362,464,107,118,71,43,854,380,474,137,159,81,31,1
9280,1149,568,581,177,133,101,30,505,268,237,68,59,34,15,1
9281,770,356,414,123,102,66,25,377,158,219,80,68,26,14,1
9282,538,252,286,77,87,53,30,651,306,345,85,64,61,32,1
9283,664,297,367,88,86,55,47,882,432,450,115,111,68,44,1
9284,938,484,454,137,100,104,41,673,329,344,111,95,92,41,1
9285,2261,1217,1044,271,243,267,101,519,246,273,78,82,42,16,1
9286,266,133,133,43,28,30,8,552,285,267,74,51,69,24,1
9287,2442,1193,1249,278,183,170,145,706,354,352,82,61,32,30,1
9288,724,334,390,112,109,79,17,976,496,480,128,111,121,48,1
9289,1014,490,524,177,137,94,38,294,122,172,46,65,18,11,1
9290,349,192,157,46,41,45,15,437,200,237,54,48,32,16,1
9291,127,58,69,17,22,3,2,427,218,209,61,53,45,26,1
9292,1134,539,595,150,146,78,40,922,418,504,120,120,106,31,1
9293,154,75,79,17,24,16,13,147,79,68,20,15,19,8,1
9294,545,269,276,80,76,27,32,305,177,128,42,25,39,6,1
9295,815,418,397,97,62,70,17,788,381,407,77,41,46,35,1
9296,480,234,246,79,77,65,23,245,112,133,32,45,20,10,1
9297,246,115,131,15,29,10,32,499,188,311,123,53,84,39,1
9298,225,116,109,29,19,25,6,1165,567,598,134,119,158,63,1
9299,509,254,255,67,55,52,35,451,222,229,72,46,57,17,1
9300,685,315,370,108,99,36,9,646,316,330,89,95,48,17,1
9301,171,94,77,24,28,30,11,873,366,507,127,125,75,21,1
9302,747,371,376,87,134,54,29,226,120,106,68,8,2,1,1
9303,507,242,265,53,44,31,22,236,118,118,26,20,18,7,1
9304,2073,846,1227,304,300,162,111,480,252,228,55,37,49,20,1
9305,109,48,61,10,24,11,5,522,293,229,74,51,49,27,1
9306,1149,568,581,177,133,101,30,248,119,129,33,48,20,10,1
9307,2843,1104,1739,429,357,178,95,309,154,155,42,44,45,16,1
9308,1464,693,771,153,136,91,86,364,222,142,33,18,57,22,1
9309,595,316,279,86,60,65,40,303,137,166,54,54,31,15,1
9310,609,292,317,102,96,64,21,866,405,461,155,136,101,43,1
9311,1566,743,823,261,188,151,48,2157,1171,986,306,238,131,32,1
9312,1028,576,452,128,139,79,31,1487,996,491,147,141,50,35,1
9313,427,186,241,55,52,42,23,810,367,443,115,92,94,59,1
9314,425,161,264,69,79,22,10,249,111,138,40,30,22,17,1
9315,253,148,105,31,15,39,16,858,417,441,93,124,75,26,1
9316,359,184,175,49,35,32,11,1669,1162,507,154,128,86,51,1
9317,146,71,75,20,17,8,7,311,154,157,47,29,34,13,1
9318,1210,592,618,157,138,116,85,933,493,440,140,108,124,32,1
9319,622,328,294,75,42,67,31,2556,1169,1387,248,291,227,275,1
9320,451,239,212,53,64,56,22,445,225,220,47,62,53,26,1
9321,476,270,206,62,45,46,30,605,295,310,74,66,70,36,1
9322,202,105,97,28,27,14,6,397,186,211,73,63,36,25,1
9323,770,355,415,103,142,75,42,467,269,198,46,51,60,18,1
9324,589,294,295,37,44,27,33,167,94,73,22,11,23,4,1
9325,248,118,130,54,31,26,5,235,135,100,30,13,25,11,1
9326,425,210,215,56,43,52,25,673,317,356,101,85,76,49,1
9327,416,201,215,54,52,39,25,330,143,187,63,29,52,20,1
9328,726,312,414,121,73,82,23,322,164,158,46,44,29,7,1
9329,341,162,179,54,49,41,12,433,222,211,68,58,42,23,1
9330,824,386,438,94,77,81,34,854,380,474,137,159,81,31,1
9331,2414,1189,1225,277,178,170,169,280,97,183,55,48,20,20,1
9332,344,181,163,61,37,40,14,470,205,265,71,80,33,11,1
9333,266,137,129,66,21,18,5,368,141,227,64,61,24,13,1
9334,184,95,89,22,22,19,7,648,307,341,101,58,76,34,1
9335,168,67,101,37,17,13,13,309,154,155,42,44,45,16,1
9336,582,285,297,62,57,44,16,859,438,421,142,80,105,43,1
9337,940,464,476,116,135,108,58,387,178,209,59,70,45,22,1
9338,1087,480,607,155,179,99,28,245,111,134,31,44,20,11,1
9339,672,334,338,110,93,91,41,906,485,421,112,98,112,39,1
9340,8797,3688,5109,1359,1437,715,322,854,399,455,127,118,57,39,1
9341,1493,672,821,258,211,146,47,1014,490,524,177,137,94,38,1
9342,606,279,327,81,70,49,34,497,227,270,70,63,66,30,1
9343,171,94,77,24,28,30,11,393,223,170,60,35,50,14,1
9344,654,317,337,95,111,44,13,870,489,381,97,99,76,14,1
9345,162,67,95,32,17,15,11,735,375,360,103,91,77,46,1
9346,1313,644,669,169,90,111,43,636,336,300,94,65,58,32,1
9347,257,148,109,28,20,21,14,187,92,95,13,51,14,11,1
9348,3056,1457,1599,438,389,329,168,273,126,147,54,49,25,18,1
9349,3056,1457,1599,438,389,329,168,184,95,89,22,22,19,7,1
9350,114,71,43,8,18,7,4,769,329,440,116,66,55,22,1
9351,603,291,312,98,87,61,28,758,362,396,115,102,35,13,1
9352,541,279,262,79,82,31,32,375,202,173,46,49,41,23,1
9353,562,312,250,80,65,67,30,473,259,214,63,62,47,18,1
9354,418,189,229,76,72,45,14,450,215,235,73,72,53,18,1
9355,754,318,436,114,106,58,28,708,303,405,115,115,70,23,1
9356,368,158,210,64,61,39,14,179,102,77,23,20,6,3,1
9357,1190,638,552,162,95,112,18,246,115,131,15,29,10,32,1
9358,463,256,207,60,53,39,18,247,110,137,34,45,23,10,1
9359,587,260,327,84,69,55,23,593,266,327,102,84,69,24,1
9360,108,51,57,16,12,16,11,776,356,420,122,103,85,30,1
9361,1738,821,917,242,196,181,58,767,392,375,113,112,83,13,1
9362,552,285,267,74,51,69,24,728,358,370,118,100,55,29,1
9363,276,136,140,39,34,33,9,635,333,302,99,75,83,28,1
9364,393,186,207,58,50,36,22,140,74,66,15,14,14,10,1
9365,672,334,338,110,93,91,41,206,85,121,31,42,6,17,1
9366,643,294,349,92,97,53,35,377,184,193,50,43,33,17,1
9367,508,267,241,43,35,25,17,411,208,203,63,44,52,19,1
9368,68,34,34,9,2,9,9,466,186,280,71,84,30,11,1
9369,54,26,28,11,4,3,3,175,91,84,19,21,21,10,1
9370,298,167,131,47,33,40,8,636,320,316,79,61,67,31,1
9371,860,378,482,101,123,82,74,470,230,240,67,60,42,16,1
9372,317,153,164,39,30,35,13,551,299,252,51,62,63,17,1
9373,363,182,181,33,55,23,11,892,397,495,146,63,65,37,1
9374,1257,662,595,176,142,106,42,304,159,145,38,40,32,3,1
9375,341,178,163,48,44,42,20,577,288,289,85,56,40,20,1
9376,677,361,316,81,61,42,22,665,297,368,111,107,34,12,1
9377,833,452,381,117,85,71,39,217,109,108,34,32,35,7,1
9378,745,351,394,88,95,68,56,552,285,267,74,51,69,24,1
9379,890,512,378,92,95,75,41,676,319,357,83,86,62,46,1
9380,593,257,336,76,56,56,96,330,143,187,63,29,52,20,1
9381,239,127,112,39,33,18,13,402,227,175,48,40,35,11,1
9382,1494,762,732,183,160,144,68,1873,935,938,233,225,203,79,1
9383,248,130,118,26,28,16,11,1304,585,719,179,169,154,47,1
9384,2817,1216,1601,379,436,183,115,245,112,133,32,45,20,10,1
9385,359,171,188,31,25,29,13,601,313,288,42,48,25,36,1
9386,245,112,133,32,45,20,10,897,487,410,92,97,83,31,1
9387,1863,721,1142,262,283,139,74,425,210,215,56,43,52,25,1
9388,1948,1039,909,242,227,200,67,201,88,113,33,27,20,8,1
9389,506,243,263,75,70,39,17,4655,2074,2581,545,652,562,399,1
9390,603,311,292,102,71,66,23,255,134,121,36,40,29,13,1
9391,403,195,208,68,48,37,16,297,123,174,51,49,16,10,1
9392,295,135,160,48,43,29,11,976,496,480,128,111,121,48,1
9393,208,101,107,38,28,24,7,1834,823,1011,297,282,151,63,1
9394,323,162,161,44,28,43,14,870,433,437,133,121,95,25,1
9395,391,208,183,65,49,57,17,700,265,435,134,106,16,3,1
9396,360,192,168,55,45,48,16,367,203,164,41,32,39,20,1
9397,740,313,427,101,135,40,22,390,207,183,50,48,38,15,1
9398,1106,579,527,121,152,113,45,1187,631,556,182,139,152,56,1
9399,745,366,379,110,93,79,45,455,218,237,57,51,42,35,1
9400,1247,620,627,134,149,142,58,1669,1162,507,154,128,86,51,1
9401,576,250,326,93,71,34,15,2985,1374,1611,450,433,312,111,1
9402,392,115,277,117,75,28,17,1270,557,713,130,195,57,30,1
9403,560,254,306,78,67,75,47,1690,1173,517,186,130,110,56,1
9404,1663,775,888,230,184,109,74,550,243,307,91,99,70,10,1
9405,583,322,261,73,66,45,26,1332,652,680,210,180,155,49,1
9406,461,227,234,61,47,54,33,920,492,428,100,92,88,49,1
9407,246,108,138,32,44,21,10,553,309,244,75,60,39,14,1
9408,1473,758,715,205,171,161,65,239,146,93,30,22,35,9,1
9409,1647,794,853,279,235,128,65,345,203,142,47,35,31,11,1
9410,462,228,234,59,47,37,32,2524,1232,1292,398,317,186,61,1
9411,379,203,176,55,48,45,16,998,496,502,149,146,89,27,1
9412,196,107,89,19,18,15,7,450,241,209,67,58,54,23,1
9413,340,169,171,49,42,31,14,131,66,65,21,14,23,7,1
9414,556,269,287,86,66,62,22,130,55,75,21,26,10,3,1
9415,256,134,122,27,31,31,10,622,309,313,75,81,76,29,1
9416,771,361,410,131,99,115,34,923,471,452,119,117,119,41,1
9417,173,110,63,35,6,9,8,303,175,128,43,36,34,12,1
9418,304,135,169,48,36,38,26,470,255,215,68,49,83,15,1
9419,583,322,261,73,66,45,26,508,295,213,42,61,53,17,1
9420,504,272,232,72,41,57,23,283,112,171,48,39,34,15,1
9421,79,38,41,17,8,7,8,211,114,97,32,24,19,10,1
9422,427,218,209,61,53,45,26,467,226,241,55,48,54,23,1
9423,894,420,474,136,146,93,39,1313,644,669,169,90,111,43,1
9424,219,124,95,22,22,23,5,669,323,346,94,89,34,18,1
9425,531,286,245,81,67,42,29,402,227,175,48,40,35,11,1
9426,235,111,124,38,26,31,22,638,300,338,83,53,81,49,1
9427,1989,869,1120,320,274,179,65,202,102,100,29,35,6,9,1
9428,71,33,38,10,2,2,12,863,450,413,116,122,106,41,1
9429,101,41,60,18,19,10,5,808,357,451,116,98,56,36,1
9430,962,500,462,146,134,62,27,814,450,364,91,114,69,12,1
9431,574,277,297,88,77,58,36,398,181,217,65,69,42,17,1
9432,383,204,179,61,32,54,16,516,296,220,79,59,69,16,1
9433,570,318,252,77,48,93,26,195,129,66,21,13,19,6,1
9434,537,270,267,76,63,74,20,390,209,181,59,47,41,26,1
9435,564,284,280,71,64,41,13,432,193,239,55,68,26,15,1
9436,1163,493,670,214,158,106,42,227,104,123,28,32,27,12,1
9437,2442,1193,1249,278,183,170,145,920,492,428,100,92,88,49,1
9438,1215,652,563,129,142,121,62,2414,1189,1225,277,178,170,169,1
9439,1621,750,871,276,243,162,51,1531,691,840,270,226,143,52,1
9440,2045,985,1060,359,339,199,74,101,41,60,18,19,10,5,1
9441,176,73,103,22,29,13,9,632,326,306,92,71,56,19,1
9442,291,141,150,49,43,26,7,199,108,91,36,24,24,9,1
9443,273,148,125,38,31,16,19,757,359,398,109,127,80,26,1
9444,1307,594,713,179,208,102,41,360,188,172,49,48,47,17,1
9445,361,184,177,50,53,51,22,464,242,222,61,68,36,17,1
9446,202,113,89,16,27,21,11,103,56,47,27,7,8,2,1
9447,486,236,250,73,67,59,16,1132,553,579,172,143,150,57,1
9448,416,198,218,58,65,38,14,648,307,341,101,58,76,34,1
9449,858,431,427,94,57,54,30,660,326,334,106,61,71,32,1
9450,1159,641,518,148,115,114,48,124,62,62,22,14,14,8,1
9451,524,264,260,75,75,40,21,648,307,341,101,58,76,34,1
9452,245,112,133,32,45,20,10,255,122,133,35,51,22,13,1
9453,1273,592,681,199,164,139,39,425,198,227,57,69,59,13,1
9454,906,413,493,134,111,94,61,245,112,133,32,45,20,10,1
9455,280,118,162,35,32,41,37,508,267,241,43,35,25,17,1
9456,862,409,453,149,125,86,29,1615,835,780,189,208,172,86,1
9457,1275,579,696,200,172,125,51,193,99,94,31,31,16,12,1
9458,676,295,381,94,71,65,24,1189,559,630,179,147,118,35,1
9459,767,392,375,113,112,83,13,816,428,388,95,87,108,32,1
9460,347,183,164,55,45,51,16,1585,840,745,184,152,155,100,1
9461,545,269,276,80,76,27,32,648,307,341,101,58,76,34,1
9462,826,410,416,98,94,107,39,1132,553,579,172,143,150,57,1
9463,1102,511,591,171,179,148,52,557,240,317,97,74,68,37,1
9464,477,281,196,56,39,39,13,671,318,353,83,124,46,34,1
9465,292,152,140,46,38,35,12,770,355,415,103,142,75,42,1
9466,156,64,92,39,19,15,8,168,120,48,7,5,20,7,1
9467,294,122,172,46,65,18,11,165,83,82,16,29,11,9,1
9468,393,175,218,66,67,21,10,247,110,137,34,45,23,10,1
9469,268,157,111,26,30,28,13,94,55,39,18,6,18,5,1
9470,429,219,210,46,66,42,17,345,155,190,49,56,23,6,1
9471,265,141,124,28,30,23,10,601,313,288,42,48,25,36,1
9472,848,461,387,111,102,108,42,1185,585,600,180,174,113,58,1
9473,748,355,393,121,91,95,26,328,170,158,48,31,45,15,1
9474,1215,572,643,151,105,127,54,413,207,206,68,39,58,43,1
9475,378,222,156,39,25,51,25,362,225,137,43,22,30,11,1
9476,676,333,343,111,89,94,39,450,275,175,57,32,48,15,1
9477,1186,493,693,184,208,88,32,760,405,355,112,95,92,29,1
9478,210,124,86,27,21,14,8,427,204,223,38,57,26,32,1
9479,288,158,130,59,23,21,10,442,252,190,35,52,20,4,1
9480,140,81,59,16,15,15,12,369,167,202,66,59,39,20,1
9481,582,330,252,82,69,87,21,282,135,147,36,49,25,10,1
9482,1972,846,1126,222,330,114,68,393,186,207,58,50,36,22,1
9483,400,207,193,30,36,12,10,135,73,62,15,16,15,8,1
9484,1202,506,696,209,198,74,44,876,407,469,137,130,73,29,1
9485,357,214,143,30,32,27,13,402,227,175,48,40,35,11,1
9486,733,346,387,98,113,66,26,870,489,381,97,99,76,14,1
9487,456,272,184,53,43,37,29,602,324,278,71,61,91,23,1
9488,211,109,102,33,27,24,11,819,411,408,108,86,90,58,1
9489,171,98,73,15,25,15,10,165,80,85,21,9,18,19,1
9490,140,81,59,16,15,15,12,3144,1617,1527,367,342,278,136,1
9491,75,45,30,17,7,10,5,168,67,101,37,17,13,13,1
9492,425,210,215,56,43,52,25,375,202,173,46,49,41,23,1
9493,446,176,270,64,79,45,24,1133,491,642,192,170,61,29,1
9494,985,466,519,153,122,73,26,445,219,226,61,60,60,21,1
9495,1464,693,771,153,136,91,86,504,259,245,73,56,45,29,1
9496,494,123,371,160,58,29,5,280,142,138,35,37,22,13,1
9497,511,336,175,35,38,69,22,661,361,300,65,82,57,15,1
9498,245,112,133,32,45,20,10,729,321,408,128,84,63,26,1
9499,262,151,111,30,17,32,25,790,352,438,132,87,91,60,1
9500,339,170,169,32,17,24,13,1893,850,1043,280,340,169,80,1
9501,651,323,328,90,65,64,24,939,493,446,113,100,87,31,1
9502,272,173,99,32,32,11,8,958,451,507,165,135,97,41,1
9503,379,203,176,55,48,45,16,724,325,399,98,92,64,24,1
9504,598,323,275,68,53,60,17,365,186,179,48,47,42,13,1
9505,505,254,251,80,77,60,15,468,225,243,67,69,68,19,1
9506,221,80,141,48,37,14,10,160,53,107,31,29,13,3,1
9507,776,346,430,103,102,61,40,592,264,328,86,85,62,41,1
9508,757,373,384,115,93,95,25,303,137,166,54,54,31,15,1
9509,710,361,349,81,98,63,26,1149,568,581,177,133,101,30,1
9510,1162,548,614,191,166,142,38,221,80,141,48,37,14,10,1
9511,377,177,200,63,53,44,16,202,86,116,33,29,26,10,1
9512,168,67,101,37,17,13,13,306,155,151,43,34,36,17,1
9513,211,113,98,38,17,25,8,489,235,254,53,69,49,20,1
9514,1709,942,767,179,148,157,60,1255,708,547,120,68,88,7,1
9515,177,68,109,44,21,17,2,418,204,214,68,66,38,12,1
9516,731,383,348,102,84,68,30,321,187,134,59,29,32,8,1
9517,316,157,159,45,38,22,19,551,298,253,63,65,45,19,1
9518,257,148,109,28,20,21,14,530,259,271,83,50,54,41,1
9519,462,228,234,59,47,37,32,581,254,327,100,83,54,20,1
9520,247,110,137,34,45,23,10,1597,710,887,241,219,146,69,1
9521,536,278,258,72,63,62,20,1132,624,508,199,79,127,41,1
9522,97,46,51,11,12,9,6,195,109,86,25,24,17,6,1
9523,527,257,270,72,68,50,28,745,354,391,116,100,95,46,1
9524,910,431,479,138,103,98,41,309,106,203,66,49,25,10,1
9525,391,208,183,65,49,57,17,397,234,163,44,38,23,21,1
9526,874,431,443,112,120,79,50,448,281,167,47,37,45,13,1
9527,380,187,193,38,51,30,18,750,347,403,105,103,83,29,1
9528,926,435,491,133,132,85,17,445,255,190,57,53,56,28,1
9529,313,150,163,51,38,25,21,377,202,175,46,50,41,23,1
9530,651,307,344,74,130,45,18,1087,523,564,146,177,103,33,1
9531,953,481,472,133,130,77,48,964,408,556,131,153,76,55,1
9532,1074,538,536,190,131,157,35,193,99,94,31,31,16,12,1
9533,392,115,277,117,75,28,17,125,60,65,22,17,14,5,1
9534,350,181,169,44,52,43,13,592,264,328,86,85,62,41,1
9535,756,368,388,114,99,89,30,238,95,143,37,55,4,4,1
9536,158,76,82,18,23,14,8,609,279,330,103,98,72,42,1
9537,503,263,240,72,55,51,34,724,334,390,112,109,79,17,1
9538,770,390,380,104,76,78,32,1401,670,731,174,122,153,57,1
9539,278,137,141,47,32,28,20,503,263,240,72,55,51,34,1
9540,201,78,123,38,31,19,4,705,356,349,111,97,84,36,1
9541,869,488,381,110,77,78,30,450,231,219,77,50,76,16,1
9542,137,70,67,18,13,14,10,854,380,474,137,159,81,31,1
9543,346,208,138,46,39,51,18,686,375,311,89,80,63,20,1
9544,432,190,242,85,82,28,11,2414,1189,1225,277,178,170,169,1
9545,522,235,287,78,67,60,50,712,396,316,78,69,65,25,1
9546,956,403,553,147,135,99,87,496,251,245,66,57,39,22,1
9547,2024,765,1259,283,343,137,76,513,271,242,54,52,44,13,1
9548,303,158,145,47,40,41,12,769,329,440,116,66,55,22,1
9549,140,62,78,28,14,8,5,204,84,120,29,30,16,9,1
9550,210,115,95,31,22,27,10,552,285,267,74,51,69,24,1
9551,372,189,183,60,44,41,18,144,69,75,11,21,8,5,1
9552,435,208,227,68,64,53,23,360,192,168,55,45,48,16,1
9553,99,46,53,18,15,9,7,95,49,46,12,16,9,5,1
9554,245,112,133,32,45,20,10,462,291,171,57,25,53,17,1
9555,646,355,291,99,62,72,21,586,270,316,83,80,59,21,1
9556,1149,568,581,177,133,101,30,522,235,287,78,67,60,50,1
9557,1190,638,552,162,95,112,18,1132,646,486,99,102,71,41,1
9558,207,93,114,20,33,19,10,347,181,166,27,20,12,12,1
9559,556,199,357,125,112,22,13,1017,498,519,136,107,82,52,1
9560,517,295,222,60,55,55,19,240,125,115,34,32,30,8,1
9561,1577,747,830,213,232,147,57,559,296,263,77,69,42,13,1
9562,365,171,194,48,56,36,11,163,71,92,22,38,11,7,1
9563,564,284,280,71,64,41,13,202,102,100,29,35,6,9,1
9564,2414,1189,1225,277,178,170,169,680,308,372,81,72,70,40,1
9565,476,263,213,56,44,50,16,1152,586,566,131,112,117,42,1
9566,375,214,161,38,36,24,17,710,357,353,99,79,72,39,1
9567,179,80,99,16,18,24,13,358,179,179,49,48,49,8,1
9568,1455,765,690,189,162,166,66,536,287,249,64,73,21,27,1
9569,344,181,163,61,37,40,14,642,271,371,106,111,57,23,1
9570,220,113,107,31,21,25,12,297,123,174,51,49,16,10,1
9571,509,254,255,67,55,52,35,427,191,236,67,60,41,34,1
9572,832,428,404,131,89,88,38,2321,1177,1144,236,255,174,254,1
9573,1134,570,564,152,133,131,69,508,267,241,57,49,40,13,1
9574,894,469,425,127,93,82,31,551,237,314,95,79,54,17,1
9575,505,296,209,55,50,45,23,346,208,138,46,39,51,18,1
9576,848,394,454,100,90,101,41,551,298,253,63,65,45,19,1
9577,359,173,186,55,57,44,16,659,325,334,102,85,87,32,1
9578,536,237,299,116,87,42,17,2524,1232,1292,398,317,186,61,1
9579,447,276,171,51,21,38,25,428,237,191,45,25,46,30,1
9580,1664,855,809,204,192,87,48,503,260,243,46,56,33,16,1
9581,4128,2104,2024,581,505,453,205,791,391,400,103,94,59,38,1
9582,1748,791,957,281,247,173,25,433,224,209,56,63,45,14,1
9583,309,161,148,38,34,40,15,171,88,83,20,21,16,7,1
9584,136,66,70,33,11,9,4,425,199,226,54,71,56,11,1
9585,448,238,210,55,49,61,16,203,120,83,27,17,24,12,1
9586,63,33,30,12,11,5,1,158,85,73,24,18,18,8,1
9587,863,458,405,97,82,63,57,671,326,345,111,77,74,11,1
9588,795,444,351,120,97,73,32,835,420,415,104,105,57,47,1
9589,389,176,213,81,59,24,7,568,193,375,112,83,50,15,1
9590,177,67,110,34,24,13,10,432,228,204,59,53,43,15,1
9591,806,436,370,101,100,76,34,443,265,178,47,47,27,8,1
9592,425,199,226,54,71,56,11,482,231,251,76,81,64,26,1
9593,496,251,245,78,62,61,23,193,90,103,26,33,23,11,1
9594,465,218,247,64,51,50,42,1484,731,753,206,175,187,71,1
9595,660,359,301,81,87,102,31,911,493,418,89,140,83,34,1
9596,446,252,194,41,23,54,35,372,237,135,38,22,39,26,1
9597,1004,457,547,150,150,74,52,233,94,139,36,37,15,8,1
9598,1624,808,816,183,197,132,170,390,203,187,58,40,43,19,1
9599,458,158,300,91,59,57,33,702,298,404,134,111,48,18,1
9600,396,150,246,103,64,38,3,1045,374,671,217,143,103,29,1
9601,1043,479,564,200,131,123,62,209,75,134,53,48,20,9,1
9602,719,364,355,104,100,58,34,875,376,499,155,125,53,39,1
9603,298,159,139,39,40,33,15,239,110,129,32,32,24,10,1
9604,278,111,167,66,66,19,8,1202,506,696,209,198,74,44,1
9605,1970,978,992,245,206,198,80,1149,568,581,177,133,101,30,1
9606,2045,985,1060,359,339,199,74,529,274,255,57,62,38,14,1
9607,146,75,71,13,32,15,11,632,326,306,92,71,56,19,1
9608,358,170,188,54,55,20,10,1106,579,527,121,152,113,45,1
9609,126,66,60,24,10,7,9,92,46,46,14,9,8,6,1
9610,833,467,366,106,84,105,34,767,392,375,113,112,83,13,1
9611,499,252,247,75,71,65,25,332,140,192,60,49,31,21,1
9612,2063,1024,1039,175,117,80,97,463,236,227,64,50,44,29,1
9613,270,147,123,34,17,39,21,2414,1189,1225,277,178,170,169,1
9614,204,96,108,31,37,20,5,745,391,354,85,81,52,39,1
9615,863,458,405,97,82,63,57,1105,514,591,164,147,85,21,1
9616,377,177,200,63,53,44,16,503,263,240,72,55,51,34,1
9617,247,110,137,34,45,23,10,305,95,210,88,27,15,9,1
9618,403,195,208,68,48,37,16,982,545,437,119,100,92,40,1
9619,215,105,110,26,22,19,9,359,219,140,42,19,56,19,1
9620,545,263,282,80,80,68,22,149,68,81,15,38,11,10,1
9621,301,150,151,45,47,33,13,3969,1703,2266,619,432,259,144,1
9622,221,110,111,28,32,25,11,327,177,150,40,40,38,18,1
9623,119,86,33,6,1,4,5,295,143,152,38,47,22,25,1
9624,261,130,131,27,41,19,16,292,153,139,39,33,24,21,1
9625,1516,963,553,148,152,111,26,333,171,162,41,44,48,23,1
9626,377,184,193,56,53,44,14,207,107,100,27,25,20,11,1
9627,694,315,379,101,87,47,17,702,298,404,134,111,48,18,1
9628,444,230,214,46,61,53,26,1038,470,568,130,123,86,51,1
9629,427,214,213,65,58,26,18,1292,592,700,186,169,108,22,1
9630,686,375,311,89,80,63,20,422,213,209,63,60,35,13,1
9631,530,259,271,83,50,54,41,149,68,81,15,38,11,10,1
9632,431,227,204,53,60,58,12,1062,522,540,151,147,105,66,1
9633,150,81,69,23,21,13,5,327,177,150,40,40,38,18,1
9634,1336,633,703,182,197,110,52,648,307,341,101,58,76,34,1
9635,582,330,252,82,69,87,21,178,100,78,23,22,30,6,1
9636,5938,2573,3365,858,958,396,195,377,202,175,46,50,41,23,1
9637,520,245,275,78,80,40,24,1037,575,462,122,150,82,32,1
9638,854,380,474,137,159,81,31,660,359,301,81,87,102,31,1
9639,282,171,111,30,38,15,8,961,507,454,130,102,115,37,1
9640,825,427,398,79,95,81,48,536,226,310,93,63,62,26,1
9641,621,301,320,76,64,46,34,998,496,502,149,146,89,27,1
9642,512,261,251,79,73,60,21,459,221,238,52,56,51,19,1
9643,295,139,156,48,31,30,17,358,192,166,49,48,49,16,1
9644,321,141,180,45,47,32,17,1092,562,530,126,91,125,84,1
9645,1354,537,817,245,247,117,57,583,248,335,115,111,52,16,1
9646,810,367,443,115,92,94,59,397,237,160,47,15,56,21,1
9647,516,227,289,75,36,54,28,356,185,171,37,31,17,21,1
9648,247,110,137,34,45,23,10,1367,690,677,172,175,154,83,1
9649,158,74,84,26,23,18,18,168,120,48,7,5,20,7,1
9650,667,360,307,76,92,46,27,199,106,93,29,23,26,7,1
9651,785,374,411,56,42,38,25,551,298,253,63,65,45,19,1
9652,285,159,126,36,23,46,13,92,47,45,15,9,9,5,1
9653,375,214,161,43,22,52,25,97,55,42,15,13,11,2,1
9654,295,143,152,38,47,22,25,595,316,279,86,60,65,40,1
9655,552,285,267,74,51,69,24,160,53,107,31,29,13,3,1
9656,149,52,97,36,36,7,4,654,317,337,95,111,44,13,1
9657,574,273,301,101,74,68,26,908,488,420,115,97,111,43,1
9658,284,173,111,28,19,49,12,211,114,97,32,24,19,10,1
9659,791,391,400,103,94,59,38,719,364,355,104,100,58,34,1
9660,744,384,360,104,96,57,31,392,115,277,117,75,28,17,1
9661,815,418,397,97,62,70,17,530,281,249,58,60,33,21,1
9662,2419,1042,1377,389,474,238,59,377,202,175,46,50,41,23,1
9663,679,338,341,96,95,40,23,803,346,457,126,171,74,24,1
9664,589,314,275,70,83,44,28,297,158,139,47,37,37,9,1
9665,344,168,176,65,44,33,15,499,252,247,74,42,55,14,1
9666,766,386,380,101,81,78,31,360,192,168,55,45,48,16,1
9667,335,183,152,36,27,45,11,1304,585,719,179,169,154,47,1
9668,628,345,283,73,75,80,17,1332,652,680,210,180,155,49,1
9669,163,70,93,28,21,17,6,920,526,394,79,58,82,41,1
9670,836,407,429,122,89,61,21,881,383,498,142,148,77,24,1
9671,255,134,121,36,40,29,13,234,133,101,29,25,28,7,1
9672,644,329,315,70,64,50,11,2871,1148,1723,496,469,204,98,1
9673,68,34,34,11,8,3,4,428,228,200,55,50,51,25,1
9674,653,389,264,69,59,51,19,758,360,398,114,107,51,19,1
9675,229,105,124,36,33,12,4,649,330,319,82,67,81,31,1
9676,168,67,101,37,17,13,13,302,138,164,50,36,30,20,1
9677,1455,765,690,189,162,166,66,2472,1055,1417,416,458,235,64,1
9678,245,111,134,31,44,20,11,377,184,193,50,43,33,17,1
9679,520,272,248,74,71,44,15,385,188,197,59,51,43,15,1
9680,767,392,375,113,112,83,13,495,263,232,56,65,66,21,1
9681,245,137,108,34,30,19,10,355,179,176,51,45,45,11,1
9682,1498,615,883,226,244,60,46,462,224,238,77,75,37,13,1
9683,704,356,348,112,94,71,24,746,382,364,117,72,119,28,1
9684,520,223,297,90,60,48,13,168,67,101,37,17,13,13,1
9685,442,254,188,54,31,50,30,1203,651,552,151,128,123,46,1
9686,1748,791,957,281,247,173,25,906,437,469,135,132,49,40,1
9687,676,333,343,111,89,94,39,689,343,346,119,100,86,38,1
9688,1210,592,618,157,138,116,85,906,455,451,116,105,87,46,1
9689,461,208,253,79,76,61,21,1382,689,693,186,176,167,77,1
9690,438,217,221,77,52,62,20,655,328,327,65,54,55,35,1
9691,264,122,142,33,29,13,13,349,131,218,66,76,22,9,1
9692,377,177,200,63,53,44,16,350,224,126,34,14,48,18,1
9693,505,244,261,77,65,56,22,245,111,134,31,44,20,11,1
9694,656,358,298,67,47,64,26,105,63,42,16,10,12,7,1
9695,1691,1159,532,160,109,95,46,652,329,323,65,70,51,50,1
9696,544,299,245,74,67,69,13,508,254,254,74,99,61,12,1
9697,2718,1148,1570,384,286,195,88,815,418,397,97,62,70,17,1
9698,574,269,305,91,63,54,27,173,110,63,35,6,9,8,1
9699,355,165,190,53,56,42,19,363,221,142,36,16,56,25,1
9700,822,417,405,111,127,76,34,824,392,432,106,89,88,32,1
9701,161,73,88,23,22,15,8,587,311,276,84,66,60,25,1
9702,440,255,185,67,28,24,6,502,299,203,57,52,32,11,1
9703,601,313,288,42,48,25,36,755,348,407,109,98,49,23,1
9704,1274,674,600,169,166,82,50,3144,1617,1527,367,342,278,136,1
9705,201,88,113,33,27,20,8,721,346,375,89,73,65,30,1
9706,824,386,438,94,77,81,34,462,233,229,66,49,43,30,1
9707,108,51,57,16,12,16,11,1094,543,551,171,121,129,54,1
9708,215,115,100,27,28,34,16,390,191,199,66,49,43,12,1
9709,1043,479,564,200,131,123,62,538,268,270,58,72,42,25,1
9710,425,210,215,56,43,52,25,347,198,149,45,29,29,8,1
9711,934,386,548,132,120,98,72,1676,860,816,208,192,204,56,1
9712,246,115,131,15,29,10,32,575,218,357,135,58,89,41,1
9713,2644,1346,1298,391,304,315,148,174,87,87,26,16,25,2,1
9714,108,51,57,16,12,16,11,295,143,152,38,47,22,25,1
9715,906,455,451,116,105,87,46,243,117,126,26,37,20,9,1
9716,1863,721,1142,262,283,139,74,527,262,265,62,73,39,49,1
9717,330,157,173,56,42,51,8,262,144,118,19,39,22,8,1
9718,467,232,235,52,40,46,20,217,109,108,34,32,35,7,1
9719,288,153,135,42,35,32,8,680,351,329,93,97,87,27,1
9720,560,260,300,100,58,29,28,173,110,63,35,6,9,8,1
9721,1444,671,773,184,187,97,46,757,373,384,115,93,95,25,1
9722,875,376,499,155,125,53,39,712,331,381,111,86,86,34,1
9723,173,82,91,27,25,28,4,466,260,206,62,44,56,19,1
9724,2045,985,1060,359,339,199,74,3144,1617,1527,367,342,278,136,1
9725,163,70,93,28,21,17,6,648,307,341,101,58,76,34,1
9726,339,170,169,32,17,24,13,347,212,135,35,32,17,6,1
9727,506,243,263,75,70,39,17,281,138,143,50,36,27,16,1
9728,251,178,73,21,12,50,12,1480,789,691,195,151,173,55,1
9729,969,505,464,123,133,92,33,542,249,293,82,69,58,31,1
9730,470,199,271,78,84,33,8,1855,852,1003,329,264,184,83,1
9731,135,65,70,21,25,15,9,4655,2074,2581,545,652,562,399,1
9732,1024,510,514,152,122,131,52,433,237,196,60,52,33,27,1
9733,465,225,240,65,44,65,25,656,358,298,67,47,64,26,1
9734,198,80,118,35,31,14,7,245,111,134,31,44,20,11,1
9735,213,88,125,30,20,12,19,409,208,201,33,45,23,10,1
9736,970,440,530,142,102,111,39,552,285,267,74,51,69,24,1
9737,195,86,109,31,37,19,5,834,483,351,102,83,103,22,1
9738,448,199,249,65,54,38,33,462,233,229,66,49,43,30,1
9739,429,219,210,46,66,42,17,694,260,434,122,92,62,36,1
9740,262,144,118,19,39,22,8,374,184,190,52,38,48,11,1
9741,161,96,65,8,7,16,16,1075,594,481,132,108,101,42,1
9742,391,208,183,65,49,57,17,901,458,443,91,129,86,21,1
9743,870,433,437,133,121,95,25,1836,1051,785,185,221,239,110,1
9744,1337,667,670,137,143,140,35,1290,629,661,191,187,167,55,1
9745,291,146,145,39,45,22,16,293,153,140,45,38,22,15,1
9746,164,88,76,27,20,17,6,1304,585,719,179,169,154,47,1
9747,400,187,213,57,46,51,16,976,496,480,128,111,121,48,1
9748,252,121,131,42,34,12,16,719,364,355,104,100,58,34,1
9749,501,328,173,47,29,65,21,418,246,172,52,39,57,10,1
9750,558,306,252,83,67,64,20,430,239,191,63,42,51,19,1
9751,272,173,99,32,32,11,8,456,220,236,67,75,30,21,1
9752,1712,926,786,199,198,156,71,921,455,466,144,127,108,39,1
9753,508,254,254,74,99,61,12,680,493,187,64,34,48,12,1
9754,427,191,236,67,60,41,34,257,148,109,28,20,21,14,1
9755,920,492,428,100,92,88,49,778,367,411,90,85,64,43,1
9756,2644,1346,1298,391,304,315,148,437,228,209,47,61,26,11,1
9757,1098,519,579,182,159,79,42,2045,985,1060,359,339,199,74,1
9758,551,286,265,79,71,45,24,307,154,153,39,36,31,12,1
9759,391,208,183,65,49,57,17,473,217,256,59,44,34,21,1
9760,315,129,186,51,29,24,29,1074,539,535,136,87,87,66,1
9761,2803,1300,1503,392,510,170,57,448,236,212,53,64,56,24,1
9762,271,131,140,55,17,30,16,373,142,231,61,66,29,13,1
9763,1100,474,626,197,143,126,41,480,234,246,79,77,65,23,1
9764,562,273,289,76,92,45,24,243,70,173,54,65,8,6,1
9765,374,191,183,70,48,61,13,912,461,451,127,109,96,48,1
9766,351,184,167,59,45,54,9,768,378,390,105,104,63,26,1
9767,633,311,322,94,82,45,20,277,163,114,33,24,21,16,1
9768,580,328,252,63,50,80,31,266,152,114,31,13,37,11,1
9769,601,313,288,42,48,25,36,372,222,150,59,31,75,13,1
9770,340,169,171,40,39,36,22,475,237,238,59,67,35,21,1
9771,541,273,268,67,48,48,30,154,75,79,28,23,16,6,1
9772,415,189,226,69,54,50,21,750,347,403,105,103,83,29,1
9773,666,347,319,92,73,63,25,1670,1140,530,173,120,89,53,1
9774,2758,1332,1426,394,384,287,131,406,200,206,58,65,57,16,1
9775,593,266,327,102,84,69,24,537,276,261,75,68,68,22,1
9776,665,341,324,109,79,38,22,758,360,398,114,107,51,19,1
9777,331,134,197,61,67,26,13,410,186,224,72,57,52,22,1
9778,350,180,170,64,46,55,12,149,68,81,15,38,11,10,1
9779,1255,666,589,145,142,120,82,365,186,179,48,47,42,13,1
9780,503,263,240,72,55,51,34,1336,724,612,209,141,133,60,1
9781,2440,1061,1379,377,326,172,62,894,420,474,136,146,93,39,1
9782,1190,537,653,207,186,101,26,211,138,73,14,11,22,17,1
9783,265,119,146,44,52,12,9,201,86,115,33,37,8,7,1
9784,540,261,279,62,49,59,26,292,150,142,31,43,39,16,1
9785,605,283,322,94,72,64,39,163,71,92,22,38,11,7,1
9786,443,208,235,43,55,51,50,329,182,147,34,34,40,31,1
9787,466,186,280,71,84,30,11,653,389,264,69,59,51,19,1
9788,618,307,311,73,54,46,18,1272,520,752,235,242,117,54,1
9789,504,259,245,73,56,45,29,423,222,201,51,33,41,28,1
9790,189,105,84,17,20,21,10,368,141,227,64,61,24,13,1
9791,543,221,322,78,122,37,12,1020,410,610,220,221,32,13,1
9792,226,118,108,32,30,18,11,418,215,203,60,69,35,14,1
9793,325,184,141,43,34,22,18,1647,794,853,222,218,151,65,1
9794,240,141,99,31,20,28,7,300,157,143,41,25,25,23,1
9795,2579,1337,1242,316,280,305,121,1270,557,713,130,195,57,30,1
9796,729,358,371,116,99,89,33,724,320,404,120,147,67,25,1
9797,210,115,95,31,22,27,10,1101,521,580,177,168,86,45,1
9798,576,250,326,93,71,34,15,240,167,73,32,12,8,21,1
9799,518,274,244,76,58,55,20,462,251,211,74,53,41,18,1
9800,537,288,249,60,60,61,19,684,288,396,107,90,54,42,1
9801,443,208,235,43,55,51,50,780,359,421,160,78,169,16,1
9802,2004,839,1165,291,300,148,108,271,131,140,47,37,41,11,1
9803,881,419,462,132,82,81,24,2871,1148,1723,496,469,204,98,1
9804,285,148,137,31,42,42,16,297,158,139,47,37,37,9,1
9805,317,153,164,39,30,35,13,676,333,343,111,89,94,39,1
9806,309,164,145,35,47,30,11,425,177,248,72,55,46,21,1
9807,507,248,259,56,49,44,10,286,148,138,29,51,25,6,1
9808,808,484,324,80,63,76,24,442,243,199,60,49,65,13,1
9809,716,354,362,102,87,77,30,140,76,64,15,10,13,15,1
9810,245,112,133,32,45,20,10,622,309,313,75,81,76,29,1
9811,754,182,572,236,122,57,18,743,233,510,148,142,28,17,1
9812,245,122,123,21,32,18,13,483,155,328,138,109,32,9,1
9813,370,173,197,65,57,42,10,503,263,240,72,55,51,34,1
9814,606,279,327,81,70,49,34,334,171,163,48,42,32,18,1
9815,284,111,173,47,34,47,43,341,154,187,34,36,11,11,1
9816,350,180,170,64,46,55,12,482,231,251,76,81,64,26,1
9817,482,231,251,76,81,64,26,928,442,486,139,118,91,43,1
9818,1190,638,552,162,95,112,18,219,124,95,22,22,23,5,1
9819,788,360,428,93,106,67,72,1106,579,527,121,152,113,45,1
9820,111,51,60,20,21,10,11,568,243,325,98,73,56,44,1
9821,160,86,74,21,11,16,16,451,204,247,97,63,53,10,1
9822,572,309,263,64,55,47,29,380,212,168,47,38,19,11,1
9823,223,108,115,35,44,20,11,185,93,92,26,28,18,9,1
9824,552,285,267,74,51,69,24,272,141,131,45,29,36,9,1
9825,1163,493,670,214,158,106,42,185,115,70,19,17,26,6,1
9826,1093,567,526,122,75,71,46,788,381,407,77,41,46,35,1
9827,598,300,298,68,77,59,21,422,198,224,52,52,42,43,1
9828,780,370,410,107,120,75,22,149,68,81,15,38,11,10,1
9829,532,276,256,57,50,32,19,453,216,237,58,60,67,20,1
9830,277,138,139,40,39,20,14,493,208,285,75,77,70,40,1
9831,537,276,261,75,68,68,22,495,233,262,64,39,49,32,1
9832,1140,495,645,129,95,128,159,1114,513,601,179,166,115,46,1
9833,465,225,240,65,44,65,25,832,428,404,131,89,88,38,1
9834,1270,557,713,130,195,57,30,428,228,200,47,33,53,14,1
9835,303,147,156,43,20,32,6,624,308,316,92,72,68,22,1
9836,360,188,172,49,48,47,17,1411,472,939,252,262,58,31,1
9837,464,242,222,61,68,36,17,346,180,166,55,49,38,6,1
9838,178,89,89,26,21,21,10,1450,754,696,207,197,145,54,1
9839,2027,896,1131,340,313,172,86,767,392,375,113,112,83,13,1
9840,553,261,292,73,79,40,26,985,445,540,164,146,68,36,1
9841,154,75,79,17,24,16,13,896,407,489,97,152,70,22,1
9842,427,218,209,56,57,53,24,870,433,437,133,121,95,25,1
9843,87,50,37,16,7,10,5,1749,880,869,237,228,214,112,1
9844,660,359,301,81,87,102,31,3177,1728,1449,392,366,262,67,1
9845,673,318,355,61,71,40,31,2414,1189,1225,277,178,170,169,1
9846,982,494,488,150,117,91,45,665,297,368,111,107,34,12,1
9847,593,266,327,102,84,69,24,557,268,289,66,67,70,17,1
9848,80,42,38,12,7,7,4,294,148,146,35,33,25,14,1
9849,1417,598,819,223,188,135,58,339,183,156,43,45,28,17,1
9850,601,313,288,42,48,25,36,408,215,193,47,31,42,17,1
9851,2556,1169,1387,248,291,227,275,448,275,173,32,53,55,27,1
9852,938,484,454,137,100,104,41,400,215,185,59,54,33,16,1
9853,1474,808,666,160,146,166,60,1254,631,623,152,160,66,44,1
9854,1935,819,1116,350,358,141,67,435,225,210,58,46,50,14,1
9855,741,387,354,118,104,90,27,341,154,187,34,36,11,11,1
9856,382,207,175,55,32,40,13,4391,2256,2135,494,411,423,231,1
9857,261,130,131,27,41,19,16,473,212,261,72,64,45,28,1
9858,2175,1078,1097,364,275,271,81,377,202,175,46,50,41,23,1
9859,331,169,162,40,28,22,14,480,252,228,55,37,49,20,1
9860,283,112,171,48,39,34,15,428,226,202,52,60,75,20,1
9861,1338,633,705,199,151,144,65,931,464,467,109,126,119,42,1
9862,745,366,379,110,93,79,45,706,346,360,118,92,98,56,1
9863,1087,523,564,146,177,103,33,117,57,60,17,14,11,10,1
9864,194,112,82,26,13,17,8,301,150,151,41,30,17,11,1
9865,169,99,70,26,21,20,7,177,99,78,22,23,20,10,1
9866,460,228,232,70,46,46,17,130,71,59,30,9,8,1,1
9867,770,374,396,95,91,79,41,740,313,427,101,135,40,22,1
9868,604,255,349,100,72,55,26,671,303,368,93,68,61,26,1
9869,301,157,144,31,28,34,9,2414,1189,1225,277,178,170,169,1
9870,441,218,223,69,55,50,27,533,297,236,74,57,39,28,1
9871,770,374,396,95,91,79,41,413,236,177,41,25,35,19,1
9872,445,230,215,64,62,50,20,215,105,110,26,22,19,9,1
9873,1354,537,817,245,247,117,57,768,378,390,105,104,63,26,1
9874,171,94,77,24,28,30,11,339,189,150,34,27,55,13,1
9875,173,82,91,23,23,14,12,703,308,395,81,91,66,80,1
9876,412,193,219,69,57,43,14,1272,520,752,235,242,117,54,1
9877,463,231,232,66,69,29,18,505,226,279,68,51,30,15,1
9878,574,318,256,73,61,66,22,375,202,173,46,49,41,23,1
9879,624,204,420,166,101,32,13,735,375,360,103,91,77,46,1
9880,1581,684,897,220,153,118,63,2177,1034,1143,274,228,201,95,1
9881,958,451,507,165,135,97,41,235,119,116,31,26,15,13,1
9882,261,130,131,27,41,19,16,165,83,82,16,29,11,9,1
9883,102,61,41,15,13,8,2,770,390,380,104,76,78,32,1
9884,966,416,550,152,134,98,42,256,141,115,32,22,32,8,1
9885,840,468,372,96,85,121,29,535,301,234,66,61,53,21,1
9886,740,331,409,125,97,79,35,149,77,72,19,15,18,9,1
9887,426,231,195,51,52,45,24,1590,726,864,270,237,126,59,1
9888,134,64,70,19,24,19,4,508,270,238,74,54,57,17,1
9889,502,240,262,78,61,54,32,312,143,169,55,61,12,11,1
9890,294,122,172,46,65,18,11,298,167,131,47,33,40,8,1
9891,345,176,169,34,31,36,11,332,185,147,31,59,7,4,1
9892,1162,515,647,191,143,97,35,847,372,475,141,134,77,27,1
9893,948,484,464,134,131,75,27,473,212,261,72,64,45,28,1
9894,1210,601,609,126,80,120,39,740,313,427,101,135,40,22,1
9895,314,162,152,56,32,36,26,360,167,193,61,34,43,35,1
9896,277,124,153,44,40,35,18,524,264,260,75,75,40,21,1
9897,290,149,141,37,26,41,12,164,88,76,27,20,17,6,1
9898,1189,559,630,179,147,118,35,993,492,501,116,119,135,57,1
9899,430,198,232,57,46,37,19,778,367,411,90,85,64,43,1
9900,1484,737,747,216,178,148,71,1394,717,677,194,190,135,53,1
9901,1258,531,727,218,216,108,35,1807,933,874,248,203,173,71,1
9902,198,107,91,26,18,27,6,660,359,301,81,87,102,31,1
9903,1150,620,530,156,128,161,32,1332,659,673,174,170,153,55,1
9904,239,110,129,32,32,24,10,497,227,270,70,63,66,30,1
9905,293,142,151,49,40,42,17,702,298,404,134,111,48,18,1
9906,802,388,414,131,105,96,29,168,76,92,26,21,19,4,1
9907,986,499,487,123,116,98,54,238,138,100,31,15,38,11,1
9908,713,335,378,94,70,56,35,715,324,391,107,92,71,31,1
9909,264,126,138,44,26,25,10,176,84,92,46,10,28,11,1
9910,205,90,115,40,32,25,15,757,359,398,109,127,80,26,1
9911,467,226,241,55,48,54,23,473,217,256,59,44,34,21,1
9912,271,131,140,46,41,36,12,165,80,85,21,9,18,19,1
9913,1029,482,547,147,158,71,32,1071,549,522,133,127,130,59,1
9914,509,254,255,67,55,52,35,553,261,292,73,79,40,26,1
9915,1102,511,591,171,179,148,52,391,212,179,40,45,47,10,1
9916,815,418,397,97,62,70,17,1411,624,787,213,179,91,47,1
9917,66,36,30,11,3,5,5,96,55,41,13,2,8,5,1
9918,560,244,316,92,118,47,12,928,442,486,139,118,91,43,1
9919,369,216,153,36,22,46,23,355,166,189,54,54,39,17,1
9920,424,209,215,56,58,45,24,407,207,200,53,36,38,8,1
9921,708,306,402,116,118,44,41,218,108,110,28,28,22,10,1
9922,440,218,222,58,66,40,24,467,261,206,54,49,48,24,1
9923,1188,558,630,176,163,116,66,302,134,168,50,34,32,15,1
9924,2758,1332,1426,394,384,287,131,433,237,196,60,52,33,27,1
9925,500,193,307,97,68,32,20,288,158,130,59,23,21,10,1
9926,765,407,358,89,75,90,42,1094,611,483,101,89,103,52,1
9927,110,49,61,19,7,2,5,1494,720,774,186,104,112,66,1
9928,1273,592,681,199,164,139,39,1069,512,557,148,126,84,36,1
9929,415,134,281,114,65,27,7,582,282,300,81,66,71,18,1
9930,786,367,419,126,108,87,29,948,484,464,134,131,75,27,1
9931,730,442,288,104,88,42,68,2157,1171,986,306,238,131,32,1
9932,115,60,55,16,9,9,5,298,167,131,47,33,40,8,1
9933,221,75,146,68,21,16,5,437,167,270,126,95,34,10,1
9934,724,325,399,98,92,64,24,243,117,126,26,37,20,9,1
9935,736,388,348,88,85,67,28,113,54,59,10,12,13,7,1
9936,751,390,361,116,98,80,34,647,322,325,104,98,54,14,1
9937,311,175,136,40,30,25,13,632,326,306,92,71,56,19,1
9938,635,333,302,99,75,83,28,906,455,451,116,105,87,46,1
9939,446,246,200,64,48,54,12,270,136,134,38,31,31,4,1
9940,712,327,385,86,54,64,31,504,255,249,56,59,45,13,1
9941,357,214,143,30,32,27,13,2549,1331,1218,366,296,271,130,1
9942,292,108,184,47,64,19,15,359,173,186,55,57,44,16,1
9943,1102,552,550,174,137,137,45,782,421,361,101,97,82,20,1
9944,345,141,204,64,58,13,11,641,324,317,88,92,49,14,1
9945,1744,920,824,223,192,177,58,2489,1251,1238,288,234,283,178,1
9946,491,233,258,81,76,42,25,1076,563,513,129,114,90,37,1
9947,1149,568,581,177,133,101,30,416,210,206,55,54,39,20,1
9948,719,270,449,113,122,44,32,356,178,178,67,41,19,15,1
9949,1290,597,693,182,182,119,63,150,64,86,22,12,29,12,1
9950,330,143,187,63,29,52,20,443,208,235,43,55,51,50,1
9951,614,226,388,103,97,51,30,892,420,472,135,146,98,37,1
9952,146,76,70,16,15,14,14,529,274,255,57,62,38,14,1
9953,208,96,112,31,32,13,9,281,166,115,34,17,36,16,1
9954,872,468,404,129,85,92,34,149,68,81,15,38,11,10,1
9955,1591,734,857,229,225,171,75,412,201,211,75,60,40,13,1
9956,977,406,571,151,128,84,47,767,392,375,113,112,83,13,1
9957,1367,690,677,172,175,154,83,1374,679,695,191,193,154,48,1
9958,471,238,233,66,63,62,19,126,73,53,14,9,8,6,1
9959,288,118,170,50,57,18,15,422,211,211,73,61,43,17,1
9960,624,275,349,93,99,74,22,1670,1140,530,173,120,89,53,1
9961,231,126,105,37,26,29,6,859,395,464,157,119,59,31,1
9962,733,346,387,98,113,66,26,1065,495,570,197,115,100,36,1
9963,293,134,159,40,27,23,30,557,240,317,97,74,68,37,1
9964,406,211,195,55,37,47,16,327,177,150,40,40,38,18,1
9965,402,225,177,62,42,43,21,408,197,211,74,44,53,16,1
9966,236,110,126,31,39,10,8,312,158,154,45,49,29,14,1
9967,679,338,341,96,95,40,23,155,74,81,23,19,20,5,1
9968,549,277,272,94,63,60,25,215,105,110,26,22,19,9,1
9969,400,208,192,62,44,42,21,326,176,150,35,22,29,11,1
9970,1106,579,527,121,152,113,45,1068,539,529,161,134,132,71,1
9971,148,78,70,21,11,14,11,176,92,84,25,26,15,8,1
9972,244,136,108,21,25,25,13,676,333,343,111,89,94,39,1
9973,325,181,144,46,31,48,9,357,182,175,49,36,39,15,1
9974,189,89,100,24,26,18,15,1092,562,530,126,91,125,84,1
9975,684,288,396,107,90,54,42,1247,620,627,134,149,142,58,1
9976,758,360,398,114,107,51,19,235,149,86,30,21,17,5,1
9977,341,170,171,41,66,27,10,240,167,73,32,12,8,21,1
9978,181,96,85,25,23,20,7,641,341,300,101,91,29,22,1
9979,914,453,461,112,115,79,29,189,88,101,31,29,18,10,1
9980,529,274,255,57,62,38,14,864,362,502,142,150,70,19,1
9981,432,188,244,76,81,26,13,984,516,468,78,45,73,12,1
9982,922,491,431,112,92,97,52,450,242,208,53,63,56,22,1
9983,1382,508,874,334,320,98,36,1599,806,793,213,237,100,45,1
9984,309,154,155,42,44,45,16,218,121,97,29,26,21,6,1
9985,919,538,381,111,98,103,41,136,72,64,22,16,7,3,1
9986,541,273,268,67,48,48,30,193,83,110,26,20,16,9,1
9987,2843,1104,1739,429,357,178,95,440,246,194,62,49,41,16,1
9988,508,267,241,57,49,40,13,1332,652,680,210,180,155,49,1
9989,778,353,425,140,89,92,51,375,202,173,46,49,41,23,1
9990,220,113,107,31,21,25,12,288,118,170,50,57,18,15,1
9991,173,88,85,20,21,9,12,771,321,450,151,135,43,15,1
9992,427,191,236,67,60,41,34,425,210,215,56,43,52,25,1
9993,108,51,57,16,12,16,11,913,408,505,141,125,87,36,1
9994,439,220,219,63,72,25,20,815,418,397,97,62,70,17,1
9995,346,191,155,52,38,40,13,595,316,279,86,60,65,40,1
9996,425,210,215,56,43,52,25,646,304,342,104,93,58,26,1
9997,538,263,275,71,85,44,18,928,442,486,139,118,91,43,1
9998,646,304,342,104,93,58,26,605,283,322,94,72,64,39,1
9999,298,167,131,47,33,40,8,425,210,215,56,43,52,25,1
10000,236,121,115,26,45,28,6,317,153,164,34,52,30,14,1
10001,277,124,153,44,40,35,18,211,114,97,32,24,19,10,1
10002,747,469,278,60,41,53,23,301,150,151,41,30,17,11,1
10003,375,202,173,46,49,41,23,166,81,85,30,27,13,8,1
10004,601,290,311,92,89,55,30,246,113,133,33,45,22,10,1
10005,330,143,187,63,29,52,20,752,365,387,104,79,59,44,1
10006,245,122,123,21,32,18,13,890,501,389,115,91,114,39,1
10007,240,128,112,34,29,24,11,448,209,239,36,53,46,52,1
10008,1452,733,719,182,161,179,64,802,388,414,101,93,88,35,1
10009,446,265,181,51,35,27,17,433,221,212,59,42,47,14,1
10010,796,445,351,96,80,90,38,480,244,236,74,47,50,21,1
10011,465,228,237,64,42,63,24,388,245,143,45,25,41,16,1
10012,541,269,272,75,57,59,36,257,148,109,28,20,21,14,1
10013,391,204,187,47,48,38,18,756,362,394,102,104,73,25,1
10014,903,437,466,117,112,108,32,331,169,162,40,28,22,14,1
10015,279,135,144,40,52,40,5,550,243,307,91,99,70,10,1
10016,186,84,102,27,29,21,10,309,161,148,38,34,40,15,1
10017,613,379,234,55,55,72,33,415,217,198,48,43,51,21,1
10018,530,259,271,83,50,54,41,1130,639,491,87,188,57,41,1
10019,247,110,137,34,45,23,10,1859,935,924,240,243,170,88,1
10020,536,278,258,72,63,62,20,998,496,502,149,146,89,27,1
10021,342,177,165,42,44,45,20,247,110,137,34,45,23,10,1
10022,731,383,348,102,84,68,30,614,305,309,96,73,65,24,1
10023,638,260,378,96,100,53,28,98,32,66,15,25,5,4,1
10024,522,245,277,78,69,52,21,455,218,237,57,51,42,35,1
10025,231,126,105,37,26,29,6,652,272,380,116,113,55,27,1
10026,1332,626,706,182,144,80,41,1464,715,749,200,167,181,70,1
10027,409,171,238,69,57,47,17,719,270,449,113,122,44,32,1
10028,646,355,291,99,62,72,21,393,186,207,58,50,36,22,1
10029,732,385,347,95,69,93,34,238,117,121,32,27,22,14,1
10030,680,340,340,70,62,51,24,677,303,374,79,63,55,28,1
10031,756,348,408,101,103,60,40,1424,650,774,152,124,95,87,1
10032,562,214,348,120,86,69,42,89,42,47,16,12,15,6,1
10033,520,245,275,78,80,40,24,359,173,186,55,57,44,16,1
10034,513,271,242,54,52,44,13,424,179,245,65,67,29,11,1
10035,448,229,219,60,50,46,16,1189,559,630,179,147,118,35,1
10036,1455,765,690,189,162,166,66,483,236,247,82,60,43,18,1
10037,367,167,200,63,42,60,17,776,356,420,122,103,85,30,1
10038,125,52,73,27,23,11,10,163,79,84,22,24,13,5,1
10039,418,213,205,54,56,49,13,263,146,117,24,21,23,14,1
10040,298,154,144,44,34,25,11,946,479,467,126,110,110,27,1
10041,245,111,134,31,44,20,11,1822,879,943,236,227,175,97,1
10042,806,436,370,101,100,76,34,251,136,115,38,19,35,15,1
10043,422,213,209,63,60,35,13,131,66,65,21,14,23,7,1
10044,199,87,112,31,27,8,15,424,197,227,67,62,43,17,1
10045,494,123,371,160,58,29,5,748,355,393,121,91,95,26,1
10046,2321,1177,1144,236,255,174,254,448,275,173,32,53,55,27,1
10047,147,81,66,18,18,18,4,330,159,171,48,38,50,19,1
10048,1863,721,1142,262,283,139,74,465,257,208,51,61,54,23,1
10049,410,208,202,59,58,43,26,368,175,193,72,43,39,15,1
10050,464,242,222,61,68,36,17,391,189,202,73,47,37,8,1
10051,381,189,192,74,49,44,13,589,314,275,70,83,44,28,1
10052,418,155,263,88,66,29,11,268,104,164,58,37,30,14,1
10053,1154,540,614,195,160,138,66,217,109,108,34,32,35,7,1
10054,1150,585,565,162,148,102,36,477,301,176,52,35,45,24,1
10055,419,175,244,71,73,23,23,208,96,112,31,32,13,9,1
10056,336,154,182,51,48,39,22,631,294,337,83,129,46,24,1
10057,350,180,170,64,46,55,12,253,148,105,31,15,39,16,1
10058,507,314,193,49,45,59,25,423,237,186,64,44,67,16,1
10059,143,65,78,32,11,11,11,1154,540,614,195,160,138,66,1
10060,1465,716,749,213,205,172,55,1960,810,1150,358,377,121,72,1
10061,538,252,286,77,87,53,30,920,492,428,100,92,88,49,1
10062,728,385,343,110,102,69,14,526,264,262,77,71,61,27,1
10063,851,446,405,93,94,92,37,442,208,234,68,49,51,25,1
10064,372,189,183,60,44,41,18,920,492,428,100,92,88,49,1
10065,467,226,241,55,48,54,23,552,285,267,74,51,69,24,1
10066,524,361,163,41,8,28,16,261,130,131,27,41,19,16,1
10067,410,211,199,55,42,34,27,1273,592,681,199,164,139,39,1
10068,503,263,240,72,55,51,34,165,80,85,30,20,12,9,1
10069,785,374,411,56,42,38,25,2524,1232,1292,398,317,186,61,1
10070,273,126,147,54,49,25,18,1493,672,821,258,211,146,47,1
10071,1132,553,579,172,143,150,57,378,192,186,49,36,45,23,1
10072,904,318,586,264,81,35,10,375,125,250,85,76,17,13,1
10073,509,243,266,80,57,45,19,724,334,390,112,109,79,17,1
10074,219,97,122,30,29,23,9,233,121,112,24,31,30,7,1
10075,1190,638,552,162,95,112,18,267,127,140,43,42,24,9,1
10076,1018,547,471,122,122,120,33,253,148,105,31,15,39,16,1
10077,1274,669,605,185,172,116,43,1960,810,1150,358,377,121,72,1
10078,391,204,187,47,48,38,18,261,130,131,27,41,19,16,1
10079,501,240,261,80,62,49,42,446,176,270,64,79,45,24,1
10080,128,69,59,29,9,8,1,111,29,82,10,54,0,1,1
10081,441,201,240,70,58,55,24,798,378,420,99,94,71,63,1
10082,207,99,108,27,27,21,9,331,183,148,36,44,40,21,1
10083,128,57,71,26,20,12,3,370,177,193,51,61,32,4,1
10084,442,228,214,44,53,39,18,1270,557,713,130,195,57,30,1
10085,154,75,79,28,23,16,6,1247,548,699,168,150,140,43,1
10086,892,397,495,146,63,65,37,837,444,393,128,89,87,37,1
10087,153,71,82,28,20,15,7,527,276,251,64,60,70,20,1
10088,707,295,412,105,105,66,30,1687,770,917,282,226,181,79,1
10089,926,435,491,133,132,85,17,1285,578,707,239,191,136,57,1
10090,709,373,336,73,72,78,24,770,355,415,103,142,75,42,1
10091,504,259,245,73,56,45,29,1158,481,677,169,129,86,40,1
10092,604,282,322,76,74,69,35,277,124,153,44,40,35,18,1
10093,827,422,405,111,104,94,28,375,202,173,46,49,41,23,1
10094,674,334,340,107,71,74,35,350,169,181,52,54,42,20,1
10095,142,60,82,20,28,13,5,58,23,35,14,8,5,7,1
10096,355,168,187,48,57,30,15,510,252,258,75,60,57,24,1
10097,961,463,498,139,156,62,34,517,196,321,103,98,34,12,1
10098,729,321,408,128,84,63,26,474,226,248,47,84,38,26,1
10099,211,113,98,38,17,25,8,976,496,480,128,111,121,48,1
10100,501,240,261,80,62,49,42,208,80,128,26,22,13,16,1
10101,373,174,199,55,49,33,7,181,96,85,25,23,20,7,1
10102,504,237,267,62,66,48,17,770,394,376,92,92,98,33,1
10103,635,333,302,99,75,83,28,244,136,108,21,25,25,13,1
10104,316,156,160,34,28,32,14,526,264,262,77,71,61,27,1
10105,2045,985,1060,359,339,199,74,1051,523,528,164,140,126,50,1
10106,552,285,267,74,51,69,24,655,328,327,65,54,55,35,1
10107,314,142,172,29,48,21,16,437,228,209,47,61,26,11,1
10108,473,230,243,80,56,52,35,533,297,236,74,57,39,28,1
10109,475,203,272,90,58,50,16,211,114,97,32,24,19,10,1
10110,309,137,172,51,50,28,14,769,329,440,116,66,55,22,1
10111,134,72,62,14,28,8,4,770,355,415,103,142,75,42,1
10112,2003,1022,981,195,194,164,229,1133,549,584,99,76,66,54,1
10113,649,337,312,90,73,66,29,247,110,137,34,45,23,10,1
10114,515,253,262,46,83,57,21,187,90,97,28,18,28,10,1
10115,370,194,176,51,57,43,17,271,110,161,33,27,11,8,1
10116,371,199,172,39,44,52,15,459,221,238,52,56,51,19,1
10117,577,217,360,100,116,32,24,380,187,193,38,51,30,18,1
10118,394,202,192,44,43,38,28,332,180,152,46,36,28,14,1
10119,750,347,403,105,103,83,29,635,333,302,99,75,83,28,1
10120,350,224,126,34,14,48,18,184,86,98,26,26,14,11,1
10121,245,112,133,32,45,20,10,790,352,438,132,87,91,60,1
10122,351,195,156,47,53,25,14,344,168,176,65,44,33,15,1
10123,2416,1280,1136,140,374,175,47,508,279,229,67,54,73,15,1
10124,688,310,378,130,82,78,47,512,248,264,66,71,49,30,1
10125,224,139,85,20,13,31,12,1279,733,546,143,121,130,49,1
10126,633,262,371,76,137,64,22,171,98,73,15,25,15,10,1
10127,79,40,39,12,13,5,4,489,242,247,83,63,62,19,1
10128,139,64,75,18,17,18,4,615,293,322,70,67,45,29,1
10129,789,386,403,95,124,83,25,788,390,398,94,118,80,18,1
10130,1441,657,784,140,135,81,73,461,207,254,82,66,55,33,1
10131,4967,2501,2466,718,692,594,248,2758,1332,1426,394,384,287,131,1
10132,426,212,214,63,48,34,18,1477,738,739,176,176,145,72,1
10133,211,114,97,32,24,19,10,204,96,108,31,37,20,5,1
10134,411,208,203,63,44,52,19,339,170,169,32,17,24,13,1
10135,427,215,212,69,35,51,21,437,228,209,47,61,26,11,1
10136,1001,417,584,186,147,96,47,352,179,173,54,46,35,22,1
10137,407,164,243,88,42,40,22,532,187,345,127,64,89,45,1
10138,1150,585,565,162,148,102,36,1584,831,753,197,161,142,83,1
10139,294,146,148,50,45,51,15,1038,470,568,130,123,86,51,1
10140,750,347,403,105,103,83,29,393,198,195,47,48,39,14,1
10141,488,274,214,58,51,38,17,1690,1173,517,186,130,110,56,1
10142,1061,440,621,189,149,153,72,396,150,246,103,64,38,3,1
10143,651,323,328,90,65,64,24,683,341,342,107,77,93,43,1
10144,509,241,268,67,53,56,13,876,457,419,88,124,67,47,1
10145,1177,666,511,131,99,88,35,530,259,271,83,50,54,41,1
10146,482,231,251,76,81,64,26,331,193,138,44,37,18,9,1
10147,191,72,119,40,41,17,8,615,356,259,90,56,97,19,1
10148,703,308,395,81,91,66,80,3396,1499,1897,325,572,309,90,1
10149,933,536,397,96,90,71,41,1441,657,784,140,135,81,73,1
10150,435,208,227,68,64,53,23,1367,690,677,172,175,154,83,1
10151,261,108,153,35,37,16,6,495,292,203,49,33,62,20,1
10152,331,169,162,40,28,22,14,765,295,470,200,142,84,27,1
10153,672,334,338,110,93,91,41,461,233,228,75,64,36,18,1
10154,465,224,241,63,54,54,31,837,464,373,104,72,85,49,1
10155,468,233,235,65,61,49,34,127,58,69,18,17,10,5,1
10156,485,209,276,78,69,37,30,462,233,229,66,49,43,30,1
10157,613,373,240,74,57,52,20,236,145,91,17,19,30,18,1
10158,464,242,222,61,68,36,17,158,85,73,24,18,18,8,1
10159,199,101,98,22,25,9,12,318,165,153,53,37,36,13,1
10160,109,53,56,17,8,13,7,355,214,141,43,29,63,13,1
10161,201,103,98,18,25,40,18,1132,646,486,99,102,71,41,1
10162,1164,622,542,150,143,78,35,180,103,77,22,19,29,8,1
10163,1024,507,517,141,122,119,46,1040,564,476,134,110,114,51,1
10164,464,236,228,64,56,53,28,409,200,209,69,56,44,13,1
10165,609,292,317,102,96,64,21,933,536,397,96,90,71,41,1
10166,139,68,71,22,16,19,7,389,249,140,46,14,40,15,1
10167,1018,547,471,122,122,120,33,537,276,261,75,68,68,22,1
10168,393,186,207,58,50,36,22,1014,490,524,177,137,94,38,1
10169,95,44,51,14,13,7,4,505,254,251,80,77,60,15,1
10170,1816,865,951,246,230,189,76,1270,557,713,130,195,57,30,1
10171,102,51,51,12,15,12,3,142,80,62,24,12,21,4,1
10172,1220,481,739,252,271,65,30,906,455,451,116,105,87,46,1
10173,540,269,271,51,70,43,26,1124,615,509,157,125,128,52,1
10174,317,156,161,49,51,18,10,758,362,396,115,102,35,13,1
10175,1440,759,681,173,170,178,71,234,129,105,31,22,19,18,1
10176,422,227,195,62,36,45,15,372,206,166,43,32,49,12,1
10177,413,206,207,38,55,19,10,928,442,486,139,118,91,43,1
10178,3097,1431,1666,473,433,300,121,2639,1436,1203,317,307,242,77,1
10179,906,455,451,116,105,87,46,529,283,246,66,69,66,25,1
10180,4128,2104,2024,581,505,453,205,261,130,131,27,41,19,16,1
10181,256,125,131,34,27,24,14,164,88,76,27,20,17,6,1
10182,1309,667,642,183,174,139,54,3312,1761,1551,403,345,309,127,1
10183,1125,581,544,135,124,137,47,380,212,168,47,38,19,11,1
10184,1792,658,1134,393,250,134,38,1425,670,755,153,189,122,85,1
10185,182,71,111,45,36,11,13,375,202,173,46,49,41,23,1
10186,163,71,92,22,38,11,7,432,228,204,59,53,43,15,1
10187,208,100,108,27,29,18,9,997,441,556,152,165,92,41,1
10188,933,536,397,96,90,71,41,530,244,286,103,62,42,20,1
10189,619,343,276,88,65,84,25,643,373,270,91,43,113,21,1
10190,102,28,74,17,47,0,1,327,172,155,38,41,41,15,1
10191,363,178,185,54,48,21,13,681,322,359,100,87,71,26,1
10192,427,191,236,67,60,41,34,117,60,57,20,17,16,5,1
10193,1710,650,1060,338,287,185,46,482,231,251,76,81,64,26,1
10194,488,296,192,66,54,77,9,930,367,563,181,153,83,48,1
10195,313,166,147,47,44,41,10,168,76,92,26,21,19,4,1
10196,711,344,367,87,109,74,24,480,234,246,79,77,65,23,1
10197,783,429,354,89,73,68,33,294,140,154,47,35,22,17,1
10198,987,515,472,107,110,106,61,346,186,160,48,32,35,14,1
10199,782,347,435,110,92,74,34,544,259,285,76,81,40,20,1
10200,550,319,231,49,65,35,16,131,66,65,21,14,23,7,1
10201,176,84,92,46,10,28,11,859,429,430,126,115,64,33,1
10202,334,172,162,43,39,41,17,347,212,135,35,32,17,6,1
10203,467,250,217,64,49,63,39,467,224,243,70,43,67,23,1
10204,185,83,102,30,19,21,8,467,226,241,55,48,54,23,1
10205,1395,627,768,172,263,141,59,463,267,196,51,36,73,27,1
10206,1006,478,528,153,127,80,61,404,177,227,75,68,45,13,1
10207,124,58,66,20,28,11,7,1443,776,667,191,175,160,56,1
10208,2261,1217,1044,271,243,267,101,330,178,152,49,35,30,15,1
10209,443,208,235,43,55,51,50,589,294,295,37,44,27,33,1
10210,778,391,387,94,77,42,33,437,235,202,72,61,39,17,1
10211,3623,1788,1835,325,354,507,198,4655,2074,2581,545,652,562,399,1
10212,380,184,196,58,52,46,8,1210,592,618,157,138,116,85,1
10213,325,184,141,43,34,22,18,298,167,131,47,33,40,8,1
10214,724,334,390,112,109,79,17,1367,690,677,172,175,154,83,1
10215,351,184,167,59,45,54,9,304,127,177,61,38,31,4,1
10216,2414,1189,1225,277,178,170,169,1937,899,1038,336,332,181,86,1
10217,469,247,222,70,58,82,13,98,48,50,18,4,9,8,1
10218,925,414,511,137,144,59,18,3801,1837,1964,510,442,418,170,1
10219,103,56,47,27,7,8,2,577,277,300,71,59,64,24,1
10220,187,95,92,27,20,16,8,318,176,142,25,32,35,25,1
10221,494,123,371,160,58,29,5,344,109,235,100,39,26,5,1
10222,443,208,235,43,55,51,50,620,334,286,82,55,71,25,1
10223,290,138,152,37,50,24,14,377,184,193,50,43,33,17,1
10224,117,60,57,20,17,16,5,393,210,183,44,53,53,23,1
10225,101,41,60,18,19,10,5,1084,537,547,154,121,92,35,1
10226,724,334,390,112,109,79,17,784,373,411,101,90,91,37,1
10227,546,267,279,90,69,56,19,335,185,150,46,34,36,13,1
10228,480,234,246,79,77,65,23,854,380,474,137,159,81,31,1
10229,565,285,280,72,73,47,31,822,417,405,111,127,76,34,1
10230,922,418,504,120,120,106,31,369,181,188,41,36,54,16,1
10231,606,279,327,81,70,49,34,815,382,433,97,50,88,31,1
10232,3418,1378,2040,515,464,318,121,2639,1436,1203,317,307,242,77,1
10233,508,267,241,43,35,25,17,536,278,258,72,63,62,20,1
10234,656,358,298,67,47,64,26,149,68,81,15,38,11,10,1
10235,408,197,211,74,44,53,16,368,195,173,52,41,42,15,1
10236,3075,1459,1616,390,359,298,207,223,127,96,25,23,33,4,1
10237,84,42,42,10,6,8,9,211,114,97,32,24,19,10,1
10238,1324,657,667,163,122,81,32,969,505,464,123,133,92,33,1
10239,484,223,261,76,70,47,12,2339,1260,1079,336,252,279,106,1
10240,616,296,320,69,76,49,48,522,235,287,78,67,60,50,1
10241,357,147,210,48,37,21,47,349,166,183,49,37,25,52,1
10242,637,316,321,88,91,70,36,675,305,370,114,109,60,21,1
10243,316,156,160,43,42,28,17,769,329,440,116,66,55,22,1
10244,2364,1004,1360,406,426,226,79,864,362,502,142,150,70,19,1
10245,802,449,353,102,87,82,29,155,74,81,23,19,20,5,1
10246,589,296,293,99,76,64,29,413,227,186,45,34,58,23,1
10247,920,492,428,100,92,88,49,854,380,474,137,159,81,31,1
10248,483,236,247,82,60,43,18,595,316,279,86,60,65,40,1
10249,426,228,198,62,42,47,22,320,163,157,44,44,26,15,1
10250,238,91,147,68,19,22,7,588,331,257,86,71,52,12,1
10251,442,252,190,35,52,20,4,450,241,209,67,58,54,23,1
10252,655,281,374,108,103,61,24,1463,521,942,252,204,105,52,1
10253,467,224,243,70,43,67,23,1025,527,498,120,122,142,40,1
10254,183,95,88,27,22,26,5,142,76,66,21,21,22,11,1
10255,461,207,254,82,66,55,33,406,210,196,68,60,25,20,1
10256,595,292,303,79,83,69,24,1332,652,680,210,180,155,49,1
10257,595,316,279,86,60,65,40,1690,810,880,248,238,168,67,1
10258,2549,1331,1218,366,296,271,130,118,56,62,13,14,6,6,1
10259,947,482,465,143,107,89,37,448,223,225,50,58,39,34,1
10260,880,355,525,122,139,75,36,920,492,428,100,92,88,49,1
10261,4391,2256,2135,494,411,423,231,1247,620,627,134,149,142,58,1
10262,424,219,205,61,40,40,23,1581,891,690,189,147,181,64,1
10263,1384,769,615,178,141,219,56,193,99,94,31,31,16,12,1
10264,262,136,126,41,24,23,17,209,75,134,53,48,20,9,1
10265,493,276,217,57,52,46,31,763,361,402,103,144,78,45,1
10266,740,385,355,114,97,91,27,595,316,279,86,60,65,40,1
10267,443,248,195,67,54,40,15,724,334,390,112,109,79,17,1
10268,926,435,491,133,132,85,17,864,362,502,142,150,70,19,1
10269,1037,461,576,146,163,75,44,951,506,445,107,118,79,40,1
10270,924,521,403,99,98,62,35,1170,627,543,131,136,132,47,1
10271,303,137,166,54,54,31,15,147,78,69,20,15,20,7,1
10272,167,79,88,22,26,16,9,240,167,73,32,12,8,21,1
10273,500,215,285,120,41,66,35,710,307,403,117,176,37,9,1
10274,926,435,491,133,132,85,17,552,289,263,80,73,50,18,1
10275,1490,655,835,261,174,109,35,1970,978,992,245,206,198,80,1
10276,569,288,281,86,69,74,24,274,158,116,27,27,22,18,1
10277,1130,538,592,158,118,113,44,647,324,323,101,80,76,43,1
10278,710,375,335,95,94,110,28,129,66,63,23,17,18,4,1
10279,845,402,443,137,126,105,47,217,109,108,34,32,35,7,1
10280,4374,2058,2316,531,605,321,183,173,110,63,35,6,9,8,1
10281,540,271,269,80,77,51,16,96,45,51,13,12,6,4,1
10282,1822,879,943,236,227,175,97,943,485,458,109,87,110,31,1
10283,518,315,203,40,47,57,17,770,355,415,103,142,75,42,1
10284,179,102,77,23,20,6,3,648,262,386,113,108,78,29,1
10285,419,210,209,54,44,31,23,339,170,169,32,17,24,13,1
10286,148,77,71,26,24,23,4,780,354,426,123,102,45,17,1
10287,227,85,142,48,40,17,9,202,102,100,29,35,6,9,1
10288,175,91,84,19,21,21,10,211,126,85,21,20,28,7,1
10289,309,154,155,42,44,45,16,437,221,216,62,64,47,13,1
10290,517,278,239,57,50,78,23,729,391,338,80,64,71,34,1
10291,1097,526,571,131,134,120,43,200,99,101,31,24,26,6,1
10292,480,257,223,74,26,60,27,462,228,234,59,47,37,32,1
10293,288,159,129,27,44,27,15,622,328,294,75,42,67,31,1
10294,1084,537,547,154,121,92,35,603,282,321,74,68,60,38,1
10295,420,218,202,47,49,52,15,897,487,410,92,97,83,31,1
10296,347,181,166,27,20,12,12,461,257,204,63,49,50,29,1
10297,1452,733,719,182,161,179,64,781,418,363,92,90,64,41,1
10298,185,70,115,37,48,15,5,835,420,415,104,105,57,47,1
10299,216,119,97,33,27,28,7,1117,423,694,182,134,88,31,1
10300,429,219,210,46,66,42,17,213,94,119,38,25,16,9,1
10301,126,57,69,31,10,10,3,538,268,270,58,72,42,25,1
10302,2442,1193,1249,278,183,170,145,801,395,406,106,91,61,25,1
10303,466,186,280,71,84,30,11,144,57,87,38,26,10,4,1
10304,164,88,76,27,20,17,6,619,332,287,95,77,74,38,1
10305,365,173,192,47,47,29,14,3144,1617,1527,367,342,278,136,1
10306,1208,575,633,187,204,117,41,1255,586,669,167,149,113,59,1
10307,570,292,278,80,65,72,23,296,154,142,38,38,24,16,1
10308,928,442,486,139,118,91,43,719,364,355,104,100,58,34,1
10309,164,77,87,33,19,6,7,605,263,342,73,103,54,18,1
10310,459,229,230,78,65,59,26,2109,999,1110,332,294,187,89,1
10311,980,537,443,125,99,98,50,723,309,414,106,106,41,40,1
10312,374,235,139,33,16,72,21,299,153,146,32,28,29,12,1
10313,361,184,177,50,53,51,22,131,66,65,21,14,23,7,1
10314,1054,453,601,183,183,107,35,636,320,316,79,61,67,31,1
10315,624,334,290,35,40,26,31,607,317,290,87,80,73,10,1
10316,320,203,117,34,22,36,13,260,150,110,20,22,42,22,1
10317,443,248,195,67,54,40,15,536,278,258,72,63,62,20,1
10318,504,237,267,62,66,48,17,1366,943,423,137,109,58,19,1
10319,432,218,214,57,55,42,11,265,148,117,34,35,42,12,1
10320,436,196,240,62,50,59,19,482,231,251,76,81,64,26,1
10321,858,431,427,94,57,54,30,534,266,268,86,62,37,14,1
10322,1444,671,773,184,187,97,46,191,99,92,25,24,18,8,1
10323,317,153,164,39,30,35,13,825,363,462,97,105,72,75,1
10324,1555,797,758,203,211,195,46,164,89,75,17,21,13,10,1
10325,505,275,230,63,57,35,12,3433,1476,1957,522,578,264,123,1
10326,368,201,167,61,38,38,12,781,367,414,60,67,43,17,1
10327,624,204,420,166,101,32,13,636,336,300,94,65,58,32,1
10328,3623,1788,1835,325,354,507,198,417,222,195,33,32,36,20,1
10329,432,193,239,55,68,26,15,1210,592,618,157,138,116,85,1
10330,1167,640,527,143,121,131,40,825,363,462,97,105,72,75,1
10331,336,134,202,51,64,27,12,911,445,466,154,121,108,48,1
10332,384,241,143,45,18,40,23,354,169,185,54,54,41,19,1
10333,114,64,50,16,19,14,5,480,234,246,79,77,65,23,1
10334,415,228,187,44,44,48,15,677,392,285,77,67,102,19,1
10335,694,360,334,90,88,77,32,417,238,179,60,56,62,27,1
10336,1356,576,780,229,198,107,38,433,222,211,68,58,42,23,1
10337,327,172,155,38,41,41,15,344,201,143,34,22,46,18,1
10338,748,355,393,121,91,95,26,465,228,237,64,42,63,24,1
10339,560,244,316,92,118,47,12,2644,1346,1298,391,304,315,148,1
10340,309,164,145,35,47,30,11,365,186,179,48,47,42,13,1
10341,446,252,194,41,23,54,35,1756,697,1059,328,345,110,27,1
10342,509,262,247,64,70,64,20,128,67,61,19,13,15,4,1
10343,446,221,225,50,44,45,22,234,114,120,34,28,25,9,1
10344,326,160,166,34,33,37,19,1335,701,634,163,140,140,64,1
10345,409,200,209,69,56,44,13,213,129,84,32,14,21,15,1
10346,150,79,71,19,29,19,6,1970,978,992,245,206,198,80,1
10347,833,467,366,106,84,105,34,870,433,437,133,121,95,25,1
10348,911,423,488,140,150,102,32,377,202,175,46,50,41,22,1
10349,140,86,54,17,6,20,7,63,29,34,13,10,4,8,1
10350,743,366,377,41,37,26,14,787,386,401,98,95,86,25,1
10351,260,133,127,43,32,39,3,573,316,257,78,80,21,21,1
10352,477,215,262,85,82,51,29,700,305,395,111,99,54,18,1
10353,437,225,212,61,57,66,12,160,83,77,18,13,14,3,1
10354,360,192,168,55,45,48,16,492,280,212,56,61,30,13,1
10355,955,465,490,137,138,119,28,640,339,301,70,64,90,41,1
10356,217,109,108,34,32,35,7,906,455,451,116,105,87,46,1
10357,858,417,441,124,101,85,41,513,277,236,64,62,56,28,1
10358,261,137,124,33,25,49,9,418,213,205,54,56,49,13,1
10359,533,268,265,70,30,46,17,5147,2557,2590,501,472,455,607,1
10360,285,135,150,39,45,33,14,630,326,304,82,62,80,31,1
10361,394,202,192,44,43,38,28,781,418,363,92,90,64,41,1
10362,1192,649,543,153,145,116,57,467,224,243,70,43,67,23,1
10363,275,125,150,37,48,27,7,782,330,452,119,123,25,16,1
10364,239,146,93,30,22,35,9,2758,1332,1426,394,384,287,131,1
10365,370,196,174,63,52,21,18,2138,1161,977,258,229,249,95,1
10366,501,240,261,80,62,49,42,778,353,425,140,89,92,51,1
10367,435,233,202,43,42,39,32,244,160,84,20,22,20,4,1
10368,164,87,77,16,18,12,20,389,239,150,45,20,46,22,1
10369,1187,573,614,188,132,138,52,781,418,363,92,90,64,41,1
10370,403,220,183,57,39,45,11,441,216,225,57,66,57,19,1
10371,730,337,393,115,111,91,26,184,86,98,26,26,14,11,1
10372,1064,576,488,130,119,109,36,544,291,253,62,53,35,26,1
10373,433,221,212,59,42,47,14,938,415,523,115,101,69,30,1
10374,796,445,351,96,80,90,38,583,322,261,73,66,45,26,1
10375,912,460,452,139,132,89,53,1616,735,881,285,248,153,72,1
10376,740,404,336,113,77,87,34,659,361,298,106,66,86,29,1
10377,340,169,171,49,42,31,14,769,329,440,116,66,55,22,1
10378,375,202,173,46,49,41,23,140,81,59,16,15,15,12,1
10379,543,236,307,64,91,38,28,341,178,163,48,44,42,20,1
10380,404,190,214,55,55,35,27,702,298,404,134,111,48,18,1
10381,473,230,243,80,56,52,35,798,287,511,126,125,77,26,1
10382,1573,791,782,198,173,148,46,521,265,256,69,69,61,26,1
10383,987,535,452,124,110,101,45,442,252,190,35,52,20,4,1
10384,509,295,214,55,41,69,35,267,124,143,45,46,26,4,1
10385,215,115,100,27,28,34,16,1863,721,1142,262,283,139,74,1
10386,784,393,391,117,102,65,35,1210,578,632,172,184,94,66,1
10387,471,254,217,56,57,43,11,624,334,290,35,40,26,31,1
10388,848,394,454,100,90,101,41,595,316,279,86,60,65,40,1
10389,1290,629,661,191,187,167,55,1255,666,589,145,142,120,82,1
10390,164,78,86,28,23,12,8,1374,679,695,191,193,154,48,1
10391,266,133,133,54,19,38,10,592,264,328,86,85,62,41,1
10392,183,91,92,21,29,16,10,1834,823,1011,297,282,151,63,1
10393,246,113,133,33,45,22,10,1005,422,583,166,179,70,21,1
10394,622,299,323,86,86,69,35,397,237,160,47,15,56,21,1
10395,352,212,140,37,17,61,20,609,281,328,80,82,67,41,1
10396,1565,699,866,236,276,110,26,470,205,265,71,80,33,11,1
10397,1099,620,479,124,108,127,48,527,263,264,75,71,41,15,1
10398,1158,481,677,169,129,86,40,595,316,279,86,60,65,40,1
10399,770,374,396,95,91,79,41,712,396,316,78,69,65,25,1
10400,365,180,185,63,35,48,19,503,263,240,72,55,51,34,1
10401,349,186,163,43,45,51,12,213,107,106,28,41,19,5,1
10402,139,73,66,26,13,9,9,446,176,270,64,79,45,24,1
10403,1037,575,462,122,150,82,32,74,32,42,13,18,2,6,1
10404,435,221,214,72,45,47,19,441,189,252,73,50,47,23,1
10405,851,446,405,93,94,92,37,625,342,283,62,53,56,28,1
10406,297,158,139,47,37,37,9,1149,568,581,177,133,101,30,1
10407,601,313,288,42,48,25,36,229,114,115,38,30,28,6,1
10408,293,194,99,32,17,47,10,257,166,91,8,17,38,18,1
10409,745,402,343,95,71,69,40,1065,533,532,147,148,176,40,1
10410,418,199,219,55,44,22,15,536,278,258,72,63,62,20,1
10411,738,339,399,102,88,68,35,745,391,354,85,81,52,39,1
10412,1173,508,665,213,192,121,34,467,224,243,70,43,67,23,1
10413,1090,533,557,137,125,75,28,680,308,372,81,72,70,40,1
10414,267,159,108,31,13,22,15,491,270,221,51,47,53,18,1
10415,649,304,345,99,80,67,40,616,304,312,75,71,55,25,1
10416,666,344,322,91,73,91,20,1133,491,642,192,170,61,29,1
10417,920,492,428,100,92,88,49,2639,1436,1203,317,307,242,77,1
10418,758,362,396,115,102,35,13,646,316,330,89,95,48,17,1
10419,2477,1186,1291,256,271,249,90,717,469,248,92,67,22,21,1
10420,160,86,74,21,11,16,16,298,160,138,37,30,22,12,1
10421,785,412,373,114,84,95,38,412,250,162,40,34,58,26,1
10422,989,513,476,125,106,92,60,595,316,279,86,60,65,40,1
10423,906,455,451,116,105,87,46,522,235,287,78,67,60,50,1
10424,676,333,343,111,89,94,39,1382,689,693,186,176,167,77,1
10425,521,289,232,71,58,49,16,201,42,159,19,3,2,75,1
10426,371,123,248,104,70,26,15,159,84,75,13,28,10,8,1
10427,1590,726,864,270,237,126,59,778,367,411,90,85,64,43,1
10428,435,233,202,43,42,39,32,205,123,82,22,8,31,5,1
10429,479,233,246,68,66,36,21,2090,1085,1005,167,141,168,40,1
10430,714,364,350,98,102,91,27,72,30,42,12,8,3,4,1
10431,583,322,261,73,66,45,26,427,218,209,61,53,45,26,1
10432,1124,567,557,118,143,120,51,216,119,97,33,27,28,7,1
10433,462,251,211,74,53,41,18,422,213,209,63,60,35,13,1
10434,144,69,75,11,21,8,5,1970,978,992,245,206,198,80,1
10435,1419,759,660,198,135,147,51,894,492,402,95,103,88,42,1
10436,329,171,158,49,41,31,10,227,107,120,38,33,30,10,1
10437,516,296,220,79,59,69,16,395,222,173,48,42,21,8,1
10438,655,281,374,108,103,61,24,475,235,240,77,58,43,22,1
10439,299,110,189,54,75,17,4,391,208,183,65,49,57,17,1
10440,108,54,54,10,9,5,15,464,297,167,72,30,52,14,1
10441,316,201,115,29,31,12,6,261,130,131,27,41,19,16,1
10442,347,181,166,27,20,12,12,310,141,169,36,38,20,8,1
10443,462,229,233,63,49,42,18,191,99,92,25,24,18,8,1
10444,288,159,129,27,44,27,15,451,267,184,43,39,50,7,1
10445,383,204,179,61,32,54,16,208,128,80,20,17,32,16,1
10446,227,127,100,32,24,31,5,437,167,270,126,95,34,10,1
10447,1706,830,876,265,209,230,63,1937,899,1038,336,332,181,86,1
10448,1566,743,823,261,188,151,48,255,134,121,36,40,29,13,1
10449,176,122,54,8,7,30,9,224,99,125,27,37,14,3,1
10450,595,309,286,63,54,62,25,593,266,327,102,84,69,24,1
10451,441,218,223,69,55,50,27,1158,481,677,169,129,86,40,1
10452,686,334,352,107,93,73,43,647,324,323,101,80,76,43,1
10453,1023,449,574,140,174,76,43,458,225,233,67,61,43,33,1
10454,1105,479,626,182,125,80,29,202,102,100,29,35,6,9,1
10455,529,274,255,57,62,38,14,1043,479,564,200,131,123,62,1
10456,296,153,143,30,62,36,9,825,363,462,97,105,72,75,1
10457,605,285,320,89,61,68,26,421,195,226,73,71,34,15,1
10458,433,221,212,59,42,47,14,452,236,216,73,54,50,29,1
10459,769,329,440,116,66,55,22,758,360,398,114,107,51,19,1
10460,303,146,157,40,28,28,41,154,75,79,28,23,16,6,1
10461,672,334,338,110,93,91,41,686,345,341,98,106,75,25,1
10462,1006,569,437,133,96,76,36,985,551,434,123,93,91,26,1
10463,370,190,180,60,52,37,13,646,316,330,89,95,48,17,1
10464,534,266,268,86,62,37,14,641,341,300,101,91,29,22,1
10465,862,432,430,113,83,100,41,1132,553,579,172,143,150,57,1
10466,4599,2000,2599,590,655,515,413,562,265,297,79,56,72,45,1
10467,509,254,255,67,55,52,35,149,73,76,26,24,17,8,1
10468,750,347,403,105,103,83,29,143,65,78,32,11,11,11,1
10469,684,311,373,109,99,66,16,1785,857,928,246,225,187,93,1
10470,432,181,251,48,75,27,17,458,269,189,56,40,29,7,1
10471,437,167,270,126,95,34,10,224,123,101,23,24,33,6,1
10472,580,339,241,72,47,66,21,202,102,100,29,35,6,9,1
10473,984,509,475,114,109,106,56,605,295,310,74,66,70,36,1
10474,646,316,330,89,95,48,17,149,52,97,36,36,7,4,1
10475,822,424,398,107,106,86,46,194,94,100,35,19,25,16,1
10476,329,190,139,24,23,50,13,338,193,145,34,27,53,17,1
10477,1068,559,509,158,132,122,57,152,79,73,18,13,11,6,1
10478,119,67,52,15,15,7,7,391,203,188,49,34,36,9,1
10479,1037,575,462,122,150,82,32,326,217,109,32,20,43,18,1
10480,1068,559,509,158,132,122,57,160,83,77,18,13,14,3,1
10481,568,243,325,98,73,56,44,557,240,317,97,74,68,37,1
10482,240,141,99,31,20,28,7,435,233,202,43,42,39,32,1
10483,418,215,203,60,69,35,14,439,220,219,63,72,25,20,1
10484,317,153,164,34,52,30,14,298,184,114,45,22,45,12,1
10485,1068,494,574,176,155,81,27,3144,1617,1527,367,342,278,136,1
10486,352,183,169,41,40,38,26,2477,1186,1291,256,271,249,90,1
10487,428,248,180,44,39,28,9,360,192,168,55,45,48,16,1
10488,160,60,100,23,40,19,11,641,324,317,88,92,49,14,1
10489,894,479,415,117,93,119,38,512,261,251,79,73,60,21,1
10490,778,353,425,140,89,92,51,990,410,580,140,175,44,36,1
10491,227,104,123,28,32,27,12,315,150,165,52,36,22,15,1
10492,350,180,170,64,46,55,12,215,115,100,27,28,34,16,1
10493,484,254,230,60,66,56,14,1586,815,771,196,135,138,67,1
10494,193,102,91,23,25,20,10,1242,613,629,174,113,114,53,1
10495,195,100,95,27,20,17,11,1272,520,752,235,242,117,54,1
10496,292,153,139,39,33,24,21,282,171,111,30,38,15,8,1
10497,963,385,578,171,162,62,35,1357,505,852,245,256,70,35,1
10498,520,300,220,66,36,57,23,2725,1490,1235,339,333,254,78,1
10499,283,141,142,32,26,23,26,416,201,215,54,52,39,25,1
10500,476,251,225,57,67,57,18,1378,680,698,160,154,111,38,1
10501,401,204,197,49,33,29,17,331,169,162,40,28,22,14,1
10502,622,299,323,86,86,69,35,425,244,181,38,26,60,26,1
10503,1465,806,659,163,141,107,73,673,317,356,101,85,76,49,1
10504,289,139,150,38,44,23,20,928,442,486,139,118,91,43,1
10505,1190,638,552,162,95,112,18,2157,1171,986,306,238,131,32,1
10506,1447,698,749,214,180,116,46,189,90,99,26,29,17,11,1
10507,159,68,91,27,19,20,14,359,173,186,55,57,44,16,1
10508,676,333,343,111,89,94,39,624,308,316,92,72,68,22,1
10509,1395,627,768,172,263,141,59,425,244,181,38,26,60,26,1
10510,207,107,100,27,25,20,11,619,332,287,95,77,74,38,1
10511,332,211,121,27,16,41,22,363,193,170,52,51,41,14,1
10512,734,339,395,135,89,79,36,280,118,162,35,32,41,37,1
10513,677,245,432,129,155,72,11,331,143,188,66,45,27,8,1
10514,52,24,28,6,4,3,5,1273,592,681,199,164,139,39,1
10515,451,278,173,71,35,58,12,209,75,134,53,48,20,9,1
10516,1102,552,550,174,137,137,45,189,88,101,31,29,18,10,1
10517,593,325,268,84,66,73,24,1255,586,669,167,149,113,59,1
10518,593,266,327,102,84,69,24,364,182,182,49,30,41,14,1
10519,101,41,60,18,19,10,5,1441,657,784,140,135,81,73,1
10520,494,234,260,88,81,61,29,2839,1413,1426,384,301,308,145,1
10521,1647,794,853,279,235,128,65,519,219,300,86,72,50,39,1
10522,425,210,215,56,43,52,25,521,290,231,76,56,76,18,1
10523,1342,673,669,178,154,137,94,513,176,337,101,90,31,25,1
10524,3396,1499,1897,325,572,309,90,354,193,161,51,41,58,13,1
10525,839,427,412,91,83,114,37,1336,633,703,182,197,110,52,1
10526,142,74,68,21,20,24,7,982,545,437,119,100,92,40,1
10527,417,217,200,56,39,62,17,201,103,98,18,25,40,18,1
10528,537,288,249,60,60,61,19,191,101,90,21,23,28,5,1
10529,458,225,233,67,61,43,33,139,62,77,23,6,14,4,1
10530,331,169,162,40,28,22,14,778,367,411,90,85,64,43,1
10531,1134,574,560,157,164,47,48,906,437,469,135,132,49,40,1
10532,304,159,145,38,40,32,3,870,489,381,97,99,76,14,1
10533,462,186,276,73,62,38,15,176,74,102,20,29,7,7,1
10534,832,428,404,131,89,88,38,3418,1378,2040,515,464,318,121,1
10535,782,330,452,119,123,25,16,285,143,142,45,32,21,17,1
10536,2663,1073,1590,548,499,192,64,1123,554,569,142,130,85,36,1
10537,775,324,451,130,140,45,15,703,356,347,96,97,38,22,1
10538,766,395,371,89,86,127,27,119,53,66,33,8,7,6,1
10539,642,271,371,106,111,57,23,433,220,213,67,68,31,19,1
10540,1098,519,579,182,159,79,42,356,185,171,37,31,17,21,1
10541,165,95,70,18,23,19,11,906,455,451,116,105,87,46,1
10542,378,154,224,74,84,35,22,543,246,297,99,93,50,29,1
10543,211,113,98,38,17,25,8,1154,540,614,195,160,138,66,1
10544,684,351,333,104,79,74,19,292,154,138,46,29,41,7,1
10545,1395,627,768,172,263,141,59,136,72,64,22,16,7,3,1
10546,156,64,92,39,19,15,8,467,226,241,55,48,54,23,1
10547,96,50,46,8,15,6,2,119,59,60,29,10,6,4,1
10548,289,164,125,37,31,35,16,873,366,507,127,125,75,21,1
10549,377,212,165,56,37,34,21,355,209,146,41,25,73,14,1
10550,1150,645,505,134,112,131,64,527,263,264,75,71,41,15,1
10551,1210,592,618,157,138,116,85,586,254,332,114,111,55,17,1
10552,333,171,162,41,44,48,23,463,250,213,56,45,73,25,1
10553,432,218,214,57,55,42,11,863,458,405,97,82,63,57,1
10554,462,233,229,66,49,43,30,447,222,225,71,54,44,25,1
10555,297,158,139,47,37,37,9,370,177,193,51,61,32,4,1
10556,391,208,183,65,49,57,17,543,265,278,52,37,54,19,1
10557,439,251,188,59,51,50,13,601,313,288,42,48,25,36,1
10558,277,100,177,35,88,30,2,164,78,86,28,23,12,8,1
10559,485,209,276,78,69,37,30,201,92,109,27,24,16,8,1
10560,718,283,435,126,127,34,29,780,354,426,123,102,45,17,1
10561,108,55,53,19,7,11,2,158,74,84,26,23,18,18,1
10562,984,461,523,109,89,91,52,375,202,173,46,49,41,23,1
10563,470,226,244,81,53,59,39,1608,778,830,243,230,159,74,1
10564,466,242,224,66,53,53,13,411,207,204,51,38,40,15,1
10565,394,202,192,44,43,38,28,894,469,425,127,93,82,31,1
10566,984,459,525,150,145,89,37,480,234,246,79,77,65,23,1
10567,2442,1193,1249,278,183,170,145,350,180,170,64,46,55,12,1
10568,532,276,256,57,50,32,19,661,361,300,65,82,57,15,1
10569,388,213,175,48,28,53,18,119,57,62,18,16,17,4,1
10570,2556,1169,1387,248,291,227,275,906,455,451,116,105,87,46,1
10571,342,160,182,69,40,37,16,693,289,404,95,158,61,15,1
10572,346,192,154,47,29,33,13,320,163,157,44,44,26,15,1
10573,1477,738,739,176,176,145,72,425,202,223,74,56,48,18,1
10574,136,66,70,33,11,9,3,1025,576,449,111,140,69,32,1
10575,1691,1217,474,130,115,73,46,398,216,182,52,33,40,15,1
10576,468,212,256,70,45,30,18,271,159,112,34,34,33,7,1
10577,264,122,142,33,29,13,13,161,75,86,24,20,10,7,1
10578,318,150,168,60,42,32,12,430,192,238,62,67,27,10,1
10579,148,87,61,20,13,21,11,89,45,44,13,4,8,3,1
10580,362,178,184,50,63,17,8,233,121,112,24,31,30,7,1
10581,491,283,208,55,61,40,13,712,399,313,73,50,91,39,1
10582,305,153,152,47,33,22,10,213,76,137,63,36,13,2,1
10583,415,205,210,76,52,55,17,377,184,193,56,53,44,14,1
10584,715,355,360,118,79,71,29,482,231,251,76,81,64,26,1
10585,1070,558,512,154,134,126,54,750,371,379,95,98,86,29,1
10586,765,407,358,89,75,90,42,1268,659,609,119,99,133,48,1
10587,766,352,414,123,82,109,30,789,362,427,90,82,70,35,1
10588,498,289,209,62,41,63,18,499,290,209,59,50,50,19,1
10589,1112,457,655,180,164,98,41,789,362,427,90,82,70,35,1
10590,347,212,135,35,32,17,6,772,363,409,76,120,57,20,1
10591,190,94,96,25,24,18,5,317,153,164,34,52,30,14,1
10592,154,75,79,17,24,16,13,419,175,244,71,73,23,23,1
10593,488,217,271,71,71,50,32,213,114,99,62,7,2,1,1
10594,411,208,203,63,44,52,19,1935,819,1116,350,358,141,67,1
10595,656,358,298,67,47,64,26,1007,503,504,117,105,72,38,1
10596,437,212,225,66,44,44,11,2843,1104,1739,429,357,178,95,1
10597,595,316,279,86,60,65,40,310,141,169,36,38,20,8,1
10598,1066,468,598,175,170,89,55,1038,470,568,130,123,86,51,1
10599,526,264,262,77,71,61,27,976,496,480,128,111,121,48,1
10600,673,317,356,101,85,76,49,279,106,173,48,35,41,39,1
10601,598,300,298,68,77,59,21,168,70,98,19,30,8,12,1
10602,845,402,443,137,126,105,47,377,202,175,46,50,41,23,1
10603,1210,592,618,157,138,116,85,76,31,45,8,14,3,1,1
10604,328,170,158,48,31,45,15,341,154,187,34,36,11,11,1
10605,675,311,364,111,80,96,30,770,374,396,95,91,79,41,1
10606,976,496,480,128,111,121,48,1675,875,800,213,219,196,72,1
10607,851,446,405,93,94,92,37,412,192,220,71,50,48,23,1
10608,590,306,284,69,82,68,27,570,277,293,95,69,75,21,1
10609,244,135,109,36,24,20,10,304,184,120,36,16,36,18,1
10610,651,331,320,93,93,51,28,102,61,41,15,13,8,2,1
10611,323,169,154,47,44,39,20,928,442,486,139,118,91,43,1
10612,135,69,66,21,14,11,5,392,156,236,40,91,28,16,1
10613,719,364,355,104,100,58,34,317,153,164,34,52,30,14,1
10614,862,432,430,113,83,100,41,328,148,180,44,45,40,14,1
10615,269,165,104,24,19,27,7,290,138,152,37,50,24,14,1
10616,316,161,155,46,50,39,16,770,355,415,103,142,75,42,1
10617,125,46,79,24,16,12,2,380,187,193,38,51,30,18,1
10618,327,177,150,40,40,38,18,776,356,420,122,103,85,30,1
10619,591,319,272,96,62,43,19,191,99,92,25,24,18,8,1
10620,740,374,366,117,95,84,33,464,242,222,61,68,36,17,1
10621,750,347,403,105,103,83,29,356,208,148,42,26,57,15,1
10622,577,241,336,112,109,47,21,275,140,135,34,24,32,15,1
10623,589,281,308,69,39,63,20,764,277,487,158,162,64,31,1
10624,205,91,114,31,36,13,8,1279,669,610,164,162,104,55,1
10625,465,240,225,50,54,24,14,785,374,411,56,42,38,25,1
10626,911,423,488,140,150,102,32,264,130,134,38,33,26,10,1
10627,1477,738,739,176,176,145,72,828,459,369,95,92,107,25,1
10628,145,84,61,16,15,14,4,1496,760,736,217,184,151,41,1
10629,297,158,139,47,37,37,9,4684,2161,2523,779,782,304,101,1
10630,1441,657,784,140,135,81,73,427,191,236,67,60,41,34,1
10631,469,253,216,49,51,48,18,261,130,131,27,41,19,16,1
10632,199,113,86,27,17,10,7,283,132,151,57,33,12,7,1
10633,635,333,302,99,75,83,28,379,203,176,55,48,45,16,1
10634,591,263,328,95,90,26,13,1149,568,581,177,133,101,30,1
10635,1161,620,541,119,120,119,47,739,359,380,83,95,53,38,1
10636,722,384,338,94,83,63,35,825,363,462,97,105,72,75,1
10637,356,199,157,43,58,29,12,346,180,166,52,55,36,13,1
10638,215,80,135,54,56,21,9,342,185,157,42,27,31,14,1
10639,848,461,387,111,102,108,42,289,125,164,51,55,17,10,1
10640,342,200,142,39,18,55,20,1187,631,556,182,139,152,56,1
10641,1374,657,717,243,178,185,70,785,374,411,56,42,38,25,1
10642,757,359,398,109,127,80,26,581,254,327,100,83,54,20,1
10643,632,280,352,111,96,55,16,324,154,170,57,40,26,4,1
10644,288,159,129,27,44,27,15,118,52,66,20,15,23,2,1
10645,991,537,454,134,99,80,34,878,453,425,118,97,93,41,1
10646,297,158,139,47,37,37,9,109,42,67,25,13,1,1,1
10647,905,421,484,110,119,105,34,419,208,211,68,60,35,22,1
10648,198,80,118,35,31,14,7,719,364,355,104,100,58,34,1
10649,508,267,241,43,35,25,17,463,236,227,64,50,44,29,1
10650,1901,796,1105,253,274,183,76,418,213,205,54,70,38,18,1
10651,277,124,153,44,40,35,18,573,316,257,78,80,21,21,1
10652,1427,587,840,165,165,76,49,743,366,377,41,37,26,14,1
10653,525,299,226,62,78,61,13,417,182,235,57,109,50,8,1
10654,231,126,105,37,26,29,6,1056,506,550,147,129,106,48,1
10655,195,90,105,28,27,22,8,751,285,466,185,70,117,46,1
10656,177,66,111,35,24,20,24,366,191,175,37,33,19,19,1
10657,365,173,192,47,47,29,14,1573,791,782,198,173,148,46,1
10658,684,288,396,107,90,54,42,465,225,240,65,44,65,25,1
10659,620,307,313,92,91,92,33,425,210,215,56,43,52,25,1
10660,573,278,295,58,79,37,23,396,150,246,103,64,38,3,1
10661,1357,505,852,245,256,70,35,716,364,352,107,80,75,26,1
10662,560,260,300,100,58,29,28,904,436,468,138,146,82,39,1
10663,684,288,396,107,90,54,42,907,455,452,132,117,80,40,1
10664,415,219,196,53,55,57,20,418,248,170,41,31,54,9,1
10665,1009,506,503,146,141,97,55,295,135,160,48,43,29,11,1
10666,2406,1132,1274,362,272,192,66,461,217,244,44,41,27,36,1
10667,490,198,292,65,81,39,27,928,442,486,139,118,91,43,1
10668,434,189,245,76,69,43,18,367,173,194,59,60,32,18,1
10669,368,195,173,52,41,42,15,1487,996,491,147,141,50,35,1
10670,349,166,183,58,32,38,33,591,366,225,66,42,76,43,1
10671,970,486,484,142,120,85,51,140,81,59,16,15,15,12,1
10672,341,178,163,48,44,42,20,403,185,218,67,62,63,19,1
10673,1290,597,693,182,182,119,63,225,102,123,32,32,31,15,1
10674,336,154,182,51,48,39,22,339,183,156,43,45,28,17,1
10675,540,269,271,51,70,43,26,341,178,163,48,44,42,20,1
10676,770,390,380,104,76,78,32,1190,638,552,162,95,112,18,1
10677,2477,1186,1291,256,271,249,90,245,142,103,29,20,21,9,1
10678,467,226,241,55,48,54,23,564,291,273,77,72,95,21,1
10679,320,163,157,44,44,26,15,149,68,81,15,38,11,10,1
10680,158,85,73,24,18,18,8,101,41,60,18,19,10,5,1
10681,2045,985,1060,359,339,199,74,331,193,138,44,37,18,9,1
10682,247,110,137,34,45,23,10,1134,539,595,150,146,78,40,1
10683,815,418,397,97,62,70,17,242,132,110,25,21,26,11,1
10684,1203,741,462,114,97,141,46,462,261,201,69,52,48,12,1
10685,336,134,202,51,64,27,12,4128,2104,2024,581,505,453,205,1
10686,384,237,147,50,43,31,11,473,217,256,59,44,34,21,1
10687,802,388,414,131,105,96,29,770,374,396,95,91,79,41,1
10688,334,172,162,43,39,41,17,780,369,411,130,113,79,35,1
10689,185,115,70,19,17,26,6,377,184,193,50,43,33,17,1
10690,553,247,306,71,82,34,20,297,123,174,51,49,16,10,1
10691,169,85,84,21,14,9,9,585,214,371,77,124,34,8,1
10692,1254,631,623,152,160,66,44,550,243,307,91,99,70,10,1
10693,761,418,343,87,73,89,32,359,171,188,31,25,29,13,1
10694,496,256,240,78,67,75,13,483,274,209,54,39,45,13,1
10695,1738,821,917,242,196,181,58,870,489,381,97,99,76,14,1
10696,416,210,206,55,54,39,20,497,227,270,70,63,66,30,1
10697,458,269,189,56,40,29,7,226,137,89,20,20,18,5,1
10698,101,41,60,18,19,10,5,1215,572,643,151,105,127,54,1
10699,724,325,399,98,92,64,24,217,109,108,34,32,35,7,1
10700,689,343,346,119,100,86,38,332,198,134,29,17,46,28,1
10701,480,234,246,79,77,65,23,530,259,271,83,50,54,41,1
10702,811,441,370,95,84,95,49,2477,1186,1291,256,271,249,90,1
10703,270,136,134,38,31,31,4,201,42,159,19,3,2,75,1
10704,3259,1163,2096,526,657,162,86,496,313,183,38,35,57,23,1
10705,415,209,206,60,67,39,18,1608,924,684,163,133,89,29,1
10706,283,132,151,57,33,12,7,140,70,70,22,17,9,4,1
10707,513,271,242,54,52,44,13,1149,568,581,177,133,101,30,1
10708,424,197,227,67,62,43,17,496,272,224,70,58,42,18,1
10709,771,321,450,151,135,43,15,493,208,285,75,77,70,40,1
10710,335,148,187,52,26,51,12,386,181,205,55,51,57,31,1
10711,360,188,172,49,48,47,17,169,64,105,23,37,11,3,1
10712,605,263,342,73,103,54,18,404,190,214,55,55,35,27,1
10713,711,344,367,87,109,74,24,847,467,380,117,101,67,24,1
10714,451,239,212,53,64,56,22,421,210,211,72,55,44,14,1
10715,897,487,410,92,97,83,31,378,192,186,49,36,45,23,1
10716,458,222,236,69,39,35,18,1304,585,719,179,169,154,47,1
10717,510,264,246,67,66,38,29,482,231,251,76,81,64,26,1
10718,798,385,413,120,115,79,30,623,320,303,103,85,75,15,1
10719,536,278,258,72,63,62,20,895,474,421,122,93,69,25,1
10720,1038,470,568,130,123,86,51,175,86,89,33,25,27,2,1
10721,245,137,108,34,30,19,10,396,215,181,53,43,55,17,1
10722,144,57,87,38,26,10,4,201,42,159,19,3,2,75,1
10723,736,388,348,88,85,67,28,184,78,106,21,25,25,12,1
10724,770,356,414,123,102,66,25,876,397,479,168,168,84,24,1
10725,246,115,131,15,29,10,32,791,348,443,128,110,101,24,1
10726,806,436,370,101,100,76,34,1178,562,616,155,107,127,34,1
10727,432,190,242,85,82,28,11,306,118,188,59,52,18,10,1
10728,590,330,260,79,69,56,13,623,320,303,103,85,75,15,1
10729,466,242,224,66,53,53,13,253,133,120,39,23,19,5,1
10730,478,239,239,65,66,65,21,442,208,234,68,49,51,25,1
10731,358,176,182,69,42,51,15,757,373,384,115,93,95,25,1
10732,508,267,241,43,35,25,17,320,163,157,44,44,26,15,1
10733,351,184,167,59,45,54,9,332,198,134,29,17,46,28,1
10734,1066,587,479,127,108,118,48,417,182,235,57,109,50,8,1
10735,537,276,261,75,68,68,22,750,347,403,105,103,83,29,1
10736,446,176,270,64,79,45,24,1061,440,621,189,149,153,72,1
10737,712,396,316,78,69,65,25,360,188,172,49,48,47,17,1
10738,427,236,191,49,54,46,13,2442,1193,1249,278,183,170,145,1
10739,1251,591,660,183,137,106,50,3130,1364,1766,481,369,294,126,1
10740,553,261,292,73,79,40,26,552,285,267,74,51,69,24,1
10741,277,124,153,44,40,35,18,491,227,264,72,82,46,29,1
10742,991,483,508,166,120,94,42,424,197,227,67,62,43,17,1
10743,454,224,230,71,39,62,22,422,213,209,63,60,35,13,1
10744,794,402,392,96,84,86,30,2725,1490,1235,339,333,254,78,1
10745,377,171,206,59,58,41,22,193,85,108,24,37,20,13,1
10746,1106,579,527,121,152,113,45,201,42,159,19,3,2,75,1
10747,461,287,174,56,27,82,25,349,166,183,56,30,42,31,1
10748,1210,592,618,157,138,116,85,724,325,399,98,92,64,24,1
10749,534,266,268,86,62,37,14,202,102,100,29,35,6,9,1
10750,455,244,211,60,35,60,21,365,186,179,48,47,42,13,1
10751,886,440,446,116,140,95,45,339,170,169,32,17,24,13,1
10752,338,188,150,45,41,31,18,632,326,306,92,71,56,19,1
10753,780,370,410,107,120,75,22,354,169,185,54,54,41,19,1
10754,291,131,160,49,35,32,15,2442,1193,1249,278,183,170,145,1
10755,228,92,136,43,39,16,7,324,174,150,37,24,35,27,1
10756,240,134,106,34,35,15,13,158,85,73,24,18,18,8,1
10757,1242,613,629,174,113,114,53,217,109,108,34,32,35,7,1
10758,205,77,128,31,45,12,11,817,397,420,120,152,48,17,1
10759,1170,510,660,142,182,115,84,303,141,162,42,57,37,20,1
10760,434,237,197,52,64,37,14,294,164,130,42,39,22,7,1
10761,151,83,68,18,19,17,7,354,169,185,54,54,41,19,1
10762,1935,819,1116,350,358,141,67,434,221,213,58,47,54,15,1
10763,683,398,285,71,76,112,49,422,211,211,73,61,43,17,1
10764,503,263,240,72,55,51,34,128,54,74,30,13,8,7,1
10765,673,317,356,101,85,76,49,260,138,122,44,30,28,6,1
10766,764,277,487,158,162,64,31,943,342,601,188,127,74,24,1
10767,101,45,56,17,17,12,9,434,189,245,76,69,43,18,1
10768,419,197,222,70,51,36,19,764,277,487,158,162,64,31,1
10769,119,57,62,16,15,15,4,389,249,140,46,14,40,15,1
10770,723,353,370,120,109,96,33,509,267,242,79,81,38,20,1
10771,466,224,242,68,56,48,16,1051,523,528,164,140,126,50,1
10772,305,162,143,45,34,38,18,1074,539,535,136,87,87,66,1
10773,662,340,322,67,72,71,35,328,148,180,44,45,40,14,1
10774,83,42,41,13,12,5,2,100,51,49,12,12,8,4,1
10775,455,229,226,66,62,63,29,3097,1431,1666,473,433,300,121,1
10776,2040,956,1084,202,190,258,147,2477,1186,1291,256,271,249,90,1
10777,501,240,261,80,62,49,42,698,352,346,83,68,89,32,1
10778,568,243,325,98,73,56,44,595,284,311,69,71,35,49,1
10779,331,169,162,40,28,22,14,380,187,193,38,51,30,18,1
10780,636,336,300,94,65,58,32,577,288,289,85,56,40,20,1
10781,458,222,236,69,39,35,18,260,144,116,30,34,38,9,1
10782,1215,652,563,129,142,121,62,579,321,258,74,70,47,22,1
10783,153,75,78,24,19,13,4,466,269,197,60,37,62,21,1
10784,903,436,467,128,116,83,33,175,90,85,28,21,19,7,1
10785,1004,464,540,143,104,78,55,482,231,251,76,81,64,26,1
10786,711,344,367,87,109,74,24,824,403,421,80,150,65,35,1
10787,360,188,172,49,48,47,17,725,339,386,112,122,93,32,1
10788,552,285,267,74,51,69,24,426,224,202,48,38,53,13,1
10789,468,243,225,60,50,34,32,386,180,206,47,45,21,23,1
10790,589,314,275,70,83,44,28,493,208,285,75,77,70,40,1
10791,985,445,540,164,146,68,36,1203,462,741,215,230,40,22,1
10792,767,392,375,113,112,83,13,828,459,369,95,92,107,25,1
10793,619,289,330,67,77,36,19,619,292,327,73,73,61,32,1
10794,1132,646,486,99,102,71,41,1290,597,693,182,182,119,63,1
10795,247,110,137,34,45,23,10,1103,536,567,171,156,81,43,1
10796,522,265,257,35,39,38,8,568,243,325,98,73,56,44,1
10797,885,424,461,143,114,92,32,540,271,269,80,77,51,16,1
10798,222,119,103,37,32,24,8,222,122,100,39,32,24,9,1
10799,309,149,160,55,33,27,15,202,102,100,29,35,6,9,1
10800,427,236,191,49,54,46,13,422,211,211,73,61,43,17,1
10801,351,184,167,59,45,54,9,888,476,412,98,89,72,61,1
10802,266,138,128,37,25,37,9,267,129,138,45,40,23,14,1
10803,228,72,156,42,27,8,7,538,252,286,77,87,53,30,1
10804,508,267,241,43,35,25,17,882,432,450,115,111,68,44,1
10805,428,248,180,44,39,28,9,158,85,73,24,18,18,8,1
10806,583,322,261,73,66,45,26,450,241,209,67,58,54,23,1
10807,174,82,92,27,23,26,14,173,82,91,27,25,28,4,1
10808,555,278,277,60,70,48,18,304,159,145,38,40,32,3,1
10809,432,181,251,48,75,27,17,537,276,261,75,68,68,22,1
10810,700,305,395,111,99,54,18,2440,1061,1379,377,326,172,62,1
10811,216,119,97,33,27,28,7,528,252,276,97,68,58,22,1
10812,325,153,172,62,37,50,39,503,263,240,72,55,51,34,1
10813,145,70,75,24,16,16,20,344,151,193,59,51,30,9,1
10814,533,254,279,81,78,52,10,1304,585,719,179,169,154,47,1
10815,1544,738,806,239,217,145,91,928,442,486,139,118,91,43,1
10816,580,233,347,78,58,29,13,173,110,63,35,6,9,8,1
10817,268,144,124,33,25,29,14,423,220,203,51,54,46,17,1
10818,561,292,269,88,68,64,22,1290,629,661,191,187,167,55,1
10819,299,140,159,27,59,20,18,659,361,298,106,66,86,29,1
10820,384,196,188,42,43,32,20,376,187,189,55,48,36,17,1
10821,320,163,157,44,44,26,15,770,374,396,95,91,79,41,1
10822,423,198,225,43,47,36,41,522,235,287,78,67,60,50,1
10823,456,209,247,72,58,40,9,226,129,97,20,25,26,11,1
10824,574,356,218,61,44,87,39,589,294,295,37,44,27,33,1
10825,390,207,183,50,48,38,15,1616,735,881,285,248,153,72,1
10826,858,431,427,94,57,54,30,260,149,111,33,22,37,9,1
10827,456,228,228,49,70,32,19,212,106,106,35,19,15,9,1
10828,360,218,142,39,26,50,18,350,213,137,39,21,53,22,1
10829,248,119,129,33,48,20,10,315,150,165,49,59,23,15,1
10830,897,487,410,92,97,83,31,976,496,480,128,111,121,48,1
10831,399,181,218,48,56,37,13,547,292,255,51,55,46,28,1
10832,456,228,228,49,70,32,19,323,181,142,40,37,26,16,1
10833,1462,711,751,219,222,148,65,928,442,486,139,118,91,43,1
10834,948,484,464,134,131,75,27,332,185,147,31,59,7,4,1
10835,140,59,81,25,23,12,6,255,106,149,46,40,21,10,1
10836,317,156,161,49,51,18,10,609,279,330,103,98,72,42,1
10837,436,201,235,54,37,34,20,1198,571,627,177,168,97,54,1
10838,211,138,73,14,11,22,17,582,330,252,82,69,87,21,1
10839,165,83,82,16,29,11,9,297,158,139,47,37,37,9,1
10840,297,158,139,47,37,37,9,270,137,133,30,28,27,11,1
10841,154,75,79,17,24,16,13,4834,2507,2327,618,579,415,201,1
10842,1200,602,598,145,116,110,50,2442,1193,1249,278,183,170,145,1
10843,487,256,231,68,54,59,21,377,202,175,46,50,41,23,1
10844,298,154,144,44,34,25,11,340,158,182,51,56,9,7,1
10845,1480,789,691,195,151,173,55,288,118,170,50,57,18,15,1
10846,505,296,209,55,50,45,23,318,176,142,25,32,35,25,1
10847,434,237,197,52,64,37,14,207,99,108,22,33,20,12,1
10848,866,382,484,116,114,91,28,1247,620,627,134,149,142,58,1
10849,379,203,176,55,48,45,16,367,203,164,41,32,39,20,1
10850,290,157,133,40,28,24,15,291,155,136,34,33,29,15,1
10851,425,224,201,58,56,40,16,839,439,400,101,86,102,43,1
10852,432,188,244,76,81,26,13,466,186,280,71,84,30,11,1
10853,391,208,183,65,49,57,17,323,200,123,33,25,38,18,1
10854,245,112,133,32,45,20,10,963,385,578,171,162,62,35,1
10855,3230,1723,1507,361,358,157,75,832,428,404,131,89,88,38,1
10856,148,64,84,33,19,6,1,339,170,169,32,17,24,13,1
10857,474,258,216,63,48,51,24,536,278,258,72,63,62,20,1
10858,561,210,351,108,77,41,22,307,133,174,65,42,14,9,1
10859,355,214,141,43,29,63,13,395,197,198,44,57,27,18,1
10860,611,229,382,121,126,46,5,217,98,119,33,32,27,7,1
10861,556,259,297,75,69,63,38,327,177,150,56,20,25,6,1
10862,367,195,172,57,54,43,16,1198,571,627,177,168,97,54,1
10863,372,187,185,55,36,45,21,168,82,86,30,23,19,10,1
10864,656,358,298,67,47,64,26,322,179,143,26,26,40,22,1
10865,446,252,194,41,23,54,35,354,168,186,50,53,39,20,1
10866,991,483,508,166,120,94,42,862,427,435,139,98,100,59,1
10867,146,75,71,13,32,15,11,673,317,356,101,85,76,49,1
10868,413,223,190,52,45,53,10,343,185,158,47,28,63,17,1
10869,303,141,162,42,57,37,20,2477,1186,1291,256,271,249,90,1
10870,589,314,275,70,83,44,28,447,194,253,70,67,57,19,1
10871,858,431,427,94,57,54,30,326,141,185,57,39,33,20,1
10872,553,261,292,73,79,40,26,211,114,97,32,24,19,10,1
10873,1058,557,501,128,128,115,43,207,128,79,26,17,19,9,1
10874,751,312,439,131,115,78,48,239,144,95,20,26,23,13,1
10875,522,265,257,35,39,38,8,1800,882,918,202,185,186,49,1
10876,1529,698,831,198,167,141,122,558,286,272,76,67,45,30,1
10877,1354,537,817,245,247,117,57,577,241,336,112,109,47,21,1
10878,589,281,308,69,39,63,20,736,388,348,88,85,67,28,1
10879,317,153,164,39,30,35,13,1382,689,693,186,176,167,77,1
10880,491,283,208,55,61,40,13,670,384,286,58,58,79,52,1
10881,137,60,77,23,23,9,6,493,208,285,75,77,70,40,1
10882,454,229,225,59,60,60,19,767,392,375,113,112,83,13,1
10883,275,125,150,37,48,27,7,592,295,297,79,70,76,11,1
10884,333,192,141,50,48,28,10,217,94,123,29,30,23,17,1
10885,246,115,131,15,29,10,32,145,70,75,24,16,16,20,1
10886,277,141,136,35,21,16,22,175,91,84,22,18,11,20,1
10887,712,327,385,86,54,64,31,522,235,287,78,67,60,50,1
10888,163,70,93,28,21,17,6,501,240,261,80,62,49,42,1
10889,1273,592,681,199,164,139,39,290,127,163,47,58,23,12,1
10890,825,422,403,100,90,62,43,158,82,76,25,26,19,12,1
10891,407,217,190,50,44,54,19,431,228,203,66,46,59,15,1
10892,376,195,181,41,39,52,13,412,192,220,71,50,48,23,1
10893,1011,559,452,121,97,132,33,467,224,243,70,43,67,23,1
10894,114,66,48,13,7,3,7,350,213,137,39,21,53,22,1
10895,99,49,50,16,8,7,8,374,227,147,44,22,54,20,1
10896,456,228,228,49,70,32,19,958,492,466,119,104,119,35,1
10897,466,186,280,71,84,30,11,185,115,70,19,17,26,6,1
10898,478,256,222,79,44,38,15,305,168,137,48,35,40,9,1
10899,346,173,173,50,56,31,14,207,89,118,28,26,16,6,1
10900,1190,638,552,162,95,112,18,2492,894,1598,466,444,164,102,1
10901,785,419,366,96,94,89,33,654,317,337,95,111,44,13,1
10902,2261,1217,1044,271,243,267,101,1597,710,887,241,219,146,69,1
10903,1382,689,693,186,176,167,77,151,84,67,17,17,22,11,1
10904,1170,510,660,142,182,115,84,1172,545,627,156,135,85,96,1
10905,484,192,292,118,68,83,22,510,264,246,67,66,38,29,1
10906,556,307,249,74,53,63,18,117,62,55,24,18,21,2,1
10907,743,366,377,41,37,26,14,497,284,213,69,53,45,16,1
10908,174,79,95,36,37,18,6,146,74,72,26,25,23,4,1
10909,230,117,113,36,29,25,12,853,401,452,121,118,74,38,1
10910,432,193,239,55,68,26,15,202,102,100,29,35,6,9,1
10911,352,179,173,54,46,35,22,367,195,172,57,54,43,16,1
10912,260,92,168,37,43,18,13,301,119,182,53,47,14,20,1
10913,564,291,273,77,72,95,21,1135,624,511,150,118,145,73,1
10914,1123,554,569,142,130,85,36,480,257,223,74,26,60,27,1
10915,171,94,77,24,28,30,11,240,125,115,34,32,30,8,1
10916,1426,807,619,140,99,79,94,781,418,363,92,90,64,41,1
10917,289,143,146,40,35,28,9,553,309,244,75,60,39,14,1
10918,225,102,123,32,32,31,15,864,429,435,129,118,68,35,1
10919,246,115,131,15,29,10,32,554,215,339,102,65,85,42,1
10920,391,208,183,65,49,57,17,141,64,77,26,24,10,6,1
10921,605,283,322,94,72,64,39,862,409,453,149,125,86,29,1
10922,442,252,190,35,52,20,4,1505,681,824,201,204,73,32,1
10923,191,99,92,25,24,18,8,437,225,212,61,57,66,12,1
10924,372,193,179,60,43,29,2,206,94,112,37,36,18,9,1
10925,1441,657,784,140,135,81,73,969,505,464,123,133,92,33,1
10926,503,298,205,62,28,20,4,502,299,203,57,52,32,11,1
10927,228,92,136,43,39,16,7,95,49,46,12,16,9,5,1
10928,770,356,414,123,102,66,25,689,343,346,119,100,86,38,1
10929,471,221,250,87,68,42,25,126,55,71,14,17,12,16,1
10930,120,67,53,13,15,9,6,235,119,116,36,25,24,14,1
10931,536,222,314,101,100,34,22,694,260,434,122,92,62,36,1
10932,168,82,86,30,23,19,10,419,226,193,58,38,39,22,1
10933,1353,661,692,192,197,139,63,3685,1574,2111,579,580,303,116,1
10934,450,215,235,73,72,53,18,1165,567,598,134,119,158,63,1
10935,309,106,203,66,49,25,10,703,356,347,96,97,38,22,1
10936,377,184,193,56,53,44,14,833,452,381,117,85,71,39,1
10937,788,360,428,93,106,67,72,1049,585,464,107,108,120,28,1
10938,543,277,266,62,54,70,19,219,124,95,22,22,23,5,1
10939,415,203,212,77,44,49,18,136,72,64,22,16,7,3,1
10940,651,357,294,81,67,103,18,568,327,241,67,60,66,21,1
10941,501,240,261,80,62,49,42,451,225,226,68,57,65,22,1
10942,246,108,138,32,44,21,10,963,385,578,171,162,62,35,1
10943,524,264,260,75,75,40,21,249,105,144,71,26,13,7,1
10944,201,108,93,36,21,17,4,1512,737,775,238,209,156,57,1
10945,246,123,123,40,31,27,7,1014,490,524,177,137,94,38,1
10946,624,204,420,166,101,32,13,972,501,471,125,156,106,39,1
10947,100,51,49,13,11,7,4,246,128,118,39,34,22,7,1
10948,1609,694,915,204,241,132,122,136,72,64,22,16,7,3,1
10949,552,285,267,74,51,69,24,575,290,285,67,70,28,9,1
10950,659,334,325,90,79,72,36,621,310,311,100,106,77,27,1
10951,95,41,54,15,16,8,5,331,169,162,40,28,22,14,1
10952,255,122,133,35,51,22,13,149,68,81,15,38,11,10,1
10953,246,128,118,39,34,22,7,1976,810,1166,364,387,134,59,1
10954,279,135,144,40,52,40,5,1280,712,568,167,131,135,39,1
10955,350,185,165,53,24,36,15,344,138,206,46,48,24,43,1
10956,1130,639,491,87,188,57,41,2414,1189,1225,277,178,170,169,1
10957,805,338,467,109,145,49,25,76,42,34,12,8,5,7,1
10958,467,226,241,55,48,54,23,257,134,123,35,32,33,9,1
10959,716,354,362,102,87,77,30,611,246,365,116,82,71,27,1
10960,655,336,319,83,62,78,35,285,135,150,39,45,33,14,1
10961,586,270,316,83,80,59,21,1863,721,1142,262,283,139,74,1
10962,206,96,110,33,25,8,6,215,115,100,27,28,34,16,1
10963,435,221,214,72,45,47,19,519,219,300,86,72,50,39,1
10964,744,385,359,125,89,90,23,341,154,187,34,36,11,11,1
10965,553,261,292,73,79,40,26,2639,1436,1203,317,307,242,77,1
10966,665,304,361,90,72,63,28,372,201,171,52,50,42,13,1
10967,1100,474,626,197,143,126,41,427,214,213,65,58,26,18,1
10968,592,291,301,92,93,71,31,651,323,328,90,65,64,24,1
10969,480,234,246,79,77,65,23,324,154,170,57,40,26,4,1
10970,141,68,73,25,20,12,6,4128,2104,2024,581,505,453,205,1
10971,211,114,97,32,24,19,10,459,229,230,78,65,59,26,1
10972,2477,1186,1291,256,271,249,90,224,123,101,23,24,33,6,1
10973,1274,674,600,169,166,82,50,577,342,235,63,57,23,37,1
10974,460,251,209,61,48,43,21,631,309,322,106,83,89,33,1
10975,221,139,82,17,26,39,6,1247,548,699,168,150,140,43,1
10976,304,153,151,40,32,42,13,366,183,183,48,47,36,17,1
10977,728,358,370,118,100,55,29,1586,815,771,196,135,138,67,1
10978,1474,756,718,175,158,169,51,183,63,120,33,49,16,6,1
10979,740,313,427,101,135,40,22,441,216,225,57,66,57,19,1
10980,1018,547,471,122,122,120,33,2471,1130,1341,240,281,219,290,1
10981,456,228,228,49,70,32,19,516,296,220,79,59,69,16,1
10982,415,189,226,69,54,50,21,1124,615,509,157,125,128,52,1
10983,451,209,242,73,53,47,36,396,192,204,71,41,51,15,1
10984,374,191,183,70,48,61,13,710,307,403,117,176,37,9,1
10985,450,241,209,67,58,54,23,526,264,262,77,71,61,27,1
10986,449,240,209,59,55,63,20,476,227,249,52,59,38,17,1
10987,733,438,295,95,79,67,32,482,231,251,76,81,64,26,1
10988,211,138,73,14,11,22,17,1748,791,957,281,247,173,25,1
10989,261,143,118,33,24,32,16,376,190,186,48,52,44,25,1
10990,591,279,312,88,91,52,26,400,203,197,30,36,31,10,1
10991,624,204,420,166,101,32,13,915,336,579,185,199,56,29,1
10992,561,292,269,88,68,64,22,1149,568,581,177,133,101,30,1
10993,1337,667,670,137,143,140,35,808,374,434,140,108,54,17,1
10994,267,127,140,43,42,24,9,323,181,142,40,37,26,16,1
10995,317,153,164,39,30,35,13,473,256,217,66,47,64,20,1
10996,246,115,131,15,29,10,32,595,233,362,143,66,94,47,1
10997,306,144,162,52,35,40,16,1367,690,677,172,175,154,83,1
10998,111,51,60,20,21,10,11,522,235,287,78,67,60,50,1
10999,1158,481,677,169,129,86,40,505,247,258,72,71,60,27,1
11000,199,113,86,27,17,10,7,220,101,119,50,22,23,6,1
11001,1591,704,887,253,227,156,50,189,90,99,26,29,17,11,1
11002,170,81,89,25,24,15,4,438,242,196,48,33,62,26,1
11003,261,144,117,34,22,31,15,423,220,203,51,54,46,17,1
11004,508,266,242,81,62,49,22,358,170,188,54,55,20,10,1
11005,369,181,188,41,36,54,16,825,427,398,79,95,81,48,1
11006,193,99,94,31,31,16,12,1272,651,621,178,194,79,59,1
11007,393,215,178,44,56,49,15,443,240,203,66,31,57,27,1
11008,225,116,109,29,19,25,6,1382,689,693,186,176,167,77,1
11009,606,307,299,92,56,68,30,568,292,276,69,74,59,34,1
11010,465,218,247,64,51,50,42,211,114,97,32,24,19,10,1
11011,670,333,337,95,79,62,21,418,204,214,68,66,38,12,1
11012,1430,718,712,205,172,151,64,455,218,237,57,51,42,35,1
11013,410,211,199,55,42,34,27,533,297,236,74,57,39,28,1
11014,278,111,167,66,66,19,8,279,131,148,48,34,27,15,1
11015,1647,794,853,279,235,128,65,579,321,258,74,70,47,22,1
11016,427,210,217,64,66,45,24,109,53,56,17,8,13,7,1
11017,330,143,187,63,29,52,20,847,372,475,141,134,77,27,1
11018,101,45,56,17,17,12,9,285,109,176,54,80,9,9,1
11019,435,221,214,72,45,47,19,1297,663,634,215,154,118,55,1
11020,584,307,277,54,63,53,10,425,210,215,56,43,52,25,1
11021,834,405,429,112,95,84,34,509,262,247,64,70,64,20,1
11022,940,464,476,116,135,108,58,179,76,103,36,32,9,9,1
11023,854,380,474,137,159,81,31,619,305,314,85,93,71,29,1
11024,1865,943,922,270,209,228,91,1185,585,600,180,174,113,58,1
11025,393,186,207,58,50,36,22,595,316,279,86,60,65,40,1
11026,651,311,340,94,75,59,22,178,88,90,24,21,11,11,1
11027,930,367,563,181,153,83,48,376,139,237,69,73,34,6,1
11028,390,237,153,41,57,22,16,188,99,89,22,21,26,12,1
11029,1098,552,546,157,133,110,58,523,249,274,92,64,58,21,1
11030,1721,809,912,268,234,144,50,206,85,121,31,42,6,17,1
11031,508,267,241,43,35,25,17,431,216,215,46,40,33,9,1
11032,710,307,403,117,176,37,9,765,295,470,200,142,84,27,1
11033,498,263,235,59,63,36,10,1134,570,564,152,133,131,69,1
11034,470,226,244,81,53,59,39,366,184,182,46,42,23,18,1
11035,220,142,78,15,12,17,15,984,516,468,78,45,73,12,1
11036,933,536,397,96,90,71,41,743,366,377,41,37,26,14,1
11037,580,339,241,72,47,66,21,1970,978,992,245,206,198,80,1
11038,750,347,403,105,103,83,29,551,237,314,95,79,54,17,1
11039,424,209,215,56,58,45,24,525,274,251,82,74,60,25,1
11040,262,136,126,41,24,23,17,318,164,154,52,43,34,10,1
11041,614,226,388,103,97,51,30,1834,823,1011,297,282,151,63,1
11042,2414,1189,1225,277,178,170,169,551,298,253,63,65,45,19,1
11043,265,119,146,44,52,12,9,501,267,234,83,62,38,20,1
11044,484,254,230,60,66,56,14,183,97,86,23,24,22,8,1
11045,870,418,452,121,102,109,28,746,442,304,82,71,99,36,1
11046,508,267,241,43,35,25,17,324,190,134,41,27,28,9,1
11047,335,185,150,46,34,36,13,173,88,85,20,21,9,12,1
11048,582,330,252,82,69,87,21,1048,564,484,118,122,113,40,1
11049,2414,1189,1225,277,178,170,169,261,130,131,27,41,19,16,1
11050,558,289,269,83,59,75,19,643,338,305,81,72,78,35,1
11051,1154,540,614,195,160,138,66,592,291,301,92,93,71,31,1
11052,393,186,207,58,50,36,22,843,417,426,121,93,118,41,1
11053,1105,514,591,164,147,85,21,536,278,258,72,63,62,20,1
11054,1251,591,660,183,137,106,50,870,363,507,144,117,76,46,1
11055,297,158,139,47,37,37,9,695,340,355,79,124,53,13,1
11056,352,212,140,37,17,61,20,1009,506,503,146,141,97,55,1
11057,301,118,183,58,36,32,33,497,227,270,70,63,66,30,1
11058,653,298,355,70,101,64,39,215,105,110,27,22,20,9,1
11059,677,323,354,101,109,45,31,391,208,183,65,49,57,17,1
11060,158,85,73,24,18,18,8,587,300,287,67,102,34,20,1
11061,480,234,246,79,77,65,23,1843,654,1189,324,323,102,51,1
11062,589,316,273,83,60,69,25,557,306,251,66,42,52,15,1
11063,454,214,240,56,71,35,16,785,374,411,56,42,38,25,1
11064,326,167,159,46,31,38,13,538,268,270,58,72,42,25,1
11065,424,198,226,57,46,41,19,654,344,310,80,69,57,15,1
11066,454,230,224,63,56,38,33,139,62,77,23,6,14,4,1
11067,338,188,150,45,41,31,18,892,420,472,135,146,98,37,1
11068,381,189,192,74,49,44,13,631,309,322,106,83,89,33,1
11069,697,373,324,105,83,95,38,400,195,205,63,67,40,18,1
11070,686,345,341,98,106,75,25,1480,789,691,195,151,173,55,1
11071,126,57,69,31,10,10,3,1017,498,519,136,107,82,52,1
11072,337,177,160,40,43,45,19,367,161,206,70,48,41,19,1
11073,220,115,105,31,26,22,18,825,363,462,97,105,72,75,1
11074,501,216,285,79,70,54,30,253,148,105,31,15,39,16,1
11075,1627,782,845,204,187,202,108,1270,557,713,130,195,57,30,1
11076,593,305,288,91,83,54,24,118,51,67,25,13,6,7,1
11077,1972,846,1126,222,330,114,68,143,81,62,28,9,8,1,1
11078,817,425,392,120,102,83,26,367,195,172,57,54,43,16,1
11079,709,310,399,95,103,61,30,664,316,348,75,96,53,31,1
11080,870,418,452,121,102,109,28,437,212,225,66,44,44,11,1
11081,2328,1054,1274,377,410,232,62,2419,1042,1377,389,474,238,59,1
11082,288,153,135,42,35,32,8,206,115,91,29,20,19,8,1
11083,4303,2489,1814,436,369,444,134,892,420,472,135,146,98,37,1
11084,2477,1186,1291,256,271,249,90,359,184,175,49,35,32,11,1
11085,926,435,491,133,132,85,17,1484,731,753,206,175,187,71,1
11086,589,281,308,69,39,63,20,345,203,142,47,35,31,11,1
11087,770,390,380,104,76,78,32,480,252,228,55,37,49,20,1
11088,183,89,94,19,24,22,15,724,650,74,44,3,32,3,1
11089,255,130,125,44,18,22,12,1014,490,524,177,137,94,38,1
11090,684,288,396,107,90,54,42,470,230,240,67,60,42,16,1
11091,2414,1189,1225,277,178,170,169,536,237,299,116,87,42,17,1
11092,1432,652,780,217,205,131,81,380,185,195,68,54,32,16,1
11093,875,376,499,155,125,53,39,292,153,139,39,33,24,21,1
11094,86,50,36,9,14,8,7,76,42,34,12,8,5,7,1
11095,462,224,238,77,75,37,13,694,441,253,69,47,82,42,1
11096,429,219,210,46,66,42,17,793,318,475,110,104,45,30,1
11097,512,261,251,79,73,60,21,298,167,131,47,33,40,8,1
11098,395,186,209,53,48,46,30,74,32,42,13,18,2,6,1
11099,1042,530,512,162,150,103,52,540,271,269,80,77,51,16,1
11100,509,262,247,64,70,64,20,676,333,343,111,89,94,39,1
11101,817,425,392,120,102,83,26,908,488,420,115,97,111,43,1
11102,583,322,261,73,66,45,26,906,455,451,116,105,87,46,1
11103,738,339,399,102,88,68,35,512,261,251,79,73,60,21,1
11104,116,55,61,16,7,18,14,780,337,443,112,116,77,28,1
11105,758,360,398,114,107,51,19,179,89,90,36,28,31,9,1
11106,147,72,75,26,10,17,9,894,420,474,136,146,93,39,1
11107,206,85,121,31,42,6,17,136,72,64,22,16,7,3,1
11108,282,152,130,35,27,13,21,310,156,154,27,43,20,6,1
11109,346,186,160,50,33,27,12,328,178,150,36,34,16,14,1
11110,255,122,133,35,51,22,13,198,80,118,35,31,14,7,1
11111,1657,800,857,249,235,154,51,211,114,97,32,24,19,10,1
11112,1069,512,557,148,126,84,36,2440,1061,1379,377,326,172,62,1
11113,360,192,168,55,45,48,16,928,442,486,139,118,91,43,1
11114,1138,615,523,142,120,116,57,724,334,390,112,109,79,17,1
11115,454,191,263,61,66,38,15,854,380,474,137,159,81,31,1
11116,534,285,249,87,77,59,16,784,337,447,127,135,59,29,1
11117,185,70,115,37,48,15,5,1616,735,881,285,248,153,72,1
11118,440,218,222,58,66,40,24,473,245,228,67,52,70,24,1
11119,480,232,248,83,64,51,25,233,121,112,24,31,30,7,1
11120,453,255,198,62,49,29,19,493,208,285,75,77,70,40,1
11121,843,446,397,132,116,107,33,892,420,472,135,146,98,37,1
11122,1032,565,467,133,81,135,49,1336,633,703,182,197,110,52,1
11123,714,364,350,98,102,91,27,290,162,128,38,33,22,17,1
11124,695,373,322,80,59,89,39,673,317,356,101,85,76,49,1
11125,114,70,44,8,11,11,7,771,321,450,151,135,43,15,1
11126,1238,596,642,148,147,126,136,2471,1130,1341,240,281,219,290,1
11127,170,82,88,28,23,20,12,409,200,209,69,56,44,13,1
11128,371,237,134,31,25,43,17,264,142,122,27,26,25,15,1
11129,1004,464,540,143,104,78,55,362,181,181,67,46,43,8,1
11130,440,246,194,62,49,41,16,2414,1189,1225,277,178,170,169,1
11131,1444,671,773,184,187,97,46,211,114,97,32,24,19,10,1
11132,950,497,453,146,127,115,43,255,134,121,36,40,29,13,1
11133,524,237,287,87,75,54,26,1505,681,824,201,204,73,32,1
11134,921,544,377,99,116,105,32,245,111,134,31,44,20,11,1
11135,4640,2231,2409,660,549,437,245,780,337,443,112,116,77,28,1
11136,78,40,38,11,12,5,3,1484,731,753,206,175,187,71,1
11137,433,221,212,59,42,47,14,975,400,575,160,162,62,31,1
11138,438,262,176,30,16,80,8,1064,555,509,111,90,99,32,1
11139,1932,1080,852,221,199,209,71,440,250,190,51,35,64,27,1
11140,953,493,460,122,133,87,47,345,141,204,64,58,13,11,1
11141,270,137,133,30,28,27,11,391,212,179,40,45,47,10,1
11142,428,226,202,52,60,75,20,480,257,223,74,26,60,27,1
11143,459,221,238,52,56,51,19,770,374,396,95,91,79,41,1
11144,714,364,350,98,102,91,27,772,363,409,76,120,57,20,1
11145,304,159,145,38,40,32,3,508,215,293,72,71,42,15,1
11146,536,278,258,72,63,62,20,412,223,189,55,55,41,10,1
11147,743,366,377,41,37,26,14,798,393,405,112,80,83,33,1
11148,1584,831,753,197,161,142,83,1462,652,810,243,199,115,30,1
11149,556,279,277,83,69,71,19,744,385,359,125,89,90,23,1
11150,359,171,188,49,74,45,11,503,263,240,72,55,51,34,1
11151,941,448,493,150,118,127,39,973,522,451,140,134,124,39,1
11152,404,231,173,44,43,24,10,92,40,52,14,23,13,7,1
11153,185,115,70,19,17,26,6,207,99,108,27,27,21,9,1
11154,144,62,82,29,8,19,17,3396,1499,1897,325,572,309,90,1
11155,720,356,364,90,98,61,22,914,453,461,112,115,79,29,1
11156,1102,511,591,171,179,148,52,870,418,452,121,102,109,28,1
11157,825,427,398,79,95,81,48,146,85,61,15,9,12,10,1
11158,743,233,510,148,142,28,17,400,191,209,51,60,30,9,1
11159,194,87,107,30,24,12,10,411,209,202,69,43,18,15,1
11160,2414,1189,1225,277,178,170,169,414,194,220,76,66,49,16,1
11161,862,432,430,113,83,100,41,662,340,322,67,72,71,35,1
11162,426,220,206,49,37,49,13,771,321,450,151,135,43,15,1
11163,1367,690,677,172,175,154,83,497,185,312,63,92,38,28,1
11164,524,274,250,79,59,66,16,670,333,337,95,79,62,21,1
11165,329,181,148,51,31,40,14,246,129,117,38,16,23,17,1
11166,469,221,248,49,60,55,21,536,278,258,72,63,62,20,1
11167,784,373,411,101,90,91,37,786,378,408,101,79,104,35,1
11168,1170,510,660,142,182,115,84,272,124,148,51,36,23,27,1
11169,1320,566,754,235,198,122,36,538,252,286,77,87,53,30,1
11170,543,287,256,71,66,64,23,1106,579,527,121,152,113,45,1
11171,167,80,87,27,14,18,12,339,177,162,40,36,51,24,1
11172,209,89,120,41,35,17,3,298,129,169,51,40,29,8,1
11173,1410,678,732,183,139,129,71,785,374,411,56,42,38,25,1
11174,697,373,324,105,83,95,38,394,183,211,65,60,35,18,1
11175,332,206,126,36,30,30,12,437,225,212,61,57,66,12,1
11176,1019,522,497,159,138,142,40,770,355,415,103,142,75,42,1
11177,482,262,220,72,60,52,15,249,105,144,71,26,13,7,1
11178,160,80,80,20,14,25,11,784,373,411,101,90,91,37,1
11179,276,118,158,38,40,16,10,295,145,150,41,45,36,18,1
11180,853,400,453,137,109,88,42,582,293,289,94,80,77,32,1
11181,589,296,293,99,76,64,29,348,226,122,23,20,59,25,1
11182,106,52,54,18,4,9,8,875,421,454,124,142,98,43,1
11183,660,294,366,85,67,54,25,2414,1189,1225,277,178,170,169,1
11184,483,237,246,63,47,25,21,380,187,193,38,51,30,18,1
11185,341,178,163,48,44,42,20,261,130,131,27,41,19,16,1
11186,381,188,193,59,60,35,12,552,285,267,74,51,69,24,1
11187,355,168,187,48,57,30,15,1021,487,534,135,113,119,32,1
11188,471,246,225,46,38,52,30,499,252,247,75,71,65,25,1
11189,201,96,105,20,38,22,11,1103,651,452,144,118,96,44,1
11190,541,273,268,67,48,48,30,207,89,118,28,26,16,6,1
11191,652,332,320,72,59,57,24,1640,855,785,215,212,201,77,1
11192,652,397,255,79,43,36,13,375,198,177,48,44,45,22,1
11193,473,212,261,72,64,45,28,297,158,139,47,37,37,9,1
11194,303,159,144,40,35,35,8,374,184,190,52,38,48,11,1
11195,444,209,235,76,62,62,16,246,113,133,33,45,22,10,1
11196,295,139,156,48,31,30,17,173,110,63,35,6,9,8,1
11197,532,269,263,72,59,59,39,408,197,211,74,44,53,16,1
11198,246,108,138,32,44,21,10,657,293,364,109,75,66,28,1
11199,424,197,227,67,62,43,17,563,255,308,91,111,42,30,1
11200,646,316,330,89,95,48,17,529,264,265,59,68,41,17,1
11201,490,198,292,65,81,39,27,181,96,85,25,23,20,7,1
11202,290,142,148,43,35,34,13,288,161,127,32,27,29,10,1
11203,309,155,154,41,44,45,16,667,294,373,97,80,70,38,1
11204,317,165,152,33,50,27,9,435,170,265,77,69,41,22,1
11205,247,110,137,34,45,23,10,575,290,285,67,70,28,9,1
11206,828,463,365,94,86,65,21,393,186,207,58,50,36,22,1
11207,277,124,153,44,40,35,18,758,362,396,115,102,35,13,1
11208,636,320,316,79,61,67,31,189,90,99,26,29,17,11,1
11209,715,355,360,118,79,71,29,89,42,47,16,12,15,6,1
11210,1149,568,581,177,133,101,30,906,455,451,116,105,87,46,1
11211,247,110,137,34,45,23,10,968,452,516,150,144,79,28,1
11212,247,110,137,34,45,23,10,262,78,184,78,28,32,4,1
11213,369,176,193,56,53,39,35,430,218,212,58,47,34,20,1
11214,698,325,373,112,95,69,33,423,211,212,42,31,48,7,1
11215,490,198,292,65,81,39,27,636,320,316,79,61,67,31,1
11216,743,377,366,87,74,68,30,215,80,135,54,56,21,9,1
11217,360,188,172,49,48,47,17,428,248,180,44,39,28,9,1
11218,271,159,112,34,34,33,7,418,248,170,41,31,54,9,1
11219,579,330,249,52,27,90,11,295,147,148,36,24,36,11,1
11220,201,93,108,34,39,21,6,845,402,443,137,126,105,47,1
11221,956,475,481,122,128,100,50,501,240,261,80,62,49,42,1
11222,354,192,162,46,43,30,20,363,178,185,54,48,21,13,1
11223,317,164,153,47,33,47,12,480,234,246,79,77,65,23,1
11224,560,279,281,113,64,58,15,440,246,194,62,49,41,16,1
11225,384,183,201,68,51,46,10,1038,470,568,130,123,86,51,1
11226,480,256,224,67,55,26,22,372,179,193,50,52,33,6,1
11227,467,201,266,71,70,63,27,753,318,435,154,95,56,23,1
11228,744,385,359,125,89,90,23,1257,647,610,156,146,145,35,1
11229,814,403,411,112,140,94,23,1382,508,874,334,320,98,36,1
11230,1156,519,637,104,62,66,45,2556,1169,1387,248,291,227,275,1
11231,205,114,91,25,24,20,15,140,76,64,17,13,13,8,1
11232,304,159,145,38,40,32,3,796,445,351,96,80,90,38,1
11233,262,136,126,41,24,23,17,586,240,346,94,110,29,19,1
11234,954,521,433,135,118,78,26,191,99,92,25,24,18,8,1
11235,567,261,306,63,89,29,15,1071,549,522,133,127,130,59,1
11236,1477,738,739,176,176,145,72,823,438,385,97,88,108,32,1
11237,147,81,66,18,18,18,4,327,172,155,38,41,41,15,1
11238,537,276,261,75,68,68,22,1907,1008,899,235,224,195,73,1
11239,494,234,260,88,81,61,29,282,135,147,27,37,30,19,1
11240,561,279,282,85,81,88,24,516,296,220,79,59,69,16,1
11241,778,367,411,90,85,64,43,537,276,261,75,68,68,22,1
11242,743,341,402,104,89,68,38,505,275,230,63,57,35,12,1
11243,345,141,204,64,58,13,11,648,307,341,101,58,76,34,1
11244,509,254,255,67,55,52,35,459,221,238,72,78,47,16,1
11245,822,416,406,111,105,84,44,419,233,186,54,53,55,17,1
11246,624,204,420,166,101,32,13,449,240,209,59,55,63,20,1
11247,1009,522,487,121,106,107,46,834,395,439,117,92,96,28,1
11248,462,251,211,74,53,41,18,527,276,251,64,60,70,20,1
11249,551,299,252,51,62,63,17,512,261,251,79,73,60,21,1
11250,508,268,240,92,58,56,21,1255,666,589,145,142,120,82,1
11251,708,334,374,105,96,61,37,613,333,280,71,66,47,26,1
11252,440,282,158,38,21,38,24,537,276,261,75,68,68,22,1
11253,2602,1424,1178,314,320,249,75,2639,1436,1203,317,307,242,77,1
11254,652,397,255,79,43,36,13,187,91,96,23,28,23,7,1
11255,1941,818,1123,351,358,141,64,1214,573,641,184,152,101,66,1
11256,502,240,262,78,61,54,32,501,265,236,89,52,45,16,1
11257,399,208,191,57,46,41,20,367,195,172,57,54,43,16,1
11258,933,536,397,96,90,71,41,244,104,140,52,31,30,14,1
11259,462,157,305,93,51,54,3,672,334,338,110,93,91,41,1
11260,148,58,90,23,25,10,4,461,257,204,48,37,78,28,1
11261,362,174,188,46,55,35,23,595,284,311,69,71,35,49,1
11262,191,101,90,21,23,28,5,245,181,64,6,6,25,8,1
11263,390,191,199,57,49,45,25,376,171,205,45,45,34,12,1
11264,1279,733,546,143,121,130,49,1141,583,558,141,98,91,45,1
11265,3911,1465,2446,610,767,240,133,545,230,315,91,101,50,16,1
11266,136,65,71,33,11,9,6,1710,650,1060,338,287,185,46,1
11267,898,467,431,101,127,90,53,126,57,69,31,10,10,3,1
11268,219,100,119,32,43,9,10,199,87,112,31,27,8,15,1
11269,1210,592,618,157,138,116,85,338,193,145,34,27,53,17,1
11270,247,110,137,34,45,23,10,331,145,186,40,56,16,9,1
11271,616,304,312,75,71,55,25,757,359,398,109,127,80,26,1
11272,250,114,136,45,42,18,8,245,122,123,21,32,18,13,1
11273,592,283,309,84,137,60,20,699,376,323,79,53,86,41,1
11274,356,161,195,52,57,40,17,149,68,81,15,38,11,10,1
11275,497,185,312,63,92,38,28,294,122,172,46,65,18,11,1
11276,147,68,79,31,23,8,4,697,373,324,105,83,95,38,1
11277,553,261,292,73,79,40,26,776,346,430,103,102,61,40,1
11278,671,318,353,83,124,46,34,422,213,209,63,60,35,13,1
11279,350,180,170,64,46,55,12,1304,585,719,179,169,154,47,1
11280,635,333,302,99,75,83,28,912,461,451,127,109,96,48,1
11281,556,269,287,86,66,62,22,1144,622,522,140,128,132,65,1
11282,277,138,139,40,39,20,14,201,88,113,33,27,20,8,1
11283,190,94,96,25,24,18,5,776,356,420,122,103,85,30,1
11284,161,99,62,15,22,9,7,236,141,95,36,32,14,6,1
11285,829,366,463,137,130,56,10,502,299,203,57,52,32,11,1
11286,458,225,233,67,61,43,33,327,177,150,56,20,25,6,1
11287,724,334,390,112,109,79,17,972,519,453,109,98,120,39,1
11288,521,265,256,69,69,61,26,76,38,38,6,13,4,8,1
11289,673,313,360,101,101,46,17,1943,846,1097,301,257,135,77,1
11290,312,123,189,59,43,30,18,460,251,209,61,48,43,21,1
11291,1377,579,798,179,169,139,99,353,196,157,51,39,49,8,1
11292,781,418,363,92,90,64,41,1425,670,755,153,189,122,85,1
11293,429,219,210,46,66,42,17,633,266,367,117,67,72,43,1
11294,103,49,54,21,21,10,2,548,292,256,67,65,68,26,1
11295,684,342,342,81,85,82,38,190,100,90,29,12,20,6,1
11296,246,115,131,15,29,10,32,722,344,378,126,71,46,42,1
11297,1265,580,685,205,188,166,53,1356,672,684,171,172,134,59,1
11298,356,208,148,42,26,57,15,1304,585,719,179,169,154,47,1
11299,699,326,373,111,97,82,25,410,186,224,72,57,52,22,1
11300,245,122,123,21,32,18,13,422,198,224,52,52,42,43,1
11301,633,303,330,95,91,51,13,1014,490,524,177,137,94,38,1
11302,372,189,183,60,44,41,18,501,240,261,80,62,49,42,1
11303,716,354,362,102,87,77,30,683,304,379,140,101,48,19,1
11304,653,298,355,70,101,64,39,218,108,110,28,28,22,10,1
11305,452,262,190,61,45,54,19,215,115,100,27,28,34,16,1
11306,395,195,200,41,55,23,10,1585,840,745,184,152,155,100,1
11307,502,240,262,78,61,54,32,303,175,128,43,36,34,12,1
11308,245,112,133,32,45,20,10,596,286,310,90,89,78,37,1
11309,815,418,397,97,62,70,17,1209,487,722,199,146,125,51,1
11310,390,218,172,48,21,66,17,354,168,186,50,53,39,20,1
11311,609,292,317,102,96,64,21,231,126,105,37,26,29,6,1
11312,863,458,405,97,82,63,57,377,184,193,56,53,44,14,1
11313,670,333,337,95,79,62,21,521,266,255,89,61,68,13,1
11314,270,147,123,34,17,39,21,437,212,225,66,44,44,11,1
11315,501,285,216,52,55,62,25,318,176,142,25,32,35,25,1
11316,422,173,249,74,87,40,17,1086,603,483,147,121,95,40,1
11317,454,224,230,71,39,62,22,225,102,123,32,32,31,15,1
11318,710,307,403,117,176,37,9,391,208,183,65,49,57,17,1
11319,797,394,403,109,89,83,40,312,172,140,41,40,21,8,1
11320,368,170,198,59,64,29,13,862,409,453,149,125,86,29,1
11321,481,256,225,60,56,48,12,1047,562,485,141,127,114,41,1
11322,350,200,150,45,47,23,8,160,91,69,13,28,11,13,1
11323,247,110,137,34,45,23,10,2426,1147,1279,307,320,114,128,1
11324,293,147,146,39,22,30,20,1049,530,519,102,125,89,48,1
11325,980,580,400,109,103,59,32,1270,557,713,130,195,57,30,1
11326,688,364,324,74,94,89,40,245,142,103,29,20,21,9,1
11327,387,207,180,61,25,59,21,113,66,47,11,9,6,5,1
11328,340,158,182,51,56,9,7,204,99,105,32,32,22,10,1
11329,292,152,140,46,38,35,12,441,189,252,73,50,47,23,1
11330,406,211,195,55,37,47,16,491,233,258,73,58,56,30,1
11331,822,416,406,111,105,84,44,2442,1193,1249,278,183,170,145,1
11332,794,390,404,103,95,86,23,225,125,100,33,32,29,12,1
11333,767,392,375,113,112,83,13,908,488,420,115,97,111,43,1
11334,2414,1189,1225,277,178,170,169,847,452,395,100,94,81,36,1
11335,922,418,504,120,120,106,31,468,242,226,58,42,49,19,1
11336,556,269,287,86,66,62,22,271,110,161,33,27,11,8,1
11337,246,115,131,15,29,10,32,346,165,181,69,43,22,9,1
11338,619,332,287,95,77,74,38,431,204,227,59,72,41,12,1
11339,148,94,54,19,15,8,4,191,99,92,25,24,18,8,1
11340,323,169,154,47,44,39,20,648,307,341,101,58,76,34,1
11341,2839,1321,1518,400,328,170,90,1192,545,647,161,116,105,34,1
11342,467,261,206,54,49,48,24,619,293,326,98,78,65,22,1
11343,2045,985,1060,359,339,199,74,463,244,219,54,58,47,21,1
11344,298,154,144,44,34,25,11,710,302,408,112,118,60,29,1
11345,177,67,110,34,24,13,10,595,316,279,86,60,65,40,1
11346,444,189,255,72,82,45,17,498,263,235,59,63,36,10,1
11347,640,279,361,102,83,69,21,403,220,183,57,39,45,11,1
11348,1455,760,695,205,191,124,40,513,274,239,67,66,62,35,1
11349,183,97,86,30,18,20,12,240,119,121,31,24,10,19,1
11350,1108,548,560,176,132,136,36,375,202,173,46,49,41,23,1
11351,219,104,115,25,31,25,11,552,285,267,74,51,69,24,1
11352,189,90,99,26,29,17,11,845,402,443,137,126,105,47,1
11353,306,128,178,49,59,17,9,189,88,101,31,29,18,10,1
11354,298,154,144,44,34,25,11,539,317,222,66,42,72,31,1
11355,755,348,407,109,98,49,23,176,73,103,22,29,13,9,1
11356,815,382,433,97,50,88,31,467,226,241,55,48,54,23,1
11357,1582,734,848,238,223,149,44,166,81,85,30,27,13,8,1
11358,3114,1105,2009,505,603,150,122,2701,957,1744,504,525,160,95,1
11359,960,409,551,166,134,77,44,632,285,347,102,78,43,29,1
11360,1098,432,666,166,199,76,28,525,274,251,82,74,60,25,1
11361,393,186,207,58,50,36,22,582,293,289,94,80,77,32,1
11362,559,217,342,105,86,42,16,1163,417,746,209,145,87,28,1
11363,684,288,396,107,90,54,42,320,184,136,38,29,20,16,1
11364,171,88,83,20,21,16,7,246,129,117,38,16,23,17,1
11365,982,494,488,150,117,91,45,724,334,390,112,109,79,17,1
11366,916,430,486,132,118,91,37,466,186,280,71,84,30,11,1
11367,277,124,153,44,40,35,18,928,442,486,139,118,91,43,1
11368,589,314,275,70,83,44,28,184,86,98,26,26,14,11,1
11369,369,200,169,42,46,39,16,153,75,78,22,23,13,12,1
11370,1873,948,925,245,214,194,85,923,471,452,119,117,119,41,1
11371,1982,710,1272,353,319,146,76,538,252,286,77,87,53,30,1
11372,1608,924,684,163,133,89,29,126,55,71,14,17,12,16,1
11373,771,321,450,151,135,43,15,125,52,73,23,23,6,4,1
11374,336,192,144,30,36,40,14,955,465,490,137,138,119,28,1
11375,412,195,217,79,48,36,29,372,193,179,60,43,29,2,1
11376,1192,579,613,120,215,79,24,308,170,138,38,35,45,14,1
11377,399,233,166,58,39,20,4,140,76,64,17,13,13,8,1
11378,223,121,102,28,26,29,14,147,75,72,22,14,14,6,1
11379,714,364,350,98,102,91,27,791,306,485,142,157,21,18,1
11380,870,436,434,131,114,72,25,526,264,262,77,71,61,27,1
11381,815,418,397,97,62,70,17,984,516,468,78,45,73,12,1
11382,528,228,300,60,119,43,28,211,88,123,38,28,26,10,1
11383,353,196,157,51,39,49,8,437,167,270,126,95,34,10,1
11384,391,212,179,40,45,47,10,878,365,513,128,125,56,28,1
11385,355,168,187,48,57,30,15,1336,724,612,209,141,133,60,1
11386,379,203,176,55,48,45,16,1914,892,1022,272,267,143,79,1
11387,261,134,127,39,27,30,11,110,67,43,9,10,11,8,1
11388,686,375,311,89,80,63,20,351,183,168,55,44,33,9,1
11389,191,85,106,24,34,19,5,1074,538,536,154,140,111,51,1
11390,284,167,117,35,25,28,8,703,354,349,84,81,40,25,1
11391,645,297,348,89,105,74,24,89,42,47,16,12,15,6,1
11392,1215,572,643,151,105,127,54,313,157,156,39,26,34,29,1
11393,462,251,211,74,53,41,18,199,101,98,29,25,18,6,1
11394,380,187,193,38,51,30,18,702,298,404,134,111,48,18,1
11395,246,124,122,33,24,25,19,183,93,90,20,31,22,7,1
11396,241,106,135,48,29,17,15,306,128,178,49,59,17,9,1
11397,595,316,279,86,60,65,40,451,238,213,53,64,56,22,1
11398,284,128,156,48,29,34,8,202,102,100,29,35,6,9,1
11399,473,230,243,80,56,52,35,2524,1232,1292,398,317,186,61,1
11400,595,292,303,79,83,69,24,863,458,405,97,82,63,57,1
11401,442,208,234,68,49,51,25,770,355,415,103,142,75,42,1
11402,1218,499,719,147,141,119,145,1170,510,660,142,182,115,84,1
11403,703,523,180,57,42,40,12,744,569,175,71,37,51,25,1
11404,361,184,177,50,53,51,22,1087,523,564,146,177,103,33,1
11405,265,119,146,44,52,12,9,437,210,227,73,62,38,19,1
11406,180,96,84,21,22,17,15,769,329,440,116,66,55,22,1
11407,1807,933,874,248,203,173,71,467,226,241,55,48,54,23,1
11408,303,187,116,41,23,23,9,770,390,380,104,76,78,32,1
11409,986,499,487,123,116,98,54,205,101,104,34,25,34,8,1
11410,213,84,129,38,27,19,9,355,169,186,49,37,26,11,1
11411,1102,511,591,171,179,148,52,957,494,463,101,112,73,27,1
11412,728,358,370,118,100,55,29,882,432,450,115,111,68,44,1
11413,465,229,236,68,62,40,22,360,192,168,55,45,48,16,1
11414,443,248,195,67,54,40,15,526,264,262,77,71,61,27,1
11415,439,227,212,60,55,58,8,536,278,258,72,63,62,20,1
11416,723,404,319,105,71,70,24,547,300,247,68,60,55,30,1
11417,392,115,277,117,75,28,17,182,84,98,20,52,9,9,1
11418,431,216,215,46,40,33,9,155,85,70,17,16,4,8,1
11419,3695,1922,1773,449,360,352,261,1231,603,628,121,162,109,120,1
11420,1508,733,775,216,186,172,60,824,397,427,113,95,82,33,1
11421,384,238,146,38,26,66,19,92,49,43,7,8,10,9,1
11422,1140,586,554,130,146,117,49,546,256,290,83,77,67,18,1
11423,320,159,161,44,54,29,9,117,57,60,17,14,11,10,1
11424,501,328,173,47,29,65,21,661,361,300,65,82,57,15,1
11425,424,197,227,67,62,43,17,222,105,117,37,44,6,18,1
11426,456,228,228,49,70,32,19,778,353,425,140,89,92,51,1
11427,236,145,91,17,19,30,18,356,178,178,67,41,19,15,1
11428,881,383,498,142,148,77,24,439,227,212,60,55,58,8,1
11429,226,120,106,68,8,2,1,298,167,131,47,33,40,8,1
11430,436,199,237,70,55,47,22,426,228,198,62,42,47,22,1
11431,283,141,142,32,26,23,26,568,243,325,98,73,56,44,1
11432,3433,1476,1957,522,578,264,123,894,420,474,136,146,93,39,1
11433,305,164,141,43,23,47,18,770,390,380,104,76,78,32,1
11434,651,331,320,93,93,51,28,333,127,206,66,68,25,14,1
11435,948,484,464,122,113,130,38,455,218,237,57,51,42,35,1
11436,248,119,129,33,48,20,10,970,440,530,142,102,111,39,1
11437,785,374,411,56,42,38,25,920,492,428,100,92,88,49,1
11438,490,198,292,65,81,39,27,365,180,185,63,35,48,19,1
11439,552,285,267,74,51,69,24,440,218,222,58,66,40,24,1
11440,631,294,337,83,129,46,24,1052,492,560,184,163,103,44,1
11441,304,127,177,61,38,31,4,254,146,108,28,35,33,8,1
11442,182,105,77,18,11,21,3,226,137,89,20,20,18,5,1
11443,559,317,242,58,65,37,23,653,389,264,69,59,51,19,1
11444,454,209,245,85,78,45,9,740,313,427,101,135,40,22,1
11445,1098,519,579,182,159,79,42,646,316,330,89,95,48,17,1
11446,474,214,260,73,58,53,17,395,222,173,48,42,21,8,1
11447,471,246,225,46,38,52,30,2803,1300,1503,392,510,170,57,1
11448,95,44,51,14,13,7,4,541,279,262,79,82,31,32,1
11449,458,265,193,55,35,49,27,149,68,81,15,38,11,10,1
11450,375,202,173,46,49,41,23,559,296,263,77,69,42,13,1
11451,840,385,455,118,137,66,39,383,204,179,61,32,54,16,1
11452,589,256,333,112,67,63,28,1475,658,817,149,114,120,43,1
11453,509,254,255,67,55,52,35,503,263,240,72,55,51,34,1
11454,171,85,86,23,16,20,10,285,148,137,31,42,42,16,1
11455,598,322,276,67,57,63,26,744,385,359,125,89,90,23,1
11456,476,211,265,80,68,47,20,377,202,175,46,50,41,23,1
11457,462,251,211,74,53,41,18,270,137,133,30,28,27,11,1
11458,194,122,72,18,17,18,12,191,101,90,21,23,28,5,1
11459,1484,731,753,206,175,187,71,499,249,250,79,63,61,22,1
11460,593,266,327,102,84,69,24,1242,613,629,174,113,114,53,1
11461,245,111,134,31,44,20,11,821,394,427,122,117,109,38,1
11462,502,240,262,78,61,54,32,440,218,222,58,66,40,24,1
11463,269,134,135,42,35,27,13,248,120,128,43,37,20,6,1
11464,1190,638,552,162,95,112,18,1842,988,854,232,191,184,74,1
11465,1048,564,484,118,122,113,40,1247,620,627,134,149,142,58,1
11466,759,326,433,115,95,61,29,689,343,346,119,100,86,38,1
11467,552,285,267,74,51,69,24,505,226,279,68,51,30,15,1
11468,414,193,221,54,49,45,28,282,135,147,27,37,30,19,1
11469,636,320,316,79,61,67,31,393,186,207,58,50,36,22,1
11470,391,208,183,65,49,57,17,255,134,121,36,40,29,13,1
11471,170,82,88,28,23,20,12,476,251,225,57,67,57,18,1
11472,2321,1177,1144,236,255,174,254,1133,549,584,99,76,66,54,1
11473,281,144,137,42,25,30,16,510,252,258,75,60,57,24,1
11474,3333,1606,1727,446,357,333,206,266,152,114,31,13,37,11,1
11475,147,68,79,31,23,8,4,416,209,207,76,45,50,17,1
11476,548,236,312,88,88,63,25,431,186,245,79,83,37,18,1
11477,918,427,491,113,111,113,33,770,374,396,95,91,79,41,1
11478,500,272,228,44,31,29,18,499,252,247,74,42,55,14,1
11479,825,399,426,128,128,77,32,778,367,411,90,85,64,43,1
11480,226,109,117,38,36,13,11,364,195,169,50,38,33,12,1
11481,1663,835,828,224,213,163,63,1092,562,530,126,91,125,84,1
11482,639,287,352,111,108,44,9,360,161,199,72,36,35,13,1
11483,1152,459,693,138,343,75,33,1233,498,735,252,232,88,41,1
11484,210,89,121,51,34,11,6,377,202,175,46,50,41,23,1
11485,583,322,261,73,66,45,26,217,109,108,34,32,35,7,1
11486,207,105,102,35,27,15,5,433,229,204,60,59,53,24,1
11487,424,284,140,51,28,47,20,895,437,458,150,156,60,30,1
11488,505,268,237,68,59,34,15,460,274,186,50,34,69,27,1
11489,1244,674,570,145,141,131,42,193,99,94,31,31,16,12,1
11490,3259,1163,2096,526,657,162,86,140,81,59,16,15,15,12,1
11491,837,381,456,123,109,65,25,873,366,507,127,125,75,21,1
11492,707,295,412,105,105,66,30,454,191,263,61,66,38,15,1
11493,368,154,214,80,52,41,16,339,170,169,32,17,24,13,1
11494,377,177,200,63,53,44,16,1009,506,503,146,141,97,55,1
11495,504,259,245,73,56,45,29,655,328,327,65,54,55,35,1
11496,216,120,96,21,24,31,13,627,323,304,81,90,53,27,1
11497,616,296,320,69,76,49,48,982,494,488,150,117,91,45,1
11498,311,173,138,43,21,45,19,870,489,381,97,99,76,14,1
11499,452,217,235,59,47,60,20,362,174,188,46,55,35,23,1
11500,875,421,454,124,142,98,43,467,224,243,70,43,67,23,1
11501,672,334,338,110,93,91,41,430,192,238,62,67,27,10,1
11502,306,128,178,49,59,17,9,291,141,150,49,43,26,7,1
11503,163,70,93,28,21,17,6,925,484,441,112,86,84,31,1
11504,1032,526,506,129,117,119,47,798,378,420,99,94,71,63,1
11505,501,240,261,80,62,49,42,693,297,396,87,52,64,27,1
11506,824,397,427,113,95,82,33,86,50,36,9,14,8,7,1
11507,81,41,40,15,13,3,2,377,180,197,45,63,19,17,1
11508,691,307,384,93,128,45,19,2442,1193,1249,278,183,170,145,1
11509,628,341,287,77,59,55,31,930,367,563,181,153,83,48,1
11510,504,237,267,62,66,48,17,2471,1130,1341,240,281,219,290,1
11511,1142,515,627,56,128,113,16,1516,764,752,179,155,126,55,1
11512,536,266,270,58,73,40,25,876,457,419,88,124,67,47,1
11513,481,268,213,54,48,53,14,83,42,41,13,10,7,5,1
11514,304,159,145,38,40,32,3,1382,689,693,186,176,167,77,1
11515,767,392,375,113,112,83,13,574,356,218,61,44,87,39,1
11516,536,278,258,72,63,62,20,362,183,179,49,49,41,11,1
11517,158,85,73,24,18,18,8,1177,666,511,131,99,88,35,1
11518,233,96,137,40,40,13,9,868,448,420,108,103,76,25,1
11519,87,50,37,16,7,10,5,229,106,123,43,30,31,10,1
11520,178,91,87,20,21,12,5,301,150,151,41,30,17,11,1
11521,309,137,172,51,50,28,14,463,238,225,49,35,31,14,1
11522,785,374,411,56,42,38,25,303,187,116,41,23,23,9,1
11523,802,449,353,102,87,82,29,906,474,432,90,125,74,24,1
11524,2468,1038,1430,333,465,167,62,375,202,173,46,49,41,23,1
11525,201,93,108,34,39,21,6,193,99,94,31,31,16,12,1
11526,685,315,370,108,99,36,9,223,113,110,31,33,22,12,1
11527,101,45,56,17,17,12,9,478,223,255,80,81,41,24,1
11528,536,278,258,72,63,62,20,432,188,244,76,81,26,13,1
11529,249,90,159,29,89,12,4,318,164,154,52,43,34,10,1
11530,427,164,263,62,80,14,10,521,265,256,69,69,61,26,1
11531,1873,948,925,245,214,194,85,822,402,420,125,107,82,26,1
11532,460,251,209,61,48,43,21,1255,666,589,145,142,120,82,1
11533,431,228,203,66,46,59,15,529,274,255,57,62,38,14,1
11534,639,287,352,111,108,44,9,1333,646,687,209,179,148,45,1
11535,429,156,273,94,65,29,7,508,267,241,43,35,25,17,1
11536,580,308,272,82,79,58,25,1863,721,1142,262,283,139,74,1
11537,351,184,167,59,45,54,9,295,143,152,38,47,22,25,1
11538,309,184,125,40,23,48,14,240,125,115,34,32,30,8,1
11539,255,130,125,44,18,22,12,485,273,212,52,47,51,17,1
11540,1066,587,479,127,108,118,48,238,151,87,15,14,35,18,1
11541,898,467,431,101,127,90,53,372,196,176,51,36,51,8,1
11542,316,157,159,45,38,22,19,433,220,213,67,68,31,19,1
11543,396,215,181,53,43,55,17,1129,589,540,134,122,108,46,1
11544,233,121,112,24,31,30,7,1242,613,629,174,113,114,53,1
11545,1123,554,569,142,130,85,36,2440,1061,1379,377,326,172,62,1
11546,583,322,261,73,66,45,26,1390,695,695,180,137,170,71,1
11547,4391,2256,2135,494,411,423,231,930,367,563,181,153,83,48,1
11548,349,200,149,41,39,30,20,168,67,101,37,17,13,13,1
11549,255,122,133,35,51,22,13,790,352,438,132,87,91,60,1
11550,311,175,136,40,30,25,13,205,104,101,28,28,35,13,1
11551,785,374,411,56,42,38,25,295,143,152,38,47,22,25,1
11552,257,139,118,64,17,24,7,150,89,61,22,15,17,6,1
11553,349,167,182,54,38,30,28,624,222,402,92,81,39,15,1
11554,356,208,148,42,26,57,15,1960,810,1150,358,377,121,72,1
11555,130,55,75,21,26,10,3,208,96,112,31,32,13,9,1
11556,1816,865,951,246,230,189,76,769,329,440,116,66,55,22,1
11557,940,464,476,116,135,108,58,312,174,138,38,27,24,16,1
11558,217,102,115,28,26,22,9,1374,679,695,191,193,154,48,1
11559,3830,2000,1830,532,388,418,203,1235,584,651,140,226,82,52,1
11560,449,242,207,47,42,39,20,1487,996,491,147,141,50,35,1
11561,329,168,161,48,34,41,16,390,183,207,56,50,52,12,1
11562,247,110,137,34,45,23,10,553,261,292,73,79,40,26,1
11563,296,154,142,38,38,24,16,449,244,205,68,53,49,12,1
11564,360,192,168,55,45,48,16,353,194,159,67,35,52,11,1
11565,380,185,195,68,54,32,16,298,167,131,47,33,40,8,1
11566,1435,649,786,214,181,135,54,2799,1324,1475,369,371,215,124,1
11567,209,138,71,13,9,16,19,402,227,175,48,40,35,11,1
11568,975,505,470,110,124,117,48,165,84,81,29,18,8,5,1
11569,246,108,138,32,44,21,10,1038,422,616,183,175,75,32,1
11570,615,339,276,82,76,63,16,628,324,304,83,85,75,23,1
11571,745,355,390,99,85,62,19,255,122,133,35,51,22,13,1
11572,295,145,150,41,45,36,18,1192,579,613,120,215,79,24,1
11573,857,370,487,127,103,76,37,251,137,114,28,16,19,12,1
11574,433,229,204,60,59,53,24,767,392,375,113,112,83,13,1
11575,342,241,101,22,23,38,11,121,74,47,15,6,11,4,1
11576,350,213,137,39,21,53,22,114,66,48,15,5,2,6,1
11577,1881,929,952,259,247,158,57,2671,1322,1349,379,345,290,135,1
11578,382,199,183,60,51,40,14,948,484,464,134,131,75,27,1
11579,98,55,43,14,1,7,4,267,127,140,43,42,24,9,1
11580,762,363,399,127,85,83,31,729,321,408,128,84,63,26,1
11581,277,100,177,35,88,30,2,111,29,82,10,54,0,1,1
11582,2322,1315,1007,242,257,220,38,1141,582,559,162,151,76,34,1
11583,220,126,94,29,12,34,11,509,262,247,64,70,64,20,1
11584,417,212,205,55,50,54,24,135,67,68,22,9,18,6,1
11585,676,333,343,111,89,94,39,537,276,261,75,68,68,22,1
11586,1382,689,693,186,176,167,77,443,248,195,67,54,40,15,1
11587,509,254,255,67,55,52,35,461,207,254,82,66,55,33,1
11588,443,198,245,68,72,48,19,462,233,229,66,49,43,30,1
11589,107,36,71,27,15,0,1,331,169,162,40,28,22,14,1
11590,856,429,427,113,105,96,24,531,250,281,72,61,68,31,1
11591,416,182,234,62,67,37,17,559,296,263,77,69,42,13,1
11592,875,421,454,124,142,98,43,338,193,145,34,27,53,17,1
11593,671,318,353,83,124,46,34,483,249,234,81,55,41,19,1
11594,429,187,242,79,72,28,19,790,352,438,132,87,91,60,1
11595,380,225,155,52,37,72,11,291,131,160,40,42,36,14,1
11596,427,205,222,53,52,51,22,1187,631,556,182,139,152,56,1
11597,744,383,361,104,80,66,28,1855,852,1003,329,264,184,83,1
11598,784,393,391,117,102,65,35,393,186,207,58,50,36,22,1
11599,263,159,104,30,27,31,11,522,235,287,78,67,60,50,1
11600,663,397,266,76,58,121,39,201,92,109,27,29,27,8,1
11601,631,332,299,61,104,60,19,519,246,273,78,82,42,16,1
11602,1085,471,614,181,156,110,46,191,99,92,25,24,18,8,1
11603,906,455,451,116,105,87,46,864,510,354,89,81,76,42,1
11604,802,388,414,101,93,88,35,217,109,108,34,32,35,7,1
11605,241,115,126,44,21,29,10,831,426,405,101,102,105,32,1
11606,1948,1039,909,242,227,200,67,1290,597,693,182,182,119,63,1
11607,673,317,356,101,85,76,49,201,42,159,19,3,2,75,1
11608,311,176,135,51,29,37,8,859,395,464,157,119,59,31,1
11609,709,310,399,95,103,61,30,695,373,322,80,59,89,39,1
11610,437,225,212,61,57,66,12,225,113,112,29,45,19,7,1
11611,414,213,201,61,54,50,19,873,366,507,127,125,75,21,1
11612,204,96,108,31,37,20,5,583,248,335,115,111,52,16,1
11613,444,247,197,53,32,60,28,294,153,141,33,20,33,13,1
11614,440,218,222,58,66,40,24,839,439,400,101,86,102,43,1
11615,363,221,142,36,16,56,25,485,273,212,52,47,51,17,1
11616,858,398,460,126,138,75,39,166,81,85,30,27,13,8,1
11617,4128,2104,2024,581,505,453,205,778,367,411,90,85,64,43,1
11618,175,90,85,28,21,19,7,409,200,209,69,56,44,13,1
11619,1770,824,946,245,258,179,60,333,192,141,50,48,28,10,1
11620,694,315,379,101,87,47,17,1102,511,591,171,179,148,52,1
11621,208,104,104,20,54,9,5,538,252,286,77,87,53,30,1
11622,631,309,322,106,83,89,33,562,281,281,80,61,67,23,1
11623,388,195,193,54,48,35,23,354,166,188,53,55,40,19,1
11624,314,158,156,41,57,30,12,357,184,173,51,55,35,11,1
11625,207,89,118,28,26,16,6,180,103,77,22,19,29,8,1
11626,330,157,173,56,42,51,8,456,209,247,72,58,40,9,1
11627,215,105,110,26,22,19,9,656,292,364,79,102,69,35,1
11628,631,294,337,83,129,46,24,1258,590,668,190,198,127,62,1
11629,166,81,85,30,27,13,8,815,418,397,97,62,70,17,1
11630,466,242,224,66,53,53,13,500,297,203,66,33,53,15,1
11631,355,165,190,53,56,42,19,448,236,212,53,64,56,24,1
11632,583,248,335,115,111,52,16,586,254,332,114,111,55,17,1
11633,359,173,186,55,57,44,16,520,300,220,66,36,57,23,1
11634,410,211,199,55,42,34,27,1068,527,541,160,131,112,52,1
11635,998,532,466,113,109,97,53,1047,562,485,141,127,114,41,1
11636,262,114,148,46,44,30,16,393,186,207,58,50,36,22,1
11637,480,234,246,79,77,65,23,483,274,209,54,39,45,13,1
11638,631,309,322,106,83,89,33,659,325,334,102,85,87,32,1
11639,423,222,201,60,51,51,11,860,378,482,101,123,82,74,1
11640,1268,593,675,182,193,132,78,1258,590,668,190,198,127,62,1
11641,218,133,85,20,19,13,6,1970,978,992,245,206,198,80,1
11642,1024,556,468,137,112,149,29,175,91,84,18,14,22,12,1
11643,362,233,129,37,17,51,18,354,166,188,53,55,40,19,1
11644,309,155,154,41,44,45,16,594,303,291,84,69,72,31,1
11645,724,334,390,112,109,79,17,750,371,379,95,98,86,29,1
11646,923,420,503,128,159,100,49,904,443,461,118,89,124,30,1
11647,519,258,261,87,78,59,22,886,440,446,116,140,95,45,1
11648,1377,579,798,179,169,139,99,764,277,487,158,162,64,31,1
11649,429,219,210,46,66,42,17,632,326,306,92,71,56,19,1
11650,588,331,257,86,71,52,12,568,292,276,69,74,59,34,1
11651,1046,562,484,139,116,124,51,184,78,106,14,26,21,3,1
11652,101,45,56,17,17,12,9,377,202,175,46,50,41,23,1
11653,246,119,127,53,26,19,13,264,126,138,44,26,25,10,1
11654,561,210,351,108,77,41,22,497,257,240,71,63,62,16,1
11655,1154,540,614,195,160,138,66,851,417,434,109,116,83,28,1
11656,341,178,163,48,44,42,20,559,225,334,106,87,24,12,1
11657,425,210,215,56,43,52,25,4377,1898,2479,663,608,331,126,1
11658,748,355,393,121,91,95,26,770,385,385,78,83,60,16,1
11659,493,263,230,52,49,59,20,656,358,298,67,47,64,26,1
11660,654,317,337,95,111,44,13,267,127,140,43,42,24,9,1
11661,559,296,263,77,69,42,13,1149,568,581,177,133,101,30,1
11662,668,331,337,108,64,58,29,763,354,409,101,90,63,26,1
11663,435,222,213,67,49,67,12,577,251,326,92,84,60,11,1
11664,450,241,209,67,58,54,23,512,261,251,79,73,60,21,1
11665,760,405,355,112,95,92,29,339,183,156,43,45,28,17,1
11666,1149,568,581,177,133,101,30,636,320,316,79,61,67,31,1
11667,199,87,112,31,27,8,15,437,210,227,73,62,38,19,1
11668,316,157,159,45,38,22,19,700,265,435,134,106,16,3,1
11669,651,331,320,93,93,51,28,771,321,450,151,135,43,15,1
11670,151,78,73,37,12,15,2,947,482,465,143,107,89,37,1
11671,826,362,464,107,118,71,43,239,129,110,39,31,33,13,1
11672,254,117,137,33,35,38,6,395,197,198,44,57,27,18,1
11673,470,256,214,56,39,47,34,505,247,258,72,71,60,27,1
11674,512,254,258,70,48,37,32,360,192,168,55,45,48,16,1
11675,521,265,256,56,44,35,12,2414,1189,1225,277,178,170,169,1
11676,595,316,279,86,60,65,40,461,207,254,82,66,55,33,1
11677,1117,556,561,188,117,110,48,928,442,486,139,118,91,43,1
11678,483,236,247,82,60,43,18,505,247,258,72,71,60,27,1
11679,425,210,215,56,43,52,25,1051,432,619,179,147,126,54,1
11680,705,396,309,87,48,53,17,379,203,176,55,48,45,16,1
11681,738,339,399,102,88,68,35,537,276,261,75,68,68,22,1
11682,636,336,300,94,65,58,32,355,179,176,51,45,45,11,1
11683,1721,838,883,241,218,144,54,548,292,256,67,65,68,26,1
11684,459,221,238,72,78,47,16,984,461,523,109,89,91,52,1
11685,278,131,147,29,30,33,12,362,183,179,49,49,41,11,1
11686,815,356,459,128,125,82,26,769,329,440,116,66,55,22,1
11687,815,418,397,97,62,70,17,781,316,465,130,129,65,23,1
11688,743,366,377,41,37,26,14,778,367,411,90,85,64,43,1
11689,756,378,378,109,77,94,49,1487,996,491,147,141,50,35,1
11690,485,209,276,78,69,37,30,390,175,215,53,61,26,22,1
11691,920,289,631,237,141,98,11,239,146,93,30,22,35,9,1
11692,216,103,113,31,25,24,9,465,225,240,65,44,65,25,1
11693,419,184,235,66,43,50,28,202,102,100,29,35,6,9,1
11694,926,437,489,135,107,113,42,2961,1467,1494,392,384,307,154,1
11695,726,312,414,121,73,82,23,841,329,512,137,163,35,26,1
11696,484,192,292,118,68,83,22,248,118,130,54,31,26,5,1
11697,906,455,451,116,105,87,46,632,339,293,83,77,59,20,1
11698,563,285,278,79,66,48,27,193,96,97,32,31,16,11,1
11699,247,110,137,34,45,23,10,1356,576,780,229,198,107,38,1
11700,117,65,52,15,16,10,4,412,263,149,48,24,45,19,1
11701,366,184,182,46,42,23,18,313,149,164,48,31,30,13,1
11702,360,218,142,39,26,50,18,354,166,188,53,55,40,19,1
11703,246,115,131,15,29,10,32,1242,587,655,276,98,179,46,1
11704,576,318,258,85,69,45,22,870,489,381,97,99,76,14,1
11705,91,56,35,17,2,7,7,175,91,84,19,21,21,10,1
11706,589,281,308,69,39,63,20,496,272,224,70,58,42,18,1
11707,522,251,271,87,68,60,21,248,118,130,54,31,26,5,1
11708,140,81,59,27,9,8,6,322,143,179,41,62,23,11,1
11709,246,128,118,39,34,22,7,770,355,415,103,142,75,42,1
11710,870,433,437,133,121,95,25,926,435,491,133,132,85,17,1
11711,362,181,181,67,46,43,8,928,442,486,139,118,91,43,1
11712,524,264,260,75,75,40,21,888,478,410,105,73,58,33,1
11713,237,117,120,34,27,24,14,1192,579,613,120,215,79,24,1
11714,255,130,125,44,18,22,12,397,237,160,47,15,56,21,1
11715,178,100,78,23,22,30,6,1907,1008,899,235,224,195,73,1
11716,576,250,326,93,71,34,15,1154,405,749,164,255,63,65,1
11717,250,137,113,33,19,24,9,401,166,235,70,42,51,30,1
11718,620,335,285,70,41,62,33,512,261,251,79,73,60,21,1
11719,508,295,213,42,61,53,17,1189,559,630,179,147,118,35,1
11720,538,252,286,77,87,53,30,367,169,198,66,57,42,14,1
11721,909,455,454,137,82,85,68,272,124,148,51,36,23,27,1
11722,766,384,382,132,86,71,30,473,212,261,72,64,45,28,1
11723,483,215,268,66,70,30,16,654,317,337,95,111,44,13,1
11724,487,197,290,101,45,67,37,375,125,250,85,76,17,13,1
11725,376,139,237,69,73,34,6,443,248,195,67,54,40,15,1
11726,743,346,397,91,90,62,10,529,264,265,59,68,41,17,1
11727,908,481,427,118,88,109,49,2639,1436,1203,317,307,242,77,1
11728,359,181,178,41,30,31,14,380,191,189,45,29,34,17,1
11729,1186,567,619,161,156,122,49,126,53,73,23,19,8,4,1
11730,323,169,154,47,44,39,20,403,188,215,70,42,41,11,1
11731,574,277,297,88,77,58,36,560,228,332,113,58,79,38,1
11732,482,235,247,58,45,37,26,372,201,171,52,50,42,13,1
11733,445,225,220,47,62,53,26,687,353,334,84,96,74,31,1
11734,211,92,119,33,44,11,7,462,233,229,66,49,43,30,1
11735,976,496,480,128,111,121,48,1446,762,684,193,160,182,67,1
11736,1199,589,610,189,128,167,65,1893,850,1043,280,340,169,80,1
11737,1050,473,577,142,119,87,54,595,316,279,86,60,65,40,1
11738,459,212,247,63,48,48,28,418,215,203,60,69,35,14,1
11739,770,355,415,103,142,75,42,617,387,230,65,57,77,16,1
11740,848,394,454,100,90,101,41,928,442,486,139,118,91,43,1
11741,128,65,63,18,13,7,6,168,90,78,22,19,13,4,1
11742,577,342,235,63,57,23,37,328,173,155,43,36,24,17,1
11743,643,312,331,96,79,80,23,543,221,322,78,122,37,12,1
11744,770,356,414,123,102,66,25,671,318,353,83,124,46,34,1
11745,360,161,199,72,36,35,13,219,133,86,18,12,32,18,1
11746,568,294,274,80,64,55,25,1464,693,771,153,136,91,86,1
11747,537,272,265,75,83,41,29,354,168,186,50,53,39,20,1
11748,281,154,127,45,31,24,9,413,236,177,41,25,35,19,1
11749,482,152,330,126,83,51,19,475,235,240,77,58,43,22,1
11750,1210,578,632,172,184,94,66,309,149,160,55,33,27,15,1
11751,917,470,447,139,135,88,63,601,313,288,42,48,25,36,1
11752,1217,647,570,142,160,129,45,526,264,262,77,71,61,27,1
11753,766,395,371,89,86,127,27,91,50,41,12,5,10,7,1
11754,1608,924,684,163,133,89,29,524,295,229,69,58,36,12,1
11755,140,81,59,16,15,15,12,663,323,340,89,89,76,22,1
11756,393,210,183,55,50,34,19,2414,1189,1225,277,178,170,169,1
11757,789,362,427,90,82,70,35,882,432,450,115,111,68,44,1
11758,1006,468,538,151,135,82,39,665,297,368,111,107,34,12,1
11759,480,237,243,64,60,56,33,395,186,209,53,48,46,30,1
11760,347,198,149,45,29,29,8,706,320,386,111,76,75,51,1
11761,432,181,251,48,75,27,17,1149,568,581,177,133,101,30,1
11762,202,115,87,28,10,22,8,1097,526,571,131,134,120,43,1
11763,596,288,308,77,51,58,30,375,202,173,46,49,41,23,1
11764,468,243,225,60,50,34,32,312,172,140,41,40,21,8,1
11765,437,235,202,72,61,39,17,576,250,326,93,71,34,15,1
11766,367,161,206,70,48,41,19,466,186,280,71,84,30,11,1
11767,552,285,267,74,51,69,24,265,133,132,40,34,39,10,1
11768,794,402,392,96,84,86,30,250,137,113,33,19,24,9,1
11769,417,233,184,47,37,41,24,466,233,233,65,51,50,32,1
11770,561,255,306,95,67,44,17,509,262,247,64,70,64,20,1
11771,274,158,116,27,27,22,18,375,173,202,50,46,43,25,1
11772,777,387,390,90,87,65,37,685,315,370,108,99,36,9,1
11773,103,56,47,27,7,8,2,111,29,82,10,54,0,1,1
11774,270,137,133,30,28,27,11,240,125,115,34,32,30,8,1
11775,529,274,255,57,62,38,14,356,199,157,43,58,29,12,1
11776,673,313,360,101,101,46,17,199,101,98,22,25,9,12,1
11777,410,208,202,59,58,43,26,164,78,86,28,23,12,8,1
11778,673,317,356,101,85,76,49,413,236,177,41,25,35,19,1
11779,928,442,486,139,118,91,43,589,281,308,69,39,63,20,1
11780,1690,795,895,271,257,150,101,158,74,84,26,23,18,18,1
11781,327,177,150,40,40,38,18,108,51,57,16,12,16,11,1
11782,520,223,297,90,60,48,13,131,66,65,21,14,23,7,1
11783,631,332,299,61,104,60,19,369,200,169,54,36,49,14,1
11784,873,366,507,127,125,75,21,479,202,277,94,99,30,5,1
11785,1265,580,685,205,188,166,53,295,167,128,43,23,17,11,1
11786,396,202,194,60,48,55,18,1748,791,957,281,247,173,25,1
11787,548,250,298,85,64,56,21,291,120,171,63,39,26,6,1
11788,744,384,360,104,96,57,31,894,479,415,117,93,119,38,1
11789,1382,599,783,208,252,90,39,344,151,193,59,51,30,9,1
11790,1173,508,665,213,192,121,34,505,272,233,76,66,57,23,1
11791,475,238,237,73,53,63,17,327,177,150,40,40,38,18,1
11792,520,284,236,55,48,76,24,769,362,407,99,88,66,67,1
11793,415,209,206,60,67,39,18,620,396,224,53,44,97,26,1
11794,524,264,260,75,75,40,21,671,326,345,111,77,74,11,1
11795,326,153,173,63,48,25,8,558,239,319,53,56,27,19,1
11796,538,252,286,77,87,53,30,335,128,207,59,43,24,23,1
11797,4303,2489,1814,436,369,444,134,781,418,363,92,90,64,41,1
11798,473,256,217,66,47,64,20,309,154,155,42,44,45,16,1
11799,261,102,159,45,36,31,37,394,171,223,68,62,24,12,1
11800,314,162,152,56,32,36,26,706,372,334,93,67,94,48,1
11801,433,221,212,59,42,47,14,252,133,119,35,40,29,9,1
11802,326,141,185,57,39,33,20,1117,423,694,182,134,88,31,1
11803,618,290,328,82,74,69,42,416,210,206,55,54,39,20,1
11804,327,177,150,40,40,38,18,243,100,143,38,34,11,13,1
11805,372,201,171,52,50,42,13,504,255,249,56,59,45,13,1
11806,426,200,226,75,56,39,24,625,342,283,62,53,56,28,1
11807,215,115,100,27,28,34,16,391,208,183,65,49,57,17,1
11808,246,115,131,15,29,10,32,694,260,434,122,92,62,36,1
11809,562,265,297,79,56,72,45,215,80,135,54,56,21,9,1
11810,276,143,133,34,38,20,15,958,451,507,165,135,97,41,1
11811,277,124,153,44,40,35,18,466,186,280,71,84,30,11,1
11812,2524,1232,1292,398,317,186,61,577,277,300,71,59,64,24,1
11813,416,182,234,62,67,37,17,498,263,235,59,63,36,10,1
11814,211,113,98,38,17,25,8,845,402,443,137,126,105,47,1
11815,1524,843,681,177,141,158,69,702,298,404,134,111,48,18,1
11816,173,110,63,35,6,9,8,152,74,78,17,20,16,6,1
11817,614,292,322,74,48,57,33,2440,1061,1379,377,326,172,62,1
11818,461,257,204,63,49,50,29,331,169,162,40,28,22,14,1
11819,465,225,240,65,44,65,25,532,269,263,72,59,59,39,1
11820,2214,1053,1161,272,286,275,133,357,153,204,84,62,39,2,1
11821,783,429,354,100,77,54,25,246,108,138,32,44,21,10,1
11822,241,115,126,44,21,29,10,810,367,443,115,92,94,59,1
11823,334,172,162,43,39,41,17,443,198,245,68,72,48,19,1
11824,345,171,174,42,42,25,9,1279,669,610,164,162,104,55,1
11825,149,77,72,19,15,18,9,1247,548,699,168,150,140,43,1
11826,204,93,111,35,35,16,11,429,227,202,49,51,46,26,1
11827,145,84,61,16,15,14,4,655,269,386,128,129,49,21,1
11828,323,181,142,40,37,26,16,425,161,264,69,79,22,10,1
11829,2224,1037,1187,288,276,273,74,622,299,323,86,86,69,35,1
11830,126,57,69,31,10,10,3,452,239,213,62,46,38,22,1
11831,1190,638,552,162,95,112,18,593,257,336,76,56,56,96,1
11832,281,166,115,34,17,36,16,335,128,207,59,43,24,23,1
11833,576,318,258,85,69,45,22,1210,592,618,157,138,116,85,1
11834,245,142,103,29,20,21,9,1487,996,491,147,141,50,35,1
11835,261,121,140,35,48,28,12,725,408,317,93,75,90,45,1
11836,318,150,168,60,42,32,12,538,252,286,77,87,53,30,1
11837,558,306,252,75,55,74,23,227,95,132,46,42,16,9,1
11838,1471,709,762,198,184,154,62,339,183,156,43,45,28,17,1
11839,377,187,190,51,44,46,26,204,99,105,32,32,22,10,1
11840,191,101,90,21,23,28,5,335,128,207,59,43,24,23,1
11841,736,413,323,102,78,74,22,375,202,173,46,49,41,23,1
11842,591,319,272,96,62,43,19,247,110,137,34,45,23,10,1
11843,1801,889,912,206,263,126,42,379,203,176,48,38,44,11,1
11844,203,93,110,36,26,18,9,503,263,240,72,55,51,34,1
11845,193,88,105,29,32,25,9,622,328,294,75,42,67,31,1
11846,62,23,39,11,11,3,2,149,68,81,15,38,11,10,1
11847,1009,506,503,146,141,97,55,1132,553,579,172,143,150,57,1
11848,158,74,84,26,23,18,18,133,69,64,25,18,10,5,1
11849,294,140,154,47,35,22,17,118,67,51,13,13,7,7,1
11850,52,24,28,6,4,3,5,135,65,70,21,25,15,9,1
11851,985,518,467,123,111,76,49,593,295,298,70,85,48,13,1
11852,148,64,84,33,19,6,1,341,154,187,34,36,11,11,1
11853,595,316,279,86,60,65,40,425,210,215,56,43,52,25,1
11854,744,385,359,125,89,90,23,154,73,81,24,27,18,9,1
11855,429,219,210,46,66,42,17,138,80,58,22,20,8,6,1
11856,639,368,271,72,51,38,38,475,235,240,77,58,43,22,1
11857,93,46,47,6,8,8,8,355,220,135,43,26,65,20,1
11858,333,192,141,50,48,28,10,838,431,407,107,90,107,43,1
11859,636,284,352,108,101,40,23,790,352,438,132,87,91,60,1
11860,376,183,193,50,50,43,21,769,329,440,116,66,55,22,1
11861,289,139,150,38,44,23,20,344,168,176,50,39,30,20,1
11862,501,240,261,80,62,49,42,312,172,140,41,40,21,8,1
11863,1198,571,627,177,168,97,54,246,108,138,32,44,21,10,1
11864,425,210,215,56,43,52,25,876,457,419,88,124,67,47,1
11865,699,295,404,132,126,46,28,747,316,431,143,127,53,21,1
11866,435,208,227,68,64,53,23,794,390,404,103,95,86,23,1
11867,472,233,239,69,51,41,21,475,235,240,77,58,43,22,1
11868,771,321,450,151,135,43,15,466,186,280,71,84,30,11,1
11869,255,109,146,35,32,23,17,149,68,81,15,38,11,10,1
11870,1471,709,762,198,184,154,62,558,302,256,66,62,65,30,1
11871,360,219,141,33,26,65,22,91,50,41,12,5,10,7,1
11872,154,75,79,17,24,16,13,1425,670,755,153,189,122,85,1
11873,719,301,418,122,132,42,26,694,260,434,122,92,62,36,1
11874,1257,662,595,176,142,106,42,624,308,316,92,72,68,22,1
11875,379,203,176,55,48,45,16,676,295,381,94,71,65,24,1
11876,837,444,393,128,89,87,37,609,292,317,102,96,64,21,1
11877,384,238,146,38,26,66,19,127,55,72,35,7,15,10,1
11878,1075,594,481,132,108,101,42,1242,587,655,276,98,179,46,1
11879,171,94,77,24,28,30,11,401,183,218,72,73,28,10,1
11880,471,221,250,87,68,42,25,673,313,360,101,101,46,17,1
11881,793,240,553,196,206,28,13,149,68,81,15,38,11,10,1
11882,594,340,254,77,64,62,21,521,275,246,51,35,37,28,1
11883,344,168,176,65,44,33,15,455,218,237,57,51,42,35,1
11884,509,262,247,64,70,64,20,317,153,164,34,52,30,14,1
11885,424,209,215,56,58,45,24,1075,515,560,126,106,107,40,1
11886,652,272,380,116,113,55,27,543,221,322,78,122,37,12,1
11887,652,323,329,99,90,65,20,703,356,347,96,97,38,22,1
11888,822,416,406,111,105,84,44,1013,457,556,124,157,81,26,1
11889,723,380,343,80,84,47,18,277,144,133,36,36,34,15,1
11890,373,194,179,42,54,26,13,454,223,231,38,45,24,19,1
11891,95,44,51,14,13,7,4,375,202,173,46,49,41,23,1
11892,599,311,288,91,73,55,32,161,75,86,19,6,18,14,1
11893,351,184,167,59,45,54,9,358,188,170,50,31,48,20,1
11894,490,198,292,65,81,39,27,246,113,133,33,45,22,10,1
11895,656,358,298,67,47,64,26,494,212,282,74,59,43,17,1
11896,478,204,274,65,58,41,20,368,141,227,64,61,24,13,1
11897,262,150,112,31,33,31,7,271,131,140,47,37,41,11,1
11898,450,215,235,73,72,53,18,1089,544,545,138,160,117,43,1
11899,307,154,153,39,36,31,12,329,171,158,49,41,31,10,1
11900,465,257,208,51,61,54,23,317,153,164,39,30,35,13,1
11901,333,127,206,66,68,25,14,907,455,452,132,117,80,40,1
11902,381,166,215,58,38,28,44,1048,564,484,118,122,113,40,1
11903,826,410,416,98,94,107,39,787,386,401,98,95,86,25,1
11904,267,161,106,22,25,35,20,238,151,87,21,16,24,24,1
11905,442,254,188,46,22,40,19,473,217,256,59,44,34,21,1
11906,2109,999,1110,332,294,187,89,318,150,168,60,42,32,12,1
11907,406,191,215,63,39,42,25,303,187,116,41,23,23,9,1
11908,447,222,225,71,54,44,25,2440,1061,1379,377,326,172,62,1
11909,1647,794,853,279,235,128,65,928,442,486,139,118,91,43,1
11910,240,100,140,28,39,31,16,815,382,433,97,50,88,31,1
11911,131,94,37,8,7,22,8,189,91,98,16,15,23,16,1
11912,557,278,279,75,70,66,31,684,288,396,107,90,54,42,1
11913,191,85,106,24,34,19,5,192,106,86,27,21,20,10,1
11914,1462,652,810,243,199,115,30,741,387,354,118,104,90,27,1
11915,489,253,236,73,36,62,17,673,318,355,61,71,40,31,1
11916,667,346,321,100,87,76,22,96,50,46,8,15,6,2,1
11917,1374,679,695,191,193,154,48,105,51,54,13,17,12,8,1
11918,2003,1022,981,195,194,164,229,425,210,215,56,43,52,25,1
11919,279,135,144,40,52,40,5,486,229,257,75,104,49,10,1
11920,91,56,35,17,2,7,7,168,76,92,26,21,19,4,1
11921,471,246,225,46,38,52,30,839,439,400,101,86,102,43,1
11922,311,175,136,40,30,25,13,305,162,143,45,34,38,18,1
11923,1159,641,518,148,115,114,48,246,113,133,33,45,22,10,1
11924,336,154,182,51,48,39,22,592,291,301,92,93,71,31,1
11925,117,53,64,17,17,7,5,146,71,75,20,17,8,7,1
11926,377,177,200,63,53,44,16,906,474,432,90,125,74,24,1
11927,921,544,377,99,116,105,32,245,112,133,32,45,20,10,1
11928,245,111,134,31,44,20,11,164,61,103,47,19,14,5,1
11929,437,225,212,61,57,66,12,509,267,242,79,81,38,20,1
11930,476,263,213,56,44,50,16,1048,564,484,118,122,113,40,1
11931,913,460,453,117,94,103,34,939,493,446,113,100,87,31,1
11932,1298,591,707,196,168,124,58,1747,668,1079,260,190,115,72,1
11933,512,269,243,69,70,62,29,426,200,226,75,56,39,24,1
11934,532,269,263,72,59,59,39,431,219,212,68,46,67,18,1
11935,683,301,382,118,72,97,43,377,202,175,46,50,41,22,1
11936,1273,592,681,199,164,139,39,482,231,251,76,81,64,26,1
11937,671,303,368,93,68,61,26,149,68,81,15,38,11,10,1
11938,429,219,210,46,66,42,17,385,200,185,65,41,41,12,1
11939,958,492,466,119,104,119,35,1551,835,716,216,164,221,53,1
11940,1154,540,614,195,160,138,66,1367,690,677,172,175,154,83,1
11941,326,153,173,63,48,25,8,1480,789,691,195,151,173,55,1
11942,676,333,343,111,89,94,39,1255,708,547,120,68,88,7,1
11943,1356,576,780,229,198,107,38,245,112,133,32,45,20,10,1
11944,1210,592,618,157,138,116,85,229,105,124,36,33,12,4,1
11945,651,306,345,85,64,61,32,461,257,204,63,49,50,29,1
11946,459,212,247,63,48,48,28,158,85,73,24,18,18,8,1
11947,881,419,462,132,82,81,24,590,303,287,69,65,46,17,1
11948,285,109,176,54,80,9,9,176,73,103,22,29,13,9,1
11949,345,198,147,37,39,23,27,462,261,201,69,52,48,12,1
11950,403,215,188,58,47,49,19,859,395,464,157,119,59,31,1
11951,986,488,498,143,131,84,34,189,93,96,24,28,17,12,1
11952,637,335,302,83,77,85,26,119,59,60,29,10,6,4,1
11953,2012,1061,951,253,239,203,88,819,399,420,112,114,85,29,1
11954,1508,733,775,216,186,172,60,240,167,73,32,12,8,21,1
11955,217,109,108,34,32,35,7,1338,756,582,155,105,104,44,1
11956,255,113,142,45,30,24,13,962,430,532,109,142,61,34,1
11957,462,251,211,74,53,41,18,102,61,41,15,13,8,2,1
11958,183,97,86,30,18,20,12,810,367,443,115,92,94,59,1
11959,390,171,219,73,77,16,6,794,322,472,122,108,79,34,1
11960,406,217,189,59,49,56,14,390,209,181,59,47,41,26,1
11961,453,255,198,62,49,29,19,1269,624,645,183,180,136,52,1
11962,922,491,431,112,92,97,52,149,68,81,15,38,11,10,1
11963,463,236,227,64,50,44,29,666,347,319,92,73,63,25,1
11964,551,298,253,63,65,45,19,429,187,242,79,72,28,19,1
11965,552,285,267,74,51,69,24,618,307,311,73,54,46,18,1
11966,354,169,185,54,54,41,19,677,310,367,103,93,70,26,1
11967,181,75,106,35,26,11,9,347,212,135,35,32,17,6,1
11968,295,124,171,57,27,31,18,425,199,226,54,71,56,11,1
11969,376,176,200,31,53,27,8,291,120,171,63,39,26,6,1
11970,1356,672,684,171,172,134,59,359,173,186,55,57,44,16,1
11971,1074,538,536,154,140,111,51,217,109,108,34,32,35,7,1
11972,870,418,452,121,102,109,28,895,474,421,122,93,69,25,1
11973,1015,457,558,110,160,49,26,615,356,259,90,56,97,19,1
11974,421,246,175,51,27,44,19,373,183,190,49,45,41,19,1
11975,368,158,210,64,61,39,14,450,232,218,58,54,42,20,1
11976,351,184,167,59,45,54,9,432,188,244,76,81,26,13,1
11977,148,78,70,21,11,14,11,710,357,353,99,79,72,39,1
11978,508,215,293,72,71,42,15,919,538,381,111,98,103,41,1
11979,530,259,271,83,50,54,41,205,99,106,24,29,20,5,1
11980,561,210,351,108,77,41,22,486,236,250,73,67,59,16,1
11981,720,357,363,113,85,62,39,547,287,260,96,64,51,16,1
11982,377,171,206,46,59,22,6,482,231,251,76,81,64,26,1
11983,454,191,263,61,66,38,15,648,307,341,101,58,76,34,1
11984,95,44,51,14,13,7,4,533,300,233,56,51,32,26,1
11985,442,254,188,46,22,40,19,324,190,134,41,27,28,9,1
11986,527,263,264,75,71,41,15,553,261,292,73,79,40,26,1
11987,550,337,213,47,33,55,31,519,246,273,78,82,42,16,1
11988,517,249,268,65,59,58,26,653,326,327,83,96,83,27,1
11989,578,318,260,70,50,80,17,621,404,217,61,42,73,21,1
11990,247,127,120,43,20,27,14,336,154,182,51,48,39,22,1
11991,730,337,393,115,111,91,26,208,101,107,38,28,24,7,1
11992,864,429,435,129,118,68,35,140,81,59,16,15,15,12,1
11993,419,175,244,71,73,23,23,433,221,212,59,42,47,14,1
11994,673,329,344,111,95,92,41,512,281,231,69,48,70,23,1
11995,391,208,183,65,49,57,17,596,292,304,92,60,56,19,1
11996,142,80,62,21,6,12,3,509,262,247,64,70,64,20,1
11997,272,136,136,32,34,12,12,1647,794,853,279,235,128,65,1
11998,508,251,257,74,53,51,18,949,460,489,116,66,89,42,1
11999,770,390,380,104,76,78,32,168,120,48,7,5,20,7,1
12000,694,357,337,83,70,56,24,247,110,137,34,45,23,10,1
12001,303,159,144,40,35,35,8,1382,689,693,186,176,167,77,1
12002,207,105,102,35,27,15,5,908,488,420,115,97,111,43,1
12003,205,104,101,28,28,35,13,270,162,108,26,26,16,11,1
12004,524,274,250,79,59,66,16,736,388,348,88,85,67,28,1
12005,156,74,82,24,18,16,22,280,164,116,46,21,19,9,1
12006,561,210,351,108,77,41,22,266,137,129,66,21,18,5,1
12007,276,118,158,38,40,16,10,211,83,128,28,35,5,11,1
12008,129,66,63,23,17,18,4,1132,646,486,99,102,71,41,1
12009,532,267,265,86,55,64,22,1382,689,693,186,176,167,77,1
12010,795,305,490,169,178,66,22,553,261,292,73,79,40,26,1
12011,156,88,68,29,14,12,11,321,187,134,59,29,32,8,1
12012,663,323,340,89,89,76,22,766,386,380,101,81,78,31,1
12013,1163,417,746,209,145,87,28,372,189,183,60,44,41,18,1
12014,185,107,78,20,29,10,4,183,93,90,20,31,22,7,1
12015,424,198,226,57,46,41,19,163,71,92,22,38,11,7,1
12016,451,225,226,68,57,65,22,925,484,441,112,86,84,31,1
12017,150,81,69,24,23,16,4,367,161,206,70,48,41,19,1
12018,334,172,162,43,39,41,17,393,186,207,58,50,36,22,1
12019,305,95,210,88,27,15,9,743,233,510,148,142,28,17,1
12020,659,325,334,102,85,87,32,706,346,360,118,92,98,56,1
12021,913,393,520,160,165,87,40,258,111,147,46,63,17,6,1
12022,426,196,230,76,65,54,20,318,176,142,25,32,35,25,1
12023,1356,672,684,171,172,134,59,377,184,193,56,53,44,14,1
12024,205,106,99,28,26,23,3,769,329,440,116,66,55,22,1
12025,446,252,194,41,23,54,35,337,167,170,61,51,38,11,1
12026,866,503,363,97,94,116,39,358,170,188,54,55,20,10,1
12027,414,194,220,76,66,49,16,2556,1169,1387,248,291,227,275,1
12028,663,338,325,68,71,41,16,522,273,249,62,57,51,18,1
12029,268,157,111,26,30,28,13,340,169,171,40,39,36,22,1
12030,536,237,299,116,87,42,17,2321,1177,1144,236,255,174,254,1
12031,355,165,190,53,56,42,19,1210,592,618,157,138,116,85,1
12032,582,293,289,94,80,77,32,221,80,141,48,37,14,10,1
12033,1417,598,819,223,188,135,58,380,185,195,68,54,32,16,1
12034,257,148,109,28,20,21,14,533,297,236,74,57,39,28,1
12035,656,358,298,67,47,64,26,384,207,177,52,39,43,18,1
12036,546,267,279,90,69,56,19,1406,669,737,182,177,152,52,1
12037,595,276,319,120,55,77,39,748,360,388,101,89,82,36,1
12038,192,131,61,16,13,19,8,250,164,86,22,15,30,4,1
12039,297,183,114,31,15,46,24,267,129,138,45,40,23,14,1
12040,286,130,156,42,43,38,7,92,40,52,14,23,13,7,1
12041,1190,638,552,162,95,112,18,775,324,451,130,140,45,15,1
12042,624,204,420,166,101,32,13,372,196,176,51,36,51,8,1
12043,245,137,108,34,30,19,10,293,153,140,45,38,22,15,1
12044,199,101,98,29,25,18,6,910,524,386,106,97,73,26,1
12045,330,159,171,48,38,50,19,1584,831,753,197,161,142,83,1
12046,906,437,469,135,132,49,40,814,450,364,91,114,69,12,1
12047,203,80,123,40,37,20,3,757,373,384,115,93,95,25,1
12048,466,186,280,71,84,30,11,656,336,320,86,90,73,37,1
12049,609,292,317,102,96,64,21,267,147,120,40,24,25,8,1
12050,1152,586,566,131,112,117,42,267,159,108,31,13,22,15,1
12051,376,176,200,31,53,27,8,109,50,59,12,12,9,3,1
12052,467,226,241,55,48,54,23,832,428,404,131,89,88,38,1
12053,1204,623,581,144,146,119,83,208,96,112,31,32,13,9,1
12054,538,252,286,77,87,53,30,758,362,396,115,102,35,13,1
12055,250,116,134,34,39,29,14,448,275,173,32,53,55,27,1
12056,692,383,309,88,64,58,35,503,263,240,72,55,51,34,1
12057,928,442,486,139,118,91,43,368,154,214,80,52,41,16,1
12058,708,324,384,100,103,80,36,522,235,287,78,67,60,50,1
12059,508,215,293,72,71,42,15,1114,581,533,145,132,126,54,1
12060,580,339,241,72,47,66,21,219,124,95,22,22,23,5,1
12061,95,47,48,13,12,10,4,92,46,46,14,9,8,6,1
12062,609,279,330,103,98,72,42,369,180,189,62,70,24,21,1
12063,2715,1447,1268,409,320,193,113,425,210,215,56,43,52,25,1
12064,211,114,97,32,24,19,10,2639,1436,1203,317,307,242,77,1
12065,315,150,165,49,59,23,15,551,237,314,95,79,54,17,1
12066,509,254,255,67,55,52,35,291,162,129,40,21,32,16,1
12067,706,354,352,82,61,32,30,1273,592,681,199,164,139,39,1
12068,288,118,170,50,57,18,15,797,499,298,63,54,106,46,1
12069,143,79,64,16,25,7,5,770,355,415,103,142,75,42,1
12070,150,80,70,26,5,20,7,350,214,136,33,23,49,27,1
12071,815,418,397,97,62,70,17,956,450,506,122,117,82,36,1
12072,409,171,238,69,57,47,17,1863,721,1142,262,283,139,74,1
12073,1194,646,548,139,125,127,59,445,225,220,47,62,53,26,1
12074,906,485,421,112,98,112,39,592,283,309,84,137,60,20,1
12075,1164,531,633,179,157,107,46,577,241,336,112,109,47,21,1
12076,885,424,461,143,114,92,32,1655,891,764,205,245,81,30,1
12077,815,418,397,97,62,70,17,637,339,298,44,25,43,27,1
12078,239,146,93,30,22,35,9,641,324,317,88,92,49,14,1
12079,583,273,310,84,67,73,53,1663,835,828,224,213,163,63,1
12080,238,138,100,31,15,38,11,1037,537,500,134,118,107,63,1
12081,2416,1280,1136,140,374,175,47,477,256,221,69,66,70,12,1
12082,133,66,67,21,24,9,2,1304,585,719,179,169,154,47,1
12083,436,209,227,66,47,52,22,435,222,213,67,49,67,12,1
12084,425,198,227,57,69,59,13,709,310,399,95,103,61,30,1
12085,684,288,396,107,90,54,42,437,225,212,61,57,66,12,1
12086,291,141,150,49,43,26,7,145,70,75,24,16,16,20,1
12087,1333,646,687,209,179,148,45,743,360,383,113,99,67,26,1
12088,234,125,109,23,16,27,11,595,284,311,69,71,35,49,1
12089,777,387,390,90,87,65,37,233,107,126,40,40,20,16,1
12090,491,241,250,73,58,61,25,1124,578,546,149,127,122,61,1
12091,239,110,129,32,32,24,10,618,290,328,82,74,69,42,1
12092,212,88,124,46,24,22,16,185,94,91,36,13,17,7,1
12093,314,158,156,39,28,30,17,219,124,95,22,22,23,5,1
12094,1038,422,616,183,175,75,32,782,382,400,124,131,35,16,1
12095,147,68,79,31,23,8,4,438,217,221,77,52,62,20,1
12096,2261,1217,1044,271,243,267,101,207,105,102,35,27,15,5,1
12097,522,235,287,78,67,60,50,592,291,301,92,93,71,31,1
12098,490,224,266,80,70,39,32,299,155,144,39,38,34,16,1
12099,580,240,340,108,81,59,22,215,115,100,27,28,34,16,1
12100,940,464,476,116,135,108,58,154,76,78,26,17,20,12,1
12101,392,156,236,40,91,28,16,3144,1617,1527,367,342,278,136,1
12102,357,214,143,30,32,27,13,467,224,243,70,43,67,23,1
12103,298,160,138,37,30,22,12,908,488,420,115,97,111,43,1
12104,217,109,108,34,30,34,5,1738,821,917,242,196,181,58,1
12105,354,137,217,53,57,30,5,276,118,158,38,40,16,10,1
12106,224,117,107,33,21,31,16,582,330,252,82,69,87,21,1
12107,396,211,185,66,56,48,11,757,359,398,109,127,80,26,1
12108,619,332,287,95,77,74,38,495,233,262,64,39,49,32,1
12109,920,492,428,100,92,88,49,781,418,363,92,90,64,41,1
12110,488,217,271,71,71,50,32,810,367,443,115,92,94,59,1
12111,340,201,139,34,18,49,22,165,78,87,23,21,17,8,1
12112,3036,1466,1570,417,367,361,123,220,102,118,26,32,27,10,1
12113,326,153,173,63,48,25,8,593,342,251,73,55,82,29,1
12114,919,538,381,111,98,103,41,357,182,175,49,36,39,15,1
12115,1471,709,762,198,184,154,62,1863,721,1142,262,283,139,74,1
12116,815,418,397,97,62,70,17,723,309,414,106,106,41,40,1
12117,925,484,441,112,86,84,31,170,83,87,23,32,17,9,1
12118,432,218,214,57,55,42,11,219,124,95,22,22,23,5,1
12119,133,66,67,21,24,9,2,854,380,474,137,159,81,31,1
12120,1132,553,579,172,143,150,57,897,487,410,92,97,83,31,1
12121,556,279,277,83,69,71,19,984,459,525,150,145,89,37,1
12122,904,414,490,142,115,92,32,497,185,312,63,92,38,28,1
12123,1493,672,821,258,211,146,47,396,181,215,52,47,48,19,1
12124,246,115,131,15,29,10,32,807,438,369,95,80,71,31,1
12125,435,222,213,67,49,67,12,560,260,300,100,58,29,28,1
12126,510,264,246,67,66,38,29,1290,597,693,182,182,119,63,1
12127,729,358,371,116,99,89,33,712,380,332,69,74,57,30,1
12128,504,237,267,62,66,48,17,396,184,212,69,48,36,28,1
12129,1115,586,529,124,161,111,69,1800,882,918,202,185,186,49,1
12130,166,81,85,30,27,13,8,377,202,175,46,50,41,23,1
12131,136,66,70,33,11,9,4,822,417,405,112,97,88,40,1
12132,413,206,207,38,55,19,10,1863,721,1142,262,283,139,74,1
12133,573,247,326,98,95,46,22,824,403,421,80,150,65,35,1
12134,655,269,386,128,129,49,21,743,346,397,91,90,62,10,1
12135,435,221,214,72,45,47,19,298,140,158,51,33,21,22,1
12136,96,50,46,8,15,6,2,95,47,48,13,12,10,4,1
12137,1089,544,545,138,160,117,43,1290,629,661,191,187,167,55,1
12138,150,60,90,27,16,6,3,368,141,227,64,61,24,13,1
12139,357,147,210,48,37,21,47,183,97,86,30,18,20,12,1
12140,330,178,152,49,35,30,15,476,270,206,62,45,46,30,1
12141,1863,721,1142,262,283,139,74,414,194,220,76,66,49,16,1
12142,1112,555,557,139,137,124,48,246,108,138,32,44,21,10,1
12143,858,417,441,93,124,75,26,465,206,259,59,46,40,38,1
12144,589,296,293,99,76,64,29,695,373,322,80,59,89,39,1
12145,288,138,150,82,22,25,5,288,158,130,59,23,21,10,1
12146,394,202,192,44,43,38,28,750,371,379,95,98,86,29,1
12147,1676,860,816,208,192,204,56,350,215,135,36,21,48,14,1
12148,418,245,173,43,39,36,14,258,153,105,36,28,29,9,1
12149,506,233,273,81,69,52,22,622,309,313,75,81,76,29,1
12150,360,218,142,39,26,50,18,114,66,48,15,5,2,6,1
12151,176,85,91,24,23,24,7,242,125,117,38,31,28,22,1
12152,168,120,48,7,5,20,7,259,123,136,36,40,33,12,1
12153,1502,683,819,241,216,172,52,825,363,462,97,105,72,75,1
12154,589,294,295,37,44,27,33,280,156,124,36,19,20,13,1
12155,525,245,280,59,72,47,21,1154,540,614,195,160,138,66,1
12156,335,177,158,45,49,34,13,706,346,360,118,92,98,56,1
12157,870,436,434,131,114,72,25,217,109,108,34,32,35,7,1
12158,310,142,168,42,39,24,9,1085,646,439,108,65,36,19,1
12159,95,44,51,14,13,7,4,289,147,142,45,45,38,13,1
12160,326,161,165,55,43,21,12,318,150,168,60,42,32,12,1
12161,281,166,115,34,17,36,16,617,255,362,105,108,61,23,1
12162,653,327,326,91,79,55,39,601,313,288,42,48,25,36,1
12163,421,192,229,72,54,51,48,892,420,472,135,146,98,37,1
12164,377,171,206,46,59,22,6,301,150,151,41,30,17,11,1
12165,246,107,139,55,33,27,11,289,164,125,37,31,35,16,1
12166,184,94,90,31,21,24,9,360,188,172,49,48,47,17,1
12167,552,283,269,89,66,68,30,476,270,206,62,45,46,30,1
12168,247,110,137,34,45,23,10,409,199,210,62,54,50,25,1
12169,475,235,240,77,58,43,22,736,388,348,88,85,67,28,1
12170,407,180,227,79,42,32,16,297,158,139,47,37,37,9,1
12171,1061,586,475,141,127,120,38,151,82,69,16,17,11,7,1
12172,193,88,105,29,32,25,9,347,133,214,64,60,29,9,1
12173,424,179,245,65,67,29,11,620,258,362,106,100,47,28,1
12174,474,224,250,50,72,51,43,778,367,411,90,85,64,43,1
12175,451,235,216,64,49,38,21,439,177,262,78,73,40,21,1
12176,345,203,142,47,35,31,11,543,265,278,52,37,54,19,1
12177,421,195,226,73,71,34,15,81,38,43,11,12,5,5,1
12178,456,209,247,72,58,40,9,359,157,202,44,34,31,17,1
12179,202,105,97,28,27,14,6,609,292,317,102,96,64,21,1
12180,183,95,88,27,22,26,5,118,56,62,13,14,6,6,1
12181,948,484,464,134,131,75,27,202,102,100,29,35,6,9,1
12182,304,127,177,61,38,31,4,360,188,172,49,48,47,17,1
12183,391,203,188,49,34,36,9,441,216,225,57,66,57,19,1
12184,817,425,392,120,102,83,26,1464,715,749,200,167,181,70,1
12185,445,225,220,47,62,53,26,465,218,247,64,51,50,42,1
12186,1455,765,690,189,162,166,66,1647,794,853,279,235,128,65,1
12187,1009,506,503,146,141,97,55,1338,633,705,199,151,144,65,1
12188,673,331,342,109,71,75,36,184,86,98,26,26,14,11,1
12189,903,437,466,117,112,108,32,620,348,272,91,43,59,29,1
12190,1272,520,752,235,242,117,54,406,205,201,54,58,34,21,1
12191,451,238,213,53,64,56,22,451,222,229,58,55,51,17,1
12192,2718,1148,1570,384,286,195,88,205,100,105,25,25,20,9,1
12193,101,57,44,14,8,6,6,91,50,41,12,5,10,7,1
12194,416,210,206,55,54,39,20,1403,702,701,176,173,168,74,1
12195,454,224,230,71,39,62,22,254,146,108,36,20,34,10,1
12196,724,334,390,112,109,79,17,586,254,332,114,111,55,17,1
12197,2109,1024,1085,306,265,236,86,193,99,94,31,31,16,12,1
12198,334,182,152,45,41,27,13,349,200,149,41,39,30,20,1
12199,464,242,222,61,68,36,17,526,264,262,77,71,61,27,1
12200,673,329,344,111,95,92,41,798,378,420,99,94,71,63,1
12201,317,153,164,34,52,30,14,192,91,101,29,28,17,7,1
12202,452,224,228,69,56,50,31,176,106,70,30,15,18,5,1
12203,185,94,91,23,19,17,9,1207,593,614,151,148,131,95,1
12204,413,206,207,38,55,19,10,1068,527,541,160,131,112,52,1
12205,172,80,92,28,22,21,4,361,184,177,50,53,51,22,1
12206,406,187,219,55,64,24,9,195,89,106,22,34,5,2,1
12207,642,271,371,106,111,57,23,205,99,106,24,29,20,5,1
12208,1210,592,618,157,138,116,85,371,174,197,53,56,43,15,1
12209,1298,591,707,196,168,124,58,1874,867,1007,269,223,122,55,1
12210,246,124,122,33,24,25,19,255,113,142,31,40,18,9,1
12211,113,61,52,13,15,7,5,465,279,186,48,24,70,25,1
12212,669,406,263,69,68,64,27,428,226,202,52,60,75,20,1
12213,815,418,397,97,62,70,17,1082,515,567,174,154,96,41,1
12214,591,263,328,95,90,26,13,4588,2261,2327,516,642,497,118,1
12215,376,183,193,50,50,43,21,1749,880,869,237,228,214,112,1
12216,920,492,428,100,92,88,49,969,505,464,123,133,92,33,1
12217,110,49,61,19,7,2,5,531,260,271,97,68,47,11,1
12218,461,197,264,86,97,43,10,355,165,190,53,56,42,19,1
12219,524,264,260,75,75,40,21,543,287,256,71,66,64,23,1
12220,2390,1131,1259,395,383,203,74,2419,1042,1377,389,474,238,59,1
12221,2639,1436,1203,317,307,242,77,433,237,196,60,52,33,27,1
12222,125,58,67,34,14,6,2,671,318,353,83,124,46,34,1
12223,825,399,426,128,128,77,32,548,250,298,85,64,56,21,1
12224,194,92,102,42,23,16,2,898,467,431,101,127,90,53,1
12225,745,391,354,85,81,52,39,81,38,43,11,12,5,5,1
12226,538,252,286,77,87,53,30,962,430,532,109,142,61,34,1
12227,103,56,47,27,7,8,2,577,277,300,71,59,64,24,1
12228,1023,449,574,140,174,76,43,2035,1087,948,163,129,96,73,1
12229,101,41,60,18,19,10,5,1050,473,577,142,119,87,54,1
12230,402,227,175,48,40,35,11,198,113,85,19,20,26,12,1
12231,870,433,437,133,121,95,25,767,392,375,113,112,83,13,1
12232,360,192,168,55,45,48,16,465,225,240,65,44,65,25,1
12233,229,116,113,34,27,27,15,862,335,527,136,169,47,28,1
12234,3969,1703,2266,619,432,259,144,538,263,275,71,85,44,18,1
12235,786,378,408,101,79,104,35,704,356,348,112,94,71,24,1
12236,534,266,268,86,62,37,14,270,128,142,36,43,15,11,1
12237,67,34,33,10,12,6,5,767,392,375,113,112,83,13,1
12238,1390,695,695,180,137,170,71,845,402,443,137,126,105,47,1
12239,4684,2161,2523,779,782,304,101,466,186,280,71,84,30,11,1
12240,492,317,175,42,31,63,23,417,182,235,57,109,50,8,1
12241,410,208,202,59,58,43,26,297,158,139,47,37,37,9,1
12242,212,93,119,30,27,21,14,305,168,137,48,35,40,9,1
12243,1215,652,563,129,142,121,62,451,238,213,53,64,56,22,1
12244,641,341,300,101,91,29,22,536,278,258,72,63,62,20,1
12245,1158,481,677,169,129,86,40,482,231,251,76,81,64,26,1
12246,233,121,112,24,31,30,7,393,186,207,58,50,36,22,1
12247,240,125,115,34,32,30,8,681,286,395,109,61,69,42,1
12248,466,186,280,71,84,30,11,623,269,354,100,86,62,24,1
12249,89,42,47,16,12,15,6,784,427,357,103,89,68,40,1
12250,2328,1054,1274,377,410,232,62,858,417,441,93,124,75,26,1
12251,1247,548,699,168,150,140,43,594,274,320,89,63,66,28,1
12252,471,246,225,46,38,52,30,1132,553,579,172,143,150,57,1
12253,536,278,258,72,63,62,20,524,264,260,75,75,40,21,1
12254,429,219,210,46,66,42,17,293,140,153,39,44,41,19,1
12255,1477,738,739,176,176,145,72,5938,2573,3365,858,958,396,195,1
12256,247,110,137,34,45,23,10,246,113,133,33,45,22,10,1
12257,958,451,507,165,135,97,41,803,358,445,135,117,80,44,1
12258,1087,523,564,146,177,103,33,308,129,179,44,60,19,8,1
12259,530,244,286,103,62,42,20,530,259,271,83,50,54,41,1
12260,220,127,93,26,19,27,7,1139,536,603,162,139,109,50,1
12261,182,90,92,25,23,14,5,240,125,115,34,32,30,8,1
12262,372,189,183,60,44,41,18,928,442,486,139,118,91,43,1
12263,107,36,71,27,15,0,1,347,181,166,27,20,12,12,1
12264,628,341,287,77,59,55,31,684,288,396,107,90,54,42,1
12265,422,213,209,63,60,35,13,1440,759,681,173,170,178,71,1
12266,332,211,121,27,16,41,22,326,153,173,63,48,25,8,1
12267,249,111,138,40,30,22,17,202,102,100,29,35,6,9,1
12268,216,121,95,38,27,25,6,601,313,288,42,48,25,36,1
12269,683,304,379,140,101,48,19,524,295,229,69,58,36,12,1
12270,165,87,78,24,19,22,9,1087,523,564,146,177,103,33,1
12271,225,102,123,32,32,31,15,1771,864,907,239,217,158,63,1
12272,2342,933,1409,330,354,199,108,341,178,163,48,44,42,20,1
12273,431,228,203,66,46,59,15,955,465,490,137,138,119,28,1
12274,350,180,170,64,46,55,12,596,292,304,92,60,56,19,1
12275,309,137,172,51,50,28,14,291,120,171,63,39,26,6,1
12276,425,161,264,69,79,22,10,672,334,338,110,93,91,41,1
12277,377,177,200,63,53,44,16,764,409,355,88,73,102,43,1
12278,292,153,139,39,33,24,21,164,78,86,28,23,12,8,1
12279,1360,644,716,213,194,136,62,261,130,131,27,41,19,16,1
12280,2157,1033,1124,365,281,199,63,1849,882,967,239,239,191,84,1
12281,1647,794,853,279,235,128,65,1863,721,1142,262,283,139,74,1
12282,2489,1251,1238,288,234,283,178,245,142,103,29,20,21,9,1
12283,672,334,338,110,93,91,41,483,274,209,54,39,45,13,1
12284,657,293,364,109,75,66,28,247,110,137,34,45,23,10,1
12285,358,170,188,54,55,20,10,670,384,286,58,58,79,52,1
12286,524,264,260,75,75,40,21,595,292,303,79,83,69,24,1
12287,822,417,405,112,97,88,40,677,323,354,101,109,45,31,1
12288,1322,598,724,141,94,53,37,185,70,115,37,48,15,5,1
12289,312,180,132,36,22,32,21,245,112,133,32,45,20,10,1
12290,938,484,454,137,100,104,41,149,68,81,15,38,11,10,1
12291,466,262,204,71,43,50,14,263,140,123,31,29,31,13,1
12292,406,209,197,57,50,50,17,1152,586,566,131,112,117,42,1
12293,348,187,161,50,35,44,9,461,238,223,67,61,41,23,1
12294,411,171,240,61,81,30,15,778,367,411,90,85,64,43,1
12295,654,317,337,95,111,44,13,4563,2219,2344,620,531,527,104,1
12296,1130,639,491,87,188,57,41,467,224,243,70,43,67,23,1
12297,345,176,169,34,31,36,11,1255,666,589,145,142,120,82,1
12298,986,499,487,123,116,98,54,333,167,166,45,30,34,14,1
12299,95,41,54,15,16,8,5,536,230,306,64,88,40,12,1
12300,280,139,141,25,39,26,13,480,244,236,74,47,50,21,1
12301,346,208,138,46,39,51,18,311,187,124,39,38,35,12,1
12302,454,191,263,61,66,38,15,339,170,169,32,17,24,13,1
12303,1210,592,618,157,138,116,85,208,107,101,42,22,18,10,1
12304,3664,1638,2026,598,519,231,63,2440,1061,1379,377,326,172,62,1
12305,592,291,301,92,93,71,31,191,99,92,25,24,18,8,1
12306,822,392,430,125,104,79,24,202,102,100,29,35,6,9,1
12307,1114,581,533,145,132,126,54,427,218,209,61,53,45,26,1
12308,376,139,237,69,73,34,6,240,167,73,32,12,8,21,1
12309,233,130,103,26,23,23,6,554,269,285,60,67,38,21,1
12310,211,108,103,34,25,26,12,465,225,240,65,44,65,25,1
12311,767,392,375,113,112,83,13,672,334,338,110,93,91,41,1
12312,394,202,192,44,43,38,28,806,419,387,115,130,57,32,1
12313,2639,1436,1203,317,307,242,77,467,269,198,46,51,60,18,1
12314,95,41,54,15,16,8,5,587,300,287,67,102,34,20,1
12315,425,210,215,56,43,52,25,450,227,223,53,36,48,12,1
12316,67,34,33,10,12,6,5,340,162,178,40,39,35,22,1
12317,103,56,47,27,7,8,2,158,85,73,24,18,18,8,1
12318,673,318,355,61,71,40,31,552,285,267,74,51,69,24,1
12319,485,187,298,95,71,61,25,611,246,365,116,82,71,27,1
12320,878,453,425,118,97,93,41,480,196,284,72,74,25,2,1
12321,282,135,147,36,49,25,10,2157,1171,986,306,238,131,32,1
12322,240,125,115,34,32,30,8,222,148,74,26,5,29,10,1
12323,588,266,322,99,79,87,28,1050,473,577,142,119,87,54,1
12324,452,234,218,65,46,63,22,1132,646,486,99,102,71,41,1
12325,351,184,167,59,45,54,9,906,485,421,112,98,112,39,1
12326,505,254,251,80,77,60,15,592,283,309,84,137,60,20,1
12327,1117,423,694,182,134,88,31,611,246,365,116,82,71,27,1
12328,490,224,266,80,70,39,32,582,293,289,94,80,77,32,1
12329,520,261,259,82,76,71,24,695,373,322,80,59,89,39,1
12330,912,460,452,139,132,89,53,482,231,251,76,81,64,26,1
12331,466,233,233,68,72,41,12,450,241,209,67,58,54,23,1
12332,607,311,296,73,81,33,33,184,86,98,26,26,14,11,1
12333,824,365,459,121,123,88,50,926,435,491,133,132,85,17,1
12334,940,464,476,116,135,108,58,395,222,173,48,42,21,8,1
12335,450,241,209,67,58,54,23,536,278,258,72,63,62,20,1
12336,387,193,194,60,53,57,15,150,81,69,24,23,16,4,1
12337,2549,1331,1218,366,296,271,130,482,262,220,72,60,52,15,1
12338,465,224,241,63,54,54,31,335,143,192,45,36,32,37,1
12339,582,330,252,82,69,87,21,4544,2024,2520,579,628,480,403,1
12340,344,190,154,34,31,36,10,285,148,137,31,42,42,16,1
12341,2321,1177,1144,236,255,174,254,745,366,379,110,93,79,45,1
12342,2624,999,1625,416,495,109,81,928,442,486,139,118,91,43,1
12343,96,55,41,13,2,8,5,4563,2219,2344,620,531,527,104,1
12344,808,366,442,130,133,66,31,821,387,434,121,131,76,29,1
12345,191,72,119,40,41,17,8,753,318,435,154,95,56,23,1
12346,308,170,138,38,35,45,14,273,148,125,38,31,16,19,1
12347,204,93,111,35,35,16,11,227,109,118,42,35,29,8,1
12348,3259,1163,2096,526,657,162,86,290,127,163,47,58,23,12,1
12349,335,143,192,45,36,32,37,526,264,262,77,71,61,27,1
12350,676,333,343,111,89,94,39,483,274,209,54,39,45,13,1
12351,815,382,433,97,50,88,31,234,110,124,39,29,23,2,1
12352,911,493,418,89,140,83,34,467,251,216,56,49,79,11,1
12353,2944,1827,1117,338,332,122,35,646,316,330,89,95,48,17,1
12354,291,159,132,36,29,20,10,178,100,78,23,22,30,6,1
12355,864,362,502,142,150,70,19,719,360,359,102,93,89,30,1
12356,1152,459,693,138,343,75,33,1286,576,710,202,207,121,41,1
12357,458,269,189,56,40,29,7,360,188,172,49,48,47,17,1
12358,406,202,204,54,54,41,16,423,212,211,51,44,48,28,1
12359,199,87,112,31,27,8,15,744,358,386,100,76,71,36,1
12360,458,225,233,67,61,43,33,1158,481,677,169,129,86,40,1
12361,605,352,253,69,59,54,15,195,83,112,40,16,19,16,1
12362,394,202,192,44,43,38,28,527,287,240,78,63,67,22,1
12363,775,355,420,116,99,86,68,1032,526,506,129,117,119,47,1
12364,309,144,165,54,39,25,12,756,366,390,83,146,47,23,1
12365,1744,920,824,223,192,177,58,100,51,49,12,12,8,4,1
12366,277,124,153,44,40,35,18,948,484,464,134,131,75,27,1
12367,639,322,317,73,82,39,23,2214,1053,1161,272,286,275,133,1
12368,344,168,176,65,44,33,15,445,225,220,47,62,53,26,1
12369,918,427,491,113,111,113,33,200,99,101,31,24,26,6,1
12370,538,268,270,58,72,42,25,144,67,77,28,14,9,8,1
12371,502,240,262,78,61,54,32,880,355,525,122,139,75,36,1
12372,1435,649,786,214,181,135,54,391,204,187,47,48,38,18,1
12373,989,439,550,142,121,75,29,926,435,491,133,132,85,17,1
12374,174,82,92,27,23,26,14,175,86,89,33,25,27,2,1
12375,441,201,240,70,58,55,24,351,183,168,55,44,33,9,1
12376,764,380,384,89,92,67,25,226,129,97,20,25,26,11,1
12377,514,265,249,74,61,62,16,605,281,324,111,67,40,44,1
12378,150,74,76,21,22,18,7,196,99,97,28,32,17,12,1
12379,424,209,215,56,58,45,24,198,102,96,27,20,21,12,1
12380,1210,592,618,157,138,116,85,149,68,81,15,38,11,10,1
12381,1149,568,581,177,133,101,30,497,185,312,63,92,38,28,1
12382,147,81,66,18,18,18,4,729,321,408,128,84,63,26,1
12383,323,154,169,52,52,32,9,244,135,109,36,24,20,10,1
12384,515,250,265,67,60,58,29,694,315,379,101,87,47,17,1
12385,770,374,396,95,91,79,41,794,390,404,103,95,86,23,1
12386,465,228,237,64,42,63,24,147,78,69,22,16,20,4,1
12387,548,250,298,85,64,56,21,916,442,474,150,133,91,32,1
12388,297,158,139,47,37,37,9,550,319,231,49,65,35,16,1
12389,941,504,437,119,86,103,44,282,171,111,30,38,15,8,1
12390,555,308,247,70,67,60,38,247,133,114,41,25,41,8,1
12391,984,516,468,78,45,73,12,219,124,95,22,22,23,5,1
12392,436,209,227,66,47,52,22,808,366,442,130,133,66,31,1
12393,2045,985,1060,359,339,199,74,435,203,232,57,67,40,12,1
12394,1087,480,607,155,179,99,28,467,250,217,59,52,41,19,1
12395,314,162,152,56,32,36,26,370,176,194,61,30,40,28,1
12396,737,363,374,119,101,85,41,537,276,261,75,68,68,22,1
12397,552,285,267,74,51,69,24,505,269,236,52,59,32,18,1
12398,330,157,173,56,42,51,8,724,325,399,98,92,64,24,1
12399,267,130,137,31,18,19,13,551,299,252,51,62,63,17,1
12400,209,96,113,35,28,22,13,771,321,450,151,135,43,15,1
12401,1269,624,645,183,180,136,52,1076,517,559,139,136,72,34,1
12402,751,312,439,131,115,78,48,156,88,68,29,14,12,11,1
12403,163,70,93,28,21,17,6,902,332,570,154,146,75,40,1
12404,454,224,230,71,39,62,22,496,286,210,60,53,61,16,1
12405,501,249,252,77,70,55,22,320,171,149,40,29,30,14,1
12406,247,110,137,34,45,23,10,957,385,572,173,168,62,33,1
12407,446,246,200,64,48,54,12,289,143,146,38,18,40,8,1
12408,360,188,172,49,48,47,17,606,279,327,81,70,49,34,1
12409,501,240,261,80,62,49,42,144,57,87,38,26,10,4,1
12410,777,387,390,90,87,65,37,606,279,327,81,70,49,34,1
12411,247,110,137,34,45,23,10,508,254,254,74,99,61,12,1
12412,1130,590,540,155,133,133,61,207,124,83,22,19,24,11,1
12413,519,219,300,86,72,50,39,153,71,82,28,20,15,7,1
12414,445,219,226,61,60,60,21,478,229,249,85,72,58,21,1
12415,581,323,258,74,58,48,20,671,326,345,111,77,74,11,1
12416,426,200,226,75,56,39,24,513,274,239,67,66,62,35,1
12417,1123,554,569,142,130,85,36,413,236,177,41,25,35,19,1
12418,595,316,279,86,60,65,40,840,385,455,118,137,66,39,1
12419,416,209,207,76,45,50,17,736,388,348,88,85,67,28,1
12420,520,236,284,115,52,45,16,238,91,147,68,19,22,7,1
12421,609,292,317,102,96,64,21,204,99,105,32,32,22,10,1
12422,598,300,298,68,77,59,21,757,359,398,109,127,80,26,1
12423,676,295,381,94,71,65,24,303,159,144,40,35,35,8,1
12424,415,219,196,53,55,57,20,449,240,209,59,55,63,20,1
12425,624,308,316,92,72,68,22,847,402,445,109,91,100,37,1
12426,783,429,354,89,73,68,33,693,359,334,75,54,59,20,1
12427,582,293,289,94,80,77,32,1863,721,1142,262,283,139,74,1
12428,362,233,129,37,17,51,18,340,163,177,39,38,37,23,1
12429,318,165,153,45,38,25,18,452,256,196,32,44,27,11,1
12430,281,125,156,44,47,17,7,406,212,194,50,52,24,18,1
12431,398,216,182,52,33,40,15,1712,1175,537,179,142,113,46,1
12432,1118,555,563,151,154,88,35,888,478,410,105,73,58,33,1
12433,677,310,367,103,93,70,26,355,165,190,53,56,42,19,1
12434,380,212,168,47,38,19,11,208,104,104,20,54,9,5,1
12435,1048,564,484,118,122,113,40,390,203,187,58,40,43,19,1
12436,171,94,77,24,28,30,11,147,79,68,24,17,17,11,1
12437,291,131,160,49,35,32,15,441,216,225,57,66,57,19,1
12438,560,260,300,100,58,29,28,1150,506,644,154,176,124,52,1
12439,856,415,441,133,128,51,39,297,148,149,64,35,37,15,1
12440,1052,492,560,184,163,103,44,763,354,409,101,90,63,26,1
12441,245,110,135,42,32,29,9,985,466,519,153,122,73,26,1
12442,246,115,131,15,29,10,32,187,95,92,27,20,16,8,1
12443,1424,650,774,152,124,95,87,437,228,209,47,61,26,11,1
12444,392,156,236,40,91,28,16,1217,496,721,230,214,94,42,1
12445,372,196,176,51,36,51,8,2157,1171,986,306,238,131,32,1
12446,509,341,168,35,32,52,15,385,194,191,49,50,40,12,1
12447,656,358,298,67,47,64,26,219,124,95,22,22,23,5,1
12448,218,133,85,20,19,13,6,349,131,218,66,76,22,9,1
12449,261,127,134,42,37,24,11,241,124,117,25,35,21,12,1
12450,631,294,337,83,129,46,24,1268,593,675,182,193,132,78,1
12451,789,389,400,121,80,92,40,264,126,138,44,26,25,10,1
12452,2490,1126,1364,352,325,219,89,281,166,115,34,17,36,16,1
12453,351,163,188,54,61,21,7,285,109,176,54,80,9,9,1
12454,1441,657,784,140,135,81,73,530,259,271,83,50,54,41,1
12455,1320,566,754,235,198,122,36,183,91,92,21,29,16,10,1
12456,671,303,368,93,68,61,26,236,118,118,26,20,18,7,1
12457,236,140,96,20,39,12,6,505,271,234,56,57,57,26,1
12458,624,204,420,166,101,32,13,288,104,184,80,30,39,6,1
12459,464,242,222,61,68,36,17,266,110,156,50,28,43,7,1
12460,815,418,397,97,62,70,17,2157,1171,986,306,238,131,32,1
12461,377,184,193,56,53,44,14,218,121,97,29,26,21,6,1
12462,678,362,316,89,60,88,24,803,395,408,127,102,79,31,1
12463,632,339,293,83,77,59,20,512,261,251,79,73,60,21,1
12464,323,162,161,53,41,40,13,1341,481,860,275,264,57,21,1
12465,368,201,167,61,38,38,12,456,294,162,35,26,63,24,1
12466,1074,538,536,154,140,111,51,788,360,428,93,106,67,72,1
12467,166,81,85,30,27,13,8,1023,561,462,117,125,96,48,1
12468,355,186,169,54,41,35,15,298,141,157,43,29,28,13,1
12469,471,246,225,46,38,52,30,373,189,184,54,46,50,23,1
12470,963,447,516,120,146,87,74,3460,1748,1712,369,360,496,190,1
12471,276,151,125,35,28,33,20,703,414,289,75,61,68,26,1
12472,160,60,100,23,40,19,11,1132,624,508,199,79,127,41,1
12473,249,114,135,47,33,25,4,150,60,90,27,16,6,3,1
12474,391,208,183,65,49,57,17,428,226,202,52,60,75,20,1
12475,2220,1085,1135,312,304,202,91,521,265,256,69,69,61,26,1
12476,712,380,332,69,74,57,30,427,236,191,49,54,46,13,1
12477,372,179,193,50,52,33,6,1143,557,586,198,157,92,32,1
12478,729,321,408,128,84,63,26,278,148,130,36,29,25,16,1
12479,295,124,171,57,27,31,18,441,201,240,70,58,55,24,1
12480,136,65,71,33,11,9,6,719,364,355,104,100,58,34,1
12481,202,117,85,21,23,23,6,1247,548,699,168,150,140,43,1
12482,592,275,317,100,86,57,31,280,142,138,35,37,22,13,1
12483,452,236,216,73,54,50,29,788,360,428,93,106,67,72,1
12484,101,53,48,8,12,10,3,475,238,237,73,53,63,17,1
12485,442,208,234,68,49,51,25,349,166,183,49,37,25,52,1
12486,324,174,150,37,24,35,27,1447,751,696,161,143,131,46,1
12487,428,224,204,69,50,61,24,673,329,344,111,95,92,41,1
12488,1038,422,616,183,175,75,32,247,110,137,34,45,23,10,1
12489,325,159,166,42,43,48,15,595,316,279,86,60,65,40,1
12490,130,71,59,30,9,8,2,183,93,90,20,31,22,7,1
12491,161,100,61,13,9,28,5,674,358,316,91,92,97,29,1
12492,158,85,73,24,18,18,8,588,255,333,94,82,58,27,1
12493,255,143,112,22,29,34,12,458,222,236,69,39,35,18,1
12494,652,272,380,116,113,55,27,130,71,59,30,9,8,1,1
12495,656,358,298,67,47,64,26,485,249,236,67,54,52,13,1
12496,379,184,195,51,61,49,8,592,267,325,91,88,53,27,1
12497,220,127,93,26,19,27,7,1068,527,541,160,131,112,52,1
12498,361,184,177,50,53,51,22,385,212,173,57,40,39,21,1
12499,3418,1378,2040,515,464,318,121,410,208,202,59,58,43,26,1
12500,149,78,71,20,20,19,5,941,459,482,167,140,82,38,1
12501,651,331,320,93,93,51,28,99,34,65,12,1,2,18,1
12502,161,75,86,24,20,10,7,677,361,316,81,61,42,22,1
12503,477,256,221,69,66,70,12,99,49,50,16,8,7,8,1
12504,456,228,228,49,70,32,19,623,233,390,145,83,43,20,1
12505,435,187,248,62,51,51,21,424,209,215,56,58,45,24,1
12506,462,251,211,74,53,41,18,206,122,84,17,29,13,4,1
12507,2639,1436,1203,317,307,242,77,400,228,172,43,20,47,24,1
12508,209,125,84,20,22,22,6,275,140,135,38,32,18,5,1
12509,184,86,98,26,26,14,11,648,307,341,101,58,76,34,1
12510,172,88,84,24,31,20,12,350,200,150,45,47,23,8,1
12511,211,126,85,21,20,28,7,347,169,178,41,37,44,13,1
12512,920,492,428,100,92,88,49,832,428,404,131,89,88,38,1
12513,250,123,127,40,28,29,8,246,115,131,15,29,10,32,1
12514,156,67,89,25,13,15,14,461,223,238,45,62,18,35,1
12515,379,203,176,55,48,45,16,770,374,396,95,91,79,41,1
12516,546,267,279,90,69,56,19,118,51,67,25,13,6,7,1
12517,815,418,397,97,62,70,17,265,103,162,61,58,25,3,1
12518,2364,1004,1360,406,426,226,79,1270,557,713,130,195,57,30,1
12519,370,190,180,60,52,37,13,611,246,365,116,82,71,27,1
12520,445,272,173,51,41,36,7,4391,2256,2135,494,411,423,231,1
12521,1336,828,508,166,121,152,48,568,243,325,98,73,56,44,1
12522,601,313,288,42,48,25,36,813,439,374,106,77,85,65,1
12523,490,224,266,80,70,39,32,2524,1232,1292,398,317,186,61,1
12524,656,358,298,67,47,64,26,291,141,150,49,43,26,7,1
12525,2556,1169,1387,248,291,227,275,330,143,187,63,29,52,20,1
12526,426,200,226,75,56,39,24,344,138,206,46,48,24,43,1
12527,815,418,397,97,62,70,17,443,208,235,43,55,51,50,1
12528,707,295,412,105,105,66,30,776,356,420,122,103,85,30,1
12529,360,190,170,61,40,38,19,469,221,248,49,60,55,21,1
12530,860,378,482,101,123,82,74,555,278,277,60,70,48,18,1
12531,305,95,210,88,27,15,9,780,304,476,160,173,66,23,1
12532,724,650,74,44,3,32,3,2912,1266,1646,268,360,243,422,1
12533,1615,835,780,189,208,172,86,694,441,253,69,47,82,42,1
12534,437,235,202,72,61,39,17,1431,757,674,122,88,121,33,1
12535,358,204,154,57,41,36,14,327,177,150,40,40,38,18,1
12536,556,269,287,86,66,62,22,1234,590,644,180,182,95,40,1
12537,2442,1193,1249,278,183,170,145,1311,690,621,158,161,128,51,1
12538,1210,592,618,157,138,116,85,912,461,451,127,109,96,48,1
12539,1210,592,618,157,138,116,85,101,43,58,18,16,12,7,1
12540,295,146,149,50,42,24,10,325,186,139,49,36,20,5,1
12541,1943,846,1097,301,257,135,77,235,119,116,31,26,15,13,1
12542,168,67,101,37,17,13,13,631,341,290,96,71,71,19,1
12543,764,409,355,88,73,102,43,1037,575,462,122,150,82,32,1
12544,622,299,323,86,86,69,35,359,200,159,49,37,47,17,1
12545,268,153,115,42,27,23,10,315,118,197,85,57,42,14,1
12546,377,177,200,63,53,44,16,425,244,181,38,26,60,26,1
12547,480,234,246,79,77,65,23,130,55,75,21,26,10,3,1
12548,205,106,99,28,26,23,3,377,202,175,46,50,41,22,1
12549,101,45,56,17,17,12,9,1939,811,1128,352,357,148,73,1
12550,911,423,488,140,150,102,32,1537,701,836,209,187,129,58,1
12551,1430,718,712,205,172,151,64,288,118,170,50,57,18,15,1
12552,933,536,397,96,90,71,41,439,202,237,80,53,35,15,1
12553,385,179,206,58,56,38,19,928,442,486,139,118,91,43,1
12554,279,135,144,40,52,40,5,1321,724,597,151,143,144,56,1
12555,173,110,63,35,6,9,8,826,362,464,107,118,71,43,1
12556,432,218,214,57,55,42,11,622,328,294,75,42,67,31,1
12557,224,123,101,23,24,33,6,223,127,96,25,23,33,4,1
12558,432,218,214,57,55,42,11,456,225,231,64,57,56,23,1
12559,145,58,87,45,15,14,4,633,327,306,102,90,72,15,1
12560,659,325,334,102,85,87,32,468,243,225,60,50,34,32,1
12561,1835,904,931,192,144,135,63,465,257,208,51,61,54,23,1
12562,601,313,288,42,48,25,36,273,148,125,26,41,30,11,1
12563,297,148,149,64,35,37,15,509,267,242,79,81,38,20,1
12564,325,196,129,35,17,48,33,267,129,138,45,40,23,14,1
12565,279,135,144,40,52,40,5,245,111,134,31,44,20,11,1
12566,348,187,161,50,35,44,9,577,241,336,112,109,47,21,1
12567,261,108,153,35,37,16,6,232,101,131,44,34,19,8,1
12568,291,155,136,34,33,29,15,2725,1490,1235,339,333,254,78,1
12569,1358,659,699,129,178,134,63,1709,942,767,179,148,157,60,1
12570,1170,510,660,142,182,115,84,2944,1827,1117,338,332,122,35,1
12571,773,411,362,115,81,110,39,239,146,93,30,22,35,9,1
12572,525,281,244,69,68,65,25,925,484,441,112,86,84,31,1
12573,838,431,407,107,90,107,43,632,339,293,83,77,59,20,1
12574,298,167,131,47,33,40,8,863,418,445,127,114,70,31,1
12575,2414,1189,1225,277,178,170,169,469,221,248,49,60,55,21,1
12576,605,295,310,74,66,70,36,1675,875,800,213,219,196,72,1
12577,559,296,263,77,69,42,13,537,276,261,75,68,68,22,1
12578,831,426,405,101,102,105,32,357,153,204,84,62,39,2,1
12579,964,408,556,131,153,76,55,670,358,312,95,75,58,26,1
12580,1132,553,579,172,143,150,57,1863,721,1142,262,283,139,74,1
12581,1332,652,680,210,180,155,49,1290,629,661,191,187,167,55,1
12582,1071,549,522,133,127,130,59,848,394,454,100,90,101,41,1
12583,168,120,48,7,5,20,7,516,296,220,79,59,69,16,1
12584,340,145,195,46,38,26,23,2442,1193,1249,278,183,170,145,1
12585,450,194,256,57,75,45,22,233,121,112,24,31,30,7,1
12586,504,259,245,73,56,45,29,1454,780,674,182,120,135,67,1
12587,520,261,259,82,76,71,24,497,227,270,70,63,66,30,1
12588,788,360,428,93,106,67,72,1247,620,627,134,149,142,58,1
12589,314,108,206,45,75,34,8,457,237,220,69,44,53,26,1
12590,160,76,84,21,28,10,8,339,157,182,39,49,43,19,1
12591,422,207,215,79,38,53,23,415,209,206,60,67,39,18,1
12592,1132,553,579,172,143,150,57,1210,592,618,157,138,116,85,1
12593,336,154,182,51,48,39,22,507,242,265,53,44,31,22,1
12594,330,198,132,40,21,45,13,888,476,412,98,89,72,61,1
12595,373,164,209,51,45,44,21,397,184,213,64,39,40,28,1
12596,243,117,126,26,37,20,9,1265,580,685,205,188,166,53,1
12597,458,269,189,56,40,29,7,239,110,129,32,32,24,10,1
12598,194,82,112,28,24,19,6,233,121,112,24,31,30,7,1
12599,781,418,363,92,90,64,41,2302,1039,1263,395,353,222,90,1
12600,989,439,550,142,121,75,29,938,484,454,137,100,104,41,1
12601,408,179,229,86,72,32,5,510,264,246,67,66,38,29,1
12602,228,72,156,42,27,8,7,208,96,112,31,32,13,9,1
12603,964,408,556,131,153,76,55,522,235,287,78,67,60,50,1
12604,1867,973,894,256,222,194,65,643,312,331,96,79,80,23,1
12605,369,181,188,41,36,54,16,153,65,88,27,14,18,9,1
12606,1541,713,828,176,147,151,250,330,143,187,63,29,52,20,1
12607,976,520,456,120,115,109,53,593,266,327,102,84,69,24,1
12608,177,84,93,32,18,22,15,502,253,249,65,43,60,32,1
12609,639,310,329,91,94,46,15,657,293,364,109,75,66,28,1
12610,355,214,141,43,29,63,13,91,50,41,12,5,10,7,1
12611,187,92,95,13,51,14,11,928,442,486,139,118,91,43,1
12612,303,175,128,43,36,34,12,1147,471,676,229,164,86,37,1
12613,349,152,197,55,47,27,13,2414,1189,1225,277,178,170,169,1
12614,380,187,193,38,51,30,18,520,224,296,69,64,31,29,1
12615,379,203,176,55,48,45,16,483,215,268,66,70,30,16,1
12616,1027,444,583,127,80,80,36,1537,772,765,222,154,114,32,1
12617,236,121,115,26,45,28,6,776,356,420,122,103,85,30,1
12618,354,128,226,63,61,27,7,5038,2652,2386,655,729,544,245,1
12619,806,436,370,101,100,76,34,155,74,81,23,19,20,5,1
12620,845,402,443,137,126,105,47,609,292,317,102,96,64,21,1
12621,1756,697,1059,328,345,110,27,480,234,246,79,77,65,23,1
12622,428,248,180,44,39,28,9,621,301,320,76,64,46,34,1
12623,847,402,445,137,119,102,41,211,114,97,32,24,19,10,1
12624,727,259,468,163,157,68,15,221,75,146,68,21,16,5,1
12625,255,113,142,31,40,18,9,941,448,493,150,118,127,39,1
12626,1464,693,771,153,136,91,86,292,153,139,39,33,24,21,1
12627,842,366,476,148,119,79,46,213,107,106,28,41,19,5,1
12628,907,455,452,132,117,80,40,217,98,119,33,32,27,7,1
12629,352,212,140,37,17,61,20,418,204,214,68,66,38,12,1
12630,309,154,155,42,44,45,16,205,94,111,48,31,15,6,1
12631,828,463,365,94,86,65,21,785,374,411,56,42,38,25,1
12632,359,174,185,54,56,43,16,427,230,197,48,28,60,37,1
12633,361,155,206,43,61,29,18,404,190,214,55,55,35,27,1
12634,351,184,167,59,45,54,9,52,30,22,6,2,3,6,1
12635,391,208,183,65,49,57,17,729,325,404,129,88,64,32,1
12636,336,154,182,51,48,39,22,604,282,322,76,74,69,35,1
12637,961,463,498,139,156,62,34,301,119,182,53,47,14,20,1
12638,858,431,427,94,57,54,30,248,128,120,65,21,27,10,1
12639,1634,828,806,236,195,195,67,217,109,108,34,32,35,7,1
12640,1173,508,665,213,192,121,34,1331,657,674,159,137,182,58,1
12641,326,153,173,63,48,25,8,351,184,167,59,45,54,9,1
12642,247,110,137,34,45,23,10,646,304,342,104,93,58,26,1
12643,350,224,126,34,14,48,18,1257,662,595,176,142,106,42,1
12644,1461,883,578,209,197,49,48,957,436,521,138,126,101,41,1
12645,646,316,330,89,95,48,17,89,42,47,16,12,15,6,1
12646,1170,510,660,142,182,115,84,1464,987,477,137,141,55,31,1
12647,656,358,298,67,47,64,26,356,185,171,37,31,17,21,1
12648,386,189,197,54,57,39,16,220,106,114,32,26,15,7,1
12649,1273,592,681,199,164,139,39,728,358,370,118,100,55,29,1
12650,336,154,182,51,48,39,22,452,224,228,69,56,50,31,1
12651,1164,531,633,179,157,107,46,433,237,196,60,52,33,27,1
12652,279,106,173,48,35,41,39,33423,16370,17053,4965,4756,2786,883,1
12653,147,72,75,26,26,11,8,377,202,175,46,50,41,23,1
12654,986,465,521,152,132,138,51,1499,975,524,152,145,54,41,1
12655,451,267,184,43,39,50,7,595,316,279,86,60,65,40,1
12656,101,45,56,17,17,12,9,284,104,180,54,81,8,10,1
12657,563,271,292,72,91,34,27,192,104,88,24,14,24,14,1
12658,983,487,496,126,115,104,52,748,341,407,121,87,96,52,1
12659,757,373,384,115,93,95,25,128,54,74,30,13,8,7,1
12660,906,485,421,112,98,112,39,654,317,337,95,111,44,13,1
12661,304,135,169,48,36,38,26,267,147,120,37,28,35,12,1
12662,894,420,474,136,146,93,39,723,364,359,107,106,52,14,1
12663,326,154,172,45,39,20,10,331,169,162,40,28,22,14,1
12664,451,267,184,43,39,50,7,530,259,271,83,50,54,41,1
12665,1280,712,568,167,131,135,39,178,100,78,23,22,30,6,1
12666,627,289,338,101,73,62,43,125,61,64,16,7,9,6,1
12667,626,333,293,64,55,61,15,177,108,69,15,13,17,11,1
12668,411,224,187,50,43,54,19,1073,547,526,60,60,47,19,1
12669,219,116,103,66,7,2,1,191,72,119,40,41,17,8,1
12670,163,71,92,33,26,5,7,2442,1193,1249,278,183,170,145,1
12671,150,74,76,21,22,18,7,168,70,98,19,30,8,12,1
12672,418,199,219,55,44,22,15,526,264,262,77,71,61,27,1
12673,150,79,71,19,29,19,6,172,98,74,20,21,22,8,1
12674,672,334,338,110,93,91,41,374,191,183,70,48,61,13,1
12675,250,137,113,33,19,24,9,184,87,97,19,21,12,17,1
12676,2430,1065,1365,330,328,190,84,202,102,100,29,35,6,9,1
12677,815,418,397,97,62,70,17,360,208,152,47,38,31,20,1
12678,538,293,245,48,66,45,16,336,169,167,38,30,44,16,1
12679,211,114,97,32,24,19,10,596,286,310,90,89,78,37,1
12680,666,344,322,91,73,91,20,451,222,229,58,55,51,17,1
12681,354,181,173,52,18,50,15,219,124,95,22,22,23,5,1
12682,382,183,199,55,60,38,22,858,461,397,125,114,79,45,1
12683,549,303,246,64,54,59,35,1462,652,810,243,199,115,30,1
12684,369,200,169,42,46,39,16,192,92,100,36,20,14,6,1
12685,904,436,468,138,146,82,39,263,137,126,57,25,27,9,1
12686,864,362,502,142,150,70,19,447,232,215,55,65,50,25,1
12687,1432,652,780,217,205,131,81,393,186,207,58,50,36,22,1
12688,526,264,262,77,71,61,27,845,402,443,137,126,105,47,1
12689,422,213,209,63,60,35,13,327,177,150,40,40,38,18,1
12690,1124,456,668,167,148,60,42,437,190,247,82,66,39,20,1
12691,134,56,78,17,30,7,7,445,225,220,47,62,53,26,1
12692,1477,738,739,176,176,145,72,419,208,211,68,60,35,22,1
12693,1159,471,688,183,156,123,58,339,183,156,43,45,28,17,1
12694,535,217,318,87,106,41,14,210,102,108,33,33,20,9,1
12695,391,189,202,73,47,37,8,349,183,166,56,55,38,5,1
12696,839,439,400,101,86,102,43,427,204,223,38,57,26,32,1
12697,920,492,428,100,92,88,49,361,184,177,50,53,51,22,1
12698,672,334,338,110,93,91,41,1210,592,618,157,138,116,85,1
12699,815,382,433,97,50,88,31,436,201,235,54,37,34,20,1
12700,748,355,393,121,91,95,26,262,151,111,30,17,32,25,1
12701,2033,877,1156,359,333,106,44,169,85,84,21,14,9,9,1
12702,392,180,212,78,49,43,18,757,373,384,115,93,95,25,1
12703,1014,490,524,177,137,94,38,1009,487,522,177,121,103,51,1
12704,1333,646,687,209,179,148,45,1255,666,589,145,142,120,82,1
12705,231,126,105,37,26,29,6,769,329,440,116,66,55,22,1
12706,392,199,193,63,35,49,21,454,224,230,71,39,62,22,1
12707,524,237,287,87,75,54,26,246,108,138,32,44,21,10,1
12708,113,55,58,20,8,8,3,878,365,513,128,125,56,28,1
12709,1112,457,655,180,164,98,41,101,41,60,18,19,10,5,1
12710,238,151,87,21,16,24,24,1091,543,548,146,136,110,34,1
12711,767,392,375,113,112,83,13,980,537,443,125,99,98,50,1
12712,393,186,207,58,50,36,22,586,270,316,83,80,59,21,1
12713,426,200,226,75,56,39,24,509,254,255,67,55,52,35,1
12714,583,322,261,73,66,45,26,750,371,379,95,98,86,29,1
12715,412,216,196,24,48,18,16,577,241,336,112,109,47,21,1
12716,538,252,286,77,87,53,30,770,355,415,103,142,75,42,1
12717,802,449,353,102,87,82,29,986,499,487,123,116,98,54,1
12718,1907,1008,899,235,224,195,73,745,391,354,85,81,52,39,1
12719,537,276,261,75,68,68,22,476,227,249,52,59,38,17,1
12720,616,304,312,75,71,55,25,261,130,131,27,41,19,16,1
12721,432,181,251,48,75,27,17,512,261,251,79,73,60,21,1
12722,361,155,206,43,61,29,18,422,222,200,58,39,62,21,1
12723,171,89,82,29,17,24,11,105,53,52,23,11,12,6,1
12724,655,281,374,108,103,61,24,247,110,137,34,45,23,10,1
12725,787,394,393,113,98,52,19,824,365,459,121,123,88,50,1
12726,586,270,316,83,80,59,21,1456,695,761,184,168,221,76,1
12727,577,251,326,92,84,60,11,616,304,312,75,71,55,25,1
12728,991,483,508,166,120,94,42,1001,498,503,156,114,106,56,1
12729,695,373,322,80,59,89,39,685,315,370,108,99,36,9,1
12730,512,261,251,79,73,60,21,271,131,140,55,17,30,16,1
12731,709,294,415,132,123,76,23,103,49,54,21,21,10,2,1
12732,855,420,435,139,134,109,35,467,224,243,70,43,67,23,1
12733,473,300,173,50,21,106,24,989,508,481,139,117,114,41,1
12734,326,153,173,63,48,25,8,834,483,351,102,83,103,22,1
12735,1152,586,566,131,112,117,42,161,75,86,21,11,17,7,1
12736,510,264,246,67,66,38,29,200,106,94,24,26,18,6,1
12737,483,283,200,56,51,45,18,211,114,97,32,24,19,10,1
12738,178,100,78,23,22,30,6,1074,538,536,190,131,157,35,1
12739,821,387,434,121,131,76,29,577,251,326,92,84,60,11,1
12740,419,175,244,71,73,23,23,618,290,328,82,74,69,42,1
12741,252,121,131,42,34,12,16,712,331,381,111,86,86,34,1
12742,344,168,176,65,44,33,15,2468,1038,1430,333,465,167,62,1
12743,176,84,92,46,10,28,11,1086,603,483,147,121,95,40,1
12744,273,154,119,33,25,21,12,639,287,352,111,108,44,9,1
12745,655,269,386,128,129,49,21,211,114,97,32,24,19,10,1
12746,389,195,194,68,60,30,17,223,103,120,36,30,15,9,1
12747,347,198,149,45,29,29,8,772,363,409,76,120,57,20,1
12748,1356,576,780,229,198,107,38,191,99,92,25,24,18,8,1
12749,455,229,226,66,62,63,29,684,342,342,81,85,82,38,1
12750,219,110,109,32,23,24,7,338,156,182,58,39,39,15,1
12751,808,366,442,130,133,66,31,719,364,355,104,100,58,34,1
12752,427,210,217,64,66,45,24,815,382,433,97,50,88,31,1
12753,395,186,209,53,48,46,30,467,260,207,74,52,57,24,1
12754,581,254,327,100,83,54,20,376,176,200,31,53,27,8,1
12755,305,155,150,63,37,30,8,33423,16370,17053,4965,4756,2786,883,1
12756,1320,566,754,235,198,122,36,481,256,225,60,56,48,12,1
12757,536,278,258,72,63,62,20,912,461,451,127,109,96,48,1
12758,440,218,222,58,66,40,24,117,60,57,20,17,16,5,1
12759,299,164,135,30,21,29,10,138,67,71,21,20,15,9,1
12760,508,267,241,57,49,40,13,822,392,430,125,104,79,24,1
12761,474,258,216,63,48,51,24,512,261,251,79,73,60,21,1
12762,656,358,298,67,47,64,26,107,36,71,27,15,0,1,1
12763,593,266,327,102,84,69,24,391,223,168,35,26,47,31,1
12764,692,305,387,100,97,78,30,1863,721,1142,262,283,139,74,1
12765,672,334,338,110,93,91,41,864,429,435,129,118,68,35,1
12766,368,158,210,64,61,39,14,327,177,150,40,40,38,18,1
12767,201,42,159,19,3,2,75,620,334,286,82,55,71,25,1
12768,318,176,142,25,32,35,25,454,260,194,68,47,76,19,1
12769,845,402,443,137,126,105,47,448,236,212,53,64,56,24,1
12770,961,485,476,147,130,83,37,751,416,335,104,75,130,20,1
12771,396,150,246,103,64,38,3,465,225,240,65,44,65,25,1
12772,509,254,255,67,55,52,35,183,95,88,27,22,26,5,1
12773,1190,638,552,162,95,112,18,800,387,413,122,77,90,34,1
12774,368,175,193,72,43,39,15,636,320,316,79,61,67,31,1
12775,466,186,280,71,84,30,11,694,260,434,122,92,62,36,1
12776,117,60,57,20,17,16,5,723,309,414,106,106,41,40,1
12777,420,205,215,60,44,52,21,296,154,142,38,38,24,16,1
12778,133,66,67,21,24,9,2,548,273,275,84,81,64,30,1
12779,589,294,295,37,44,27,33,616,366,250,65,57,23,35,1
12780,684,300,384,101,106,67,20,1113,401,712,196,186,53,44,1
12781,610,281,329,54,62,65,58,894,420,474,136,146,93,39,1
12782,835,499,336,94,89,96,22,1801,889,912,206,263,126,42,1
12783,651,306,345,85,64,61,32,1040,460,580,156,117,116,43,1
12784,501,240,261,80,62,49,42,277,122,155,33,33,25,24,1
12785,794,434,360,122,87,61,23,1210,578,632,172,184,94,66,1
12786,790,379,411,99,116,81,23,790,384,406,93,120,79,16,1
12787,435,254,181,52,46,48,14,382,200,182,53,36,51,16,1
12788,3056,1457,1599,438,389,329,168,732,355,377,108,109,79,27,1
12789,2440,1061,1379,377,326,172,62,486,217,269,110,62,23,10,1
12790,546,267,279,90,69,56,19,920,492,428,100,92,88,49,1
12791,1581,684,897,220,153,118,63,461,223,238,66,57,36,23,1
12792,870,433,437,133,121,95,25,1308,652,656,166,153,149,87,1
12793,2477,1186,1291,256,271,249,90,732,373,359,97,96,90,29,1
12794,122,52,70,24,22,7,6,227,109,118,42,35,29,8,1
12795,719,301,418,122,132,42,26,560,228,332,113,58,79,38,1
12796,369,216,153,36,22,46,23,1254,631,623,152,160,66,44,1
12797,584,272,312,76,72,66,42,559,250,309,79,83,62,36,1
12798,817,425,392,120,102,83,26,1484,731,753,206,175,187,71,1
12799,365,188,177,60,47,48,16,1608,778,830,243,230,159,74,1
12800,278,131,147,29,30,33,12,164,88,76,27,20,17,6,1
12801,425,210,215,56,43,52,25,217,102,115,28,29,29,12,1
12802,319,153,166,61,52,26,12,399,194,205,49,102,52,8,1
12803,1278,593,685,198,201,71,43,352,179,173,54,46,35,22,1
12804,740,313,427,101,135,40,22,393,186,207,58,50,36,22,1
12805,217,105,112,34,32,25,13,189,90,99,26,29,17,11,1
12806,482,231,251,76,81,64,26,272,149,123,34,35,21,2,1
12807,330,143,187,63,29,52,20,555,288,267,75,70,61,20,1
12808,666,347,319,92,73,63,25,1234,590,644,180,182,95,40,1
12809,619,293,326,98,78,65,22,1374,679,695,191,193,154,48,1
12810,223,93,130,38,27,39,10,162,86,76,26,19,23,8,1
12811,482,232,250,77,81,44,13,969,505,464,123,133,92,33,1
12812,593,266,327,102,84,69,24,796,445,351,96,80,90,38,1
12813,505,275,230,63,57,35,12,217,109,108,34,32,35,7,1
12814,433,226,207,52,60,58,20,595,316,279,86,60,65,40,1
12815,325,159,166,42,43,48,15,1599,806,793,213,237,100,45,1
12816,672,334,338,110,93,91,41,207,128,79,26,17,19,9,1
12817,1098,519,579,182,159,79,42,1290,597,693,182,182,119,63,1
12818,551,298,253,63,65,45,19,334,171,163,48,42,32,18,1
12819,423,218,205,64,55,54,15,405,189,216,53,60,39,14,1
12820,419,207,212,63,65,64,20,426,228,198,62,42,47,22,1
12821,483,236,247,82,60,43,18,430,198,232,57,46,37,19,1
12822,502,240,262,78,61,54,32,216,119,97,33,27,28,7,1
12823,172,74,98,32,30,11,7,125,58,67,20,16,10,5,1
12824,150,81,69,24,23,16,4,148,89,59,14,15,15,14,1
12825,854,380,474,137,159,81,31,729,358,371,116,99,89,33,1
12826,165,76,89,26,24,18,15,249,111,138,40,30,22,17,1
12827,467,261,206,54,49,48,24,592,291,301,92,93,71,31,1
12828,159,84,75,13,28,10,8,261,130,131,27,41,19,16,1
12829,592,291,301,92,93,71,31,1242,613,629,174,113,114,53,1
12830,391,208,183,65,49,57,17,271,110,161,33,27,11,8,1
12831,476,263,213,56,44,50,16,1049,585,464,107,108,120,28,1
12832,339,109,230,77,35,36,21,201,42,159,19,3,2,75,1
12833,723,335,388,90,84,77,74,357,147,210,48,37,21,47,1
12834,334,172,162,43,39,41,17,552,285,267,74,51,69,24,1
12835,187,96,91,30,24,24,4,393,210,183,55,50,34,19,1
12836,858,406,452,135,78,69,36,1342,673,669,178,154,137,94,1
12837,335,185,150,46,34,36,13,90,46,44,14,15,8,3,1
12838,154,75,79,17,24,16,13,525,245,280,59,72,47,21,1
12839,398,196,202,61,45,34,18,164,78,86,28,23,12,8,1
12840,1210,592,618,157,138,116,85,689,343,346,119,100,86,38,1
12841,1001,422,579,185,180,51,32,1061,440,621,189,149,153,72,1
12842,427,218,209,61,53,45,26,529,264,265,59,68,41,17,1
12843,554,254,300,104,58,66,28,202,102,100,29,35,6,9,1
12844,321,180,141,47,37,33,12,461,197,264,86,97,43,10,1
12845,2639,1436,1203,317,307,242,77,443,240,203,66,31,57,27,1
12846,424,198,226,57,46,41,19,316,201,115,29,31,12,6,1
12847,700,265,435,134,106,16,3,576,250,326,93,71,34,15,1
12848,1040,562,478,125,101,103,32,207,93,114,20,33,19,10,1
12849,398,217,181,38,44,49,14,135,73,62,17,14,7,6,1
12850,259,118,141,21,29,15,23,723,309,414,106,106,41,40,1
12851,975,498,477,144,99,119,58,4061,1099,2962,910,478,510,7,1
12852,962,430,532,109,142,61,34,277,124,153,44,40,35,18,1
12853,737,363,374,119,101,85,41,648,307,341,101,58,76,34,1
12854,1154,540,614,195,160,138,66,825,427,398,79,95,81,48,1
12855,685,319,366,80,66,70,71,2556,1169,1387,248,291,227,275,1
12856,282,135,147,36,49,25,10,676,333,343,111,89,94,39,1
12857,684,288,396,107,90,54,42,353,200,153,38,28,31,9,1
12858,297,148,149,64,35,37,15,215,115,100,27,28,34,16,1
12859,671,318,353,83,124,46,34,478,216,262,110,67,27,4,1
12860,216,113,103,28,24,22,17,1132,646,486,99,102,71,41,1
12861,480,232,248,83,64,51,25,522,245,277,78,69,52,21,1
12862,334,178,156,41,29,37,22,244,131,113,34,26,35,16,1
12863,507,242,265,53,44,31,22,101,41,60,18,19,10,5,1
12864,1132,646,486,99,102,71,41,2414,1189,1225,277,178,170,169,1
12865,976,522,454,123,108,100,54,748,355,393,121,91,95,26,1
12866,670,333,337,95,79,62,21,211,114,97,32,24,19,10,1
12867,694,360,334,90,88,77,32,622,331,291,69,74,45,21,1
12868,1192,545,647,161,116,105,34,896,430,466,120,117,85,35,1
12869,409,200,209,69,56,44,13,1214,612,602,169,173,98,35,1
12870,1356,672,684,171,172,134,59,781,418,363,92,90,64,41,1
12871,435,203,232,57,67,40,12,770,356,414,123,102,66,25,1
12872,686,375,311,89,80,63,20,1354,537,817,245,247,117,57,1
12873,749,361,388,107,115,73,27,418,248,170,41,31,54,9,1
12874,626,333,293,64,55,61,15,622,299,323,86,86,69,35,1
12875,350,183,167,47,30,30,21,270,137,133,30,28,27,11,1
12876,609,292,317,102,96,64,21,180,96,84,21,22,17,15,1
12877,299,153,146,32,28,29,12,1834,823,1011,297,282,151,63,1
12878,595,316,279,86,60,65,40,193,107,86,13,20,13,6,1
12879,770,390,380,104,76,78,32,297,158,139,47,37,37,9,1
12880,926,435,491,133,132,85,17,537,315,222,55,46,69,39,1
12881,505,254,251,80,77,60,15,808,484,324,80,63,76,24,1
12882,1190,638,552,162,95,112,18,930,411,519,138,137,86,24,1
12883,264,121,143,57,32,22,15,482,167,315,118,88,50,13,1
12884,998,532,466,113,109,97,53,610,328,282,78,65,57,33,1
12885,1046,562,484,139,116,124,51,758,362,396,115,102,35,13,1
12886,670,333,337,95,79,62,21,259,143,116,39,37,23,9,1
12887,467,226,241,55,48,54,23,785,374,411,56,42,38,25,1
12888,624,204,420,166,101,32,13,390,208,182,47,53,32,12,1
12889,326,161,165,55,43,21,12,538,252,286,77,87,53,30,1
12890,1247,613,634,172,176,136,47,427,215,212,69,35,51,21,1
12891,366,190,176,39,62,55,14,349,131,218,66,76,22,9,1
12892,576,250,326,93,71,34,15,394,199,195,61,52,55,26,1
12893,505,268,237,68,59,34,15,140,76,64,17,13,13,8,1
12894,391,208,183,65,49,57,17,238,110,128,25,49,26,8,1
12895,186,91,95,30,22,18,7,188,119,69,24,15,26,12,1
12896,356,199,157,43,58,29,12,462,233,229,66,49,43,30,1
12897,476,233,243,76,61,52,21,776,356,420,122,103,85,30,1
12898,2644,1346,1298,391,304,315,148,1338,633,705,199,151,144,65,1
12899,815,418,397,97,62,70,17,423,219,204,57,43,50,17,1
12900,225,106,119,32,33,24,10,530,259,271,83,50,54,41,1
12901,535,217,318,87,106,41,14,467,221,246,98,68,43,11,1
12902,434,205,229,51,55,24,13,2491,1175,1316,303,302,273,147,1
12903,1102,511,591,171,179,148,52,815,418,397,97,62,70,17,1
12904,149,68,81,15,38,11,10,1575,744,831,228,240,141,42,1
12905,785,374,411,56,42,38,25,462,233,229,66,49,43,30,1
12906,656,358,298,67,47,64,26,501,273,228,70,59,30,10,1
12907,660,359,301,81,87,102,31,109,50,59,20,7,10,9,1
12908,552,285,267,74,51,69,24,103,63,40,9,9,14,3,1
12909,605,283,322,94,72,64,39,551,298,253,63,65,45,19,1
12910,1464,693,771,153,136,91,86,328,173,155,39,16,45,6,1
12911,336,154,182,51,48,39,22,758,362,396,115,102,35,13,1
12912,462,251,211,74,53,41,18,89,47,42,11,5,6,9,1
12913,765,351,414,118,102,65,32,331,169,162,40,28,22,14,1
12914,54,26,28,11,4,3,3,673,317,356,101,85,76,49,1
12915,1272,520,752,235,242,117,54,2803,1300,1503,392,510,170,57,1
12916,231,126,105,37,26,29,6,873,366,507,127,125,75,21,1
12917,491,283,208,55,61,40,13,556,356,200,53,38,68,26,1
12918,2442,1193,1249,278,183,170,145,745,366,379,110,93,79,45,1
12919,183,76,107,34,38,14,8,835,420,415,104,105,57,47,1
12920,1310,710,600,92,165,113,31,1798,844,954,277,212,142,53,1
12921,1284,511,773,227,166,169,107,1014,490,524,177,137,94,38,1
12922,541,279,262,79,82,31,32,199,101,98,22,25,9,12,1
12923,158,74,84,38,12,18,7,947,482,465,143,107,89,37,1
12924,493,238,255,89,67,53,23,906,455,451,116,105,87,46,1
12925,592,264,328,86,85,62,41,742,303,439,88,96,86,23,1
12926,309,161,148,38,34,40,15,164,88,76,27,20,17,6,1
12927,1290,597,693,182,182,119,63,72,35,37,10,9,7,6,1
12928,431,216,215,46,40,33,9,119,67,52,15,15,7,7,1
12929,611,246,365,116,82,71,27,444,189,255,72,82,45,17,1
12930,724,334,390,112,109,79,17,1242,613,629,174,113,114,53,1
12931,963,455,508,126,110,68,29,723,380,343,80,84,47,18,1
12932,355,165,190,53,56,42,19,450,275,175,57,32,48,15,1
12933,769,362,407,99,88,66,67,547,292,255,51,55,46,28,1
12934,525,274,251,82,74,60,25,360,192,168,55,45,48,16,1
12935,221,110,111,28,32,25,11,1692,713,979,325,210,122,58,1
12936,261,114,147,23,20,8,6,385,181,204,48,41,52,36,1
12937,930,477,453,111,92,92,29,170,83,87,23,32,17,9,1
12938,2490,1126,1364,352,325,219,89,333,167,166,45,30,34,14,1
12939,683,365,318,89,69,56,25,1712,1175,537,179,142,113,46,1
12940,251,144,107,33,23,23,8,167,77,90,22,25,11,11,1
12941,575,293,282,78,64,40,13,450,232,218,60,52,33,27,1
12942,480,244,236,74,47,50,21,646,316,330,89,95,48,17,1
12943,601,313,288,42,48,25,36,106,46,60,27,18,12,3,1
12944,280,156,124,36,19,20,13,134,60,74,19,13,10,7,1
12945,1132,624,508,199,79,127,41,710,307,403,117,176,37,9,1
12946,1333,646,687,209,179,148,45,526,264,262,77,71,61,27,1
12947,240,167,73,32,12,8,21,757,359,398,109,127,80,26,1
12948,381,206,175,42,53,36,20,253,155,98,27,20,22,14,1
12949,623,320,303,103,85,75,15,785,419,366,96,94,89,33,1
12950,1216,552,664,194,189,110,49,358,170,188,54,55,20,10,1
12951,784,391,393,105,113,86,21,866,382,484,116,114,91,28,1
12952,1480,789,691,195,151,173,55,701,411,290,72,64,98,31,1
12953,427,191,236,67,60,41,34,331,169,162,40,28,22,14,1
12954,238,91,147,68,19,22,7,619,290,329,97,79,62,19,1
12955,912,460,452,139,132,89,53,751,312,439,131,115,78,48,1
12956,229,120,109,31,30,22,9,410,186,224,72,57,52,22,1
12957,834,405,429,112,95,84,34,377,184,193,56,53,44,14,1
12958,247,110,137,34,45,23,10,655,328,327,65,54,55,35,1
12959,350,181,169,44,52,43,13,240,167,73,32,12,8,21,1
12960,358,170,188,54,55,20,10,1545,828,717,186,149,176,58,1
12961,405,189,216,53,60,39,14,183,91,92,21,29,16,10,1
12962,381,191,190,55,61,33,11,365,186,179,48,47,42,13,1
12963,593,311,282,78,68,59,40,568,292,276,69,74,59,34,1
12964,1119,621,498,145,144,85,47,339,170,169,32,17,24,13,1
12965,478,230,248,69,66,35,23,256,127,129,31,34,27,18,1
12966,217,105,112,34,32,25,13,803,345,458,109,110,68,40,1
12967,1042,530,512,162,150,103,52,456,220,236,67,75,30,21,1
12968,837,381,456,123,109,65,25,347,181,166,27,20,12,12,1
12969,427,186,241,55,52,42,23,1170,510,660,142,182,115,84,1
12970,380,184,196,58,52,46,8,838,431,407,107,90,107,43,1
12971,446,252,194,41,23,54,35,2639,1436,1203,317,307,242,77,1
12972,532,269,263,72,59,59,39,513,260,253,71,50,58,23,1
12973,1581,684,897,220,153,118,63,505,247,258,72,71,60,27,1
12974,556,269,287,86,66,62,22,552,285,267,74,51,69,24,1
12975,879,439,440,120,108,101,30,228,139,89,24,21,32,18,1
12976,2492,894,1598,466,444,164,102,834,335,499,129,110,84,33,1
12977,237,112,125,19,57,25,10,407,209,198,55,59,38,19,1
12978,895,436,459,124,113,87,44,216,113,103,26,21,19,9,1
12979,1290,597,693,182,182,119,63,306,155,151,43,34,36,17,1
12980,344,168,176,65,44,33,15,468,243,225,60,50,34,32,1
12981,2414,1189,1225,277,178,170,169,654,344,310,80,69,57,15,1
12982,221,131,90,32,19,15,7,513,274,239,67,66,62,35,1
12983,579,293,286,68,72,31,47,677,310,367,103,93,70,26,1
12984,729,325,404,129,88,64,32,155,85,70,17,16,4,8,1
12985,486,192,294,91,79,32,19,339,157,182,39,49,43,19,1
12986,327,149,178,47,49,38,11,1506,722,784,216,177,116,54,1
12987,1756,697,1059,328,345,110,27,2033,877,1156,359,333,106,44,1
12988,247,110,137,34,45,23,10,508,248,260,71,56,50,19,1
12989,373,213,160,44,33,27,17,504,259,245,73,56,45,29,1
12990,200,90,110,22,29,10,13,551,298,253,63,65,45,19,1
12991,470,205,265,71,80,33,11,6669,2978,3691,1310,930,829,237,1
12992,531,226,305,81,83,56,33,853,400,453,137,109,88,42,1
12993,247,135,112,38,18,29,13,212,88,124,46,24,22,16,1
12994,728,385,343,110,102,69,14,361,174,187,63,56,38,16,1
12995,2321,1177,1144,236,255,174,254,500,244,256,66,57,52,27,1
12996,413,194,219,77,72,28,11,324,154,170,57,40,26,4,1
12997,328,184,144,47,24,23,9,262,151,111,30,17,32,25,1
12998,598,323,275,68,53,60,17,338,179,159,44,45,42,16,1
12999,826,423,403,129,93,82,42,757,359,398,109,127,80,26,1
13000,381,188,193,59,60,35,12,425,210,215,56,43,52,25,1
13001,474,255,219,61,47,63,23,427,164,263,62,80,14,10,1
13002,1566,743,823,261,188,151,48,318,176,142,25,32,35,25,1
13003,411,202,209,60,67,57,24,928,442,486,139,118,91,43,1
13004,595,316,279,86,60,65,40,151,82,69,16,17,11,7,1
13005,317,156,161,49,51,18,10,770,355,415,103,142,75,42,1
13006,158,72,86,27,14,15,11,113,66,47,11,9,6,5,1
13007,589,314,275,70,83,44,28,575,305,270,74,87,73,25,1
13008,931,464,467,109,126,119,42,923,471,452,119,117,119,41,1
13009,745,432,313,104,75,79,26,659,361,298,106,66,86,29,1
13010,745,351,394,88,95,68,56,465,225,240,65,44,65,25,1
13011,406,202,204,54,54,41,16,780,369,411,130,113,79,35,1
13012,267,127,140,43,43,25,15,815,478,337,104,80,103,27,1
13013,325,181,144,46,31,48,9,125,52,73,23,23,6,4,1
13014,510,260,250,53,55,59,16,1663,835,828,224,213,163,63,1
13015,824,392,432,106,89,88,32,185,83,102,30,19,21,8,1
13016,667,360,307,76,92,46,27,797,395,402,107,117,77,22,1
13017,933,493,440,140,108,124,32,335,185,150,46,34,36,13,1
13018,637,335,302,83,77,85,26,304,127,177,61,38,31,4,1
13019,1647,794,853,279,235,128,65,781,418,363,92,90,64,41,1
13020,365,180,185,63,35,48,19,522,283,239,65,64,76,22,1
13021,364,172,192,55,57,32,15,160,53,107,31,29,13,3,1
13022,815,418,397,97,62,70,17,1208,565,643,182,162,120,57,1
13023,427,218,209,61,53,45,26,360,192,168,55,45,48,16,1
13024,91,50,41,8,14,4,5,294,148,146,35,33,25,14,1
13025,193,95,98,33,17,25,17,892,420,472,135,146,98,37,1
13026,904,318,586,264,81,35,10,2752,959,1793,638,192,79,46,1
13027,624,308,316,92,72,68,22,825,427,398,79,95,81,48,1
13028,568,193,375,112,83,50,15,769,329,440,116,66,55,22,1
13029,167,86,81,21,21,11,11,454,191,263,61,66,38,15,1
13030,1830,904,926,276,245,222,100,164,88,76,27,20,17,6,1
13031,822,402,420,125,107,82,26,770,374,396,95,91,79,41,1
13032,509,341,168,35,32,52,15,418,220,198,69,51,44,16,1
13033,273,148,125,38,31,16,19,632,326,306,92,71,56,19,1
13034,476,270,206,62,45,46,30,1180,598,582,184,63,87,66,1
13035,821,387,434,121,131,76,29,269,134,135,42,35,27,13,1
13036,628,341,287,77,59,55,31,770,374,396,95,91,79,41,1
13037,334,172,162,43,39,41,17,446,265,181,51,35,27,17,1
13038,384,238,146,38,26,66,19,98,53,45,14,6,7,6,1
13039,770,356,414,123,102,66,25,590,279,311,103,83,69,30,1
13040,351,184,167,59,45,54,9,263,181,82,19,11,39,8,1
13041,341,178,163,48,44,42,20,903,457,446,99,127,62,29,1
13042,95,44,51,14,13,7,4,646,316,330,89,95,48,17,1
13043,360,192,168,55,45,48,16,508,215,293,72,71,42,15,1
13044,911,493,418,89,140,83,34,476,259,217,64,64,81,15,1
13045,1121,650,471,143,110,132,55,706,326,380,102,79,89,47,1
13046,219,124,95,22,22,23,5,622,328,294,75,42,67,31,1
13047,588,266,322,99,79,87,28,450,231,219,77,50,76,16,1
13048,1647,794,853,279,235,128,65,848,394,454,100,90,101,41,1
13049,299,148,151,49,35,41,15,286,132,154,42,42,36,7,1
13050,433,221,212,59,42,47,14,755,349,406,131,80,68,28,1
13051,747,333,414,102,64,63,46,466,186,280,71,84,30,11,1
13052,2030,1006,1024,306,249,263,107,467,269,198,46,51,60,18,1
13053,780,369,411,130,113,79,35,757,373,384,115,93,95,25,1
13054,416,210,206,55,54,39,20,700,348,352,93,115,85,27,1
13055,290,130,160,47,43,32,11,1498,615,883,226,244,60,46,1
13056,494,234,260,88,81,61,29,391,204,187,47,48,38,18,1
13057,246,115,131,15,29,10,32,255,109,146,35,32,23,17,1
13058,1127,528,599,147,128,83,58,1050,473,577,142,119,87,54,1
13059,411,207,204,60,57,35,21,146,74,72,26,25,23,4,1
13060,465,206,259,59,46,40,38,211,101,110,40,27,17,12,1
13061,1153,535,618,204,158,93,50,220,113,107,31,21,25,12,1
13062,902,332,570,154,146,75,40,261,130,131,27,41,19,16,1
13063,1304,585,719,179,169,154,47,135,73,62,15,16,15,8,1
13064,750,371,379,95,98,86,29,151,82,69,16,17,11,7,1
13065,1455,760,695,205,191,124,40,2113,1079,1034,268,209,196,65,1
13066,1095,530,565,157,151,98,34,304,159,145,38,40,32,3,1
13067,1098,519,579,182,159,79,42,3144,1617,1527,367,342,278,136,1
13068,307,150,157,44,23,30,13,553,261,292,73,79,40,26,1
13069,240,125,115,34,32,30,8,120,67,53,13,15,9,6,1
13070,900,484,416,119,110,77,29,615,339,276,82,76,63,16,1
13071,437,225,212,61,57,66,12,656,336,320,86,90,73,37,1
13072,896,485,411,112,91,86,28,247,110,137,34,45,23,10,1
13073,859,398,461,96,109,89,57,894,420,474,136,146,93,39,1
13074,335,183,152,36,27,45,11,296,147,149,45,29,30,23,1
13075,595,339,256,64,36,54,24,208,104,104,39,20,26,15,1
13076,863,458,405,97,82,63,57,1292,592,700,186,169,108,22,1
13077,351,184,167,59,45,54,9,817,397,420,120,152,48,17,1
13078,1048,564,484,118,122,113,40,314,108,206,45,75,34,8,1
13079,766,395,371,89,86,127,27,363,193,170,52,51,41,14,1
13080,357,223,134,36,20,65,12,655,328,327,65,54,55,35,1
13081,2556,1169,1387,248,291,227,275,357,147,210,48,37,21,47,1
13082,318,176,142,25,32,35,25,788,381,407,77,41,46,35,1
13083,200,91,109,29,34,24,7,265,103,162,61,58,25,3,1
13084,391,208,183,65,49,57,17,858,398,460,126,138,75,39,1
13085,176,92,84,28,14,26,9,295,161,134,30,40,31,9,1
13086,892,397,495,146,63,65,37,415,209,206,60,67,39,18,1
13087,154,75,79,17,24,16,13,641,318,323,69,61,41,19,1
13088,546,267,279,90,69,56,19,327,172,155,38,41,41,15,1
13089,283,141,142,32,26,23,26,205,123,82,22,8,31,5,1
13090,401,198,203,70,29,38,15,840,385,455,118,137,66,39,1
13091,562,214,348,120,86,69,42,2440,1061,1379,377,326,172,62,1
13092,168,67,101,37,17,13,13,384,183,201,66,46,77,26,1
13093,827,446,381,111,88,81,45,930,367,563,181,153,83,48,1
13094,165,77,88,28,27,19,10,336,154,182,51,48,39,22,1
13095,361,184,177,50,53,51,22,288,158,130,59,23,21,10,1
13096,1941,818,1123,351,358,141,64,747,372,375,115,97,112,38,1
13097,626,272,354,96,80,71,36,2803,1300,1503,392,510,170,57,1
13098,158,85,73,24,18,18,8,765,295,470,200,142,84,27,1
13099,785,374,411,56,42,38,25,552,285,267,74,51,69,24,1
13100,1432,652,780,217,205,131,81,609,292,317,102,96,64,21,1
13101,415,209,206,60,67,39,18,347,183,164,55,45,51,16,1
13102,355,209,146,41,25,73,14,354,169,185,54,54,41,19,1
13103,111,51,60,20,21,10,11,470,226,244,81,53,59,39,1
13104,1861,896,965,265,187,156,70,2472,1055,1417,416,458,235,64,1
13105,412,195,217,79,48,36,29,1356,672,684,171,172,134,59,1
13106,377,171,206,59,58,41,22,277,124,153,44,40,35,18,1
13107,2109,999,1110,332,294,187,89,128,65,63,18,13,7,6,1
13108,729,391,338,80,64,71,34,920,492,428,100,92,88,49,1
13109,815,382,433,97,50,88,31,312,172,140,41,40,21,8,1
13110,1214,498,716,197,180,121,65,440,246,194,62,49,41,16,1
13111,441,201,240,70,58,55,24,747,326,421,123,98,84,56,1
13112,364,185,179,58,53,48,15,215,115,100,27,28,34,16,1
13113,989,513,476,125,106,92,60,462,233,229,66,49,43,30,1
13114,280,114,166,56,28,48,35,2406,1132,1274,362,272,192,66,1
13115,815,418,397,97,62,70,17,568,292,276,69,74,59,34,1
13116,605,283,322,94,72,64,39,776,356,420,122,103,85,30,1
13117,108,59,49,17,13,12,5,521,265,256,69,69,61,26,1
13118,271,110,161,33,27,11,8,300,140,160,39,35,14,12,1
13119,267,124,143,45,46,26,4,2261,1217,1044,271,243,267,101,1
13120,543,221,322,78,122,37,12,1893,764,1129,308,323,126,60,1
13121,407,225,182,58,44,44,22,366,213,153,48,27,42,17,1
13122,612,330,282,71,54,63,37,94,55,39,18,6,18,5,1
13123,837,381,456,123,109,65,25,956,450,506,122,117,82,36,1
13124,454,230,224,63,56,38,33,347,168,179,44,51,35,23,1
13125,533,297,236,74,57,39,28,1152,556,596,146,159,31,39,1
13126,243,98,145,25,65,20,5,367,199,168,62,44,34,8,1
13127,414,185,229,53,54,49,11,181,96,85,25,23,20,7,1
13128,517,196,321,103,98,34,12,392,156,236,40,91,28,16,1
13129,864,429,435,129,118,68,35,131,66,65,21,14,23,7,1
13130,139,62,77,23,6,14,4,423,247,176,58,55,29,20,1
13131,1308,652,656,166,153,149,87,1255,708,547,120,68,88,7,1
13132,673,313,360,101,101,46,17,344,151,193,59,51,30,9,1
13133,832,428,404,131,89,88,38,422,203,219,75,49,40,22,1
13134,237,112,125,19,57,25,10,375,202,173,46,49,41,23,1
13135,1069,494,575,133,111,110,39,512,248,264,66,71,49,30,1
13136,607,335,272,90,65,97,23,138,73,65,18,9,10,3,1
13137,589,294,295,37,44,27,33,2549,1331,1218,366,296,271,130,1
13138,536,278,258,72,63,62,20,968,452,516,150,144,79,28,1
13139,603,311,292,102,71,66,23,1085,529,556,149,133,126,54,1
13140,76,30,46,7,15,1,5,529,264,265,59,68,41,17,1
13141,317,167,150,45,21,30,26,360,201,159,38,38,34,13,1
13142,673,317,356,101,85,76,49,755,390,365,103,84,85,34,1
13143,222,110,112,43,30,14,6,598,322,276,67,57,63,26,1
13144,787,386,401,98,95,86,25,638,305,333,68,90,70,29,1
13145,2414,1189,1225,277,178,170,169,207,128,79,26,17,19,9,1
13146,1102,511,591,171,179,148,52,421,195,226,73,71,34,15,1
13147,700,357,343,99,84,88,34,537,276,261,75,68,68,22,1
13148,598,300,298,68,77,59,21,439,202,237,80,53,35,15,1
13149,428,226,202,52,60,75,20,1069,512,557,148,126,84,36,1
13150,158,85,73,24,18,18,8,853,400,453,137,109,88,42,1
13151,460,263,197,55,53,32,19,188,92,96,25,27,18,7,1
13152,350,224,126,34,14,48,18,354,166,188,53,55,40,19,1
13153,512,261,251,79,73,60,21,400,187,213,57,46,51,16,1
13154,330,143,187,63,29,52,20,334,172,162,43,39,41,17,1
13155,447,222,225,71,54,44,25,418,163,255,57,54,38,24,1
13156,2133,789,1344,342,419,135,88,433,221,212,59,42,47,14,1
13157,154,75,79,17,24,16,13,298,160,138,37,30,22,12,1
13158,316,157,159,45,38,22,19,614,263,351,85,84,54,35,1
13159,1335,701,634,163,140,140,64,118,56,62,13,14,6,6,1
13160,178,89,89,26,21,21,10,571,314,257,74,67,46,24,1
13161,522,245,277,78,69,52,21,416,201,215,54,52,39,25,1
13162,968,452,516,150,144,79,28,908,488,420,115,97,111,43,1
13163,540,271,269,80,77,51,16,320,143,177,51,51,24,10,1
13164,386,204,182,62,36,56,26,385,174,211,38,32,23,12,1
13165,1893,764,1129,308,323,126,60,437,225,212,61,57,66,12,1
13166,218,133,85,20,19,13,6,1085,646,439,108,65,36,19,1
13167,1395,627,768,172,263,141,59,322,160,162,44,52,33,16,1
13168,536,278,258,72,63,62,20,906,455,451,116,105,87,46,1
13169,480,234,246,79,77,65,23,2414,1189,1225,277,178,170,169,1
13170,760,401,359,96,89,98,22,698,345,353,104,87,81,50,1
13171,413,236,177,41,25,35,19,158,74,84,26,23,18,18,1
13172,1006,468,538,151,135,82,39,660,332,328,84,73,47,19,1
13173,350,180,170,64,46,55,12,721,363,358,87,104,70,28,1
13174,926,435,491,133,132,85,17,427,218,209,56,57,53,24,1
13175,653,389,264,69,59,51,19,320,171,149,40,29,30,14,1
13176,297,158,139,47,37,37,9,920,492,428,100,92,88,49,1
13177,288,158,130,59,23,21,10,740,385,355,114,97,91,27,1
13178,641,341,300,101,91,29,22,930,367,563,181,153,83,48,1
13179,870,418,452,121,102,109,28,588,331,257,86,71,52,12,1
13180,2109,999,1110,332,294,187,89,648,341,307,78,89,77,21,1
13181,736,320,416,113,97,61,36,684,311,373,109,99,66,16,1
13182,332,206,126,36,30,30,12,1749,880,869,237,228,214,112,1
13183,395,204,191,51,48,54,20,621,404,217,61,42,73,21,1
13184,393,186,207,58,50,36,22,446,196,250,73,62,62,19,1
13185,104,46,58,15,17,9,5,103,46,57,16,14,12,4,1
13186,593,291,302,81,85,56,20,694,260,434,122,92,62,36,1
13187,351,184,167,59,45,54,9,172,74,98,30,40,11,8,1
13188,501,240,261,80,62,49,42,467,240,227,65,65,51,23,1
13189,198,104,94,22,21,17,8,329,171,158,49,41,31,10,1
13190,406,210,196,68,60,25,20,427,191,236,67,60,41,34,1
13191,796,445,351,96,80,90,38,379,203,176,55,48,45,16,1
13192,245,138,107,26,19,35,16,769,329,440,116,66,55,22,1
13193,631,309,322,106,83,89,33,1154,540,614,195,160,138,66,1
13194,486,236,250,73,67,59,16,585,317,268,77,64,89,21,1
13195,656,358,298,67,47,64,26,128,62,66,33,11,10,3,1
13196,911,423,488,140,150,102,32,556,269,287,86,66,62,22,1
13197,318,176,142,25,32,35,25,1074,539,535,136,87,87,66,1
13198,288,118,170,50,57,18,15,973,522,451,140,134,124,39,1
13199,770,356,414,123,102,66,25,776,346,430,103,102,61,40,1
13200,906,455,451,116,105,87,46,1356,672,684,171,172,134,59,1
13201,218,108,110,28,28,22,10,493,276,217,57,52,46,31,1
13202,1338,506,832,241,229,101,40,451,222,229,58,55,51,17,1
13203,193,104,89,24,12,18,10,260,120,140,40,25,30,26,1
13204,209,125,84,20,22,22,6,445,219,226,61,60,60,21,1
13205,908,489,419,114,131,79,46,433,220,213,67,68,31,19,1
13206,2414,1189,1225,277,178,170,169,1972,846,1126,222,330,114,68,1
13207,427,204,223,38,57,26,32,153,73,80,19,15,14,10,1
13208,400,193,207,53,69,48,14,374,174,200,54,52,42,21,1
13209,870,433,437,133,121,95,25,1434,727,707,210,173,161,54,1
13210,1863,721,1142,262,283,139,74,495,218,277,94,62,58,19,1
13211,350,220,130,32,18,45,17,122,69,53,18,16,20,4,1
13212,1246,677,569,159,154,108,52,1706,830,876,265,209,230,63,1
13213,741,351,390,131,113,84,25,920,492,428,100,92,88,49,1
13214,1970,978,992,245,206,198,80,782,378,404,111,132,75,34,1
13215,1132,624,508,199,79,127,41,854,380,474,137,159,81,31,1
13216,1441,657,784,140,135,81,73,847,452,395,100,94,81,36,1
13217,355,197,158,38,43,49,9,267,124,143,45,46,26,4,1
13218,890,474,416,104,78,97,44,889,524,365,111,79,88,42,1
13219,736,388,348,88,85,67,28,560,228,332,113,58,79,38,1
13220,802,449,353,102,87,82,29,216,94,122,43,17,23,9,1
13221,1164,531,633,179,157,107,46,246,113,133,33,45,22,10,1
13222,770,374,396,95,91,79,41,748,360,388,101,89,82,36,1
13223,335,185,150,46,34,36,13,492,317,175,42,31,63,23,1
13224,469,224,245,67,77,34,17,114,71,43,8,18,7,4,1
13225,4303,2489,1814,436,369,444,134,2477,1186,1291,256,271,249,90,1
13226,706,346,360,118,92,98,56,547,292,255,51,55,46,28,1
13227,534,267,267,69,75,58,17,1134,539,595,150,146,78,40,1
13228,465,220,245,88,34,61,23,778,367,411,90,85,64,43,1
13229,596,292,304,92,60,56,19,2414,1189,1225,277,178,170,169,1
13230,1203,527,676,199,174,99,107,610,281,329,54,62,65,58,1
13231,656,358,298,67,47,64,26,1247,492,755,222,184,67,44,1
13232,138,69,69,28,7,10,10,769,329,440,116,66,55,22,1
13233,193,92,101,29,32,25,11,375,202,173,46,49,41,23,1
13234,504,259,245,73,56,45,29,393,186,207,58,50,36,22,1
13235,327,177,150,56,20,25,6,920,492,428,100,92,88,49,1
13236,589,256,333,112,67,63,28,103,44,59,16,17,9,5,1
13237,391,208,183,65,49,57,17,143,79,64,16,25,7,5,1
13238,1150,585,565,162,148,102,36,403,185,218,67,62,63,19,1
13239,465,225,240,65,44,65,25,763,364,399,106,96,54,30,1
13240,214,122,92,12,13,26,13,212,93,119,30,27,21,14,1
13241,277,124,153,44,40,35,18,467,269,198,46,51,60,18,1
13242,358,170,188,54,55,20,10,1153,588,565,174,128,149,56,1
13243,433,221,212,59,42,47,14,358,212,146,51,36,33,9,1
13244,431,186,245,79,83,37,18,144,63,81,28,32,11,4,1
13245,498,224,274,69,49,45,16,2725,1490,1235,339,333,254,78,1
13246,314,151,163,42,61,39,16,125,60,65,22,17,14,5,1
13247,1581,684,897,220,153,118,63,1863,721,1142,262,283,139,74,1
13248,1816,865,951,246,230,189,76,873,366,507,127,125,75,21,1
13249,529,203,326,125,84,49,10,391,156,235,70,67,25,13,1
13250,905,421,484,110,119,105,34,422,211,211,73,61,43,17,1
13251,208,122,86,27,13,23,7,822,424,398,107,106,86,46,1
13252,310,167,143,39,31,28,22,466,186,280,71,84,30,11,1
13253,280,136,144,41,34,26,16,282,135,147,27,37,30,19,1
13254,947,482,465,143,107,89,37,1332,659,673,174,170,153,55,1
13255,432,115,317,127,90,24,15,484,192,292,118,68,83,22,1
13256,606,340,266,67,62,76,22,339,189,150,34,27,55,13,1
13257,361,155,206,43,61,29,18,415,209,206,60,67,39,18,1
13258,368,141,227,64,61,24,13,359,179,180,52,45,48,16,1
13259,788,420,368,93,89,98,23,593,291,302,81,85,56,20,1
13260,245,112,133,32,45,20,10,766,386,380,101,81,78,31,1
13261,707,386,321,85,83,99,28,1482,762,720,156,144,154,52,1
13262,2174,1054,1120,240,247,216,112,2177,1034,1143,274,228,201,95,1
13263,1163,493,670,214,158,106,42,220,102,118,26,32,27,10,1
13264,546,267,279,90,69,56,19,297,158,139,47,37,37,9,1
13265,359,219,140,42,19,56,19,590,279,311,103,83,69,30,1
13266,593,266,327,102,84,69,24,976,496,480,128,111,121,48,1
13267,272,94,178,76,33,19,4,454,242,212,54,42,61,24,1
13268,183,97,86,30,18,20,12,1019,522,497,159,138,142,40,1
13269,306,155,151,43,34,36,17,467,250,217,59,52,41,19,1
13270,897,487,410,92,97,83,31,635,333,302,99,75,83,28,1
13271,247,110,137,34,45,23,10,770,356,414,123,102,66,25,1
13272,211,114,97,32,24,19,10,847,467,380,117,101,67,24,1
13273,2442,1193,1249,278,183,170,145,2948,1454,1494,327,456,140,81,1
13274,2016,1107,909,214,229,238,111,1198,571,627,177,168,97,54,1
13275,103,51,52,15,17,6,5,294,148,146,35,33,25,14,1
13276,1192,579,613,120,215,79,24,453,250,203,53,37,47,11,1
13277,550,319,231,49,65,35,16,1675,875,800,213,219,196,72,1
13278,140,81,59,16,15,15,12,439,177,262,78,73,40,21,1
13279,553,261,292,73,79,40,26,391,208,183,65,49,57,17,1
13280,592,295,297,79,70,76,11,915,336,579,185,199,56,29,1
13281,333,192,141,50,48,28,10,796,445,351,96,80,90,38,1
13282,912,460,452,139,132,89,53,441,201,240,70,58,55,24,1
13283,431,220,211,71,49,42,16,623,320,303,103,85,75,15,1
13284,1424,650,774,152,124,95,87,513,260,253,71,50,58,23,1
13285,292,154,138,46,29,41,7,1117,423,694,182,134,88,31,1
13286,154,75,79,17,24,16,13,571,204,367,108,89,38,30,1
13287,1272,520,752,235,242,117,54,133,66,67,21,24,9,2,1
13288,4391,2256,2135,494,411,423,231,703,308,395,81,91,66,80,1
13289,229,115,114,27,30,16,9,703,356,347,96,97,38,22,1
13290,673,315,358,112,80,60,30,577,288,289,85,56,40,20,1
13291,129,78,51,17,9,10,10,416,201,215,54,52,39,25,1
13292,894,492,402,95,103,88,42,724,334,390,112,109,79,17,1
13293,194,91,103,17,32,9,6,172,74,98,32,30,11,7,1
13294,1117,423,694,182,134,88,31,392,156,236,40,91,28,16,1
13295,780,337,443,112,116,77,28,1009,506,503,146,141,97,55,1
13296,417,217,200,70,55,42,16,283,142,141,35,29,32,5,1
13297,1098,519,579,182,159,79,42,1304,696,608,195,169,122,53,1
13298,298,154,144,44,34,25,11,466,224,242,68,56,48,16,1
13299,250,114,136,45,42,18,8,466,186,280,71,84,30,11,1
13300,458,225,233,67,61,43,33,841,427,414,112,88,56,25,1
13301,293,142,151,49,40,42,17,416,201,215,54,52,39,25,1
13302,780,370,410,107,120,75,22,178,100,78,23,22,30,6,1
13303,493,230,263,73,47,47,13,424,198,226,57,46,41,19,1
13304,956,403,553,147,135,99,87,1712,1175,537,179,142,113,46,1
13305,472,263,209,61,56,56,18,769,329,440,116,66,55,22,1
13306,2414,1189,1225,277,178,170,169,1141,583,558,141,98,91,45,1
13307,606,279,327,81,70,49,34,380,187,193,38,51,30,18,1
13308,209,122,87,21,24,20,5,1044,557,487,155,98,170,31,1
13309,605,285,320,89,61,68,26,593,291,302,81,85,56,20,1
13310,503,263,240,72,55,51,34,390,203,187,58,40,43,19,1
13311,277,100,177,35,88,30,2,209,75,134,53,48,20,9,1
13312,407,180,227,79,42,32,16,356,199,157,36,43,28,12,1
13313,636,320,316,79,61,67,31,454,191,263,61,66,38,15,1
13314,561,292,269,88,68,64,22,698,345,353,104,87,81,50,1
13315,379,203,176,55,48,45,16,87,48,39,15,9,9,3,1
13316,204,84,120,29,30,16,9,494,315,179,49,22,42,24,1
13317,1009,506,503,146,141,97,55,499,272,227,49,66,66,21,1
13318,802,381,421,137,97,82,35,351,184,167,59,45,54,9,1
13319,474,208,266,65,69,43,36,769,329,440,116,66,55,22,1
13320,354,140,214,55,50,31,18,854,376,478,136,112,72,29,1
13321,826,410,416,98,94,107,39,750,347,403,105,103,83,29,1
13322,480,256,224,67,55,26,22,408,197,211,74,44,53,16,1
13323,187,90,97,28,18,28,10,557,268,289,66,67,70,17,1
13324,1170,627,543,131,136,132,47,532,276,256,57,50,32,19,1
13325,1202,506,696,209,198,74,44,1005,439,566,159,165,70,43,1
13326,415,209,206,60,67,39,18,906,485,421,112,98,112,39,1
13327,933,536,397,96,90,71,41,875,421,454,124,142,98,43,1
13328,248,118,130,54,31,26,5,765,295,470,200,142,84,27,1
13329,681,322,359,100,87,71,26,280,136,144,41,34,26,16,1
13330,885,424,461,143,114,92,32,667,346,321,100,87,76,22,1
13331,626,345,281,62,76,66,25,1487,996,491,147,141,50,35,1
13332,440,218,222,58,66,40,24,125,60,65,22,17,14,5,1
13333,987,515,472,107,110,106,61,548,309,239,73,62,54,13,1
13334,560,260,300,100,58,29,28,577,251,326,92,84,60,11,1
13335,747,371,376,87,134,54,29,393,186,207,58,50,36,22,1
13336,562,265,297,79,56,72,45,810,367,443,115,92,94,59,1
13337,292,152,140,46,38,35,12,1464,715,749,200,167,181,70,1
13338,377,177,200,63,53,44,16,583,248,335,115,111,52,16,1
13339,1164,622,542,150,143,78,35,377,202,175,46,50,41,23,1
13340,784,337,447,127,135,59,29,218,108,110,28,28,22,10,1
13341,171,94,77,24,28,30,11,297,146,151,55,39,24,13,1
13342,219,124,95,22,22,23,5,328,184,144,47,24,23,9,1
13343,768,354,414,133,106,79,42,295,143,152,38,47,22,25,1
13344,269,134,135,42,35,27,13,603,311,292,102,71,66,23,1
13345,246,108,138,32,44,21,10,1382,689,693,186,176,167,77,1
13346,175,88,87,29,21,18,5,652,272,380,116,113,55,27,1
13347,455,242,213,69,50,45,18,465,225,240,65,44,65,25,1
13348,418,190,228,80,50,45,22,160,53,107,31,29,13,3,1
13349,261,108,153,35,37,16,6,220,113,107,31,21,25,12,1
13350,390,191,199,66,49,43,12,710,342,368,99,82,76,46,1
13351,815,418,397,97,62,70,17,512,254,258,70,48,37,32,1
13352,559,296,263,77,69,42,13,217,109,108,34,32,35,7,1
13353,739,393,346,91,91,70,44,1050,482,568,136,154,101,41,1
13354,245,93,152,35,28,32,21,622,305,317,91,80,65,28,1
13355,123,62,61,15,15,19,6,1159,641,518,148,115,114,48,1
13356,1098,432,666,166,199,76,28,205,77,128,31,45,12,11,1
13357,963,553,410,126,103,79,26,204,99,105,32,32,22,10,1
13358,1168,652,516,155,113,134,68,502,286,216,56,50,66,32,1
13359,499,272,227,49,66,66,21,550,243,307,91,99,70,10,1
13360,504,259,245,73,56,45,29,151,82,69,16,17,11,7,1
13361,2440,1061,1379,377,326,172,62,523,300,223,70,54,51,25,1
13362,4377,1898,2479,663,608,331,126,724,334,390,112,109,79,17,1
13363,349,131,218,66,76,22,9,1199,589,610,189,128,167,65,1
13364,737,363,374,119,101,85,41,372,237,135,38,22,39,26,1
13365,354,188,166,44,31,48,11,1051,523,528,164,140,126,50,1
13366,904,443,461,118,89,124,30,296,154,142,38,38,24,16,1
13367,326,166,160,49,45,36,12,904,436,468,138,146,82,39,1
13368,697,373,324,105,83,95,38,478,239,239,65,66,65,21,1
13369,730,313,417,119,92,65,23,220,102,118,26,32,27,10,1
13370,247,110,137,34,45,23,10,679,338,341,96,95,40,23,1
13371,214,108,106,53,20,27,15,543,287,256,71,66,64,23,1
13372,558,306,252,75,55,74,23,1129,589,540,134,122,108,46,1
13373,91,50,41,12,5,10,7,217,109,108,34,32,35,7,1
13374,613,354,259,72,72,61,19,926,435,491,133,132,85,17,1
13375,920,492,428,100,92,88,49,331,169,162,40,28,22,14,1
13376,1073,539,534,153,134,136,51,536,278,258,72,63,62,20,1
13377,693,359,334,75,54,59,20,521,265,256,69,69,61,26,1
13378,630,294,336,92,90,57,21,378,154,224,74,84,35,22,1
13379,552,285,267,74,51,69,24,1204,623,581,144,146,119,83,1
13380,323,156,167,52,45,39,18,782,372,410,127,111,89,36,1
13381,2414,1189,1225,277,178,170,169,465,225,240,65,44,65,25,1
13382,551,298,253,63,65,45,19,269,156,113,37,32,17,7,1
13383,524,264,260,75,75,40,21,424,191,233,76,73,49,13,1
13384,152,87,65,20,19,14,5,145,75,70,18,17,10,9,1
13385,2041,1035,1006,223,274,125,60,489,242,247,83,63,62,19,1
13386,2414,1189,1225,277,178,170,169,363,182,181,33,55,23,11,1
13387,603,311,292,102,71,66,23,223,93,130,38,27,39,10,1
13388,1019,522,497,159,138,142,40,110,67,43,9,10,11,8,1
13389,2005,1074,931,235,243,249,109,4377,1898,2479,663,608,331,126,1
13390,525,299,226,54,54,51,19,327,177,150,40,40,38,18,1
13391,404,190,214,55,55,35,27,448,275,173,32,53,55,27,1
13392,947,482,465,143,107,89,37,724,320,404,120,147,67,25,1
13393,299,164,135,37,29,28,11,167,77,90,22,25,11,11,1
13394,304,155,149,40,31,44,13,113,66,47,11,9,6,5,1
13395,246,115,131,15,29,10,32,475,251,224,67,49,48,23,1
13396,537,272,265,75,83,41,29,377,177,200,63,53,44,16,1
13397,346,168,178,36,43,20,9,410,188,222,53,52,31,14,1
13398,71,37,34,11,9,5,5,659,325,334,102,85,87,32,1
13399,377,177,200,63,53,44,16,781,418,363,92,90,64,41,1
13400,233,121,112,24,31,30,7,239,146,93,30,22,35,9,1
13401,991,537,454,134,99,80,34,2524,1232,1292,398,317,186,61,1
13402,2512,1328,1184,379,280,301,113,340,162,178,40,39,35,22,1
13403,215,115,100,27,28,34,16,224,108,116,33,26,32,10,1
13404,344,181,163,61,37,40,14,140,71,69,33,11,14,2,1
13405,786,378,408,101,79,104,35,1008,499,509,164,134,110,40,1
13406,454,240,214,57,68,39,11,553,261,292,73,79,40,26,1
13407,87,50,37,16,7,10,5,403,220,183,50,40,39,27,1
13408,414,194,220,76,66,49,16,1177,666,511,131,99,88,35,1
13409,522,245,277,78,69,52,21,928,442,486,139,118,91,43,1
13410,668,331,337,108,64,58,29,393,186,207,58,50,36,22,1
13411,154,75,79,17,24,16,13,489,210,279,79,58,55,18,1
13412,1037,575,462,122,150,82,32,477,279,198,60,34,73,23,1
13413,505,273,232,70,57,60,33,188,97,91,27,16,24,21,1
13414,476,270,206,62,45,46,30,330,143,187,63,29,52,20,1
13415,1142,515,627,56,128,113,16,292,155,137,50,34,29,13,1
13416,374,213,161,46,43,31,26,680,334,346,101,92,78,33,1
13417,781,418,363,92,90,64,41,391,255,136,55,21,41,19,1
13418,246,108,138,32,44,21,10,1096,513,583,195,156,113,24,1
13419,1332,659,673,174,170,153,55,606,279,327,81,70,49,34,1
13420,235,106,129,38,39,24,12,290,142,148,41,37,43,11,1
13421,2442,1193,1249,278,183,170,145,436,196,240,62,50,59,19,1
13422,205,106,99,28,26,23,3,740,313,427,101,135,40,22,1
13423,344,151,193,59,51,30,9,782,378,404,120,112,87,31,1
13424,858,417,441,124,101,85,41,491,242,249,59,72,66,26,1
13425,540,257,283,81,63,57,24,404,190,214,55,55,35,27,1
13426,521,290,231,76,56,76,18,184,91,93,25,25,11,9,1
13427,169,87,82,20,15,19,16,1308,652,656,166,153,149,87,1
13428,1075,515,560,126,106,107,40,380,187,193,38,51,30,18,1
13429,153,109,44,10,7,35,5,162,88,74,18,20,25,10,1
13430,356,208,148,42,26,57,15,845,402,443,137,126,105,47,1
13431,375,202,173,46,49,41,23,402,227,175,48,40,35,11,1
13432,503,263,240,72,55,51,34,625,342,283,62,53,56,28,1
13433,684,288,396,107,90,54,42,308,164,144,47,29,33,7,1
13434,341,190,151,50,41,23,15,98,55,43,14,1,7,4,1
13435,1015,466,549,156,153,67,25,340,162,178,40,39,35,22,1
13436,522,283,239,65,64,76,22,283,159,124,41,21,39,17,1
13437,776,401,375,81,122,54,16,233,121,112,24,31,30,7,1
13438,790,352,438,132,87,91,60,671,321,350,95,87,75,34,1
13439,351,184,167,59,45,54,9,450,241,209,67,58,54,23,1
13440,428,226,202,52,60,75,20,541,279,262,79,82,31,32,1
13441,189,90,99,26,29,17,11,359,219,140,42,19,56,19,1
13442,229,123,106,28,21,21,14,648,307,341,101,58,76,34,1
13443,473,217,256,59,44,34,21,785,374,411,56,42,38,25,1
13444,4861,2440,2421,597,576,422,237,531,286,245,81,67,42,29,1
13445,635,333,302,99,75,83,28,229,105,124,36,33,12,4,1
13446,347,198,149,45,29,29,8,1382,599,783,208,252,90,39,1
13447,656,358,298,67,47,64,26,552,285,267,74,51,69,24,1
13448,625,313,312,103,90,74,29,410,186,224,72,57,52,22,1
13449,1007,353,654,277,147,70,26,316,156,160,43,42,28,17,1
13450,210,116,94,24,28,21,9,871,437,434,112,113,83,49,1
13451,228,72,156,42,27,8,7,406,212,194,50,52,24,18,1
13452,2133,789,1344,342,419,135,88,351,184,167,59,45,54,9,1
13453,651,323,328,90,65,64,24,2556,1169,1387,248,291,227,275,1
13454,394,202,192,44,43,38,28,765,407,358,89,75,90,42,1
13455,409,208,201,33,45,23,10,377,180,197,45,63,19,17,1
13456,268,124,144,36,34,12,4,163,71,92,22,38,11,7,1
13457,619,290,329,97,79,62,19,146,74,72,26,25,23,4,1
13458,677,300,377,85,79,61,40,202,102,100,29,35,6,9,1
13459,927,527,400,104,123,119,43,245,111,134,31,44,20,11,1
13460,470,226,244,81,53,59,39,834,465,369,82,84,81,21,1
13461,262,144,118,19,39,22,8,316,156,160,34,28,32,14,1
13462,487,247,240,73,42,42,22,480,257,223,74,26,60,27,1
13463,482,231,251,76,81,64,26,1531,691,840,270,226,143,52,1
13464,770,385,385,78,83,60,16,435,221,214,72,45,47,19,1
13465,256,148,108,31,16,29,12,724,650,74,44,3,32,3,1
13466,560,348,212,58,44,83,28,352,166,186,55,59,31,16,1
13467,360,192,168,55,45,48,16,178,100,78,23,22,30,6,1
13468,881,428,453,174,110,64,21,933,536,397,96,90,71,41,1
13469,351,184,167,59,45,54,9,648,307,341,101,58,76,34,1
13470,707,386,321,85,83,99,28,304,135,169,48,36,38,26,1
13471,292,152,140,46,38,35,12,705,396,309,87,48,53,17,1
13472,698,345,353,104,87,81,50,417,182,235,57,109,50,8,1
13473,257,139,118,64,17,24,7,337,177,160,40,43,45,19,1
13474,439,260,179,47,40,23,19,418,220,198,69,51,44,16,1
13475,1037,575,462,122,150,82,32,408,271,137,36,18,38,23,1
13476,2414,1189,1225,277,178,170,169,318,164,154,52,43,34,10,1
13477,305,166,139,42,38,28,12,311,176,135,51,29,37,8,1
13478,189,93,96,24,28,17,12,648,307,341,101,58,76,34,1
13479,784,373,411,101,90,91,37,540,257,283,81,63,57,24,1
13480,815,418,397,97,62,70,17,1087,481,606,102,80,92,18,1
13481,439,251,188,59,51,50,13,371,237,134,31,25,43,17,1
13482,269,109,160,41,54,21,11,808,357,451,116,98,56,36,1
13483,580,306,274,79,71,50,25,191,99,92,25,24,18,8,1
13484,437,225,212,61,57,66,12,389,176,213,81,59,24,7,1
13485,1647,794,853,279,235,128,65,410,208,202,59,58,43,26,1
13486,406,210,196,68,60,25,20,782,372,410,127,111,89,36,1
13487,217,115,102,40,24,26,6,599,292,307,74,126,45,14,1
13488,280,114,166,56,28,48,35,500,244,256,66,57,52,27,1
13489,165,80,85,21,9,18,19,1863,721,1142,262,283,139,74,1
13490,349,167,182,54,38,30,28,375,173,202,50,46,43,25,1
13491,1123,554,569,142,130,85,36,428,226,202,52,60,75,20,1
13492,1435,649,786,214,181,135,54,437,228,209,47,61,26,11,1
13493,282,135,147,36,49,25,10,592,291,301,92,93,71,31,1
13494,1168,535,633,185,154,122,51,247,110,137,34,45,23,10,1
13495,1032,574,458,105,83,107,62,767,410,357,91,78,91,41,1
13496,448,236,212,53,64,56,24,465,218,247,64,51,50,42,1
13497,239,110,129,32,32,24,10,165,77,88,28,27,19,10,1
13498,247,110,137,34,45,23,10,536,278,258,72,63,62,20,1
13499,719,378,341,108,66,61,44,789,362,427,90,82,70,35,1
13500,360,201,159,38,38,34,13,920,492,428,100,92,88,49,1
13501,3969,1703,2266,619,432,259,144,615,339,276,82,76,63,16,1
13502,351,184,167,59,45,54,9,220,142,78,15,12,17,15,1
13503,898,467,431,101,127,90,53,1800,882,918,202,185,186,49,1
13504,261,144,117,34,22,31,15,297,145,152,49,30,23,21,1
13505,1170,510,660,142,182,115,84,2477,1186,1291,256,271,249,90,1
13506,706,300,406,94,74,61,22,134,60,74,19,13,10,7,1
13507,264,121,143,57,32,22,15,169,64,105,23,37,11,3,1
13508,502,299,203,57,52,32,11,1290,629,661,191,187,167,55,1
13509,592,275,317,100,86,57,31,294,148,146,35,33,25,14,1
13510,114,70,44,8,11,11,7,519,246,273,78,82,42,16,1
13511,433,221,212,59,42,47,14,968,452,516,150,144,79,28,1
13512,298,167,131,47,33,40,8,700,305,395,111,99,54,18,1
13513,1278,593,685,198,201,71,43,376,205,171,56,52,46,12,1
13514,241,115,126,44,21,29,10,267,147,120,37,28,35,12,1
13515,498,174,324,112,108,33,19,472,220,252,59,69,32,20,1
13516,1149,568,581,177,133,101,30,1182,599,583,162,130,106,41,1
13517,350,180,170,64,46,55,12,409,200,209,69,56,44,13,1
13518,158,85,73,24,18,18,8,1004,498,506,94,59,46,33,1
13519,396,150,246,103,64,38,3,2414,1189,1225,277,178,170,169,1
13520,407,208,199,40,25,37,20,431,236,195,65,40,50,25,1
13521,149,68,81,15,38,11,10,879,466,413,103,85,111,54,1
13522,493,208,285,75,77,70,40,1450,754,696,207,197,145,54,1
13523,806,436,370,101,100,76,34,2109,999,1110,332,294,187,89,1
13524,509,254,255,67,55,52,35,465,225,240,65,44,65,25,1
13525,305,166,139,42,38,28,12,450,263,187,52,38,54,16,1
13526,441,218,223,69,55,50,27,224,125,99,33,32,22,6,1
13527,512,261,251,79,73,60,21,295,167,128,43,23,17,11,1
13528,211,108,103,34,25,26,12,425,210,215,56,43,52,25,1
13529,817,397,420,120,152,48,17,1591,704,887,253,227,156,50,1
13530,856,429,427,113,105,96,24,131,66,65,21,14,23,7,1
13531,418,213,205,54,56,49,13,258,133,125,24,13,30,11,1
13532,794,402,392,96,84,86,30,211,90,121,49,27,14,11,1
13533,159,78,81,22,15,9,11,113,54,59,10,12,13,7,1
13534,524,297,227,77,44,50,19,781,418,363,92,90,64,41,1
13535,1770,759,1011,237,271,163,74,2442,1193,1249,278,183,170,145,1
13536,777,345,432,128,88,65,39,671,318,353,83,124,46,34,1
13537,1427,542,885,246,269,69,46,327,149,178,47,49,38,11,1
13538,268,143,125,43,29,22,10,1024,486,538,186,113,94,51,1
13539,432,181,251,48,75,27,17,635,333,302,99,75,83,28,1
13540,524,264,260,75,75,40,21,466,186,280,71,84,30,11,1
13541,1575,744,831,228,240,141,42,191,99,92,25,24,18,8,1
13542,330,143,187,63,29,52,20,656,321,335,85,91,50,31,1
13543,592,291,301,92,93,71,31,467,269,198,46,51,60,18,1
13544,1821,809,1012,317,235,180,69,216,84,132,47,43,17,12,1
13545,384,238,146,38,26,66,19,109,53,56,17,8,13,7,1
13546,242,111,131,35,35,17,13,149,68,81,15,38,11,10,1
13547,224,108,116,33,26,32,10,171,94,77,24,28,30,11,1
13548,711,435,276,72,62,51,20,639,292,347,95,92,83,20,1
13549,128,58,70,22,14,4,7,486,254,232,45,33,38,28,1
13550,292,150,142,31,43,39,16,639,298,341,77,61,70,20,1
13551,480,234,246,79,77,65,23,454,223,231,38,45,24,19,1
13552,307,150,157,44,23,30,13,603,291,312,98,87,61,28,1
13553,472,259,213,51,44,56,21,228,139,89,24,21,32,18,1
13554,656,358,298,67,47,64,26,520,243,277,83,66,51,21,1
13555,676,333,343,111,89,94,39,464,242,222,61,68,36,17,1
13556,437,230,207,41,55,27,13,352,163,189,73,44,29,15,1
13557,1149,568,581,177,133,101,30,331,169,162,40,28,22,14,1
13558,1106,499,607,161,139,95,39,894,420,474,136,146,93,39,1
13559,369,167,202,66,59,39,20,465,218,247,64,51,50,42,1
13560,358,180,178,57,55,39,11,1749,880,869,237,228,214,112,1
13561,2414,1189,1225,277,178,170,169,1800,882,918,202,185,186,49,1
13562,135,69,66,21,14,11,5,1332,659,673,174,170,153,55,1
13563,656,358,298,67,47,64,26,452,217,235,59,47,60,20,1
13564,130,69,61,26,12,14,7,428,214,214,65,67,45,23,1
13565,1970,978,992,245,206,198,80,526,268,258,54,37,55,12,1
13566,217,109,108,34,32,35,7,363,193,170,52,51,41,14,1
13567,501,240,261,80,62,49,42,119,61,58,18,8,9,6,1
13568,1434,727,707,210,173,161,54,1205,632,573,156,149,102,48,1
13569,2414,1189,1225,277,178,170,169,251,139,112,41,18,27,11,1
13570,712,331,381,111,86,86,34,404,197,207,60,48,47,20,1
13571,1102,511,591,171,179,148,52,415,209,206,60,67,39,18,1
13572,423,192,231,61,59,48,19,2556,1169,1387,248,291,227,275,1
13573,140,86,54,17,6,20,7,280,121,159,60,45,22,12,1
13574,327,177,150,40,40,38,18,115,67,48,10,7,12,7,1
13575,196,103,93,32,21,14,11,325,169,156,32,37,49,20,1
13576,125,46,79,24,16,12,2,331,169,162,40,28,22,14,1
13577,161,75,86,24,20,10,7,800,416,384,102,105,83,22,1
13578,215,117,98,43,22,27,5,706,300,406,94,74,61,22,1
13579,358,188,170,50,31,48,20,384,210,174,49,48,49,20,1
13580,621,404,217,61,42,73,21,435,301,134,34,26,87,17,1
13581,400,208,192,62,44,42,21,205,106,99,28,26,23,3,1
13582,724,334,390,112,109,79,17,317,153,164,34,52,30,14,1
13583,246,125,121,33,31,34,18,465,225,240,65,44,65,25,1
13584,277,124,153,44,40,35,18,497,227,270,70,63,66,30,1
13585,1927,1023,904,240,218,310,45,654,317,337,95,111,44,13,1
13586,671,318,353,83,124,46,34,758,360,398,114,107,51,19,1
13587,837,447,390,95,81,93,34,2135,1170,965,232,246,196,89,1
13588,377,224,153,52,23,51,20,799,377,422,98,95,80,70,1
13589,465,229,236,68,62,40,22,360,188,172,49,48,47,17,1
13590,1261,694,567,159,130,136,70,672,334,338,110,93,91,41,1
13591,359,203,156,42,19,45,26,377,221,156,55,38,45,12,1
13592,207,105,102,35,27,15,5,445,255,190,57,53,56,28,1
13593,392,115,277,117,75,28,17,159,84,75,13,28,10,8,1
13594,249,114,135,47,33,25,4,291,120,171,63,39,26,6,1
13595,245,112,133,32,45,20,10,465,220,245,82,71,60,25,1
13596,941,459,482,167,140,82,38,920,492,428,100,92,88,49,1
13597,1005,422,583,166,179,70,21,2472,1055,1417,416,458,235,64,1
13598,164,78,86,28,23,12,8,940,464,476,116,135,108,58,1
13599,483,237,246,63,47,25,21,424,209,215,56,58,45,24,1
13600,1822,879,943,236,227,175,97,466,186,280,71,84,30,11,1
13601,439,220,219,63,72,25,20,173,110,63,35,6,9,8,1
13602,569,288,281,86,69,74,24,269,133,136,30,41,34,17,1
13603,246,108,138,32,44,21,10,164,61,103,47,19,14,5,1
13604,174,79,95,36,37,18,6,443,255,188,57,44,42,19,1
13605,308,160,148,39,46,30,12,953,481,472,133,130,77,48,1
13606,413,194,219,77,72,28,11,1045,374,671,217,143,103,29,1
13607,312,164,148,45,34,35,15,1079,582,497,151,133,133,47,1
13608,2602,1424,1178,314,320,249,75,748,355,393,121,91,95,26,1
13609,455,229,226,66,62,63,29,159,72,87,52,7,10,5,1
13610,1356,576,780,229,198,107,38,426,228,198,62,42,47,22,1
13611,158,74,84,26,23,18,18,281,137,144,39,41,34,11,1
13612,594,340,254,77,64,62,21,895,479,416,96,119,92,56,1
13613,718,283,435,126,127,34,29,160,53,107,31,29,13,3,1
13614,385,179,206,58,56,38,19,778,367,411,90,85,64,43,1
13615,351,184,167,59,45,54,9,433,222,211,68,58,42,23,1
13616,360,192,168,55,45,48,16,309,154,155,42,44,45,16,1
13617,24,14,10,4,2,1,2,770,355,415,103,142,75,42,1
13618,568,292,276,69,74,59,34,632,326,306,92,71,56,19,1
13619,354,169,185,54,54,41,19,2115,838,1277,346,354,90,48,1
13620,184,131,53,15,15,16,5,2414,1189,1225,277,178,170,169,1
13621,240,98,142,49,42,23,17,2414,1189,1225,277,178,170,169,1
13622,205,100,105,25,25,20,9,281,137,144,39,41,34,11,1
13623,1354,537,817,245,247,117,57,1030,368,662,172,188,56,20,1
13624,1770,824,946,245,258,179,60,505,275,230,63,57,35,12,1
13625,839,427,412,91,83,114,37,578,311,267,78,45,97,30,1
13626,585,312,273,57,64,77,25,250,164,86,22,15,30,4,1
13627,422,207,215,79,38,53,23,604,255,349,100,72,55,26,1
13628,815,418,397,97,62,70,17,4924,2469,2455,477,612,472,115,1
13629,189,93,96,24,28,17,12,552,285,267,74,51,69,24,1
13630,583,322,261,73,66,45,26,1242,613,629,174,113,114,53,1
13631,445,219,226,61,60,60,21,467,224,243,70,43,67,23,1
13632,613,263,350,106,75,51,28,201,42,159,19,3,2,75,1
13633,4303,2489,1814,436,369,444,134,1487,996,491,147,141,50,35,1
13634,298,159,139,39,40,33,15,336,154,182,51,48,39,22,1
13635,521,289,232,71,58,49,16,336,134,202,51,64,27,12,1
13636,246,113,133,33,45,22,10,143,79,64,16,25,7,5,1
13637,1354,537,817,245,247,117,57,572,298,274,72,67,52,20,1
13638,162,76,86,18,20,17,11,551,299,252,51,62,63,17,1
13639,429,219,210,46,66,42,17,618,290,328,82,74,69,42,1
13640,467,269,198,46,51,60,18,447,232,215,55,65,50,25,1
13641,815,418,397,97,62,70,17,311,187,124,39,38,35,12,1
13642,2477,1186,1291,256,271,249,90,1669,1162,507,154,128,86,51,1
13643,789,362,427,90,82,70,35,717,345,372,85,74,69,41,1
13644,2363,875,1488,361,444,95,53,1800,882,918,202,185,186,49,1
13645,393,186,207,58,50,36,22,120,67,53,13,15,9,6,1
13646,4544,2024,2520,579,628,480,403,1474,756,718,175,158,169,51,1
13647,453,191,262,58,55,39,22,465,225,240,65,44,65,25,1
13648,415,189,226,69,54,50,21,583,322,261,73,66,45,26,1
13649,1086,603,483,147,121,95,40,191,99,92,25,24,18,8,1
13650,644,311,333,80,107,67,25,778,367,411,90,85,64,43,1
13651,501,240,261,80,62,49,42,1133,491,642,192,170,61,29,1
13652,393,186,207,58,50,36,22,72,35,37,10,9,7,6,1
13653,443,208,235,43,55,51,50,304,144,160,30,39,26,16,1
13654,394,202,192,44,43,38,28,433,220,213,67,68,31,19,1
13655,2414,1189,1225,277,178,170,169,2442,1193,1249,278,183,170,145,1
13656,242,111,131,35,35,17,13,134,60,74,19,13,10,7,1
13657,465,228,237,64,42,63,24,437,167,270,126,95,34,10,1
13658,1132,553,579,172,143,150,57,671,364,307,75,71,58,22,1
13659,226,129,97,20,25,26,11,509,262,247,64,70,64,20,1
13660,399,201,198,65,45,48,17,589,281,308,69,39,63,20,1
13661,480,244,236,74,47,50,21,467,224,243,70,43,67,23,1
13662,973,527,446,110,137,122,34,246,108,138,32,44,21,10,1
13663,784,393,391,117,102,65,35,173,110,63,35,6,9,8,1
13664,304,159,145,38,40,32,3,1338,633,705,199,151,144,65,1
13665,327,177,150,40,40,38,18,103,49,54,21,21,10,2,1
13666,546,267,279,90,69,56,19,437,228,209,47,61,26,11,1
13667,1290,597,693,182,182,119,63,358,204,154,57,41,36,14,1
13668,376,192,184,50,50,41,16,456,211,245,75,68,36,25,1
13669,465,228,237,64,42,63,24,386,207,179,43,48,44,19,1
13670,432,188,244,76,81,26,13,309,106,203,66,49,25,10,1
13671,1390,695,695,180,137,170,71,724,334,390,112,109,79,17,1
13672,907,455,452,132,117,80,40,1382,508,874,334,320,98,36,1
13673,310,166,144,43,30,29,17,94,55,39,18,6,18,5,1
13674,114,53,61,16,7,4,6,3396,1499,1897,325,572,309,90,1
13675,1801,889,912,206,263,126,42,375,192,183,50,39,46,16,1
13676,2624,999,1625,416,495,109,81,467,201,266,71,70,63,27,1
13677,540,257,283,81,63,57,24,757,373,384,115,93,95,25,1
13678,461,208,253,79,76,61,21,1068,539,529,161,134,132,71,1
13679,394,202,192,44,43,38,28,631,336,295,64,65,70,12,1
13680,651,331,320,93,93,51,28,160,67,93,32,37,15,9,1
13681,351,184,167,59,45,54,9,946,469,477,133,113,62,39,1
13682,443,248,195,67,54,40,15,509,262,247,64,70,64,20,1
13683,716,354,362,102,87,77,30,862,409,453,149,125,86,29,1
13684,427,204,223,38,57,26,32,379,203,176,55,48,45,16,1
13685,652,342,310,71,68,66,17,442,243,199,60,49,65,13,1
13686,517,250,267,78,37,64,29,393,186,207,58,50,36,22,1
13687,2442,1193,1249,278,183,170,145,162,73,89,32,19,4,4,1
13688,278,110,168,58,49,29,5,335,155,180,64,48,36,10,1
13689,673,317,356,101,85,76,49,597,246,351,95,98,45,25,1
13690,2442,1193,1249,278,183,170,145,136,66,70,33,11,9,3,1
13691,871,312,559,187,101,140,58,630,289,341,100,121,62,34,1
13692,154,75,79,17,24,16,13,152,87,65,20,19,14,5,1
13693,1464,693,771,153,136,91,86,473,217,256,59,44,34,21,1
13694,837,464,373,104,72,85,49,911,493,418,89,140,83,34,1
13695,687,353,334,84,96,74,31,210,121,89,22,23,23,7,1
13696,915,336,579,185,199,56,29,2045,985,1060,359,339,199,74,1
13697,399,208,191,57,46,41,20,947,482,465,143,107,89,37,1
13698,331,170,161,47,39,41,8,270,133,137,42,37,34,8,1
13699,815,418,397,97,62,70,17,166,69,97,35,10,17,21,1
13700,734,366,368,121,99,63,39,750,347,403,105,103,83,29,1
13701,439,227,212,60,55,58,8,448,236,212,53,64,56,24,1
13702,417,182,235,57,109,50,8,770,355,415,103,142,75,42,1
13703,155,79,76,26,13,15,6,366,220,146,36,28,52,17,1
13704,456,209,247,72,58,40,9,982,494,488,150,117,91,45,1
13705,537,276,261,75,68,68,22,230,115,115,29,29,22,14,1
13706,277,124,153,44,40,35,18,1247,548,699,168,150,140,43,1
13707,1649,796,853,250,234,175,53,503,263,240,72,55,51,34,1
13708,315,129,186,51,29,24,29,318,176,142,25,32,35,25,1
13709,355,214,141,43,29,63,13,94,44,50,18,2,12,6,1
13710,639,397,242,64,37,64,30,299,140,159,27,59,20,18,1
13711,621,404,217,61,42,73,21,148,93,55,24,3,19,8,1
13712,570,292,278,80,65,72,23,211,114,97,32,24,19,10,1
13713,583,322,261,73,66,45,26,1265,580,685,205,188,166,53,1
13714,859,438,421,142,80,105,43,824,397,427,113,95,82,33,1
13715,464,242,222,61,68,36,17,215,80,135,54,56,21,9,1
13716,1210,592,618,157,138,116,85,896,407,489,97,152,70,22,1
13717,1756,697,1059,328,345,110,27,466,186,280,71,84,30,11,1
13718,673,329,344,111,95,92,41,483,274,209,54,39,45,13,1
13719,344,184,160,24,24,32,9,526,254,272,44,43,49,13,1
13720,501,240,261,80,62,49,42,755,348,407,109,98,49,23,1
13721,425,210,215,56,43,52,25,575,225,350,106,74,68,29,1
13722,536,278,258,72,63,62,20,655,328,327,65,54,55,35,1
13723,433,237,196,60,52,33,27,1863,721,1142,262,283,139,74,1
13724,191,100,91,30,22,23,4,562,281,281,80,61,67,23,1
13725,358,179,179,49,48,49,8,528,268,260,81,77,36,22,1
13726,538,252,286,77,87,53,30,465,218,247,64,51,50,42,1
13727,337,171,166,46,27,33,16,217,115,102,40,24,26,6,1
13728,156,72,84,27,24,20,7,790,385,405,121,108,106,39,1
13729,351,184,167,59,45,54,9,4967,2501,2466,718,692,594,248,1
13730,115,60,55,16,9,9,5,1462,711,751,219,222,148,65,1
13731,1338,756,582,155,105,104,44,796,445,351,96,80,90,38,1
13732,651,306,345,85,64,61,32,414,216,198,51,32,42,28,1
13733,508,254,254,74,99,61,12,392,156,236,40,91,28,16,1
13734,688,323,365,121,69,55,22,246,108,138,32,44,21,10,1
13735,1464,693,771,153,136,91,86,920,492,428,100,92,88,49,1
13736,231,126,105,37,26,29,6,292,162,130,43,27,21,12,1
13737,388,195,193,54,48,35,23,354,169,185,54,54,41,19,1
13738,1863,721,1142,262,283,139,74,448,236,212,53,64,56,24,1
13739,238,110,128,25,49,26,8,605,283,322,94,72,64,39,1
13740,147,78,69,20,15,20,7,313,157,156,39,26,34,29,1
13741,168,67,101,37,17,13,13,171,94,77,24,28,30,11,1
13742,570,318,252,77,48,93,26,211,114,97,32,24,19,10,1
13743,24,14,10,4,2,1,2,854,380,474,137,159,81,31,1
13744,566,263,303,83,87,74,31,712,331,381,111,86,86,34,1
13745,546,163,383,167,88,44,12,247,110,137,34,45,23,10,1
13746,330,166,164,57,51,36,16,145,75,70,22,18,10,5,1
13747,559,217,342,105,86,42,16,389,176,213,81,59,24,7,1
13748,568,243,325,98,73,56,44,377,202,175,46,50,41,23,1
13749,428,226,202,52,60,75,20,525,264,261,78,61,62,23,1
13750,74,32,42,13,18,2,6,411,236,175,39,45,50,30,1
13751,336,154,182,51,48,39,22,467,269,198,46,51,60,18,1
13752,297,141,156,32,18,31,15,798,393,405,112,80,83,33,1
13753,237,119,118,34,30,17,8,465,225,240,65,44,65,25,1
13754,221,75,146,68,21,16,5,526,268,258,54,37,55,12,1
13755,676,333,343,111,89,94,39,375,202,173,46,49,41,23,1
13756,107,36,71,27,15,0,1,508,267,241,43,35,25,17,1
13757,1201,557,644,151,125,117,50,1255,586,669,167,149,113,59,1
13758,320,163,157,44,44,26,15,236,121,115,26,45,28,6,1
13759,720,357,363,113,85,62,39,330,178,152,49,35,30,15,1
13760,480,232,248,83,64,51,25,462,232,230,78,54,42,23,1
13761,278,137,141,47,32,28,20,748,355,393,121,91,95,26,1
13762,360,192,168,55,45,48,16,595,316,279,86,60,65,40,1
13763,361,184,177,50,53,51,22,1336,724,612,209,141,133,60,1
13764,4303,2489,1814,436,369,444,134,483,215,268,66,70,30,16,1
13765,257,136,121,29,26,39,8,946,479,467,126,110,110,27,1
13766,137,65,72,19,18,14,7,1498,615,883,226,244,60,46,1
13767,509,262,247,64,70,64,20,794,390,404,103,95,86,23,1
13768,524,264,260,75,75,40,21,166,83,83,24,30,18,7,1
13769,147,72,75,26,10,17,9,188,97,91,27,16,24,21,1
13770,556,199,357,125,112,22,13,709,359,350,107,102,65,20,1
13771,1102,552,550,174,137,137,45,284,104,180,54,81,8,10,1
13772,586,254,332,114,111,55,17,742,303,439,88,96,86,23,1
13773,857,387,470,119,94,71,30,690,345,345,96,83,73,42,1
13774,733,346,387,98,113,66,26,1330,656,674,201,178,146,45,1
13775,1647,794,853,279,235,128,65,272,149,123,34,35,21,2,1
13776,1088,565,523,165,121,122,38,538,292,246,69,57,52,39,1
13777,176,73,103,22,29,13,9,240,98,142,49,42,23,17,1
13778,297,148,149,64,35,37,15,497,185,312,63,92,38,28,1
13779,372,189,183,60,44,41,18,700,305,395,111,99,54,18,1
13780,92,43,49,24,3,9,8,769,329,440,116,66,55,22,1
13781,729,358,371,116,99,89,33,378,154,224,74,84,35,22,1
13782,753,359,394,102,100,85,23,406,219,187,44,39,52,20,1
13783,726,326,400,106,106,57,31,768,378,390,105,104,63,26,1
13784,360,161,199,72,36,35,13,1304,585,719,179,169,154,47,1
13785,781,418,363,92,90,64,41,592,264,328,86,85,62,41,1
13786,1132,553,579,172,143,150,57,449,244,205,68,53,49,12,1
13787,462,251,211,74,53,41,18,811,361,450,124,107,80,31,1
13788,787,351,436,135,98,82,23,215,104,111,61,7,2,1,1
13789,2414,1189,1225,277,178,170,169,277,100,177,35,88,30,2,1
13790,619,293,326,98,78,65,22,462,232,230,78,54,42,23,1
13791,851,446,405,93,94,92,37,513,274,239,67,66,62,35,1
13792,617,255,362,105,108,61,23,1327,690,637,194,140,130,52,1
13793,377,177,200,63,53,44,16,901,458,443,91,129,86,21,1
13794,557,278,279,75,70,66,31,1292,633,659,171,202,109,47,1
13795,504,237,267,62,66,48,17,2477,1186,1291,256,271,249,90,1
13796,1721,809,912,268,234,144,50,338,193,145,34,27,53,17,1
13797,222,127,95,23,28,22,7,648,307,341,101,58,76,34,1
13798,277,129,148,41,32,32,15,433,237,196,60,52,33,27,1
13799,185,115,70,19,17,26,6,647,350,297,95,79,77,29,1
13800,252,146,106,23,19,25,7,536,278,258,72,63,62,20,1
13801,240,141,99,31,20,28,7,244,160,84,20,22,20,4,1
13802,1970,978,992,245,206,198,80,294,148,146,35,33,25,14,1
13803,277,124,153,44,40,35,18,4128,2104,2024,581,505,453,205,1
13804,462,251,211,74,53,41,18,179,76,103,36,32,9,9,1
13805,496,256,240,78,67,75,13,433,221,212,59,42,47,14,1
13806,553,261,292,73,79,40,26,757,373,384,115,93,95,25,1
13807,689,370,319,93,53,78,26,133,66,67,21,24,9,2,1
13808,1285,578,707,239,191,136,57,377,202,175,46,50,41,23,1
13809,136,66,70,33,11,9,5,202,113,89,16,27,21,11,1
13810,207,107,100,27,25,20,11,380,184,196,58,52,46,8,1
13811,1599,806,793,213,237,100,45,977,467,510,153,129,106,55,1
13812,673,329,344,111,95,92,41,332,185,147,31,59,7,4,1
13813,286,130,156,42,43,38,7,94,45,49,11,20,10,4,1
13814,459,221,238,52,56,51,19,787,386,401,98,95,86,25,1
13815,423,212,211,51,44,48,28,443,198,245,68,72,48,19,1
13816,594,276,318,110,79,47,19,1038,470,568,130,123,86,51,1
13817,400,228,172,43,20,47,24,190,94,96,24,33,24,6,1
13818,673,313,360,101,101,46,17,780,354,426,123,102,45,17,1
13819,1313,644,669,169,90,111,43,280,60,220,61,110,5,10,1
13820,161,75,86,24,20,10,7,211,92,119,33,44,11,7,1
13821,555,278,277,60,70,48,18,410,186,224,72,57,52,22,1
13822,589,296,293,99,76,64,29,383,204,179,61,32,54,16,1
13823,324,145,179,45,23,32,17,226,115,111,38,16,26,6,1
13824,398,196,202,61,45,34,18,592,264,328,86,85,62,41,1
13825,241,115,126,44,21,29,10,1474,756,718,175,158,169,51,1
13826,377,180,197,45,63,19,17,685,315,370,108,99,36,9,1
13827,169,123,46,15,6,33,6,104,54,50,17,18,13,4,1
13828,348,198,150,51,23,50,19,341,178,163,48,44,42,20,1
13829,335,128,207,59,43,24,23,672,334,338,110,93,91,41,1
13830,716,354,362,102,87,77,30,780,409,371,125,80,60,34,1
13831,456,228,228,49,70,32,19,780,354,426,123,102,45,17,1
13832,789,376,413,101,116,66,40,770,394,376,90,96,78,34,1
13833,645,268,377,104,73,55,30,1207,593,614,151,148,131,95,1
13834,736,293,443,95,116,54,43,156,64,92,31,19,5,4,1
13835,271,120,151,41,31,24,10,239,146,93,30,22,35,9,1
13836,199,101,98,29,25,18,6,140,86,54,17,6,20,7,1
13837,655,328,327,65,54,55,35,461,207,254,82,66,55,33,1
13838,211,92,119,33,44,11,7,218,133,85,20,19,13,6,1
13839,1608,778,830,243,230,159,74,357,169,188,61,53,32,15,1
13840,607,317,290,87,80,73,10,404,210,194,56,38,53,20,1
13841,406,219,187,44,39,52,20,277,144,133,36,36,34,15,1
13842,2045,985,1060,359,339,199,74,355,186,169,61,43,28,13,1
13843,138,72,66,15,10,21,19,116,55,61,16,7,18,14,1
13844,93,45,48,19,15,14,3,240,125,115,34,32,30,8,1
13845,1132,646,486,99,102,71,41,601,313,288,42,48,25,36,1
13846,551,299,252,51,62,63,17,648,307,341,101,58,76,34,1
13847,503,286,217,76,44,66,22,184,91,93,25,25,11,9,1
13848,552,285,267,74,51,69,24,781,418,363,92,90,64,41,1
13849,352,169,183,57,36,47,31,610,328,282,78,65,57,33,1
13850,351,184,167,59,45,54,9,467,269,198,46,51,60,18,1
13851,499,249,250,79,63,61,22,152,71,81,41,16,14,2,1
13852,469,247,222,70,58,82,13,385,194,191,49,50,40,12,1
13853,131,66,65,21,14,23,7,3144,1617,1527,367,342,278,136,1
13854,103,51,52,15,17,6,5,91,50,41,8,14,4,5,1
13855,981,465,516,126,164,112,38,710,361,349,81,98,63,26,1
13856,211,113,98,38,17,25,8,1382,689,693,186,176,167,77,1
13857,641,341,300,101,91,29,22,327,172,155,45,44,39,21,1
13858,598,300,298,68,77,59,21,312,117,195,87,50,35,11,1
13859,698,245,453,133,133,34,39,588,255,333,94,82,58,27,1
13860,863,450,413,116,122,106,41,551,233,318,103,99,64,23,1
13861,712,396,316,78,69,65,25,331,169,162,40,28,22,14,1
13862,2133,789,1344,342,419,135,88,403,188,215,70,42,41,11,1
13863,501,240,261,80,62,49,42,299,128,171,57,40,13,25,1
13864,832,428,404,131,89,88,38,905,371,534,192,135,81,28,1
13865,175,91,84,22,18,11,20,260,120,140,40,25,30,26,1
13866,1032,526,506,129,117,119,47,381,191,190,55,61,33,11,1
13867,410,222,188,42,55,52,20,810,367,443,115,92,94,59,1
13868,736,388,348,88,85,67,28,683,304,379,140,101,48,19,1
13869,707,295,412,105,105,66,30,163,71,92,22,38,11,7,1
13870,272,94,178,76,33,19,4,757,373,384,115,93,95,25,1
13871,317,153,164,34,52,30,14,194,112,82,26,13,17,8,1
13872,568,192,376,140,71,85,46,522,235,287,78,67,60,50,1
13873,173,110,63,35,6,9,8,260,135,125,35,29,31,14,1
13874,627,316,311,91,76,69,29,335,128,207,59,43,24,23,1
13875,398,227,171,47,32,44,17,448,236,212,53,64,56,24,1
13876,330,166,164,57,51,36,16,647,324,323,71,95,65,32,1
13877,1179,579,600,140,133,122,53,3075,1459,1616,390,359,298,207,1
13878,196,107,89,19,18,15,7,593,266,327,102,84,69,24,1
13879,95,44,51,14,13,7,4,317,153,164,39,30,35,13,1
13880,751,312,439,131,115,78,48,2109,999,1110,332,294,187,89,1
13881,248,129,119,26,46,21,6,1675,875,800,213,219,196,72,1
13882,473,224,249,82,63,48,24,393,186,207,58,50,36,22,1
13883,589,296,293,99,76,64,29,352,229,123,40,12,35,12,1
13884,1805,814,991,257,268,155,59,341,178,163,48,44,42,20,1
13885,501,240,261,80,62,49,42,1105,479,626,182,125,80,29,1
13886,116,55,61,14,14,18,8,417,231,186,37,32,43,18,1
13887,210,89,121,51,34,11,6,968,498,470,129,133,115,37,1
13888,466,186,280,71,84,30,11,283,141,142,32,26,23,26,1
13889,423,212,211,51,44,48,28,648,307,341,101,58,76,34,1
13890,147,78,69,20,15,20,7,875,421,454,124,142,98,43,1
13891,1359,684,675,188,160,127,47,920,492,428,100,92,88,49,1
13892,1771,864,907,239,217,158,63,839,439,400,101,86,102,43,1
13893,515,274,241,85,42,77,23,640,279,361,102,83,69,21,1
13894,1050,473,577,142,119,87,54,414,216,198,51,32,42,28,1
13895,646,316,330,89,95,48,17,303,137,166,54,54,31,15,1
13896,641,341,300,101,91,29,22,724,334,390,112,109,79,17,1
13897,235,135,100,30,13,25,11,171,88,83,20,21,16,7,1
13898,410,222,188,54,49,43,13,858,448,410,98,83,122,29,1
13899,808,419,389,109,87,86,32,101,59,42,11,17,10,1,1
13900,452,236,216,73,54,50,29,416,210,206,55,54,39,20,1
13901,1447,698,749,214,180,116,46,355,165,190,53,56,42,19,1
13902,843,391,452,139,104,91,34,781,418,363,92,90,64,41,1
13903,205,101,104,34,25,34,8,976,522,454,123,108,100,54,1
13904,134,54,80,29,35,5,8,289,125,164,51,55,17,10,1
13905,756,366,390,83,146,47,23,213,109,104,26,26,21,6,1
13906,461,257,204,48,37,78,28,148,87,61,20,13,21,11,1
13907,470,230,240,67,60,42,16,873,381,492,98,137,76,78,1
13908,330,159,171,48,38,50,19,347,194,153,53,44,40,10,1
13909,987,515,472,107,110,106,61,377,184,193,56,53,44,14,1
13910,2644,1346,1298,391,304,315,148,393,186,207,58,50,36,22,1
13911,475,238,237,73,53,63,17,873,381,492,98,137,76,78,1
13912,785,374,411,56,42,38,25,1721,838,883,241,218,144,54,1
13913,400,195,205,63,67,40,18,409,200,209,69,56,44,13,1
13914,265,119,146,44,52,12,9,1512,695,817,264,166,111,31,1
13915,528,340,188,45,41,57,16,233,121,112,24,31,30,7,1
13916,1333,646,687,209,179,148,45,1290,629,661,191,187,167,55,1
13917,556,269,287,86,66,62,22,906,485,421,112,98,112,39,1
13918,393,186,207,58,50,36,22,215,80,135,54,56,21,9,1
13919,259,109,150,55,19,27,29,1613,806,807,190,211,180,84,1
13920,1290,597,693,182,182,119,63,353,166,187,82,42,41,16,1
13921,512,261,251,79,73,60,21,280,133,147,44,38,40,12,1
13922,224,96,128,40,37,23,6,642,271,371,106,111,57,23,1
13923,229,105,124,36,33,12,4,618,290,328,82,74,69,42,1
13924,1591,734,857,229,225,171,75,510,252,258,75,60,57,24,1
13925,1093,568,525,149,131,128,38,199,108,91,36,24,24,9,1
13926,803,358,445,135,117,80,44,138,80,58,22,20,8,6,1
13927,336,186,150,54,38,47,11,332,185,147,47,40,49,13,1
13928,684,288,396,107,90,54,42,158,85,73,24,18,18,8,1
13929,604,227,377,106,102,45,33,202,102,100,29,35,6,9,1
13930,279,106,173,48,35,41,39,616,296,320,69,76,49,48,1
13931,512,261,251,79,73,60,21,316,156,160,34,28,32,14,1
13932,1007,523,484,116,113,117,43,462,224,238,77,75,37,13,1
13933,606,279,327,81,70,49,34,399,208,191,57,46,41,20,1
13934,140,81,59,16,15,15,12,1336,724,612,209,141,133,60,1
13935,270,130,140,48,44,37,12,1461,741,720,176,155,140,45,1
13936,901,458,443,91,129,86,21,745,391,354,85,81,52,39,1
13937,374,181,193,63,49,46,20,413,227,186,45,34,58,23,1
13938,95,44,51,14,13,7,4,210,121,89,22,23,23,7,1
13939,1009,487,522,177,121,103,51,633,303,330,95,91,51,13,1
13940,526,254,272,44,43,49,13,1210,592,618,157,138,116,85,1
13941,757,373,384,115,93,95,25,764,277,487,158,162,64,31,1
13942,900,484,416,119,110,77,29,429,187,242,79,72,28,19,1
13943,509,341,168,35,32,52,15,412,238,174,41,38,43,19,1
13944,964,408,556,131,153,76,55,323,181,142,40,37,26,16,1
13945,673,317,356,101,85,76,49,595,316,279,86,60,65,40,1
13946,164,77,87,33,19,6,7,503,260,243,46,56,33,16,1
13947,316,156,160,34,28,32,14,620,335,285,70,41,62,33,1
13948,446,246,200,64,48,54,12,358,212,146,51,36,33,9,1
13949,440,235,205,34,61,36,13,297,158,139,47,37,37,9,1
13950,178,91,87,20,21,12,5,703,356,347,96,97,38,22,1
13951,280,156,124,36,19,20,13,119,67,52,15,15,7,7,1
13952,805,419,386,94,99,111,35,485,273,212,52,47,51,17,1
13953,337,171,166,46,27,33,16,482,231,251,76,81,64,26,1
13954,339,170,169,32,17,24,13,303,187,116,41,23,23,9,1
13955,298,138,160,50,37,22,6,245,111,134,31,44,20,11,1
13956,450,242,208,53,63,56,22,307,133,174,48,53,27,10,1
13957,1210,592,618,157,138,116,85,149,68,81,15,38,11,10,1
13958,1039,597,442,101,110,106,33,2813,1331,1482,320,339,261,290,1
13959,3122,1486,1636,416,387,297,209,895,474,421,122,93,69,25,1
13960,346,174,172,36,43,21,9,403,220,183,57,39,45,11,1
13961,465,229,236,68,62,40,22,907,455,452,132,117,80,40,1
13962,485,187,298,95,71,61,25,201,42,159,19,3,2,75,1
13963,838,380,458,114,95,68,57,154,78,76,23,21,13,5,1
13964,611,246,365,116,82,71,27,512,248,264,66,71,49,30,1
13965,1251,635,616,155,215,101,48,743,233,510,148,142,28,17,1
13966,2054,882,1172,361,347,147,68,248,144,104,24,30,21,15,1
13967,381,189,192,74,49,44,13,425,244,181,38,26,60,26,1
13968,549,303,246,64,54,59,35,767,392,375,113,112,83,13,1
13969,887,385,502,144,122,110,34,247,110,137,34,45,23,10,1
13970,574,287,287,94,70,63,25,95,41,54,15,16,8,5,1
13971,426,204,222,73,63,49,9,212,100,112,34,31,20,10,1
13972,1738,821,917,242,196,181,58,676,295,381,94,71,65,24,1
13973,204,99,105,32,32,22,10,1834,823,1011,297,282,151,63,1
13974,350,224,126,34,14,48,18,362,233,129,37,17,51,18,1
13975,954,521,433,135,118,78,26,3144,1617,1527,367,342,278,136,1
13976,775,324,451,130,140,45,15,1133,491,642,192,170,61,29,1
13977,149,68,81,15,38,11,10,920,492,428,100,92,88,49,1
13978,1210,494,716,205,174,107,41,2725,1490,1235,339,333,254,78,1
13979,673,329,344,111,95,92,41,425,202,223,74,56,48,18,1
13980,864,362,502,142,150,70,19,425,210,215,56,43,52,25,1
13981,257,136,121,29,26,39,8,244,136,108,21,25,25,13,1
13982,780,369,411,130,113,79,35,503,263,240,72,55,51,34,1
13983,595,316,279,86,60,65,40,870,489,381,97,99,76,14,1
13984,626,333,293,64,55,61,15,2813,1331,1482,320,339,261,290,1
13985,389,176,213,81,59,24,7,406,212,194,50,52,24,18,1
13986,1290,629,661,191,187,167,55,864,429,435,129,118,68,35,1
13987,1154,540,614,195,160,138,66,1863,721,1142,262,283,139,74,1
13988,398,217,181,38,44,49,14,336,210,126,26,20,38,13,1
13989,589,296,293,99,76,64,29,358,170,188,54,55,20,10,1
13990,341,154,187,34,36,11,11,271,110,161,33,27,11,8,1
13991,208,115,93,31,27,22,19,131,66,65,21,14,23,7,1
13992,461,207,254,82,66,55,33,545,230,315,91,101,50,16,1
13993,154,78,76,22,25,12,10,687,353,334,84,96,74,31,1
13994,504,259,245,73,56,45,29,2442,1193,1249,278,183,170,145,1
13995,390,191,199,66,49,43,12,209,78,131,33,42,11,7,1
13996,594,303,291,84,69,72,31,585,322,263,77,66,74,40,1
13997,540,269,271,51,70,43,26,1154,540,614,195,160,138,66,1
13998,473,212,261,72,64,45,28,509,262,247,64,70,64,20,1
13999,247,110,137,34,45,23,10,694,260,434,122,92,62,36,1
14000,255,134,121,36,40,29,13,330,143,187,63,29,52,20,1
14001,785,391,394,83,116,74,20,790,384,406,93,120,79,16,1
14002,1721,809,912,268,234,144,50,864,429,435,129,118,68,35,1
14003,930,411,519,138,137,86,24,582,282,300,81,66,71,18,1
14004,624,204,420,166,101,32,13,567,291,276,82,65,59,22,1
14005,454,191,263,61,66,38,15,424,198,226,57,46,41,19,1
14006,598,288,310,86,79,46,15,1190,638,552,162,95,112,18,1
14007,267,147,120,37,28,35,12,359,184,175,49,35,32,11,1
14008,933,536,397,96,90,71,41,628,341,287,77,59,55,31,1
14009,601,290,311,92,89,55,30,248,119,129,33,48,20,10,1
14010,1970,978,992,245,206,198,80,471,221,250,87,68,42,25,1
14011,335,143,192,45,36,32,37,1154,540,614,195,160,138,66,1
14012,73,29,44,10,14,6,3,508,267,241,43,35,25,17,1
14013,977,492,485,135,122,116,35,334,172,162,43,39,41,17,1
14014,461,223,238,66,57,36,23,246,115,131,15,29,10,32,1
14015,812,427,385,109,81,69,35,219,124,95,22,22,23,5,1
14016,259,118,141,21,29,15,23,281,132,149,38,32,38,14,1
14017,921,455,466,144,127,108,39,442,252,190,35,52,20,4,1
14018,350,180,170,64,46,55,12,217,94,123,29,30,23,17,1
14019,1102,511,591,171,179,148,52,704,252,452,100,89,55,25,1
14020,292,163,129,50,27,46,16,480,252,228,55,37,49,20,1
14021,2414,1189,1225,277,178,170,169,1464,693,771,153,136,91,86,1
14022,686,345,341,98,106,75,25,648,307,341,101,58,76,34,1
14023,509,254,255,67,55,52,35,219,104,115,25,31,25,11,1
14024,335,170,165,39,36,34,16,128,67,61,19,13,15,4,1
14025,538,268,270,58,72,42,25,249,90,159,29,89,12,4,1
14026,372,199,173,56,45,40,15,399,208,191,57,46,41,20,1
14027,673,329,344,111,95,92,41,390,191,199,66,49,43,12,1
14028,763,354,409,101,90,63,26,2414,1189,1225,277,178,170,169,1
14029,894,439,455,138,104,106,44,593,295,298,70,85,48,13,1
14030,509,254,255,67,55,52,35,212,107,105,32,25,22,7,1
14031,222,106,116,31,27,27,15,367,161,206,70,48,41,19,1
14032,320,143,177,51,51,24,10,864,362,502,142,150,70,19,1
14033,672,334,338,110,93,91,41,462,228,234,59,47,37,32,1
14034,522,265,257,35,39,38,8,627,289,338,101,73,62,43,1
14035,1074,538,536,154,140,111,51,1354,537,817,245,247,117,57,1
14036,1154,540,614,195,160,138,66,551,299,252,51,62,63,17,1
14037,336,154,182,51,48,39,22,160,53,107,31,29,13,3,1
14038,524,264,260,75,75,40,21,1914,892,1022,272,267,143,79,1
14039,247,110,137,34,45,23,10,1447,698,749,214,180,116,46,1
14040,465,206,259,59,46,40,38,197,106,91,43,19,16,12,1
14041,652,329,323,65,70,51,50,1366,943,423,137,109,58,19,1
14042,142,68,74,21,22,16,4,674,358,316,91,92,97,29,1
14043,336,154,182,51,48,39,22,1047,562,485,141,127,114,41,1
14044,386,191,195,61,54,31,21,201,86,115,33,37,8,7,1
14045,322,160,162,44,52,33,16,1117,423,694,182,134,88,31,1
14046,433,170,263,67,52,48,23,465,225,240,65,44,65,25,1
14047,247,110,137,34,45,23,10,609,335,274,79,57,45,22,1
14048,189,90,99,26,29,17,11,648,307,341,101,58,76,34,1
14049,375,214,161,38,36,24,17,381,184,197,40,33,33,21,1
14050,365,180,185,63,35,48,19,208,96,112,31,32,13,9,1
14051,1122,546,576,140,158,103,50,324,219,105,25,24,27,14,1
14052,344,201,143,42,39,41,14,632,326,306,92,71,56,19,1
14053,718,350,368,85,71,62,31,969,505,464,123,133,92,33,1
14054,270,130,140,48,44,37,12,1290,629,661,191,187,167,55,1
14055,210,116,94,24,28,21,9,511,247,264,75,73,43,24,1
14056,150,74,76,21,22,18,7,184,86,98,26,26,14,11,1
14057,4967,2501,2466,718,692,594,248,5038,2652,2386,655,729,544,245,1
14058,205,104,101,28,28,35,13,170,90,80,22,27,15,4,1
14059,2113,1079,1034,268,209,196,65,1001,483,518,143,134,112,55,1
14060,199,113,86,27,17,10,7,163,80,83,25,21,20,10,1
14061,159,77,82,23,9,18,11,770,374,396,95,91,79,41,1
14062,980,537,443,125,99,98,50,268,104,164,58,37,30,14,1
14063,1006,468,538,151,135,82,39,181,96,85,25,23,20,7,1
14064,950,497,453,146,127,115,43,154,78,76,22,25,12,10,1
14065,743,346,397,91,90,62,10,217,109,108,34,32,35,7,1
14066,287,137,150,36,37,25,7,593,266,327,102,84,69,24,1
14067,570,292,278,80,65,72,23,398,203,195,58,43,54,16,1
14068,583,322,261,73,66,45,26,919,538,381,111,98,103,41,1
14069,463,236,227,64,50,44,29,462,228,234,59,47,37,32,1
14070,575,317,258,48,62,49,55,461,221,240,70,64,56,32,1
14071,543,287,256,71,66,64,23,972,519,453,109,98,120,39,1
14072,461,207,254,82,66,55,33,2524,1232,1292,398,317,186,61,1
14073,894,469,425,127,93,82,31,246,115,131,15,29,10,32,1
14074,509,243,266,80,57,45,19,845,402,443,137,126,105,47,1
14075,553,261,292,73,79,40,26,372,187,185,55,36,45,21,1
14076,256,168,88,18,18,11,5,601,313,288,42,48,25,36,1
14077,622,299,323,86,86,69,35,461,221,240,70,64,56,32,1
14078,493,256,237,64,50,44,39,407,225,182,58,44,44,22,1
14079,227,124,103,33,21,16,19,465,228,237,64,42,63,24,1
14080,1992,927,1065,292,228,166,77,1270,557,713,130,195,57,30,1
14081,640,279,361,102,83,69,21,299,157,142,39,29,27,11,1
14082,528,245,283,79,96,53,14,3259,1163,2096,526,657,162,86,1
14083,615,299,316,106,86,59,31,461,257,204,63,49,50,29,1
14084,452,213,239,79,69,39,18,606,307,299,92,56,68,30,1
14085,657,335,322,92,65,64,29,360,192,168,55,45,48,16,1
14086,825,422,403,100,90,62,43,181,96,85,25,23,20,7,1
14087,317,156,161,49,51,18,10,1474,756,718,175,158,169,51,1
14088,799,377,422,98,95,80,70,320,159,161,44,54,29,9,1
14089,624,204,420,166,101,32,13,248,118,130,54,31,26,5,1
14090,1360,600,760,233,199,123,40,183,91,92,21,29,16,10,1
14091,299,153,146,32,28,29,12,1170,627,543,131,136,132,47,1
14092,398,200,198,68,43,51,14,920,492,428,100,92,88,49,1
14093,1464,693,771,153,136,91,86,595,316,279,86,60,65,40,1
14094,1273,592,681,199,164,139,39,824,397,427,113,95,82,33,1
14095,382,190,192,59,48,40,21,360,188,172,49,48,47,17,1
14096,462,232,230,78,54,42,23,847,467,380,117,101,67,24,1
14097,441,216,225,57,66,57,19,2442,1193,1249,278,183,170,145,1
14098,729,358,371,116,99,89,33,317,153,164,34,52,30,14,1
14099,178,100,78,23,22,30,6,689,343,346,119,100,86,38,1
14100,606,279,327,81,70,49,34,770,374,396,95,91,79,41,1
14101,446,176,270,64,79,45,24,531,286,245,61,45,46,16,1
14102,469,242,227,66,48,48,26,947,482,465,143,107,89,37,1
14103,341,178,163,48,44,42,20,309,154,155,42,44,45,16,1
14104,2477,1186,1291,256,271,249,90,281,166,115,34,17,36,16,1
14105,171,94,77,24,28,30,11,676,331,345,105,98,68,25,1
14106,653,327,326,91,79,55,39,589,294,295,37,44,27,33,1
14107,975,400,575,160,162,62,31,645,297,348,89,105,74,24,1
14108,519,244,275,76,90,44,16,1089,544,545,138,160,117,43,1
14109,474,268,206,66,42,45,24,770,355,415,103,142,75,42,1
14110,1135,624,511,150,118,145,73,595,316,279,86,60,65,40,1
14111,410,211,199,55,42,34,27,425,199,226,54,71,56,11,1
14112,489,242,247,83,63,62,19,246,108,138,39,46,27,10,1
14113,2414,1189,1225,277,178,170,169,295,143,152,38,47,22,25,1
14114,466,233,233,68,72,41,12,1047,562,485,141,127,114,41,1
14115,443,248,195,67,54,40,15,659,325,334,102,85,87,32,1
14116,388,205,183,60,43,41,25,359,213,146,44,40,35,20,1
14117,721,284,437,133,122,55,20,1269,624,645,183,180,136,52,1
14118,204,96,108,31,37,20,5,355,168,187,48,57,30,15,1
14119,1337,667,670,137,143,140,35,1210,592,618,157,138,116,85,1
14120,141,68,73,25,20,12,6,2524,1232,1292,398,317,186,61,1
14121,345,141,204,64,58,13,11,928,442,486,139,118,91,43,1
14122,505,272,233,76,66,57,23,906,455,451,116,105,87,46,1
14123,332,185,147,31,59,7,4,496,251,245,78,62,61,23,1
14124,1024,486,538,186,113,94,51,195,109,86,25,24,17,6,1
14125,1585,741,844,220,242,103,53,217,98,119,33,32,27,7,1
14126,964,408,556,131,153,76,55,568,243,325,98,73,56,44,1
14127,2063,1024,1039,175,117,80,97,1014,490,524,177,137,94,38,1
14128,201,42,159,19,3,2,75,197,92,105,38,16,26,15,1
14129,160,76,84,17,45,13,12,182,71,111,45,36,11,13,1
14130,523,273,250,73,68,44,13,656,336,320,86,90,73,37,1
14131,671,303,368,93,68,61,26,119,67,52,15,15,7,7,1
14132,478,223,255,80,81,41,24,191,99,92,25,24,18,8,1
14133,559,217,342,105,86,42,16,1027,444,583,127,80,80,36,1
14134,268,143,125,43,29,22,10,220,101,119,50,22,23,6,1
14135,519,246,273,78,82,42,16,759,450,309,86,62,80,26,1
14136,524,361,163,41,8,28,16,393,185,208,55,64,37,21,1
14137,296,154,142,38,38,24,16,784,373,411,101,90,91,37,1
14138,1464,715,749,200,167,181,70,537,276,261,75,68,68,22,1
14139,245,112,133,32,45,20,10,1338,756,582,155,105,104,44,1
14140,695,340,355,79,124,53,13,705,396,309,87,48,53,17,1
14141,855,359,496,142,153,53,24,208,99,109,28,30,18,9,1
14142,164,78,86,28,23,12,8,202,102,100,29,35,6,9,1
14143,473,248,225,64,50,38,24,206,94,112,37,36,18,9,1
14144,4588,2261,2327,516,642,497,118,354,137,217,53,57,30,5,1
14145,428,226,202,52,60,75,20,551,298,253,63,65,45,19,1
14146,861,393,468,150,101,69,35,424,198,226,57,46,41,19,1
14147,562,326,236,76,58,71,15,501,216,285,79,70,54,30,1
14148,714,364,350,98,102,91,27,463,250,213,56,45,73,25,1
14149,495,184,311,89,76,34,26,152,74,78,17,20,16,6,1
14150,262,150,112,31,33,31,7,345,203,142,47,35,31,11,1
14151,379,184,195,51,61,49,8,3114,1105,2009,505,603,150,122,1
14152,872,498,374,101,75,106,43,1447,698,749,214,180,116,46,1
14153,656,358,298,67,47,64,26,467,248,219,65,46,45,28,1
14154,454,223,231,38,45,24,19,426,228,198,62,42,47,22,1
14155,224,101,123,45,32,21,3,391,208,183,65,49,57,17,1
14156,1012,411,601,177,174,75,32,392,115,277,117,75,28,17,1
14157,824,397,427,113,95,82,33,280,142,138,35,37,22,13,1
14158,704,358,346,94,83,81,45,549,273,276,74,68,72,24,1
14159,873,381,492,98,137,76,78,357,153,204,84,62,39,2,1
14160,758,360,398,114,107,51,19,196,120,76,29,15,39,10,1
14161,1278,593,685,198,201,71,43,318,164,154,52,43,34,10,1
14162,784,391,393,105,113,86,21,593,266,327,102,84,69,24,1
14163,518,262,256,70,52,49,27,261,130,131,27,41,19,16,1
14164,504,237,267,62,66,48,17,308,163,145,52,36,33,15,1
14165,456,209,247,72,58,40,9,845,402,443,137,126,105,47,1
14166,1771,864,907,239,217,158,63,427,204,223,38,57,26,32,1
14167,356,175,181,58,40,33,26,363,178,185,54,48,21,13,1
14168,607,305,302,92,89,74,23,331,191,140,44,37,45,20,1
14169,825,399,426,128,128,77,32,621,284,337,108,68,50,17,1
14170,423,193,230,60,45,32,35,163,71,92,22,38,11,7,1
14171,938,484,454,137,100,104,41,447,194,253,70,67,57,19,1
14172,185,115,70,19,17,26,6,454,273,181,49,58,33,11,1
14173,713,335,378,94,70,56,35,156,64,92,39,19,15,8,1
14174,815,418,397,97,62,70,17,207,89,118,28,26,16,6,1
14175,54,26,28,11,4,3,3,239,146,93,30,22,35,9,1
14176,461,227,234,61,47,54,33,620,396,224,53,44,97,26,1
14177,387,198,189,48,48,47,23,853,400,453,137,109,88,42,1
14178,798,378,420,99,94,71,63,739,359,380,83,95,53,38,1
14179,482,231,251,76,81,64,26,363,178,185,54,48,21,13,1
14180,169,99,70,26,21,20,7,313,159,154,30,40,23,14,1
14181,465,257,208,51,61,54,23,298,167,131,47,33,40,8,1
14182,522,283,239,65,64,76,22,757,373,384,115,93,95,25,1
14183,288,156,132,37,32,22,11,563,304,259,75,64,68,31,1
14184,815,418,397,97,62,70,17,2217,1239,978,240,244,126,62,1
14185,330,143,187,63,29,52,20,2985,1374,1611,450,433,312,111,1
14186,261,130,131,27,41,19,16,1107,601,506,155,138,104,49,1
14187,645,326,319,97,117,73,14,4563,2219,2344,620,531,527,104,1
14188,453,255,198,62,49,29,19,445,228,217,47,62,53,26,1
14189,243,117,126,26,37,20,9,217,109,108,34,32,35,7,1
14190,356,208,148,42,26,57,15,354,169,185,54,54,41,19,1
14191,1095,530,565,157,151,98,34,204,99,105,32,32,22,10,1
14192,420,197,223,72,57,54,19,857,455,402,135,81,104,40,1
14193,351,184,167,59,45,54,9,149,52,97,36,36,7,4,1
14194,101,41,60,18,19,10,5,882,432,450,115,111,68,44,1
14195,561,210,351,108,77,41,22,277,100,177,35,88,30,2,1
14196,364,185,179,58,53,48,15,391,208,183,65,49,57,17,1
14197,427,254,173,63,28,46,24,149,68,81,15,38,11,10,1
14198,477,301,176,52,35,45,24,462,224,238,77,75,37,13,1
14199,558,302,256,66,62,65,30,803,346,457,126,171,74,24,1
14200,323,181,142,40,37,26,16,446,227,219,58,52,45,26,1
14201,180,96,84,21,22,17,15,193,83,110,26,20,16,9,1
14202,484,254,230,60,66,56,14,930,460,470,129,64,97,40,1
14203,480,234,246,79,77,65,23,219,112,107,24,31,25,9,1
14204,656,358,298,67,47,64,26,633,262,371,76,137,64,22,1
14205,587,260,327,84,69,55,23,536,278,258,72,63,62,20,1
14206,775,407,368,122,100,97,32,660,333,327,102,95,69,31,1
14207,532,269,263,72,59,59,39,424,284,140,51,28,47,20,1
14208,406,211,195,55,37,47,16,488,217,271,71,71,50,32,1
14209,748,355,393,121,91,95,26,426,228,198,62,42,47,22,1
14210,1265,424,841,230,200,86,47,309,154,155,42,44,45,16,1
14211,255,134,121,36,40,29,13,261,127,134,42,37,24,11,1
14212,668,338,330,85,95,68,18,951,506,445,107,118,79,40,1
14213,540,257,283,81,63,57,24,455,218,237,57,51,42,35,1
14214,515,274,241,85,42,77,23,2442,1193,1249,278,183,170,145,1
14215,677,310,367,103,93,70,26,189,90,99,26,29,17,11,1
14216,501,240,261,80,62,49,42,2639,1436,1203,317,307,242,77,1
14217,871,482,389,113,95,109,35,903,437,466,117,112,108,32,1
14218,393,186,207,58,50,36,22,659,325,334,102,85,87,32,1
14219,560,279,281,113,64,58,15,928,442,486,139,118,91,43,1
14220,427,218,209,61,53,45,26,304,159,145,38,40,32,3,1
14221,4655,2074,2581,545,652,562,399,475,238,237,73,53,63,17,1
14222,1123,554,569,142,130,85,36,824,397,427,113,95,82,33,1
14223,551,260,291,81,58,62,35,211,113,98,38,17,25,8,1
14224,170,83,87,30,19,14,16,1338,633,705,199,151,144,65,1
14225,212,93,119,30,27,21,14,297,158,139,47,37,37,9,1
14226,185,115,70,19,17,26,6,632,326,306,92,71,56,19,1
14227,692,326,366,103,121,67,27,277,124,153,44,40,35,18,1
14228,387,198,189,48,48,47,23,125,68,57,19,18,18,6,1
14229,4684,2161,2523,779,782,304,101,1822,879,943,236,227,175,97,1
14230,1341,481,860,275,264,57,21,709,359,350,107,102,65,20,1
14231,556,279,277,83,69,71,19,245,111,134,31,44,20,11,1
14232,456,209,247,72,58,40,9,665,297,368,111,107,34,12,1
14233,511,271,240,64,55,81,23,903,457,446,99,127,62,29,1
14234,1315,720,595,138,136,115,62,1586,815,771,196,135,138,67,1
14235,114,71,43,8,18,7,4,127,82,45,20,6,19,6,1
14236,872,473,399,124,100,93,27,149,68,81,15,38,11,10,1
14237,767,392,375,113,112,83,13,399,222,177,48,44,52,23,1
14238,1273,592,681,199,164,139,39,582,293,289,94,80,77,32,1
14239,346,191,155,52,38,40,13,323,156,167,52,45,39,18,1
14240,350,180,170,64,46,55,12,288,118,170,50,57,18,15,1
14241,1256,595,661,153,143,106,130,208,107,101,42,22,18,10,1
14242,163,71,92,22,38,11,7,2701,957,1744,504,525,160,95,1
14243,976,496,480,128,111,121,48,794,390,404,103,95,86,23,1
14244,680,308,372,81,72,70,40,217,109,108,34,32,35,7,1
14245,789,319,470,129,139,81,35,439,227,212,60,55,58,8,1
14246,251,122,129,39,39,25,7,1657,800,857,249,235,154,51,1
14247,379,203,176,55,48,45,16,492,280,212,56,61,30,13,1
14248,620,307,313,92,91,92,33,1050,482,568,136,154,101,41,1
14249,175,88,87,29,29,23,6,160,67,93,32,37,15,9,1
14250,384,206,178,52,35,39,21,379,203,176,55,48,45,16,1
14251,837,444,393,128,89,87,37,2414,1189,1225,277,178,170,169,1
14252,474,250,224,58,47,37,12,158,85,73,24,18,18,8,1
14253,233,111,122,38,27,17,8,1484,731,753,206,175,187,71,1
14254,876,473,403,110,106,73,24,136,65,71,33,11,9,6,1
14255,243,120,123,30,24,26,13,647,322,325,104,98,54,14,1
14256,1332,626,706,182,144,80,41,1030,368,662,172,188,56,20,1
14257,1462,711,751,219,222,148,65,297,158,139,47,37,37,9,1
14258,501,216,285,79,70,54,30,559,250,309,79,83,62,36,1
14259,245,112,133,32,45,20,10,641,324,317,88,92,49,14,1
14260,846,425,421,126,97,98,38,501,240,261,80,62,49,42,1
14261,351,184,167,59,45,54,9,522,276,246,68,64,31,14,1
14262,817,425,392,120,102,83,26,1034,451,583,165,146,104,40,1
14263,2045,985,1060,359,339,199,74,393,186,207,58,50,36,22,1
14264,282,163,119,40,23,25,17,557,306,251,66,42,52,15,1
14265,527,262,265,62,73,39,49,412,238,174,41,38,43,19,1
14266,451,209,242,73,53,47,36,501,265,236,89,52,45,16,1
14267,201,98,103,26,35,16,5,144,70,74,15,17,13,10,1
14268,3801,1837,1964,510,442,418,170,2177,1034,1143,274,228,201,95,1
14269,158,85,73,24,18,18,8,505,226,279,68,51,30,15,1
14270,1015,466,549,156,153,67,25,193,99,94,31,31,16,12,1
14271,437,225,212,61,57,66,12,489,253,236,73,36,62,17,1
14272,429,219,210,46,66,42,17,206,89,117,43,31,14,6,1
14273,933,536,397,96,90,71,41,457,220,237,78,79,45,23,1
14274,457,237,220,69,44,53,26,592,291,301,92,93,71,31,1
14275,312,172,140,41,40,21,8,208,96,112,31,32,13,9,1
14276,415,134,281,114,65,27,7,213,91,122,42,30,23,12,1
14277,2383,1253,1130,323,292,273,107,1863,721,1142,262,283,139,74,1
14278,365,188,177,60,47,48,16,382,190,192,59,48,40,21,1
14279,853,400,453,137,109,88,42,101,41,60,18,19,10,5,1
14280,624,308,316,92,72,68,22,233,102,131,35,22,24,13,1
14281,930,367,563,181,153,83,48,873,366,507,127,125,75,21,1
14282,488,284,204,43,45,52,21,97,50,47,17,14,14,10,1
14283,178,100,78,23,22,30,6,450,241,209,67,58,54,23,1
14284,527,257,270,72,68,50,28,163,71,92,22,38,11,7,1
14285,145,75,70,22,18,10,5,187,97,90,28,25,21,8,1
14286,348,187,161,48,41,47,15,119,57,62,18,16,17,4,1
14287,1089,544,545,138,160,117,43,304,159,145,38,40,32,3,1
14288,267,161,106,22,25,35,20,261,159,102,19,29,41,11,1
14289,175,88,87,29,29,23,6,183,78,105,30,31,26,8,1
14290,383,181,202,64,43,57,10,487,229,258,68,82,41,24,1
14291,262,144,118,19,39,22,8,509,243,266,80,57,45,19,1
14292,304,160,144,39,30,40,14,128,62,66,13,11,17,12,1
14293,392,218,174,43,42,32,27,140,86,54,17,6,20,7,1
14294,555,278,277,60,70,48,18,1290,629,661,191,187,167,55,1
14295,439,227,212,60,55,58,8,724,334,390,112,109,79,17,1
14296,824,386,438,94,77,81,34,832,428,404,131,89,88,38,1
14297,979,534,445,83,77,80,24,834,465,369,82,84,81,21,1
14298,372,189,183,60,44,41,18,1087,523,564,146,177,103,33,1
14299,803,395,408,127,102,79,31,190,94,96,30,21,13,5,1
14300,277,124,153,44,40,35,18,490,198,292,65,81,39,27,1
14301,229,134,95,25,13,28,10,592,283,309,84,137,60,20,1
14302,654,344,310,80,69,57,15,2442,1193,1249,278,183,170,145,1
14303,3259,1163,2096,526,657,162,86,232,101,131,44,34,19,8,1
14304,1212,645,567,145,117,122,72,149,68,81,15,38,11,10,1
14305,807,359,448,114,99,93,33,450,241,209,67,58,54,23,1
14306,436,209,227,66,47,52,22,719,364,355,104,100,58,34,1
14307,1123,554,569,142,130,85,36,313,155,158,33,39,28,16,1
14308,811,441,370,95,84,95,49,3075,1459,1616,390,359,298,207,1
14309,553,261,292,73,79,40,26,467,226,241,55,48,54,23,1
14310,557,278,279,75,70,66,31,2364,1004,1360,406,426,226,79,1
14311,2752,959,1793,638,192,79,46,743,233,510,148,142,28,17,1
14312,118,63,55,16,11,14,7,703,356,347,96,97,38,22,1
14313,535,251,284,65,78,47,20,395,222,173,48,42,21,8,1
14314,604,272,332,112,62,67,51,1447,751,696,161,143,131,46,1
14315,835,419,416,119,94,106,40,377,202,175,46,50,41,23,1
14316,1190,638,552,162,95,112,18,2045,1063,982,232,215,140,156,1
14317,1395,627,768,172,263,141,59,389,239,150,45,20,46,22,1
14318,588,255,333,94,82,58,27,466,186,280,71,84,30,11,1
14319,182,90,92,25,23,14,5,2230,752,1478,421,460,118,67,1
14320,3075,1459,1616,390,359,298,207,895,474,421,122,93,69,25,1
14321,938,484,454,137,100,104,41,1858,805,1053,271,345,116,41,1
14322,962,430,532,109,142,61,34,1411,472,939,252,262,58,31,1
14323,98,48,50,18,4,9,8,355,220,135,43,26,65,20,1
14324,259,132,127,39,32,28,12,503,263,240,72,55,51,34,1
14325,1192,579,613,120,215,79,24,480,259,221,59,54,50,22,1
14326,1382,689,693,186,176,167,77,536,278,258,72,63,62,20,1
14327,272,94,178,76,33,19,4,1086,603,483,147,121,95,40,1
14328,101,38,63,23,8,9,10,1801,889,912,206,263,126,42,1
14329,502,240,262,78,61,54,32,350,175,175,49,45,44,23,1
14330,388,199,189,50,51,33,14,695,373,322,80,59,89,39,1
14331,771,321,450,151,135,43,15,202,102,100,29,35,6,9,1
14332,845,402,443,137,126,105,47,648,307,341,101,58,76,34,1
14333,508,254,254,74,99,61,12,1366,943,423,137,109,58,19,1
14334,1165,567,598,134,119,158,63,167,89,78,16,14,18,7,1
14335,293,142,151,49,40,42,17,3144,1617,1527,367,342,278,136,1
14336,361,184,177,50,53,51,22,638,260,378,96,100,53,28,1
14337,463,238,225,49,35,31,14,778,367,411,90,85,64,43,1
14338,729,321,408,128,84,63,26,881,419,462,132,82,81,24,1
14339,355,220,135,43,26,65,20,526,264,262,77,71,61,27,1
14340,897,487,410,92,97,83,31,144,70,74,15,17,13,10,1
14341,1106,579,527,121,152,113,45,648,307,341,101,58,76,34,1
14342,217,109,108,34,30,34,5,508,295,213,42,61,53,17,1
14343,925,432,493,137,135,106,43,191,98,93,26,18,19,9,1
14344,2414,1189,1225,277,178,170,169,346,174,172,36,43,21,9,1
14345,749,374,375,99,108,98,37,466,186,280,71,84,30,11,1
14346,550,309,241,65,50,87,31,115,55,60,25,14,7,7,1
14347,284,104,180,54,81,8,10,375,202,173,46,49,41,23,1
14348,1147,483,664,200,195,95,53,706,346,360,118,92,98,56,1
14349,847,467,380,117,101,67,24,191,98,93,26,18,19,9,1
14350,656,358,298,67,47,64,26,806,408,398,119,98,91,27,1
14351,225,113,112,29,45,19,7,1036,511,525,136,89,94,56,1
14352,325,184,141,43,34,22,18,292,153,139,39,33,24,21,1
14353,241,85,156,66,37,18,13,743,233,510,148,142,28,17,1
14354,810,367,443,115,92,94,59,477,256,221,69,66,70,12,1
14355,350,178,172,49,62,29,16,336,140,196,51,44,27,18,1
14356,654,344,310,80,69,57,15,149,68,81,15,38,11,10,1
14357,1202,506,696,209,198,74,44,1912,977,935,247,226,205,65,1
14358,546,285,261,71,49,47,24,616,304,312,75,71,55,25,1
14359,686,345,341,98,106,75,25,366,124,242,80,63,25,8,1
14360,171,94,77,24,28,30,11,1117,556,561,188,117,110,48,1
14361,689,343,346,119,100,86,38,450,275,175,57,32,48,15,1
14362,360,192,168,55,45,48,16,1216,552,664,194,189,110,49,1
14363,938,484,454,137,100,104,41,2472,1055,1417,416,458,235,64,1
14364,528,283,245,77,72,63,11,360,192,168,55,45,48,16,1
14365,412,192,220,71,50,48,23,592,264,328,86,85,62,41,1
14366,729,420,309,73,78,57,37,833,467,366,106,84,105,34,1
14367,764,409,355,88,73,102,43,654,317,337,95,111,44,13,1
14368,872,468,404,129,85,92,34,149,68,81,15,38,11,10,1
14369,601,272,329,100,100,51,22,81,41,40,15,13,3,2,1
14370,391,203,188,49,34,36,9,339,170,169,32,17,24,13,1
14371,686,375,311,89,80,63,20,76,42,34,12,8,5,7,1
14372,446,176,270,64,79,45,24,346,165,181,69,43,22,9,1
14373,298,140,158,51,33,21,22,560,228,332,113,58,79,38,1
14374,274,158,116,27,27,22,18,367,173,194,59,60,32,18,1
14375,381,187,194,37,49,36,17,379,203,176,55,48,45,16,1
14376,428,226,202,52,60,75,20,414,194,220,76,66,49,16,1
14377,480,244,236,74,47,50,21,1132,553,579,172,143,150,57,1
14378,467,226,241,55,48,54,23,161,96,65,8,7,16,16,1
14379,117,60,57,20,17,16,5,703,388,315,82,78,81,37,1
14380,639,287,352,111,108,44,9,724,334,390,112,109,79,17,1
14381,225,111,114,41,35,17,7,840,385,455,118,137,66,39,1
14382,522,235,287,78,67,60,50,462,232,230,78,54,42,23,1
14383,99,50,49,18,11,8,6,355,165,190,53,56,42,19,1
14384,985,518,467,123,111,76,49,215,105,110,27,22,20,9,1
14385,421,219,202,57,36,49,16,803,358,445,135,117,80,44,1
14386,318,176,142,25,32,35,25,1180,598,582,184,63,87,66,1
14387,394,202,192,44,43,38,28,375,202,173,46,49,41,23,1
14388,728,343,385,116,82,96,57,198,107,91,26,18,27,6,1
14389,956,405,551,170,171,64,35,674,268,406,118,96,70,21,1
14390,3623,1788,1835,325,354,507,198,474,208,266,65,69,43,36,1
14391,44,13,31,9,11,1,2,687,353,334,84,96,74,31,1
14392,583,322,261,73,66,45,26,785,374,411,56,42,38,25,1
14393,281,132,149,38,32,38,14,401,166,235,70,42,51,30,1
14394,201,108,93,36,21,17,4,394,202,192,44,43,38,28,1
14395,229,111,118,33,26,13,13,757,373,384,115,93,95,25,1
14396,870,436,434,131,114,72,25,1721,809,912,268,234,144,50,1
14397,989,439,550,142,121,75,29,1100,474,626,197,143,126,41,1
14398,212,107,105,29,26,25,8,452,256,196,32,44,27,11,1
14399,239,126,113,49,18,27,5,822,424,398,107,106,86,46,1
14400,145,75,70,21,18,18,8,1689,821,868,277,250,177,78,1
14401,748,360,388,101,89,82,36,331,169,162,40,28,22,14,1
14402,1102,511,591,171,179,148,52,409,170,239,75,62,25,10,1
14403,559,217,342,105,86,42,16,1210,485,725,205,139,79,34,1
14404,595,309,286,63,54,62,25,624,308,316,92,72,68,22,1
14405,1190,638,552,162,95,112,18,1566,743,823,261,188,151,48,1
14406,298,180,118,43,23,39,12,317,153,164,34,52,30,14,1
14407,620,299,321,75,60,68,30,1140,495,645,129,95,128,159,1
14408,509,214,295,88,76,57,38,189,90,99,26,29,17,11,1
14409,557,211,346,129,125,48,19,140,81,59,16,15,15,12,1
14410,427,191,236,67,60,41,34,461,223,238,66,57,36,23,1
14411,593,266,327,102,84,69,24,1124,578,546,149,127,122,61,1
14412,950,497,453,146,127,115,43,271,161,110,32,34,27,14,1
14413,241,146,95,34,20,21,5,593,266,327,102,84,69,24,1
14414,189,91,98,23,23,21,16,515,253,262,46,83,57,21,1
14415,505,268,237,68,59,34,15,1721,809,912,268,234,144,50,1
14416,287,129,158,48,48,20,9,462,228,234,59,47,37,32,1
14417,395,226,169,57,44,32,8,872,498,374,101,75,106,43,1
14418,656,358,298,67,47,64,26,259,123,136,32,42,21,8,1
14419,626,345,281,62,76,66,25,2468,1038,1430,333,465,167,62,1
14420,339,177,162,40,36,51,24,1074,539,535,136,87,87,66,1
14421,1106,579,527,121,152,113,45,217,109,108,34,32,35,7,1
14422,1308,652,656,166,153,149,87,217,109,108,34,32,35,7,1
14423,177,82,95,24,37,9,12,703,356,347,96,97,38,22,1
14424,443,248,195,67,54,40,15,620,305,315,97,80,87,28,1
14425,634,348,286,72,64,51,28,601,313,288,42,48,25,36,1
14426,1190,537,653,207,186,101,26,864,362,502,142,150,70,19,1
14427,2799,1324,1475,369,371,215,124,191,85,106,24,34,19,5,1
14428,183,97,86,30,18,20,12,2491,1175,1316,303,302,273,147,1
14429,95,44,51,14,13,7,4,224,125,99,33,32,22,6,1
14430,135,65,70,21,25,15,9,230,129,101,29,23,27,10,1
14431,674,268,406,118,96,70,21,712,331,381,111,86,86,34,1
14432,171,94,77,24,28,30,11,686,375,311,89,80,63,20,1
14433,1210,578,632,172,184,94,66,226,120,106,68,8,2,1,1
14434,977,492,485,135,122,116,35,455,218,237,57,51,42,35,1
14435,205,99,106,24,29,20,5,1382,689,693,186,176,167,77,1
14436,427,191,236,67,60,41,34,1189,653,536,152,118,109,56,1
14437,421,192,229,72,54,51,48,380,212,168,47,38,19,11,1
14438,646,355,291,99,62,72,21,432,218,214,57,55,42,11,1
14439,267,130,137,31,18,19,13,162,76,86,18,20,17,11,1
14440,229,120,109,31,30,22,9,276,136,140,39,34,33,9,1
14441,251,122,129,39,39,25,7,586,254,332,114,111,55,17,1
14442,672,334,338,110,93,91,41,647,322,325,104,98,54,14,1
14443,788,360,428,93,106,67,72,583,322,261,73,66,45,26,1
14444,601,313,288,42,48,25,36,537,272,265,75,83,41,29,1
14445,501,240,261,80,62,49,42,233,130,103,26,23,23,6,1
14446,803,358,445,135,117,80,44,998,496,502,149,146,89,27,1
14447,345,203,142,47,35,31,11,341,154,187,34,36,11,11,1
14448,1068,539,529,161,134,132,71,1338,756,582,155,105,104,44,1
14449,360,179,181,63,60,26,12,393,186,207,58,50,36,22,1
14450,435,222,213,67,49,67,12,712,331,381,111,86,86,34,1
14451,418,201,217,53,39,56,15,433,222,211,68,58,42,23,1
14452,530,259,271,83,50,54,41,372,201,171,52,50,42,13,1
14453,1158,481,677,169,129,86,40,331,169,162,40,28,22,14,1
14454,486,236,250,73,67,59,16,758,362,396,115,102,35,13,1
14455,172,88,84,24,31,20,12,462,251,211,74,53,41,18,1
14456,517,196,321,103,98,34,12,291,120,171,63,39,26,6,1
14457,536,278,258,72,63,62,20,317,153,164,39,30,35,13,1
14458,433,226,207,52,60,58,20,462,233,229,66,49,43,30,1
14459,452,236,216,73,54,50,29,538,252,286,77,87,53,30,1
14460,483,236,247,82,60,43,18,1105,544,561,165,167,98,40,1
14461,611,246,365,116,82,71,27,597,246,351,95,98,45,25,1
14462,358,192,166,49,48,49,16,391,208,183,65,49,57,17,1
14463,951,506,445,107,118,79,40,435,221,214,72,45,47,19,1
14464,372,189,183,60,44,41,18,307,150,157,44,23,30,13,1
14465,189,91,97,36,24,13,6,806,419,387,115,130,57,32,1
14466,502,240,262,78,61,54,32,496,272,224,70,58,42,18,1
14467,679,338,341,96,95,40,23,393,186,207,58,50,36,22,1
14468,638,300,338,83,53,81,49,728,343,385,116,82,96,57,1
14469,444,209,235,76,62,62,16,3144,1617,1527,367,342,278,136,1
14470,294,179,115,26,28,38,23,605,283,322,94,72,64,39,1
14471,502,253,249,65,43,60,32,522,235,287,78,67,60,50,1
14472,1100,474,626,197,143,126,41,1149,568,581,177,133,101,30,1
14473,201,86,115,33,37,8,7,83,33,50,14,11,7,9,1
14474,261,130,131,27,41,19,16,934,472,462,119,122,87,39,1
14475,94,45,49,11,20,10,4,377,184,193,50,43,33,17,1
14476,432,218,214,57,55,42,11,196,105,91,26,24,15,9,1
14477,764,397,367,109,76,93,39,202,102,100,29,35,6,9,1
14478,280,156,124,36,19,20,13,375,198,177,48,44,45,22,1
14479,1378,680,698,160,154,111,38,1651,798,853,203,199,137,50,1
14480,195,100,95,27,20,17,11,1436,763,673,160,169,163,77,1
14481,763,354,409,101,90,63,26,832,428,404,131,89,88,38,1
14482,211,83,128,28,35,5,11,297,123,174,51,49,16,10,1
14483,1690,1173,517,186,130,110,56,122,69,53,18,16,20,4,1
14484,328,160,168,37,34,35,12,128,67,61,19,13,15,4,1
14485,921,544,377,99,116,105,32,246,108,138,32,44,21,10,1
14486,574,269,305,91,63,54,27,435,222,213,67,49,67,12,1
14487,357,147,210,48,37,21,47,382,200,182,53,36,51,16,1
14488,235,106,129,38,39,24,12,826,362,464,107,118,71,43,1
14489,659,325,334,102,85,87,32,1032,565,467,133,81,135,49,1
14490,439,177,262,78,73,40,21,1166,597,569,181,132,123,45,1
14491,862,335,527,136,169,47,28,215,105,110,26,22,19,9,1
14492,1141,583,558,141,98,91,45,218,102,116,32,31,21,4,1
14493,391,206,185,56,36,60,17,358,170,188,54,55,20,10,1
14494,410,211,199,55,42,34,27,299,164,135,30,21,29,10,1
14495,200,100,100,28,36,24,12,1108,605,503,147,121,137,58,1
14496,561,210,351,108,77,41,22,137,60,77,37,4,10,6,1
14497,1581,684,897,220,153,118,63,504,259,245,73,56,45,29,1
14498,280,118,162,35,32,41,37,601,290,311,92,89,55,30,1
14499,480,234,246,79,77,65,23,403,185,218,67,62,63,19,1
14500,825,363,462,97,105,72,75,4391,2256,2135,494,411,423,231,1
14501,929,410,519,187,146,53,30,218,133,85,20,19,13,6,1
14502,796,390,406,105,81,106,39,704,356,348,112,94,71,24,1
14503,1132,624,508,199,79,127,41,672,334,338,110,93,91,41,1
14504,362,233,129,37,17,51,18,654,317,337,95,111,44,13,1
14505,419,220,199,52,57,50,24,501,257,244,65,53,57,28,1
14506,297,158,139,47,37,37,9,883,403,480,140,119,85,38,1
14507,906,437,469,135,132,49,40,926,435,491,133,132,85,17,1
14508,350,224,126,34,14,48,18,654,317,337,95,111,44,13,1
14509,586,270,316,83,80,59,21,497,257,240,71,63,62,16,1
14510,163,71,92,33,26,5,7,347,198,149,45,29,29,8,1
14511,240,134,106,21,17,16,11,724,334,390,112,109,79,17,1
14512,482,231,251,76,81,64,26,224,101,123,45,32,21,3,1
14513,467,226,241,55,48,54,23,4646,2328,2318,674,639,475,170,1
14514,936,396,540,96,166,77,29,785,419,366,105,90,64,31,1
14515,255,126,129,36,20,21,29,501,240,261,80,62,49,42,1
14516,724,325,399,98,92,64,24,724,334,390,112,109,79,17,1
14517,374,201,173,51,34,53,24,246,113,133,33,45,22,10,1
14518,267,124,143,45,46,26,4,841,356,485,173,116,27,14,1
14519,777,387,390,90,87,65,37,725,365,360,104,111,70,31,1
14520,557,240,317,97,74,68,37,260,120,140,40,25,30,26,1
14521,277,124,153,44,40,35,18,1341,481,860,275,264,57,21,1
14522,297,123,174,51,49,16,10,218,108,110,28,28,22,10,1
14523,347,169,178,41,37,44,13,264,121,143,57,32,22,15,1
14524,311,175,136,40,30,25,13,307,154,153,39,36,31,12,1
14525,230,115,115,29,29,22,14,635,333,302,99,75,83,28,1
14526,577,277,300,71,59,64,24,514,254,260,55,57,56,19,1
14527,2442,1193,1249,278,183,170,145,631,315,316,64,57,49,15,1
14528,759,365,394,134,108,85,35,1230,623,607,154,156,94,61,1
14529,185,115,70,19,17,26,6,116,67,49,13,12,6,5,1
14530,346,193,153,64,27,41,14,631,332,299,61,104,60,19,1
14531,964,408,556,131,153,76,55,753,318,435,154,95,56,23,1
14532,544,259,285,76,81,40,20,377,184,193,56,53,44,14,1
14533,1134,539,595,150,146,78,40,341,178,163,48,44,42,20,1
14534,191,98,93,26,18,19,9,839,408,431,138,122,105,46,1
14535,947,482,465,143,107,89,37,557,240,317,97,74,68,37,1
14536,1098,519,579,182,159,79,42,294,122,172,46,65,18,11,1
14537,362,207,155,43,34,44,20,353,195,158,40,55,30,13,1
14538,372,189,183,60,44,41,18,418,220,198,69,51,44,16,1
14539,587,326,261,70,61,67,21,225,125,100,33,32,29,12,1
14540,123,61,62,17,18,17,7,649,349,299,90,77,62,26,1
14541,317,153,164,34,52,30,14,149,77,72,19,15,18,9,1
14542,1816,865,951,246,230,189,76,327,177,150,40,40,38,18,1
14543,1807,933,874,248,203,173,71,245,111,134,31,44,20,11,1
14544,694,315,379,101,87,47,17,928,442,486,139,118,91,43,1
14545,1290,629,661,191,187,167,55,359,219,140,42,19,56,19,1
14546,732,385,347,95,69,93,34,212,88,124,46,24,22,16,1
14547,409,208,201,33,45,23,10,361,155,206,43,61,29,18,1
14548,620,299,321,75,60,68,30,1390,695,695,180,137,170,71,1
14549,298,181,117,43,23,40,12,201,42,159,19,3,2,75,1
14550,208,96,112,31,32,13,9,335,128,207,59,43,24,23,1
14551,543,265,278,52,37,54,19,785,374,411,56,42,38,25,1
14552,585,277,308,92,73,61,32,509,214,295,88,76,57,38,1
14553,443,240,203,66,31,57,27,744,384,360,104,96,57,31,1
14554,869,464,405,107,91,89,56,412,202,210,64,46,43,34,1
14555,463,236,227,64,50,44,29,490,224,266,80,70,39,32,1
14556,52,24,28,6,4,3,5,425,198,227,57,69,59,13,1
14557,462,233,229,66,49,43,30,165,83,82,16,29,11,9,1
14558,377,184,193,50,43,33,17,273,148,125,38,31,16,19,1
14559,358,169,189,71,50,39,18,400,203,197,30,36,31,10,1
14560,2414,1189,1225,277,178,170,169,326,140,186,53,36,41,16,1
14561,764,409,355,88,73,102,43,1132,553,579,172,143,150,57,1
14562,486,217,269,110,62,23,10,728,358,370,118,100,55,29,1
14563,1453,611,842,208,192,128,79,756,362,394,102,104,73,25,1
14564,896,407,489,97,152,70,22,424,197,227,67,62,43,17,1
14565,536,278,258,72,63,62,20,198,80,118,35,31,14,7,1
14566,588,303,285,80,59,75,30,377,202,175,46,50,41,23,1
14567,429,219,210,46,66,42,17,521,289,232,71,58,49,16,1
14568,1102,511,591,171,179,148,52,522,235,287,78,67,60,50,1
14569,247,110,137,34,45,23,10,1134,570,564,152,133,131,69,1
14570,780,337,443,112,116,77,28,450,241,209,67,58,54,23,1
14571,419,189,230,64,49,36,15,270,137,133,30,28,27,11,1
14572,313,170,143,51,28,43,6,270,137,133,30,28,27,11,1
14573,113,66,47,11,9,6,5,398,209,189,45,39,38,14,1
14574,770,356,414,123,102,66,25,605,295,310,74,66,70,36,1
14575,647,324,323,101,80,76,43,645,268,377,104,73,55,30,1
14576,1463,521,942,252,204,105,52,164,61,103,47,19,14,5,1
14577,394,202,192,44,43,38,28,656,358,298,67,47,64,26,1
14578,254,117,137,33,35,38,6,468,212,256,70,45,30,18,1
14579,1360,644,716,213,194,136,62,546,285,261,71,49,47,24,1
14580,538,293,245,48,66,45,16,94,55,39,18,6,18,5,1
14581,340,177,163,46,57,37,6,1149,568,581,177,133,101,30,1
14582,2442,1193,1249,278,183,170,145,331,169,162,40,28,22,14,1
14583,815,418,397,97,62,70,17,475,235,240,77,58,43,22,1
14584,672,334,338,110,93,91,41,586,240,346,94,110,29,19,1
14585,1106,579,527,121,152,113,45,728,385,343,110,102,69,14,1
14586,702,349,353,92,75,76,24,290,130,160,47,43,32,11,1
14587,298,167,131,47,33,40,8,1107,601,506,155,138,104,49,1
14588,779,390,389,108,95,95,42,277,124,153,44,40,35,18,1
14589,359,219,140,42,19,56,19,1210,592,618,157,138,116,85,1
14590,89,42,47,16,12,15,6,873,366,507,127,125,75,21,1
14591,219,104,115,43,32,24,11,1914,768,1146,327,268,227,120,1
14592,743,233,510,148,142,28,17,430,192,238,62,67,27,10,1
14593,164,78,86,28,23,12,8,205,100,105,25,25,20,9,1
14594,490,258,232,67,57,57,26,680,351,329,93,97,87,27,1
14595,426,213,213,60,56,46,24,349,152,197,55,47,27,13,1
14596,2524,1232,1292,398,317,186,61,462,233,229,66,49,43,30,1
14597,938,484,454,137,100,104,41,394,207,187,52,42,37,24,1
14598,277,124,153,44,40,35,18,1332,626,706,182,144,80,41,1
14599,350,180,170,64,46,55,12,376,176,200,31,53,27,8,1
14600,437,221,216,62,64,47,13,499,250,249,78,81,46,25,1
14601,525,299,226,54,54,51,19,493,226,267,68,67,54,29,1
14602,198,86,112,24,29,25,15,1480,789,691,195,151,173,55,1
14603,309,106,203,66,49,25,10,339,189,150,34,27,55,13,1
14604,313,149,164,48,31,30,13,859,438,421,142,80,105,43,1
14605,581,212,369,99,116,31,23,854,367,487,127,113,59,59,1
14606,462,251,211,74,53,41,18,926,437,489,135,107,113,42,1
14607,2541,1299,1242,306,302,121,98,799,377,422,98,95,80,70,1
14608,979,492,487,120,122,89,51,216,119,97,33,27,28,7,1
14609,911,449,462,134,111,81,34,467,224,243,70,43,67,23,1
14610,719,364,355,104,100,58,34,1068,527,541,160,131,112,52,1
14611,1615,835,780,189,208,172,86,467,224,243,70,43,67,23,1
14612,247,110,137,34,45,23,10,1616,749,867,263,221,128,34,1
14613,1290,629,661,191,187,167,55,847,402,445,109,91,100,37,1
14614,933,493,440,140,108,124,32,450,241,209,67,58,54,23,1
14615,258,88,170,68,67,14,4,360,168,192,57,49,48,19,1
14616,617,402,215,55,42,109,23,589,314,275,70,83,44,28,1
14617,300,212,88,26,7,38,11,354,169,185,54,54,41,19,1
14618,675,305,370,114,109,60,21,1801,889,912,206,263,126,42,1
14619,452,202,250,83,60,56,19,452,217,235,59,47,60,20,1
14620,175,88,87,29,21,18,5,131,66,65,21,14,23,7,1
14621,559,317,242,58,65,37,23,528,268,260,81,77,36,22,1
14622,96,50,46,8,15,6,2,993,480,513,166,117,75,25,1
14623,250,164,86,22,15,30,4,316,156,160,34,28,32,14,1
14624,347,181,166,27,20,12,12,346,174,172,36,43,21,9,1
14625,772,417,355,118,92,80,23,380,187,193,38,51,30,18,1
14626,870,418,452,145,79,61,85,830,394,436,99,90,64,85,1
14627,522,235,287,78,67,60,50,418,201,217,53,39,56,15,1
14628,4303,2489,1814,436,369,444,134,745,391,354,85,81,52,39,1
14629,418,248,170,41,31,54,9,288,159,129,27,44,27,15,1
14630,336,154,182,51,48,39,22,466,186,280,71,84,30,11,1
14631,484,254,230,60,66,56,14,124,69,55,15,13,12,2,1
14632,372,189,183,60,44,41,18,969,505,464,123,133,92,33,1
14633,103,44,59,16,17,9,5,380,187,193,38,51,30,18,1
14634,261,171,90,21,21,35,17,1247,548,699,168,150,140,43,1
14635,614,263,351,85,84,54,35,462,233,229,66,49,43,30,1
14636,770,390,380,104,76,78,32,255,144,111,23,27,32,11,1
14637,762,363,399,127,85,83,31,360,192,168,55,45,48,16,1
14638,973,513,460,149,93,103,56,724,353,371,94,95,71,31,1
14639,1745,1125,620,193,177,88,24,1838,1168,670,185,225,103,35,1
14640,149,73,76,26,24,17,8,503,263,240,72,55,51,34,1
14641,2524,1232,1292,398,317,186,61,778,367,411,90,85,64,43,1
14642,464,242,222,61,68,36,17,341,190,151,50,41,23,15,1
14643,609,292,317,102,96,64,21,589,281,308,69,39,63,20,1
14644,527,257,270,72,68,50,28,443,198,245,68,72,48,19,1
14645,465,225,240,65,44,65,25,412,193,219,70,56,51,26,1
14646,248,119,129,33,48,20,10,355,179,176,51,45,45,11,1
14647,536,278,258,72,63,62,20,1210,592,618,157,138,116,85,1
14648,393,210,183,55,50,34,19,522,235,287,78,67,60,50,1
14649,532,269,263,72,59,59,39,1038,470,568,130,123,86,51,1
14650,372,193,179,60,43,29,2,366,191,175,37,33,19,19,1
14651,403,185,218,67,62,63,19,1798,844,954,277,212,142,53,1
14652,894,469,425,127,93,82,31,294,148,146,35,33,25,14,1
14653,1116,539,577,149,161,115,43,315,150,165,49,59,23,15,1
14654,472,259,213,51,44,56,21,543,287,256,71,66,64,23,1
14655,407,218,189,34,41,23,17,607,317,290,87,80,73,10,1
14656,549,277,272,93,63,60,26,215,105,110,26,22,19,9,1
14657,982,494,488,150,117,91,45,586,309,277,81,64,76,25,1
14658,1170,627,543,131,136,132,47,547,292,255,51,55,46,28,1
14659,711,344,367,87,109,74,24,4655,2074,2581,545,652,562,399,1
14660,671,321,350,95,87,75,34,208,96,112,31,32,13,9,1
14661,127,55,72,25,18,5,7,281,154,127,45,31,24,9,1
14662,745,366,379,110,93,79,45,503,263,240,72,55,51,34,1
14663,2220,1085,1135,312,304,202,91,512,256,256,77,64,66,24,1
14664,1721,809,912,268,234,144,50,427,218,209,61,53,45,26,1
14665,381,191,190,55,61,33,11,381,188,193,59,60,35,12,1
14666,444,212,232,74,25,60,24,1151,493,658,157,141,108,62,1
14667,427,218,209,61,53,45,26,168,76,92,26,21,19,4,1
14668,1190,638,552,162,95,112,18,841,356,485,173,116,27,14,1
14669,1948,1039,909,242,227,200,67,546,267,279,90,69,56,19,1
14670,495,184,311,89,76,34,26,152,74,78,16,20,16,5,1
14671,378,154,224,74,84,35,22,920,492,428,100,92,88,49,1
14672,976,496,480,128,111,121,48,258,141,117,33,29,23,10,1
14673,91,62,29,12,2,9,6,129,63,66,17,8,13,13,1
14674,193,118,75,20,21,24,6,341,178,163,48,44,42,20,1
14675,509,214,295,88,76,57,38,233,121,112,24,31,30,7,1
14676,782,421,361,101,97,82,20,147,74,73,28,20,24,4,1
14677,975,400,575,160,162,62,31,208,99,109,28,30,18,9,1
14678,614,305,309,96,73,65,24,149,68,81,15,38,11,10,1
14679,870,433,437,133,121,95,25,233,111,122,38,27,17,8,1
14680,2477,1186,1291,256,271,249,90,344,138,206,46,48,24,43,1
14681,579,293,286,68,72,31,47,652,323,329,99,90,65,20,1
14682,355,165,190,53,56,42,19,326,217,109,32,20,43,18,1
14683,870,489,381,97,99,76,14,2322,1315,1007,242,257,220,38,1
14684,480,234,246,79,77,65,23,1807,933,874,248,203,173,71,1
14685,245,112,133,32,45,20,10,430,192,238,62,67,27,10,1
14686,181,71,110,34,30,21,7,354,169,185,54,54,41,19,1
14687,168,120,48,7,5,20,7,274,137,137,35,22,22,10,1
14688,655,269,386,128,129,49,21,660,332,328,84,73,47,19,1
14689,1275,579,696,200,172,125,51,838,431,407,107,90,107,43,1
14690,819,423,396,108,113,96,25,304,159,145,38,40,32,3,1
14691,559,296,263,77,69,42,13,253,127,126,31,25,21,21,1
14692,522,245,277,78,69,52,21,452,224,228,69,56,50,31,1
14693,468,233,235,65,61,49,34,672,334,338,110,93,91,41,1
14694,109,42,67,25,13,1,1,969,505,464,123,133,92,33,1
14695,394,202,192,44,43,38,28,710,307,403,117,176,37,9,1
14696,331,169,162,40,28,22,14,543,265,278,52,37,54,19,1
14697,1084,537,547,154,121,92,35,2492,894,1598,466,444,164,102,1
14698,858,431,427,94,57,54,30,797,434,363,121,103,77,22,1
14699,860,378,482,101,123,82,74,4563,2219,2344,620,531,527,104,1
14700,758,360,398,114,107,51,19,379,192,187,55,47,33,15,1
14701,185,98,87,26,16,25,4,173,95,78,17,16,21,6,1
14702,425,210,215,56,43,52,25,687,353,334,84,96,74,31,1
14703,175,90,85,28,21,19,7,418,204,214,68,66,38,12,1
14704,369,237,132,33,16,38,18,359,174,185,54,56,43,16,1
14705,791,391,400,103,94,59,38,616,304,312,75,71,55,25,1
14706,393,186,207,58,50,36,22,1336,724,612,209,141,133,60,1
14707,468,242,226,58,42,49,19,770,374,396,95,91,79,41,1
14708,318,150,168,60,42,32,12,208,96,112,31,32,13,9,1
14709,267,161,106,22,25,35,20,879,439,440,120,108,101,30,1
14710,769,362,407,99,88,66,67,275,140,135,34,24,32,15,1
14711,1482,762,720,156,144,154,52,261,144,117,34,22,31,15,1
14712,317,164,153,47,33,47,12,522,235,287,78,67,60,50,1
14713,753,346,407,122,101,94,33,149,68,81,15,38,11,10,1
14714,1785,857,928,246,225,187,93,404,197,207,57,69,33,15,1
14715,574,314,260,69,52,78,15,448,209,239,36,53,46,52,1
14716,95,44,51,14,13,7,4,1531,691,840,270,226,143,52,1
14717,352,212,140,37,17,61,20,201,94,107,25,31,27,6,1
14718,233,130,103,26,23,23,6,455,218,237,57,51,42,35,1
14719,1272,520,752,235,242,117,54,125,58,67,34,14,6,2,1
14720,2442,1193,1249,278,183,170,145,305,166,139,42,38,28,12,1
14721,756,265,491,129,127,51,17,505,247,258,72,71,60,27,1
14722,1093,407,686,158,205,49,31,822,374,448,134,118,76,39,1
14723,1290,597,693,182,182,119,63,247,133,114,41,25,41,8,1
14724,317,152,165,43,40,27,26,1308,652,656,166,153,149,87,1
14725,839,427,412,91,83,114,37,786,378,408,101,79,104,35,1
14726,294,146,148,50,45,51,15,367,161,206,70,48,41,19,1
14727,1151,493,658,157,141,108,62,413,236,177,41,25,35,19,1
14728,211,114,97,32,24,19,10,802,370,432,134,111,81,31,1
14729,410,208,202,59,58,43,26,149,68,81,15,38,11,10,1
14730,2442,1193,1249,278,183,170,145,505,269,236,52,59,32,18,1
14731,136,72,64,22,16,7,3,211,83,128,28,35,5,11,1
14732,147,74,73,28,20,24,4,497,284,213,69,53,45,16,1
14733,307,162,145,38,46,41,15,873,411,462,132,107,84,40,1
14734,271,136,135,37,30,18,10,691,307,384,93,128,45,19,1
14735,1158,481,677,169,129,86,40,462,233,229,66,49,43,30,1
14736,571,204,367,108,89,38,30,708,334,374,105,96,61,37,1
14737,676,333,343,111,89,94,39,2414,1189,1225,277,178,170,169,1
14738,178,100,78,23,22,30,6,590,279,311,103,83,69,30,1
14739,298,167,131,47,33,40,8,415,189,226,69,54,50,21,1
14740,2414,1189,1225,277,178,170,169,425,210,215,56,43,52,25,1
14741,802,344,458,156,136,57,24,351,183,168,55,44,33,9,1
14742,864,429,435,129,118,68,35,1117,423,694,182,134,88,31,1
14743,406,211,195,55,37,47,16,431,201,230,69,39,55,33,1
14744,240,102,138,40,59,18,6,552,285,267,74,51,69,24,1
14745,427,218,209,61,53,45,26,725,339,386,112,122,93,32,1
14746,424,209,215,56,58,45,24,424,284,140,51,28,47,20,1
14747,457,237,220,69,44,53,26,672,334,338,110,93,91,41,1
14748,467,226,241,55,48,54,23,299,140,159,27,59,20,18,1
14749,112,65,47,14,4,6,6,325,169,156,32,37,49,20,1
14750,601,313,288,42,48,25,36,379,197,182,52,38,53,32,1
14751,1360,644,716,213,194,136,62,934,472,462,119,122,87,39,1
14752,462,228,234,59,47,37,32,875,421,454,124,142,98,43,1
14753,310,156,154,27,43,20,6,728,343,385,116,82,96,57,1
14754,309,137,172,51,50,28,14,360,201,159,38,38,34,13,1
14755,271,131,140,47,37,41,11,520,224,296,69,64,31,29,1
14756,463,231,232,66,69,29,18,456,232,224,69,65,30,19,1
14757,667,360,307,76,92,46,27,216,102,114,31,29,21,6,1
14758,467,233,234,83,37,77,22,1580,742,838,208,146,144,71,1
14759,435,208,227,68,64,53,23,1382,689,693,186,176,167,77,1
14760,638,305,333,68,90,70,29,724,334,390,112,109,79,17,1
14761,766,395,371,89,86,127,27,93,54,39,13,9,9,7,1
14762,1226,594,632,189,142,120,47,1071,549,522,133,127,130,59,1
14763,1140,495,645,129,95,128,159,1024,587,437,122,126,84,27,1
14764,351,184,167,59,45,54,9,1827,947,880,198,203,280,65,1
14765,480,234,246,79,77,65,23,382,214,168,49,20,47,23,1
14766,3418,1378,2040,515,464,318,121,432,228,204,59,53,43,15,1
14767,930,477,453,111,92,92,29,313,166,147,47,44,41,10,1
14768,2414,1189,1225,277,178,170,169,100,50,50,17,10,5,3,1
14769,556,259,297,75,69,63,38,320,163,157,44,44,26,15,1
14770,2016,1107,909,214,229,238,111,955,465,490,137,138,119,28,1
14771,905,421,484,110,119,105,34,896,407,489,97,152,70,22,1
14772,356,185,171,37,31,17,21,559,317,242,58,65,37,23,1
14773,186,99,87,30,17,18,8,709,359,350,107,102,65,20,1
14774,1162,548,614,191,166,142,38,1290,597,693,182,182,119,63,1
14775,574,269,305,91,63,54,27,1272,651,621,178,194,79,59,1
14776,319,131,188,51,29,26,31,217,109,108,34,32,35,7,1
14777,236,110,126,31,39,10,8,261,108,153,35,37,16,6,1
14778,940,464,476,116,135,108,58,694,260,434,122,92,62,36,1
14779,425,210,215,56,43,52,25,541,205,336,116,60,77,38,1
14780,299,164,135,30,21,29,10,963,532,431,99,110,105,44,1
14781,456,201,255,82,46,61,43,408,197,211,74,44,53,16,1
14782,216,109,107,32,26,35,10,202,102,100,29,35,6,9,1
14783,1590,726,864,270,237,126,59,1863,721,1142,262,283,139,74,1
14784,476,254,222,58,33,46,23,131,66,65,21,14,23,7,1
14785,452,224,228,69,56,50,31,292,153,139,39,33,24,21,1
14786,465,218,247,64,51,50,42,404,190,214,55,55,35,27,1
14787,384,238,146,38,26,66,19,97,52,45,17,5,7,6,1
14788,413,236,177,41,25,35,19,1006,569,437,133,96,76,36,1
14789,2442,1193,1249,278,183,170,145,509,241,268,67,53,56,13,1
14790,1149,568,581,177,133,101,30,339,183,156,43,45,28,17,1
14791,425,210,215,56,43,52,25,500,209,291,88,49,63,28,1
14792,126,57,69,31,10,10,3,687,353,334,84,96,74,31,1
14793,365,173,192,47,47,29,14,695,340,355,79,124,53,13,1
14794,1748,791,957,281,247,173,25,435,254,181,52,46,48,14,1
14795,2442,1193,1249,278,183,170,145,910,462,448,143,126,90,25,1
14796,672,334,338,110,93,91,41,1220,640,580,160,161,101,43,1
14797,2414,1189,1225,277,178,170,169,320,163,157,44,44,26,15,1
14798,484,254,230,60,66,56,14,153,71,82,28,20,15,7,1
14799,700,348,352,93,115,85,27,307,150,157,44,23,30,13,1
14800,2639,1436,1203,317,307,242,77,213,107,106,28,41,19,5,1
14801,341,178,163,48,44,42,20,218,127,91,27,23,23,10,1
14802,589,294,295,37,44,27,33,505,271,234,56,57,57,26,1
14803,330,157,173,56,42,51,8,424,197,227,67,62,43,17,1
14804,536,278,258,72,63,62,20,382,200,182,53,36,51,16,1
14805,146,71,75,20,17,8,7,233,107,126,40,40,20,16,1
14806,859,395,464,157,119,59,31,598,300,298,68,77,59,21,1
14807,204,103,101,16,32,22,8,136,66,70,33,11,9,3,1
14808,508,251,257,74,53,51,18,626,335,291,77,70,63,28,1
14809,155,74,81,23,19,20,5,215,115,100,27,28,34,16,1
14810,910,524,386,106,97,73,26,208,96,112,31,32,13,9,1
14811,235,106,129,38,39,24,12,1210,578,632,172,184,94,66,1
14812,1074,538,536,154,140,111,51,3097,1431,1666,473,433,300,121,1
14813,347,169,178,41,37,44,13,105,53,52,23,11,12,6,1
14814,391,208,183,65,49,57,17,1257,647,610,156,146,145,35,1
14815,228,92,136,43,39,16,7,90,46,44,14,15,8,3,1
14816,705,396,309,87,48,53,17,217,109,108,34,32,35,7,1
14817,502,240,262,78,61,54,32,278,137,141,47,32,28,20,1
14818,333,192,141,50,48,28,10,443,240,203,66,31,57,27,1
14819,183,97,86,30,18,20,12,272,124,148,51,36,23,27,1
14820,299,164,135,37,29,28,11,2725,1490,1235,339,333,254,78,1
14821,336,140,196,51,44,27,18,406,212,194,50,52,24,18,1
14822,1194,609,585,195,142,105,37,2440,1061,1379,377,326,172,62,1
14823,680,308,372,81,72,70,40,393,186,207,58,50,36,22,1
14824,467,226,241,55,48,54,23,595,316,279,86,60,65,40,1
14825,266,133,133,43,28,30,8,748,355,393,121,91,95,26,1
14826,726,312,414,121,73,82,23,424,198,226,57,46,41,19,1
14827,625,298,327,90,78,57,33,416,209,207,76,45,50,17,1
14828,191,99,92,25,24,18,8,776,346,430,103,102,61,40,1
14829,781,418,363,92,90,64,41,426,228,198,62,42,47,22,1
14830,480,234,246,79,77,65,23,497,227,270,70,63,66,30,1
14831,350,181,169,44,52,43,13,131,74,57,17,14,12,4,1
14832,574,269,305,91,63,54,27,861,393,468,150,101,69,35,1
14833,467,224,243,70,43,67,23,977,407,570,162,172,37,21,1
14834,246,108,138,32,44,21,10,960,409,551,166,134,77,44,1
14835,296,127,169,55,40,29,17,970,484,486,131,134,78,28,1
14836,576,250,326,93,71,34,15,718,283,435,126,127,34,29,1
14837,473,194,279,92,64,57,27,179,102,77,23,20,6,3,1
14838,1074,538,536,154,140,111,51,198,98,100,30,21,21,8,1
14839,968,452,516,150,144,79,28,673,300,373,77,92,57,22,1
14840,418,199,219,55,44,22,15,710,361,349,81,98,63,26,1
14841,390,208,182,47,53,32,12,4128,2104,2024,581,505,453,205,1
14842,606,279,327,81,70,49,34,425,210,215,56,43,52,25,1
14843,326,166,160,49,45,36,12,295,143,152,38,47,22,25,1
14844,218,133,85,20,19,13,6,339,170,169,32,17,24,13,1
14845,1500,793,707,169,159,117,70,140,74,66,24,18,21,2,1
14846,205,91,114,31,32,23,12,191,72,119,40,41,17,8,1
14847,984,466,518,159,139,97,42,211,114,97,32,24,19,10,1
14848,758,421,337,95,73,116,28,100,61,39,13,12,10,4,1
14849,480,252,228,55,37,49,20,326,166,160,49,45,36,12,1
14850,271,131,140,47,37,41,11,969,505,464,123,133,92,33,1
14851,725,365,360,104,111,70,31,172,74,98,32,30,11,7,1
14852,104,52,52,18,14,17,4,736,388,348,88,85,67,28,1
14853,1023,527,496,148,122,132,46,509,283,226,69,53,44,21,1
14854,400,207,193,30,36,12,10,537,276,261,75,68,68,22,1
14855,499,250,249,78,81,46,25,815,418,397,97,62,70,17,1
14856,466,186,280,71,84,30,11,246,124,122,31,28,25,5,1
14857,351,184,167,59,45,54,9,380,212,168,47,38,19,11,1
14858,391,206,185,56,36,60,17,1498,615,883,226,244,60,46,1
14859,1242,587,655,276,98,179,46,172,71,101,31,39,11,10,1
14860,482,268,214,54,53,52,19,493,226,267,68,67,54,29,1
14861,597,313,284,87,75,82,28,395,222,173,48,42,21,8,1
14862,514,283,231,60,60,52,19,716,364,352,107,80,75,26,1
14863,802,388,414,131,105,96,29,103,56,47,27,7,8,2,1
14864,509,262,247,64,70,64,20,158,71,87,23,21,17,12,1
14865,764,409,355,88,73,102,43,699,376,323,79,53,86,41,1
14866,142,77,65,24,16,12,6,245,157,88,25,16,26,10,1
14867,420,197,223,72,57,54,19,344,201,143,42,39,41,14,1
14868,212,106,106,35,19,15,9,703,356,347,96,97,38,22,1
14869,362,211,151,46,35,42,12,385,179,206,58,56,38,19,1
14870,684,311,373,109,99,66,16,974,462,512,145,134,82,37,1
14871,1948,1039,909,242,227,200,67,802,388,414,101,93,88,35,1
14872,873,366,507,127,125,75,21,956,450,506,122,117,82,36,1
14873,217,134,83,40,16,26,5,294,148,146,35,33,25,14,1
14874,736,337,399,97,95,53,32,770,355,415,103,142,75,42,1
14875,188,119,69,24,15,26,12,352,212,140,37,17,61,20,1
14876,422,211,211,73,61,43,17,401,167,234,56,71,16,10,1
14877,521,265,256,56,44,35,12,925,484,441,112,86,84,31,1
14878,1114,581,533,145,132,126,54,360,188,172,49,48,47,17,1
14879,671,303,368,93,68,61,26,514,226,288,71,66,63,32,1
14880,294,122,172,46,65,18,11,710,307,403,117,176,37,9,1
14881,529,314,215,59,64,39,14,267,127,140,43,42,24,9,1
14882,540,271,269,80,77,51,16,456,220,236,67,75,30,21,1
14883,163,71,92,33,26,5,7,832,428,404,131,89,88,38,1
14884,847,452,395,100,94,81,36,969,505,464,123,133,92,33,1
14885,2440,1061,1379,377,326,172,62,380,148,232,81,69,24,8,1
14886,297,158,139,47,37,37,9,1447,814,633,171,141,183,58,1
14887,595,292,303,79,83,69,24,540,271,269,80,77,51,16,1
14888,600,254,346,104,100,44,17,1855,852,1003,329,264,184,83,1
14889,176,106,70,30,15,18,5,525,303,222,57,47,84,36,1
14890,226,129,97,20,25,26,11,495,233,262,64,39,49,32,1
14891,258,141,117,39,35,27,8,390,207,183,50,48,38,15,1
14892,270,147,123,41,21,41,18,1748,791,957,281,247,173,25,1
14893,585,312,273,57,64,77,25,1247,620,627,134,149,142,58,1
14894,923,476,447,144,105,96,38,2803,1300,1503,392,510,170,57,1
14895,695,340,355,79,124,53,13,478,239,239,65,66,65,21,1
14896,433,229,204,60,59,53,24,540,306,234,74,52,43,22,1
14897,171,91,80,27,13,23,4,2472,1057,1415,331,352,159,96,1
14898,2027,896,1131,340,313,172,86,1336,828,508,166,121,152,48,1
14899,979,492,487,120,122,89,51,304,127,177,61,38,31,4,1
14900,269,134,135,42,35,27,13,910,431,479,138,103,98,41,1
14901,240,125,115,34,32,30,8,458,222,236,69,39,35,18,1
14902,605,295,310,74,66,70,36,610,281,329,54,62,65,58,1
14903,546,267,279,90,69,56,19,326,141,185,57,39,33,20,1
14904,476,235,241,62,57,34,22,520,224,296,69,64,31,29,1
14905,686,375,311,89,80,63,20,205,94,111,29,31,16,7,1
14906,346,183,163,51,38,23,6,697,373,324,105,83,95,38,1
14907,780,369,411,130,113,79,35,108,51,57,16,12,16,11,1
14908,136,65,71,33,11,9,6,191,72,119,40,41,17,8,1
14909,1024,510,514,152,122,131,52,432,228,204,59,53,43,15,1
14910,352,167,185,49,44,37,16,202,102,100,29,35,6,9,1
14911,425,210,215,56,43,52,25,399,201,198,65,45,48,17,1
14912,1970,978,992,245,206,198,80,429,227,202,49,51,46,26,1
14913,991,537,454,134,99,80,34,706,320,386,111,76,75,51,1
14914,131,66,65,21,14,23,7,467,250,217,64,49,63,39,1
14915,385,179,206,58,56,38,19,601,313,288,42,48,25,36,1
14916,697,373,324,105,83,95,38,782,330,452,119,123,25,16,1
14917,258,113,145,43,44,16,7,220,113,107,31,21,25,12,1
14918,465,225,240,65,44,65,25,411,171,240,61,81,30,15,1
14919,187,96,91,30,24,24,4,360,192,168,55,45,48,16,1
14920,1328,648,680,220,151,112,40,261,130,131,27,41,19,16,1
14921,659,325,334,102,85,87,32,182,114,68,13,22,25,8,1
14922,926,435,491,133,132,85,17,149,68,81,15,38,11,10,1
14923,862,432,430,113,83,100,41,748,360,388,101,89,82,36,1
14924,1049,484,565,120,117,59,26,931,476,455,101,101,44,24,1
14925,949,512,437,102,124,70,41,1085,529,556,149,133,126,54,1
14926,1231,603,628,121,162,109,120,1669,1162,507,154,128,86,51,1
14927,247,110,137,34,45,23,10,449,240,209,59,55,63,20,1
14928,596,256,340,100,87,43,18,297,158,139,47,37,37,9,1
14929,324,174,150,37,24,35,27,501,240,261,80,62,49,42,1
14930,570,292,278,80,65,72,23,712,396,316,78,69,65,25,1
14931,556,279,277,83,69,71,19,592,291,301,92,93,71,31,1
14932,744,569,175,71,37,51,25,201,42,159,19,3,2,75,1
14933,583,322,261,73,66,45,26,1333,646,687,209,179,148,45,1
14934,502,299,203,57,52,32,11,620,305,315,97,80,87,28,1
14935,252,121,131,42,34,12,16,821,387,434,121,131,76,29,1
14936,423,247,176,58,55,29,20,737,320,417,112,94,73,34,1
14937,673,329,344,111,95,92,41,745,366,379,110,93,79,45,1
14938,484,192,292,118,68,83,22,401,167,234,56,71,16,10,1
14939,436,201,235,54,37,34,20,1801,889,912,206,263,126,42,1
14940,394,183,211,65,60,35,18,1273,592,681,199,164,139,39,1
14941,319,154,165,41,41,38,21,479,233,246,68,66,36,21,1
14942,3075,1459,1616,390,359,298,207,574,318,256,73,61,66,22,1
14943,1129,500,629,171,148,85,30,424,191,233,76,73,49,13,1
14944,764,277,487,158,162,64,31,339,170,169,32,17,24,13,1
14945,292,162,130,43,27,21,12,298,160,138,37,30,22,12,1
14946,415,209,206,60,67,39,18,510,262,248,60,64,44,17,1
14947,757,373,384,115,93,95,25,1071,549,522,133,127,130,59,1
14948,245,112,133,32,45,20,10,1190,537,653,207,186,101,26,1
14949,509,254,255,67,55,52,35,236,110,126,31,39,10,8,1
14950,233,111,122,38,27,17,8,817,425,392,120,102,83,26,1
14951,345,203,142,47,35,31,11,551,298,253,63,65,45,19,1
14952,140,74,66,24,18,21,2,1243,650,593,158,159,98,55,1
14953,168,82,86,30,23,19,10,151,75,76,21,22,9,5,1
14954,1132,553,579,172,143,150,57,359,219,140,42,19,56,19,1
14955,190,94,96,25,24,18,5,211,113,98,38,17,25,8,1
14956,165,83,82,16,29,11,9,175,88,87,29,29,23,6,1
14957,631,309,322,106,83,89,33,675,311,364,111,80,96,30,1
14958,1174,579,595,174,135,132,42,1103,536,567,171,156,81,43,1
14959,291,146,145,39,45,22,16,456,220,236,67,75,30,21,1
14960,171,91,80,27,13,23,4,138,79,59,16,13,11,7,1
14961,673,329,344,111,95,92,41,1147,483,664,200,195,95,53,1
14962,326,154,172,45,39,20,10,347,198,149,45,29,29,8,1
14963,656,358,298,67,47,64,26,410,194,216,60,47,47,26,1
14964,688,323,365,121,69,55,22,448,236,212,53,64,56,24,1
14965,794,402,392,96,84,86,30,2813,1331,1482,320,339,261,290,1
14966,432,190,242,85,82,28,11,293,145,148,49,41,25,9,1
14967,464,242,222,61,68,36,17,620,305,315,97,80,87,28,1
14968,522,245,277,78,69,52,21,293,142,151,49,40,42,17,1
14969,1354,537,817,245,247,117,57,686,334,352,107,93,73,43,1
14970,446,221,225,50,44,45,22,595,316,279,86,60,65,40,1
14971,250,114,136,45,42,18,8,445,228,217,47,62,53,26,1
14972,770,374,396,95,91,79,41,515,253,262,46,83,57,21,1
14973,559,296,263,77,69,42,13,140,76,64,17,13,13,8,1
14974,247,110,137,34,45,23,10,256,134,122,29,42,14,7,1
14975,167,86,81,21,21,11,11,451,238,213,53,64,56,22,1
14976,252,146,106,23,19,25,7,526,254,272,44,43,49,13,1
14977,593,266,327,102,84,69,24,750,347,403,105,103,83,29,1
14978,103,51,52,15,17,6,5,1938,796,1142,343,356,142,79,1
14979,394,202,192,44,43,38,28,740,374,366,117,95,84,33,1
14980,69,29,40,14,9,1,3,437,225,212,61,57,66,12,1
14981,482,231,251,76,81,64,26,261,130,131,27,41,19,16,1
14982,639,322,317,73,82,39,23,425,210,215,56,43,52,25,1
14983,671,306,365,114,76,49,19,277,124,153,44,40,35,18,1
14984,908,489,419,114,131,79,46,440,215,225,76,74,29,16,1
14985,364,216,148,36,20,50,30,1562,742,820,219,231,104,46,1
14986,1074,538,536,154,140,111,51,870,489,381,97,99,76,14,1
14987,1102,511,591,171,179,148,52,416,201,215,54,52,39,25,1
14988,1503,691,812,145,265,133,35,307,150,157,44,23,30,13,1
14989,304,159,145,38,40,32,3,304,144,160,54,31,22,10,1
14990,1015,457,558,110,160,49,26,537,276,261,75,68,68,22,1
14991,587,260,327,84,69,55,23,554,269,285,60,67,38,21,1
14992,465,225,240,65,44,65,25,575,225,350,106,74,68,29,1
14993,222,106,116,31,27,27,15,144,70,74,15,17,13,10,1
14994,317,164,153,47,33,47,12,401,166,235,70,42,51,30,1
14995,802,388,414,101,93,88,35,870,489,381,97,99,76,14,1
14996,798,455,343,99,71,112,32,195,86,109,31,37,19,5,1
14997,894,459,435,126,109,78,46,191,72,119,40,41,17,8,1
14998,517,289,228,61,56,64,17,217,109,108,34,32,35,7,1
14999,1150,506,644,154,176,124,52,215,80,135,54,56,21,9,1
15000,458,210,248,39,38,25,16,347,181,166,27,20,12,12,1
15001,729,321,408,128,84,63,26,706,346,360,118,92,98,56,1
15002,480,234,246,79,77,65,23,433,221,212,59,42,47,14,1
15003,632,326,306,92,71,56,19,651,323,328,90,65,64,24,1
15004,489,253,236,73,36,62,17,552,285,267,74,51,69,24,1
15005,444,183,261,74,69,44,35,341,178,163,48,44,42,20,1
15006,942,423,519,130,126,104,50,547,287,260,96,64,51,16,1
15007,911,449,462,134,111,81,34,465,225,240,65,44,65,25,1
15008,505,268,237,68,59,34,15,191,99,92,25,24,18,8,1
15009,462,228,234,59,47,37,32,224,125,99,33,32,22,6,1
15010,211,83,128,28,35,5,11,220,113,107,31,21,25,12,1
15011,673,313,360,101,101,46,17,755,348,407,109,98,49,23,1
15012,512,261,251,79,73,60,21,659,325,334,102,85,87,32,1
15013,429,219,210,46,66,42,17,184,80,104,43,29,10,8,1
15014,509,254,255,67,55,52,35,229,116,113,34,27,27,15,1
15015,434,237,197,52,64,37,14,921,462,459,140,126,83,55,1
15016,724,334,390,112,109,79,17,1154,540,614,195,160,138,66,1
15017,676,333,343,111,89,94,39,304,127,177,61,38,31,4,1
15018,1210,592,618,157,138,116,85,525,245,280,59,72,47,21,1
15019,573,319,254,60,60,52,32,503,263,240,72,55,51,34,1
15020,1320,566,754,235,198,122,36,815,478,337,104,80,103,27,1
15021,2063,1024,1039,175,117,80,97,595,316,279,86,60,65,40,1
15022,322,160,162,44,52,33,16,552,285,267,74,51,69,24,1
15023,340,176,164,50,50,33,13,339,183,156,43,45,28,17,1
15024,593,266,327,102,84,69,24,504,245,259,64,54,42,14,1
15025,465,225,240,65,44,65,25,476,270,206,62,45,46,30,1
15026,150,81,69,23,21,13,5,513,362,151,36,25,97,33,1
15027,695,291,404,107,69,73,13,632,280,352,111,96,55,16,1
15028,427,218,209,61,53,45,26,347,198,149,45,29,29,8,1
15029,261,130,131,27,41,19,16,298,167,131,47,33,40,8,1
15030,624,204,420,166,101,32,13,119,59,60,29,10,6,4,1
15031,177,93,84,20,28,17,6,874,431,443,112,120,79,50,1
15032,459,221,238,52,76,33,24,1210,592,618,157,138,116,85,1
15033,868,448,420,108,103,76,25,536,278,258,72,63,62,20,1
15034,647,322,325,104,98,54,14,380,187,193,38,51,30,18,1
15035,501,240,261,80,62,49,42,315,129,186,51,29,24,29,1
15036,487,229,258,68,82,41,24,185,84,101,21,23,18,12,1
15037,441,189,252,73,50,47,23,518,235,283,94,77,55,22,1
15038,840,468,372,96,85,121,29,193,110,83,18,20,15,12,1
15039,501,240,261,80,62,49,42,260,120,140,40,25,30,26,1
15040,429,219,210,46,66,42,17,271,159,112,34,34,33,7,1
15041,544,295,249,84,56,49,14,536,278,258,72,63,62,20,1
15042,625,342,283,62,53,56,28,513,274,239,67,66,62,35,1
15043,528,269,259,79,73,72,21,1117,556,561,188,117,110,48,1
15044,170,85,85,15,24,12,11,676,386,290,102,53,78,19,1
15045,3224,1440,1784,455,440,333,126,216,119,97,33,27,28,7,1
15046,473,224,249,82,63,48,24,424,209,215,56,58,45,24,1
15047,2414,1189,1225,277,178,170,169,1863,721,1142,262,283,139,74,1
15048,289,125,164,51,55,17,10,403,195,208,68,48,37,16,1
15049,215,115,100,27,28,34,16,241,115,126,35,30,17,14,1
15050,201,103,98,18,25,40,18,390,203,187,58,40,43,19,1
15051,367,195,172,57,54,43,16,758,362,396,115,102,35,13,1
15052,556,269,287,86,66,62,22,750,347,403,105,103,83,29,1
15053,499,252,247,75,71,65,25,758,362,396,115,102,35,13,1
15054,385,181,204,48,41,52,36,412,216,196,24,48,18,16,1
15055,330,166,164,57,51,36,16,789,362,427,90,82,70,35,1
15056,454,191,263,61,66,38,15,393,210,183,55,50,34,19,1
15057,317,165,152,33,50,27,9,365,186,179,48,47,42,13,1
15058,671,326,345,111,77,74,11,694,260,434,122,92,62,36,1
15059,743,366,377,41,37,26,14,794,390,404,103,95,86,23,1
15060,480,256,224,67,55,26,22,1464,987,477,137,141,55,31,1
15061,340,169,171,49,42,31,14,327,177,150,40,40,38,18,1
15062,134,72,62,14,28,8,4,143,79,64,16,25,7,5,1
15063,374,202,172,58,40,41,7,454,242,212,54,42,61,24,1
15064,91,50,41,8,14,4,5,102,49,53,14,21,7,4,1
15065,146,83,63,19,12,13,8,815,418,397,97,62,70,17,1
15066,596,288,308,77,51,58,30,518,235,283,94,77,55,22,1
15067,309,154,155,42,44,45,16,339,150,189,55,60,34,12,1
15068,79,38,41,19,11,17,4,462,251,211,74,53,41,18,1
15069,556,279,277,83,69,71,19,854,380,474,137,159,81,31,1
15070,433,221,212,59,42,47,14,2556,1169,1387,248,291,227,275,1
15071,1258,590,668,190,198,127,62,467,224,243,70,43,67,23,1
15072,394,202,192,44,43,38,28,736,413,323,102,78,74,22,1
15073,3695,1922,1773,449,360,352,261,475,208,267,84,67,50,20,1
15074,582,330,252,82,69,87,21,615,312,303,86,54,75,45,1
15075,387,235,152,34,34,24,13,2161,1233,928,269,199,178,42,1
15076,201,108,93,36,21,17,4,528,228,300,60,119,43,28,1
15077,114,71,43,8,18,7,4,122,52,70,24,22,7,6,1
15078,399,208,191,57,46,41,20,954,521,433,135,118,78,26,1
15079,686,375,311,89,80,63,20,231,126,105,37,26,29,6,1
15080,309,144,165,54,39,25,12,467,221,246,98,68,43,11,1
15081,447,179,268,81,49,35,29,810,352,458,126,122,71,39,1
15082,390,203,187,58,40,43,19,625,342,283,62,53,56,28,1
15083,702,358,344,113,87,81,30,3801,1837,1964,510,442,418,170,1
15084,427,204,223,38,57,26,32,356,199,157,43,58,29,12,1
15085,633,305,328,90,56,22,23,411,209,202,69,43,18,15,1
15086,211,113,98,38,17,25,8,161,73,88,23,22,15,8,1
15087,1278,593,685,198,201,71,43,466,186,280,71,84,30,11,1
15088,597,291,306,104,92,80,29,202,102,100,29,35,6,9,1
15089,277,173,104,26,12,48,19,626,345,281,62,76,66,25,1
15090,672,334,338,110,93,91,41,655,269,386,128,129,49,21,1
15091,466,242,224,66,53,53,13,289,143,146,38,18,40,8,1
15092,108,59,49,17,13,12,5,4870,2464,2406,658,676,550,245,1
15093,345,203,142,47,35,31,11,169,64,105,23,37,11,3,1
15094,473,224,249,82,63,48,24,505,226,279,68,51,30,15,1
15095,393,186,207,58,50,36,22,205,106,99,28,26,23,3,1
15096,840,385,455,118,137,66,39,419,175,244,71,73,23,23,1
15097,903,457,446,99,127,62,29,418,213,205,54,70,38,18,1
15098,356,171,185,51,59,24,11,503,263,240,72,55,51,34,1
15099,168,67,101,37,17,13,13,103,49,54,21,21,10,2,1
15100,1366,943,423,137,109,58,19,770,355,415,103,142,75,42,1
15101,282,171,111,30,38,15,8,236,121,115,26,45,28,6,1
15102,467,250,217,64,49,63,39,246,115,131,15,29,10,32,1
15103,461,207,254,82,66,55,33,1424,650,774,152,124,95,87,1
15104,522,235,287,78,67,60,50,304,127,177,61,38,31,4,1
15105,537,272,265,75,83,41,29,354,166,188,53,55,40,19,1
15106,802,388,414,131,105,96,29,372,201,171,52,50,42,13,1
15107,238,151,87,15,14,35,18,825,363,462,97,105,72,75,1
15108,758,338,420,132,87,67,29,1152,556,596,146,159,31,39,1
15109,261,143,118,33,24,32,16,491,270,221,51,47,53,18,1
15110,911,423,488,140,150,102,32,412,260,152,39,24,49,23,1
15111,562,281,281,80,61,67,23,1074,538,536,190,131,157,35,1
15112,606,343,263,69,65,66,22,767,392,375,113,112,83,13,1
15113,381,191,190,55,61,33,11,903,457,446,99,127,62,29,1
15114,920,492,428,100,92,88,49,729,325,404,129,88,64,32,1
15115,393,186,207,58,50,36,22,347,181,166,27,20,12,12,1
15116,204,84,120,39,39,18,10,301,150,151,41,30,17,11,1
15117,33423,16370,17053,4965,4756,2786,883,167,77,90,22,25,11,11,1
15118,672,334,338,110,93,91,41,1134,574,560,157,164,47,48,1
15119,577,241,336,112,109,47,21,547,292,255,51,55,46,28,1
15120,377,180,197,45,63,19,17,392,160,232,68,70,19,8,1
15121,605,302,303,50,108,39,18,385,181,204,48,41,52,36,1
15122,1006,551,455,115,97,110,41,259,143,116,39,37,23,9,1
15123,245,112,133,32,45,20,10,657,293,364,109,75,66,28,1
15124,711,344,367,87,109,74,24,770,355,415,103,142,75,42,1
15125,785,374,411,56,42,38,25,706,320,386,111,76,75,51,1
15126,498,198,300,122,70,83,16,490,205,285,119,63,82,23,1
15127,158,85,73,24,18,18,8,455,218,237,57,51,42,35,1
15128,225,116,109,29,19,25,6,112,59,53,12,17,14,8,1
15129,583,322,261,73,66,45,26,1255,666,589,145,142,120,82,1
15130,1594,660,934,251,272,117,77,1074,538,536,154,140,111,51,1
15131,1052,574,478,139,101,128,39,703,354,349,84,81,40,25,1
15132,441,201,240,70,58,55,24,414,194,220,76,66,49,16,1
15133,326,153,173,63,48,25,8,553,333,220,61,43,72,36,1
15134,499,249,250,79,63,61,22,894,420,474,136,146,93,39,1
15135,366,213,153,48,27,42,17,426,200,226,75,56,39,24,1
15136,436,246,190,59,45,57,28,494,266,228,64,60,58,28,1
15137,3801,1837,1964,510,442,418,170,476,234,242,72,66,35,10,1
15138,665,341,324,109,79,38,22,313,157,156,39,26,34,29,1
15139,313,160,153,51,33,43,23,431,228,203,66,46,59,15,1
15140,659,325,334,102,85,87,32,796,390,406,105,81,106,39,1
15141,815,418,397,97,62,70,17,1738,821,917,242,196,181,58,1
15142,360,168,192,57,49,48,19,876,457,419,88,124,67,47,1
15143,1139,536,603,162,139,109,50,432,228,204,59,53,43,15,1
15144,673,317,356,101,85,76,49,2524,1232,1292,398,317,186,61,1
15145,2696,1169,1527,432,347,193,146,920,492,428,100,92,88,49,1
15146,390,191,199,57,49,45,25,279,161,118,37,21,22,9,1
15147,589,314,275,70,83,44,28,808,366,442,130,133,66,31,1
15148,394,202,192,44,43,38,28,249,105,144,71,26,13,7,1
15149,566,287,279,77,66,34,14,183,91,92,21,29,16,10,1
15150,247,110,137,34,45,23,10,712,338,374,102,88,61,21,1
15151,671,318,353,83,124,46,34,529,274,255,57,62,38,14,1
15152,586,270,316,83,80,59,21,391,204,187,47,48,38,18,1
15153,222,105,117,37,44,6,18,923,480,443,110,114,98,55,1
15154,1119,621,498,145,144,85,47,753,361,392,99,94,66,16,1
15155,504,237,267,62,66,48,17,653,389,264,69,59,51,19,1
15156,168,82,86,30,23,19,10,418,226,192,57,57,53,17,1
15157,1427,542,885,246,269,69,46,2549,1331,1218,366,296,271,130,1
15158,624,204,420,166,101,32,13,317,153,164,39,30,35,13,1
15159,1290,597,693,182,182,119,63,332,173,159,48,40,31,11,1
15160,185,115,70,19,17,26,6,308,170,138,38,35,45,14,1
15161,103,44,59,16,17,9,5,768,354,414,133,106,79,42,1
15162,491,232,259,80,65,54,21,445,225,220,47,62,53,26,1
15163,777,387,390,90,87,65,37,593,291,302,81,85,56,20,1
15164,920,492,428,100,92,88,49,2540,1065,1475,426,322,239,78,1
15165,263,159,104,30,27,31,11,832,448,384,110,91,82,31,1
15166,366,211,155,35,42,24,12,224,151,73,19,13,42,16,1
15167,110,67,43,9,10,11,8,357,147,210,48,37,21,47,1
15168,1722,774,948,199,192,158,167,2912,1266,1646,268,360,243,422,1
15169,456,256,200,48,37,53,22,357,169,188,61,53,32,15,1
15170,722,310,412,134,81,46,24,416,209,207,76,45,50,17,1
15171,938,484,454,137,100,104,41,1115,589,526,142,108,136,50,1
15172,256,148,108,31,16,29,12,269,133,136,30,41,34,17,1
15173,431,216,215,46,40,33,9,816,463,353,99,99,61,26,1
15174,786,378,408,106,98,77,39,433,237,196,60,52,33,27,1
15175,646,316,330,89,95,48,17,430,239,191,63,42,51,19,1
15176,318,176,142,25,32,35,25,1978,807,1171,323,310,129,70,1
15177,522,265,257,35,39,38,8,876,457,419,88,124,67,47,1
15178,625,298,327,90,78,57,33,846,356,490,102,79,88,34,1
15179,431,202,229,57,50,50,25,1863,721,1142,262,283,139,74,1
15180,313,178,135,43,18,35,6,360,192,168,55,45,48,16,1
15181,501,240,261,80,62,49,42,846,349,497,149,114,57,33,1
15182,298,138,160,50,37,22,6,255,122,133,35,51,22,13,1
15183,854,380,474,137,159,81,31,1512,737,775,238,209,156,57,1
15184,157,78,79,18,29,16,10,225,102,123,32,32,31,15,1
15185,1519,823,696,204,195,110,45,758,362,396,115,102,35,13,1
15186,297,148,149,64,35,37,15,391,208,183,65,49,57,17,1
15187,1210,592,618,157,138,116,85,968,452,516,150,144,79,28,1
15188,380,184,196,58,52,46,8,424,284,140,51,28,47,20,1
15189,846,425,421,126,97,98,38,1149,568,581,177,133,101,30,1
15190,465,225,240,65,44,65,25,514,226,288,71,66,63,32,1
15191,489,242,247,83,63,62,19,508,267,241,43,35,25,17,1
15192,646,316,330,89,95,48,17,245,111,134,31,44,20,11,1
15193,619,332,287,95,77,74,38,624,308,316,92,72,68,22,1
15194,158,85,73,24,18,18,8,339,183,156,43,45,28,17,1
15195,862,409,453,149,125,86,29,736,388,348,88,85,67,28,1
15196,362,205,157,51,36,64,15,211,114,97,32,24,19,10,1
15197,90,52,38,15,7,6,9,95,49,46,12,12,11,12,1
15198,647,282,365,104,90,53,27,694,260,434,122,92,62,36,1
15199,729,358,371,116,99,89,33,377,184,193,56,53,44,14,1
15200,439,177,262,78,73,40,21,873,366,507,127,125,75,21,1
15201,1032,526,506,129,117,119,47,825,363,462,97,105,72,75,1
15202,390,191,199,66,49,43,12,281,166,115,34,17,36,16,1
15203,987,515,472,107,110,106,61,333,167,166,45,30,34,14,1
15204,240,128,112,29,16,26,7,834,465,369,82,84,81,21,1
15205,318,176,142,25,32,35,25,223,76,147,49,29,31,5,1
15206,413,227,186,47,64,26,16,521,265,256,69,69,61,26,1
15207,384,224,160,42,37,58,22,503,263,240,72,55,51,34,1
15208,559,296,263,77,69,42,13,211,114,97,32,24,19,10,1
15209,305,155,150,63,37,30,8,1320,599,721,177,156,104,47,1
15210,419,204,215,67,64,20,9,925,484,441,112,86,84,31,1
15211,460,251,209,61,48,43,21,1149,568,581,177,133,101,30,1
15212,2644,1346,1298,391,304,315,148,1863,721,1142,262,283,139,74,1
15213,620,348,272,91,43,59,29,217,109,108,34,32,35,7,1
15214,158,71,87,23,21,17,12,866,417,449,131,126,92,39,1
15215,6907,2887,4020,1056,1159,566,267,377,202,175,46,50,41,22,1
15216,484,182,302,124,66,20,8,305,95,210,88,27,15,9,1
15217,1248,584,664,184,164,155,67,538,252,286,77,87,53,30,1
15218,375,125,250,85,76,17,13,437,212,225,66,44,44,11,1
15219,375,202,173,46,49,41,23,282,165,117,26,34,37,11,1
15220,925,484,441,112,86,84,31,245,111,134,31,44,20,11,1
15221,608,336,272,61,49,78,31,636,336,300,94,65,58,32,1
15222,4655,2074,2581,545,652,562,399,2541,1299,1242,306,302,121,98,1
15223,665,341,324,92,88,59,27,469,253,216,49,51,48,18,1
15224,1861,896,965,265,187,156,70,375,202,173,46,49,41,23,1
15225,253,148,105,31,15,39,16,395,222,173,48,42,21,8,1
15226,204,84,120,29,30,16,9,224,99,125,27,37,14,3,1
15227,329,148,181,44,38,36,21,223,132,91,18,16,27,17,1
15228,233,102,131,35,22,24,13,358,179,179,49,48,49,8,1
15229,186,84,102,27,29,21,10,724,334,390,112,109,79,17,1
15230,479,233,246,68,66,36,21,1087,536,551,123,115,122,55,1
15231,605,263,342,73,103,54,18,2442,1193,1249,278,183,170,145,1
15232,1256,595,661,153,143,106,130,930,367,563,181,153,83,48,1
15233,103,51,52,15,17,6,5,102,49,53,14,21,7,4,1
15234,428,248,180,44,39,28,9,119,67,52,15,15,7,7,1
15235,512,216,296,92,68,51,19,218,102,116,32,31,21,4,1
15236,394,202,192,44,43,38,28,592,283,309,84,137,60,20,1
15237,325,152,173,43,47,28,17,2414,1189,1225,277,178,170,169,1
15238,938,484,454,137,100,104,41,1336,828,508,166,121,152,48,1
15239,1036,511,525,136,89,94,56,598,300,298,68,77,59,21,1
15240,211,112,99,30,15,34,18,660,359,301,81,87,102,31,1
15241,351,184,167,59,45,54,9,380,187,193,38,51,30,18,1
15242,496,269,227,67,55,37,19,509,262,247,64,70,64,20,1
15243,117,65,52,15,16,10,4,97,53,44,13,12,7,5,1
15244,427,186,241,55,52,42,23,175,88,87,29,29,23,6,1
15245,608,308,300,91,84,53,29,854,380,474,137,159,81,31,1
15246,393,186,207,58,50,36,22,1149,568,581,177,133,101,30,1
15247,510,264,246,67,66,38,29,465,225,240,65,44,65,25,1
15248,1242,613,629,174,113,114,53,339,183,156,43,45,28,17,1
15249,399,201,198,65,45,48,17,781,418,363,92,90,64,41,1
15250,551,237,314,95,79,54,17,317,153,164,34,52,30,14,1
15251,1655,891,764,205,245,81,30,1190,537,653,207,186,101,26,1
15252,295,124,171,57,27,31,18,739,324,415,127,89,76,33,1
15253,470,255,215,68,49,83,15,335,143,192,45,36,32,37,1
15254,715,324,391,107,92,71,31,261,130,131,27,41,19,16,1
15255,1006,551,455,115,97,110,41,303,159,144,40,35,35,8,1
15256,683,288,395,125,94,77,39,179,102,77,23,20,6,3,1
15257,221,112,109,31,27,20,10,465,257,208,51,61,54,23,1
15258,452,262,190,61,45,54,19,959,496,463,144,132,75,35,1
15259,505,271,234,56,57,57,26,328,158,170,52,68,45,7,1
15260,264,122,142,33,29,13,13,677,361,316,81,61,42,22,1
15261,307,162,145,38,46,41,15,551,298,253,63,65,45,19,1
15262,3911,1465,2446,610,767,240,133,241,124,117,30,35,24,8,1
15263,556,199,357,125,112,22,13,103,56,47,27,7,8,2,1
15264,396,240,156,62,41,43,11,1447,814,633,171,141,183,58,1
15265,356,182,174,58,48,29,11,202,102,100,29,35,6,9,1
15266,504,237,267,62,66,48,17,364,195,169,50,38,33,12,1
15267,824,403,421,80,150,65,35,4544,2024,2520,579,628,480,403,1
15268,142,69,73,20,27,9,6,202,111,91,28,33,5,3,1
15269,979,480,499,109,108,130,45,1154,540,614,195,160,138,66,1
15270,451,267,184,43,39,50,7,342,208,134,36,31,29,15,1
15271,1893,850,1043,280,340,169,80,331,169,162,40,28,22,14,1
15272,165,76,89,26,24,18,15,201,42,159,19,3,2,75,1
15273,465,225,240,65,44,65,25,399,201,198,65,45,48,17,1
15274,427,236,191,49,54,46,13,716,364,352,107,80,75,26,1
15275,205,91,114,31,32,23,12,281,128,153,47,43,22,14,1
15276,1214,498,716,197,180,121,65,465,228,237,64,42,63,24,1
15277,873,366,507,127,125,75,21,331,193,138,44,37,18,9,1
15278,798,378,420,99,94,71,63,406,215,191,34,46,21,9,1
15279,252,128,124,46,31,18,8,1051,523,528,164,140,126,50,1
15280,454,191,263,61,66,38,15,756,362,394,102,104,73,25,1
15281,385,255,130,37,20,42,16,374,235,139,33,16,72,21,1
15282,235,119,116,31,26,15,13,67,40,27,10,8,7,6,1
15283,2490,1126,1364,352,325,219,89,427,204,223,38,57,26,32,1
15284,468,215,253,65,60,34,13,216,119,97,33,27,28,7,1
15285,465,257,208,51,61,54,23,164,78,86,28,23,12,8,1
15286,758,360,398,114,107,51,19,2157,1171,986,306,238,131,32,1
15287,362,233,129,37,17,51,18,2044,1089,955,267,233,241,109,1
15288,512,216,296,92,68,51,19,743,346,397,91,90,62,10,1
15289,246,108,138,32,44,21,10,1433,675,758,171,176,149,47,1
15290,330,143,187,63,29,52,20,448,209,239,36,53,46,52,1
15291,392,156,236,40,91,28,16,885,437,448,135,130,89,36,1
15292,238,151,87,21,16,24,24,254,146,108,28,35,33,8,1
15293,968,452,516,150,144,79,28,377,202,175,46,50,41,23,1
15294,277,124,153,44,40,35,18,497,185,312,63,92,38,28,1
15295,392,156,236,40,91,28,16,688,376,312,96,90,79,22,1
15296,744,385,359,125,89,90,23,2442,1193,1249,278,183,170,145,1
15297,530,259,271,83,50,54,41,595,316,279,86,60,65,40,1
15298,1162,515,647,191,143,97,35,465,225,240,65,44,65,25,1
15299,969,505,464,123,133,92,33,356,199,157,43,58,29,12,1
15300,367,203,164,41,32,39,20,360,188,172,49,48,47,17,1
15301,428,248,180,44,39,28,9,372,201,171,52,50,42,13,1
15302,425,220,205,60,55,45,18,684,353,331,95,98,77,38,1
15303,420,202,218,67,43,51,15,979,534,445,83,77,80,24,1
15304,561,210,351,108,77,41,22,248,128,120,65,21,27,10,1
15305,548,296,252,71,74,43,28,375,202,173,46,49,41,23,1
15306,215,105,110,26,22,19,9,664,316,348,75,96,53,31,1
15307,404,190,214,55,55,35,27,1247,548,699,168,150,140,43,1
15308,2416,1280,1136,140,374,175,47,1231,603,628,121,162,109,120,1
15309,738,339,399,102,88,68,35,543,287,256,71,66,64,23,1
15310,383,181,202,64,43,57,10,491,227,264,72,82,46,29,1
15311,899,453,446,149,128,78,24,2175,1078,1097,364,275,271,81,1
15312,425,198,227,57,69,59,13,1863,721,1142,262,283,139,74,1
15313,1290,597,693,182,182,119,63,254,146,108,36,20,34,10,1
15314,269,156,113,37,32,17,7,358,212,146,51,36,33,9,1
15315,1034,451,583,165,146,104,40,1801,889,912,206,263,126,42,1
15316,303,137,166,54,54,31,15,377,180,197,45,63,19,17,1
15317,317,153,164,39,30,35,13,1187,631,556,182,139,152,56,1
15318,252,124,128,49,22,19,13,1712,1175,537,179,142,113,46,1
15319,374,213,161,46,43,31,26,2602,1424,1178,314,320,249,75,1
15320,178,85,93,27,21,19,14,325,169,156,32,37,49,20,1
15321,462,217,245,71,60,54,13,335,128,207,51,60,16,8,1
15322,1311,690,621,158,161,128,51,435,221,214,72,45,47,19,1
15323,350,224,126,34,14,48,18,243,113,130,38,35,16,12,1
15324,560,260,300,100,58,29,28,432,228,204,59,53,43,15,1
15325,443,198,245,68,72,48,19,205,90,115,40,32,25,15,1
15326,464,242,222,61,68,36,17,478,215,263,103,72,47,3,1
15327,802,449,353,102,87,82,29,208,110,98,32,25,28,4,1
15328,75,37,38,11,9,5,8,340,162,178,40,39,35,22,1
15329,542,249,293,82,69,58,31,524,237,287,87,75,54,26,1
15330,205,106,99,28,26,23,3,105,53,52,23,11,12,6,1
15331,777,387,390,90,87,65,37,540,269,271,51,70,43,26,1
15332,270,166,104,30,26,28,14,219,124,95,22,22,23,5,1
15333,684,311,373,109,99,66,16,292,154,138,46,29,41,7,1
15334,491,233,258,73,58,56,30,1247,620,627,134,149,142,58,1
15335,247,110,137,34,45,23,10,707,388,319,85,61,68,23,1
15336,1210,578,632,172,184,94,66,2229,1036,1193,337,286,161,62,1
15337,595,339,256,64,36,54,24,2414,1189,1225,277,178,170,169,1
15338,212,120,92,29,27,24,10,177,75,102,28,29,20,12,1
15339,467,226,241,55,48,54,23,475,224,251,72,64,55,20,1
15340,445,230,215,64,62,50,20,201,92,109,27,29,27,8,1
15341,421,192,229,72,54,51,48,591,263,328,95,90,26,13,1
15342,435,187,248,62,51,51,21,246,115,131,15,29,10,32,1
15343,125,52,73,23,23,6,4,1117,423,694,182,134,88,31,1
15344,1395,627,768,172,263,141,59,477,301,176,52,35,45,24,1
15345,119,67,52,15,15,7,7,255,109,146,35,32,23,17,1
15346,399,208,191,57,46,41,20,464,236,228,64,56,53,28,1
15347,605,281,324,111,67,40,44,425,210,215,56,43,52,25,1
15348,4391,2256,2135,494,411,423,231,330,143,187,63,29,52,20,1
15349,297,158,139,47,37,37,9,801,395,406,106,91,61,25,1
15350,455,191,264,68,86,21,19,659,325,334,102,85,87,32,1
15351,247,110,137,34,45,23,10,656,358,298,67,47,64,26,1
15352,350,180,170,64,46,55,12,255,109,146,35,32,23,17,1
15353,825,427,398,79,95,81,48,1242,613,629,174,113,114,53,1
15354,1970,978,992,245,206,198,80,415,219,196,53,55,57,20,1
15355,686,270,416,134,77,92,48,432,190,242,85,82,28,11,1
15356,671,364,307,75,71,58,22,1382,689,693,186,176,167,77,1
15357,652,272,380,116,113,55,27,2472,1057,1415,331,352,159,96,1
15358,625,316,309,77,79,54,34,467,226,241,55,48,54,23,1
15359,819,411,408,108,86,90,58,233,130,103,26,23,23,6,1
15360,627,289,338,101,73,62,43,3685,1574,2111,579,580,303,116,1
15361,722,384,338,94,83,63,35,767,392,375,113,112,83,13,1
15362,579,250,329,90,61,62,45,2440,1061,1379,377,326,172,62,1
15363,177,82,95,24,37,9,12,99,47,52,12,16,6,2,1
15364,258,133,125,24,13,30,11,1474,756,718,175,158,169,51,1
15365,1313,644,669,169,90,111,43,621,310,311,100,106,77,27,1
15366,7968,4016,3952,1072,1051,652,307,33423,16370,17053,4965,4756,2786,883,1
15367,770,356,414,123,102,66,25,2315,1086,1229,231,306,248,64,1
15368,355,168,187,48,57,30,15,196,120,76,29,15,39,10,1
15369,822,402,420,125,107,82,26,825,427,398,79,95,81,48,1
15370,1029,482,547,147,158,71,32,837,399,438,112,144,71,32,1
15371,205,91,114,31,32,23,12,205,94,111,29,31,16,7,1
15372,1273,592,681,199,164,139,39,272,149,123,34,35,21,2,1
15373,489,253,236,73,36,62,17,425,210,215,56,43,52,25,1
15374,728,343,385,116,82,96,57,478,239,239,65,66,65,21,1
15375,546,267,279,90,69,56,19,125,52,73,23,23,6,4,1
15376,89,42,47,16,12,15,6,1434,727,707,210,173,161,54,1
15377,369,176,193,56,53,39,35,1942,947,995,264,198,221,60,1
15378,501,285,216,52,55,62,25,4544,2024,2520,579,628,480,403,1
15379,824,397,427,113,95,82,33,240,167,73,32,12,8,21,1
15380,158,85,73,24,18,18,8,930,367,563,181,153,83,48,1
15381,425,210,215,56,43,52,25,160,53,107,31,29,13,3,1
15382,985,551,434,123,93,91,26,292,154,138,46,29,41,7,1
15383,671,295,376,126,93,61,28,221,110,111,28,32,25,11,1
15384,359,184,175,49,35,32,11,245,142,103,29,20,21,9,1
15385,824,414,410,106,107,91,45,233,94,139,36,37,15,8,1
15386,207,107,100,27,25,20,11,309,161,148,38,34,40,15,1
15387,213,88,125,30,20,12,19,389,201,188,61,64,47,18,1
15388,482,223,259,74,67,39,12,411,171,240,61,81,30,15,1
15389,1074,538,536,154,140,111,51,2541,1299,1242,306,302,121,98,1
15390,273,126,147,54,49,25,18,270,137,133,30,28,27,11,1
15391,678,344,334,85,87,67,46,894,492,402,95,103,88,42,1
15392,150,60,90,27,16,6,3,461,231,230,52,61,26,14,1
15393,703,351,352,104,96,55,13,577,288,289,85,56,40,20,1
15394,465,218,247,64,51,50,42,87,50,37,16,7,10,5,1
15395,191,99,92,25,24,18,8,391,222,169,46,36,30,9,1
15396,477,281,196,56,39,39,13,758,360,398,114,107,51,19,1
15397,354,128,226,63,61,27,7,836,407,429,122,89,61,21,1
15398,33423,16370,17053,4965,4756,2786,883,966,459,507,123,145,83,39,1
15399,930,367,563,181,153,83,48,104,37,67,25,27,10,6,1
15400,834,390,444,133,114,109,34,317,153,164,39,30,35,13,1
15401,570,292,278,80,65,72,23,770,374,396,95,91,79,41,1
15402,727,346,381,106,100,75,41,961,485,476,147,130,83,37,1
15403,898,467,431,101,127,90,53,3224,1440,1784,455,440,333,126,1
15404,189,90,99,26,29,17,11,184,88,96,24,25,14,9,1
15405,178,91,87,20,21,12,5,217,109,108,34,32,35,7,1
15406,275,140,135,38,32,18,5,205,94,111,29,31,16,7,1
15407,1100,474,626,197,143,126,41,977,406,571,151,128,84,47,1
15408,152,79,73,18,13,11,6,1068,539,529,161,134,132,71,1
15409,391,189,202,55,56,56,12,256,148,108,31,16,29,12,1
15410,1139,536,603,162,139,109,50,648,307,341,101,58,76,34,1
15411,515,253,262,46,83,57,21,1154,540,614,195,160,138,66,1
15412,1275,607,668,192,178,136,63,1801,889,912,206,263,126,42,1
15413,358,196,162,58,49,54,9,381,191,190,55,61,33,11,1
15414,802,449,353,102,87,82,29,1290,629,661,191,187,167,55,1
15415,370,190,180,60,52,37,13,748,355,393,121,91,95,26,1
15416,243,117,126,26,37,20,9,601,313,288,42,48,25,36,1
15417,226,118,108,32,30,18,11,317,165,152,33,50,27,9,1
15418,206,85,121,31,42,6,17,340,187,153,30,45,11,10,1
15419,376,183,193,50,50,43,21,930,367,563,181,153,83,48,1
15420,205,106,99,28,26,23,3,196,105,91,22,26,21,8,1
15421,320,159,161,44,54,29,9,1599,806,793,213,237,100,45,1
15422,2416,1280,1136,140,374,175,47,930,463,467,151,83,106,52,1
15423,1050,473,577,142,119,87,54,439,205,234,64,88,41,21,1
15424,712,396,316,78,69,65,25,516,298,218,62,57,49,19,1
15425,476,220,256,65,65,41,21,207,97,110,34,27,22,10,1
15426,191,101,90,21,23,28,5,205,103,102,20,32,21,5,1
15427,673,318,355,61,71,40,31,747,371,376,87,134,54,29,1
15428,671,332,339,103,75,75,31,1392,799,593,150,115,175,56,1
15429,389,210,179,51,37,43,9,1356,672,684,171,172,134,59,1
15430,736,367,369,107,97,46,24,954,521,433,135,118,78,26,1
15431,920,492,428,100,92,88,49,317,153,164,39,30,35,13,1
15432,785,374,411,56,42,38,25,1177,666,511,131,99,88,35,1
15433,461,227,234,61,47,54,33,778,367,411,90,85,64,43,1
15434,1742,805,937,274,217,133,82,356,161,195,52,57,40,17,1
15435,1251,591,660,183,137,106,50,211,109,102,33,27,24,11,1
15436,150,74,76,21,22,18,7,363,182,181,33,55,23,11,1
15437,380,185,195,68,54,32,16,204,96,108,31,37,20,5,1
15438,1194,609,585,195,142,105,37,372,189,183,60,44,41,18,1
15439,251,122,129,39,39,25,7,892,420,472,135,146,98,37,1
15440,360,192,168,55,45,48,16,492,238,254,72,56,49,20,1
15441,130,71,59,30,9,8,1,220,113,107,37,24,16,7,1
15442,653,311,342,106,74,52,28,482,231,251,76,81,64,26,1
15443,666,349,317,87,91,58,20,184,86,98,26,26,14,11,1
15444,3056,1457,1599,438,389,329,168,902,332,570,154,146,75,40,1
15445,515,256,259,68,58,53,33,896,407,489,97,152,70,22,1
15446,261,130,131,27,41,19,16,1014,490,524,177,137,94,38,1
15447,4128,2104,2024,581,505,453,205,331,169,162,40,28,22,14,1
15448,4655,2074,2581,545,652,562,399,501,216,285,79,70,54,30,1
15449,453,255,198,62,49,29,19,1516,764,752,179,155,126,55,1
15450,990,410,580,140,175,44,36,588,255,333,94,82,58,27,1
15451,303,187,116,41,23,23,9,264,126,138,44,26,25,10,1
15452,314,108,206,45,75,34,8,563,255,308,91,111,42,30,1
15453,462,228,234,59,47,37,32,401,226,175,53,18,38,20,1
15454,368,177,191,49,35,50,20,1800,882,918,202,185,186,49,1
15455,834,465,369,82,84,81,21,497,227,270,70,63,66,30,1
15456,501,240,261,80,62,49,42,655,269,386,128,129,49,21,1
15457,802,449,353,102,87,82,29,288,158,130,59,23,21,10,1
15458,330,143,187,63,29,52,20,415,209,206,60,67,39,18,1
15459,1078,498,580,184,164,96,44,670,333,337,95,79,62,21,1
15460,153,81,72,22,18,16,8,324,174,150,37,24,35,27,1
15461,1152,459,693,138,343,75,33,1217,496,721,230,214,94,42,1
15462,2730,1423,1307,425,288,193,85,981,465,516,126,164,112,38,1
15463,2414,1189,1225,277,178,170,169,925,484,441,112,86,84,31,1
15464,396,197,199,75,49,49,16,359,179,180,52,45,48,16,1
15465,1154,540,614,195,160,138,66,1189,559,630,179,147,118,35,1
15466,386,181,205,55,51,57,31,1074,538,536,154,140,111,51,1
15467,766,395,371,89,86,127,27,97,52,45,17,5,7,6,1
15468,948,484,464,134,131,75,27,466,186,280,71,84,30,11,1
15469,573,271,302,56,64,55,18,781,384,397,73,74,57,19,1
15470,262,114,148,46,44,30,16,611,246,365,116,82,71,27,1
15471,1074,538,536,154,140,111,51,512,261,251,79,73,60,21,1
15472,440,218,222,58,66,40,24,128,54,74,30,13,8,7,1
15473,509,262,247,64,70,64,20,280,133,147,44,38,40,12,1
15474,591,366,225,66,42,76,43,246,115,131,15,29,10,32,1
15475,1290,597,693,182,182,119,63,779,392,387,124,79,52,13,1
15476,732,355,377,108,109,79,27,399,184,215,55,81,29,10,1
15477,1321,676,645,166,113,139,59,926,435,491,133,132,85,17,1
15478,1299,517,782,209,222,93,37,240,167,73,32,12,8,21,1
15479,510,264,246,67,66,38,29,426,228,198,62,42,47,22,1
15480,2383,1253,1130,323,292,273,107,677,245,432,129,155,72,11,1
15481,605,295,310,74,66,70,36,780,337,443,112,116,77,28,1
15482,425,199,226,54,71,56,11,607,317,290,87,80,73,10,1
15483,220,113,107,37,24,16,7,221,80,141,48,37,14,10,1
15484,102,28,74,17,47,0,1,778,367,411,90,85,64,43,1
15485,426,213,213,60,56,46,24,803,358,445,135,117,80,44,1
15486,1261,694,567,159,130,136,70,354,169,185,54,54,41,19,1
15487,649,326,323,83,66,87,38,669,340,329,77,61,94,40,1
15488,1463,698,765,194,180,248,80,165,91,74,18,16,16,20,1
15489,736,388,348,88,85,67,28,305,95,210,88,27,15,9,1
15490,2442,1193,1249,278,183,170,145,371,174,197,53,56,43,15,1
15491,554,249,305,100,87,44,13,654,317,337,95,111,44,13,1
15492,461,197,264,86,97,43,10,355,168,187,55,48,40,15,1
15493,532,269,263,72,59,59,39,501,265,236,89,52,45,16,1
15494,482,231,251,76,81,64,26,1085,529,556,149,133,126,54,1
15495,267,159,108,31,13,22,15,425,244,181,38,26,60,26,1
15496,1247,620,627,134,149,142,58,770,355,415,103,142,75,42,1
15497,71,39,32,7,11,6,4,782,372,410,127,111,89,36,1
15498,758,421,337,95,73,116,28,622,299,323,86,86,69,35,1
15499,114,64,50,16,19,14,5,520,261,259,82,76,71,24,1
15500,134,60,74,19,13,10,7,240,125,115,34,32,30,8,1
15501,125,60,65,22,17,14,5,1272,520,752,235,242,117,54,1
15502,1738,821,917,242,196,181,58,796,445,351,96,80,90,38,1
15503,1007,523,484,116,113,117,43,980,537,443,125,99,98,50,1
15504,1149,568,581,177,133,101,30,1663,835,828,224,213,163,63,1
15505,262,151,111,30,17,32,25,507,249,258,54,76,28,20,1
15506,725,328,397,83,85,54,25,145,70,75,24,16,16,20,1
15507,1309,651,658,198,158,113,36,403,185,218,67,62,63,19,1
15508,767,392,375,113,112,83,13,323,162,161,44,28,43,14,1
15509,272,124,148,51,36,23,27,344,168,176,65,44,33,15,1
15510,481,268,213,54,48,53,14,375,214,161,38,36,24,17,1
15511,537,276,261,75,68,68,22,292,152,140,46,38,35,12,1
15512,536,278,258,72,63,62,20,414,207,207,59,47,54,18,1
15513,920,492,428,100,92,88,49,782,421,361,101,97,82,20,1
15514,446,252,194,41,23,54,35,354,169,185,54,54,41,19,1
15515,3623,1788,1835,325,354,507,198,609,279,330,103,98,72,42,1
15516,432,188,244,76,81,26,13,330,157,173,56,42,51,8,1
15517,456,228,228,49,70,32,19,470,199,271,78,84,33,8,1
15518,605,295,310,74,66,70,36,509,262,247,64,70,64,20,1
15519,1562,742,820,219,231,104,46,2468,1038,1430,333,465,167,62,1
15520,361,184,177,50,53,51,22,825,399,426,128,128,77,32,1
15521,577,217,360,100,116,32,24,3144,1617,1527,367,342,278,136,1
15522,288,159,129,27,44,27,15,597,291,306,104,92,80,29,1
15523,241,114,127,32,20,33,10,938,484,454,137,100,104,41,1
15524,325,159,166,42,43,48,15,1382,508,874,334,320,98,36,1
15525,2109,999,1110,332,294,187,89,390,237,153,41,57,22,16,1
15526,151,82,69,16,17,11,7,601,313,288,42,48,25,36,1
15527,805,382,423,109,118,77,33,724,334,390,112,109,79,17,1
15528,1395,627,768,172,263,141,59,841,356,485,173,116,27,14,1
15529,412,238,174,41,38,43,19,110,67,43,9,10,11,8,1
15530,159,84,75,13,28,10,8,160,77,83,14,27,11,10,1
15531,1124,578,546,149,127,122,61,724,334,390,112,109,79,17,1
15532,2524,1232,1292,398,317,186,61,380,187,193,38,51,30,18,1
15533,1332,659,673,174,170,153,55,541,279,262,79,82,31,32,1
15534,351,184,167,59,45,54,9,1858,805,1053,271,345,116,41,1
15535,862,427,435,139,98,100,59,3114,1105,2009,505,603,150,122,1
15536,246,115,131,15,29,10,32,411,149,262,94,42,58,35,1
15537,707,295,412,105,105,66,30,331,169,162,40,28,22,14,1
15538,466,242,224,66,53,53,13,443,250,193,52,23,49,13,1
15539,121,74,47,15,9,6,6,440,250,190,51,35,64,27,1
15540,255,111,144,31,25,21,28,568,243,325,98,73,56,44,1
15541,154,75,79,28,23,16,6,1863,721,1142,262,283,139,74,1
15542,772,417,355,118,92,80,23,360,192,168,55,45,48,16,1
15543,956,484,472,120,128,111,39,749,360,389,91,122,59,37,1
15544,769,362,407,99,88,66,67,532,276,256,57,50,32,19,1
15545,271,120,151,41,31,24,10,790,385,405,121,108,106,39,1
15546,619,292,327,73,73,61,32,356,199,157,43,58,29,12,1
15547,619,292,327,73,73,61,32,2556,1169,1387,248,291,227,275,1
15548,150,81,69,24,23,16,4,406,216,190,59,56,45,15,1
15549,468,238,230,67,69,39,26,788,381,407,77,41,46,35,1
15550,551,298,253,63,65,45,19,149,68,81,15,38,11,10,1
15551,302,138,164,50,36,30,20,1519,823,696,204,195,110,45,1
15552,372,179,193,50,52,33,6,596,286,310,90,89,78,37,1
15553,586,309,277,81,64,76,25,1208,575,633,187,204,117,41,1
15554,1233,635,598,187,149,146,51,511,247,264,75,73,43,24,1
15555,163,70,93,28,21,17,6,225,116,109,29,19,25,6,1
15556,913,408,505,141,125,87,36,595,316,279,86,60,65,40,1
15557,344,181,163,61,37,40,14,503,263,240,72,55,51,34,1
15558,488,217,271,71,71,50,32,466,233,233,65,51,50,32,1
15559,632,280,352,111,96,55,16,710,307,403,117,176,37,9,1
15560,710,307,403,117,176,37,9,408,171,237,84,79,36,9,1
15561,672,334,338,110,93,91,41,1464,715,749,200,167,181,70,1
15562,536,278,258,72,63,62,20,178,100,78,23,22,30,6,1
15563,770,356,414,123,102,66,25,358,204,154,57,41,36,14,1
15564,1395,627,768,172,263,141,59,1212,645,567,145,117,122,72,1
15565,750,347,403,105,103,83,29,1338,633,705,199,151,144,65,1
15566,758,360,398,114,107,51,19,166,78,88,27,25,19,7,1
15567,211,114,97,32,24,19,10,1357,505,852,245,256,70,35,1
15568,851,464,387,109,101,82,34,936,451,485,111,97,92,41,1
15569,204,103,101,16,32,22,8,956,405,551,170,171,64,35,1
15570,330,191,139,40,24,35,18,219,124,95,22,22,23,5,1
15571,862,384,478,127,110,75,42,756,362,394,102,104,73,25,1
15572,626,357,269,81,61,51,26,166,81,85,30,27,13,8,1
15573,1149,568,581,177,133,101,30,928,442,486,139,118,91,43,1
15574,419,197,222,43,33,46,18,1426,807,619,140,99,79,94,1
15575,122,52,70,24,22,7,6,770,356,414,123,102,66,25,1
15576,213,86,127,37,33,5,16,3114,1105,2009,505,603,150,122,1
15577,577,287,290,90,62,42,17,781,418,363,92,90,64,41,1
15578,1858,805,1053,271,345,116,41,317,156,161,49,51,18,10,1
15579,739,393,346,91,91,70,44,1085,529,556,149,133,126,54,1
15580,149,52,97,36,36,7,4,770,374,396,95,91,79,41,1
15581,846,349,497,149,114,57,33,605,283,322,94,72,64,39,1
15582,868,448,420,108,103,76,25,1190,638,552,162,95,112,18,1
15583,1390,695,695,180,137,170,71,519,244,275,76,90,44,16,1
15584,1143,574,569,176,151,123,59,331,193,138,44,37,18,9,1
15585,375,202,173,46,49,41,23,444,255,189,60,46,54,16,1
15586,315,169,146,51,49,27,9,666,370,296,84,61,99,51,1
15587,780,337,443,112,116,77,28,502,299,203,57,52,32,11,1
15588,294,148,146,35,33,25,14,225,111,114,38,22,25,10,1
15589,245,112,133,32,45,20,10,685,315,370,108,99,36,9,1
15590,2157,1033,1124,365,281,199,63,225,102,123,32,32,31,15,1
15591,450,231,219,77,50,76,16,393,186,207,58,50,36,22,1
15592,699,334,365,108,80,70,20,941,448,493,150,118,127,39,1
15593,1149,568,581,177,133,101,30,624,308,316,92,72,68,22,1
15594,185,94,91,23,19,17,9,400,215,185,59,54,33,16,1
15595,583,322,261,73,66,45,26,1342,673,669,178,154,137,94,1
15596,1198,620,578,155,151,147,56,636,336,300,94,65,58,32,1
15597,767,392,375,113,112,83,13,512,261,251,79,73,60,21,1
15598,492,261,231,62,45,64,19,589,294,295,37,44,27,33,1
15599,415,242,173,53,21,70,21,124,69,55,20,10,5,2,1
15600,160,67,93,32,37,15,9,560,244,316,92,118,47,12,1
15601,396,240,156,62,41,43,11,1203,741,462,114,97,141,46,1
15602,347,190,157,47,38,49,10,751,416,335,104,75,130,20,1
15603,540,257,283,81,63,57,24,419,175,244,71,73,23,23,1
15604,2442,1193,1249,278,183,170,145,2089,917,1172,285,306,83,39,1
15605,205,100,105,25,25,20,9,523,275,248,83,56,65,25,1
15606,247,110,137,34,45,23,10,428,214,214,65,67,45,23,1
15607,840,385,455,118,137,66,39,522,235,287,78,67,60,50,1
15608,586,309,277,81,64,76,25,1290,658,632,145,139,94,44,1
15609,223,113,110,31,33,22,12,185,70,115,37,48,15,5,1
15610,620,305,315,97,80,87,28,659,325,334,102,85,87,32,1
15611,461,154,307,98,45,69,37,780,337,443,112,116,77,28,1
15612,228,92,136,43,39,16,7,92,42,50,17,15,13,1,1
15613,442,252,190,35,52,20,4,1838,1168,670,185,225,103,35,1
15614,362,233,129,37,17,51,18,340,162,178,40,39,35,22,1
15615,882,432,450,115,111,68,44,1069,494,575,133,111,110,39,1
15616,453,216,237,58,60,67,20,1152,586,566,131,112,117,42,1
15617,278,146,132,43,27,22,11,391,204,187,47,48,38,18,1
15618,671,303,368,93,68,61,26,1014,490,524,177,137,94,38,1
15619,241,132,109,33,26,27,13,263,159,104,30,27,31,11,1
15620,392,115,277,117,75,28,17,190,100,90,29,12,20,6,1
15621,900,484,416,119,110,77,29,619,292,327,73,73,61,32,1
15622,331,169,162,40,28,22,14,464,236,228,64,56,53,28,1
15623,262,78,184,78,28,32,4,437,167,270,126,95,34,10,1
15624,575,318,257,65,65,70,24,218,127,91,27,23,23,10,1
15625,976,496,480,128,111,121,48,1149,568,581,177,133,101,30,1
15626,870,489,381,97,99,76,14,435,208,227,68,64,53,23,1
15627,1164,622,542,150,143,78,35,1092,562,530,126,91,125,84,1
15628,354,137,217,53,57,30,5,1194,646,548,139,125,127,59,1
15629,1230,623,607,154,156,94,61,745,354,391,116,100,95,46,1
15630,536,278,258,72,63,62,20,568,243,325,98,73,56,44,1
15631,465,240,225,50,54,24,14,305,168,137,48,35,40,9,1
15632,576,250,326,93,71,34,15,753,318,435,154,95,56,23,1
15633,1273,592,681,199,164,139,39,220,113,107,37,24,16,7,1
15634,489,253,236,73,36,62,17,467,226,241,55,48,54,23,1
15635,1272,561,711,178,194,101,34,221,110,111,28,32,25,11,1
15636,281,154,127,45,31,24,9,169,64,105,23,37,11,3,1
15637,221,111,110,42,35,33,6,288,104,184,80,30,39,6,1
15638,520,279,241,62,72,35,25,227,105,122,37,29,19,12,1
15639,593,325,268,84,66,73,24,1290,658,632,145,139,94,44,1
15640,651,323,328,90,65,64,24,313,157,156,39,26,34,29,1
15641,191,98,93,26,18,19,9,503,263,240,72,55,51,34,1
15642,394,202,192,44,43,38,28,445,219,226,61,60,60,21,1
15643,146,75,71,13,32,15,11,734,339,395,135,89,79,36,1
15644,329,165,164,61,44,29,17,509,245,264,85,71,56,22,1
15645,1508,738,770,194,169,119,53,464,236,228,64,56,53,28,1
15646,360,192,168,55,45,48,16,845,402,443,137,126,105,47,1
15647,773,389,384,119,91,79,26,467,269,198,46,51,60,18,1
15648,728,385,343,110,102,69,14,894,492,402,95,103,88,42,1
15649,1231,566,665,164,147,154,103,224,123,101,23,24,33,6,1
15650,592,283,309,84,137,60,20,911,551,360,92,106,107,29,1
15651,231,141,90,28,20,22,16,131,66,65,21,14,23,7,1
15652,979,535,444,123,99,79,34,992,511,481,108,131,70,40,1
15653,209,125,84,20,22,22,6,414,211,203,52,49,40,19,1
15654,220,113,107,37,24,16,7,425,198,227,57,69,59,13,1
15655,158,76,82,18,23,14,8,742,303,439,88,96,86,23,1
15656,246,108,138,39,46,27,10,689,343,346,119,100,86,38,1
15657,187,96,91,30,24,24,4,648,307,341,101,58,76,34,1
15658,429,219,210,46,66,42,17,128,52,76,27,25,11,8,1
15659,680,308,372,81,72,70,40,740,313,427,101,135,40,22,1
15660,117,62,55,24,18,21,2,109,63,46,17,7,16,9,1
15661,400,187,213,57,46,51,16,897,487,410,92,97,83,31,1
15662,228,72,156,42,27,8,7,465,240,225,50,54,24,14,1
15663,702,358,344,113,87,81,30,446,246,200,46,32,53,25,1
15664,297,158,139,47,37,37,9,389,207,182,53,58,52,18,1
15665,224,108,116,31,32,22,8,134,60,74,19,13,10,7,1
15666,229,105,124,36,33,12,4,313,178,135,43,18,35,6,1
15667,312,147,165,52,44,12,13,320,171,149,40,29,30,14,1
15668,911,423,488,140,150,102,32,782,421,361,101,97,82,20,1
15669,418,205,213,69,50,29,15,218,121,97,29,26,21,6,1
15670,158,85,73,24,18,18,8,361,182,179,54,61,36,10,1
15671,208,96,112,31,32,13,9,225,102,123,32,32,31,15,1
15672,676,333,343,111,89,94,39,798,378,420,99,94,71,63,1
15673,201,112,89,28,24,26,9,205,118,87,24,23,20,20,1
15674,1190,638,552,162,95,112,18,955,530,425,128,90,75,59,1
15675,635,333,302,99,75,83,28,217,109,108,34,32,35,7,1
15676,1382,689,693,186,176,167,77,450,241,209,67,58,54,23,1
15677,1117,556,561,188,117,110,48,368,141,227,64,61,24,13,1
15678,480,252,228,55,37,49,20,358,212,146,51,36,33,9,1
15679,2261,1217,1044,271,243,267,101,1544,670,874,236,239,128,49,1
15680,595,272,323,111,107,54,28,605,295,310,74,66,70,36,1
15681,346,174,172,36,43,21,9,380,187,193,38,51,30,18,1
15682,1332,652,680,210,180,155,49,217,109,108,34,32,35,7,1
15683,252,146,106,23,19,25,7,93,45,48,19,15,14,3,1
15684,1970,978,992,245,206,198,80,755,271,484,113,226,61,20,1
15685,259,132,127,39,32,28,12,465,225,240,65,44,65,25,1
15686,191,99,92,25,24,18,8,393,186,207,58,50,36,22,1
15687,163,71,92,22,38,11,7,500,268,232,65,56,28,17,1
15688,737,320,417,112,94,73,34,504,259,245,73,56,45,29,1
15689,676,333,343,111,89,94,39,377,202,175,46,50,41,23,1
15690,771,321,450,151,135,43,15,1134,539,595,150,146,78,40,1
15691,546,279,267,94,60,32,22,209,78,131,33,42,11,7,1
15692,964,408,556,131,153,76,55,343,165,178,57,48,36,14,1
15693,354,169,185,54,54,41,19,450,275,175,57,32,48,15,1
15694,277,135,142,39,31,24,6,648,307,341,101,58,76,34,1
15695,1202,506,696,209,198,74,44,1257,525,732,216,210,79,52,1
15696,2442,1193,1249,278,183,170,145,530,281,249,58,60,33,21,1
15697,461,223,238,45,62,18,35,147,72,75,26,10,17,9,1
15698,266,124,142,44,21,28,26,467,224,243,70,43,67,23,1
15699,499,252,247,74,42,55,14,403,188,215,70,42,41,11,1
15700,854,380,474,137,159,81,31,657,293,364,109,75,66,28,1
15701,377,202,175,46,50,41,22,714,364,350,98,102,91,27,1
15702,171,94,77,24,28,30,11,395,222,173,48,42,21,8,1
15703,375,173,202,50,46,43,25,379,167,212,54,49,32,33,1
15704,311,154,157,47,29,34,13,200,91,109,23,35,13,7,1
15705,128,67,61,19,13,15,4,782,347,435,110,92,74,34,1
15706,1271,599,672,194,175,118,47,1132,553,579,172,143,150,57,1
15707,985,551,434,123,93,91,26,1051,432,619,179,147,126,54,1
15708,821,387,434,121,131,76,29,623,269,354,100,86,62,24,1
15709,1132,646,486,99,102,71,41,145,75,70,22,18,10,5,1
15710,454,224,230,71,39,62,22,93,45,48,19,15,14,3,1
15711,845,402,443,137,126,105,47,1382,689,693,186,176,167,77,1
15712,729,266,463,185,136,34,8,399,194,205,49,102,52,8,1
15713,524,264,260,75,75,40,21,705,396,309,87,48,53,17,1
15714,808,419,389,109,87,86,32,1696,771,925,257,225,149,63,1
15715,979,534,445,83,77,80,24,465,225,240,65,44,65,25,1
15716,551,298,253,63,65,45,19,579,321,258,74,70,47,22,1
15717,128,58,70,22,14,4,7,360,218,142,39,26,50,18,1
15718,1417,598,819,223,188,135,58,476,233,243,76,61,52,21,1
15719,362,233,129,37,17,51,18,796,390,406,110,117,86,33,1
15720,2491,1175,1316,303,302,273,147,247,127,120,43,20,27,14,1
15721,785,374,411,56,42,38,25,360,161,199,72,36,35,13,1
15722,621,301,320,76,64,46,34,396,150,246,103,64,38,3,1
15723,641,324,317,88,92,49,14,184,86,98,26,26,14,11,1
15724,328,184,144,47,24,23,9,215,117,98,43,22,27,5,1
15725,624,308,316,92,72,68,22,495,233,262,64,39,49,32,1
15726,1801,889,912,206,263,126,42,1484,731,753,206,175,187,71,1
15727,357,182,175,53,45,41,26,309,155,154,41,44,45,16,1
15728,734,366,368,121,99,63,39,904,436,468,138,146,82,39,1
15729,514,283,231,60,60,52,19,729,358,371,116,99,89,33,1
15730,1706,830,876,265,209,230,63,227,124,103,37,23,26,10,1
15731,1571,864,707,201,151,137,67,770,385,385,78,83,60,16,1
15732,1562,742,820,219,231,104,46,377,177,200,63,53,44,16,1
15733,268,140,128,33,39,26,9,439,177,262,78,73,40,21,1
15734,356,197,159,50,43,29,17,321,170,151,43,39,25,16,1
15735,468,225,243,80,61,62,22,1132,646,486,99,102,71,41,1
15736,2564,1278,1286,414,406,207,64,3312,1761,1551,403,345,309,127,1
15737,326,141,185,57,39,33,20,3969,1703,2266,619,432,259,144,1
15738,1046,459,587,184,168,58,23,89,42,47,16,12,15,6,1
15739,598,288,310,86,79,46,15,89,42,47,16,12,15,6,1
15740,222,103,119,38,39,4,17,444,218,226,71,64,37,11,1
15741,815,418,397,97,62,70,17,3664,1638,2026,598,519,231,63,1
15742,103,49,54,21,21,10,2,1392,799,593,150,115,175,56,1
15743,1189,559,630,179,147,118,35,1390,695,695,180,137,170,71,1
15744,329,148,181,44,38,36,21,288,135,153,41,31,36,17,1
15745,585,354,231,66,39,80,42,943,496,447,112,98,101,59,1
15746,636,320,316,79,61,67,31,903,437,466,117,112,108,32,1
15747,894,459,435,126,109,78,46,412,193,219,70,56,51,26,1
15748,914,453,461,112,115,79,29,218,121,97,29,26,21,6,1
15749,767,342,425,145,118,80,25,103,49,54,21,21,10,2,1
15750,822,402,420,125,107,82,26,724,334,390,112,109,79,17,1
15751,488,217,271,71,71,50,32,2351,1110,1241,337,269,300,87,1
15752,446,252,194,41,23,54,35,1395,627,768,172,263,141,59,1
15753,327,189,138,42,26,48,14,241,106,135,48,29,17,15,1
15754,687,353,334,84,96,74,31,1722,774,948,199,192,158,167,1
15755,903,437,466,117,112,108,32,352,166,186,55,59,31,16,1
15756,1480,789,691,195,151,173,55,586,254,332,114,111,55,17,1
15757,1424,650,774,152,124,95,87,448,199,249,65,54,38,33,1
15758,382,207,175,55,32,40,13,1464,987,477,137,141,55,31,1
15759,305,95,210,88,27,15,9,288,104,184,80,30,39,6,1
15760,788,381,407,77,41,46,35,467,226,241,55,48,54,23,1
15761,273,148,125,38,31,16,19,706,370,336,86,79,78,43,1
15762,133,66,67,21,24,9,2,294,148,146,35,33,25,14,1
15763,772,323,449,174,108,68,22,1382,599,783,208,252,90,39,1
15764,953,481,472,133,130,77,48,181,96,85,25,23,20,7,1
15765,653,304,349,102,84,93,28,149,68,81,15,38,11,10,1
15766,798,287,511,126,125,77,26,503,260,243,46,56,33,16,1
15767,201,122,79,27,19,12,3,1097,526,571,131,134,120,43,1
15768,351,177,174,57,49,36,11,4314,2128,2186,613,568,464,145,1
15769,538,268,270,58,72,42,25,770,374,396,95,91,79,41,1
15770,158,87,71,23,20,15,5,61,17,44,8,4,0,21,1
15771,276,143,133,34,38,20,15,1706,830,876,265,209,230,63,1
15772,736,362,374,115,83,86,31,184,86,98,26,26,14,11,1
15773,3056,1457,1599,438,389,329,168,1471,709,762,198,184,154,62,1
15774,160,76,84,19,24,8,5,806,436,370,101,100,76,34,1
15775,99,50,49,18,11,8,6,336,221,115,22,17,40,16,1
15776,273,131,142,35,35,25,12,144,70,74,15,17,13,10,1
15777,910,431,479,138,103,98,41,173,104,69,18,20,18,9,1
15778,545,230,315,91,101,50,16,502,299,203,57,52,32,11,1
15779,559,317,242,58,65,37,23,484,182,302,124,66,20,8,1
15780,117,57,60,17,14,11,10,732,355,377,108,109,79,27,1
15781,744,384,360,104,96,57,31,189,102,87,28,17,22,5,1
15782,501,216,285,79,70,54,30,1165,567,598,134,119,158,63,1
15783,109,57,52,19,7,8,8,134,63,71,27,9,6,8,1
15784,488,284,204,43,45,52,21,673,329,344,111,95,92,41,1
15785,648,341,307,78,89,77,21,757,359,398,109,127,80,26,1
15786,101,45,56,17,17,12,9,1960,810,1150,358,377,121,72,1
15787,318,165,153,45,38,25,18,308,170,138,38,35,45,14,1
15788,686,345,341,98,106,75,25,848,461,387,111,102,108,42,1
15789,985,445,540,164,146,68,36,211,114,97,32,24,19,10,1
15790,317,153,164,39,30,35,13,825,427,398,79,95,81,48,1
15791,391,208,183,65,49,57,17,435,208,227,68,64,53,23,1
15792,420,197,223,72,57,54,19,582,285,297,62,57,44,16,1
15793,940,464,476,116,135,108,58,381,187,194,37,49,36,17,1
15794,615,293,322,70,67,45,29,724,320,404,120,147,67,25,1
15795,1273,592,681,199,164,139,39,1046,562,484,139,116,124,51,1
15796,228,139,89,24,21,32,18,208,107,101,42,22,18,10,1
15797,208,99,109,35,12,30,14,267,129,138,45,40,23,14,1
15798,178,86,92,30,21,12,17,1255,666,589,145,142,120,82,1
15799,255,111,144,31,25,21,28,501,240,261,80,62,49,42,1
15800,487,224,263,77,68,44,17,543,265,278,52,37,54,19,1
15801,425,210,215,56,43,52,25,727,294,433,143,118,69,50,1
15802,1367,690,677,172,175,154,83,355,165,190,53,56,42,19,1
15803,428,226,202,52,60,75,20,2524,1232,1292,398,317,186,61,1
15804,246,115,131,15,29,10,32,190,103,87,29,16,16,5,1
15805,1248,584,664,184,164,155,67,105,53,52,23,11,12,6,1
15806,73,29,44,10,14,6,3,582,293,289,94,80,77,32,1
15807,802,388,414,131,105,96,29,182,99,83,26,30,22,2,1
15808,479,238,241,64,47,62,22,469,221,248,49,60,55,21,1
15809,939,493,446,113,100,87,31,951,506,445,107,118,79,40,1
15810,513,246,267,71,66,60,35,1937,899,1038,336,332,181,86,1
15811,354,137,217,53,57,30,5,361,172,189,51,54,25,4,1
15812,837,464,373,104,72,85,49,794,402,392,96,84,86,30,1
15813,1801,889,912,206,263,126,42,1836,1051,785,185,221,239,110,1
15814,359,173,186,55,57,44,16,1068,539,529,161,134,132,71,1
15815,860,457,403,118,103,103,36,512,269,243,69,70,62,29,1
15816,336,140,196,51,44,27,18,560,279,281,113,64,58,15,1
15817,896,407,489,97,152,70,22,1247,548,699,168,150,140,43,1
15818,140,86,54,17,6,20,7,465,261,204,51,35,48,21,1
15819,583,322,261,73,66,45,26,822,392,430,125,104,79,24,1
15820,2799,1324,1475,369,371,215,124,538,268,270,58,72,42,25,1
15821,136,65,71,33,11,9,6,377,211,166,45,46,51,20,1
15822,240,125,115,34,32,30,8,624,329,295,97,83,75,34,1
15823,725,408,317,93,75,90,45,246,115,131,15,29,10,32,1
15824,1796,979,817,189,211,160,52,742,303,439,88,96,86,23,1
15825,160,77,83,14,27,11,10,1374,679,695,191,193,154,48,1
15826,536,278,258,72,63,62,20,894,492,402,95,103,88,42,1
15827,264,127,137,35,34,18,10,445,219,226,61,60,60,21,1
15828,591,263,328,95,90,26,13,508,267,241,57,49,40,13,1
15829,493,240,253,72,62,59,15,781,418,363,92,90,64,41,1
15830,1097,588,509,128,86,84,31,508,295,213,42,61,53,17,1
15831,437,225,212,61,57,66,12,327,172,155,38,41,41,15,1
15832,442,254,188,46,22,40,19,1246,539,707,245,146,109,52,1
15833,161,75,86,21,11,17,7,788,360,428,93,106,67,72,1
15834,277,124,153,44,40,35,18,164,78,86,28,23,12,8,1
15835,822,416,406,111,105,84,44,155,74,81,23,19,20,5,1
15836,987,515,472,107,110,106,61,201,98,103,26,35,16,5,1
15837,633,327,306,102,90,72,15,294,148,146,35,33,25,14,1
15838,802,388,414,101,93,88,35,537,276,261,75,68,68,22,1
15839,446,260,186,64,43,46,20,173,84,89,25,33,19,8,1
15840,131,74,57,23,9,16,8,754,412,342,92,53,110,49,1
15841,294,148,146,35,33,25,14,321,187,134,59,29,32,8,1
15842,159,72,87,52,7,10,5,662,297,365,92,88,44,29,1
15843,392,156,236,40,91,28,16,145,73,72,25,14,12,4,1
15844,745,366,379,110,93,79,45,393,186,207,58,50,36,22,1
15845,1094,508,586,152,151,77,36,175,90,85,28,21,19,7,1
15846,230,115,115,29,29,22,14,556,300,256,58,73,55,22,1
15847,250,123,127,40,28,29,8,2414,1189,1225,277,178,170,169,1
15848,89,42,47,16,12,15,6,87,50,37,16,7,10,5,1
15849,723,364,359,107,106,52,14,508,267,241,57,49,40,13,1
15850,1712,1175,537,179,142,113,46,770,355,415,103,142,75,42,1
15851,876,473,403,110,106,73,24,482,231,251,76,81,64,26,1
15852,1863,721,1142,262,283,139,74,341,178,163,48,44,42,20,1
15853,1432,652,780,217,205,131,81,1417,598,819,223,188,135,58,1
15854,371,237,134,31,25,43,17,240,132,108,16,13,30,12,1
15855,96,50,46,8,15,6,2,656,341,315,86,95,82,23,1
15856,688,258,430,119,86,37,20,391,201,190,52,47,35,24,1
15857,714,282,432,119,128,69,15,249,142,107,36,24,21,5,1
15858,644,329,315,70,64,50,11,271,131,140,40,47,34,14,1
15859,500,215,285,120,41,66,35,415,219,196,53,55,57,20,1
15860,452,256,196,32,44,27,11,395,222,173,48,42,21,8,1
15861,2881,1254,1627,442,386,273,102,595,316,279,86,60,65,40,1
15862,896,407,489,97,152,70,22,371,174,197,53,56,43,15,1
15863,725,419,306,75,67,105,26,329,190,139,24,23,50,13,1
15864,429,219,210,46,66,42,17,372,147,225,62,49,35,17,1
15865,2031,983,1048,294,257,230,93,211,114,97,32,24,19,10,1
15866,587,260,327,84,69,55,23,330,157,173,56,42,51,8,1
15867,589,281,308,69,39,63,20,862,409,453,149,125,86,29,1
15868,211,92,119,33,44,11,7,1085,646,439,108,65,36,19,1
15869,1052,525,527,144,135,122,41,467,224,243,70,43,67,23,1
15870,540,261,279,62,49,59,26,753,361,392,99,94,66,16,1
15871,437,241,196,49,48,61,24,173,91,82,32,18,19,11,1
15872,454,223,231,38,45,24,19,261,171,90,21,21,35,17,1
15873,763,354,409,101,90,63,26,444,212,232,74,25,60,24,1
15874,1735,889,846,220,158,171,48,1074,538,536,154,140,111,51,1
15875,129,78,51,17,9,10,10,568,243,325,98,73,56,44,1
15876,127,54,73,11,33,15,6,636,336,300,94,65,58,32,1
15877,656,358,298,67,47,64,26,157,78,79,18,29,16,10,1
15878,989,513,476,125,106,92,60,505,247,258,72,71,60,27,1
15879,1366,943,423,137,109,58,19,402,227,175,48,40,35,11,1
15880,471,246,225,46,38,52,30,354,197,157,44,45,47,7,1
15881,269,134,135,42,35,27,13,201,112,89,28,24,26,9,1
15882,1106,579,527,121,152,113,45,724,325,399,98,92,64,24,1
15883,164,78,86,28,23,12,8,317,153,164,39,30,35,13,1
15884,768,354,414,133,106,79,42,81,41,40,15,13,3,2,1
15885,198,80,118,35,31,14,7,246,113,133,33,45,22,10,1
15886,407,209,198,55,59,38,19,907,455,452,132,117,80,40,1
15887,355,179,176,51,45,45,11,158,85,73,24,18,18,8,1
15888,1516,775,741,222,198,191,54,164,89,75,17,21,13,10,1
15889,363,221,142,36,16,56,25,1342,673,669,178,154,137,94,1
15890,235,104,131,29,35,26,10,570,292,278,80,65,72,23,1
15891,353,156,197,35,57,28,43,502,279,223,62,54,66,28,1
15892,361,184,177,50,53,51,22,103,56,47,27,7,8,2,1
15893,353,195,158,40,55,30,13,399,220,179,51,57,27,18,1
15894,876,457,419,88,124,67,47,1141,583,558,141,98,91,45,1
15895,297,158,139,47,37,37,9,663,323,340,89,89,76,22,1
15896,591,300,291,70,45,59,30,391,203,188,49,34,36,9,1
15897,1156,538,618,144,139,117,90,406,209,197,57,50,50,17,1
15898,822,424,398,107,106,86,46,1009,506,503,146,141,97,55,1
15899,445,255,190,57,53,56,28,921,455,466,144,127,108,39,1
15900,317,153,164,39,30,35,13,770,374,396,95,91,79,41,1
15901,777,345,432,128,88,65,39,743,366,377,41,37,26,14,1
15902,764,377,387,93,85,84,37,1097,526,571,131,134,120,43,1
15903,380,187,193,38,51,30,18,350,180,170,64,46,55,12,1
15904,806,419,387,115,130,57,32,1132,553,579,172,143,150,57,1
15905,508,215,293,72,71,42,15,1333,646,687,209,179,148,45,1
15906,641,275,366,108,107,45,29,983,487,496,126,115,104,52,1
15907,377,180,197,37,20,24,8,710,357,353,99,79,72,39,1
15908,1068,559,509,158,132,122,57,724,334,390,112,109,79,17,1
15909,286,152,134,38,38,32,11,594,303,291,84,69,72,31,1
15910,432,228,204,59,53,43,15,305,168,137,48,35,40,9,1
15911,854,380,474,137,159,81,31,350,180,170,64,46,55,12,1
15912,471,246,225,46,38,52,30,169,99,70,26,21,20,7,1
15913,816,463,353,99,99,61,26,648,307,341,101,58,76,34,1
15914,4655,2074,2581,545,652,562,399,2768,1380,1388,280,294,291,161,1
15915,258,141,117,33,29,23,10,508,295,213,42,61,53,17,1
15916,1356,576,780,229,198,107,38,89,42,47,16,12,15,6,1
15917,1585,840,745,184,152,155,100,259,143,116,39,37,23,9,1
15918,1290,597,693,182,182,119,63,1036,511,525,136,89,94,56,1
15919,442,230,212,50,58,56,23,480,256,224,67,55,26,22,1
15920,163,71,92,22,38,11,7,292,126,166,59,28,34,18,1
15921,1116,464,652,186,156,99,42,139,73,66,26,13,9,9,1
15922,582,293,289,94,80,77,32,451,213,238,72,63,42,27,1
15923,373,174,199,55,49,33,7,181,96,85,26,23,18,7,1
15924,541,273,268,67,48,48,30,147,78,69,20,15,20,7,1
15925,108,57,51,16,12,10,5,4967,2501,2466,718,692,594,248,1
15926,205,104,101,28,28,35,13,386,189,197,54,57,39,16,1
15927,2201,1053,1148,238,312,200,122,1997,972,1025,262,209,239,52,1
15928,551,298,253,63,65,45,19,650,304,346,80,106,62,28,1
15929,346,191,155,52,38,40,13,395,189,206,63,50,49,28,1
15930,416,209,207,76,45,50,17,843,391,452,139,104,91,34,1
15931,360,192,168,55,45,48,16,462,233,229,66,49,43,30,1
15932,887,439,448,131,119,98,39,270,130,140,48,44,37,12,1
15933,433,221,212,59,42,47,14,1046,562,484,139,116,124,51,1
15934,601,313,288,42,48,25,36,58,33,25,8,2,8,3,1
15935,1182,612,570,142,118,140,62,2803,1300,1503,392,510,170,57,1
15936,871,482,389,113,95,109,35,537,276,261,75,68,68,22,1
15937,671,295,376,126,93,61,28,288,118,170,50,57,18,15,1
15938,44,13,31,9,11,1,3,375,202,173,46,49,41,23,1
15939,298,140,158,51,33,21,22,351,195,156,47,53,25,14,1
15940,826,362,464,107,118,71,43,715,355,360,118,79,71,29,1
15941,323,169,154,47,44,39,20,205,77,128,31,45,12,11,1
15942,508,266,242,81,62,49,22,586,254,332,114,111,55,17,1
15943,1914,768,1146,327,268,227,120,930,367,563,181,153,83,48,1
15944,102,47,55,23,13,10,3,1290,597,693,182,182,119,63,1
15945,979,534,445,83,77,80,24,552,285,267,74,51,69,24,1
15946,365,180,185,63,35,48,19,721,363,358,87,104,70,28,1
15947,624,204,420,166,101,32,13,324,154,170,57,40,26,4,1
15948,1038,470,568,130,123,86,51,339,140,199,46,67,19,8,1
15949,1328,661,667,210,147,126,55,1336,828,508,166,121,152,48,1
15950,359,216,143,43,21,48,27,1037,575,462,122,150,82,32,1
15951,593,283,310,91,57,27,25,411,209,202,69,43,18,15,1
15952,454,224,230,71,39,62,22,234,129,105,31,22,19,18,1
15953,528,228,300,60,119,43,28,1304,585,719,179,169,154,47,1
15954,1292,592,700,186,169,108,22,510,306,204,82,46,45,20,1
15955,405,180,225,72,57,31,12,118,51,67,25,13,6,7,1
15956,186,99,87,30,17,18,8,316,157,159,45,38,22,19,1
15957,561,210,351,108,77,41,22,467,231,236,71,65,58,18,1
15958,178,87,91,20,32,13,10,1117,423,694,182,134,88,31,1
15959,415,189,226,69,54,50,21,770,374,396,95,91,79,41,1
15960,422,203,219,75,49,40,22,261,130,131,27,41,19,16,1
15961,325,184,141,43,34,22,18,201,42,159,19,3,2,75,1
15962,246,115,131,15,29,10,32,597,243,354,97,105,63,20,1
15963,401,204,197,49,33,29,17,1273,592,681,199,164,139,39,1
15964,1091,543,548,146,136,110,34,592,283,309,84,137,60,20,1
15965,1454,780,674,182,120,135,67,1416,545,871,279,247,84,54,1
15966,266,110,156,50,28,43,7,202,102,100,29,35,6,9,1
15967,193,99,94,31,31,16,12,592,291,301,92,93,71,31,1
15968,396,150,246,103,64,38,3,552,285,267,74,51,69,24,1
15969,450,242,208,53,63,56,22,89,42,47,16,12,15,6,1
15970,427,204,223,38,57,26,32,217,109,108,34,32,35,7,1
15971,266,133,133,43,28,30,8,425,210,215,56,43,52,25,1
15972,1706,830,876,265,209,230,63,364,195,169,50,38,33,12,1
15973,391,208,183,65,49,57,17,330,166,164,57,51,36,16,1
15974,3144,1617,1527,367,342,278,136,2363,875,1488,361,444,95,53,1
15975,3114,1105,2009,505,603,150,122,206,85,121,31,42,6,17,1
15976,594,274,320,89,63,66,28,428,248,180,44,39,28,9,1
15977,480,252,228,55,37,49,20,400,191,209,41,40,33,21,1
15978,361,167,194,55,35,41,11,500,297,203,66,33,53,15,1
15979,359,185,174,42,48,22,26,641,324,317,88,92,49,14,1
15980,418,220,198,69,51,44,16,371,237,134,31,25,43,17,1
15981,462,228,234,59,47,37,32,345,141,204,64,58,13,11,1
15982,257,139,118,64,17,24,7,444,255,189,60,46,54,16,1
15983,424,191,233,76,73,49,13,1333,646,687,209,179,148,45,1
15984,961,463,498,139,156,62,34,437,167,270,126,95,34,10,1
15985,841,370,471,103,123,61,56,156,64,92,31,19,5,4,1
15986,697,373,324,105,83,95,38,495,233,262,64,39,49,32,1
15987,360,192,168,55,45,48,16,217,109,108,34,32,35,7,1
15988,505,239,266,71,55,50,18,740,313,427,101,135,40,22,1
15989,469,221,248,49,60,55,21,778,367,411,90,85,64,43,1
15990,425,199,226,54,71,56,11,422,203,219,75,49,40,22,1
15991,724,261,463,135,139,39,20,747,306,441,158,115,57,20,1
15992,427,218,209,61,53,45,26,483,215,268,66,70,30,16,1
15993,553,261,292,73,79,40,26,1914,892,1022,272,267,143,79,1
15994,462,224,238,77,75,37,13,450,194,256,57,75,45,22,1
15995,537,288,249,60,60,61,19,583,248,335,115,111,52,16,1
15996,580,339,241,72,47,66,21,201,42,159,19,3,2,75,1
15997,815,418,397,97,62,70,17,274,158,116,27,27,22,18,1
15998,548,273,275,84,81,64,30,815,418,397,97,62,70,17,1
15999,2414,1189,1225,277,178,170,169,628,341,287,77,59,55,31,1
16000,732,355,377,108,109,79,27,2063,1024,1039,175,117,80,97,1
16001,234,129,105,31,22,19,18,327,177,150,40,40,38,18,1
16002,331,193,138,44,37,18,9,156,74,82,24,18,16,22,1
16003,953,481,472,133,130,77,48,511,247,264,75,73,43,24,1
16004,1114,581,533,145,132,126,54,1074,538,536,154,140,111,51,1
16005,123,58,65,22,14,13,3,102,49,53,14,21,7,4,1
16006,791,391,400,103,94,59,38,309,106,203,66,49,25,10,1
16007,777,387,390,90,87,65,37,1247,548,699,168,150,140,43,1
16008,154,75,79,17,24,16,13,507,249,258,54,76,28,20,1
16009,351,184,167,59,45,54,9,444,209,235,76,62,62,16,1
16010,1263,613,650,163,127,128,62,693,359,334,75,54,59,20,1
16011,684,311,373,109,99,66,16,205,114,91,25,24,20,15,1
16012,321,180,141,47,37,33,12,393,186,207,58,50,36,22,1
16013,2488,1087,1401,346,253,162,76,218,121,97,29,26,21,6,1
16014,183,97,86,30,18,20,12,297,145,152,49,30,23,21,1
16015,269,156,113,37,32,17,7,271,131,140,47,37,41,11,1
16016,219,99,120,46,31,17,5,433,221,212,59,42,47,14,1
16017,303,159,144,40,35,35,8,635,333,302,99,75,83,28,1
16018,136,65,71,33,11,9,6,185,70,115,37,48,15,5,1
16019,907,475,432,124,92,65,14,2175,1078,1097,364,275,271,81,1
16020,854,380,474,137,159,81,31,712,396,316,78,69,65,25,1
16021,315,129,186,51,29,24,29,293,140,153,39,44,41,19,1
16022,552,285,267,74,51,69,24,727,294,433,143,118,69,50,1
16023,220,117,103,26,39,14,13,556,269,287,86,66,62,22,1
16024,789,362,427,90,82,70,35,848,394,454,100,90,101,41,1
16025,1113,520,593,168,139,109,49,789,319,470,129,139,81,35,1
16026,304,127,177,61,38,31,4,342,160,182,69,40,37,16,1
16027,501,240,261,80,62,49,42,586,309,277,81,64,76,25,1
16028,484,264,220,59,62,68,15,2414,1189,1225,277,178,170,169,1
16029,103,44,59,16,17,9,5,331,169,162,40,28,22,14,1
16030,831,334,497,163,167,49,22,1187,631,556,182,139,152,56,1
16031,354,168,186,50,53,39,20,83,43,40,13,8,8,3,1
16032,95,44,51,14,13,7,4,434,233,201,61,55,37,15,1
16033,2442,1193,1249,278,183,170,145,393,186,207,58,50,36,22,1
16034,1210,592,618,157,138,116,85,1047,562,485,141,127,114,41,1
16035,814,403,411,112,140,94,23,320,143,177,51,51,24,10,1
16036,599,314,285,80,72,58,20,102,51,51,12,15,12,3,1
16037,377,184,193,56,53,44,14,1290,629,661,191,187,167,55,1
16038,1356,672,684,171,172,134,59,1516,963,553,148,152,111,26,1
16039,969,505,464,123,133,92,33,446,265,181,51,35,27,17,1
16040,239,146,93,30,22,35,9,295,181,114,34,19,43,21,1
16041,593,305,288,91,83,54,24,116,67,49,13,12,6,5,1
16042,609,292,317,102,96,64,21,425,210,215,56,43,52,25,1
16043,341,178,163,48,44,42,20,1200,586,614,138,160,89,31,1
16044,333,167,166,45,30,34,14,1198,571,627,177,168,97,54,1
16045,521,265,256,56,44,35,12,473,217,256,59,44,34,21,1
16046,558,306,252,75,55,74,23,426,257,169,43,35,58,15,1
16047,341,154,187,34,36,11,11,775,480,295,82,78,58,19,1
16048,1225,593,632,158,125,102,38,781,418,363,92,90,64,41,1
16049,418,205,213,69,50,29,15,206,94,112,37,36,18,9,1
16050,292,152,140,46,38,35,12,559,296,263,77,69,42,13,1
16051,491,283,208,55,61,40,13,708,418,290,67,49,95,37,1
16052,1675,875,800,213,219,196,72,777,387,390,90,87,65,37,1
16053,376,199,177,54,49,48,22,498,174,324,112,108,33,19,1
16054,822,424,398,107,106,86,46,251,136,115,38,19,35,15,1
16055,391,208,183,65,49,57,17,961,463,498,139,156,62,34,1
16056,1338,756,582,155,105,104,44,1367,690,677,172,175,154,83,1
16057,505,239,266,71,55,50,18,254,115,139,41,31,28,7,1
16058,262,151,111,30,17,32,25,4374,2058,2316,531,605,321,183,1
16059,292,152,140,46,38,35,12,464,236,228,64,56,53,28,1
16060,703,414,289,75,61,68,26,366,183,183,48,47,36,17,1
16061,798,287,511,126,125,77,26,595,316,279,86,60,65,40,1
16062,591,279,312,88,91,52,26,609,318,291,80,72,55,36,1
16063,938,484,454,137,100,104,41,526,268,258,54,37,55,12,1
16064,218,110,108,24,31,27,13,258,111,147,46,63,17,6,1
16065,938,484,454,137,100,104,41,3911,1465,2446,610,767,240,133,1
16066,239,144,95,20,26,23,13,321,187,134,59,29,32,8,1
16067,101,41,60,18,19,10,5,410,200,210,60,54,46,19,1
16068,1590,726,864,270,237,126,59,443,248,195,67,54,40,15,1
16069,338,168,170,60,38,48,17,2351,1110,1241,337,269,300,87,1
16070,561,210,351,108,77,41,22,4128,2104,2024,581,505,453,205,1
16071,681,322,359,100,87,71,26,391,204,187,47,48,38,18,1
16072,591,319,272,96,62,43,19,647,324,323,101,80,76,43,1
16073,1382,599,783,208,252,90,39,723,309,414,106,106,41,40,1
16074,206,85,121,31,42,6,17,287,124,163,52,48,24,16,1
16075,870,433,437,133,121,95,25,1007,523,484,116,113,117,43,1
16076,265,103,162,61,58,25,3,140,86,54,17,6,20,7,1
16077,548,266,282,86,76,57,14,665,297,368,111,107,34,12,1
16078,684,311,373,109,99,66,16,370,177,193,55,38,48,19,1
16079,956,517,439,111,99,107,53,908,488,420,115,97,111,43,1
16080,250,123,127,40,28,29,8,201,42,159,19,3,2,75,1
16081,279,106,173,48,35,41,39,788,367,421,93,97,71,71,1
16082,333,127,206,66,68,25,14,4128,2104,2024,581,505,453,205,1
16083,579,330,249,52,27,90,11,339,181,158,31,26,40,15,1
16084,393,186,207,58,50,36,22,168,90,78,22,19,13,4,1
16085,316,142,174,51,42,33,15,976,520,456,120,115,109,53,1
16086,218,110,108,24,31,27,13,292,153,139,39,33,24,21,1
16087,318,176,142,25,32,35,25,755,348,407,109,98,49,23,1
16088,729,391,338,80,64,71,34,216,119,97,33,27,28,7,1
16089,217,102,115,28,26,22,9,462,232,230,78,54,42,23,1
16090,669,348,321,83,80,55,23,426,221,205,71,51,39,21,1
16091,359,182,177,54,37,41,12,1032,526,506,129,117,119,47,1
16092,440,218,222,58,66,40,24,190,100,90,29,12,20,6,1
16093,336,154,182,51,48,39,22,791,306,485,142,157,21,18,1
16094,101,41,60,18,19,10,5,317,153,164,34,52,30,14,1
16095,235,135,100,30,13,25,11,362,183,179,49,49,41,11,1
16096,247,110,137,34,45,23,10,979,402,577,146,144,79,35,1
16097,456,209,247,72,58,40,9,217,109,108,34,32,35,7,1
16098,2871,1218,1653,290,374,238,414,359,184,175,49,35,32,11,1
16099,2003,1022,981,195,194,164,229,467,226,241,55,48,54,23,1
16100,450,241,209,67,58,54,23,742,303,439,88,96,86,23,1
16101,577,241,336,112,109,47,21,739,359,380,83,95,53,38,1
16102,938,484,454,137,100,104,41,906,474,432,90,125,74,24,1
16103,1798,844,954,277,212,142,53,89,42,47,16,12,15,6,1
16104,470,230,240,67,60,42,16,830,402,428,80,67,100,80,1
16105,94,58,36,10,9,7,8,94,57,37,10,10,7,8,1
16106,1066,485,581,136,182,99,31,470,289,181,58,47,45,25,1
16107,731,340,391,95,83,81,32,1042,553,489,133,119,85,25,1
16108,519,274,245,67,55,60,20,2024,765,1259,283,343,137,76,1
16109,440,218,222,58,66,40,24,509,262,247,64,70,64,20,1
16110,626,272,354,96,80,71,36,2468,1038,1430,333,465,167,62,1
16111,1005,439,566,159,165,70,43,1452,733,719,182,161,179,64,1
16112,859,429,430,126,115,64,33,1073,547,526,60,60,47,19,1
16113,3056,1457,1599,438,389,329,168,341,154,187,34,36,11,11,1
16114,540,282,258,50,53,33,16,925,439,486,141,134,105,46,1
16115,290,134,156,47,31,21,13,473,217,256,59,44,34,21,1
16116,173,110,63,35,6,9,8,499,250,249,78,81,46,25,1
16117,275,140,135,38,32,18,5,406,202,204,54,54,41,16,1
16118,360,192,168,55,45,48,16,1076,563,513,129,114,90,37,1
16119,420,218,202,47,49,52,15,134,70,64,19,14,13,5,1
16120,52,24,28,6,4,3,5,425,199,226,54,71,56,11,1
16121,1009,506,503,146,141,97,55,656,358,298,67,47,64,26,1
16122,339,170,169,32,17,24,13,446,265,181,51,35,27,17,1
16123,77,36,41,18,7,13,9,1395,627,768,172,263,141,59,1
16124,133,55,78,22,22,13,9,346,180,166,52,55,36,13,1
16125,1132,624,508,199,79,127,41,609,292,317,102,96,64,21,1
16126,499,272,227,49,66,66,21,193,99,94,31,31,16,12,1
16127,1816,865,951,246,230,189,76,1749,880,869,237,228,214,112,1
16128,1336,736,600,137,136,163,69,195,83,112,40,16,19,16,1
16129,2549,1331,1218,366,296,271,130,933,493,440,140,108,124,32,1
16130,864,362,502,142,150,70,19,128,73,55,11,15,13,8,1
16131,824,397,427,113,95,82,33,92,46,46,14,9,8,6,1
16132,318,164,154,52,43,34,10,234,92,142,29,74,17,5,1
16133,145,70,75,24,16,16,20,202,102,100,29,35,6,9,1
16134,324,174,150,37,24,35,27,845,402,443,137,126,105,47,1
16135,564,305,259,82,64,57,27,822,402,420,125,107,82,26,1
16136,351,184,167,59,45,54,9,308,159,149,52,41,22,10,1
16137,5537,2898,2639,598,623,347,214,465,225,240,65,44,65,25,1
16138,840,467,373,91,87,121,47,780,414,366,112,89,73,38,1
16139,4128,2104,2024,581,505,453,205,1149,568,581,177,133,101,30,1
16140,688,323,365,121,69,55,22,246,113,133,33,45,22,10,1
16141,176,73,103,22,29,13,9,163,67,96,27,30,15,9,1
16142,326,166,160,49,45,36,12,289,139,150,38,44,23,20,1
16143,538,292,246,69,57,52,39,574,347,227,61,55,46,34,1
16144,589,294,295,37,44,27,33,448,275,173,32,53,55,27,1
16145,582,189,393,117,66,66,6,462,157,305,93,51,54,3,1
16146,454,223,231,38,45,24,19,450,238,212,56,52,49,14,1
16147,500,209,291,88,49,63,28,529,274,255,57,62,38,14,1
16148,328,120,208,76,50,23,9,439,177,262,78,73,40,21,1
16149,232,108,124,33,27,19,16,532,267,265,86,55,64,22,1
16150,1332,652,680,210,180,155,49,189,90,99,26,29,17,11,1
16151,615,307,308,96,58,66,35,574,269,305,91,63,54,27,1
16152,785,374,411,56,42,38,25,224,108,116,31,32,22,8,1
16153,502,240,262,78,61,54,32,513,260,253,71,50,58,23,1
16154,1089,544,545,138,160,117,43,750,347,403,105,103,83,29,1
16155,516,220,296,75,67,47,19,467,226,241,55,48,54,23,1
16156,483,274,209,54,39,45,13,529,264,265,59,68,41,17,1
16157,5497,2328,3169,872,896,436,168,590,303,287,69,65,46,17,1
16158,1342,675,667,162,154,123,39,268,130,138,41,29,31,17,1
16159,797,394,403,109,89,83,40,501,240,261,80,62,49,42,1
16160,360,201,159,38,38,34,13,215,80,135,54,56,21,9,1
16161,512,248,264,66,71,49,30,630,289,341,100,121,62,34,1
16162,732,366,366,108,86,74,41,619,305,314,85,93,71,29,1
16163,589,300,289,78,66,72,34,503,263,240,72,55,51,34,1
16164,473,217,256,59,44,34,21,2414,1189,1225,277,178,170,169,1
16165,480,234,246,79,77,65,23,2382,1161,1221,237,220,140,50,1
16166,194,81,113,64,9,7,2,698,365,333,108,83,65,21,1
16167,919,376,543,129,122,55,30,327,172,155,38,41,41,15,1
16168,3256,1307,1949,625,448,159,88,673,329,344,111,95,92,41,1
16169,1948,1039,909,242,227,200,67,1749,880,869,237,228,214,112,1
16170,249,114,135,47,33,25,4,517,196,321,103,98,34,12,1
16171,191,99,92,25,24,18,8,509,262,247,64,70,64,20,1
16172,689,484,205,73,55,18,15,392,156,236,40,91,28,16,1
16173,855,420,435,139,134,109,35,1970,978,992,245,206,198,80,1
16174,671,332,339,103,75,75,31,189,88,101,31,29,18,10,1
16175,785,412,373,114,84,95,38,412,195,217,79,48,36,29,1
16176,928,442,486,139,118,91,43,326,166,160,49,45,36,12,1
16177,760,401,359,96,89,98,22,164,88,76,27,20,17,6,1
16178,153,81,72,22,18,16,8,875,421,454,124,142,98,43,1
16179,351,184,167,59,45,54,9,700,265,435,134,106,16,3,1
16180,186,103,83,28,20,27,6,796,390,406,110,117,86,33,1
16181,252,125,127,33,25,26,19,655,349,306,78,59,76,42,1
16182,1087,523,564,146,177,103,33,453,202,251,74,68,60,20,1
16183,920,492,428,100,92,88,49,517,196,321,103,98,34,12,1
16184,595,316,279,86,60,65,40,552,285,267,74,51,69,24,1
16185,95,44,51,14,13,7,4,204,96,108,31,37,20,5,1
16186,277,124,153,44,40,35,18,241,115,126,35,30,17,14,1
16187,360,188,172,49,48,47,17,160,53,107,31,29,13,3,1
16188,261,139,122,30,33,23,6,164,88,76,27,20,17,6,1
16189,728,385,343,110,102,69,14,635,333,302,99,75,83,28,1
16190,296,154,142,38,38,24,16,712,396,316,78,69,65,25,1
16191,730,328,402,126,99,48,23,672,334,338,110,93,91,41,1
16192,104,52,52,18,14,17,4,452,256,196,32,44,27,11,1
16193,128,58,70,22,14,4,7,642,326,316,86,83,63,26,1
16194,443,255,188,57,44,42,19,654,317,337,95,111,44,13,1
16195,377,218,159,61,17,68,24,1149,568,581,177,133,101,30,1
16196,158,85,73,24,18,18,8,632,280,352,111,96,55,16,1
16197,657,372,285,81,70,88,25,592,283,309,84,137,60,20,1
16198,216,119,97,33,27,28,7,920,492,428,100,92,88,49,1
16199,462,224,238,77,75,37,13,585,354,231,66,39,80,42,1
16200,371,174,197,53,56,43,15,969,505,464,123,133,92,33,1
16201,2414,1189,1225,277,178,170,169,457,228,229,64,36,52,21,1
16202,330,143,187,63,29,52,20,2346,948,1398,352,377,147,66,1
16203,671,303,368,93,68,61,26,732,355,377,108,109,79,27,1
16204,287,156,131,40,31,33,15,163,71,92,22,38,11,7,1
16205,911,445,466,154,121,108,48,1197,521,676,216,187,82,38,1
16206,754,182,572,236,122,57,18,1970,978,992,245,206,198,80,1
16207,457,242,215,39,46,53,10,236,121,115,39,20,44,15,1
16208,344,168,176,65,44,33,15,740,313,427,101,135,40,22,1
16209,435,221,214,72,45,47,19,348,187,161,47,39,27,17,1
16210,389,199,190,51,56,41,21,832,428,404,131,89,88,38,1
16211,594,340,254,77,64,62,21,623,320,303,103,85,75,15,1
16212,464,242,222,61,68,36,17,164,61,103,47,19,14,5,1
16213,206,100,106,34,26,11,7,134,60,74,19,13,10,7,1
16214,832,428,404,131,89,88,38,598,322,276,67,57,63,26,1
16215,605,295,310,74,66,70,36,1032,526,506,129,117,119,47,1
16216,290,130,160,47,43,32,11,127,57,70,18,33,8,7,1
16217,1972,846,1126,222,330,114,68,89,42,47,16,12,15,6,1
16218,822,402,420,125,107,82,26,1124,615,509,157,125,128,52,1
16219,146,72,74,21,15,12,13,1009,487,522,177,121,103,51,1
16220,1100,474,626,197,143,126,41,1030,495,535,154,106,116,49,1
16221,869,488,381,110,77,78,30,339,170,169,32,17,24,13,1
16222,287,167,120,39,18,32,15,201,42,159,19,3,2,75,1
16223,697,373,324,105,83,95,38,748,386,362,111,75,71,40,1
16224,1152,459,693,138,343,75,33,1278,593,685,198,201,71,43,1
16225,404,190,214,55,55,35,27,193,85,108,24,37,20,13,1
16226,288,138,150,82,22,25,5,159,72,87,52,7,10,5,1
16227,260,92,168,37,43,18,13,621,284,337,108,68,50,17,1
16228,1045,374,671,217,143,103,29,158,85,73,24,18,18,8,1
16229,1333,646,687,209,179,148,45,217,109,108,34,32,35,7,1
16230,953,489,464,126,104,111,44,377,171,206,59,58,41,22,1
16231,1377,579,798,179,169,139,99,346,208,138,46,39,51,18,1
16232,1042,530,512,162,150,103,52,1706,830,876,265,209,230,63,1
16233,537,276,261,75,68,68,22,594,274,320,89,63,66,28,1
16234,508,254,254,74,99,61,12,589,294,295,37,44,27,33,1
16235,202,102,100,29,35,6,9,597,246,351,95,98,45,25,1
16236,1798,844,954,277,212,142,53,522,235,287,78,67,60,50,1
16237,678,364,314,83,59,66,28,557,306,251,66,42,52,15,1
16238,411,214,197,52,45,50,19,390,209,181,59,47,41,26,1
16239,428,226,202,52,60,75,20,1721,838,883,241,218,144,54,1
16240,295,177,118,27,16,40,17,621,310,311,100,106,77,27,1
16241,2556,1169,1387,248,291,227,275,473,217,256,59,44,34,21,1
16242,1058,558,500,132,127,121,53,319,131,188,51,29,26,31,1
16243,377,212,165,56,37,34,21,355,214,141,43,29,63,13,1
16244,420,214,206,58,44,32,24,376,176,200,31,53,27,8,1
16245,277,124,153,44,40,35,18,1447,751,696,161,143,131,46,1
16246,404,206,198,45,61,31,24,117,60,57,20,17,16,5,1
16247,815,418,397,97,62,70,17,442,230,212,50,58,56,23,1
16248,172,98,74,20,21,22,8,368,201,167,61,38,38,12,1
16249,277,124,153,44,40,35,18,1141,583,558,141,98,91,45,1
16250,619,332,287,95,77,74,38,185,94,91,23,19,17,9,1
16251,693,297,396,87,52,64,27,606,279,327,81,70,49,34,1
16252,504,259,245,73,56,45,29,631,315,316,64,57,49,15,1
16253,610,328,282,78,65,57,33,370,176,194,61,30,40,28,1
16254,838,380,458,114,95,68,57,451,222,229,58,55,51,17,1
16255,168,67,101,37,17,13,13,488,238,250,62,64,65,22,1
16256,628,341,287,77,59,55,31,482,231,251,76,81,64,26,1
16257,287,129,158,48,48,20,9,461,207,254,82,66,55,33,1
16258,1721,809,912,268,234,144,50,905,421,484,110,119,105,34,1
16259,974,462,512,145,134,82,37,817,425,392,120,102,83,26,1
16260,596,288,308,77,51,58,30,892,420,472,135,146,98,37,1
16261,963,525,438,119,102,102,34,324,154,170,57,40,26,4,1
16262,295,122,173,52,42,22,10,1273,592,681,199,164,139,39,1
16263,2414,1189,1225,277,178,170,169,794,390,404,103,95,86,23,1
16264,149,52,97,36,36,7,4,601,313,288,42,48,25,36,1
16265,770,390,380,104,76,78,32,76,42,34,12,8,5,7,1
16266,193,92,101,29,32,25,11,448,236,212,53,64,56,24,1
16267,845,402,443,137,126,105,47,537,276,261,75,68,68,22,1
16268,787,394,393,113,98,52,19,1332,652,680,210,180,155,49,1
16269,156,88,68,29,14,12,11,757,359,398,109,127,80,26,1
16270,377,184,193,56,53,44,14,258,131,127,37,32,20,14,1
16271,427,218,209,61,53,45,26,770,374,396,95,91,79,41,1
16272,1382,689,693,186,176,167,77,1047,562,485,141,127,114,41,1
16273,717,331,386,99,66,62,31,247,110,137,34,45,23,10,1
16274,298,167,131,47,33,40,8,177,68,109,44,21,17,2,1
16275,357,187,170,51,34,40,23,798,287,511,126,125,77,26,1
16276,563,285,278,79,66,48,27,462,224,238,77,75,37,13,1
16277,211,114,97,32,24,19,10,2135,1170,965,232,246,196,89,1
16278,1106,499,607,161,139,95,39,586,254,332,114,111,55,17,1
16279,470,226,244,81,53,59,39,318,176,142,25,32,35,25,1
16280,265,183,82,22,17,41,7,448,275,173,32,53,55,27,1
16281,113,36,77,37,10,14,4,202,102,100,29,35,6,9,1
16282,391,208,183,65,49,57,17,393,186,207,58,50,36,22,1
16283,760,461,299,96,53,99,35,188,101,87,20,18,20,14,1
16284,165,83,82,16,29,11,9,1608,778,830,243,230,159,74,1
16285,556,279,277,83,69,71,19,383,204,179,61,32,54,16,1
16286,246,108,138,32,44,21,10,409,199,210,62,54,50,25,1
16287,516,277,239,72,49,65,17,680,351,329,93,97,87,27,1
16288,425,210,215,56,43,52,25,778,367,411,90,85,64,43,1
16289,183,91,92,31,21,16,11,192,104,88,24,14,24,14,1
16290,2556,1169,1387,248,291,227,275,969,505,464,123,133,92,33,1
16291,146,71,75,20,17,8,7,178,91,87,20,21,12,5,1
16292,152,98,54,13,10,21,9,989,439,550,142,121,75,29,1
16293,770,385,385,78,83,60,16,529,283,246,66,69,66,25,1
16294,671,321,350,95,87,75,34,712,380,332,69,74,57,30,1
16295,71,37,34,11,9,5,5,395,186,209,53,48,46,30,1
16296,1006,468,538,151,135,82,39,424,191,233,76,73,49,13,1
16297,178,91,87,20,21,12,5,536,278,258,72,63,62,20,1
16298,204,96,108,31,37,20,5,192,101,91,25,22,18,9,1
16299,360,192,168,55,45,48,16,416,210,206,55,54,39,20,1
16300,811,361,450,124,107,80,31,771,321,450,151,135,43,15,1
16301,627,316,311,91,76,69,29,1248,584,664,184,164,155,67,1
16302,806,408,398,119,98,91,27,315,150,165,49,59,23,15,1
16303,968,452,516,150,144,79,28,1452,733,719,182,161,179,64,1
16304,346,183,163,51,38,23,6,1356,576,780,229,198,107,38,1
16305,1024,507,517,141,122,119,46,404,190,214,55,55,35,27,1
16306,177,99,78,22,23,20,10,187,107,80,30,16,22,7,1
16307,458,177,281,90,69,48,9,418,190,228,80,50,45,22,1
16308,82,37,45,6,19,10,7,458,243,215,51,44,49,26,1
16309,2442,1193,1249,278,183,170,145,279,106,173,48,35,41,39,1
16310,2261,1217,1044,271,243,267,101,1919,871,1048,315,265,148,61,1
16311,393,186,207,58,50,36,22,1493,672,821,258,211,146,47,1
16312,962,430,532,109,142,61,34,3259,1163,2096,526,657,162,86,1
16313,1591,704,887,253,227,156,50,1881,929,952,259,247,158,57,1
16314,781,418,363,92,90,64,41,603,311,292,102,71,66,23,1
16315,247,110,137,34,45,23,10,1863,866,997,256,219,191,90,1
16316,430,240,190,60,42,34,30,639,287,352,111,108,44,9,1
16317,802,388,414,131,105,96,29,528,283,245,77,72,63,11,1
16318,304,125,179,61,31,44,10,170,81,89,25,24,15,4,1
16319,160,86,74,21,11,16,16,1255,666,589,145,142,120,82,1
16320,1412,603,809,184,195,112,45,901,458,443,91,129,86,21,1
16321,929,462,467,106,88,78,44,1425,670,755,153,189,122,85,1
16322,711,344,367,87,109,74,24,143,79,64,16,25,7,5,1
16323,103,51,52,15,17,6,5,133,66,67,21,24,9,2,1
16324,393,186,207,58,50,36,22,1621,750,871,276,243,162,51,1
16325,1258,531,727,218,216,108,35,699,295,404,132,126,46,28,1
16326,582,285,297,62,57,44,16,857,455,402,135,81,104,40,1
16327,2382,1161,1221,237,220,140,50,619,293,326,98,78,65,22,1
16328,313,166,147,47,44,41,10,983,487,496,126,115,104,52,1
16329,350,181,169,44,52,43,13,503,263,240,72,55,51,34,1
16330,496,272,224,70,58,42,18,465,225,240,65,44,65,25,1
16331,385,181,204,48,41,52,36,458,222,236,69,39,35,18,1
16332,422,198,224,52,52,42,43,437,225,212,61,57,66,12,1
16333,428,226,202,52,60,75,20,589,281,308,69,39,63,20,1
16334,1881,929,952,259,247,158,57,742,303,439,88,96,86,23,1
16335,614,275,339,108,83,80,31,395,222,173,48,42,21,8,1
16336,676,333,343,111,89,94,39,758,362,396,115,102,35,13,1
16337,1021,487,534,135,113,119,32,559,317,242,58,65,37,23,1
16338,546,267,279,90,69,56,19,159,84,75,13,28,10,8,1
16339,624,308,316,92,72,68,22,738,339,399,102,88,68,35,1
16340,738,339,399,102,88,68,35,450,241,209,67,58,54,23,1
16341,579,330,249,52,27,90,11,168,120,48,7,5,20,7,1
16342,232,127,105,36,22,23,15,431,219,212,68,46,67,18,1
16343,425,210,215,56,43,52,25,628,341,287,77,59,55,31,1
16344,419,248,171,44,38,58,19,123,67,56,18,15,10,3,1
16345,607,317,290,87,80,73,10,353,165,188,57,52,35,30,1
16346,456,258,198,58,54,47,15,377,202,175,46,50,41,23,1
16347,444,183,261,74,69,44,35,976,496,480,128,111,121,48,1
16348,245,112,133,32,45,20,10,1807,933,874,248,203,173,71,1
16349,309,154,155,42,44,45,16,594,303,291,84,69,72,31,1
16350,670,333,337,95,79,62,21,415,203,212,77,44,49,18,1
16351,156,64,92,39,19,15,8,503,263,240,72,55,51,34,1
16352,425,199,226,54,71,56,11,559,274,285,75,63,52,16,1
16353,293,134,159,40,27,23,30,296,145,151,42,37,27,13,1
16354,501,240,261,80,62,49,42,425,177,248,72,55,46,21,1
16355,222,123,99,32,20,32,6,327,172,155,38,41,41,15,1
16356,486,254,232,45,33,38,28,639,373,266,77,89,68,25,1
16357,173,110,63,35,6,9,8,534,218,316,101,82,34,31,1
16358,470,226,244,81,53,59,39,908,434,474,127,142,108,47,1
16359,211,92,119,33,44,11,7,1050,473,577,142,119,87,54,1
16360,228,118,110,32,29,36,13,983,487,496,126,115,104,52,1
16361,240,125,115,34,32,30,8,349,179,170,47,50,22,13,1
16362,619,289,330,67,77,36,19,969,505,464,123,133,92,33,1
16363,350,222,128,33,33,41,20,244,165,79,16,25,34,5,1
16364,815,418,397,97,62,70,17,274,137,137,35,22,22,10,1
16365,205,101,104,34,25,34,8,998,514,484,120,122,113,57,1
16366,4655,2074,2581,545,652,562,399,147,81,66,18,18,18,4,1
16367,1390,695,695,180,137,170,71,1233,498,735,252,232,88,41,1
16368,3056,1457,1599,438,389,329,168,1082,532,550,144,151,79,38,1
16369,261,137,124,38,37,29,9,517,196,321,103,98,34,12,1
16370,501,285,216,52,55,62,25,467,269,198,46,51,60,18,1
16371,191,91,100,28,33,23,12,375,202,173,46,49,41,23,1
16372,651,323,328,90,65,64,24,737,363,374,119,101,85,41,1
16373,439,220,219,63,72,25,20,522,235,287,78,67,60,50,1
16374,443,248,195,67,54,40,15,512,261,251,79,73,60,21,1
16375,763,354,409,101,90,63,26,482,231,251,76,81,64,26,1
16376,154,72,82,25,24,5,5,122,52,70,24,22,7,6,1
16377,2416,1280,1136,140,374,175,47,660,359,301,81,87,102,31,1
16378,870,436,434,131,114,72,25,982,545,437,119,100,92,40,1
16379,1231,603,628,121,162,109,120,2477,1186,1291,256,271,249,90,1
16380,540,271,269,80,77,51,16,689,343,346,105,102,81,35,1
16381,960,409,551,166,134,77,44,181,96,85,26,23,18,7,1
16382,400,195,205,63,67,40,18,181,96,85,25,23,20,7,1
16383,235,129,106,24,19,20,10,993,492,501,116,119,135,57,1
16384,1189,653,536,152,118,109,56,482,231,251,76,81,64,26,1
16385,586,309,277,81,64,76,25,201,42,159,19,3,2,75,1
16386,204,84,120,39,39,18,10,683,320,363,117,100,76,32,1
16387,802,388,414,131,105,96,29,433,222,211,68,58,42,23,1
16388,465,225,240,65,44,65,25,905,371,534,192,135,81,28,1
16389,465,225,240,65,44,65,25,760,461,299,96,53,99,35,1
16390,815,418,397,97,62,70,17,480,244,236,74,47,50,21,1
16391,770,356,414,123,102,66,25,2472,1057,1415,331,352,159,96,1
16392,440,282,158,38,21,38,24,359,173,186,55,57,44,16,1
16393,1442,606,836,212,158,111,47,202,102,100,29,35,6,9,1
16394,2489,1251,1238,288,234,283,178,530,315,215,83,43,78,11,1
16395,968,452,516,150,144,79,28,822,374,448,134,118,76,39,1
16396,247,127,120,43,20,27,14,1074,538,536,154,140,111,51,1
16397,5497,2328,3169,872,896,436,168,3312,1761,1551,403,345,309,127,1
16398,329,159,170,46,51,34,15,257,134,123,35,32,33,9,1
16399,684,288,396,107,90,54,42,1215,572,643,151,105,127,54,1
16400,1863,721,1142,262,283,139,74,1531,691,840,270,226,143,52,1
16401,403,185,218,67,62,63,19,326,153,173,63,48,25,8,1
16402,168,67,101,37,17,13,13,414,195,219,51,60,40,17,1
16403,422,211,211,73,61,43,17,505,247,258,72,71,60,27,1
16404,450,194,256,57,75,45,22,1071,549,522,133,127,130,59,1
16405,391,208,183,65,49,57,17,253,148,105,31,15,39,16,1
16406,217,108,109,30,23,28,10,224,108,116,33,26,32,10,1
16407,901,458,443,91,129,86,21,586,254,332,114,111,55,17,1
16408,419,189,230,64,49,36,15,904,436,468,138,146,82,39,1
16409,401,226,175,53,18,38,20,417,182,235,57,109,50,8,1
16410,515,246,269,77,62,60,24,217,109,108,34,32,35,7,1
16411,412,238,174,41,38,43,19,427,226,201,63,44,66,13,1
16412,706,346,360,118,92,98,56,512,261,251,79,73,60,21,1
16413,99,50,49,18,11,8,6,350,213,137,39,21,53,22,1
16414,152,74,78,16,20,16,5,1749,880,869,237,228,214,112,1
16415,533,254,279,81,78,52,10,847,402,445,137,119,102,41,1
16416,624,323,301,76,67,74,48,605,263,342,73,103,54,18,1
16417,267,147,120,37,28,35,12,469,247,222,70,58,82,13,1
16418,501,240,261,80,62,49,42,1798,844,954,277,212,142,53,1
16419,456,228,228,49,70,32,19,498,174,324,112,108,33,19,1
16420,444,259,185,45,33,65,25,672,334,338,110,93,91,41,1
16421,655,281,374,108,103,61,24,915,336,579,185,199,56,29,1
16422,427,218,209,61,53,45,26,711,344,367,87,109,74,24,1
16423,1210,592,618,157,138,116,85,742,303,439,88,96,86,23,1
16424,426,228,198,62,42,47,22,1053,436,617,207,130,117,57,1
16425,500,268,232,65,56,28,17,619,292,327,73,73,61,32,1
16426,604,282,322,76,74,69,35,416,201,215,54,52,39,25,1
16427,292,152,140,46,38,35,12,695,340,355,79,124,53,13,1
16428,268,157,111,26,30,28,13,303,175,128,43,36,34,12,1
16429,290,138,152,37,50,24,14,261,119,142,49,27,16,11,1
16430,313,159,154,30,40,23,14,520,328,192,47,35,65,37,1
16431,853,400,453,137,109,88,42,482,231,251,76,81,64,26,1
16432,214,109,105,31,26,25,17,502,299,203,57,52,32,11,1
16433,2063,1024,1039,175,117,80,97,638,305,333,68,90,70,29,1
16434,948,484,464,134,131,75,27,3911,1465,2446,610,767,240,133,1
16435,375,202,173,46,49,41,23,390,191,199,66,49,43,12,1
16436,289,147,142,45,45,38,13,446,221,225,50,44,45,22,1
16437,191,98,93,26,18,19,9,465,225,240,65,44,65,25,1
16438,800,365,435,129,102,97,31,334,171,163,48,42,32,18,1
16439,291,133,158,46,51,21,15,482,231,251,76,81,64,26,1
16440,362,233,129,37,17,51,18,1257,662,595,176,142,106,42,1
16441,582,293,289,94,80,77,32,441,218,223,69,55,50,27,1
16442,742,303,439,88,96,86,23,1544,670,874,236,239,128,49,1
16443,143,65,78,32,11,11,11,1132,553,579,172,143,150,57,1
16444,391,208,183,65,49,57,17,1863,721,1142,262,283,139,74,1
16445,615,293,322,70,67,45,29,501,240,261,80,62,49,42,1
16446,863,458,405,97,82,63,57,1149,568,581,177,133,101,30,1
16447,247,110,137,34,45,23,10,653,309,344,107,75,49,14,1
16448,204,93,111,35,35,16,11,375,202,173,46,49,41,23,1
16449,738,339,399,102,88,68,35,2871,1148,1723,496,469,204,98,1
16450,720,356,364,90,98,61,22,491,227,264,72,82,46,29,1
16451,121,69,52,15,18,14,8,904,436,468,138,146,82,39,1
16452,517,295,222,60,55,55,19,467,250,217,59,52,41,19,1
16453,413,183,230,69,55,37,18,291,141,150,49,43,26,7,1
16454,740,385,355,114,97,91,27,360,192,168,55,45,48,16,1
16455,227,124,103,37,23,26,10,770,374,396,95,91,79,41,1
16456,207,120,87,17,16,27,10,770,355,415,103,142,75,42,1
16457,504,272,232,72,41,57,23,393,186,207,58,50,36,22,1
16458,309,137,172,51,50,28,14,928,442,486,139,118,91,43,1
16459,1690,795,895,271,257,150,101,339,170,169,32,17,24,13,1
16460,624,204,420,166,101,32,13,262,78,184,78,28,32,4,1
16461,207,108,99,25,15,27,16,328,173,155,43,36,24,17,1
16462,400,228,172,43,20,47,24,217,109,108,34,32,35,7,1
16463,140,86,54,17,6,20,7,681,286,395,109,61,69,42,1
16464,914,453,461,112,115,79,29,184,86,98,26,26,14,11,1
16465,1117,423,694,182,134,88,31,125,66,59,24,16,11,5,1
16466,151,60,91,23,29,4,6,743,341,402,104,89,68,38,1
16467,964,408,556,131,153,76,55,144,57,87,38,26,10,4,1
16468,740,313,427,101,135,40,22,281,166,115,34,17,36,16,1
16469,201,103,98,18,25,40,18,359,184,175,49,35,32,11,1
16470,3056,1457,1599,438,389,329,168,393,186,207,58,50,36,22,1
16471,1124,578,546,149,127,122,61,326,151,175,50,39,36,17,1
16472,519,246,273,78,82,42,16,670,384,286,58,58,79,52,1
16473,1035,559,476,128,122,122,50,825,363,462,97,105,72,75,1
16474,673,317,356,101,85,76,49,1273,592,681,199,164,139,39,1
16475,435,208,227,68,64,53,23,906,474,432,90,125,74,24,1
16476,425,198,227,57,69,59,13,422,203,219,75,49,40,22,1
16477,502,253,249,65,43,60,32,180,95,85,27,15,14,16,1
16478,562,214,348,120,86,69,42,469,221,248,49,60,55,21,1
16479,4128,2104,2024,581,505,453,205,209,75,134,53,48,20,9,1
16480,546,267,279,90,69,56,19,171,94,77,24,28,30,11,1
16481,239,144,95,20,26,23,13,141,70,71,16,19,12,6,1
16482,672,334,338,110,93,91,41,656,358,298,67,47,64,26,1
16483,670,358,312,95,75,58,26,212,114,98,25,26,19,11,1
16484,313,160,153,51,33,43,23,202,102,100,29,35,6,9,1
16485,199,87,112,31,27,8,15,709,294,415,132,123,76,23,1
16486,168,76,92,26,21,19,4,467,261,206,54,49,48,24,1
16487,870,418,452,121,102,109,28,649,326,323,83,66,87,38,1
16488,143,65,78,32,11,11,11,241,150,91,15,17,35,19,1
16489,1190,638,552,162,95,112,18,313,157,156,39,26,34,29,1
16490,892,420,472,135,146,98,37,1134,574,560,157,164,47,48,1
16491,211,113,98,38,17,25,8,554,269,285,60,67,38,21,1
16492,139,62,77,23,6,14,4,461,257,204,63,49,50,29,1
16493,503,259,244,73,53,52,28,412,192,220,71,50,48,23,1
16494,1100,474,626,197,143,126,41,553,261,292,73,79,40,26,1
16495,684,288,396,107,90,54,42,1712,1175,537,179,142,113,46,1
16496,962,502,460,112,122,109,50,3224,1440,1784,455,440,333,126,1
16497,263,99,164,74,39,22,8,213,91,122,42,30,23,12,1
16498,1338,633,705,199,151,144,65,923,471,452,119,117,119,41,1
16499,480,234,246,79,77,65,23,168,76,92,26,21,19,4,1
16500,1215,652,563,129,142,121,62,229,105,124,36,33,12,4,1
16501,2541,1299,1242,306,302,121,98,1039,597,442,101,110,106,33,1
16502,667,360,307,76,92,46,27,206,100,106,28,32,18,8,1
16503,246,113,133,33,45,22,10,372,179,193,50,52,33,6,1
16504,536,278,258,72,63,62,20,1153,588,565,174,128,149,56,1
16505,423,212,211,51,44,48,28,780,369,411,130,113,79,35,1
16506,512,261,251,79,73,60,21,863,470,393,82,72,92,44,1
16507,276,136,140,39,34,33,9,619,332,287,95,77,74,38,1
16508,429,187,242,79,72,28,19,969,505,464,123,133,92,33,1
16509,541,279,262,79,82,31,32,648,341,307,78,89,77,21,1
16510,525,281,244,69,68,65,25,973,527,446,110,137,122,34,1
16511,351,184,167,59,45,54,9,90,41,49,26,14,0,1,1
16512,196,105,91,22,26,21,8,245,117,128,42,30,26,11,1
16513,400,208,192,62,44,42,21,339,140,199,46,67,19,8,1
16514,525,274,251,82,74,60,25,118,56,62,13,14,6,6,1
16515,341,195,146,42,21,36,9,303,187,116,41,23,23,9,1
16516,509,243,266,80,57,45,19,619,332,287,95,77,74,38,1
16517,450,238,212,59,45,53,23,528,268,260,81,77,36,22,1
16518,2109,999,1110,332,294,187,89,312,117,195,87,50,35,11,1
16519,95,44,51,14,13,7,4,527,273,254,81,61,81,14,1
16520,667,360,307,76,92,46,27,385,194,191,49,50,40,12,1
16521,475,268,207,61,27,56,30,520,300,220,66,36,57,23,1
16522,103,56,47,27,7,8,2,806,365,441,134,118,78,44,1
16523,399,201,198,65,45,48,17,95,41,54,15,16,8,5,1
16524,738,339,399,102,88,68,35,509,262,247,64,70,64,20,1
16525,598,316,282,81,83,71,21,108,51,57,16,12,16,11,1
16526,724,334,390,112,109,79,17,223,132,91,18,16,27,17,1
16527,309,154,155,42,44,45,16,862,409,453,149,125,86,29,1
16528,1225,593,632,158,125,102,38,509,262,247,64,70,64,20,1
16529,261,137,124,33,25,49,9,259,133,126,26,30,22,22,1
16530,239,146,93,30,22,35,9,105,53,52,23,11,12,6,1
16531,601,313,288,42,48,25,36,1312,599,713,225,186,50,19,1
16532,747,369,378,85,78,81,47,1270,557,713,130,195,57,30,1
16533,590,330,260,79,69,56,13,206,85,121,31,42,6,17,1
16534,257,148,109,28,20,21,14,504,259,245,73,56,45,29,1
16535,418,205,213,69,50,29,15,399,184,215,55,81,29,10,1
16536,585,242,343,110,111,55,20,1014,490,524,177,137,94,38,1
16537,412,203,209,65,47,37,18,625,298,327,90,78,57,33,1
16538,345,203,142,47,35,31,11,595,316,279,86,60,65,40,1
16539,590,279,311,103,83,69,30,348,226,122,23,20,59,25,1
16540,368,201,167,61,38,38,12,509,273,236,65,54,55,30,1
16541,462,233,229,66,49,43,30,320,163,157,44,44,26,15,1
16542,636,284,352,108,101,40,23,360,192,168,55,45,48,16,1
16543,845,412,433,146,103,112,18,911,423,488,140,150,102,32,1
16544,128,67,61,19,13,15,4,655,311,344,69,73,60,28,1
16545,585,299,286,92,73,89,23,431,220,211,71,49,42,16,1
16546,1100,581,519,144,149,78,42,609,292,317,102,96,64,21,1
16547,444,230,214,46,61,53,26,577,288,289,85,56,40,20,1
16548,593,266,327,102,84,69,24,1097,526,571,131,134,120,43,1
16549,229,116,113,34,27,27,15,990,410,580,140,175,44,36,1
16550,245,112,133,32,45,20,10,445,225,220,47,62,53,26,1
16551,331,169,162,40,28,22,14,770,374,396,95,91,79,41,1
16552,133,61,72,21,19,13,4,233,120,113,38,32,20,15,1
16553,714,364,350,98,102,91,27,397,237,160,47,15,56,21,1
16554,1000,510,490,117,123,113,31,261,130,131,27,41,19,16,1
16555,620,299,321,75,60,68,30,465,231,234,80,63,56,23,1
16556,244,147,97,23,11,37,17,760,391,369,101,109,65,24,1
16557,750,347,403,105,103,83,29,558,302,256,66,62,65,30,1
16558,1162,515,647,191,143,97,35,205,91,114,31,36,13,8,1
16559,653,309,344,107,75,49,14,216,102,114,31,29,21,6,1
16560,2414,1189,1225,277,178,170,169,543,265,278,52,37,54,19,1
16561,207,97,110,34,27,22,10,466,186,280,71,84,30,11,1
16562,116,58,58,13,14,7,8,369,216,153,36,22,46,23,1
16563,810,367,443,115,92,94,59,1065,533,532,147,148,176,40,1
16564,480,232,248,83,64,51,25,448,275,173,32,53,55,27,1
16565,769,362,407,99,88,66,67,406,209,197,57,50,50,17,1
16566,446,176,270,64,79,45,24,456,191,265,82,55,45,11,1
16567,1581,684,897,220,153,118,63,393,186,207,58,50,36,22,1
16568,639,298,341,77,61,70,20,147,79,68,20,15,19,8,1
16569,425,210,215,56,43,52,25,673,318,355,61,71,40,31,1
16570,574,287,287,94,70,63,25,1270,557,713,130,195,57,30,1
16571,277,124,153,44,40,35,18,1354,537,817,245,247,117,57,1
16572,964,408,556,131,153,76,55,501,240,261,80,62,49,42,1
16573,750,347,403,105,103,83,29,165,66,99,28,32,16,3,1
16574,1424,650,774,152,124,95,87,331,169,162,40,28,22,14,1
16575,1312,484,828,258,239,86,51,754,318,436,114,106,58,28,1
16576,1139,536,603,162,139,109,50,292,153,139,39,33,24,21,1
16577,217,94,123,29,30,23,17,354,169,185,54,54,41,19,1
16578,264,121,143,57,32,22,15,578,329,249,65,72,78,23,1
16579,890,512,378,92,95,75,41,724,334,390,112,109,79,17,1
16580,787,394,393,113,98,52,19,368,170,198,59,64,29,13,1
16581,902,332,570,154,146,75,40,1068,527,541,160,131,112,52,1
16582,832,428,404,131,89,88,38,331,193,138,44,37,18,9,1
16583,815,418,397,97,62,70,17,381,162,219,55,76,28,18,1
16584,341,178,163,48,44,42,20,676,333,343,111,89,94,39,1
16585,406,192,214,60,45,45,24,349,167,182,54,38,30,28,1
16586,99,34,65,12,1,2,18,1117,423,694,182,134,88,31,1
16587,3703,1708,1995,456,428,305,162,628,341,287,77,59,55,31,1
16588,416,210,206,55,54,39,20,522,245,277,78,69,52,21,1
16589,283,132,151,57,33,12,7,268,143,125,43,29,22,10,1
16590,442,254,188,54,31,50,30,178,100,78,23,22,30,6,1
16591,932,471,461,137,86,84,32,536,278,258,72,63,62,20,1
16592,261,102,159,45,36,31,37,393,186,207,58,50,36,22,1
16593,331,170,161,47,39,41,8,552,283,269,89,66,68,30,1
16594,538,252,286,77,87,53,30,448,275,173,32,53,55,27,1
16595,822,416,406,111,105,84,44,1419,759,660,198,135,147,51,1
16596,475,247,228,62,45,75,24,521,265,256,69,69,61,26,1
16597,454,187,267,66,80,36,15,948,484,464,134,131,75,27,1
16598,588,317,271,78,49,54,17,781,418,363,92,90,64,41,1
16599,343,152,191,47,73,27,11,220,126,94,29,12,34,11,1
16600,745,391,354,85,81,52,39,1255,666,589,145,142,120,82,1
16601,1354,537,817,245,247,117,57,586,254,332,114,111,55,17,1
16602,592,291,301,92,93,71,31,335,177,158,45,49,34,13,1
16603,211,92,119,33,44,11,7,677,361,316,81,61,42,22,1
16604,262,114,148,46,44,30,16,2414,1189,1225,277,178,170,169,1
16605,1308,652,656,166,153,149,87,728,385,343,110,102,69,14,1
16606,1342,673,669,178,154,137,94,803,395,408,127,102,79,31,1
16607,95,44,51,14,13,7,4,334,181,153,41,40,25,15,1
16608,538,252,286,77,87,53,30,277,124,153,44,40,35,18,1
16609,117,60,57,20,17,16,5,255,113,142,45,30,24,13,1
16610,1014,490,524,177,137,94,38,140,71,69,33,11,14,2,1
16611,745,366,379,110,93,79,45,136,65,71,33,11,9,6,1
16612,532,291,241,83,36,79,25,1106,565,541,139,102,103,52,1
16613,2472,1055,1417,416,458,235,64,277,124,153,44,40,35,18,1
16614,673,317,356,101,85,76,49,208,107,101,42,22,18,10,1
16615,498,263,235,59,63,36,10,399,216,183,60,53,43,18,1
16616,436,246,190,59,45,57,28,858,417,441,124,101,85,41,1
16617,336,154,182,51,48,39,22,928,442,486,139,118,91,43,1
16618,811,441,370,95,84,95,49,1464,987,477,137,141,55,31,1
16619,1970,978,992,245,206,198,80,1493,672,821,258,211,146,47,1
16620,195,83,112,40,16,19,16,297,145,152,49,30,23,21,1
16621,256,125,131,34,27,24,14,551,237,314,95,79,54,17,1
16622,427,218,209,61,53,45,26,379,203,176,55,48,45,16,1
16623,211,126,85,21,20,28,7,393,186,207,58,50,36,22,1
16624,524,264,260,75,75,40,21,352,166,186,55,59,31,16,1
16625,870,489,381,97,99,76,14,476,270,206,62,45,46,30,1
16626,496,269,227,67,55,37,19,450,241,209,67,58,54,23,1
16627,91,50,41,8,14,4,5,133,66,67,21,24,9,2,1
16628,351,184,167,59,45,54,9,726,326,400,106,106,57,31,1
16629,924,441,483,131,115,90,38,206,94,112,37,36,18,9,1
16630,475,268,207,61,27,56,30,350,213,137,39,21,53,22,1
16631,551,298,253,63,65,45,19,1863,721,1142,262,283,139,74,1
16632,508,215,293,72,71,42,15,1382,689,693,186,176,167,77,1
16633,76,30,46,7,15,1,5,641,324,317,88,92,49,14,1
16634,167,86,81,21,21,11,11,636,320,316,79,61,67,31,1
16635,161,73,88,23,22,15,8,288,156,132,36,36,24,15,1
16636,647,322,325,104,98,54,14,315,118,197,85,57,42,14,1
16637,393,210,183,55,50,34,19,772,417,355,118,92,80,23,1
16638,1124,615,509,157,125,128,52,509,262,247,64,70,64,20,1
16639,317,201,116,31,14,38,20,267,129,138,45,40,23,14,1
16640,196,110,86,23,15,14,16,179,96,83,21,18,19,6,1
16641,158,85,73,24,18,18,8,912,460,452,139,132,89,53,1
16642,998,532,466,113,109,97,53,304,159,145,38,40,32,3,1
16643,684,300,384,101,106,67,20,202,102,100,29,35,6,9,1
16644,1210,592,618,157,138,116,85,770,374,396,95,91,79,41,1
16645,313,149,164,48,31,30,13,256,125,131,34,27,24,14,1
16646,321,180,141,47,37,33,12,427,204,223,38,57,26,32,1
16647,159,69,90,24,20,9,7,1115,586,529,124,161,111,69,1
16648,1292,592,700,186,169,108,22,605,295,310,74,66,70,36,1
16649,1214,498,716,197,180,121,65,467,226,241,55,48,54,23,1
16650,150,60,90,27,16,6,3,269,156,113,37,32,17,7,1
16651,503,263,240,72,55,51,34,833,389,444,126,111,85,31,1
16652,1129,528,601,154,162,114,52,1066,587,479,127,108,118,48,1
16653,1091,543,548,146,136,110,34,1497,881,616,151,117,94,40,1
16654,2032,995,1037,320,281,137,88,1015,526,489,133,133,86,34,1
16655,838,431,407,107,90,107,43,583,322,261,73,66,45,26,1
16656,373,227,146,40,19,58,21,326,217,109,32,20,43,18,1
16657,614,305,309,96,73,65,24,393,186,207,58,50,36,22,1
16658,181,96,85,25,23,20,7,1129,500,629,171,148,85,30,1
16659,684,288,396,107,90,54,42,382,169,213,51,38,36,18,1
16660,441,201,240,70,58,55,24,428,226,202,52,60,75,20,1
16661,425,210,215,56,43,52,25,437,167,270,126,95,34,10,1
16662,2471,1130,1341,240,281,219,290,500,244,256,66,57,52,27,1
16663,651,307,344,74,130,45,18,140,76,64,17,13,13,8,1
16664,1212,645,567,145,117,122,72,2639,1436,1203,317,307,242,77,1
16665,778,367,411,90,85,64,43,149,68,81,15,38,11,10,1
16666,253,127,126,31,25,21,21,99,50,49,18,11,8,6,1
16667,712,313,399,115,106,40,16,341,178,163,48,44,42,20,1
16668,651,323,328,90,65,64,24,770,355,415,103,142,75,42,1
16669,536,278,258,72,63,62,20,745,366,379,110,93,79,45,1
16670,381,189,192,74,49,44,13,384,241,143,45,18,40,23,1
16671,1118,471,647,204,164,102,34,540,269,271,51,70,43,26,1
16672,593,295,298,70,85,48,13,1091,543,548,146,136,110,34,1
16673,421,192,229,72,54,51,48,418,199,219,55,44,22,15,1
16674,920,492,428,100,92,88,49,326,166,160,49,45,36,12,1
16675,491,283,208,55,61,40,13,710,420,290,60,54,79,49,1
16676,205,82,123,38,28,20,15,354,169,185,54,54,41,19,1
16677,413,227,186,47,64,26,16,233,121,112,24,31,30,7,1
16678,770,390,380,104,76,78,32,72,35,37,10,9,7,6,1
16679,297,141,156,32,18,31,15,815,418,397,97,62,70,17,1
16680,481,256,225,60,56,48,12,128,67,61,19,13,15,4,1
16681,1333,646,687,209,179,148,45,226,109,117,38,36,13,11,1
16682,351,184,167,59,45,54,9,2843,1104,1739,429,357,178,95,1
16683,1424,650,774,152,124,95,87,339,170,169,32,17,24,13,1
16684,218,115,103,32,32,34,11,467,250,217,59,52,41,19,1
16685,406,202,204,54,54,41,16,703,356,347,96,97,38,22,1
16686,1198,571,627,177,168,97,54,595,316,279,86,60,65,40,1
16687,338,156,182,58,39,39,15,331,145,186,40,56,16,9,1
16688,327,177,150,40,40,38,18,334,172,162,43,39,41,17,1
16689,966,416,550,152,134,98,42,756,348,408,101,103,60,40,1
16690,484,192,292,118,68,83,22,73,35,38,14,10,9,4,1
16691,95,44,51,14,13,7,4,211,94,117,35,35,29,8,1
16692,1011,499,512,157,133,116,48,204,99,105,32,32,22,10,1
16693,2442,1193,1249,278,183,170,145,196,107,89,20,31,17,4,1
16694,881,428,453,174,110,64,21,595,316,279,86,60,65,40,1
16695,552,264,288,86,72,68,23,377,180,197,37,20,24,8,1
16696,513,246,267,71,66,60,35,468,238,230,67,69,39,26,1
16697,730,313,417,119,92,65,23,208,99,109,28,30,18,9,1
16698,126,53,73,23,19,8,4,781,418,363,92,90,64,41,1
16699,729,325,404,129,88,64,32,119,67,52,15,15,7,7,1
16700,355,179,176,51,45,45,11,332,180,152,46,36,28,14,1
16701,303,159,144,40,35,35,8,1333,646,687,209,179,148,45,1
16702,542,249,293,82,69,58,31,605,283,322,94,72,64,39,1
16703,425,177,248,72,55,46,21,574,277,297,88,77,58,36,1
16704,410,200,210,60,54,46,19,552,285,267,74,51,69,24,1
16705,2138,1161,977,258,229,249,95,340,162,178,40,39,35,22,1
16706,260,120,140,34,39,36,12,194,112,82,26,13,17,8,1
16707,684,351,333,104,79,74,19,467,224,243,70,43,67,23,1
16708,201,102,99,25,26,19,7,990,410,580,140,175,44,36,1
16709,1441,657,784,140,135,81,73,789,362,427,90,82,70,35,1
16710,277,124,153,44,40,35,18,791,306,485,142,157,21,18,1
16711,526,266,260,76,75,53,22,191,99,92,25,24,18,8,1
16712,1123,554,569,142,130,85,36,473,217,256,59,44,34,21,1
16713,1270,682,588,165,147,136,54,709,294,415,132,123,76,23,1
16714,825,399,426,128,128,77,32,294,148,146,35,33,25,14,1
16715,265,119,146,44,52,12,9,868,448,420,108,103,76,25,1
16716,528,283,245,77,72,63,11,246,108,138,32,44,21,10,1
16717,784,391,393,105,113,86,21,781,418,363,92,90,64,41,1
16718,515,256,259,68,58,53,33,982,545,437,119,100,92,40,1
16719,211,83,128,28,35,5,11,118,67,51,13,13,7,7,1
16720,351,184,167,59,45,54,9,1079,582,497,151,133,133,47,1
16721,476,251,225,57,67,57,18,769,329,440,116,66,55,22,1
16722,784,337,447,127,135,59,29,570,281,289,86,70,58,22,1
16723,138,74,64,14,15,8,2,2477,1186,1291,256,271,249,90,1
16724,262,138,124,25,34,34,16,427,186,241,55,52,42,23,1
16725,304,127,177,61,38,31,4,553,261,292,73,79,40,26,1
16726,593,257,336,76,56,56,96,467,224,243,70,43,67,23,1
16727,165,83,82,16,29,11,9,164,78,86,28,23,12,8,1
16728,427,218,209,61,53,45,26,505,247,258,72,71,60,27,1
16729,415,209,206,60,67,39,18,1834,823,1011,297,282,151,63,1
16730,739,359,380,83,95,53,38,146,85,61,15,9,12,10,1
16731,181,95,86,21,22,18,9,2230,752,1478,421,460,118,67,1
16732,1270,682,588,165,147,136,54,280,142,138,35,37,22,13,1
16733,270,137,133,30,28,27,11,114,71,43,8,18,7,4,1
16734,673,313,360,101,101,46,17,366,124,242,80,63,25,8,1
16735,448,209,239,36,53,46,52,862,427,435,139,98,100,59,1
16736,360,192,168,55,45,48,16,143,79,64,16,25,7,5,1
16737,630,326,304,82,62,80,31,767,392,375,113,112,83,13,1
16738,127,58,69,20,30,6,7,288,142,146,52,32,26,8,1
16739,824,392,432,106,89,88,32,277,124,153,44,40,35,18,1
16740,771,321,450,151,135,43,15,159,84,75,13,28,10,8,1
16741,161,75,86,21,11,17,7,509,262,247,64,70,64,20,1
16742,835,419,416,119,94,106,40,210,89,121,51,34,11,6,1
16743,159,84,75,13,28,10,8,168,67,101,37,17,13,13,1
16744,912,461,451,127,109,96,48,1265,580,685,205,188,166,53,1
16745,318,176,142,25,32,35,25,458,245,213,52,43,27,24,1
16746,557,268,289,66,67,70,17,770,374,396,95,91,79,41,1
16747,289,164,125,37,31,35,16,769,329,440,116,66,55,22,1
16748,605,295,310,74,66,70,36,635,333,302,99,75,83,28,1
16749,532,267,265,86,55,64,22,1074,538,536,154,140,111,51,1
16750,314,158,156,41,57,30,12,395,197,198,44,57,27,18,1
16751,152,74,78,17,20,16,6,393,186,207,58,50,36,22,1
16752,435,187,248,62,51,51,21,501,240,261,80,62,49,42,1
16753,3703,1708,1995,456,428,305,162,640,279,361,102,83,69,21,1
16754,487,201,286,71,84,26,26,595,272,323,111,107,54,28,1
16755,389,239,150,45,20,46,22,409,200,209,69,56,44,13,1
16756,1441,657,784,140,135,81,73,508,267,241,43,35,25,17,1
16757,524,264,260,75,75,40,21,217,109,108,34,32,35,7,1
16758,225,116,109,29,19,25,6,1338,756,582,155,105,104,44,1
16759,111,29,82,10,54,0,1,215,104,111,61,7,2,1,1
16760,745,366,379,110,93,79,45,467,240,227,65,65,51,23,1
16761,132,67,65,22,15,17,5,335,172,163,40,29,31,15,1
16762,326,141,185,57,39,33,20,769,329,440,116,66,55,22,1
16763,207,99,108,34,27,22,9,1132,646,486,99,102,71,41,1
16764,325,159,166,39,40,41,14,1060,531,529,129,122,122,29,1
16765,304,184,120,36,16,36,18,213,76,137,63,36,13,2,1
16766,1463,521,942,252,204,105,52,437,167,270,126,95,34,10,1
16767,140,86,54,17,6,20,7,275,125,150,37,48,27,7,1
16768,855,456,399,96,105,108,47,1466,991,475,136,129,59,39,1
16769,854,399,455,127,118,57,39,352,167,185,49,44,37,16,1
16770,158,85,73,24,18,18,8,885,339,546,159,135,81,49,1
16771,377,202,175,46,50,41,22,109,63,46,17,7,16,9,1
16772,496,260,236,55,64,38,20,168,67,101,37,17,13,13,1
16773,1154,540,614,195,160,138,66,578,294,284,60,66,63,17,1
16774,549,290,259,64,61,62,15,1834,823,1011,297,282,151,63,1
16775,2063,1024,1039,175,117,80,97,358,212,146,51,36,33,9,1
16776,617,336,281,76,81,62,29,455,255,200,72,57,38,19,1
16777,724,650,74,44,3,32,3,359,184,175,49,35,32,11,1
16778,639,373,266,77,89,68,25,1190,638,552,162,95,112,18,1
16779,496,269,227,67,55,37,19,512,261,251,79,73,60,21,1
16780,505,239,266,71,55,50,18,400,191,209,41,40,33,21,1
16781,163,70,93,28,21,17,6,218,108,110,28,28,22,10,1
16782,914,401,513,110,125,64,37,1046,562,484,139,116,124,51,1
16783,573,247,326,98,95,46,22,770,355,415,103,142,75,42,1
16784,806,436,370,101,100,76,34,268,129,139,50,15,33,7,1
16785,537,276,261,75,68,68,22,834,405,429,112,95,84,34,1
16786,330,159,171,48,38,50,19,327,177,150,40,40,38,18,1
16787,529,265,264,37,19,37,20,601,313,288,42,48,25,36,1
16788,202,86,116,33,29,26,10,354,169,185,54,54,41,19,1
16789,971,516,455,114,115,116,35,589,316,273,83,60,69,25,1
16790,762,361,401,97,111,92,36,518,235,283,94,77,55,22,1
16791,211,88,123,38,28,26,10,414,185,229,53,54,49,11,1
16792,609,292,317,102,96,64,21,128,65,63,18,13,7,6,1
16793,439,227,212,60,55,58,8,502,299,203,57,52,32,11,1
16794,267,159,108,31,13,22,15,356,208,148,42,26,57,15,1
16795,273,131,142,35,35,25,12,976,496,480,128,111,121,48,1
16796,624,308,316,92,72,68,22,244,136,108,21,25,25,13,1
16797,1696,771,925,257,225,149,63,96,50,46,8,15,6,2,1
16798,255,113,142,31,40,18,9,325,149,176,51,49,24,11,1
16799,468,233,235,65,61,49,34,676,333,343,111,89,94,39,1
16800,1251,635,616,155,215,101,48,346,187,159,42,34,43,21,1
16801,512,254,258,70,48,37,32,482,231,251,76,81,64,26,1
16802,264,130,134,38,33,26,10,892,420,472,135,146,98,37,1
16803,822,417,405,111,127,76,34,493,230,263,73,47,47,13,1
16804,309,161,148,38,34,40,15,362,183,179,49,49,41,11,1
16805,623,320,303,103,85,75,15,422,211,211,73,61,43,17,1
16806,501,285,216,52,55,62,25,711,435,276,72,62,51,20,1
16807,553,261,292,73,79,40,26,1255,666,589,145,142,120,82,1
16808,556,269,287,86,66,62,22,902,495,407,116,97,111,37,1
16809,963,477,486,134,143,123,38,579,321,258,74,70,47,22,1
16810,1004,498,506,94,59,46,33,858,431,427,94,57,54,30,1
16811,1251,591,660,183,137,106,50,279,106,173,48,35,41,39,1
16812,562,281,281,80,61,67,23,933,493,440,140,108,124,32,1
16813,423,219,204,58,41,69,15,810,367,443,115,92,94,59,1
16814,373,213,160,44,33,27,17,462,233,229,66,49,43,30,1
16815,802,388,414,131,105,96,29,2442,1193,1249,278,183,170,145,1
16816,360,161,199,72,36,35,13,509,262,247,64,70,64,20,1
16817,436,209,227,66,47,52,22,712,331,381,111,86,86,34,1
16818,412,223,189,55,55,41,10,1124,578,546,149,127,122,61,1
16819,409,268,141,32,26,57,25,911,551,360,92,106,107,29,1
16820,323,123,200,59,69,30,15,422,203,219,75,49,40,22,1
16821,553,261,292,73,79,40,26,647,324,323,101,80,76,43,1
16822,1094,508,586,152,151,77,36,181,96,85,25,23,20,7,1
16823,750,371,379,95,98,86,29,170,81,89,25,24,15,4,1
16824,475,235,240,77,58,43,22,468,212,256,70,45,30,18,1
16825,1342,673,669,178,154,137,94,217,109,108,34,32,35,7,1
16826,412,202,210,64,46,43,34,895,474,421,122,93,69,25,1
16827,980,537,443,125,99,98,50,401,167,234,56,71,16,10,1
16828,764,430,334,82,82,94,32,839,444,395,107,95,104,39,1
16829,673,329,344,111,95,92,41,217,98,119,33,32,27,7,1
16830,446,176,270,64,79,45,24,686,337,349,96,116,45,19,1
16831,345,203,142,47,35,31,11,778,367,411,90,85,64,43,1
16832,2920,1191,1729,439,398,182,99,493,284,209,76,29,48,30,1
16833,725,329,396,113,97,52,41,247,106,141,40,45,7,14,1
16834,1901,796,1105,253,274,183,76,381,191,190,55,61,33,11,1
16835,185,83,102,30,19,21,8,597,313,284,87,75,82,28,1
16836,548,292,256,67,65,68,26,191,101,90,21,23,28,5,1
16837,766,386,380,101,81,78,31,245,111,134,31,44,20,11,1
16838,204,84,120,29,30,16,9,246,108,138,32,44,21,10,1
16839,834,395,439,117,92,96,28,353,158,195,75,31,33,11,1
16840,529,264,265,59,68,41,17,103,44,59,16,17,9,5,1
16841,328,184,144,47,24,23,9,1215,572,643,151,105,127,54,1
16842,962,430,532,109,142,61,34,603,291,312,98,87,61,28,1
16843,1115,586,529,124,161,111,69,211,100,111,60,17,16,5,1
16844,236,141,95,36,32,14,6,552,285,267,74,51,69,24,1
16845,497,185,312,63,92,38,28,605,285,320,89,61,68,26,1
16846,1960,810,1150,358,377,121,72,1976,810,1166,364,387,134,59,1
16847,180,115,65,17,12,9,9,266,138,128,37,25,37,9,1
16848,361,184,177,50,53,51,22,576,250,326,93,71,34,15,1
16849,493,238,255,54,70,37,45,1038,470,568,130,123,86,51,1
16850,201,108,93,36,21,17,4,248,109,139,36,57,21,11,1
16851,2414,1189,1225,277,178,170,169,803,358,445,135,117,80,44,1
16852,123,67,56,12,13,18,7,627,314,313,61,59,71,22,1
16853,769,329,440,116,66,55,22,779,392,387,124,79,52,13,1
16854,1337,667,670,137,143,140,35,1390,695,695,180,137,170,71,1
16855,828,405,423,114,106,78,33,190,94,96,24,33,24,6,1
16856,463,246,217,75,53,41,17,479,274,205,57,24,50,24,1
16857,481,256,225,60,56,48,12,798,378,420,99,94,71,63,1
16858,241,85,156,66,37,18,13,292,162,130,43,27,21,12,1
16859,747,306,441,158,115,57,20,403,188,215,70,42,41,11,1
16860,1150,463,687,198,204,84,35,248,119,129,33,48,20,10,1
16861,368,158,210,64,61,39,14,686,375,311,89,80,63,20,1
16862,219,105,114,36,29,19,8,351,195,156,47,53,25,14,1
16863,464,242,222,61,68,36,17,330,143,187,63,29,52,20,1
16864,146,75,71,13,32,15,11,351,166,185,48,61,24,15,1
16865,918,427,491,113,111,113,33,624,308,316,92,72,68,22,1
16866,476,220,256,65,65,41,21,219,112,107,24,31,25,9,1
16867,178,85,93,27,21,19,14,1474,756,718,175,158,169,51,1
16868,2490,1126,1364,352,325,219,89,404,183,221,63,50,39,16,1
16869,303,159,144,40,35,35,8,593,266,327,102,84,69,24,1
16870,2035,1087,948,163,129,96,73,331,169,162,40,28,22,14,1
16871,391,165,226,56,104,38,12,2414,1189,1225,277,178,170,169,1
16872,501,240,261,80,62,49,42,426,234,192,46,41,39,37,1
16873,999,541,458,110,110,104,42,217,109,108,34,32,35,7,1
16874,205,106,99,28,26,23,3,467,250,217,59,52,41,19,1
16875,536,300,236,65,47,77,19,527,262,265,62,73,39,49,1
16876,586,254,332,114,111,55,17,520,300,220,66,36,57,23,1
16877,784,391,393,105,113,86,21,1997,972,1025,262,209,239,52,1
16878,1354,537,817,245,247,117,57,140,81,59,16,15,15,12,1
16879,589,296,293,99,76,64,29,391,223,168,35,26,47,31,1
16880,323,156,167,52,45,39,18,291,120,171,63,39,26,6,1
16881,524,295,229,69,58,36,12,331,154,177,51,38,58,18,1
16882,395,198,197,53,50,44,14,749,360,389,91,122,59,37,1
16883,307,133,174,48,53,27,10,263,146,117,30,26,25,5,1
16884,933,493,440,140,108,124,32,178,100,78,23,22,30,6,1
16885,543,293,250,77,67,40,25,131,66,65,21,14,23,7,1
16886,294,122,172,46,65,18,11,181,96,85,25,23,20,7,1
16887,650,304,346,80,106,62,28,396,150,246,103,64,38,3,1
16888,304,127,177,61,38,31,4,596,286,310,90,89,78,37,1
16889,299,140,159,27,59,20,18,745,432,313,104,75,79,26,1
16890,655,281,374,108,103,61,24,437,167,270,126,95,34,10,1
16891,822,392,430,125,104,79,24,825,363,462,97,105,72,75,1
16892,127,49,78,27,20,6,5,1893,850,1043,280,340,169,80,1
16893,562,273,289,76,92,45,24,760,391,369,101,109,65,24,1
16894,672,334,338,110,93,91,41,583,322,261,73,66,45,26,1
16895,535,217,318,87,106,41,14,249,114,135,47,33,25,4,1
16896,69,32,37,13,13,3,3,445,255,190,57,53,56,28,1
16897,1190,638,552,162,95,112,18,1338,506,832,241,229,101,40,1
16898,560,244,316,92,118,47,12,454,209,245,85,78,45,9,1
16899,356,185,171,37,31,17,21,521,275,246,51,35,37,28,1
16900,499,217,282,76,83,29,6,577,288,289,85,56,40,20,1
16901,246,108,138,32,44,21,10,1358,685,673,191,157,146,53,1
16902,604,255,349,100,72,55,26,386,189,197,54,57,39,16,1
16903,393,215,178,44,56,49,15,419,274,145,41,23,28,27,1
16904,1049,493,556,146,138,87,41,166,79,87,29,27,14,5,1
16905,581,254,327,100,83,54,20,551,298,253,63,65,45,19,1
16906,602,260,342,94,93,37,8,562,265,297,79,56,72,45,1
16907,100,50,50,15,13,10,4,206,85,121,31,42,6,17,1
16908,685,301,384,98,68,70,86,396,192,204,71,41,51,15,1
16909,901,439,462,133,123,102,45,217,109,108,34,32,35,7,1
16910,517,295,222,60,55,55,19,371,237,134,31,25,43,17,1
16911,194,82,112,28,24,19,6,192,106,86,25,19,26,9,1
16912,489,242,247,83,63,62,19,748,386,362,111,75,71,40,1
16913,470,289,181,58,47,45,25,522,235,287,78,67,60,50,1
16914,1382,689,693,186,176,167,77,624,308,316,92,72,68,22,1
16915,198,80,118,35,31,14,7,247,110,137,34,45,23,10,1
16916,164,88,76,27,20,17,6,450,241,209,67,58,54,23,1
16917,518,264,254,58,55,42,23,712,380,332,69,74,57,30,1
16918,827,446,381,111,88,81,45,327,177,150,40,40,38,18,1
16919,1257,525,732,216,210,79,52,1912,977,935,247,226,205,65,1
16920,1172,545,627,156,135,85,96,2944,1827,1117,338,332,122,35,1
16921,552,285,267,74,51,69,24,2364,1004,1360,406,426,226,79,1
16922,99,49,50,16,8,7,8,3396,1499,1897,325,572,309,90,1
16923,369,180,189,62,70,24,21,854,380,474,137,159,81,31,1
16924,665,297,368,111,107,34,12,1333,646,687,209,179,148,45,1
16925,427,186,241,55,52,42,23,714,364,350,98,102,91,27,1
16926,618,290,328,82,74,69,42,345,198,147,37,39,23,27,1
16927,870,415,455,112,103,93,51,625,298,327,90,78,57,33,1
16928,423,218,205,64,55,54,15,417,218,199,46,29,38,20,1
16929,684,288,396,107,90,54,42,560,279,281,113,64,58,15,1
16930,1948,1039,909,242,227,200,67,1210,592,618,157,138,116,85,1
16931,215,115,100,27,28,34,16,781,418,363,92,90,64,41,1
16932,227,127,100,32,24,31,5,471,231,240,76,58,44,8,1
16933,255,122,133,35,51,22,13,1198,571,627,177,168,97,54,1
16934,332,155,177,55,51,44,13,159,102,57,14,13,23,7,1
16935,333,192,141,50,48,28,10,400,228,172,43,20,47,24,1
16936,1009,506,503,146,141,97,55,1464,715,749,200,167,181,70,1
16937,488,274,214,58,51,38,17,1712,1175,537,179,142,113,46,1
16938,221,113,108,23,17,11,11,1287,561,726,185,223,144,51,1
16939,247,136,111,20,26,25,10,487,270,217,65,35,56,22,1
16940,1264,655,609,141,119,131,50,906,474,432,90,125,74,24,1
16941,963,455,508,126,110,68,29,794,402,392,96,84,86,30,1
16942,1873,948,925,245,214,194,85,480,234,246,79,77,65,23,1
16943,379,203,176,55,48,45,16,914,453,461,112,115,79,29,1
16944,468,197,271,75,92,36,8,457,194,263,66,108,20,12,1
16945,631,332,299,61,104,60,19,509,295,214,55,41,69,35,1
16946,683,365,318,89,69,56,25,1366,943,423,137,109,58,19,1
16947,235,119,116,31,26,15,13,531,286,245,81,67,42,29,1
16948,1412,603,809,184,195,112,45,552,285,267,74,51,69,24,1
16949,403,195,208,68,48,37,16,623,320,303,103,85,75,15,1
16950,672,334,338,110,93,91,41,211,83,128,28,35,5,11,1
16951,164,78,86,28,23,12,8,1281,590,691,192,138,128,47,1
16952,245,112,133,32,45,20,10,655,328,327,65,54,55,35,1
16953,424,198,226,57,46,41,19,700,305,395,111,99,54,18,1
16954,1235,454,781,212,249,74,37,981,465,516,126,164,112,38,1
16955,456,228,228,49,70,32,19,703,356,347,96,97,38,22,1
16956,391,208,183,65,49,57,17,238,95,143,37,55,4,4,1
16957,1390,695,695,180,137,170,71,480,244,236,74,47,50,21,1
16958,380,185,195,68,54,32,16,261,130,131,27,41,19,16,1
16959,471,246,225,46,38,52,30,357,214,143,30,32,27,13,1
16960,722,384,338,94,83,63,35,782,347,435,110,92,74,34,1
16961,421,192,229,72,54,51,48,2541,1299,1242,306,302,121,98,1
16962,173,110,63,35,6,9,8,904,436,468,138,146,82,39,1
16963,246,108,138,32,44,21,10,632,285,347,102,78,43,29,1
16964,201,42,159,19,3,2,75,575,218,357,135,58,89,41,1
16965,246,108,138,32,44,21,10,641,324,317,88,92,49,14,1
16966,1032,526,506,129,117,119,47,406,215,191,34,46,21,9,1
16967,624,204,420,166,101,32,13,238,91,147,68,19,22,7,1
16968,1338,756,582,155,105,104,44,583,322,261,73,66,45,26,1
16969,1400,800,600,158,134,150,65,724,325,399,98,92,64,24,1
16970,676,333,343,111,89,94,39,1242,613,629,174,113,114,53,1
16971,514,254,260,55,57,56,19,126,57,69,31,10,10,3,1
16972,1332,626,706,182,144,80,41,647,344,303,84,62,73,28,1
16973,1599,806,793,213,237,100,45,217,98,119,33,32,27,7,1
16974,963,468,495,155,164,92,40,305,95,210,88,27,15,9,1
16975,510,264,246,67,66,38,29,758,360,398,114,107,51,19,1
16976,2109,1024,1085,306,265,236,86,247,110,137,34,45,23,10,1
16977,370,216,154,56,27,72,12,339,170,169,32,17,24,13,1
16978,92,40,52,14,23,13,7,673,328,345,107,112,63,27,1
16979,605,295,310,74,66,70,36,304,159,145,38,40,32,3,1
16980,427,164,263,62,80,14,10,149,68,81,15,38,11,10,1
16981,417,212,205,55,50,54,24,1687,770,917,282,226,181,79,1
16982,1067,555,512,141,129,100,36,466,186,280,71,84,30,11,1
16983,1378,680,698,160,154,111,38,601,313,288,42,48,25,36,1
16984,520,261,259,82,76,71,24,480,234,246,79,77,65,23,1
16985,1446,762,684,193,160,182,67,781,418,363,92,90,64,41,1
16986,1248,584,664,184,164,155,67,1473,758,715,205,171,161,65,1
16987,350,180,170,64,46,55,12,156,88,68,29,14,12,11,1
16988,770,374,396,95,91,79,41,787,386,401,98,95,86,25,1
16989,331,169,162,40,28,22,14,371,174,197,53,56,43,15,1
16990,464,249,215,73,42,65,12,314,158,156,41,57,30,12,1
16991,1174,579,595,174,135,132,42,903,457,446,99,127,62,29,1
16992,437,212,225,66,44,44,11,781,418,363,92,90,64,41,1
16993,360,192,168,55,45,48,16,193,108,85,24,15,18,9,1
16994,1932,1080,852,221,199,209,71,766,395,371,89,86,127,27,1
16995,346,178,168,57,42,33,12,1230,644,586,198,125,123,61,1
16996,233,121,112,24,31,30,7,143,79,64,16,25,7,5,1
16997,1141,583,558,141,98,91,45,785,374,411,56,42,38,25,1
16998,331,169,162,40,28,22,14,730,442,288,104,88,42,68,1
16999,264,122,142,33,29,13,13,245,93,152,35,28,32,21,1
17000,124,72,52,14,12,13,6,220,101,119,50,22,23,6,1
17001,422,213,209,63,60,35,13,834,335,499,129,110,84,33,1
17002,335,185,150,46,34,36,13,375,202,173,46,49,41,23,1
17003,886,440,446,116,140,95,45,677,323,354,101,109,45,31,1
17004,458,222,236,69,39,35,18,135,73,62,15,16,15,8,1
17005,158,85,73,24,18,18,8,640,308,332,91,102,49,21,1
17006,329,155,174,46,38,29,14,624,222,402,92,81,39,15,1
17007,522,251,271,87,68,60,21,94,55,39,18,6,18,5,1
17008,173,110,63,35,6,9,8,1432,652,780,217,205,131,81,1
17009,1052,492,560,184,163,103,44,403,220,183,57,39,45,11,1
17010,551,298,253,63,65,45,19,615,339,276,82,76,63,16,1
17011,461,257,204,63,49,50,29,781,418,363,92,90,64,41,1
17012,1016,495,521,138,138,94,50,1419,648,771,234,218,109,45,1
17013,1050,473,577,142,119,87,54,882,432,450,115,111,68,44,1
17014,1417,598,819,223,188,135,58,1972,846,1126,222,330,114,68,1
17015,395,226,169,57,44,32,8,1212,645,567,145,117,122,72,1
17016,450,275,175,57,32,48,15,305,166,139,42,38,28,12,1
17017,341,190,151,50,41,23,15,451,267,184,43,39,50,7,1
17018,759,391,368,103,82,101,45,354,137,217,53,57,30,5,1
17019,624,204,420,166,101,32,13,662,322,340,101,89,76,21,1
17020,339,177,162,40,36,51,24,406,219,187,44,39,52,20,1
17021,2315,1086,1229,231,306,248,64,726,326,400,106,106,57,31,1
17022,498,263,235,59,63,36,10,217,109,108,34,32,35,7,1
17023,534,267,267,69,75,58,17,601,313,288,42,48,25,36,1
17024,740,313,427,101,135,40,22,335,128,207,59,43,24,23,1
17025,336,154,182,51,48,39,22,448,275,173,32,53,55,27,1
17026,1149,568,581,177,133,101,30,245,111,134,31,44,20,11,1
17027,207,124,83,22,19,24,11,399,208,191,57,46,41,20,1
17028,1836,1051,785,185,221,239,110,540,306,234,74,52,43,22,1
17029,150,81,69,24,23,16,4,182,99,83,26,30,22,2,1
17030,197,106,91,43,19,16,12,1114,581,533,145,132,126,54,1
17031,546,267,279,90,69,56,19,770,355,415,103,142,75,42,1
17032,639,322,317,73,82,39,23,708,334,374,105,96,61,37,1
17033,1290,629,661,191,187,167,55,906,455,451,116,105,87,46,1
17034,806,436,370,101,100,76,34,1075,594,481,132,108,101,42,1
17035,361,184,177,50,53,51,22,413,194,219,77,72,28,11,1
17036,1502,683,819,241,216,172,52,1047,562,485,141,127,114,41,1
17037,659,325,334,102,85,87,32,280,133,147,44,38,40,12,1
17038,351,184,167,59,45,54,9,483,274,209,54,39,45,13,1
17039,166,83,83,24,30,18,7,723,309,414,106,106,41,40,1
17040,576,250,326,93,71,34,15,418,189,229,76,72,45,14,1
17041,211,88,123,38,28,26,10,374,181,193,63,49,46,20,1
17042,78,28,50,12,16,1,2,398,203,195,69,51,65,11,1
17043,160,86,74,21,11,16,16,855,438,417,137,93,116,41,1
17044,168,90,78,22,19,13,4,173,110,63,35,6,9,8,1
17045,613,333,280,71,66,47,26,862,335,527,136,169,47,28,1
17046,501,240,261,80,62,49,42,975,505,470,110,124,117,48,1
17047,131,66,65,21,14,23,7,439,202,237,80,53,35,15,1
17048,109,42,67,25,13,1,1,391,208,183,65,49,57,17,1
17049,874,431,443,112,120,79,50,181,96,85,25,23,20,7,1
17050,894,469,425,127,93,82,31,1270,682,588,165,147,136,54,1
17051,288,158,130,59,23,21,10,350,180,170,64,46,55,12,1
17052,374,201,173,51,34,53,24,245,111,134,31,44,20,11,1
17053,684,288,396,107,90,54,42,728,358,370,118,100,55,29,1
17054,4289,2228,2061,511,563,380,175,207,115,92,26,16,11,13,1
17055,228,139,89,24,21,32,18,825,363,462,97,105,72,75,1
17056,327,177,150,40,40,38,18,359,160,199,62,33,27,17,1
17057,429,219,210,46,66,42,17,659,338,321,93,77,56,31,1
17058,442,230,212,50,58,56,23,1132,646,486,99,102,71,41,1
17059,433,221,212,59,42,47,14,655,328,327,65,54,55,35,1
17060,509,214,295,88,76,57,38,158,85,73,24,18,18,8,1
17061,330,143,187,63,29,52,20,126,55,71,14,17,12,16,1
17062,750,347,403,105,103,83,29,551,299,252,51,62,63,17,1
17063,745,366,379,110,93,79,45,847,467,380,117,101,67,24,1
17064,655,281,374,108,103,61,24,164,61,103,47,19,14,5,1
17065,431,237,194,51,39,63,15,784,391,393,105,113,86,21,1
17066,882,432,450,115,111,68,44,412,193,219,70,56,51,26,1
17067,672,334,338,110,93,91,41,287,145,142,36,21,39,5,1
17068,419,189,230,64,49,36,15,760,405,355,112,95,92,29,1
17069,724,334,390,112,109,79,17,316,156,160,34,28,32,14,1
17070,541,361,180,41,44,41,19,648,341,307,78,89,77,21,1
17071,911,423,488,140,150,102,32,6669,2978,3691,1310,930,829,237,1
17072,4128,2104,2024,581,505,453,205,854,380,474,137,159,81,31,1
17073,1098,519,579,182,159,79,42,956,405,551,170,171,64,35,1
17074,770,356,414,123,102,66,25,688,330,358,122,97,92,39,1
17075,138,80,58,22,20,8,6,178,89,89,26,21,21,10,1
17076,595,316,279,86,60,65,40,601,290,311,92,89,55,30,1
17077,257,132,125,39,27,26,10,467,226,241,55,48,54,23,1
17078,1019,547,472,141,136,82,34,2477,1186,1291,256,271,249,90,1
17079,706,300,406,94,74,61,22,155,85,70,17,16,4,8,1
17080,1696,771,925,257,225,149,63,502,299,203,57,52,32,11,1
17081,657,335,322,92,65,64,29,379,203,176,55,48,45,16,1
17082,603,311,292,102,71,66,23,241,124,117,25,35,21,12,1
17083,849,434,415,134,99,87,24,562,281,281,65,99,28,18,1
17084,553,261,292,73,79,40,26,1290,629,661,191,187,167,55,1
17085,75,36,39,11,10,5,7,340,169,171,40,39,36,22,1
17086,1497,881,616,151,117,94,40,892,420,472,135,146,98,37,1
17087,247,110,137,34,45,23,10,1349,534,815,216,198,111,41,1
17088,76,31,45,13,14,9,7,393,186,207,58,50,36,22,1
17089,744,383,361,104,80,66,28,200,106,94,24,26,18,6,1
17090,334,161,173,55,42,38,16,417,217,200,56,39,62,17,1
17091,930,367,563,181,153,83,48,486,217,269,110,62,23,10,1
17092,592,291,301,92,93,71,31,551,298,253,63,65,45,19,1
17093,158,74,84,26,23,18,18,280,164,116,46,21,19,9,1
17094,2058,933,1125,317,304,250,74,149,68,81,15,38,11,10,1
17095,168,67,101,37,17,13,13,226,90,136,43,43,26,7,1
17096,433,224,209,56,63,45,14,263,181,82,19,11,39,8,1
17097,604,255,349,100,72,55,26,654,344,310,80,69,57,15,1
17098,441,216,225,57,66,57,19,785,374,411,56,42,38,25,1
17099,640,311,329,61,69,70,63,205,123,82,22,8,31,5,1
17100,198,80,118,35,31,14,7,539,269,270,60,71,41,23,1
17101,425,210,215,56,43,52,25,593,265,328,107,71,65,32,1
17102,224,103,121,34,47,11,9,815,382,433,97,50,88,31,1
17103,957,436,521,138,126,101,41,895,474,421,122,93,69,25,1
17104,672,334,338,110,93,91,41,872,468,404,129,85,92,34,1
17105,341,178,163,48,44,42,20,163,71,92,22,38,11,7,1
17106,478,219,259,82,80,51,18,369,167,202,66,59,39,20,1
17107,300,136,164,44,35,33,21,228,139,89,24,21,32,18,1
17108,253,148,105,31,15,39,16,763,361,402,103,144,78,45,1
17109,832,428,404,131,89,88,38,465,220,245,88,34,61,23,1
17110,564,315,249,73,60,53,13,482,262,220,72,60,52,15,1
17111,503,280,223,68,57,60,26,529,293,236,71,52,83,28,1
17112,1382,599,783,208,252,90,39,396,169,227,74,59,35,17,1
17113,964,408,556,131,153,76,55,272,131,141,36,26,36,16,1
17114,184,86,98,26,26,14,11,259,118,141,21,29,15,23,1
17115,211,86,125,35,32,10,9,641,324,317,88,92,49,14,1
17116,247,110,137,34,45,23,10,673,318,355,61,71,40,31,1
17117,311,187,124,39,38,35,12,273,148,125,38,31,16,19,1
17118,323,198,125,28,25,34,15,335,128,207,59,43,24,23,1
17119,168,67,101,37,17,13,13,422,198,224,52,52,42,43,1
17120,217,105,112,34,32,25,13,1333,646,687,209,179,148,45,1
17121,1105,479,626,182,125,80,29,597,246,351,95,98,45,25,1
17122,498,174,324,112,108,33,19,473,222,251,53,65,32,17,1
17123,951,506,445,107,118,79,40,391,193,198,51,52,49,16,1
17124,145,75,70,22,18,10,5,307,174,133,34,20,27,16,1
17125,673,318,355,61,71,40,31,245,112,133,32,45,20,10,1
17126,1390,695,695,180,137,170,71,724,325,399,98,92,64,24,1
17127,231,126,105,37,26,29,6,131,66,65,21,14,23,7,1
17128,272,173,99,32,32,11,8,103,51,52,15,17,6,5,1
17129,1328,648,680,220,151,112,40,331,169,162,40,28,22,14,1
17130,341,174,167,44,34,46,15,366,183,183,48,47,36,17,1
17131,331,183,148,36,44,40,21,221,110,111,28,32,25,11,1
17132,961,463,498,139,156,62,34,637,335,302,83,77,85,26,1
17133,686,345,341,93,81,69,30,757,373,384,115,93,95,25,1
17134,672,334,338,110,93,91,41,524,317,207,47,49,43,28,1
17135,1181,612,569,107,121,123,43,1366,943,423,137,109,58,19,1
17136,277,124,153,44,40,35,18,870,489,381,97,99,76,14,1
17137,168,67,101,37,17,13,13,204,104,100,26,27,21,11,1
17138,1706,830,876,265,209,230,63,326,176,150,35,22,29,11,1
17139,375,173,202,50,46,43,25,361,223,138,28,24,34,27,1
17140,676,295,381,94,71,65,24,508,295,213,42,61,53,17,1
17141,379,192,187,50,48,47,14,267,159,108,31,13,22,15,1
17142,1308,652,656,166,153,149,87,583,322,261,73,66,45,26,1
17143,354,128,226,63,61,27,7,2758,1332,1426,394,384,287,131,1
17144,2472,1055,1417,416,458,235,64,543,221,322,78,122,37,12,1
17145,292,152,140,46,38,35,12,586,254,332,114,111,55,17,1
17146,746,386,360,112,106,78,24,588,281,307,112,100,66,19,1
17147,504,237,267,62,66,48,17,623,333,290,88,70,62,25,1
17148,329,168,161,48,34,41,16,427,186,241,55,52,42,23,1
17149,802,344,458,156,136,57,24,863,418,445,127,114,70,31,1
17150,676,333,343,111,89,94,39,355,168,187,55,48,40,15,1
17151,1200,602,598,145,116,110,50,461,257,204,63,49,50,29,1
17152,518,235,283,94,77,55,22,259,123,136,36,40,33,12,1
17153,1149,568,581,177,133,101,30,377,202,175,46,50,41,23,1
17154,344,168,176,65,44,33,15,164,80,84,27,28,16,7,1
17155,331,169,162,40,28,22,14,1531,691,840,270,226,143,52,1
17156,416,194,222,70,58,52,20,455,218,237,57,51,42,35,1
17157,148,93,55,24,3,19,8,201,42,159,19,3,2,75,1
17158,372,189,183,60,44,41,18,726,312,414,121,73,82,23,1
17159,677,245,432,129,155,72,11,424,230,194,56,42,53,18,1
17160,671,326,345,111,77,74,11,1919,871,1048,315,265,148,61,1
17161,555,278,277,60,70,48,18,798,378,420,99,94,71,63,1
17162,598,323,275,68,53,60,17,366,183,183,48,47,36,17,1
17163,596,256,340,100,87,43,18,473,212,261,72,64,45,28,1
17164,787,394,393,113,98,52,19,863,458,405,97,82,63,57,1
17165,757,333,424,81,132,61,54,2477,1186,1291,256,271,249,90,1
17166,1447,814,633,171,141,183,58,411,235,176,65,41,53,11,1
17167,283,142,141,35,29,32,5,198,102,96,27,20,21,12,1
17168,1103,464,639,154,187,66,25,404,197,207,57,69,33,15,1
17169,395,195,200,41,55,23,10,1608,924,684,163,133,89,29,1
17170,447,222,225,71,54,44,25,463,236,227,64,50,44,29,1
17171,203,91,112,26,24,22,12,103,51,52,15,17,6,5,1
17172,1186,567,619,161,156,122,49,1898,1059,839,230,181,189,60,1
17173,4655,2074,2581,545,652,562,399,198,107,91,26,18,27,6,1
17174,896,407,489,97,152,70,22,870,436,434,131,114,72,25,1
17175,546,267,279,90,69,56,19,346,208,138,46,39,51,18,1
17176,810,367,443,115,92,94,59,434,233,201,61,55,37,15,1
17177,1441,504,937,264,329,69,46,969,505,464,123,133,92,33,1
17178,326,153,173,63,48,25,8,586,254,332,114,111,55,17,1
17179,923,480,443,110,114,98,55,248,118,130,54,31,26,5,1
17180,670,333,337,95,79,62,21,425,210,215,56,43,52,25,1
17181,281,138,143,50,36,27,16,354,169,185,54,54,41,19,1
17182,747,371,376,87,134,54,29,551,298,253,63,65,45,19,1
17183,824,397,427,113,95,82,33,143,74,69,28,13,24,5,1
17184,533,254,279,81,78,52,10,502,299,203,57,52,32,11,1
17185,404,197,207,57,69,33,15,604,255,349,100,72,55,26,1
17186,595,316,279,86,60,65,40,262,123,139,44,32,25,18,1
17187,1434,727,707,210,173,161,54,413,227,186,45,34,58,23,1
17188,906,455,451,116,105,87,46,794,390,404,103,95,86,23,1
17189,2063,1024,1039,175,117,80,97,765,295,470,200,142,84,27,1
17190,555,277,278,84,56,66,23,859,395,464,157,119,59,31,1
17191,932,471,461,137,86,84,32,149,68,81,15,38,11,10,1
17192,299,128,171,57,40,13,25,920,435,485,115,113,94,49,1
17193,346,191,155,52,38,40,13,719,364,355,104,100,58,34,1
17194,3056,1457,1599,438,389,329,168,681,322,359,100,87,71,26,1
17195,284,104,180,54,81,8,10,308,159,149,52,41,22,10,1
17196,391,222,169,46,36,30,9,205,114,91,25,24,20,15,1
17197,451,222,229,72,46,57,17,246,108,138,32,44,21,10,1
17198,543,293,250,77,67,40,25,556,290,266,75,74,29,24,1
17199,505,277,228,70,57,45,20,158,85,73,24,18,18,8,1
17200,288,159,129,27,44,27,15,1133,491,642,192,170,61,29,1
17201,120,67,53,13,15,9,6,254,107,147,42,37,24,10,1
17202,177,100,77,22,17,20,11,522,251,271,87,68,60,21,1
17203,673,385,288,74,57,84,35,651,369,282,75,48,74,33,1
17204,280,142,138,35,37,22,13,119,59,60,29,10,6,4,1
17205,724,334,390,112,109,79,17,1132,553,579,172,143,150,57,1
17206,536,278,258,72,63,62,20,357,169,188,61,53,32,15,1
17207,1059,580,479,138,117,67,27,1394,717,677,194,190,135,53,1
17208,482,231,251,76,81,64,26,1616,735,881,285,248,153,72,1
17209,593,266,327,102,84,69,24,1154,540,614,195,160,138,66,1
17210,422,245,177,44,34,39,11,199,125,74,26,15,10,5,1
17211,313,157,156,39,26,34,29,448,236,212,53,64,56,24,1
17212,208,96,112,31,32,13,9,1032,395,637,190,189,71,40,1
17213,146,71,75,20,17,8,7,2174,1054,1120,240,247,216,112,1
17214,1822,879,943,236,227,175,97,1497,881,616,151,117,94,40,1
17215,159,84,75,13,28,10,8,164,78,86,28,23,12,8,1
17216,2414,1189,1225,277,178,170,169,509,241,268,67,53,56,13,1
17217,443,240,203,66,31,57,27,883,470,413,112,99,108,34,1
17218,4655,2074,2581,545,652,562,399,357,153,204,84,62,39,2,1
17219,391,208,183,65,49,57,17,205,77,128,31,45,12,11,1
17220,456,247,209,68,46,42,14,648,307,341,101,58,76,34,1
17221,369,200,169,42,46,39,16,377,184,193,50,43,33,17,1
17222,357,169,188,61,53,32,15,339,177,162,40,36,51,24,1
17223,170,88,82,26,29,19,6,906,455,451,116,105,87,46,1
17224,333,192,141,50,48,28,10,1285,578,707,239,191,136,57,1
17225,1970,978,992,245,206,198,80,2442,1193,1249,278,183,170,145,1
17226,366,191,175,37,33,19,19,557,306,251,66,42,52,15,1
17227,4655,2074,2581,545,652,562,399,1395,627,768,172,263,141,59,1
17228,401,204,197,49,33,29,17,131,66,65,21,14,23,7,1
17229,535,288,247,79,72,35,21,375,202,173,46,49,41,23,1
17230,527,263,264,81,63,72,31,533,254,279,81,78,52,10,1
17231,372,189,183,60,44,41,18,641,324,317,88,92,49,14,1
17232,1068,559,509,158,132,122,57,895,479,416,96,119,92,56,1
17233,1050,568,482,119,109,137,46,128,54,74,30,13,8,7,1
17234,298,167,131,47,33,40,8,576,250,326,93,71,34,15,1
17235,350,224,126,34,14,48,18,211,114,97,32,24,19,10,1
17236,473,270,203,63,34,44,18,626,345,281,62,76,66,25,1
17237,2390,1131,1259,395,383,203,74,3312,1761,1551,403,345,309,127,1
17238,1087,480,607,155,179,99,28,246,108,138,32,44,21,10,1
17239,204,86,118,38,21,23,15,920,492,428,100,92,88,49,1
17240,140,86,54,17,6,20,7,609,318,291,80,72,55,36,1
17241,592,291,301,92,93,71,31,413,194,219,77,72,28,11,1
17242,324,145,179,45,23,32,17,399,201,198,65,45,48,17,1
17243,768,354,414,133,106,79,42,108,51,57,16,12,16,11,1
17244,213,86,127,37,33,5,16,353,195,158,40,55,30,13,1
17245,1273,592,681,199,164,139,39,288,142,146,52,32,26,8,1
17246,171,94,77,24,28,30,11,437,225,212,61,57,66,12,1
17247,1608,778,830,243,230,159,74,399,208,191,57,46,41,20,1
17248,769,362,407,99,88,66,67,272,149,123,46,14,27,16,1
17249,875,376,499,155,125,53,39,808,366,442,130,133,66,31,1
17250,98,49,49,14,15,9,2,333,171,162,41,44,48,23,1
17251,247,110,137,34,45,23,10,648,307,341,101,58,76,34,1
17252,706,346,360,118,92,98,56,845,402,443,137,126,105,47,1
17253,4599,2000,2599,590,655,515,413,770,355,415,103,142,75,42,1
17254,586,270,316,83,80,59,21,560,244,316,92,118,47,12,1
17255,1190,638,552,162,95,112,18,1238,596,642,148,147,126,136,1
17256,509,243,266,80,57,45,19,369,181,188,41,36,54,16,1
17257,795,444,351,120,97,73,32,246,115,131,15,29,10,32,1
17258,146,71,75,20,17,8,7,2177,1034,1143,274,228,201,95,1
17259,489,304,185,48,37,65,24,176,92,84,25,26,15,8,1
17260,122,52,70,24,22,7,6,375,202,173,46,49,41,23,1
17261,1441,657,784,140,135,81,73,770,374,396,95,91,79,41,1
17262,546,267,279,90,69,56,19,671,318,353,83,124,46,34,1
17263,145,70,75,24,16,16,20,395,195,200,41,55,23,10,1
17264,400,191,209,51,60,30,9,513,271,242,54,52,44,13,1
17265,304,159,145,38,40,32,3,1271,599,672,194,175,118,47,1
17266,209,96,113,35,28,22,13,189,102,87,28,17,22,5,1
17267,246,115,131,15,29,10,32,586,309,277,81,64,76,25,1
17268,217,102,115,28,29,29,12,1970,978,992,245,206,198,80,1
17269,168,76,92,26,21,19,4,97,50,47,17,14,14,10,1
17270,470,256,214,56,39,47,34,920,492,428,100,92,88,49,1
17271,1275,579,696,200,172,125,51,796,445,351,96,80,90,38,1
17272,683,304,379,140,101,48,19,99,47,52,12,16,6,2,1
17273,433,221,212,59,42,47,14,279,161,118,37,32,7,7,1
17274,514,248,266,105,68,38,20,437,225,212,61,57,66,12,1
17275,166,73,93,17,17,24,11,1132,646,486,99,102,71,41,1
17276,854,380,474,137,159,81,31,1434,727,707,210,173,161,54,1
17277,772,417,355,118,92,80,23,379,203,176,55,48,45,16,1
17278,309,154,155,42,44,45,16,1807,933,874,248,203,173,71,1
17279,435,221,214,72,45,47,19,520,300,220,66,36,57,23,1
17280,61,17,44,8,4,0,21,402,227,175,48,40,35,11,1
17281,1187,631,556,182,139,152,56,1242,613,629,174,113,114,53,1
17282,1210,592,618,157,138,116,85,342,150,192,52,43,31,17,1
17283,441,201,240,70,58,55,24,482,231,251,76,81,64,26,1
17284,431,201,230,69,39,55,33,335,143,192,45,36,32,37,1
17285,215,117,98,43,22,27,5,617,387,230,65,57,77,16,1
17286,2363,875,1488,361,444,95,53,583,322,261,73,66,45,26,1
17287,313,157,156,39,26,34,29,345,141,204,64,58,13,11,1
17288,370,190,180,60,52,37,13,671,318,353,83,124,46,34,1
17289,291,141,150,49,43,26,7,295,124,171,57,27,31,18,1
17290,482,232,250,77,81,44,13,317,153,164,34,52,30,14,1
17291,201,42,159,19,3,2,75,532,254,278,91,48,23,17,1
17292,466,186,280,71,84,30,11,298,181,117,43,23,40,12,1
17293,947,482,465,143,107,89,37,1210,592,618,157,138,116,85,1
17294,188,83,105,40,31,20,8,826,362,464,107,118,71,43,1
17295,316,133,183,67,51,30,17,395,222,173,48,42,21,8,1
17296,579,281,298,91,78,74,27,467,226,241,55,48,54,23,1
17297,437,227,210,55,45,51,10,250,105,145,39,27,22,40,1
17298,1150,620,530,156,128,161,32,770,356,414,123,102,66,25,1
17299,588,331,257,86,71,52,12,318,176,142,25,32,35,25,1
17300,768,354,414,133,106,79,42,1230,623,607,154,156,94,61,1
17301,963,553,410,126,103,79,26,183,91,92,21,29,16,10,1
17302,231,126,105,37,26,29,6,1290,597,693,182,182,119,63,1
17303,420,190,230,79,61,64,15,346,178,168,57,50,56,9,1
17304,3623,1788,1835,325,354,507,198,698,345,353,104,87,81,50,1
17305,277,124,153,44,40,35,18,102,61,41,15,13,8,2,1
17306,368,175,193,72,43,39,15,393,186,207,58,50,36,22,1
17307,450,242,208,53,63,56,22,537,276,261,75,68,68,22,1
17308,146,75,71,13,32,15,11,771,321,450,151,135,43,15,1
17309,277,124,153,44,40,35,18,845,402,443,137,126,105,47,1
17310,147,81,66,18,18,18,4,919,538,381,111,98,103,41,1
17311,772,364,408,114,106,98,33,226,120,106,68,8,2,1,1
17312,509,341,168,35,32,52,15,452,231,221,74,53,56,20,1
17313,769,362,407,99,88,66,67,530,315,215,83,43,78,11,1
17314,1980,963,1017,262,243,179,78,101,47,54,23,15,5,5,1
17315,299,153,146,32,28,29,12,1997,972,1025,262,209,239,52,1
17316,166,74,92,31,19,21,8,489,235,254,53,69,49,20,1
17317,266,137,129,35,29,37,10,254,146,108,28,35,33,8,1
17318,536,278,258,72,63,62,20,2472,1055,1417,416,458,235,64,1
17319,372,189,183,60,44,41,18,776,356,420,122,103,85,30,1
17320,265,117,148,39,36,47,17,355,186,169,61,43,28,13,1
17321,128,67,61,19,13,15,4,776,346,430,103,102,61,40,1
17322,795,305,490,169,178,66,22,101,59,42,11,17,10,1,1
17323,475,238,237,73,53,63,17,417,182,235,57,109,50,8,1
17324,408,205,203,80,40,55,23,202,102,100,29,35,6,9,1
17325,837,447,390,95,81,93,34,767,392,375,113,112,83,13,1
17326,745,366,379,110,93,79,45,854,380,474,137,159,81,31,1
17327,570,318,252,77,48,93,26,526,266,260,76,75,53,22,1
17328,504,255,249,56,59,45,13,532,269,263,72,59,59,39,1
17329,673,317,356,101,85,76,49,1069,512,557,148,126,84,36,1
17330,295,140,155,44,37,26,27,370,176,194,61,30,40,28,1
17331,273,126,147,54,49,25,18,616,304,312,75,71,55,25,1
17332,372,184,188,55,55,30,8,605,295,310,74,66,70,36,1
17333,166,81,85,30,27,13,8,103,49,54,21,21,10,2,1
17334,1597,710,887,241,219,146,69,2490,1126,1364,352,325,219,89,1
17335,454,224,230,71,39,62,22,103,49,54,21,21,10,2,1
17336,1076,517,559,139,136,72,34,346,186,160,48,32,35,14,1
17337,670,358,312,95,75,58,26,193,99,94,31,31,16,12,1
17338,341,190,151,50,41,23,15,899,453,446,149,128,78,24,1
17339,767,392,375,113,112,83,13,1243,650,593,158,159,98,55,1
17340,651,311,340,110,77,73,33,1304,696,608,195,169,122,53,1
17341,500,254,246,64,62,71,22,1247,620,627,134,149,142,58,1
17342,227,132,95,31,19,31,11,552,285,267,74,51,69,24,1
17343,1718,735,983,266,225,130,68,595,316,279,86,60,65,40,1
17344,318,164,154,52,43,34,10,482,231,251,76,81,64,26,1
17345,317,153,164,34,52,30,14,205,106,99,28,26,23,3,1
17346,595,316,279,86,60,65,40,149,68,81,15,38,11,10,1
17347,482,231,251,76,81,64,26,204,84,120,29,30,16,9,1
17348,633,305,328,90,56,22,23,291,133,158,46,51,21,15,1
17349,2671,1322,1349,379,345,290,135,2758,1332,1426,394,384,287,131,1
17350,957,385,572,173,168,62,33,573,247,326,98,95,46,22,1
17351,748,355,393,121,91,95,26,216,129,87,19,27,21,9,1
17352,456,228,228,49,70,32,19,632,326,306,92,71,56,19,1
17353,2351,1110,1241,337,269,300,87,676,319,357,83,86,62,46,1
17354,468,243,225,60,50,34,32,233,94,139,36,37,15,8,1
17355,1844,721,1123,333,244,135,61,391,204,187,47,48,38,18,1
17356,430,198,232,57,46,37,19,243,114,129,37,30,32,8,1
17357,1037,461,576,146,163,75,44,437,212,225,66,44,44,11,1
17358,178,100,78,23,22,30,6,427,204,223,38,57,26,32,1
17359,445,219,226,61,60,60,21,744,384,360,104,96,57,31,1
17360,317,153,164,39,30,35,13,1452,733,719,182,161,179,64,1
17361,913,393,520,160,165,87,40,396,150,246,103,64,38,3,1
17362,425,210,215,56,43,52,25,1580,742,838,208,146,144,71,1
17363,271,127,144,36,46,37,9,467,224,243,70,43,67,23,1
17364,546,267,279,90,69,56,19,702,298,404,134,111,48,18,1
17365,512,261,251,79,73,60,21,226,129,97,20,25,26,11,1
17366,478,204,274,65,58,41,20,173,110,63,35,6,9,8,1
17367,482,242,240,60,39,60,17,239,116,123,24,22,21,9,1
17368,484,254,230,60,66,56,14,450,232,218,58,54,42,20,1
17369,287,151,136,36,50,21,13,595,316,279,86,60,65,40,1
17370,445,198,247,85,67,38,19,205,77,128,31,45,12,11,1
17371,672,334,338,110,93,91,41,400,195,205,63,67,40,18,1
17372,592,275,317,100,86,57,31,593,305,288,91,83,54,24,1
17373,1360,600,760,233,199,123,40,782,421,361,101,97,82,20,1
17374,365,184,181,47,41,29,18,632,326,306,92,71,56,19,1
17375,684,288,396,107,90,54,42,1162,515,647,191,143,97,35,1
17376,339,177,162,40,36,51,24,132,65,67,21,9,8,21,1
17377,456,220,236,67,75,30,21,293,153,140,45,38,22,15,1
17378,277,124,153,44,40,35,18,201,93,108,34,39,21,6,1
17379,662,312,350,103,104,59,20,862,455,407,123,103,116,40,1
17380,373,194,179,42,54,26,13,162,73,89,32,19,4,4,1
17381,211,88,123,38,28,26,10,149,68,81,15,38,11,10,1
17382,346,191,155,52,38,40,13,490,224,266,80,70,39,32,1
17383,212,107,105,32,25,22,7,185,115,70,19,17,26,6,1
17384,734,357,377,101,75,81,22,619,332,287,95,77,74,38,1
17385,425,210,215,56,43,52,25,108,51,57,16,12,16,11,1
17386,509,254,255,67,55,52,35,462,233,229,66,49,43,30,1
17387,480,236,244,62,51,58,33,1048,564,484,118,122,113,40,1
17388,359,219,140,42,19,56,19,418,204,214,68,66,38,12,1
17389,2414,1189,1225,277,178,170,169,428,248,180,44,39,28,9,1
17390,489,235,254,53,69,49,20,211,114,97,32,24,19,10,1
17391,508,215,293,72,71,42,15,906,455,451,116,105,87,46,1
17392,450,275,175,57,32,48,15,477,301,176,52,35,45,24,1
17393,201,111,90,25,29,26,13,219,116,103,36,31,27,9,1
17394,610,294,316,87,132,70,20,735,357,378,88,83,95,59,1
17395,416,209,207,76,45,50,17,2843,1104,1739,429,357,178,95,1
17396,1134,574,560,157,164,47,48,377,202,175,46,50,41,23,1
17397,677,323,354,101,109,45,31,393,186,207,58,50,36,22,1
17398,236,145,91,17,19,30,18,125,75,50,14,8,18,7,1
17399,589,281,308,69,39,63,20,1608,778,830,243,230,159,74,1
17400,429,187,242,79,72,28,19,419,175,244,71,73,23,23,1
17401,767,392,375,113,112,83,13,1434,727,707,210,173,161,54,1
17402,330,143,187,63,29,52,20,2045,1063,982,232,215,140,156,1
17403,639,310,329,91,94,46,15,359,185,174,42,48,22,26,1
17404,522,265,257,35,39,38,8,1475,658,817,149,114,120,43,1
17405,415,209,206,60,67,39,18,158,83,75,22,14,17,9,1
17406,546,267,279,90,69,56,19,358,204,154,57,41,36,14,1
17407,391,208,183,65,49,57,17,963,455,508,126,110,68,29,1
17408,434,237,197,52,64,37,14,204,87,117,40,40,7,14,1
17409,79,40,39,12,13,5,4,1738,821,917,242,196,181,58,1
17410,392,115,277,117,75,28,17,1117,423,694,182,134,88,31,1
17411,391,208,183,65,49,57,17,582,293,289,94,80,77,32,1
17412,1251,671,580,162,132,148,51,149,68,81,15,38,11,10,1
17413,222,110,112,43,30,14,6,159,84,75,13,28,10,8,1
17414,692,305,387,100,97,78,30,1312,484,828,258,239,86,51,1
17415,183,91,92,31,21,16,11,703,356,347,96,97,38,22,1
17416,2471,1130,1341,240,281,219,290,1133,549,584,99,76,66,54,1
17417,1333,646,687,209,179,148,45,537,276,261,75,68,68,22,1
17418,1270,682,588,165,147,136,54,1531,691,840,270,226,143,52,1
17419,465,225,240,65,44,65,25,1669,1162,507,154,128,86,51,1
17420,533,254,279,81,78,52,10,620,305,315,97,80,87,28,1
17421,187,81,106,47,32,10,11,377,202,175,46,50,41,23,1
17422,377,184,193,50,43,33,17,327,149,178,47,49,38,11,1
17423,358,179,179,49,48,49,8,119,57,62,18,16,17,4,1
17424,806,419,387,115,130,57,32,1432,652,780,217,205,131,81,1
17425,2490,1126,1364,352,325,219,89,2843,1104,1739,429,357,178,95,1
17426,1573,791,782,198,173,148,46,355,168,187,48,57,30,15,1
17427,364,168,196,64,61,27,6,246,115,131,15,29,10,32,1
17428,694,320,374,96,102,70,16,156,64,92,31,19,5,4,1
17429,206,129,77,27,15,21,6,822,424,398,107,106,86,46,1
17430,508,251,257,74,53,51,18,420,202,218,67,43,51,15,1
17431,467,226,241,55,48,54,23,424,209,215,56,58,45,24,1
17432,920,492,428,100,92,88,49,918,427,491,113,111,113,33,1
17433,715,361,354,99,102,82,21,377,202,175,46,50,41,22,1
17434,795,305,490,169,178,66,22,292,153,139,39,33,24,21,1
17435,772,370,402,78,114,85,22,790,384,406,93,120,79,16,1
17436,631,332,299,61,104,60,19,360,168,192,57,49,48,19,1
17437,868,448,420,108,103,76,25,1009,506,503,146,141,97,55,1
17438,114,71,43,8,18,7,4,626,303,323,91,80,56,20,1
17439,673,317,356,101,85,76,49,855,473,382,112,99,68,35,1
17440,460,218,242,72,62,42,26,376,203,173,57,52,48,11,1
17441,240,125,115,34,32,30,8,164,88,76,27,20,17,6,1
17442,437,228,209,47,61,26,11,1863,721,1142,262,283,139,74,1
17443,1608,778,830,243,230,159,74,593,266,327,102,84,69,24,1
17444,98,49,49,14,15,9,2,168,67,101,37,17,13,13,1
17445,976,496,480,128,111,121,48,906,455,451,116,105,87,46,1
17446,433,221,212,59,42,47,14,1901,796,1105,253,274,183,76,1
17447,418,205,213,69,50,29,15,184,88,96,24,25,14,9,1
17448,268,144,124,33,25,29,14,79,38,41,8,7,5,7,1
17449,467,232,235,52,40,46,20,470,226,244,81,53,59,39,1
17450,401,167,234,56,71,16,10,195,88,107,28,23,14,8,1
17451,602,310,292,87,66,70,36,817,425,392,120,102,83,26,1
17452,556,279,277,83,69,71,19,452,236,216,73,54,50,29,1
17453,684,342,342,81,85,82,38,125,60,65,22,17,14,5,1
17454,587,279,308,88,71,49,31,292,152,140,46,38,35,12,1
17455,724,334,390,112,109,79,17,508,295,213,42,61,53,17,1
17456,178,100,78,23,22,30,6,1153,588,565,174,128,149,56,1
17457,778,367,411,90,85,64,43,363,193,170,52,51,41,14,1
17458,466,186,280,71,84,30,11,835,420,415,104,105,57,47,1
17459,2442,1193,1249,278,183,170,145,333,160,173,45,53,37,18,1
17460,625,335,290,75,66,57,25,466,230,236,63,74,42,35,1
17461,316,157,159,45,38,22,19,529,264,265,59,68,41,17,1
17462,335,185,150,46,34,36,13,212,107,105,29,26,25,8,1
17463,1032,426,606,172,172,80,35,957,385,572,173,168,62,33,1
17464,350,180,170,64,46,55,12,757,373,384,115,93,95,25,1
17465,270,137,133,30,28,27,11,615,339,276,82,76,63,16,1
17466,639,368,271,72,51,38,38,870,418,452,121,102,109,28,1
17467,377,184,193,50,43,33,17,258,141,117,39,35,27,8,1
17468,393,186,207,58,50,36,22,947,506,441,105,126,75,14,1
17469,950,497,453,146,127,115,43,245,122,123,21,32,18,13,1
17470,573,247,326,98,95,46,22,622,294,328,104,93,42,17,1
17471,546,267,279,90,69,56,19,527,276,251,64,60,70,20,1
17472,706,326,380,102,79,89,47,118,60,58,22,9,8,9,1
17473,1255,666,589,145,142,120,82,781,418,363,92,90,64,41,1
17474,1566,743,823,261,188,151,48,443,208,235,43,55,51,50,1
17475,562,281,281,80,61,67,23,180,93,87,24,22,19,8,1
17476,3075,1459,1616,390,359,298,207,1231,603,628,121,162,109,120,1
17477,126,66,60,24,10,7,9,76,42,34,12,8,5,7,1
17478,508,214,294,90,39,57,39,505,226,279,68,51,30,15,1
17479,467,226,241,55,48,54,23,128,54,74,30,13,8,7,1
17480,457,242,215,39,46,53,10,641,324,317,88,92,49,14,1
17481,615,293,322,70,67,45,29,595,316,279,86,60,65,40,1
17482,605,263,342,73,103,54,18,156,64,92,31,19,5,4,1
17483,480,252,228,55,37,49,20,187,80,107,34,36,19,8,1
17484,599,292,307,74,126,45,14,330,143,187,63,29,52,20,1
17485,216,102,114,31,29,21,6,297,123,174,51,49,16,10,1
17486,540,271,269,80,77,51,16,1647,794,853,279,235,128,65,1
17487,509,262,247,64,70,64,20,676,295,381,94,71,65,24,1
17488,194,112,82,26,13,17,8,146,71,75,20,17,8,7,1
17489,512,261,251,79,73,60,21,310,161,149,34,31,35,12,1
17490,246,108,138,32,44,21,10,326,176,150,35,22,29,11,1
17491,495,233,262,74,59,46,12,1217,566,651,215,170,102,23,1
17492,195,129,66,21,13,19,6,348,187,161,50,35,44,9,1
17493,497,284,213,69,53,45,16,184,91,93,25,25,11,9,1
17494,920,492,428,100,92,88,49,655,328,327,65,54,55,35,1
17495,848,461,387,111,102,108,42,359,174,185,54,56,43,16,1
17496,538,293,245,48,66,45,16,246,115,131,15,29,10,32,1
17497,168,67,101,37,17,13,13,262,133,129,44,38,31,12,1
17498,436,205,231,39,51,26,20,217,108,109,30,23,28,10,1
17499,1154,540,614,195,160,138,66,750,347,403,105,103,83,29,1
17500,512,261,251,79,73,60,21,351,183,168,55,44,33,9,1
17501,575,295,280,89,68,54,18,261,130,131,27,41,19,16,1
17502,917,443,474,126,115,125,41,277,122,155,33,33,25,24,1
17503,113,54,59,10,12,13,7,645,297,348,89,105,74,24,1
17504,329,155,174,46,38,29,14,894,420,474,136,146,93,39,1
17505,441,218,223,69,55,50,27,257,148,109,28,20,21,14,1
17506,323,169,154,47,44,39,20,299,163,136,43,31,29,15,1
17507,2602,1424,1178,314,320,249,75,1270,557,713,130,195,57,30,1
17508,490,216,274,67,77,52,21,604,227,377,106,102,45,33,1
17509,1738,821,917,242,196,181,58,724,325,399,98,92,64,24,1
17510,1058,558,500,132,127,121,53,118,51,67,25,13,6,7,1
17511,1912,977,935,247,226,205,65,1948,1039,909,242,227,200,67,1
17512,211,108,103,34,25,26,12,503,263,240,72,55,51,34,1
17513,118,63,55,18,19,11,5,551,298,253,63,65,45,19,1
17514,317,153,164,39,30,35,13,864,429,435,129,118,68,35,1
17515,489,264,225,61,60,50,17,574,273,301,101,74,68,26,1
17516,233,94,139,36,37,15,8,419,175,244,71,73,23,23,1
17517,379,203,176,55,48,45,16,357,153,204,84,62,39,2,1
17518,278,131,147,29,30,33,12,365,186,179,48,47,42,13,1
17519,906,455,451,116,105,87,46,1089,544,545,138,160,117,43,1
17520,838,385,453,110,137,78,28,359,203,156,40,20,40,19,1
17521,346,194,152,54,29,39,6,299,140,159,27,59,20,18,1
17522,424,209,215,56,58,45,24,136,66,70,33,11,9,3,1
17523,592,283,309,84,137,60,20,695,373,322,80,59,89,39,1
17524,1585,741,844,220,242,103,53,636,336,300,94,65,58,32,1
17525,462,228,234,59,47,37,32,1441,657,784,140,135,81,73,1
17526,461,213,248,58,62,54,30,622,299,323,86,86,69,35,1
17527,462,228,234,59,47,37,32,743,366,377,41,37,26,14,1
17528,706,346,360,118,92,98,56,577,241,336,112,109,47,21,1
17529,353,194,159,67,35,52,11,356,161,195,52,57,40,17,1
17530,686,375,311,89,80,63,20,138,69,69,28,7,10,10,1
17531,1901,796,1105,253,274,183,76,341,178,163,48,44,42,20,1
17532,1441,657,784,140,135,81,73,454,230,224,63,56,38,33,1
17533,133,66,67,21,24,9,2,263,159,104,30,27,31,11,1
17534,348,166,182,65,33,46,20,788,406,382,99,110,62,31,1
17535,225,116,109,29,19,25,6,1242,613,629,174,113,114,53,1
17536,1893,764,1129,308,323,126,60,307,150,157,44,23,30,13,1
17537,445,225,220,47,62,53,26,317,153,164,39,30,35,13,1
17538,224,131,93,24,15,23,9,467,224,243,70,43,67,23,1
17539,356,199,157,43,58,29,12,1720,856,864,259,224,176,85,1
17540,771,321,450,151,135,43,15,719,301,418,122,132,42,26,1
17541,646,304,342,104,93,58,26,304,159,145,38,40,32,3,1
17542,346,191,155,52,38,40,13,309,137,172,51,50,28,14,1
17543,163,70,93,28,21,17,6,859,395,464,157,119,59,31,1
17544,2328,1054,1274,377,410,232,62,2472,1055,1417,416,458,235,64,1
17545,976,520,456,120,115,109,53,728,385,343,110,102,69,14,1
17546,258,133,125,24,13,30,11,2040,956,1084,202,190,258,147,1
17547,359,219,140,42,19,56,19,648,307,341,101,58,76,34,1
17548,255,122,133,35,51,22,13,143,79,64,16,25,7,5,1
17549,462,251,211,74,53,41,18,357,214,143,30,32,27,13,1
17550,317,153,164,34,52,30,14,984,516,468,78,45,73,12,1
17551,199,106,93,29,23,26,7,427,236,191,49,54,46,13,1
17552,1271,599,672,194,175,118,47,246,108,138,32,44,21,10,1
17553,200,90,110,22,29,10,13,331,169,162,40,28,22,14,1
17554,424,197,227,67,62,43,17,640,325,315,98,66,66,38,1
17555,423,222,201,60,51,51,11,480,196,284,72,74,25,2,1
17556,101,45,56,17,17,12,9,1941,818,1123,351,358,141,64,1
17557,1210,592,618,157,138,116,85,1074,538,536,190,131,157,35,1
17558,200,89,111,26,25,17,7,825,363,462,97,105,72,75,1
17559,815,418,397,97,62,70,17,451,267,184,43,39,50,7,1
17560,1390,695,695,180,137,170,71,454,209,245,85,78,45,9,1
17561,822,392,430,125,104,79,24,149,77,72,37,10,20,5,1
17562,289,143,146,38,18,40,8,834,465,369,82,84,81,21,1
17563,579,330,249,52,27,90,11,867,369,498,145,139,78,36,1
17564,201,111,90,25,29,26,13,440,235,205,34,61,36,13,1
17565,145,84,61,16,15,14,4,513,274,239,67,66,62,35,1
17566,618,290,328,82,74,69,42,318,155,163,44,37,35,10,1
17567,340,172,168,60,50,36,10,641,324,317,88,92,49,14,1
17568,1332,637,695,214,178,117,40,451,238,213,53,64,56,22,1
17569,215,91,124,23,39,5,5,339,170,169,32,17,24,13,1
17570,291,162,129,40,21,32,16,757,373,384,115,93,95,25,1
17571,672,334,338,110,93,91,41,299,153,146,32,28,29,12,1
17572,659,325,334,102,85,87,32,675,311,364,111,80,96,30,1
17573,424,197,227,67,62,43,17,1416,545,871,279,247,84,54,1
17574,278,164,114,35,23,30,18,152,83,69,24,21,12,5,1
17575,480,234,246,79,77,65,23,1112,555,557,139,137,124,48,1
17576,321,180,141,47,37,33,12,271,126,145,33,38,31,10,1
17577,277,141,136,35,21,16,22,255,111,144,31,25,21,28,1
17578,97,50,47,17,14,14,10,327,177,150,40,40,38,18,1
17579,619,289,330,67,77,36,19,785,374,411,56,42,38,25,1
17580,918,357,561,191,150,42,24,165,77,88,28,27,19,10,1
17581,387,249,138,44,14,48,22,359,173,186,55,57,44,16,1
17582,1290,597,693,182,182,119,63,410,175,235,73,61,37,27,1
17583,552,285,267,74,51,69,24,575,225,350,106,74,68,29,1
17584,323,169,154,47,44,39,20,393,186,207,58,50,36,22,1
17585,87,52,35,17,5,7,6,370,237,133,43,19,48,14,1
17586,403,185,218,67,62,63,19,358,170,188,54,55,20,10,1
17587,1257,647,610,156,146,145,35,1040,562,478,125,101,103,32,1
17588,280,136,144,41,34,26,16,278,146,132,43,27,22,11,1
17589,1446,762,684,193,160,182,67,354,168,186,50,53,39,20,1
17590,855,456,399,96,105,108,47,536,278,258,72,63,62,20,1
17591,1353,646,707,206,157,151,60,659,325,334,102,85,87,32,1
17592,357,184,173,51,55,35,11,205,90,115,40,32,25,15,1
17593,356,199,157,43,58,29,12,419,197,222,70,51,36,19,1
17594,863,430,433,131,110,70,28,354,137,217,53,57,30,5,1
17595,826,362,464,107,118,71,43,426,221,205,71,51,39,21,1
17596,1047,562,485,141,127,114,41,635,333,302,99,75,83,28,1
17597,279,106,173,48,35,41,39,769,362,407,99,88,66,67,1
17598,341,154,187,34,36,11,11,205,100,105,25,25,20,9,1
17599,372,189,183,60,44,41,18,580,339,241,72,47,66,21,1
17600,350,224,126,34,14,48,18,305,177,128,42,25,39,6,1
17601,705,396,309,87,48,53,17,724,334,390,112,109,79,17,1
17602,400,208,192,62,44,42,21,508,267,241,43,35,25,17,1
17603,1581,684,897,220,153,118,63,530,259,271,83,50,54,41,1
17604,175,101,74,20,20,20,9,89,45,44,13,4,8,3,1
17605,504,259,245,73,56,45,29,747,371,376,87,134,54,29,1
17606,759,391,368,103,82,101,45,977,500,477,139,115,121,31,1
17607,991,483,508,166,120,94,42,177,67,110,34,24,13,10,1
17608,998,496,502,149,146,89,27,750,347,403,105,103,83,29,1
17609,441,218,223,69,55,50,27,187,96,91,30,24,24,4,1
17610,284,111,173,47,34,47,43,508,267,241,43,35,25,17,1
17611,125,58,67,20,16,10,5,168,67,101,37,17,13,13,1
17612,552,285,267,74,51,69,24,1580,742,838,208,146,144,71,1
17613,626,333,293,64,55,61,15,1152,586,566,131,112,117,42,1
17614,593,295,298,70,85,48,13,870,436,434,131,114,72,25,1
17615,1106,579,527,121,152,113,45,198,110,88,27,27,24,4,1
17616,95,41,54,15,16,8,5,256,114,142,27,46,30,13,1
17617,3664,1638,2026,598,519,231,63,462,228,234,59,47,37,32,1
17618,2839,1413,1426,384,301,308,145,201,98,103,26,35,16,5,1
17619,524,264,260,75,75,40,21,1105,514,591,164,147,85,21,1
17620,2016,1107,909,214,229,238,111,1801,889,912,206,263,126,42,1
17621,907,442,465,139,105,106,33,3911,1465,2446,610,767,240,133,1
17622,593,266,327,102,84,69,24,1009,506,503,146,141,97,55,1
17623,351,184,167,59,45,54,9,673,287,386,89,111,66,30,1
17624,510,264,246,67,66,38,29,159,84,75,13,28,10,8,1
17625,24,14,10,4,2,1,2,297,145,152,49,30,23,21,1
17626,4655,2074,2581,545,652,562,399,110,67,43,9,10,11,8,1
17627,541,269,272,75,57,59,36,139,62,77,23,6,14,4,1
17628,406,202,204,62,39,58,19,847,402,445,109,91,100,37,1
17629,359,174,185,54,56,43,16,466,247,219,51,32,49,26,1
17630,1149,568,581,177,133,101,30,833,452,381,117,85,71,39,1
17631,863,418,445,127,114,70,31,1047,475,572,176,183,110,39,1
17632,624,308,316,92,72,68,22,892,420,472,135,146,98,37,1
17633,350,200,150,45,47,23,8,198,102,96,27,20,21,12,1
17634,964,408,556,131,153,76,55,521,289,232,71,58,49,16,1
17635,907,455,452,132,117,80,40,431,186,245,79,83,37,18,1
17636,255,113,142,31,40,18,9,141,64,77,26,24,10,6,1
17637,233,121,112,24,31,30,7,427,218,209,61,53,45,26,1
17638,228,118,110,32,28,18,6,2005,1074,931,235,243,249,109,1
17639,218,121,97,29,26,21,6,1834,823,1011,297,282,151,63,1
17640,489,253,236,73,36,62,17,454,224,230,71,39,62,22,1
17641,536,287,249,64,73,21,27,558,302,256,66,62,65,30,1
17642,444,250,194,58,21,60,23,316,157,159,45,38,22,19,1
17643,514,248,266,105,68,38,20,357,214,143,30,32,27,13,1
17644,454,224,230,71,39,62,22,160,67,93,32,37,15,9,1
17645,216,104,112,27,18,35,20,383,185,198,50,40,42,18,1
17646,440,218,222,58,66,40,24,592,291,301,92,93,71,31,1
17647,1189,559,630,179,147,118,35,526,264,262,77,71,61,27,1
17648,114,64,50,16,19,14,5,446,176,270,64,79,45,24,1
17649,747,469,278,60,41,53,23,1581,684,897,220,153,118,63,1
17650,683,304,379,140,101,48,19,202,102,100,29,35,6,9,1
17651,436,205,231,39,51,26,20,224,108,116,33,26,32,10,1
17652,211,113,98,38,17,25,8,638,305,333,68,90,70,29,1
17653,223,93,130,38,27,39,10,299,128,171,57,40,13,25,1
17654,436,201,235,54,37,34,20,926,435,491,133,132,85,17,1
17655,462,251,211,74,53,41,18,1816,865,951,246,230,189,76,1
17656,624,308,316,92,72,68,22,811,400,411,107,87,116,43,1
17657,1018,547,471,122,122,120,33,1257,647,610,156,146,145,35,1
17658,951,506,445,107,118,79,40,678,337,341,100,75,69,34,1
17659,84,46,38,12,11,9,6,250,130,120,40,32,19,13,1
17660,1070,558,512,154,134,126,54,526,264,262,77,71,61,27,1
17661,111,29,82,10,54,0,1,452,239,213,62,46,38,22,1
17662,491,233,258,81,76,42,25,655,327,328,91,76,53,28,1
17663,1009,506,503,146,141,97,55,508,268,240,92,58,56,21,1
17664,358,179,179,46,46,40,11,1270,557,713,130,195,57,30,1
17665,770,430,340,97,81,77,30,767,392,375,113,112,83,13,1
17666,394,220,174,50,28,53,21,247,110,137,34,45,23,10,1
17667,209,78,131,33,42,11,7,340,145,195,46,38,26,23,1
17668,574,295,279,78,65,61,22,246,115,131,15,29,10,32,1
17669,446,176,270,64,79,45,24,259,135,124,23,38,16,12,1
17670,1063,578,485,116,121,117,39,2477,1186,1291,256,271,249,90,1
17671,2214,993,1221,361,324,190,74,920,492,428,100,92,88,49,1
17672,447,222,225,71,54,44,25,533,297,236,74,57,39,28,1
17673,399,196,203,62,45,38,19,454,191,263,61,66,38,15,1
17674,95,49,46,12,16,9,5,97,46,51,12,17,11,8,1
17675,317,153,164,39,30,35,13,1047,562,485,141,127,114,41,1
17676,217,102,115,28,26,22,9,424,209,215,56,58,45,24,1
17677,863,418,445,127,114,70,31,577,251,326,92,84,60,11,1
17678,202,111,91,28,33,5,3,125,58,67,20,16,10,5,1
17679,385,179,206,58,56,38,19,536,278,258,72,63,62,20,1
17680,1384,769,615,178,141,219,56,537,276,261,75,68,68,22,1
17681,653,309,344,107,75,49,14,213,109,104,26,26,21,6,1
17682,316,157,159,45,38,22,19,423,222,201,51,33,41,28,1
17683,292,154,138,46,29,41,7,2109,999,1110,332,294,187,89,1
17684,1995,931,1064,305,242,159,52,89,42,47,16,12,15,6,1
17685,374,181,193,55,58,48,23,488,217,271,71,71,50,32,1
17686,81,41,40,15,13,3,2,913,408,505,141,125,87,36,1
17687,1050,473,577,142,119,87,54,920,492,428,100,92,88,49,1
17688,1114,581,533,145,132,126,54,217,109,108,34,32,35,7,1
17689,351,184,167,59,45,54,9,1032,526,506,129,117,119,47,1
17690,2414,1189,1225,277,178,170,169,390,207,183,50,48,38,15,1
17691,2442,1193,1249,278,183,170,145,111,29,82,10,54,0,1,1
17692,1235,637,598,191,162,99,36,445,225,220,47,62,53,26,1
17693,217,94,123,29,30,23,17,355,165,190,53,56,42,19,1
17694,1099,491,608,163,141,107,62,928,442,486,139,118,91,43,1
17695,563,286,277,95,73,76,13,723,309,414,106,106,41,40,1
17696,536,278,258,72,63,62,20,909,455,454,137,82,85,68,1
17697,1182,612,570,142,118,140,62,569,327,242,64,54,54,16,1
17698,664,301,363,113,83,64,26,467,224,243,70,43,67,23,1
17699,351,195,156,47,53,25,14,239,146,93,30,22,35,9,1
17700,1424,650,774,152,124,95,87,598,322,276,67,57,63,26,1
17701,617,386,231,60,48,76,38,393,186,207,58,50,36,22,1
17702,537,276,261,75,68,68,22,976,496,480,128,111,121,48,1
17703,1051,523,528,164,140,126,50,450,238,212,59,45,53,23,1
17704,575,290,285,67,70,28,9,520,224,296,69,64,31,29,1
17705,300,140,160,39,35,14,12,519,257,262,63,73,45,19,1
17706,505,271,234,56,57,57,26,703,356,347,96,97,38,22,1
17707,335,183,152,40,26,54,23,100,61,39,13,12,10,4,1
17708,307,133,174,48,53,27,10,770,374,396,95,91,79,41,1
17709,140,81,59,16,15,15,12,375,202,173,46,49,41,23,1
17710,509,262,247,64,70,64,20,586,254,332,114,111,55,17,1
17711,875,376,499,155,125,53,39,597,246,351,95,98,45,25,1
17712,873,422,451,126,101,124,52,1382,689,693,186,176,167,77,1
17713,896,407,489,97,152,70,22,525,245,280,59,72,47,21,1
17714,781,374,407,123,99,65,26,416,182,234,62,67,37,17,1
17715,562,281,281,80,61,67,23,175,90,85,28,21,19,7,1
17716,609,292,317,102,96,64,21,245,112,133,32,45,20,10,1
17717,668,338,330,85,95,68,18,175,90,85,28,21,19,7,1
17718,626,345,281,62,76,66,25,1466,991,475,136,129,59,39,1
17719,391,208,183,65,49,57,17,255,109,146,35,32,23,17,1
17720,862,409,453,149,125,86,29,670,333,337,95,79,62,21,1
17721,1544,670,874,236,239,128,49,193,99,94,31,31,16,12,1
17722,956,475,481,122,128,100,50,469,204,265,81,67,30,22,1
17723,264,126,138,44,26,25,10,439,205,234,64,88,41,21,1
17724,766,344,422,118,114,69,38,377,202,175,46,50,41,23,1
17725,881,383,498,142,148,77,24,2758,1332,1426,394,384,287,131,1
17726,162,73,89,32,19,4,4,367,161,206,70,48,41,19,1
17727,928,442,486,139,118,91,43,269,156,113,37,32,17,7,1
17728,439,199,240,66,64,49,30,660,359,301,81,87,102,31,1
17729,815,418,397,97,62,70,17,191,91,100,28,33,23,12,1
17730,148,93,55,24,3,19,8,292,162,130,43,27,21,12,1
17731,864,362,502,142,150,70,19,448,236,212,53,64,56,24,1
17732,1130,590,540,155,133,133,61,205,101,104,34,25,34,8,1
17733,728,385,343,110,102,69,14,581,323,258,74,58,48,20,1
17734,847,402,445,137,119,102,41,193,99,94,31,31,16,12,1
17735,277,100,177,35,88,30,2,307,150,157,44,23,30,13,1
17736,770,374,396,95,91,79,41,826,362,464,107,118,71,43,1
17737,236,140,96,20,39,12,6,173,110,63,35,6,9,8,1
17738,393,186,207,58,50,36,22,182,90,92,25,23,14,5,1
17739,1332,659,673,174,170,153,55,427,218,209,61,53,45,26,1
17740,264,126,138,44,26,25,10,215,80,135,54,56,21,9,1
17741,202,123,79,12,15,26,21,919,538,381,111,98,103,41,1
17742,235,104,131,29,35,26,10,712,396,316,78,69,65,25,1
17743,341,167,174,48,47,31,8,211,114,97,32,24,19,10,1
17744,555,278,277,60,70,48,18,3460,1748,1712,369,360,496,190,1
17745,467,250,217,64,49,63,39,165,80,85,21,9,18,19,1
17746,2414,1189,1225,277,178,170,169,467,226,241,55,48,54,23,1
17747,333,167,166,45,30,34,14,354,137,217,53,57,30,5,1
17748,441,235,206,71,34,58,18,440,200,240,47,31,46,22,1
17749,341,178,163,48,44,42,20,126,47,79,24,20,8,8,1
17750,822,416,406,111,105,84,44,207,94,113,44,20,25,10,1
17751,290,127,163,47,58,23,12,1123,554,569,142,130,85,36,1
17752,258,113,145,43,44,16,7,239,121,118,28,38,15,7,1
17753,412,238,174,41,38,43,19,770,355,415,103,142,75,42,1
17754,586,310,276,82,71,63,24,308,170,138,38,35,45,14,1
17755,805,338,467,109,145,49,25,344,181,163,61,37,40,14,1
17756,700,335,365,83,84,95,33,97,53,44,13,12,7,5,1
17757,163,70,93,28,21,17,6,229,105,124,36,33,12,4,1
17758,347,181,166,27,20,12,12,331,169,162,40,28,22,14,1
17759,476,220,256,65,65,41,21,207,99,108,34,27,22,9,1
17760,583,264,319,82,78,35,26,551,286,265,93,55,49,15,1
17761,1721,809,912,268,234,144,50,191,99,92,25,24,18,8,1
17762,605,281,324,111,67,40,44,426,228,198,62,42,47,22,1
17763,236,145,91,17,19,30,18,238,151,87,15,14,35,18,1
17764,595,316,279,86,60,65,40,461,208,253,79,76,61,21,1
17765,942,423,519,130,126,104,50,306,163,143,42,32,38,11,1
17766,777,387,390,90,87,65,37,239,121,118,28,38,15,7,1
17767,688,364,324,74,94,89,40,500,242,258,53,48,44,18,1
17768,815,382,433,97,50,88,31,1447,814,633,171,141,183,58,1
17769,394,202,192,44,43,38,28,157,72,85,46,9,12,5,1
17770,229,116,113,34,27,27,15,503,263,240,72,55,51,34,1
17771,911,423,488,140,150,102,32,825,363,462,97,105,72,75,1
17772,298,129,169,51,40,29,8,718,283,435,126,127,34,29,1
17773,3664,1638,2026,598,519,231,63,267,147,120,40,24,25,8,1
17774,561,292,269,88,68,64,22,431,204,227,59,72,41,12,1
17775,403,188,215,70,42,41,11,291,133,158,46,51,21,15,1
17776,100,48,52,8,15,5,7,217,98,119,33,32,27,7,1
17777,730,328,402,126,99,48,23,673,329,344,111,95,92,41,1
17778,247,110,137,34,45,23,10,430,192,238,62,67,27,10,1
17779,1116,539,577,149,161,115,43,605,263,342,73,103,54,18,1
17780,693,289,404,95,158,61,15,921,455,466,144,127,108,39,1
17781,822,416,406,111,105,84,44,380,184,196,58,52,46,8,1
17782,365,180,185,63,35,48,19,245,112,133,32,45,20,10,1
17783,2768,1380,1388,280,294,291,161,291,131,160,40,42,36,14,1
17784,656,358,298,67,47,64,26,1382,599,783,208,252,90,39,1
17785,136,66,70,33,11,9,5,140,71,69,33,11,14,2,1
17786,1124,615,509,157,125,128,52,164,88,76,27,20,17,6,1
17787,374,235,139,33,16,72,21,255,130,125,44,18,22,12,1
17788,360,219,141,33,26,65,22,688,330,358,122,97,92,39,1
17789,646,316,330,89,95,48,17,211,86,125,35,32,10,9,1
17790,906,413,493,134,111,94,61,557,273,284,74,56,81,19,1
17791,5537,2898,2639,598,623,347,214,628,324,304,83,85,75,23,1
17792,186,92,94,28,23,17,11,503,263,240,72,55,51,34,1
17793,196,107,89,19,18,15,7,635,333,302,99,75,83,28,1
17794,522,235,287,78,67,60,50,427,218,209,61,53,45,26,1
17795,2414,1189,1225,277,178,170,169,375,167,208,55,83,44,9,1
17796,228,118,110,32,29,36,13,1005,540,465,133,101,106,55,1
17797,792,398,394,109,96,90,39,769,329,440,116,66,55,22,1
17798,211,126,85,21,20,28,7,573,316,257,78,80,21,21,1
17799,541,279,262,79,82,31,32,377,202,175,46,50,41,23,1
17800,907,442,465,139,105,106,33,451,222,229,58,55,51,17,1
17801,1050,561,489,138,91,90,41,117,62,55,24,18,21,2,1
17802,266,110,156,50,28,43,7,347,133,214,64,60,29,9,1
17803,833,408,425,118,115,82,33,2157,1171,986,306,238,131,32,1
17804,502,240,262,78,61,54,32,424,197,227,67,62,43,17,1
17805,991,483,508,166,120,94,42,437,225,212,61,57,66,12,1
17806,770,374,396,95,91,79,41,480,257,223,74,26,60,27,1
17807,714,364,350,98,102,91,27,2364,1004,1360,406,426,226,79,1
17808,331,183,148,36,44,40,21,220,102,118,26,32,27,10,1
17809,165,78,87,23,21,17,8,476,251,225,57,67,57,18,1
17810,203,99,104,22,28,20,10,465,225,240,65,44,65,25,1
17811,683,365,318,89,69,56,25,1487,996,491,147,141,50,35,1
17812,647,322,325,104,98,54,14,493,275,218,64,36,49,30,1
17813,125,75,50,14,8,18,7,1092,562,530,126,91,125,84,1
17814,431,216,215,46,40,33,9,134,60,74,19,13,10,7,1
17815,1096,513,583,195,156,113,24,247,110,137,34,45,23,10,1
17816,355,168,187,48,57,30,15,169,86,83,31,24,26,4,1
17817,173,93,80,18,24,12,7,240,98,142,49,42,23,17,1
17818,358,204,154,57,41,36,14,480,234,246,79,77,65,23,1
17819,1599,806,793,213,237,100,45,1425,670,755,153,189,122,85,1
17820,785,374,411,56,42,38,25,882,432,450,115,111,68,44,1
17821,403,195,208,68,48,37,16,288,118,170,50,57,18,15,1
17822,95,49,46,12,16,9,5,101,45,56,17,17,12,9,1
17823,833,452,381,117,85,71,39,1210,592,618,157,138,116,85,1
17824,391,208,183,65,49,57,17,478,220,258,47,69,41,10,1
17825,323,123,200,59,69,30,15,425,198,227,57,69,59,13,1
17826,442,254,188,54,31,50,30,589,296,293,99,76,64,29,1
17827,1247,548,699,168,150,140,43,640,339,301,70,64,90,41,1
17828,257,140,117,46,24,15,7,399,201,198,65,45,48,17,1
17829,222,106,116,31,27,27,15,592,291,301,92,93,71,31,1
17830,552,264,288,82,64,48,20,1254,631,623,152,160,66,44,1
17831,413,227,186,45,34,58,23,269,133,136,30,41,34,17,1
17832,573,247,326,98,95,46,22,744,331,413,118,114,58,28,1
17833,217,121,96,27,34,18,10,187,75,112,41,32,17,11,1
17834,175,88,87,29,21,18,5,601,313,288,42,48,25,36,1
17835,289,147,142,45,45,38,13,240,125,115,34,32,30,8,1
17836,1471,709,762,198,184,154,62,785,325,460,114,123,61,28,1
17837,496,276,220,87,47,60,31,993,492,501,116,119,135,57,1
17838,245,93,152,35,28,32,21,424,255,169,38,26,27,14,1
17839,724,334,390,112,109,79,17,217,109,108,34,32,35,7,1
17840,673,391,282,70,57,40,25,412,192,220,71,50,48,23,1
17841,585,299,286,92,73,89,23,920,492,428,100,92,88,49,1
17842,258,126,132,38,22,29,8,434,221,213,58,47,54,15,1
17843,326,160,166,38,38,33,13,1132,646,486,99,102,71,41,1
17844,582,293,289,94,80,77,32,901,458,443,91,129,86,21,1
17845,277,173,104,26,12,48,19,417,182,235,57,109,50,8,1
17846,982,494,488,150,117,91,45,829,366,463,137,130,56,10,1
17847,487,223,264,81,68,63,15,354,169,185,54,54,41,19,1
17848,1038,470,568,130,123,86,51,597,282,315,81,64,75,43,1
17849,1367,690,677,172,175,154,83,728,385,343,110,102,69,14,1
17850,282,152,130,35,27,13,21,110,67,43,9,10,11,8,1
17851,671,318,353,83,124,46,34,355,169,186,49,37,26,11,1
17852,280,164,116,46,21,19,9,654,344,310,80,69,57,15,1
17853,277,153,124,39,33,48,12,2416,1280,1136,140,374,175,47,1
17854,154,75,79,28,23,16,6,906,455,451,116,105,87,46,1
17855,510,256,254,76,65,64,15,2351,1110,1241,337,269,300,87,1
17856,1591,734,857,229,225,171,75,288,112,176,55,55,18,15,1
17857,892,397,495,146,63,65,37,299,164,135,30,21,29,10,1
17858,183,78,105,30,31,26,8,673,313,360,101,101,46,17,1
17859,803,346,457,126,171,74,24,894,448,446,123,100,81,30,1
17860,463,236,227,64,50,44,29,1152,556,596,146,159,31,39,1
17861,379,203,176,55,48,45,16,654,344,310,80,69,57,15,1
17862,624,204,420,166,101,32,13,709,294,415,132,123,76,23,1
17863,721,331,390,100,122,92,28,1071,549,522,133,127,130,59,1
17864,482,231,251,76,81,64,26,1139,536,603,162,139,109,50,1
17865,589,316,273,83,60,69,25,464,242,222,61,68,36,17,1
17866,450,232,218,58,54,42,20,220,106,114,32,26,15,7,1
17867,95,44,51,14,13,7,4,424,284,140,51,28,47,20,1
17868,329,190,139,24,23,50,13,211,83,128,28,35,5,11,1
17869,1123,554,569,142,130,85,36,248,119,129,33,48,20,10,1
17870,219,97,122,30,29,23,9,792,399,393,96,103,85,37,1
17871,601,313,288,42,48,25,36,366,124,242,80,63,25,8,1
17872,413,194,219,77,72,28,11,628,341,287,77,59,55,31,1
17873,448,275,173,32,53,55,27,233,121,112,24,31,30,7,1
17874,1748,791,957,281,247,173,25,377,202,175,46,50,41,23,1
17875,1149,568,581,177,133,101,30,1651,798,853,203,199,137,50,1
17876,114,71,43,8,18,7,4,757,359,398,109,127,80,26,1
17877,121,69,52,15,18,14,8,270,137,133,30,28,27,11,1
17878,1190,638,552,162,95,112,18,1359,684,675,188,160,127,47,1
17879,113,54,59,20,16,13,3,1272,520,752,235,242,117,54,1
17880,110,49,61,19,7,2,5,5497,2328,3169,872,896,436,168,1
17881,225,116,109,29,19,25,6,863,470,393,82,72,92,44,1
17882,957,485,472,111,119,127,29,115,62,53,17,12,8,7,1
17883,298,154,144,44,34,25,11,553,309,244,75,60,39,14,1
17884,928,442,486,139,118,91,43,339,170,169,32,17,24,13,1
17885,522,235,287,78,67,60,50,360,188,172,49,48,47,17,1
17886,385,212,173,57,40,39,21,201,88,113,33,27,20,8,1
17887,890,390,500,129,115,66,33,208,99,109,28,30,18,9,1
17888,668,343,325,61,79,65,35,495,233,262,64,39,49,32,1
17889,923,471,452,119,117,119,41,412,195,217,79,48,36,29,1
17890,728,343,385,116,82,96,57,431,201,230,69,39,55,33,1
17891,153,84,69,19,9,12,13,617,387,230,65,57,77,16,1
17892,217,109,108,34,32,35,7,595,316,279,86,60,65,40,1
17893,431,204,227,59,72,41,12,454,200,254,86,74,43,13,1
17894,3122,1486,1636,416,387,297,209,295,161,134,30,40,31,9,1
17895,231,87,144,37,40,7,10,579,321,258,74,70,47,22,1
17896,358,196,162,58,49,54,9,404,197,207,57,69,33,15,1
17897,148,64,84,33,19,6,1,271,110,161,33,27,11,8,1
17898,835,419,416,119,94,106,40,330,166,164,57,51,36,16,1
17899,789,389,400,121,80,92,40,743,377,366,87,74,68,30,1
17900,797,406,391,121,86,64,15,896,430,466,120,117,85,35,1
17901,986,465,521,152,132,138,51,475,268,207,61,27,56,30,1
17902,1212,645,567,145,117,122,72,149,68,81,15,38,11,10,1
17903,2157,1171,986,306,238,131,32,775,407,368,122,100,97,32,1
17904,379,140,239,99,60,30,11,873,366,507,127,125,75,21,1
17905,1187,631,556,182,139,152,56,435,208,227,68,64,53,23,1
17906,298,167,131,47,33,40,8,801,395,406,106,91,61,25,1
17907,725,339,386,112,122,93,32,858,461,397,125,114,79,45,1
17908,660,326,334,106,61,71,32,601,313,288,42,48,25,36,1
17909,396,215,181,53,43,55,17,428,223,205,59,67,23,16,1
17910,262,151,111,30,17,32,25,308,164,144,47,29,33,7,1
17911,400,208,192,62,44,42,21,151,75,76,21,22,9,5,1
17912,346,180,166,55,49,38,6,266,110,156,50,28,43,7,1
17913,619,290,329,97,79,62,19,2468,1038,1430,333,465,167,62,1
17914,761,346,415,114,113,89,35,551,237,314,95,79,54,17,1
17915,1721,809,912,268,234,144,50,189,90,99,26,29,17,11,1
17916,270,137,133,30,28,27,11,769,329,440,116,66,55,22,1
17917,659,325,334,102,85,87,32,1154,540,614,195,160,138,66,1
17918,355,168,187,48,57,30,15,665,297,368,111,107,34,12,1
17919,794,390,404,103,95,86,23,675,311,364,111,80,96,30,1
17920,75,32,43,12,13,6,3,559,296,263,77,69,42,13,1
17921,323,198,125,28,25,34,15,409,268,141,32,26,57,25,1
17922,777,345,432,128,88,65,39,652,272,380,116,113,55,27,1
17923,431,201,230,69,39,55,33,562,265,297,79,56,72,45,1
17924,269,134,135,42,35,27,13,202,102,100,29,35,6,9,1
17925,437,225,212,61,57,66,12,159,84,75,13,28,10,8,1
17926,676,333,343,111,89,94,39,726,326,400,106,106,57,31,1
17927,673,329,344,111,95,92,41,238,95,143,37,55,4,4,1
17928,1190,638,552,162,95,112,18,493,222,271,44,53,45,51,1
17929,2028,839,1189,343,328,118,51,670,333,337,95,79,62,21,1
17930,181,75,106,35,26,11,9,331,169,162,40,28,22,14,1
17931,969,505,464,123,133,92,33,1871,919,952,318,233,164,56,1
17932,514,226,288,71,66,63,32,1273,592,681,199,164,139,39,1
17933,906,460,446,117,131,108,33,1233,635,598,187,149,146,51,1
17934,625,342,283,62,53,56,28,509,254,255,67,55,52,35,1
17935,1332,626,706,182,144,80,41,375,192,183,50,39,46,16,1
17936,595,316,279,86,60,65,40,1255,666,589,145,142,120,82,1
17937,473,245,228,67,52,70,24,2468,1038,1430,333,465,167,62,1
17938,578,294,284,60,66,63,17,325,169,156,32,37,49,20,1
17939,83,33,50,14,11,7,9,331,169,162,40,28,22,14,1
17940,822,416,406,111,105,84,44,508,215,293,72,71,42,15,1
17941,863,458,405,97,82,63,57,782,347,435,110,92,74,34,1
17942,427,164,263,62,80,14,10,767,392,375,113,112,83,13,1
17943,869,488,381,110,77,78,30,1050,473,577,142,119,87,54,1
17944,52,24,28,6,4,3,5,582,293,289,94,80,77,32,1
17945,362,225,137,43,22,30,11,99,48,51,15,7,7,7,1
17946,332,211,121,27,16,41,22,604,272,332,112,62,67,51,1
17947,324,219,105,25,24,27,14,419,212,207,61,44,35,21,1
17948,1473,758,715,205,171,161,65,452,224,228,69,56,50,31,1
17949,816,463,353,99,99,61,26,462,233,229,66,49,43,30,1
17950,598,300,298,68,77,59,21,1087,485,602,151,151,112,48,1
17951,209,125,84,20,22,22,6,393,186,207,58,50,36,22,1
17952,355,165,190,53,56,42,19,318,176,142,25,32,35,25,1
17953,272,131,141,36,26,36,16,202,102,100,29,35,6,9,1
17954,372,199,173,56,45,40,15,462,232,230,78,54,42,23,1
17955,355,168,187,48,57,30,15,235,149,86,30,21,17,5,1
17956,235,104,131,29,35,26,10,427,236,191,49,54,46,13,1
17957,758,362,396,115,102,35,13,537,276,261,75,68,68,22,1
17958,509,341,168,35,32,52,15,854,380,474,137,159,81,31,1
17959,161,94,67,23,13,8,10,671,303,368,93,68,61,26,1
17960,1151,493,658,157,141,108,62,985,551,434,123,93,91,26,1
17961,313,159,154,30,40,23,14,299,153,146,32,28,29,12,1
17962,520,224,296,69,64,31,29,360,188,172,49,48,47,17,1
17963,1738,821,917,242,196,181,58,1464,715,749,200,167,181,70,1
17964,142,80,62,24,12,21,4,147,86,61,23,15,22,4,1
17965,345,176,169,34,31,36,11,467,226,241,55,48,54,23,1
17966,762,363,399,127,85,83,31,648,307,341,101,58,76,34,1
17967,189,90,99,26,29,17,11,239,146,93,30,22,35,9,1
17968,710,352,358,104,86,84,41,648,307,341,101,58,76,34,1
17969,684,288,396,107,90,54,42,505,231,274,64,68,30,40,1
17970,341,154,187,34,36,11,11,140,86,54,17,6,20,7,1
17971,766,386,380,101,81,78,31,184,86,98,26,26,14,11,1
17972,78,45,33,12,10,2,5,149,68,81,15,38,11,10,1
17973,1960,875,1085,287,189,162,66,190,74,116,34,29,11,11,1
17974,187,96,91,30,24,24,4,1223,593,630,161,135,142,71,1
17975,482,224,258,71,62,52,39,463,236,227,64,50,44,29,1
17976,977,406,571,151,128,84,47,2843,1104,1739,429,357,178,95,1
17977,151,84,67,17,17,22,11,895,474,421,122,93,69,25,1
17978,95,41,54,15,16,8,5,2045,985,1060,359,339,199,74,1
17979,473,259,214,63,62,47,18,2261,1217,1044,271,243,267,101,1
17980,1006,551,455,115,97,110,41,906,455,451,116,105,87,46,1
17981,705,357,348,90,84,100,41,253,155,98,27,20,22,14,1
17982,451,239,212,53,64,56,22,442,252,190,35,52,20,4,1
17983,1562,848,714,179,178,125,63,431,204,227,59,72,41,12,1
17984,430,198,232,57,46,37,19,301,157,144,31,28,34,9,1
17985,2564,1278,1286,414,406,207,64,854,399,455,127,118,57,39,1
17986,185,115,70,19,17,26,6,220,102,118,26,32,27,10,1
17987,863,458,405,97,82,63,57,512,261,251,79,73,60,21,1
17988,156,74,82,24,18,16,22,108,55,53,19,7,11,2,1
17989,1333,646,687,209,179,148,45,822,416,406,111,105,84,44,1
17990,907,530,377,61,82,63,30,1290,629,661,191,187,167,55,1
17991,177,108,69,15,13,17,11,411,267,144,55,23,24,21,1
17992,103,49,54,21,21,10,2,903,457,446,99,127,62,29,1
17993,530,259,271,83,50,54,41,628,341,287,77,59,55,31,1
17994,1531,649,882,108,122,93,72,431,235,196,64,33,48,20,1
17995,407,218,189,34,41,23,17,953,493,460,122,133,87,47,1
17996,347,183,164,55,45,51,16,4655,2074,2581,545,652,562,399,1
17997,1069,512,557,148,126,84,36,706,320,386,111,76,75,51,1
17998,858,398,460,126,138,75,39,768,378,390,105,104,63,26,1
17999,246,113,133,33,45,22,10,465,218,247,64,51,50,42,1
18000,350,180,170,64,46,55,12,300,140,160,39,35,14,12,1
18001,473,230,243,80,56,52,35,536,278,258,72,63,62,20,1
18002,1320,599,721,177,156,104,47,6669,2978,3691,1310,930,829,237,1
18003,1210,578,632,172,184,94,66,1247,492,755,222,184,67,44,1
18004,2442,1193,1249,278,183,170,145,552,285,267,74,51,69,24,1
18005,350,224,126,34,14,48,18,247,149,98,28,10,35,14,1
18006,461,207,254,82,66,55,33,155,66,89,24,25,9,14,1
18007,894,469,425,127,93,82,31,318,176,142,25,32,35,25,1
18008,482,231,251,76,81,64,26,901,458,443,91,129,86,21,1
18009,839,444,395,107,95,104,39,149,68,81,15,38,11,10,1
18010,224,103,121,34,47,11,9,219,100,119,32,43,9,10,1
18011,3685,1574,2111,579,580,303,116,377,202,175,46,50,41,23,1
18012,283,142,141,35,29,32,5,218,127,91,27,23,23,10,1
18013,553,261,292,73,79,40,26,350,180,170,64,46,55,12,1
18014,1190,638,552,162,95,112,18,604,275,329,95,69,52,25,1
18015,525,299,226,54,54,51,19,254,107,147,42,37,24,10,1
18016,396,189,207,24,19,47,18,424,284,140,51,28,47,20,1
18017,851,417,434,109,116,83,28,356,208,148,42,26,57,15,1
18018,539,261,278,80,69,58,20,1014,490,524,177,137,94,38,1
18019,564,291,273,77,72,95,21,950,497,453,146,127,115,43,1
18020,672,334,338,110,93,91,41,706,458,248,56,38,112,39,1
18021,745,366,379,110,93,79,45,595,316,279,86,60,65,40,1
18022,160,77,83,14,27,11,10,297,158,139,47,37,37,9,1
18023,624,308,316,92,72,68,22,375,192,183,48,29,44,17,1
18024,423,212,211,51,44,48,28,769,362,407,99,88,66,67,1
18025,262,150,112,31,33,31,7,427,218,209,61,53,45,26,1
18026,303,141,162,42,57,37,20,211,90,121,49,27,14,11,1
18027,467,269,198,46,51,60,18,901,458,443,91,129,86,21,1
18028,264,122,142,33,29,13,13,576,250,326,93,71,34,15,1
18029,1149,568,581,177,133,101,30,619,332,287,95,77,74,38,1
18030,669,382,287,67,35,70,16,366,184,182,46,42,23,18,1
18031,864,362,502,142,150,70,19,377,202,175,46,50,41,23,1
18032,999,541,458,110,110,104,42,165,80,85,21,9,18,19,1
18033,894,408,486,143,129,93,41,206,94,112,37,36,18,9,1
18034,676,333,343,111,89,94,39,768,378,390,105,104,63,26,1
18035,456,209,247,72,58,40,9,303,159,144,40,35,35,8,1
18036,672,334,338,110,93,91,41,304,127,177,61,38,31,4,1
18037,155,85,70,17,16,4,8,921,455,466,144,127,108,39,1
18038,501,249,252,77,70,55,22,462,251,211,74,53,41,18,1
18039,211,88,123,38,28,26,10,385,193,192,59,44,30,15,1
18040,185,115,70,19,17,26,6,323,181,142,40,37,26,16,1
18041,668,338,330,85,95,68,18,259,143,116,39,37,23,9,1
18042,864,429,435,129,118,68,35,206,85,121,31,42,6,17,1
18043,3418,1378,2040,515,464,318,121,616,304,312,75,71,55,25,1
18044,838,431,407,107,90,107,43,210,124,86,27,21,14,8,1
18045,246,125,121,33,31,34,18,249,111,138,40,30,22,17,1
18046,390,191,199,57,49,45,25,270,130,140,43,24,36,10,1
18047,101,55,46,13,15,12,3,1065,533,532,147,148,176,40,1
18048,839,439,400,101,86,102,43,331,169,162,40,28,22,14,1
18049,496,251,245,78,62,61,23,393,186,207,58,50,36,22,1
18050,290,138,152,37,50,24,14,323,181,142,40,37,26,16,1
18051,289,139,150,38,44,23,20,292,152,140,46,38,35,12,1
18052,482,224,258,71,62,52,39,595,316,279,86,60,65,40,1
18053,1692,713,979,325,210,122,58,2339,1260,1079,336,252,279,106,1
18054,480,234,246,79,77,65,23,301,163,138,49,36,40,11,1
18055,89,42,47,16,12,15,6,375,202,173,46,49,41,23,1
18056,201,92,109,27,24,16,8,2517,1275,1242,304,324,245,135,1
18057,1073,541,532,126,143,123,54,806,419,387,115,130,57,32,1
18058,1114,581,533,145,132,126,54,331,151,180,55,38,46,18,1
18059,231,126,105,37,26,29,6,467,250,217,59,52,41,19,1
18060,380,184,196,58,52,46,8,673,313,360,101,101,46,17,1
18061,531,261,270,73,80,68,26,306,167,139,42,51,23,8,1
18062,196,105,91,22,26,21,8,575,293,282,78,64,40,13,1
18063,321,141,180,45,47,32,17,537,276,261,75,68,68,22,1
18064,433,221,212,59,42,47,14,673,329,344,111,95,92,41,1
18065,1087,523,564,146,177,103,33,289,112,177,63,60,18,11,1
18066,350,182,168,39,41,49,14,984,516,468,78,45,73,12,1
18067,770,390,380,104,76,78,32,376,183,193,50,50,43,21,1
18068,467,226,241,55,48,54,23,272,141,131,45,29,36,9,1
18069,346,186,160,50,33,27,12,376,187,189,55,48,36,17,1
18070,502,252,250,68,63,40,14,375,202,173,46,49,41,23,1
18071,653,327,326,91,79,55,39,593,280,313,92,89,60,42,1
18072,456,228,228,49,70,32,19,424,179,245,65,67,29,11,1
18073,430,218,212,58,47,34,20,430,198,232,57,46,37,19,1
18074,303,159,144,40,35,35,8,794,390,404,103,95,86,23,1
18075,366,211,155,35,42,24,12,390,175,215,53,61,26,22,1
18076,246,128,118,39,34,22,7,239,146,93,30,22,35,9,1
18077,562,265,297,79,56,72,45,402,222,180,50,39,51,19,1
18078,171,94,77,24,28,30,11,632,326,306,92,71,56,19,1
18079,706,346,360,118,92,98,56,413,194,219,77,72,28,11,1
18080,1342,673,669,178,154,137,94,645,268,377,104,73,55,30,1
18081,1474,808,666,160,146,166,60,817,425,392,120,102,83,26,1
18082,1163,417,746,209,145,87,28,726,312,414,121,73,82,23,1
18083,2133,789,1344,342,419,135,88,975,400,575,160,162,62,31,1
18084,2839,1321,1518,400,328,170,90,1225,593,632,158,125,102,38,1
18085,785,419,366,96,94,89,33,636,336,300,94,65,58,32,1
18086,1744,920,824,225,190,178,57,597,282,315,81,64,75,43,1
18087,219,97,122,30,29,23,9,239,146,93,30,22,35,9,1
18088,482,268,214,54,53,52,19,765,295,470,200,142,84,27,1
18089,351,184,167,59,45,54,9,1480,789,691,195,151,173,55,1
18090,316,157,159,45,38,22,19,439,205,234,64,88,41,21,1
18091,517,274,243,64,62,59,15,417,231,186,37,32,43,18,1
18092,425,204,221,71,56,45,13,297,123,174,51,49,16,10,1
18093,154,75,79,28,23,16,6,552,285,267,74,51,69,24,1
18094,800,416,384,102,105,83,22,1893,850,1043,280,340,169,80,1
18095,266,139,127,33,26,34,12,278,131,147,29,30,33,12,1
18096,376,183,193,50,50,43,21,131,66,65,21,14,23,7,1
18097,393,210,183,55,50,34,19,592,291,301,92,93,71,31,1
18098,357,167,190,55,59,43,14,160,53,107,31,29,13,3,1
18099,864,362,502,142,150,70,19,246,108,138,32,44,21,10,1
18100,876,457,419,88,124,67,47,216,119,97,33,27,28,7,1
18101,400,187,213,57,46,51,16,295,161,134,30,40,31,9,1
18102,201,111,90,25,29,26,13,452,256,196,32,44,27,11,1
18103,601,313,288,42,48,25,36,351,195,156,47,53,25,14,1
18104,1214,612,602,169,173,98,35,330,159,171,48,38,50,19,1
18105,1382,689,693,186,176,167,77,1290,629,661,191,187,167,55,1
18106,872,498,374,101,75,106,43,374,181,193,63,49,46,20,1
18107,479,227,252,65,79,42,26,326,166,160,49,45,36,12,1
18108,522,235,287,78,67,60,50,676,386,290,102,53,78,19,1
18109,349,186,163,43,45,51,12,826,362,464,107,118,71,43,1
18110,459,221,238,52,56,51,19,1009,506,503,146,141,97,55,1
18111,800,365,435,129,102,97,31,811,279,532,173,101,136,58,1
18112,497,227,270,70,63,66,30,503,263,240,72,55,51,34,1
18113,621,301,320,76,64,46,34,920,492,428,100,92,88,49,1
18114,327,177,150,40,40,38,18,280,121,159,60,45,22,12,1
18115,509,241,268,67,53,56,13,641,324,317,88,92,49,14,1
18116,303,187,116,41,23,23,9,267,147,120,40,24,25,8,1
18117,412,201,211,75,60,40,13,603,291,312,98,87,61,28,1
18118,193,99,94,31,31,16,12,2758,1332,1426,394,384,287,131,1
18119,529,264,265,63,59,60,35,601,313,288,42,48,25,36,1
18120,462,228,234,59,47,37,32,139,62,77,23,6,14,4,1
18121,870,489,381,97,99,76,14,674,319,355,84,139,50,11,1
18122,1201,557,644,151,125,117,50,625,298,327,90,78,57,33,1
18123,290,152,138,35,47,38,7,683,367,316,87,73,40,17,1
18124,160,68,92,28,20,14,6,473,217,256,59,44,34,21,1
18125,697,373,324,105,83,95,38,415,209,206,60,67,39,18,1
18126,656,358,298,67,47,64,26,549,273,276,74,68,72,24,1
18127,1835,904,931,192,144,135,63,1647,794,853,279,235,128,65,1
18128,263,159,104,30,27,31,11,277,151,126,35,30,24,15,1
18129,304,127,177,61,38,31,4,379,203,176,55,48,45,16,1
18130,1315,720,595,138,136,115,62,484,254,230,60,66,56,14,1
18131,145,75,70,22,18,10,5,392,156,236,40,91,28,16,1
18132,4303,2489,1814,436,369,444,134,1270,557,713,130,195,57,30,1
18133,144,62,82,29,8,19,17,663,360,303,88,82,80,35,1
18134,452,202,250,83,60,56,19,1273,592,681,199,164,139,39,1
18135,918,357,561,191,150,42,24,128,67,61,29,9,9,1,1
18136,205,99,106,24,29,20,5,395,222,173,48,42,21,8,1
18137,162,88,74,18,20,25,10,178,100,78,23,22,30,6,1
18138,202,86,116,33,29,26,10,355,165,190,53,56,42,19,1
18139,839,408,431,138,122,105,46,217,109,108,34,32,35,7,1
18140,294,148,146,35,33,25,14,205,104,101,28,28,35,13,1
18141,580,306,274,79,71,50,25,193,99,94,31,31,16,12,1
18142,350,180,170,64,46,55,12,306,128,178,49,59,17,9,1
18143,81,41,40,15,13,3,2,1014,490,524,177,137,94,38,1
18144,591,263,328,95,90,26,13,513,271,242,54,52,44,13,1
18145,482,231,251,76,81,64,26,770,374,396,95,91,79,41,1
18146,247,110,137,34,45,23,10,734,366,368,121,99,63,39,1
18147,423,222,201,60,51,51,11,423,218,205,64,55,54,15,1
18148,480,234,246,79,77,65,23,288,153,135,42,35,32,8,1
18149,724,320,404,120,147,67,25,505,268,237,68,59,34,15,1
18150,182,93,89,24,19,18,8,292,141,151,45,23,35,13,1
18151,452,262,190,61,45,54,19,323,156,167,52,45,39,18,1
18152,247,110,137,34,45,23,10,1253,639,614,181,155,164,73,1
18153,1328,661,667,210,147,126,55,817,425,392,120,102,83,26,1
18154,500,242,258,53,48,44,18,610,281,329,54,62,65,58,1
18155,536,278,258,72,63,62,20,202,86,116,33,29,26,10,1
18156,160,67,93,32,37,15,9,320,143,177,51,51,24,10,1
18157,855,422,433,109,97,109,50,836,416,420,106,80,85,40,1
18158,1914,892,1022,272,267,143,79,536,278,258,72,63,62,20,1
18159,412,195,217,79,48,36,29,303,141,162,42,57,37,20,1
18160,550,319,231,49,65,35,16,660,332,328,84,73,47,19,1
18161,834,405,429,112,95,84,34,825,399,426,125,99,73,42,1
18162,70,27,43,7,27,9,2,453,240,213,74,46,67,27,1
18163,467,226,241,55,48,54,23,1068,527,541,160,131,112,52,1
18164,304,143,161,39,39,43,14,199,101,98,22,25,9,12,1
18165,543,296,247,86,79,60,19,1231,494,737,194,214,84,34,1
18166,358,176,182,69,42,51,15,503,263,240,72,55,51,34,1
18167,123,61,62,17,18,17,7,110,67,43,9,10,11,8,1
18168,414,207,207,59,47,54,18,1086,603,483,147,121,95,40,1
18169,354,137,217,53,57,30,5,906,485,421,112,98,112,39,1
18170,1134,539,595,150,146,78,40,323,169,154,47,44,39,20,1
18171,368,175,193,72,43,39,15,465,257,208,51,61,54,23,1
18172,330,159,171,48,38,50,19,387,177,210,53,50,44,20,1
18173,450,227,223,53,36,48,12,134,60,74,19,13,10,7,1
18174,538,252,286,77,87,53,30,233,121,112,24,31,30,7,1
18175,298,167,131,47,33,40,8,1017,498,519,136,107,82,52,1
18176,270,147,123,34,17,39,21,450,233,217,68,45,45,17,1
18177,246,115,131,15,29,10,32,406,188,218,51,80,47,20,1
18178,595,316,279,86,60,65,40,252,146,106,38,23,21,9,1
18179,194,99,95,29,24,20,8,185,115,70,19,17,26,6,1
18180,325,149,176,51,49,24,11,100,51,49,13,11,7,4,1
18181,336,169,167,38,30,44,16,537,276,261,75,68,68,22,1
18182,776,346,430,103,102,61,40,502,240,262,78,61,54,32,1
18183,178,100,78,23,22,30,6,355,165,190,53,56,42,19,1
18184,94,45,49,11,20,10,4,1042,570,472,113,125,91,61,1
18185,815,418,397,97,62,70,17,1855,932,923,206,157,151,47,1
18186,860,457,403,118,103,103,36,674,358,316,91,92,97,29,1
18187,288,118,170,50,57,18,15,2181,1144,1037,284,248,272,103,1
18188,964,408,556,131,153,76,55,875,376,499,155,125,53,39,1
18189,25,6,19,17,0,1,3,215,115,100,27,28,34,16,1
18190,508,253,255,73,60,50,13,493,208,285,75,77,70,40,1
18191,435,221,214,72,45,47,19,223,132,91,18,16,27,17,1
18192,290,157,133,40,28,24,15,318,156,162,42,29,26,17,1
18193,548,250,298,85,64,56,21,760,405,355,112,95,92,29,1
18194,464,242,222,61,68,36,17,356,185,171,37,31,17,21,1
18195,2696,1169,1527,432,347,193,146,595,316,279,86,60,65,40,1
18196,293,142,151,49,40,42,17,765,295,470,200,142,84,27,1
18197,656,358,298,67,47,64,26,381,170,211,86,52,27,11,1
18198,1102,552,550,174,137,137,45,724,325,399,98,92,64,24,1
18199,608,299,309,81,75,76,27,307,157,150,44,41,33,15,1
18200,89,42,47,16,12,15,6,76,34,42,6,15,2,4,1
18201,189,90,99,26,29,17,11,1068,539,529,161,134,132,71,1
18202,160,77,83,14,27,11,10,441,218,223,69,55,50,27,1
18203,1009,506,503,146,141,97,55,509,262,247,64,70,64,20,1
18204,335,148,187,52,26,51,12,246,115,131,15,29,10,32,1
18205,806,365,441,134,118,78,44,136,66,70,33,11,9,5,1
18206,389,243,146,47,26,43,22,467,269,198,46,51,60,18,1
18207,510,264,246,67,66,38,29,393,186,207,58,50,36,22,1
18208,939,493,446,113,100,87,31,864,429,435,129,118,68,35,1
18209,303,146,157,40,28,28,41,153,81,72,22,18,16,8,1
18210,1464,693,771,153,136,91,86,427,191,236,67,60,41,34,1
18211,785,359,426,118,128,84,33,2758,1332,1426,394,384,287,131,1
18212,815,418,397,97,62,70,17,1684,707,977,256,196,178,72,1
18213,378,225,153,44,32,39,11,479,233,246,68,66,36,21,1
18214,1170,510,660,142,182,115,84,1466,991,475,136,129,59,39,1
18215,158,85,73,24,18,18,8,450,233,217,68,45,45,17,1
18216,1152,459,693,138,343,75,33,792,407,385,110,132,82,43,1
18217,1009,506,503,146,141,97,55,769,362,407,99,88,66,67,1
18218,2442,1193,1249,278,183,170,145,753,361,392,99,94,66,16,1
18219,956,405,551,170,171,64,35,136,66,70,33,11,9,5,1
18220,195,83,112,40,16,19,16,259,133,126,26,30,22,22,1
18221,325,181,144,46,31,48,9,424,209,215,56,58,45,24,1
18222,247,110,137,34,45,23,10,831,334,497,163,167,49,22,1
18223,707,295,412,105,105,66,30,410,208,202,59,58,43,26,1
18224,284,173,111,28,19,49,12,192,101,91,25,22,18,9,1
18225,245,112,133,32,45,20,10,622,294,328,104,93,42,17,1
18226,737,363,374,119,101,85,41,382,200,182,53,36,51,16,1
18227,140,76,64,17,13,13,8,686,375,311,89,80,63,20,1
18228,470,226,244,81,53,59,39,412,221,191,72,46,50,16,1
18229,1272,651,621,178,194,79,59,211,114,97,32,24,19,10,1
18230,706,320,386,111,76,75,51,360,192,168,55,45,48,16,1
18231,583,322,261,73,66,45,26,512,261,251,79,73,60,21,1
18232,150,79,71,19,29,19,6,210,102,108,33,33,20,9,1
18233,762,363,399,127,85,83,31,987,515,472,107,110,106,61,1
18234,375,173,202,50,46,43,25,165,80,85,21,9,18,19,1
18235,247,110,137,34,45,23,10,619,300,319,65,52,57,12,1
18236,246,128,118,39,34,22,7,254,168,86,30,12,45,7,1
18237,920,492,428,100,92,88,49,346,191,155,52,38,40,13,1
18238,339,170,169,32,17,24,13,207,93,114,20,33,19,10,1
18239,1190,638,552,162,95,112,18,448,209,239,36,53,46,52,1
18240,673,329,344,111,95,92,41,400,195,205,63,67,40,18,1
18241,519,246,273,78,82,42,16,729,430,299,78,57,101,33,1
18242,394,202,192,44,43,38,28,475,261,214,67,67,55,18,1
18243,631,309,322,106,83,89,33,406,195,211,71,58,53,14,1
18244,309,163,146,46,22,28,14,1129,589,540,134,122,108,46,1
18245,2024,765,1259,283,343,137,76,2017,1041,976,289,217,154,92,1
18246,824,365,459,121,123,88,50,205,99,106,24,29,20,5,1
18247,292,152,140,46,38,35,12,467,269,198,46,51,60,18,1
18248,603,348,255,82,70,87,16,660,359,301,81,87,102,31,1
18249,637,335,302,83,77,85,26,245,111,134,31,44,20,11,1
18250,494,234,260,88,81,61,29,757,373,384,115,93,95,25,1
18251,519,219,300,86,72,50,39,440,246,194,62,49,41,16,1
18252,399,208,191,57,46,41,20,2639,1436,1203,317,307,242,77,1
18253,437,190,247,82,66,39,20,586,273,313,100,79,40,19,1
18254,346,183,163,51,38,23,6,596,286,310,90,89,78,37,1
18255,502,299,203,57,52,32,11,536,278,258,72,63,62,20,1
18256,1349,691,658,188,150,151,50,557,278,279,75,70,66,31,1
18257,154,66,88,31,17,14,9,372,201,171,52,50,42,13,1
18258,314,154,160,43,39,24,20,211,137,74,16,9,22,21,1
18259,1194,609,585,195,142,105,37,410,211,199,55,42,34,27,1
18260,2871,1218,1653,290,374,238,414,417,182,235,57,109,50,8,1
18261,484,192,292,118,68,83,22,344,109,235,100,39,26,5,1
18262,730,298,432,128,69,86,26,928,442,486,139,118,91,43,1
18263,4599,2000,2599,590,655,515,413,402,222,180,50,39,51,19,1
18264,229,105,124,36,33,12,4,361,155,206,43,61,29,18,1
18265,460,223,237,61,65,45,22,712,396,316,78,69,65,25,1
18266,906,437,469,135,132,49,40,467,269,198,46,51,60,18,1
18267,613,290,323,95,104,27,10,341,178,163,48,44,42,20,1
18268,148,78,70,21,11,14,11,724,650,74,44,3,32,3,1
18269,520,274,246,55,70,57,16,200,107,93,31,18,18,6,1
18270,266,124,142,44,21,28,26,1613,806,807,190,211,180,84,1
18271,737,363,374,119,101,85,41,298,184,114,45,22,45,12,1
18272,189,90,99,26,29,17,11,393,210,183,55,50,34,19,1
18273,523,249,274,92,64,58,21,503,263,240,72,55,51,34,1
18274,331,145,186,40,56,16,9,219,110,109,32,23,24,7,1
18275,785,412,373,114,84,95,38,402,227,175,48,40,35,11,1
18276,2045,985,1060,359,339,199,74,510,264,246,67,66,38,29,1
18277,431,233,198,54,40,42,12,134,60,74,19,13,10,7,1
18278,247,110,137,34,45,23,10,255,142,113,40,32,27,6,1
18279,966,530,436,128,119,134,29,2157,1171,986,306,238,131,32,1
18280,410,186,224,72,57,52,22,451,239,212,53,64,56,22,1
18281,380,212,168,47,38,19,11,612,330,282,71,54,63,37,1
18282,697,373,324,105,83,95,38,1531,691,840,270,226,143,52,1
18283,979,534,445,83,77,80,24,441,211,230,67,45,53,14,1
18284,646,316,330,89,95,48,17,1311,690,621,158,161,128,51,1
18285,168,120,48,7,5,20,7,808,357,451,116,98,56,36,1
18286,444,259,185,45,33,65,25,732,385,347,95,69,93,34,1
18287,333,192,141,50,48,28,10,420,233,187,50,41,39,17,1
18288,1265,580,685,205,188,166,53,86,52,34,9,8,8,3,1
18289,663,360,303,88,82,80,35,590,303,287,69,65,46,17,1
18290,246,108,138,32,44,21,10,822,374,448,134,118,76,39,1
18291,346,180,166,55,49,38,6,780,409,371,125,80,60,34,1
18292,920,492,428,100,92,88,49,1454,780,674,182,120,135,67,1
18293,770,390,380,104,76,78,32,681,286,395,109,61,69,42,1
18294,186,99,87,30,17,18,8,371,237,134,31,25,43,17,1
18295,472,259,213,51,44,56,21,825,363,462,97,105,72,75,1
18296,595,316,279,86,60,65,40,726,312,414,121,73,82,23,1
18297,158,85,73,24,18,18,8,331,169,162,40,28,22,14,1
18298,509,243,266,80,57,45,19,1124,615,509,157,125,128,52,1
18299,4544,2024,2520,579,628,480,403,255,130,125,44,18,22,12,1
18300,838,385,453,110,137,78,28,3144,1617,1527,367,342,278,136,1
18301,203,93,110,36,26,18,9,748,355,393,121,91,95,26,1
18302,377,171,206,46,59,22,6,1214,612,602,169,173,98,35,1
18303,2220,1085,1135,312,304,202,91,695,340,355,79,124,53,13,1
18304,576,250,326,93,71,34,15,505,271,234,56,57,57,26,1
18305,262,151,111,30,17,32,25,632,320,312,74,75,47,14,1
18306,645,297,348,89,105,74,24,577,288,289,85,56,40,20,1
18307,1117,423,694,182,134,88,31,368,141,227,64,61,24,13,1
18308,2315,1086,1229,231,306,248,64,143,65,78,32,11,11,11,1
18309,411,209,202,69,43,18,15,482,231,251,76,81,64,26,1
18310,425,210,215,56,43,52,25,592,264,328,86,85,62,41,1
18311,413,169,244,66,94,28,19,212,94,118,36,33,23,8,1
18312,1647,794,853,279,235,128,65,595,316,279,86,60,65,40,1
18313,155,79,76,26,13,15,6,391,243,148,32,24,40,29,1
18314,940,464,476,116,135,108,58,514,178,336,126,103,31,20,1
18315,247,110,137,34,45,23,10,802,344,458,156,136,57,24,1
18316,211,138,73,14,11,22,17,220,142,78,15,12,17,15,1
18317,462,228,234,59,47,37,32,432,190,242,85,82,28,11,1
18318,609,292,317,102,96,64,21,529,264,265,59,68,41,17,1
18319,392,203,189,44,42,33,22,418,215,203,60,69,35,14,1
18320,502,240,262,78,61,54,32,535,249,286,79,64,55,22,1
18321,299,151,148,35,34,26,16,911,445,466,154,121,108,48,1
18322,247,110,137,34,45,23,10,609,279,330,103,98,72,42,1
18323,303,175,128,43,36,34,12,904,436,468,138,146,82,39,1
18324,301,119,182,53,47,14,20,439,205,234,64,88,41,21,1
18325,180,96,84,21,22,17,15,425,210,215,56,43,52,25,1
18326,205,100,105,25,25,20,9,504,352,152,42,44,43,23,1
18327,317,153,164,39,30,35,13,401,167,234,56,71,16,10,1
18328,1092,534,558,176,151,94,39,930,367,563,181,153,83,48,1
18329,284,104,180,54,81,8,10,689,343,346,119,100,86,38,1
18330,297,158,139,47,37,37,9,1820,673,1147,312,325,115,50,1
18331,166,96,70,21,16,21,8,536,237,299,116,87,42,17,1
18332,747,333,414,102,64,63,46,894,417,477,114,123,89,38,1
18333,187,92,95,13,51,14,11,513,246,267,71,66,60,35,1
18334,593,325,268,84,66,73,24,499,252,247,75,71,65,25,1
18335,391,201,190,52,47,35,24,649,349,299,90,77,62,26,1
18336,332,172,160,50,33,35,9,772,382,390,107,74,83,34,1
18337,2524,1232,1292,398,317,186,61,614,292,322,74,48,57,33,1
18338,461,287,174,56,27,82,25,352,169,183,57,36,47,31,1
18339,873,366,507,127,125,75,21,2045,985,1060,359,339,199,74,1
18340,293,147,146,39,22,30,20,418,213,205,54,56,49,13,1
18341,1270,557,713,130,195,57,30,854,399,455,127,118,57,39,1
18342,2414,1189,1225,277,178,170,169,529,274,255,57,62,38,14,1
18343,653,326,327,83,96,83,27,1801,889,912,206,263,126,42,1
18344,171,94,77,24,28,30,11,475,251,224,67,49,48,23,1
18345,135,65,70,26,20,11,3,145,70,75,24,16,16,20,1
18346,647,376,271,73,64,41,23,406,217,189,59,49,56,14,1
18347,509,254,255,67,55,52,35,2442,1193,1249,278,183,170,145,1
18348,419,207,212,78,40,46,23,433,237,196,60,52,33,27,1
18349,794,390,404,103,95,86,23,309,154,155,42,44,45,16,1
18350,583,322,261,73,66,45,26,976,520,456,120,115,109,53,1
18351,461,207,254,82,66,55,33,141,68,73,25,20,12,6,1
18352,624,308,316,92,72,68,22,341,174,167,44,34,46,15,1
18353,1133,491,642,192,170,61,29,703,356,347,96,97,38,22,1
18354,205,113,92,21,17,23,10,113,66,47,11,9,6,5,1
18355,273,126,147,54,49,25,18,291,120,171,63,39,26,6,1
18356,1473,758,715,205,171,161,65,195,109,86,25,24,17,6,1
18357,838,431,407,107,90,107,43,257,118,139,44,28,23,11,1
18358,168,120,48,7,5,20,7,405,195,210,57,74,24,17,1
18359,202,102,100,29,35,6,9,319,122,197,62,46,32,10,1
18360,372,189,183,60,44,41,18,551,298,253,63,65,45,19,1
18361,33423,16370,17053,4965,4756,2786,883,2639,1436,1203,317,307,242,77,1
18362,246,108,138,32,44,21,10,641,324,317,88,92,49,14,1
18363,181,64,117,46,41,5,4,1106,579,527,121,152,113,45,1
18364,538,252,286,77,87,53,30,551,237,314,95,79,54,17,1
18365,142,80,62,24,12,21,4,391,165,226,56,104,38,12,1
18366,1123,554,569,142,130,85,36,1189,653,536,152,118,109,56,1
18367,911,423,488,140,150,102,32,402,222,180,50,39,51,19,1
18368,109,57,52,19,7,8,8,415,250,165,43,28,50,21,1
18369,406,219,187,44,39,52,20,234,114,120,34,28,25,9,1
18370,522,239,283,75,88,45,11,1106,579,527,121,152,113,45,1
18371,537,276,261,75,68,68,22,906,455,451,116,105,87,46,1
18372,210,115,95,31,22,27,10,467,226,241,55,48,54,23,1
18373,963,455,508,127,130,115,48,928,442,486,139,118,91,43,1
18374,446,265,181,51,35,27,17,482,231,251,76,81,64,26,1
18375,540,265,275,87,59,74,25,1210,592,618,157,138,116,85,1
18376,552,285,267,74,51,69,24,268,143,125,39,34,30,17,1
18377,688,323,365,121,69,55,22,245,112,133,32,45,20,10,1
18378,465,245,220,71,45,76,25,391,208,183,65,49,57,17,1
18379,933,493,440,140,108,124,32,695,340,355,79,124,53,13,1
18380,613,334,279,90,71,51,17,1290,597,693,182,182,119,63,1
18381,551,298,253,63,65,45,19,215,80,135,54,56,21,9,1
18382,117,60,57,24,19,21,2,380,227,153,36,30,48,25,1
18383,790,352,438,132,87,91,60,213,88,125,30,20,12,19,1
18384,650,304,346,80,106,62,28,538,252,286,77,87,53,30,1
18385,390,191,199,66,49,43,12,526,266,260,76,75,53,22,1
18386,1283,595,688,170,184,67,34,216,102,114,31,29,21,6,1
18387,211,108,103,34,25,26,12,467,226,241,55,48,54,23,1
18388,202,113,89,16,27,21,11,956,405,551,170,171,64,35,1
18389,2718,1148,1570,384,286,195,88,244,135,109,36,24,20,10,1
18390,336,154,182,51,48,39,22,497,227,270,70,63,66,30,1
18391,247,110,137,34,45,23,10,1118,471,647,204,164,102,34,1
18392,392,218,174,43,42,32,27,371,237,134,31,25,43,17,1
18393,218,121,97,29,26,21,6,239,146,93,30,22,35,9,1
18394,589,281,308,69,39,63,20,676,333,343,111,89,94,39,1
18395,653,389,264,69,59,51,19,548,250,298,85,64,56,21,1
18396,288,159,129,27,44,27,15,168,120,48,7,5,20,7,1
18397,700,305,395,111,99,54,18,295,143,152,38,47,22,25,1
18398,1435,638,797,194,144,74,48,930,367,563,181,153,83,48,1
18399,605,298,307,94,66,46,31,710,307,403,117,176,37,9,1
18400,778,385,393,94,83,70,31,383,204,179,59,45,29,15,1
18401,415,209,206,60,67,39,18,563,304,259,75,64,68,31,1
18402,2033,877,1156,359,333,106,44,338,202,136,39,9,31,15,1
18403,623,269,354,100,86,62,24,202,102,100,29,35,6,9,1
18404,972,519,453,109,98,120,39,537,276,261,75,68,68,22,1
18405,412,201,211,75,60,40,13,113,54,59,10,12,13,7,1
18406,226,129,97,20,25,26,11,624,308,316,92,72,68,22,1
18407,4391,2256,2135,494,411,423,231,349,166,183,49,37,25,52,1
18408,512,261,251,79,73,60,21,911,551,360,92,106,107,29,1
18409,187,75,112,41,32,17,11,351,143,208,44,68,23,18,1
18410,246,108,138,32,44,21,10,2752,959,1793,638,192,79,46,1
18411,178,100,78,23,22,30,6,193,99,94,31,31,16,12,1
18412,552,285,267,74,51,69,24,684,288,396,107,90,54,42,1
18413,499,290,209,59,50,50,19,163,70,93,28,21,17,6,1
18414,302,138,164,50,36,30,20,452,230,222,64,61,31,27,1
18415,447,222,225,71,54,44,25,257,148,109,28,20,21,14,1
18416,330,157,173,56,42,51,8,833,452,381,117,85,71,39,1
18417,350,224,126,34,14,48,18,200,97,103,33,26,21,9,1
18418,500,242,258,53,48,44,18,830,402,428,80,67,100,80,1
18419,158,85,73,24,18,18,8,95,41,54,15,16,8,5,1
18420,509,254,255,67,55,52,35,183,91,92,21,29,16,10,1
18421,345,165,180,45,43,39,17,1089,544,545,138,160,117,43,1
18422,725,328,397,83,85,54,25,173,110,63,35,6,9,8,1
18423,501,285,216,52,55,62,25,412,216,196,24,48,18,16,1
18424,1730,801,929,328,213,219,64,1134,574,560,157,164,47,48,1
18425,1074,538,536,190,131,157,35,191,98,93,26,18,19,9,1
18426,89,42,47,16,12,15,6,274,145,129,40,17,20,12,1
18427,1738,821,917,242,196,181,58,901,458,443,91,129,86,21,1
18428,138,79,59,16,13,11,7,2035,1087,948,163,129,96,73,1
18429,1798,844,954,277,212,142,53,540,306,234,74,52,43,22,1
18430,700,335,365,83,84,95,33,148,75,73,25,13,9,4,1
18431,1861,896,965,265,187,156,70,767,392,375,113,112,83,13,1
18432,73,29,44,15,16,3,4,340,162,178,40,39,35,22,1
18433,1273,592,681,199,164,139,39,991,537,454,134,99,80,34,1
18434,128,54,74,30,13,8,7,443,248,195,67,54,40,15,1
18435,533,297,236,74,57,39,28,2948,1454,1494,327,456,140,81,1
18436,1188,476,712,179,163,93,57,673,329,344,111,95,92,41,1
18437,202,113,89,16,27,21,11,1893,850,1043,280,340,169,80,1
18438,309,154,155,42,44,45,16,2225,1244,981,271,243,217,93,1
18439,372,179,193,50,52,33,6,675,305,370,114,109,60,21,1
18440,826,362,464,107,118,71,43,1441,657,784,140,135,81,73,1
18441,921,462,459,140,126,83,55,660,326,334,106,61,71,32,1
18442,95,41,54,15,16,8,5,1290,597,693,182,182,119,63,1
18443,166,81,85,30,27,13,8,249,138,111,32,29,21,8,1
18444,1255,666,589,145,142,120,82,1255,708,547,120,68,88,7,1
18445,870,418,452,121,102,109,28,640,339,301,70,64,90,41,1
18446,445,209,236,63,50,42,28,335,185,150,46,34,36,13,1
18447,189,91,98,24,26,23,10,515,253,262,46,83,57,21,1
18448,784,373,411,101,90,91,37,811,400,411,107,87,116,43,1
18449,437,235,202,72,61,39,17,483,215,268,66,70,30,16,1
18450,2564,1278,1286,414,406,207,64,1015,526,489,133,133,86,34,1
18451,848,394,454,100,90,101,41,913,408,505,141,125,87,36,1
18452,163,82,81,15,32,24,7,182,90,92,25,23,14,5,1
18453,462,251,211,74,53,41,18,275,125,150,37,48,27,7,1
18454,298,154,144,44,34,25,11,98,53,45,23,12,23,3,1
18455,2556,1169,1387,248,291,227,275,609,335,274,79,57,45,22,1
18456,410,211,199,55,42,34,27,808,419,389,109,87,86,32,1
18457,595,316,279,86,60,65,40,316,157,159,45,38,22,19,1
18458,206,96,110,33,25,8,6,1174,594,580,175,155,126,66,1
18459,754,318,436,114,106,58,28,732,355,377,108,109,79,27,1
18460,614,263,351,85,84,54,35,920,492,428,100,92,88,49,1
18461,724,325,399,98,92,64,24,1265,580,685,205,188,166,53,1
18462,1179,579,600,140,133,122,53,496,251,245,66,57,39,22,1
18463,337,146,191,55,21,34,22,488,217,271,71,71,50,32,1
18464,611,314,297,79,75,78,22,643,373,270,91,43,113,21,1
18465,475,235,240,77,58,43,22,239,121,118,28,38,15,7,1
18466,241,115,126,44,21,29,10,796,445,351,96,80,90,38,1
18467,969,505,464,123,133,92,33,605,283,322,94,72,64,39,1
18468,346,191,155,52,38,40,13,760,405,355,112,95,92,29,1
18469,2414,1189,1225,277,178,170,169,380,185,195,68,54,32,16,1
18470,1620,884,736,194,161,162,80,2315,1086,1229,231,306,248,64,1
18471,1454,780,674,182,120,135,67,892,420,472,135,146,98,37,1
18472,624,275,349,93,99,74,22,177,67,110,34,24,13,10,1
18473,193,102,91,23,25,20,10,478,260,218,51,60,66,18,1
18474,251,131,120,49,35,25,5,406,212,194,50,52,24,18,1
18475,201,42,159,19,3,2,75,309,149,160,55,33,27,15,1
18476,1258,531,727,218,216,108,35,1972,846,1126,222,330,114,68,1
18477,834,390,444,133,114,109,34,526,264,262,77,71,61,27,1
18478,416,210,206,55,54,39,20,239,110,129,32,32,24,10,1
18479,98,45,53,16,11,15,3,339,177,162,40,36,51,24,1
18480,324,219,105,25,24,27,14,309,205,104,28,23,39,16,1
18481,508,270,238,74,54,57,17,680,351,329,93,97,87,27,1
18482,1566,743,823,261,188,151,48,451,267,184,43,39,50,7,1
18483,201,93,108,34,39,21,6,192,101,91,25,22,18,9,1
18484,5890,3314,2576,970,956,293,265,92,40,52,14,23,13,7,1
18485,730,328,402,126,99,48,23,377,202,175,46,50,41,22,1
18486,624,308,316,92,72,68,22,1210,592,618,157,138,116,85,1
18487,1172,521,651,132,180,129,80,660,359,301,81,87,102,31,1
18488,233,94,139,36,37,15,8,745,366,379,110,93,79,45,1
18489,758,360,398,114,107,51,19,431,235,196,57,53,50,18,1
18490,355,168,187,48,57,30,15,3144,1617,1527,367,342,278,136,1
18491,247,132,115,24,22,24,13,297,160,137,46,38,41,10,1
18492,113,54,59,10,12,13,7,1038,470,568,130,123,86,51,1
18493,619,292,327,73,73,61,32,149,68,81,15,38,11,10,1
18494,790,385,405,121,108,106,39,577,288,289,85,56,40,20,1
18495,755,348,407,109,98,49,23,512,248,264,66,71,49,30,1
18496,596,288,308,77,51,58,30,737,363,374,119,101,85,41,1
18497,301,201,100,31,14,34,12,821,387,434,121,131,76,29,1
18498,468,233,235,65,61,49,34,463,236,227,64,50,44,29,1
18499,1382,689,693,186,176,167,77,583,322,261,73,66,45,26,1
18500,622,299,323,86,86,69,35,402,222,180,50,39,51,19,1
18501,953,481,472,133,130,77,48,737,363,374,119,101,85,41,1
18502,85,44,41,9,6,10,9,721,379,342,89,73,68,25,1
18503,236,118,118,26,20,18,7,2414,1189,1225,277,178,170,169,1
18504,354,168,186,50,53,39,20,209,96,113,35,28,22,13,1
18505,454,223,231,38,45,24,19,1308,652,656,166,153,149,87,1
18506,767,392,375,113,112,83,13,471,246,225,46,38,52,30,1
18507,696,372,324,101,81,60,11,151,84,67,17,17,22,11,1
18508,145,84,61,16,15,14,4,4655,2074,2581,545,652,562,399,1
18509,149,68,81,15,38,11,10,912,497,415,126,83,106,48,1
18510,587,309,278,67,73,56,34,419,208,211,68,60,35,22,1
18511,175,86,89,33,25,27,2,466,260,206,62,44,56,19,1
18512,585,289,296,102,86,61,18,1217,647,570,142,160,129,45,1
18513,205,96,109,32,25,31,5,173,82,91,27,25,28,4,1
18514,736,337,399,97,95,53,32,757,373,384,115,93,95,25,1
18515,208,100,108,27,29,18,9,890,390,500,129,115,66,33,1
18516,259,132,127,39,32,28,12,467,226,241,55,48,54,23,1
18517,1009,506,503,146,141,97,55,1047,562,485,141,127,114,41,1
18518,114,71,43,8,18,7,4,227,127,100,32,24,31,5,1
18519,749,360,389,91,122,59,37,770,355,415,103,142,75,42,1
18520,105,50,55,14,13,11,7,375,202,173,46,49,41,23,1
18521,661,306,355,118,85,65,24,293,142,151,49,40,42,17,1
18522,377,184,193,56,53,44,14,1333,646,687,209,179,148,45,1
18523,193,96,97,32,31,16,11,1272,651,621,178,194,79,59,1
18524,125,52,73,23,23,6,4,437,225,212,61,57,66,12,1
18525,148,69,79,26,18,16,3,375,173,202,50,46,43,25,1
18526,340,169,171,40,39,36,22,503,263,240,72,55,51,34,1
18527,403,221,182,47,41,47,8,631,332,299,61,104,60,19,1
18528,440,218,222,58,66,40,24,503,263,240,72,55,51,34,1
18529,1508,733,775,216,186,172,60,126,66,60,24,10,7,9,1
18530,552,264,288,82,64,48,20,211,114,97,32,24,19,10,1
18531,480,234,246,79,77,65,23,712,396,316,78,69,65,25,1
18532,283,142,141,35,29,32,5,448,236,212,53,64,56,24,1
18533,371,197,174,36,41,38,18,237,118,119,38,30,39,11,1
18534,187,96,91,30,24,24,4,135,61,74,23,22,14,5,1
18535,211,114,97,32,24,19,10,1275,579,696,200,172,125,51,1
18536,737,363,374,119,101,85,41,482,262,220,72,60,52,15,1
18537,2413,1178,1235,229,243,289,146,248,144,104,24,30,21,15,1
18538,673,313,360,101,101,46,17,424,179,245,65,67,29,11,1
18539,187,97,90,28,25,21,8,291,131,160,40,42,36,14,1
18540,325,184,141,43,34,22,18,289,139,150,38,44,23,20,1
18541,356,199,157,43,58,29,12,133,55,78,22,22,13,9,1
18542,985,466,519,153,122,73,26,1193,492,701,152,190,66,53,1
18543,451,239,212,53,64,56,22,454,191,263,61,66,38,15,1
18544,330,157,173,56,42,51,8,346,187,159,42,34,43,21,1
18545,552,264,288,82,64,48,20,1584,831,753,197,161,142,83,1
18546,374,181,193,55,58,48,23,622,299,323,86,86,69,35,1
18547,164,78,86,28,23,12,8,391,208,183,65,49,57,17,1
18548,406,211,195,55,37,47,16,461,221,240,70,64,56,32,1
18549,834,405,429,112,95,84,34,870,489,381,97,99,76,14,1
18550,292,154,138,46,29,41,7,719,301,418,122,132,42,26,1
18551,66,39,27,9,8,7,3,1023,561,462,117,125,96,48,1
18552,173,97,76,21,18,24,6,601,313,288,42,48,25,36,1
18553,424,209,215,56,58,45,24,928,442,486,139,118,91,43,1
18554,565,285,280,72,73,47,31,499,252,247,74,42,55,14,1
18555,551,298,253,63,65,45,19,1147,471,676,229,164,86,37,1
18556,345,141,204,64,58,13,11,239,146,93,30,22,35,9,1
18557,639,373,266,77,89,68,25,648,307,341,101,58,76,34,1
18558,1816,865,951,246,230,189,76,131,66,65,21,14,23,7,1
18559,136,65,71,33,11,9,6,111,29,82,10,54,0,1,1
18560,1043,532,511,164,110,114,38,375,202,173,46,49,41,23,1
18561,393,186,207,58,50,36,22,89,47,42,11,5,6,9,1
18562,672,334,338,110,93,91,41,278,164,114,25,28,41,26,1
18563,671,295,376,126,93,61,28,220,102,118,26,32,27,10,1
18564,1321,653,668,186,195,70,35,185,84,101,21,23,18,12,1
18565,1970,978,992,245,206,198,80,621,284,337,108,68,50,17,1
18566,729,358,371,116,99,89,33,501,240,261,80,62,49,42,1
18567,221,110,111,28,32,25,11,288,118,170,50,57,18,15,1
18568,2414,1189,1225,277,178,170,169,127,49,78,27,20,6,5,1
18569,1242,613,629,174,113,114,53,556,279,277,83,69,71,19,1
18570,1244,674,570,145,141,131,42,1009,506,503,146,141,97,55,1
18571,453,255,198,62,49,29,19,1919,871,1048,315,265,148,61,1
18572,421,192,229,72,54,51,48,572,309,263,64,55,47,29,1
18573,239,146,93,30,22,35,9,598,322,276,67,57,63,26,1
18574,951,506,445,107,118,79,40,118,45,73,24,20,7,4,1
18575,524,264,260,75,75,40,21,776,346,430,103,102,61,40,1
18576,282,152,130,35,27,13,21,91,50,41,12,5,10,7,1
18577,194,94,100,35,19,25,16,923,471,452,119,117,119,41,1
18578,1529,698,831,198,167,141,122,1651,798,853,203,199,137,50,1
18579,525,274,251,82,74,60,25,392,190,202,68,40,19,14,1
18580,2357,1262,1095,242,240,220,62,765,407,358,89,75,90,42,1
18581,379,203,176,55,48,45,16,605,295,310,74,66,70,36,1
18582,450,242,208,53,63,56,22,605,295,310,74,66,70,36,1
18583,464,242,222,61,68,36,17,480,320,160,64,49,22,18,1
18584,180,91,89,22,28,16,10,140,72,68,18,16,18,12,1
18585,330,143,187,63,29,52,20,415,223,192,47,45,58,17,1
18586,956,405,551,170,171,64,35,559,274,285,75,63,52,16,1
18587,460,228,232,70,46,46,17,227,109,118,42,35,29,8,1
18588,405,205,200,59,55,39,9,520,300,220,66,36,57,23,1
18589,268,157,111,26,30,28,13,776,346,430,103,102,61,40,1
18590,894,469,425,127,93,82,31,1204,623,581,144,146,119,83,1
18591,562,281,281,80,61,67,23,181,96,85,25,23,20,7,1
18592,676,386,290,102,53,78,19,3911,1465,2446,610,767,240,133,1
18593,724,320,404,120,147,67,25,393,186,207,58,50,36,22,1
18594,1095,530,565,157,151,98,34,834,405,429,112,95,84,34,1
18595,462,251,211,74,53,41,18,525,299,226,54,54,51,19,1
18596,690,327,363,115,91,54,31,220,102,118,26,32,27,10,1
18597,1074,538,536,154,140,111,51,976,520,456,120,115,109,53,1
18598,290,127,163,47,58,23,12,167,86,81,21,21,11,11,1
18599,1865,943,922,270,209,228,91,858,461,397,125,114,79,45,1
18600,714,364,350,98,102,91,27,268,157,111,26,30,28,13,1
18601,150,60,90,27,16,6,3,1093,567,526,122,75,71,46,1
18602,142,76,66,21,21,22,11,415,219,196,53,55,57,20,1
18603,462,251,211,74,53,41,18,493,208,285,75,77,70,40,1
18604,623,233,390,145,83,43,20,201,42,159,19,3,2,75,1
18605,290,154,136,34,40,22,14,395,222,173,48,42,21,8,1
18606,546,265,281,101,64,38,16,161,73,88,23,22,15,8,1
18607,1312,484,828,258,239,86,51,708,303,405,115,115,70,23,1
18608,399,222,177,48,44,52,23,1744,920,824,225,190,178,57,1
18609,826,362,464,107,118,71,43,1290,658,632,145,139,94,44,1
18610,95,47,48,13,12,10,4,397,186,211,73,63,36,25,1
18611,175,88,87,29,29,23,6,467,224,243,70,43,67,23,1
18612,89,42,47,16,12,15,6,218,108,110,28,28,22,10,1
18613,479,239,240,54,75,46,18,406,205,201,54,58,34,21,1
18614,522,251,271,87,68,60,21,503,263,240,72,55,51,34,1
18615,270,136,134,38,31,31,4,882,432,450,115,111,68,44,1
18616,4588,2261,2327,516,642,497,118,361,172,189,51,54,25,4,1
18617,435,208,227,68,64,53,23,781,418,363,92,90,64,41,1
18618,832,428,404,131,89,88,38,90,41,49,26,14,0,1,1
18619,851,417,434,109,116,83,28,2442,1193,1249,278,183,170,145,1
18620,673,317,356,101,85,76,49,1215,652,563,129,142,121,62,1
18621,159,84,75,13,28,10,8,433,237,196,60,52,33,27,1
18622,205,100,105,25,25,20,9,648,341,307,78,89,77,21,1
18623,340,169,171,49,42,31,14,363,178,185,54,48,21,13,1
18624,420,190,230,79,61,64,15,393,186,207,58,50,36,22,1
18625,245,137,108,34,30,19,10,222,110,112,43,30,14,6,1
18626,607,311,296,73,81,33,33,189,93,96,24,28,17,12,1
18627,1051,523,528,164,140,126,50,346,180,166,55,49,38,6,1
18628,499,249,250,79,63,61,22,300,140,160,39,35,14,12,1
18629,906,437,469,135,132,49,40,906,474,432,90,125,74,24,1
18630,412,203,209,65,47,37,18,770,374,396,95,91,79,41,1
18631,711,344,367,87,109,74,24,4544,2024,2520,579,628,480,403,1
18632,911,423,488,140,150,102,32,489,242,247,83,63,62,19,1
18633,534,266,268,86,62,37,14,80,42,38,12,7,7,4,1
18634,846,425,421,126,97,98,38,1271,599,672,194,175,118,47,1
18635,247,110,137,34,45,23,10,439,158,281,92,116,31,14,1
18636,846,367,479,134,108,72,31,1137,543,594,179,140,113,38,1
18637,1464,693,771,153,136,91,86,505,247,258,72,71,60,27,1
18638,1484,731,753,206,175,187,71,423,218,205,64,55,54,15,1
18639,231,126,105,37,26,29,6,410,186,224,72,57,52,22,1
18640,987,515,472,107,110,106,61,610,328,282,78,65,57,33,1
18641,798,385,413,120,115,79,30,785,419,366,96,94,89,33,1
18642,180,103,77,22,19,29,8,503,263,240,72,55,51,34,1
18643,576,250,326,93,71,34,15,963,468,495,155,164,92,40,1
18644,351,184,167,59,45,54,9,737,374,363,100,95,103,29,1
18645,173,110,63,35,6,9,8,570,238,332,112,95,39,23,1
18646,1174,594,580,175,155,126,66,142,60,82,20,28,13,5,1
18647,268,124,144,36,34,12,4,776,356,420,122,103,85,30,1
18648,180,77,103,30,29,23,5,476,251,225,57,67,57,18,1
18649,453,242,211,59,47,49,11,315,156,159,51,28,47,13,1
18650,916,484,432,88,121,78,33,906,474,432,90,125,74,24,1
18651,159,84,75,13,28,10,8,441,218,223,69,55,50,27,1
18652,456,209,247,72,58,40,9,833,452,381,117,85,71,39,1
18653,555,278,277,60,70,48,18,303,159,144,40,35,35,8,1
18654,1657,800,857,249,235,154,51,577,288,289,85,56,40,20,1
18655,796,445,351,96,80,90,38,217,109,108,34,32,35,7,1
18656,778,367,411,90,85,64,43,246,113,133,33,45,22,10,1
18657,501,216,285,79,70,54,30,413,169,244,66,94,28,19,1
18658,168,67,101,37,17,13,13,357,214,143,30,32,27,13,1
18659,758,360,398,114,107,51,19,412,244,168,47,42,56,15,1
18660,1068,559,509,158,132,122,57,306,156,150,47,37,21,3,1
18661,233,106,127,34,48,21,7,528,268,260,81,77,36,22,1
18662,964,408,556,131,153,76,55,342,160,182,69,40,37,16,1
18663,749,354,395,77,74,76,35,501,240,261,80,62,49,42,1
18664,136,65,71,33,11,9,6,1893,850,1043,280,340,169,80,1
18665,928,442,486,139,118,91,43,451,222,229,72,46,57,17,1
18666,406,211,195,55,37,47,16,638,300,338,83,53,81,49,1
18667,3703,1708,1995,456,428,305,162,1382,599,783,208,252,90,39,1
18668,652,272,380,116,113,55,27,126,57,69,31,10,10,3,1
18669,462,224,238,77,75,37,13,205,114,91,25,24,20,15,1
18670,328,184,144,47,24,23,9,425,210,215,56,43,52,25,1
18671,920,289,631,237,141,98,11,254,117,137,33,35,38,6,1
18672,457,228,229,64,36,52,21,249,114,135,47,33,25,4,1
18673,746,361,385,91,92,101,32,115,62,53,17,12,8,7,1
18674,1304,679,625,153,158,131,35,3957,1683,2274,560,659,267,109,1
18675,225,116,109,29,19,25,6,1210,592,618,157,138,116,85,1
18676,1982,710,1272,353,319,146,76,335,128,207,59,43,24,23,1
18677,575,317,258,48,62,49,55,101,57,44,14,8,6,6,1
18678,467,226,241,55,48,54,23,2799,1324,1475,369,371,215,124,1
18679,407,218,189,34,41,23,17,631,336,295,64,65,70,12,1
18680,544,295,249,84,56,49,14,778,367,411,90,85,64,43,1
18681,1575,744,831,228,240,141,42,211,114,97,32,24,19,10,1
18682,1590,726,864,270,237,126,59,595,316,279,86,60,65,40,1
18683,550,337,213,47,33,55,31,358,170,188,54,55,20,10,1
18684,552,285,267,74,51,69,24,335,172,163,33,23,42,9,1
18685,977,500,477,139,115,121,31,358,170,188,54,55,20,10,1
18686,660,326,334,106,61,71,32,225,102,123,32,32,31,15,1
18687,853,355,498,122,156,91,29,2063,1024,1039,175,117,80,97,1
18688,611,246,365,116,82,71,27,361,161,200,43,63,9,19,1
18689,481,256,225,60,56,48,12,799,377,422,98,95,80,70,1
18690,1006,478,528,153,127,80,61,1430,718,712,205,172,151,64,1
18691,602,310,292,87,66,70,36,505,275,230,63,57,35,12,1
18692,333,197,136,31,29,44,13,527,262,265,62,73,39,49,1
18693,194,87,107,30,24,12,10,291,133,158,46,51,21,15,1
18694,145,75,70,18,17,10,9,410,194,216,60,47,47,26,1
18695,103,44,59,16,17,9,5,536,230,306,64,88,40,12,1
18696,129,78,51,17,9,10,10,249,142,107,36,24,21,5,1
18697,594,305,289,86,63,51,21,1620,884,736,194,161,162,80,1
18698,951,506,445,107,118,79,40,213,91,122,42,30,23,12,1
18699,711,344,367,87,109,74,24,1591,704,887,253,227,156,50,1
18700,379,203,176,55,48,45,16,474,199,275,76,66,29,19,1
18701,590,330,260,79,69,56,13,386,216,170,60,41,38,12,1
18702,316,132,184,48,49,14,14,540,271,269,80,77,51,16,1
18703,158,76,82,18,23,14,8,601,313,288,42,48,25,36,1
18704,205,94,111,29,31,16,7,605,263,342,73,103,54,18,1
18705,1194,609,585,195,142,105,37,425,199,226,54,71,56,11,1
18706,481,189,292,119,69,84,26,674,248,426,169,95,56,16,1
18707,1009,506,503,146,141,97,55,536,278,258,72,63,62,20,1
18708,2033,877,1156,359,333,106,44,2871,1148,1723,496,469,204,98,1
18709,833,467,366,106,84,105,34,926,435,491,133,132,85,17,1
18710,306,163,143,42,32,38,11,913,443,470,127,120,103,45,1
18711,412,238,174,41,38,43,19,134,63,71,27,9,6,8,1
18712,564,350,214,56,42,50,29,493,208,285,75,77,70,40,1
18713,543,277,266,62,54,70,19,355,168,187,55,48,40,15,1
18714,545,297,248,45,42,61,21,458,243,215,68,50,67,15,1
18715,473,224,249,82,63,48,24,217,98,119,33,32,27,7,1
18716,1275,579,696,200,172,125,51,204,99,105,32,32,22,10,1
18717,919,538,381,111,98,103,41,1499,975,524,152,145,54,41,1
18718,910,524,386,106,97,73,26,452,224,228,69,56,50,31,1
18719,256,134,122,27,31,31,10,467,224,243,70,43,67,23,1
18720,245,142,103,29,20,21,9,223,127,96,25,23,33,4,1
18721,522,235,287,78,67,60,50,427,204,223,38,57,26,32,1
18722,824,365,459,121,123,88,50,279,106,173,48,35,41,39,1
18723,1098,519,579,182,159,79,42,1970,978,992,245,206,198,80,1
18724,536,278,258,72,63,62,20,829,366,463,137,130,56,10,1
18725,984,466,518,159,139,97,42,193,99,94,31,31,16,12,1
18726,615,293,322,70,67,45,29,756,348,408,101,103,60,40,1
18727,1424,650,774,152,124,95,87,595,316,279,86,60,65,40,1
18728,1304,585,719,179,169,154,47,512,261,251,79,73,60,21,1
18729,592,291,301,92,93,71,31,483,274,209,54,39,45,13,1
18730,1290,629,661,191,187,167,55,1189,559,630,179,147,118,35,1
18731,207,93,114,20,33,19,10,282,135,147,36,49,25,10,1
18732,451,218,233,58,57,41,19,641,324,317,88,92,49,14,1
18733,284,167,117,35,25,28,8,351,184,167,59,45,54,9,1
18734,222,103,119,38,39,4,17,437,210,227,73,62,38,19,1
18735,391,208,183,65,49,57,17,2261,1217,1044,271,243,267,101,1
18736,385,181,204,48,41,52,36,1231,566,665,164,147,154,103,1
18737,100,64,36,18,7,7,2,550,309,241,65,50,87,31,1
18738,1097,526,571,131,134,120,43,372,206,166,43,32,49,12,1
18739,727,259,468,163,157,68,15,527,263,264,81,63,72,31,1
18740,101,41,60,18,19,10,5,335,128,207,59,43,24,23,1
18741,229,105,124,36,33,12,4,454,191,263,61,66,38,15,1
18742,881,428,453,174,110,64,21,530,259,271,83,50,54,41,1
18743,587,303,284,84,90,63,23,676,295,381,94,71,65,24,1
18744,98,53,45,14,6,7,6,378,222,156,39,25,51,25,1
18745,248,119,129,33,48,20,10,205,104,101,28,28,35,13,1
18746,258,88,170,68,67,14,4,182,71,111,45,36,11,13,1
18747,2161,1233,928,269,199,178,42,740,385,355,114,97,91,27,1
18748,521,267,254,53,68,39,15,325,133,192,75,62,34,9,1
18749,665,297,368,111,107,34,12,360,161,199,72,36,35,13,1
18750,1901,796,1105,253,274,183,76,404,197,207,57,69,33,15,1
18751,805,438,367,89,95,116,25,210,89,121,51,34,11,6,1
18752,557,211,346,129,125,48,19,2045,985,1060,359,339,199,74,1
18753,279,106,173,48,35,41,39,825,363,462,97,105,72,75,1
18754,1313,644,669,169,90,111,43,630,321,309,86,90,57,26,1
18755,466,242,224,66,53,53,13,476,254,222,58,33,46,23,1
18756,209,78,131,33,42,11,7,242,104,138,41,33,37,8,1
18757,1210,592,618,157,138,116,85,787,386,401,98,95,86,25,1
18758,374,191,183,70,48,61,13,221,75,146,68,21,16,5,1
18759,274,158,116,27,27,22,18,492,242,250,52,78,28,19,1
18760,1431,757,674,122,88,121,33,380,187,193,38,51,30,18,1
18761,245,112,133,32,45,20,10,100,37,63,26,19,0,1,1
18762,404,197,207,60,48,47,20,164,78,86,28,23,12,8,1
18763,501,240,261,80,62,49,42,632,326,306,92,71,56,19,1
18764,191,72,119,40,41,17,8,412,193,219,70,56,51,26,1
18765,896,430,466,120,117,85,35,745,391,354,85,81,52,39,1
18766,803,346,457,126,171,74,24,4563,2219,2344,620,531,527,104,1
18767,234,120,114,32,23,23,9,113,66,47,11,9,6,5,1
18768,1071,549,522,133,127,130,59,198,80,118,35,31,14,7,1
18769,365,180,185,63,35,48,19,215,80,135,54,56,21,9,1
18770,249,105,144,71,26,13,7,454,242,212,54,42,61,24,1
18771,699,326,373,110,125,70,24,248,118,130,54,31,26,5,1
18772,808,357,451,116,98,56,36,985,551,434,123,93,91,26,1
18773,701,368,333,90,81,39,27,526,264,262,77,71,61,27,1
18774,390,203,187,58,40,43,19,660,359,301,81,87,102,31,1
18775,1150,620,530,156,128,161,32,2045,985,1060,359,339,199,74,1
18776,2524,1232,1292,398,317,186,61,461,223,238,66,57,36,23,1
18777,125,60,65,22,17,14,5,393,210,183,44,53,53,23,1
18778,155,85,70,17,16,4,8,320,163,157,44,44,26,15,1
18779,148,69,79,26,18,16,3,1239,659,580,169,148,131,54,1
18780,281,133,148,41,32,16,12,459,212,247,63,48,48,28,1
18781,168,76,92,26,21,19,4,246,108,138,32,44,21,10,1
18782,869,488,381,110,77,78,30,588,266,322,99,79,87,28,1
18783,985,466,519,153,122,73,26,217,98,119,33,32,27,7,1
18784,522,245,277,78,69,52,21,336,154,182,51,48,39,22,1
18785,427,218,209,61,53,45,26,189,90,99,26,29,17,11,1
18786,221,110,111,28,32,25,11,769,329,440,116,66,55,22,1
18787,512,269,243,69,70,62,29,352,189,163,42,31,33,19,1
18788,640,279,361,102,83,69,21,391,203,188,49,34,36,9,1
18789,469,221,248,49,60,55,21,1425,670,755,153,189,122,85,1
18790,185,115,70,19,17,26,6,215,105,110,26,22,19,9,1
18791,536,266,270,58,73,40,25,750,347,403,105,103,83,29,1
18792,168,67,101,37,17,13,13,322,143,179,41,62,23,11,1
18793,1154,540,614,195,160,138,66,847,452,395,100,94,81,36,1
18794,391,189,202,73,47,37,8,172,80,92,28,22,21,4,1
18795,1215,572,643,151,105,127,54,676,346,330,85,72,64,41,1
18796,1219,599,620,159,198,155,42,208,107,101,42,22,18,10,1
18797,1251,591,660,183,137,106,50,713,335,378,94,70,56,35,1
18798,467,240,227,65,65,51,23,522,235,287,78,67,60,50,1
18799,140,75,65,22,18,30,7,247,122,125,37,39,30,8,1
18800,588,331,257,86,71,52,12,198,104,94,22,21,17,8,1
18801,118,56,62,13,14,6,6,217,98,119,33,32,27,7,1
18802,732,355,377,108,109,79,27,267,147,120,40,24,25,8,1
18803,676,333,343,111,89,94,39,348,187,161,50,35,44,9,1
18804,619,290,329,97,79,62,19,350,181,169,44,52,43,13,1
18805,349,167,182,54,38,30,28,423,222,201,51,33,41,28,1
18806,595,316,279,86,60,65,40,673,318,355,61,71,40,31,1
18807,724,325,399,98,92,64,24,1114,581,533,145,132,126,54,1
18808,575,318,257,65,65,70,24,499,272,227,49,66,66,21,1
18809,394,202,192,44,43,38,28,415,219,196,53,55,57,20,1
18810,442,254,188,54,31,50,30,359,174,185,54,56,43,16,1
18811,1141,583,558,141,98,91,45,2442,1193,1249,278,183,170,145,1
18812,1235,504,731,240,211,106,41,1217,496,721,230,214,94,42,1
18813,467,226,241,55,48,54,23,1580,742,838,208,146,144,71,1
18814,2472,1055,1417,416,458,235,64,906,437,469,135,132,49,40,1
18815,381,172,209,73,56,36,13,377,202,175,46,50,41,22,1
18816,613,333,280,71,66,47,26,1675,875,800,213,219,196,72,1
18817,104,52,52,18,14,17,4,377,184,193,50,43,33,17,1
18818,214,109,105,31,26,25,17,467,226,241,55,48,54,23,1
18819,498,278,220,55,42,63,26,627,351,276,78,62,71,32,1
18820,593,342,251,73,55,82,29,340,162,178,40,39,35,22,1
18821,1187,631,556,182,139,152,56,557,268,289,66,67,70,17,1
18822,121,69,52,15,18,14,8,616,304,312,75,71,55,25,1
18823,601,313,288,42,48,25,36,256,127,129,31,34,27,18,1
18824,559,296,263,77,69,42,13,1134,570,564,152,133,131,69,1
18825,858,417,441,93,124,75,26,262,123,139,44,32,25,18,1
18826,159,84,75,13,28,10,8,468,233,235,65,61,49,34,1
18827,219,133,86,18,12,32,18,153,73,80,19,15,14,10,1
18828,355,168,187,48,57,30,15,553,253,300,92,66,56,47,1
18829,527,257,270,72,68,50,28,424,198,226,57,46,41,19,1
18830,416,209,207,76,45,50,17,241,115,126,35,30,17,14,1
18831,374,184,190,52,38,48,11,290,149,141,37,26,41,12,1
18832,546,267,279,90,69,56,19,4544,2024,2520,579,628,480,403,1
18833,756,348,408,101,103,60,40,706,346,360,118,92,98,56,1
18834,360,179,181,63,60,26,12,33423,16370,17053,4965,4756,2786,883,1
18835,729,325,404,129,88,64,32,134,60,74,19,13,10,7,1
18836,1140,420,720,229,220,75,35,467,224,243,70,43,67,23,1
18837,1162,515,647,191,143,97,35,802,344,458,156,136,57,24,1
18838,1093,593,500,153,129,134,60,358,170,188,54,55,20,10,1
18839,399,208,191,57,46,41,20,424,209,215,56,58,45,24,1
18840,985,551,434,123,93,91,26,2414,1189,1225,277,178,170,169,1
18841,311,175,136,40,30,25,13,673,313,360,101,101,46,17,1
18842,433,226,207,52,60,58,20,461,207,254,82,66,55,33,1
18843,118,63,55,16,11,14,7,355,169,186,49,37,26,11,1
18844,372,237,135,38,22,39,26,413,227,186,45,34,58,23,1
18845,245,137,108,34,30,19,10,858,433,425,123,93,104,40,1
18846,715,355,360,118,79,71,29,393,186,207,58,50,36,22,1
18847,277,122,155,33,33,25,24,618,290,328,82,74,69,42,1
18848,99,48,51,15,7,7,7,3396,1499,1897,325,572,309,90,1
18849,756,368,388,114,99,89,30,876,457,419,88,124,67,47,1
18850,112,59,53,12,17,14,8,213,107,106,28,41,19,5,1
18851,895,436,459,124,113,87,44,215,105,110,26,22,19,9,1
18852,854,380,474,137,159,81,31,509,262,247,64,70,64,20,1
18853,360,192,168,55,45,48,16,2225,1244,981,271,243,217,93,1
18854,507,240,267,64,71,45,29,181,96,85,25,23,20,7,1
18855,203,97,106,37,27,20,8,463,231,232,66,69,29,18,1
18856,748,355,393,121,91,95,26,156,64,92,39,19,15,8,1
18857,198,112,86,20,36,16,5,143,65,78,32,11,11,11,1
18858,741,387,354,118,104,90,27,360,192,168,55,45,48,16,1
18859,825,422,403,100,90,62,43,949,512,437,102,124,70,41,1
18860,504,237,267,62,66,48,17,503,263,240,72,55,51,34,1
18861,1077,501,576,138,159,111,48,1339,494,845,216,298,92,37,1
18862,442,254,188,46,22,40,19,380,187,193,38,51,30,18,1
18863,677,323,354,101,109,45,31,1139,536,603,162,139,109,50,1
18864,483,237,246,63,47,25,21,173,90,83,30,19,19,11,1
18865,731,383,348,102,84,68,30,437,167,270,126,95,34,10,1
18866,501,240,261,80,62,49,42,1832,784,1048,330,229,199,102,1
18867,548,292,256,67,65,68,26,375,202,173,46,49,41,23,1
18868,276,143,133,34,38,20,15,490,217,273,72,64,46,19,1
18869,1233,635,598,187,149,146,51,587,310,277,80,64,84,26,1
18870,671,321,350,95,87,75,34,213,88,125,30,20,12,19,1
18871,875,376,499,155,125,53,39,566,263,303,83,87,74,31,1
18872,2041,1035,1006,223,274,125,60,218,146,72,15,10,24,17,1
18873,277,124,153,44,40,35,18,239,146,93,30,22,35,9,1
18874,419,178,241,59,46,43,47,1356,672,684,171,172,134,59,1
18875,2089,917,1172,285,306,83,39,1233,498,735,252,232,88,41,1
18876,117,62,55,24,18,21,2,475,247,228,62,45,75,24,1
18877,211,109,102,33,27,24,11,3130,1364,1766,481,369,294,126,1
18878,793,240,553,196,206,28,13,217,109,108,34,32,35,7,1
18879,488,217,271,71,71,50,32,270,133,137,42,37,34,8,1
18880,636,320,316,79,61,67,31,497,185,312,63,92,38,28,1
18881,253,148,105,31,15,39,16,217,109,108,34,32,35,7,1
18882,355,168,187,48,57,30,15,864,429,435,129,118,68,35,1
18883,150,74,76,21,22,18,7,207,99,108,34,27,22,9,1
18884,184,101,83,22,16,16,8,133,66,67,21,24,9,2,1
18885,538,252,286,77,87,53,30,466,186,280,71,84,30,11,1
18886,526,264,262,77,71,61,27,1290,629,661,191,187,167,55,1
18887,306,155,151,43,34,36,17,432,218,214,57,55,42,11,1
18888,247,110,137,34,45,23,10,1187,573,614,188,132,138,52,1
18889,770,356,414,123,102,66,25,1290,629,661,191,187,167,55,1
18890,912,461,451,127,109,96,48,1123,554,569,142,130,85,36,1
18891,269,165,104,24,19,27,7,246,115,131,15,29,10,32,1
18892,747,333,414,102,64,63,46,483,215,268,66,70,30,16,1
18893,416,182,234,62,67,37,17,360,161,199,72,36,35,13,1
18894,1181,612,569,107,121,123,43,377,202,175,46,50,41,23,1
18895,243,104,139,40,27,26,12,615,293,322,70,67,45,29,1
18896,723,380,343,80,84,47,18,157,79,78,24,26,19,7,1
18897,1390,705,685,219,164,129,74,708,344,364,106,98,66,33,1
18898,182,90,92,25,23,14,5,150,74,76,21,22,18,7,1
18899,712,380,332,69,74,57,30,904,443,461,118,89,124,30,1
18900,2817,1216,1601,379,436,183,115,381,189,192,74,49,44,13,1
18901,352,212,140,37,17,61,20,92,44,48,6,8,9,8,1
18902,699,376,323,79,53,86,41,116,55,61,16,7,18,14,1
18903,86,52,34,9,8,8,3,377,195,182,49,30,53,14,1
18904,840,385,455,118,137,66,39,531,260,271,97,68,47,11,1
18905,919,376,543,129,122,55,30,478,219,259,82,80,51,18,1
18906,556,300,256,58,73,55,22,1333,646,687,209,179,148,45,1
18907,536,237,299,116,87,42,17,1068,527,541,160,131,112,52,1
18908,146,75,71,13,32,15,11,673,313,360,101,101,46,17,1
18909,2442,1193,1249,278,183,170,145,573,278,295,58,79,37,23,1
18910,783,429,354,100,77,54,25,1149,568,581,177,133,101,30,1
18911,870,436,434,131,114,72,25,1074,538,536,154,140,111,51,1
18912,391,208,183,65,49,57,17,737,374,363,100,95,103,29,1
18913,502,240,262,78,61,54,32,453,228,225,72,42,59,13,1
18914,459,206,253,56,66,32,17,1367,690,677,172,175,154,83,1
18915,1770,824,946,245,258,179,60,870,433,437,133,121,95,25,1
18916,462,251,211,74,53,41,18,335,143,192,45,36,32,37,1
18917,870,433,437,133,121,95,25,647,387,260,69,51,86,38,1
18918,294,146,148,50,45,51,15,769,329,440,116,66,55,22,1
18919,246,115,131,15,29,10,32,707,422,285,84,82,59,13,1
18920,391,208,183,65,49,57,17,514,332,182,37,36,56,36,1
18921,147,81,66,18,18,18,4,351,166,185,48,61,24,15,1
18922,391,208,183,65,49,57,17,333,127,206,66,68,25,14,1
18923,428,226,202,52,60,75,20,621,301,320,76,64,46,34,1
18924,140,76,64,17,13,13,8,140,86,54,17,6,20,7,1
18925,526,264,262,77,71,61,27,481,256,225,60,56,48,12,1
18926,1627,782,845,204,187,202,108,467,224,243,70,43,67,23,1
18927,713,327,386,76,117,69,23,341,178,163,48,44,42,20,1
18928,546,267,279,90,69,56,19,389,176,213,81,59,24,7,1
18929,1315,720,595,138,136,115,62,1580,742,838,208,146,144,71,1
18930,465,240,225,50,54,24,14,575,290,285,67,70,28,9,1
18931,464,236,228,64,56,53,28,464,242,222,61,68,36,17,1
18932,464,236,228,64,56,53,28,393,186,207,58,50,36,22,1
18933,286,148,138,29,51,25,6,771,321,450,151,135,43,15,1
18934,99,34,65,12,1,2,18,467,250,217,59,52,41,19,1
18935,501,240,261,80,62,49,42,308,170,138,38,35,45,14,1
18936,2610,1215,1395,338,372,220,107,1336,736,600,137,136,163,69,1
18937,115,61,54,17,16,7,7,412,263,149,48,24,45,19,1
18938,642,345,297,89,64,66,29,377,202,175,46,50,41,22,1
18939,875,376,499,155,125,53,39,295,143,152,38,47,22,25,1
18940,246,108,138,32,44,21,10,980,381,599,165,159,57,34,1
18941,815,418,397,97,62,70,17,219,124,95,22,22,23,5,1
18942,348,187,161,48,41,47,15,760,401,359,96,89,98,22,1
18943,580,308,272,82,79,58,25,380,187,193,38,51,30,18,1
18944,822,392,430,125,104,79,24,2024,765,1259,283,343,137,76,1
18945,298,167,131,47,33,40,8,928,442,486,139,118,91,43,1
18946,651,306,345,85,64,61,32,750,347,403,105,103,83,29,1
18947,777,387,390,90,87,65,37,158,85,73,24,18,18,8,1
18948,236,140,96,20,39,12,6,303,175,128,43,36,34,12,1
18949,108,51,57,16,12,16,11,213,107,106,28,41,19,5,1
18950,483,283,200,56,51,45,18,192,101,91,25,22,18,9,1
18951,264,121,143,57,32,22,15,337,177,160,40,43,45,19,1
18952,1164,531,633,179,157,107,46,480,234,246,79,77,65,23,1
18953,499,252,247,74,42,55,14,824,392,432,106,89,88,32,1
18954,541,279,262,79,82,31,32,556,290,266,75,74,29,24,1
18955,901,439,462,133,123,102,45,215,110,105,27,26,24,8,1
18956,185,94,91,23,19,17,9,360,192,168,55,45,48,16,1
18957,330,143,187,63,29,52,20,1606,753,853,215,227,182,48,1
18958,277,128,149,40,47,15,6,205,91,114,31,32,23,12,1
18959,153,71,82,28,20,15,7,482,231,251,76,81,64,26,1
18960,440,246,194,62,49,41,16,647,322,325,104,98,54,14,1
18961,520,279,241,62,72,35,25,244,105,139,38,28,20,15,1
18962,3075,1459,1616,390,359,298,207,122,67,55,19,14,18,4,1
18963,1014,490,524,177,137,94,38,462,228,234,59,47,37,32,1
18964,540,265,275,87,59,74,25,1124,578,546,149,127,122,61,1
18965,677,361,316,81,61,42,22,1199,589,610,189,128,167,65,1
18966,728,385,343,110,102,69,14,537,276,261,75,68,68,22,1
18967,814,370,444,121,108,85,36,948,484,464,134,131,75,27,1
18968,756,265,491,129,127,51,17,595,316,279,86,60,65,40,1
18969,168,90,78,22,19,13,4,454,224,230,71,39,62,22,1
18970,1503,794,709,220,174,189,60,2671,1322,1349,379,345,290,135,1
18971,167,89,78,16,14,18,7,923,509,414,95,102,65,52,1
18972,920,492,428,100,92,88,49,217,98,119,38,35,18,9,1
18973,1333,695,638,178,145,135,72,526,279,247,68,72,55,18,1
18974,551,237,314,95,79,54,17,294,122,172,46,65,18,11,1
18975,781,367,414,60,67,43,17,2414,1189,1225,277,178,170,169,1
18976,707,386,321,85,83,99,28,1366,943,423,137,109,58,19,1
18977,933,493,440,140,108,124,32,537,276,261,75,68,68,22,1
18978,462,233,229,66,49,43,30,1014,490,524,177,137,94,38,1
18979,625,293,332,74,71,50,40,951,506,445,107,118,79,40,1
18980,509,341,168,35,32,52,15,373,174,199,55,49,33,7,1
18981,202,123,79,12,15,26,21,292,162,130,43,27,21,12,1
18982,297,158,139,47,37,37,9,300,140,160,39,35,14,12,1
18983,420,197,223,72,57,54,19,598,300,298,68,77,59,21,1
18984,394,220,174,50,28,53,21,255,122,133,35,51,22,13,1
18985,100,51,49,13,11,7,4,297,123,174,51,49,16,10,1
18986,403,188,215,70,42,41,11,433,221,212,59,42,47,14,1
18987,381,189,192,74,49,44,13,853,391,462,128,112,96,36,1
18988,360,192,168,55,45,48,16,381,187,194,37,49,36,17,1
18989,189,90,99,26,29,17,11,1333,646,687,209,179,148,45,1
18990,1304,585,719,179,169,154,47,1047,562,485,141,127,114,41,1
18991,651,306,345,85,64,61,32,930,367,563,181,153,83,48,1
18992,2109,1024,1085,306,265,236,86,191,99,92,25,24,18,8,1
18993,651,323,328,90,65,64,24,1257,647,610,156,146,145,35,1
18994,192,104,88,24,14,24,14,176,73,103,22,29,13,9,1
18995,583,322,261,73,66,45,26,164,88,76,27,20,17,6,1
18996,314,151,163,42,61,39,16,117,62,55,24,18,21,2,1
18997,304,159,145,38,40,32,3,976,496,480,128,111,121,48,1
18998,665,297,368,111,107,34,12,1068,539,529,161,134,132,71,1
18999,359,171,188,49,74,45,11,512,261,251,79,73,60,21,1
19000,382,230,152,46,22,47,23,1544,670,874,236,239,128,49,1
19001,676,333,343,111,89,94,39,377,201,176,46,50,41,23,1
19002,436,209,227,66,47,52,22,295,143,152,38,47,22,25,1
19003,245,137,108,34,30,19,10,483,155,328,138,109,32,9,1
19004,298,167,131,47,33,40,8,164,78,86,28,23,12,8,1
19005,1084,537,547,154,121,92,35,95,41,54,15,16,8,5,1
19006,825,363,462,97,105,72,75,1049,585,464,107,108,120,28,1
19007,350,181,169,44,52,43,13,425,210,215,56,43,52,25,1
19008,316,157,159,45,38,22,19,446,265,181,51,35,27,17,1
19009,780,337,443,112,116,77,28,1132,553,579,172,143,150,57,1
19010,73,29,44,15,16,3,4,780,354,426,123,102,45,17,1
19011,399,233,166,58,39,20,4,140,81,59,16,15,15,12,1
19012,208,115,93,31,27,22,19,640,297,343,120,68,68,39,1
19013,1113,520,593,168,139,109,49,724,320,404,120,147,67,25,1
19014,402,222,180,50,39,51,19,601,313,288,42,48,25,36,1
19015,2948,1454,1494,327,456,140,81,227,109,118,42,35,29,8,1
19016,529,270,259,73,68,65,25,676,333,343,111,89,94,39,1
19017,702,345,357,54,53,69,15,656,358,298,67,47,64,26,1
19018,757,373,384,115,93,95,25,512,248,264,66,71,49,30,1
19019,437,230,207,41,55,27,13,870,489,381,97,99,76,14,1
19020,247,161,86,21,10,26,11,402,227,175,48,40,35,11,1
19021,365,180,185,63,35,48,19,250,164,86,22,15,30,4,1
19022,732,355,377,108,109,79,27,866,405,461,155,136,101,43,1
19023,393,186,207,58,50,36,22,239,146,93,30,22,35,9,1
19024,1978,807,1171,323,310,129,70,621,310,311,100,106,77,27,1
19025,507,339,168,37,31,63,22,661,361,300,65,82,57,15,1
19026,574,269,305,91,63,54,27,808,366,442,130,133,66,31,1
19027,1304,585,719,179,169,154,47,1170,627,543,131,136,132,47,1
19028,624,308,316,92,72,68,22,1097,526,571,131,134,120,43,1
19029,977,492,485,135,122,116,35,654,317,337,95,111,44,13,1
19030,540,257,283,81,63,57,24,501,240,261,80,62,49,42,1
19031,219,100,119,32,43,9,10,423,186,237,92,40,52,29,1
19032,192,91,101,29,28,17,7,503,263,240,72,55,51,34,1
19033,918,427,491,113,111,113,33,1255,666,589,145,142,120,82,1
19034,212,114,98,25,26,19,11,151,60,91,24,34,15,2,1
19035,745,366,379,110,93,79,45,551,237,314,95,79,54,17,1
19036,2442,1193,1249,278,183,170,145,428,226,202,52,60,75,20,1
19037,1074,538,536,154,140,111,51,593,266,327,102,84,69,24,1
19038,443,208,235,43,55,51,50,554,215,339,102,65,85,42,1
19039,910,431,479,138,103,98,41,339,183,156,43,45,28,17,1
19040,1352,602,750,166,185,81,70,552,264,288,82,64,48,20,1
19041,233,94,139,36,37,15,8,416,210,206,55,54,39,20,1
19042,129,52,77,24,31,3,6,3144,1617,1527,367,342,278,136,1
19043,683,341,342,107,77,93,43,912,461,451,127,109,96,48,1
19044,277,124,153,44,40,35,18,258,111,147,46,63,17,6,1
19045,124,72,52,14,12,13,6,163,80,83,25,21,20,10,1
19046,433,221,212,59,42,47,14,467,269,198,46,51,60,18,1
19047,1970,978,992,245,206,198,80,961,463,498,139,156,62,34,1
19048,184,94,90,31,21,24,9,462,232,230,78,54,42,23,1
19049,1009,506,503,146,141,97,55,1342,673,669,178,154,137,94,1
19050,782,347,435,110,92,74,34,2161,1233,928,269,199,178,42,1
19051,760,391,369,101,109,65,24,746,434,312,86,83,66,27,1
19052,333,171,162,41,44,48,23,99,50,49,18,11,8,6,1
19053,778,398,380,131,85,69,24,641,324,317,88,92,49,14,1
19054,358,170,188,54,55,20,10,380,227,153,36,30,48,25,1
19055,748,355,393,121,91,95,26,464,297,167,72,30,52,14,1
19056,366,190,176,39,62,55,14,393,186,207,58,50,36,22,1
19057,901,439,462,133,123,102,45,207,99,108,34,27,22,9,1
19058,1417,598,819,223,188,135,58,756,362,394,102,104,73,25,1
19059,1154,540,614,195,160,138,66,1242,613,629,174,113,114,53,1
19060,274,157,117,40,29,40,8,393,186,207,58,50,36,22,1
19061,2490,1126,1364,352,325,219,89,346,186,160,48,32,35,14,1
19062,637,335,302,83,77,85,26,1132,553,579,172,143,150,57,1
19063,493,240,253,72,62,59,15,377,202,175,46,50,41,22,1
19064,936,396,540,96,166,77,29,723,380,343,80,84,47,18,1
19065,430,218,212,58,47,34,20,125,58,67,20,16,10,5,1
19066,770,374,396,95,91,79,41,1106,579,527,121,152,113,45,1
19067,227,85,142,48,40,17,9,201,42,159,19,3,2,75,1
19068,928,442,486,139,118,91,43,702,298,404,134,111,48,18,1
19069,868,448,420,108,103,76,25,233,120,113,38,32,20,15,1
19070,512,261,251,79,73,60,21,871,482,389,113,95,109,35,1
19071,1333,646,687,209,179,148,45,218,121,97,29,26,21,6,1
19072,219,133,86,19,9,36,11,957,566,391,111,82,124,35,1
19073,404,190,214,55,55,35,27,795,305,490,169,178,66,22,1
19074,586,254,332,114,111,55,17,377,202,175,46,50,41,22,1
19075,228,118,110,32,29,36,13,987,515,472,107,110,106,61,1
19076,583,248,335,115,111,52,16,275,140,135,34,24,32,15,1
19077,1014,490,524,177,137,94,38,969,505,464,123,133,92,33,1
19078,870,436,434,131,114,72,25,1356,672,684,171,172,134,59,1
19079,834,405,429,112,95,84,34,901,458,443,91,129,86,21,1
19080,964,408,556,131,153,76,55,694,260,434,122,92,62,36,1
19081,432,218,214,57,55,42,11,251,143,108,37,29,33,7,1
19082,485,187,298,95,71,61,25,202,102,100,29,35,6,9,1
19083,179,90,89,26,9,16,6,482,231,251,76,81,64,26,1
19084,969,505,464,123,133,92,33,579,321,258,74,70,47,22,1
19085,366,190,176,39,62,55,14,136,65,71,33,11,9,6,1
19086,1187,631,556,182,139,152,56,851,417,434,109,116,83,28,1
19087,292,102,190,71,27,51,21,399,184,215,55,81,29,10,1
19088,1271,599,672,194,175,118,47,247,110,137,34,45,23,10,1
19089,949,512,437,102,124,70,41,180,93,87,24,22,19,8,1
19090,2442,1193,1249,278,183,170,145,514,233,281,66,62,50,28,1
19091,885,424,461,143,114,92,32,1272,520,752,235,242,117,54,1
19092,1816,865,951,246,230,189,76,652,272,380,116,113,55,27,1
19093,309,155,154,41,44,45,16,963,455,508,126,110,68,29,1
19094,759,365,394,134,108,85,35,424,198,226,57,46,41,19,1
19095,1070,558,512,154,134,126,54,737,363,374,119,101,85,41,1
19096,423,212,211,51,44,48,28,268,104,164,58,37,30,14,1
19097,839,439,400,101,86,102,43,360,192,168,55,45,48,16,1
19098,1085,529,556,149,133,126,54,2843,1104,1739,429,357,178,95,1
19099,739,393,346,91,91,70,44,1137,569,568,142,138,120,50,1
19100,470,226,244,81,53,59,39,1100,474,626,197,143,126,41,1
19101,1770,759,1011,237,271,163,74,1247,548,699,168,150,140,43,1
19102,561,280,281,88,58,89,27,526,264,262,77,71,61,27,1
19103,744,569,175,71,37,51,25,601,313,288,42,48,25,36,1
19104,304,184,120,36,16,36,18,348,134,214,80,57,41,15,1
19105,1132,553,579,172,143,150,57,165,87,78,24,19,22,9,1
19106,255,122,133,35,51,22,13,1159,641,518,148,115,114,48,1
19107,2383,1253,1130,323,292,273,107,815,418,397,97,62,70,17,1
19108,339,170,169,32,17,24,13,743,366,377,41,37,26,14,1
19109,398,174,224,46,58,36,17,217,109,108,34,32,35,7,1
19110,772,364,408,114,106,98,33,452,202,250,83,60,56,19,1
19111,372,187,185,55,36,45,21,399,216,183,60,53,43,18,1
19112,458,243,215,68,50,67,15,1676,860,816,208,192,204,56,1
19113,391,208,183,65,49,57,17,318,164,154,52,43,34,10,1
19114,2040,956,1084,202,190,258,147,491,233,258,73,58,56,30,1
19115,746,361,385,91,92,101,32,115,55,60,25,14,7,7,1
19116,369,167,202,66,59,39,20,297,123,174,51,49,16,10,1
19117,271,131,140,47,37,41,11,709,294,415,132,123,76,23,1
19118,1071,549,522,133,127,130,59,385,179,206,58,56,38,19,1
19119,2133,789,1344,342,419,135,88,508,267,241,57,49,40,13,1
19120,767,392,375,113,112,83,13,352,169,183,57,36,47,31,1
19121,594,274,320,89,63,66,28,1114,581,533,145,132,126,54,1
19122,614,226,388,103,97,51,30,188,87,101,35,30,18,9,1
19123,673,317,356,101,85,76,49,1336,724,612,209,141,133,60,1
19124,719,364,355,104,100,58,34,174,79,95,36,37,18,6,1
19125,362,211,151,46,35,42,12,452,217,235,59,47,60,20,1
19126,339,177,162,40,36,51,24,431,201,230,69,39,55,33,1
19127,131,74,57,17,14,12,4,92,46,46,14,9,8,6,1
19128,601,313,288,42,48,25,36,337,177,160,40,43,45,19,1
19129,933,536,397,96,90,71,41,163,71,92,33,26,5,7,1
19130,248,143,105,20,7,28,3,62,42,20,5,4,13,3,1
19131,538,305,233,69,43,48,13,202,102,100,29,35,6,9,1
19132,430,192,238,62,67,27,10,725,365,360,104,111,70,31,1
19133,481,256,225,60,56,48,12,624,308,316,92,72,68,22,1
19134,84,43,41,5,11,6,11,601,313,288,42,48,25,36,1
19135,2442,1193,1249,278,183,170,145,781,418,363,92,90,64,41,1
19136,1313,644,669,169,90,111,43,593,295,298,70,85,48,13,1
19137,684,288,396,107,90,54,42,424,170,254,69,56,47,28,1
19138,582,293,289,94,80,77,32,551,298,253,63,65,45,19,1
19139,232,108,124,33,27,19,16,1873,948,925,245,214,194,85,1
19140,1179,579,600,140,133,122,53,744,569,175,71,37,51,25,1
19141,351,166,185,48,61,24,15,150,60,90,27,16,6,3,1
19142,101,41,60,18,19,10,5,313,145,168,56,44,50,8,1
19143,2570,1286,1284,337,338,294,120,1834,823,1011,297,282,151,63,1
19144,836,391,445,146,108,60,23,437,228,209,47,61,26,11,1
19145,2644,1346,1298,391,304,315,148,184,95,89,22,22,19,7,1
19146,219,100,119,32,43,9,10,1647,794,853,279,235,128,65,1
19147,870,433,437,133,121,95,25,1243,650,593,158,159,98,55,1
19148,1290,629,661,191,187,167,55,481,256,225,60,56,48,12,1
19149,505,268,237,68,59,34,15,550,243,307,91,99,70,10,1
19150,580,306,274,79,71,50,25,211,114,97,32,24,19,10,1
19151,251,129,122,33,22,13,11,393,186,207,58,50,36,22,1
19152,1194,543,651,190,197,65,43,876,407,469,137,130,73,29,1
19153,1356,672,684,171,172,134,59,543,287,256,71,66,64,23,1
19154,1675,875,800,213,219,196,72,379,192,187,55,47,33,15,1
19155,815,418,397,97,62,70,17,932,465,467,105,138,69,43,1
19156,647,376,271,73,64,41,23,390,209,181,59,47,41,26,1
19157,971,516,455,114,115,116,35,901,458,443,91,129,86,21,1
19158,667,360,307,76,92,46,27,482,231,251,76,81,64,26,1
19159,605,263,342,73,103,54,18,2715,1239,1476,434,417,241,116,1
19160,427,236,191,49,54,46,13,540,282,258,50,53,33,16,1
19161,360,161,199,72,36,35,13,128,62,66,13,11,17,12,1
19162,920,492,428,100,92,88,49,298,184,114,45,22,45,12,1
19163,592,291,301,92,93,71,31,710,307,403,117,176,37,9,1
19164,336,134,202,51,64,27,12,299,151,148,35,34,26,16,1
19165,264,126,138,44,26,25,10,355,168,187,48,57,30,15,1
19166,594,296,298,73,81,57,27,370,177,193,51,61,32,4,1
19167,581,254,327,100,83,54,20,969,505,464,123,133,92,33,1
19168,454,214,240,56,71,35,16,781,367,414,60,67,43,17,1
19169,3056,1457,1599,438,389,329,168,1432,652,780,217,205,131,81,1
19170,361,184,177,50,53,51,22,467,250,217,59,52,41,19,1
19171,457,237,220,69,44,53,26,601,313,288,42,48,25,36,1
19172,467,226,241,55,48,54,23,562,214,348,120,86,69,42,1
19173,611,246,365,116,82,71,27,1382,599,783,208,252,90,39,1
19174,266,139,127,33,26,34,12,254,146,108,28,35,33,8,1
19175,928,442,486,139,118,91,43,272,149,123,34,35,21,2,1
19176,546,267,279,90,69,56,19,290,163,127,34,43,30,13,1
19177,343,165,178,57,48,36,14,395,195,200,41,55,23,10,1
19178,708,328,380,113,100,82,34,175,90,85,28,21,19,7,1
19179,1912,977,935,247,226,205,65,1907,1008,899,235,224,195,73,1
19180,465,225,240,65,44,65,25,222,105,117,37,44,6,18,1
19181,1512,695,817,264,166,111,31,930,367,563,181,153,83,48,1
19182,339,170,169,32,17,24,13,456,232,224,69,65,30,19,1
19183,633,327,306,102,90,72,15,361,184,177,50,53,51,22,1
19184,1269,624,645,183,180,136,52,375,202,173,46,49,41,23,1
19185,743,366,377,41,37,26,14,595,316,279,86,60,65,40,1
19186,351,184,167,59,45,54,9,461,233,228,75,64,36,18,1
19187,1170,510,660,142,182,115,84,707,386,321,85,83,99,28,1
19188,2442,1193,1249,278,183,170,145,217,108,109,30,23,28,10,1
19189,323,154,169,52,52,32,9,393,186,207,58,50,36,22,1
19190,1164,622,542,150,143,78,35,140,81,59,16,15,15,12,1
19191,418,189,229,76,72,45,14,1165,567,598,134,119,158,63,1
19192,981,465,516,126,164,112,38,749,360,389,91,122,59,37,1
19193,701,331,370,116,95,59,28,770,356,414,123,102,66,25,1
19194,230,108,122,44,32,19,9,202,102,100,29,35,6,9,1
19195,101,45,56,17,17,12,9,361,174,187,63,56,38,16,1
19196,400,208,192,62,44,42,21,654,344,310,80,69,57,15,1
19197,858,447,411,116,76,73,34,556,259,297,75,69,63,38,1
19198,374,184,190,52,38,48,11,224,123,101,23,24,33,6,1
19199,1308,652,656,166,153,149,87,1255,666,589,145,142,120,82,1
19200,653,326,327,83,96,83,27,499,272,227,49,66,66,21,1
19201,536,278,258,72,63,62,20,217,109,108,34,32,35,7,1
19202,1133,491,642,192,170,61,29,335,128,207,59,43,24,23,1
19203,318,192,126,37,22,33,11,295,177,118,27,16,40,17,1
19204,2109,999,1110,332,294,187,89,297,145,152,49,30,23,21,1
19205,778,267,511,171,95,133,56,671,318,353,83,124,46,34,1
19206,369,181,188,41,36,54,16,153,73,80,19,15,14,10,1
19207,712,396,316,78,69,65,25,839,439,400,101,86,102,43,1
19208,217,109,108,34,32,35,7,294,122,172,46,65,18,11,1
19209,396,213,183,68,44,47,18,289,164,125,37,31,35,16,1
19210,643,294,349,92,97,53,35,437,225,212,61,57,66,12,1
19211,501,240,261,80,62,49,42,669,323,346,94,89,34,18,1
19212,592,264,328,86,85,62,41,433,237,196,60,52,33,27,1
19213,247,110,137,34,45,23,10,1164,531,633,179,157,107,46,1
19214,135,73,62,15,16,15,8,825,363,462,97,105,72,75,1
19215,651,323,328,90,65,64,24,672,334,338,110,93,91,41,1
19216,502,240,262,78,61,54,32,573,319,254,60,60,52,32,1
19217,466,242,224,66,53,53,13,103,44,59,16,17,9,5,1
19218,670,333,337,95,79,62,21,781,418,363,92,90,64,41,1
19219,454,229,225,59,60,60,19,926,435,491,133,132,85,17,1
19220,504,282,222,70,42,60,22,493,246,247,60,49,56,25,1
19221,1980,1084,896,242,235,254,106,354,168,186,50,53,39,20,1
19222,673,317,356,101,85,76,49,202,102,100,29,35,6,9,1
19223,350,224,126,34,14,48,18,437,225,212,61,57,66,12,1
19224,1084,537,547,154,121,92,35,260,136,124,24,41,19,4,1
19225,593,291,302,81,85,56,20,346,165,181,69,43,22,9,1
19226,3354,1783,1571,308,474,315,62,2175,1078,1097,364,275,271,81,1
19227,1377,579,798,179,169,139,99,526,268,258,54,37,55,12,1
19228,416,209,207,76,45,50,17,225,116,109,29,19,25,6,1
19229,223,115,108,30,29,24,10,215,105,110,26,22,19,9,1
19230,1038,470,568,130,123,86,51,408,197,211,74,44,53,16,1
19231,606,279,327,81,70,49,34,1374,679,695,191,193,154,48,1
19232,862,427,435,139,98,100,59,201,42,159,19,3,2,75,1
19233,377,212,165,56,37,34,21,355,205,150,35,19,62,24,1
19234,647,322,325,104,98,54,14,757,359,398,109,127,80,26,1
19235,536,278,258,72,63,62,20,593,266,327,102,84,69,24,1
19236,662,340,322,67,72,71,35,748,360,388,101,89,82,36,1
19237,1214,612,602,169,173,98,35,579,321,258,74,70,47,22,1
19238,2752,959,1793,638,192,79,46,247,110,137,34,45,23,10,1
19239,546,279,267,94,60,32,22,229,105,124,36,33,12,4,1
19240,102,49,53,14,21,7,4,294,148,146,35,33,25,14,1
19241,551,299,252,51,62,63,17,770,374,396,95,91,79,41,1
19242,3911,1465,2446,610,767,240,133,290,130,160,47,43,32,11,1
19243,592,291,301,92,93,71,31,433,221,212,59,42,47,14,1
19244,248,119,129,33,48,20,10,630,290,340,102,70,70,37,1
19245,222,127,95,23,28,22,7,606,307,299,92,56,68,30,1
19246,740,374,366,117,95,84,33,551,298,253,63,65,45,19,1
19247,171,91,80,27,13,23,4,335,143,192,57,61,30,10,1
19248,168,67,101,37,17,13,13,1948,1039,909,242,227,200,67,1
19249,202,105,97,28,27,14,6,165,90,75,36,18,20,6,1
19250,335,172,163,40,29,31,15,593,266,327,102,84,69,24,1
19251,1273,592,681,199,164,139,39,604,275,329,95,69,52,25,1
19252,540,248,292,77,62,61,33,703,308,395,81,91,66,80,1
19253,4655,2074,2581,545,652,562,399,817,425,392,120,102,83,26,1
19254,101,38,63,23,8,9,10,870,433,437,133,121,95,25,1
19255,544,295,249,84,56,49,14,304,127,177,61,38,31,4,1
19256,272,141,131,45,29,36,9,477,249,228,65,52,56,30,1
19257,287,154,133,33,27,36,15,226,129,97,20,25,26,11,1
19258,583,322,261,73,66,45,26,676,333,343,111,89,94,39,1
19259,230,144,86,16,11,25,14,201,42,159,19,3,2,75,1
19260,561,343,218,53,63,37,15,1074,538,536,154,140,111,51,1
19261,1562,742,820,219,231,104,46,470,227,243,70,66,53,15,1
19262,2045,985,1060,359,339,199,74,392,115,277,117,75,28,17,1
19263,288,104,184,80,30,39,6,391,189,202,73,47,37,8,1
19264,537,288,249,60,60,61,19,393,210,183,55,50,34,19,1
19265,480,234,246,79,77,65,23,750,347,403,105,103,83,29,1
19266,624,308,316,92,72,68,22,522,235,287,78,67,60,50,1
19267,724,261,463,135,139,39,20,149,68,81,15,38,11,10,1
19268,663,323,340,89,89,76,22,569,293,276,63,52,43,20,1
19269,502,252,250,68,63,40,14,728,385,343,110,102,69,14,1
19270,267,159,108,31,13,22,15,863,470,393,82,72,92,44,1
19271,467,269,198,46,51,60,18,2321,1177,1144,236,255,174,254,1
19272,858,431,427,94,57,54,30,474,227,247,47,80,33,19,1
19273,815,418,397,97,62,70,17,1359,684,675,188,160,127,47,1
19274,400,191,209,41,40,33,21,326,153,173,63,48,25,8,1
19275,1254,631,623,152,160,66,44,767,392,375,113,112,83,13,1
19276,441,216,225,57,66,57,19,885,339,546,159,135,81,49,1
19277,961,485,476,147,130,83,37,550,243,307,91,99,70,10,1
19278,982,494,488,150,117,91,45,380,184,196,58,52,46,8,1
19279,166,95,71,23,21,12,4,303,175,128,43,36,34,12,1
19280,665,292,373,107,126,37,10,415,195,220,60,63,25,16,1
19281,326,167,159,46,31,38,13,249,90,159,29,89,12,4,1
19282,718,390,328,93,86,94,30,746,382,364,117,72,119,28,1
19283,510,264,246,67,66,38,29,219,105,114,36,29,19,8,1
19284,220,126,94,29,12,34,11,724,334,390,112,109,79,17,1
19285,589,340,249,75,53,85,35,468,260,208,60,44,55,17,1
19286,502,240,262,78,61,54,32,309,154,155,42,44,45,16,1
19287,614,226,388,103,97,51,30,894,420,474,136,146,93,39,1
19288,265,165,100,32,19,27,5,399,201,198,65,45,48,17,1
19289,486,236,250,73,67,59,16,239,146,93,30,22,35,9,1
19290,1735,889,846,220,158,171,48,700,348,352,93,115,85,27,1
19291,819,473,346,75,105,69,16,968,452,516,150,144,79,28,1
19292,294,140,154,47,35,22,17,807,387,420,125,105,83,31,1
19293,351,184,167,59,45,54,9,663,323,340,89,89,76,22,1
19294,838,380,458,114,95,68,57,451,223,228,56,56,52,17,1
19295,1505,681,824,201,204,73,32,731,281,450,112,113,50,18,1
19296,379,203,176,55,48,45,16,528,283,245,77,72,63,11,1
19297,390,203,187,58,40,43,19,472,230,242,82,46,49,19,1
19298,732,355,377,108,109,79,27,2286,1154,1132,338,314,278,103,1
19299,638,327,311,88,79,77,28,165,78,87,23,21,17,8,1
19300,589,294,295,37,44,27,33,467,269,198,46,51,60,18,1
19301,822,424,398,107,106,86,46,207,94,113,44,20,25,10,1
19302,480,257,223,74,26,60,27,462,233,229,66,49,43,30,1
19303,272,141,131,45,29,36,9,434,201,233,58,46,38,19,1
19304,196,107,89,19,18,15,7,537,276,261,75,68,68,22,1
19305,587,260,327,84,69,55,23,724,334,390,112,109,79,17,1
19306,380,212,168,47,38,19,11,375,202,173,46,49,41,23,1
19307,271,159,112,34,34,33,7,454,273,181,49,58,33,11,1
19308,769,352,417,109,83,88,67,478,239,239,65,66,65,21,1
19309,1210,592,618,157,138,116,85,248,129,119,26,46,21,6,1
19310,381,206,175,42,53,36,20,245,142,103,29,20,21,9,1
19311,583,240,343,93,81,52,9,586,240,346,94,110,29,19,1
19312,615,293,322,70,67,45,29,533,297,236,74,57,39,28,1
19313,503,263,240,72,55,51,34,207,89,118,28,26,16,6,1
19314,591,279,312,88,91,52,26,1462,652,810,243,199,115,30,1
19315,537,276,261,75,68,68,22,982,494,488,150,117,91,45,1
19316,573,278,295,58,79,37,23,1464,693,771,153,136,91,86,1
19317,1290,629,661,191,187,167,55,827,422,405,111,104,94,28,1
19318,415,203,212,77,44,49,18,382,200,182,53,36,51,16,1
19319,647,322,325,104,98,54,14,625,313,312,103,90,74,29,1
19320,480,232,248,83,64,51,25,399,208,191,57,46,41,20,1
19321,531,286,245,81,67,42,29,454,242,212,54,42,61,24,1
19322,81,60,21,6,1,17,6,226,109,117,38,36,13,11,1
19323,169,64,105,23,37,11,3,125,46,79,24,16,12,2,1
19324,127,66,61,13,14,19,8,507,248,259,56,49,44,10,1
19325,758,338,420,132,87,67,29,758,362,396,115,102,35,13,1
19326,217,122,95,28,25,18,12,446,246,200,46,32,53,25,1
19327,403,215,188,58,47,49,19,528,268,260,81,77,36,22,1
19328,229,106,123,28,37,30,9,163,67,96,27,30,15,9,1
19329,596,286,310,90,89,78,37,335,185,150,46,34,36,13,1
19330,221,80,141,48,37,14,10,882,432,450,115,111,68,44,1
19331,428,226,202,52,60,75,20,372,201,171,52,50,42,13,1
19332,205,91,114,31,32,23,12,2342,933,1409,330,354,199,108,1
19333,235,135,100,30,13,25,11,246,129,117,38,16,23,17,1
19334,1356,672,684,171,172,134,59,1338,633,705,199,151,144,65,1
19335,388,199,189,50,51,33,14,364,224,140,33,18,58,22,1
19336,986,465,521,152,132,138,51,4391,2256,2135,494,411,423,231,1
19337,325,153,172,62,37,50,39,452,236,216,73,54,50,29,1
19338,498,244,254,81,67,58,19,239,146,93,30,22,35,9,1
19339,672,334,338,110,93,91,41,593,266,327,102,84,69,24,1
19340,951,506,445,107,118,79,40,399,184,215,55,81,29,10,1
19341,901,439,462,133,123,102,45,205,100,105,25,25,20,9,1
19342,309,154,155,42,44,45,16,239,146,93,30,22,35,9,1
19343,261,159,102,19,29,41,11,296,147,149,45,29,30,23,1
19344,551,298,253,63,65,45,19,847,452,395,100,94,81,36,1
19345,561,279,282,85,81,88,24,216,111,105,37,24,35,16,1
19346,310,142,168,42,39,24,9,677,361,316,81,61,42,22,1
19347,160,77,83,14,27,11,10,468,233,235,65,61,49,34,1
19348,359,174,185,54,56,43,16,520,300,220,66,36,57,23,1
19349,1074,538,536,190,131,157,35,603,291,312,98,87,61,28,1
19350,171,94,77,24,28,30,11,228,121,107,34,13,19,8,1
19351,700,357,343,99,84,88,34,360,192,168,55,45,48,16,1
19352,155,85,70,17,16,4,8,654,344,310,80,69,57,15,1
19353,756,348,408,101,103,60,40,790,352,438,132,87,91,60,1
19354,2175,1078,1097,364,275,271,81,149,68,81,15,38,11,10,1
19355,674,319,355,84,139,50,11,341,178,163,48,44,42,20,1
19356,219,105,114,36,29,19,8,432,190,242,85,82,28,11,1
19357,215,105,110,26,22,19,9,1047,562,485,141,127,114,41,1
19358,246,115,131,15,29,10,32,478,230,248,69,66,35,23,1
19359,320,163,157,44,44,26,15,149,68,81,15,38,11,10,1
19360,292,152,140,46,38,35,12,864,429,435,129,118,68,35,1
19361,1455,765,690,189,162,166,66,622,331,291,69,74,45,21,1
19362,196,89,107,28,27,11,10,559,317,242,58,65,37,23,1
19363,272,173,99,32,32,11,8,256,127,129,31,34,27,18,1
19364,530,288,242,49,55,38,22,601,313,288,42,48,25,36,1
19365,318,176,142,25,32,35,25,132,65,67,21,9,8,21,1
19366,149,68,81,15,38,11,10,1285,578,707,239,191,136,57,1
19367,667,360,307,76,92,46,27,467,231,236,71,65,58,18,1
19368,806,436,370,101,100,76,34,140,74,66,15,14,14,10,1
19369,454,224,230,71,39,62,22,313,149,164,48,31,30,13,1
19370,476,220,256,65,65,41,21,223,97,126,41,33,21,12,1
19371,4391,2256,2135,494,411,423,231,770,355,415,103,142,75,42,1
19372,611,246,365,116,82,71,27,920,492,428,100,92,88,49,1
19373,467,226,241,55,48,54,23,1382,689,693,186,176,167,77,1
19374,147,72,75,26,10,17,9,403,185,218,67,62,63,19,1
19375,151,84,67,17,17,22,11,1037,575,462,122,150,82,32,1
19376,392,156,236,40,91,28,16,1113,480,633,170,173,81,34,1
19377,1038,470,568,130,123,86,51,513,260,253,71,50,58,23,1
19378,397,186,211,73,63,36,25,493,230,263,73,47,47,13,1
19379,434,233,201,61,55,37,15,107,58,49,18,3,2,7,1
19380,246,108,138,32,44,21,10,766,386,380,101,81,78,31,1
19381,770,385,385,78,83,60,16,788,360,428,93,106,67,72,1
19382,1246,677,569,159,154,108,52,780,304,476,160,173,66,23,1
19383,906,455,451,116,105,87,46,616,296,320,69,76,49,48,1
19384,154,88,66,23,8,10,8,563,313,250,56,47,73,14,1
19385,909,455,454,137,82,85,68,217,109,108,34,32,35,7,1
19386,734,366,368,121,99,63,39,577,251,326,92,84,60,11,1
19387,737,320,417,112,94,73,34,461,257,204,63,49,50,29,1
19388,770,355,415,103,142,75,42,448,275,173,32,53,55,27,1
19389,245,112,133,32,45,20,10,444,209,235,76,62,62,16,1
19390,276,136,140,39,34,33,9,164,88,76,27,20,17,6,1
19391,228,72,156,42,27,8,7,281,125,156,44,47,17,7,1
19392,673,317,356,101,85,76,49,110,49,61,19,7,2,5,1
19393,524,264,260,75,75,40,21,1100,474,626,197,143,126,41,1
19394,781,418,363,92,90,64,41,463,231,232,66,69,29,18,1
19395,926,435,491,133,132,85,17,2803,1300,1503,392,510,170,57,1
19396,605,295,310,74,66,70,36,782,421,361,101,97,82,20,1
19397,581,299,282,93,81,73,26,377,180,197,37,20,24,8,1
19398,524,237,287,87,75,54,26,648,307,341,101,58,76,34,1
19399,558,306,252,75,55,74,23,915,336,579,185,199,56,29,1
19400,1038,470,568,130,123,86,51,382,169,213,55,47,38,27,1
19401,91,45,46,9,11,3,9,2477,1186,1291,256,271,249,90,1
19402,424,188,236,55,75,39,31,1891,1066,825,207,184,181,83,1
19403,1152,459,693,138,343,75,33,287,167,120,39,18,32,15,1
19404,881,383,498,142,148,77,24,2115,838,1277,346,354,90,48,1
19405,210,89,121,51,34,11,6,161,74,87,17,46,12,13,1
19406,536,278,258,72,63,62,20,1513,702,811,233,205,160,57,1
19407,561,255,306,95,67,44,17,1132,553,579,172,143,150,57,1
19408,646,382,264,75,55,78,45,824,480,344,94,68,101,53,1
19409,550,319,231,49,65,35,16,939,493,446,113,100,87,31,1
19410,497,227,270,70,63,66,30,205,104,101,28,28,35,13,1
19411,446,265,181,51,35,27,17,483,274,209,54,39,45,13,1
19412,957,436,521,138,126,101,41,3433,1476,1957,522,578,264,123,1
19413,312,147,165,52,44,12,13,660,333,327,102,95,69,31,1
19414,312,172,140,41,40,21,8,671,321,350,95,87,75,34,1
19415,519,246,273,78,82,42,16,834,483,351,102,83,103,22,1
19416,430,192,238,62,67,27,10,376,199,177,54,49,48,22,1
19417,391,203,188,49,48,41,14,288,118,170,50,57,18,15,1
19418,171,94,77,24,28,30,11,189,102,87,28,17,22,5,1
19419,736,388,348,88,85,67,28,780,409,371,125,80,60,34,1
19420,673,329,344,111,95,92,41,689,343,346,119,100,86,38,1
19421,346,208,138,46,39,51,18,263,137,126,57,25,27,9,1
19422,1914,892,1022,272,267,143,79,550,243,307,91,99,70,10,1
19423,1024,587,437,122,126,84,27,654,317,337,95,111,44,13,1
19424,601,290,311,92,89,55,30,297,158,139,47,37,37,9,1
19425,1231,566,665,164,147,154,103,1170,510,660,142,182,115,84,1
19426,557,211,346,129,125,48,19,522,265,257,35,39,38,8,1
19427,390,191,199,66,49,43,12,375,202,173,46,49,41,23,1
19428,748,355,393,121,91,95,26,666,329,337,90,90,54,19,1
19429,1035,559,476,128,122,122,50,171,94,77,24,28,30,11,1
19430,615,339,276,82,76,63,16,465,225,240,65,44,65,25,1
19431,353,194,159,67,35,52,11,283,172,111,39,31,29,8,1
19432,517,274,243,64,62,59,15,253,148,105,31,15,39,16,1
19433,687,353,334,84,96,74,31,346,167,179,56,52,28,13,1
19434,863,458,405,97,82,63,57,882,462,420,121,79,59,34,1
19435,561,292,269,88,68,64,22,839,408,431,138,122,105,46,1
19436,137,60,77,23,23,9,6,234,114,120,34,28,25,9,1
19437,230,104,126,27,31,18,17,757,373,384,115,93,95,25,1
19438,297,144,153,47,29,34,13,377,202,175,46,50,41,23,1
19439,347,192,155,39,33,29,8,2477,1186,1291,256,271,249,90,1
19440,351,184,167,59,45,54,9,2701,1334,1367,380,349,299,139,1
19441,250,123,127,40,28,29,8,2442,1193,1249,278,183,170,145,1
19442,2346,948,1398,352,377,147,66,673,287,386,89,111,66,30,1
19443,140,81,59,16,15,15,12,642,325,317,74,78,73,43,1
19444,245,112,133,32,45,20,10,1271,599,672,194,175,118,47,1
19445,2442,1193,1249,278,183,170,145,262,150,112,31,33,31,7,1
19446,1038,470,568,130,123,86,51,431,219,212,68,46,67,18,1
19447,349,131,218,66,76,22,9,1893,850,1043,280,340,169,80,1
19448,113,54,59,10,12,13,7,778,391,387,94,77,42,33,1
19449,639,322,317,73,82,39,23,156,64,92,39,19,15,8,1
19450,1074,538,536,154,140,111,51,675,311,364,111,80,96,30,1
19451,718,283,435,126,127,34,29,764,277,487,158,162,64,31,1
19452,834,405,429,112,95,84,34,134,60,74,19,13,10,7,1
19453,1484,731,753,206,175,187,71,453,242,211,59,47,49,11,1
19454,249,90,159,29,89,12,4,150,81,69,24,23,16,4,1
19455,416,194,222,70,58,52,20,601,313,288,42,48,25,36,1
19456,95,44,51,14,13,7,4,780,413,367,116,89,80,24,1
19457,423,247,176,58,55,29,20,257,148,109,28,20,21,14,1
19458,335,128,207,59,43,24,23,686,375,311,89,80,63,20,1
19459,815,418,397,97,62,70,17,333,166,167,58,25,46,17,1
19460,304,125,179,61,31,44,10,469,258,211,62,54,60,16,1
19461,2161,1233,928,269,199,178,42,870,436,434,131,114,72,25,1
19462,181,84,97,32,29,19,8,355,165,190,53,56,42,19,1
19463,1412,603,809,184,195,112,45,1425,670,755,153,189,122,85,1
19464,2549,1331,1218,366,296,271,130,183,95,88,27,22,26,5,1
19465,418,199,219,55,44,22,15,537,276,261,75,68,68,22,1
19466,629,338,291,92,57,64,22,304,127,177,61,38,31,4,1
19467,241,115,126,35,30,17,14,211,126,85,21,20,28,7,1
19468,448,209,239,36,53,46,52,2040,956,1084,202,190,258,147,1
19469,124,58,66,20,28,11,7,339,170,169,32,17,24,13,1
19470,376,202,174,46,49,41,23,402,227,175,48,40,35,11,1
19471,290,147,143,31,32,26,14,1189,559,630,179,147,118,35,1
19472,680,312,368,98,56,38,27,582,293,289,94,80,77,32,1
19473,425,177,248,60,62,33,16,568,243,325,98,73,56,44,1
19474,648,307,341,101,58,76,34,491,227,264,72,82,46,29,1
19475,163,71,92,22,38,11,7,447,179,268,81,49,35,29,1
19476,2414,1189,1225,277,178,170,169,356,161,195,52,57,40,17,1
19477,465,218,247,64,51,50,42,320,171,149,40,29,30,14,1
19478,466,242,224,66,53,53,13,706,300,406,94,74,61,22,1
19479,207,109,98,31,16,21,10,283,142,141,35,29,32,5,1
19480,677,303,374,79,63,55,28,740,308,432,79,66,53,28,1
19481,546,267,279,90,69,56,19,710,361,349,81,98,63,26,1
19482,429,219,210,46,66,42,17,413,169,244,66,94,28,19,1
19483,465,257,208,51,61,54,23,336,120,216,71,54,25,16,1
19484,1748,791,957,281,247,173,25,550,243,307,91,99,70,10,1
19485,912,461,451,127,109,96,48,424,209,215,56,58,45,24,1
19486,1074,538,536,154,140,111,51,393,186,207,58,50,36,22,1
19487,909,465,444,108,105,104,51,1894,962,932,232,209,205,90,1
19488,448,242,206,54,34,59,14,461,257,204,63,49,50,29,1
19489,115,65,50,12,21,4,2,114,71,43,8,18,7,4,1
19490,458,269,189,56,40,29,7,185,84,101,21,23,18,12,1
19491,481,256,225,60,56,48,12,769,362,407,99,88,66,67,1
19492,655,269,386,128,129,49,21,206,92,114,37,36,19,7,1
19493,290,149,141,37,26,41,12,482,242,240,60,39,60,17,1
19494,838,380,458,114,95,68,57,919,376,543,129,122,55,30,1
19495,277,151,126,35,30,24,15,141,70,71,16,19,12,6,1
19496,287,124,163,52,48,24,16,116,67,49,13,12,6,5,1
19497,320,171,149,40,29,30,14,280,118,162,35,32,41,37,1
19498,407,164,243,88,42,40,22,368,158,210,64,61,39,14,1
19499,673,317,356,101,85,76,49,482,231,251,76,81,64,26,1
19500,2555,1282,1273,336,333,303,117,758,362,396,115,102,35,13,1
19501,659,325,334,102,85,87,32,549,268,281,83,63,71,23,1
19502,729,358,371,116,99,89,33,392,155,237,68,61,34,16,1
19503,552,264,288,86,72,68,23,5179,2082,3097,270,269,273,249,1
19504,446,265,181,51,35,27,17,781,418,363,92,90,64,41,1
19505,255,130,125,44,18,22,12,297,145,152,49,30,23,21,1
19506,391,222,169,46,36,30,9,522,226,296,84,69,54,17,1
19507,505,226,279,68,51,30,15,391,208,183,65,49,57,17,1
19508,1007,353,654,277,147,70,26,150,81,69,24,23,16,4,1
19509,129,66,63,23,17,18,4,398,249,149,40,19,66,25,1
19510,589,340,249,75,53,85,35,1086,603,483,147,121,95,40,1
19511,794,390,404,103,95,86,23,508,295,213,42,61,53,17,1
19512,211,113,98,38,17,25,8,724,334,390,112,109,79,17,1
19513,969,505,464,123,133,92,33,272,122,150,33,30,27,26,1
19514,1197,521,676,216,187,82,38,1401,705,696,198,181,114,64,1
19515,283,112,171,48,39,34,15,393,186,207,58,50,36,22,1
19516,1980,963,1017,262,243,179,78,467,224,243,70,43,67,23,1
19517,224,117,107,33,21,31,16,660,359,301,81,87,102,31,1
19518,379,203,176,55,48,45,16,282,135,147,36,49,25,10,1
19519,747,316,431,143,127,53,21,165,80,85,21,9,18,19,1
19520,933,536,397,96,90,71,41,536,237,299,116,87,42,17,1
19521,536,278,258,72,63,62,20,481,256,225,60,56,48,12,1
19522,391,208,183,65,49,57,17,705,357,348,90,84,100,41,1
19523,328,184,144,47,24,23,9,1270,557,713,130,195,57,30,1
19524,177,99,78,22,23,20,10,205,104,101,28,28,35,13,1
19525,2564,1278,1286,414,406,207,64,979,535,444,123,99,79,34,1
19526,172,74,98,32,30,11,7,911,551,360,92,106,107,29,1
19527,2472,1055,1417,416,458,235,64,673,329,344,111,95,92,41,1
19528,361,167,194,55,35,41,11,443,226,217,67,34,53,10,1
19529,360,192,168,55,45,48,16,217,94,123,29,30,23,17,1
19530,2644,1346,1298,391,304,315,148,1339,494,845,216,298,92,37,1
19531,396,215,181,53,43,55,17,950,497,453,146,127,115,43,1
19532,224,103,121,34,47,11,9,456,220,236,67,75,30,21,1
19533,419,233,186,54,53,55,17,815,418,397,97,62,70,17,1
19534,1012,411,601,177,174,75,32,1395,627,768,172,263,141,59,1
19535,1074,538,536,154,140,111,51,671,321,350,95,87,75,34,1
19536,1125,581,544,135,124,137,47,375,202,173,46,49,41,23,1
19537,432,218,214,57,55,42,11,600,319,281,94,67,72,37,1
19538,330,143,187,63,29,52,20,715,322,393,105,82,77,51,1
19539,563,299,264,78,79,68,26,149,68,81,15,38,11,10,1
19540,710,342,368,99,82,76,46,206,85,121,31,42,6,17,1
19541,2135,1170,965,232,246,196,89,1390,695,695,180,137,170,71,1
19542,652,272,380,116,113,55,27,671,318,353,83,124,46,34,1
19543,577,241,336,112,109,47,21,390,191,199,66,49,43,12,1
19544,526,264,262,77,71,61,27,1095,530,565,157,151,98,34,1
19545,651,306,345,85,64,61,32,636,320,316,79,61,67,31,1
19546,1363,690,673,185,172,152,62,1049,585,464,107,108,120,28,1
19547,1698,875,823,222,219,173,64,1891,1066,825,207,184,181,83,1
19548,770,390,380,104,76,78,32,527,276,251,64,60,70,20,1
19549,755,271,484,113,226,61,20,249,114,135,47,33,25,4,1
19550,89,37,52,13,6,2,9,377,202,175,46,50,41,23,1
19551,2286,1154,1132,338,314,278,103,497,185,312,63,92,38,28,1
19552,624,204,420,166,101,32,13,464,242,222,61,68,36,17,1
19553,91,50,41,8,14,4,5,86,50,36,9,14,8,7,1
19554,443,198,245,68,72,48,19,462,228,234,59,47,37,32,1
19555,1616,728,888,280,204,178,54,503,263,240,72,55,51,34,1
19556,1074,538,536,154,140,111,51,769,362,407,99,88,66,67,1
19557,425,258,167,50,27,56,24,131,81,50,17,3,5,8,1
19558,1765,810,955,267,253,180,49,1027,444,583,127,80,80,36,1
19559,656,358,298,67,47,64,26,380,191,189,45,29,34,17,1
19560,239,164,75,18,16,47,10,738,399,339,88,86,83,39,1
19561,1192,579,613,120,215,79,24,239,146,93,30,22,35,9,1
19562,953,421,532,131,131,70,37,684,288,396,107,90,54,42,1
19563,229,105,124,36,33,12,4,756,348,408,101,103,60,40,1
19564,1338,633,705,199,151,144,65,593,266,327,102,84,69,24,1
19565,391,208,183,65,49,57,17,178,100,78,23,22,30,6,1
19566,574,295,279,78,65,61,22,568,243,325,98,73,56,44,1
19567,529,274,255,57,62,38,14,367,161,206,70,48,41,19,1
19568,352,183,169,41,40,38,26,609,279,330,103,98,72,42,1
19569,160,60,100,23,40,19,11,1342,673,669,178,154,137,94,1
19570,550,219,331,126,57,83,32,835,420,415,104,105,57,47,1
19571,776,356,420,122,103,85,30,356,199,157,43,58,29,12,1
19572,274,158,116,27,27,22,18,476,227,249,52,59,38,17,1
19573,471,221,250,87,68,42,25,163,70,93,28,21,17,6,1
19574,426,213,213,60,56,46,24,325,152,173,43,47,28,17,1
19575,732,355,377,108,109,79,27,589,281,308,69,39,63,20,1
19576,1455,760,695,205,191,124,40,425,210,215,56,43,52,25,1
19577,1382,689,693,186,176,167,77,367,199,168,41,41,33,16,1
19578,2477,1186,1291,256,271,249,90,1366,943,423,137,109,58,19,1
19579,601,313,288,42,48,25,36,496,286,210,60,53,61,16,1
19580,798,397,401,90,100,71,20,466,233,233,68,72,41,12,1
19581,2414,1189,1225,277,178,170,169,422,203,219,75,49,40,22,1
19582,1164,531,633,179,157,107,46,245,112,133,32,45,20,10,1
19583,184,115,69,21,17,6,5,285,145,140,37,36,22,11,1
19584,360,188,172,49,48,47,17,399,206,193,57,45,41,17,1
19585,406,210,196,68,60,25,20,316,157,159,45,38,22,19,1
19586,309,205,104,28,23,39,16,367,197,170,49,36,36,18,1
19587,673,329,344,111,95,92,41,515,253,262,46,83,57,21,1
19588,434,231,203,58,45,33,22,219,124,95,22,22,23,5,1
19589,467,250,217,59,52,41,19,315,169,146,51,49,27,9,1
19590,437,241,196,49,48,61,24,592,267,325,91,88,53,27,1
19591,589,314,275,70,83,44,28,207,99,108,27,27,21,9,1
19592,716,354,362,102,87,77,30,186,97,89,37,21,19,9,1
19593,964,408,556,131,153,76,55,575,218,357,135,58,89,41,1
19594,95,44,51,14,13,7,4,221,116,105,34,22,35,12,1
19595,730,328,402,126,99,48,23,676,333,343,111,89,94,39,1
19596,446,246,200,64,48,54,12,360,201,159,38,38,34,13,1
19597,379,203,176,55,48,45,16,454,191,263,61,66,38,15,1
19598,621,307,314,69,63,67,41,163,71,92,22,38,11,7,1
19599,386,247,139,34,19,40,28,150,74,76,21,22,18,7,1
19600,439,227,212,60,55,58,8,1585,840,745,184,152,155,100,1
19601,938,484,454,137,100,104,41,499,217,282,76,83,29,6,1
19602,676,319,357,83,86,62,46,597,282,315,81,64,75,43,1
19603,1009,522,487,121,106,107,46,462,224,238,77,75,37,13,1
19604,404,190,214,55,55,35,27,1210,592,618,157,138,116,85,1
19605,116,61,55,19,19,9,4,202,102,100,29,35,6,9,1
19606,400,183,217,53,62,28,28,353,147,206,47,61,30,25,1
19607,640,339,301,70,64,90,41,669,340,329,77,61,94,40,1
19608,461,227,234,61,47,54,33,1009,506,503,146,141,97,55,1
19609,686,375,311,89,80,63,20,550,319,231,49,65,35,16,1
19610,342,177,165,47,44,36,10,503,263,240,72,55,51,34,1
19611,331,155,176,47,49,28,4,806,419,387,115,130,57,32,1
19612,383,204,179,59,45,29,15,1241,670,571,135,139,110,32,1
19613,517,212,305,87,78,75,41,411,209,202,69,43,18,15,1
19614,589,281,308,69,39,63,20,1215,652,563,129,142,121,62,1
19615,303,141,162,42,57,37,20,562,265,297,79,56,72,45,1
19616,1217,496,721,230,214,94,42,792,407,385,110,132,82,43,1
19617,372,189,183,60,44,41,18,340,187,153,54,41,32,14,1
19618,467,226,241,55,48,54,23,575,225,350,106,74,68,29,1
19619,282,171,111,30,38,15,8,150,60,90,27,16,6,3,1
19620,556,274,282,74,68,62,37,325,181,144,46,31,48,9,1
19621,605,295,310,74,66,70,36,451,222,229,58,55,51,17,1
19622,193,92,101,29,32,25,11,622,328,294,75,42,67,31,1
19623,1132,553,579,172,143,150,57,863,470,393,82,72,92,44,1
19624,1272,520,752,235,242,117,54,950,497,453,146,127,115,43,1
19625,296,149,147,54,34,39,16,285,148,137,31,42,42,16,1
19626,2414,1189,1225,277,178,170,169,1151,493,658,157,141,108,62,1
19627,94,49,45,16,2,19,5,595,316,279,86,60,65,40,1
19628,7968,4016,3952,1072,1051,652,307,3957,1683,2274,560,659,267,109,1
19629,454,224,230,71,39,62,22,179,89,90,36,28,31,9,1
19630,154,75,79,17,24,16,13,685,315,370,108,99,36,9,1
19631,870,415,455,112,103,93,51,2414,1189,1225,277,178,170,169,1
19632,741,387,354,118,104,90,27,1257,647,610,156,146,145,35,1
19633,383,204,179,61,32,54,16,403,191,212,64,66,22,16,1
19634,1544,670,874,236,239,128,49,470,227,243,70,66,53,15,1
19635,480,234,246,79,77,65,23,211,114,97,32,24,19,10,1
19636,556,279,277,83,69,71,19,350,181,169,44,52,43,13,1
19637,683,341,342,107,77,93,43,537,276,261,75,68,68,22,1
19638,445,230,215,64,62,50,20,218,108,110,28,28,22,10,1
19639,1669,1162,507,154,128,86,51,122,69,53,18,16,20,4,1
19640,215,115,100,27,28,34,16,431,186,245,79,83,37,18,1
19641,1170,510,660,142,182,115,84,788,360,428,93,106,67,72,1
19642,870,489,381,97,99,76,14,1907,1008,899,235,224,195,73,1
19643,333,171,162,41,44,48,23,132,65,67,21,9,8,21,1
19644,442,207,235,51,72,50,19,83,33,50,14,11,7,9,1
19645,218,102,116,32,31,21,4,577,217,360,100,116,32,24,1
19646,191,99,92,25,24,18,8,1749,880,869,237,228,214,112,1
19647,105,51,54,13,17,12,8,318,164,154,52,43,34,10,1
19648,1132,553,579,172,143,150,57,1338,756,582,155,105,104,44,1
19649,914,401,513,110,125,64,37,512,281,231,69,48,70,23,1
19650,570,261,309,78,72,60,23,2414,1189,1225,277,178,170,169,1
19651,140,86,54,17,6,20,7,95,47,48,13,12,10,4,1
19652,733,438,295,95,79,67,32,747,371,376,87,134,54,29,1
19653,593,295,298,70,85,48,13,1505,681,824,201,204,73,32,1
19654,191,95,96,26,17,17,12,503,263,240,72,55,51,34,1
19655,425,210,215,56,43,52,25,575,290,285,67,70,28,9,1
19656,505,247,258,72,71,60,27,463,236,227,64,50,44,29,1
19657,346,187,159,42,34,43,21,470,199,271,78,84,33,8,1
19658,660,332,328,84,73,47,19,206,92,114,37,36,19,7,1
19659,464,236,228,64,56,53,28,1336,633,703,182,197,110,52,1
19660,673,329,344,111,95,92,41,1484,731,753,206,175,187,71,1
19661,1338,633,705,199,151,144,65,217,109,108,34,32,35,7,1
19662,445,219,226,61,60,60,21,474,197,277,80,67,52,13,1
19663,1058,497,561,194,142,87,63,1117,423,694,182,134,88,31,1
19664,433,229,204,60,59,53,24,870,433,437,133,121,95,25,1
19665,504,255,249,56,59,45,13,497,227,270,70,63,66,30,1
19666,557,245,312,81,96,72,48,1074,538,536,190,131,157,35,1
19667,246,115,131,15,29,10,32,223,76,147,49,29,31,5,1
19668,298,160,138,37,30,22,12,747,366,381,99,90,80,31,1
19669,195,109,86,25,24,17,6,508,267,241,43,35,25,17,1
19670,400,191,209,51,60,30,9,144,57,87,38,26,10,4,1
19671,433,221,212,59,42,47,14,393,186,207,58,50,36,22,1
19672,675,311,364,111,80,96,30,641,275,366,108,107,45,29,1
19673,2477,1186,1291,256,271,249,90,1464,987,477,137,141,55,31,1
19674,152,87,65,20,19,14,5,221,116,105,34,22,35,12,1
19675,885,424,461,143,114,92,32,160,67,93,32,37,15,9,1
19676,256,148,108,31,16,29,12,397,237,160,47,15,56,21,1
19677,245,122,123,21,32,18,13,346,171,175,59,53,43,14,1
19678,714,364,350,98,102,91,27,161,76,85,18,21,13,5,1
19679,466,186,280,71,84,30,11,498,174,324,112,108,33,19,1
19680,351,184,167,59,45,54,9,524,336,188,45,36,73,23,1
19681,1692,713,979,325,210,122,58,1116,413,703,214,213,53,41,1
19682,418,199,219,55,44,22,15,505,268,237,68,59,34,15,1
19683,142,81,61,11,24,9,6,145,75,70,22,18,10,5,1
19684,632,339,293,83,77,59,20,1382,689,693,186,176,167,77,1
19685,733,346,387,98,113,66,26,1426,752,674,202,139,155,42,1
19686,366,211,155,35,42,24,12,1253,639,614,181,155,164,73,1
19687,705,357,348,90,84,100,41,245,142,103,29,20,21,9,1
19688,815,382,433,97,50,88,31,393,186,207,58,50,36,22,1
19689,839,427,412,91,83,114,37,248,109,139,36,57,21,11,1
19690,460,251,209,61,48,43,21,450,241,209,67,58,54,23,1
19691,159,70,89,22,25,13,10,226,129,97,20,25,26,11,1
19692,1115,586,529,124,161,111,69,3224,1440,1784,455,440,333,126,1
19693,1074,538,536,154,140,111,51,1255,666,589,145,142,120,82,1
19694,1187,573,614,188,132,138,52,901,458,443,91,129,86,21,1
19695,358,188,170,50,31,48,20,382,200,182,53,36,51,16,1
19696,340,166,174,39,40,36,26,503,263,240,72,55,51,34,1
19697,398,227,171,47,32,44,17,445,225,220,47,62,53,26,1
19698,1204,623,581,144,146,119,83,462,251,211,74,53,41,18,1
19699,297,158,139,47,37,37,9,452,239,213,62,46,38,22,1
19700,1477,738,739,176,176,145,72,425,204,221,71,56,45,13,1
19701,1288,581,707,164,144,120,63,163,70,93,28,21,17,6,1
19702,125,66,59,22,14,15,6,1304,696,608,195,169,122,53,1
19703,822,392,430,125,104,79,24,536,278,258,72,63,62,20,1
19704,1336,724,612,209,141,133,60,437,225,212,61,57,66,12,1
19705,415,209,206,60,67,39,18,355,186,169,54,41,35,15,1
19706,522,265,257,35,39,38,8,194,91,103,17,32,9,6,1
19707,930,367,563,181,153,83,48,699,326,373,110,125,70,24,1
19708,96,50,46,8,15,6,2,337,175,162,51,47,32,12,1
19709,165,75,90,28,15,18,9,649,349,299,90,77,62,26,1
19710,385,181,204,48,41,52,36,217,109,108,34,32,35,7,1
19711,380,184,196,58,52,46,8,513,271,242,54,52,44,13,1
19712,721,379,342,89,73,68,25,405,180,225,72,57,31,12,1
19713,173,93,80,18,24,12,7,307,133,174,48,53,27,10,1
19714,4684,2161,2523,779,782,304,101,317,153,164,39,30,35,13,1
19715,1257,662,595,176,142,106,42,303,159,144,40,35,35,8,1
19716,212,133,79,28,10,36,4,299,140,159,27,59,20,18,1
19717,538,252,286,77,87,53,30,467,269,198,46,51,60,18,1
19718,589,281,308,69,39,63,20,380,187,193,38,51,30,18,1
19719,331,169,162,40,28,22,14,242,104,138,41,33,37,8,1
19720,444,247,197,53,32,60,28,131,81,50,17,3,5,8,1
19721,1298,591,707,196,168,124,58,1233,523,710,181,185,128,39,1
19722,822,424,398,107,106,86,46,244,116,128,47,19,26,9,1
19723,346,191,155,52,38,40,13,297,158,139,47,37,37,9,1
19724,975,417,558,161,126,96,44,816,428,388,95,87,108,32,1
19725,476,190,286,116,95,33,11,174,79,95,36,37,18,6,1
19726,540,265,275,87,59,74,25,1106,579,527,121,152,113,45,1
19727,900,484,416,119,110,77,29,605,285,320,89,61,68,26,1
19728,442,228,214,44,53,39,18,585,289,296,102,86,61,18,1
19729,412,218,194,63,51,49,14,724,650,74,44,3,32,3,1
19730,593,266,327,102,84,69,24,724,325,399,98,92,64,24,1
19731,755,348,407,109,98,49,23,1382,599,783,208,252,90,39,1
19732,197,104,93,21,14,20,11,193,85,108,24,37,20,13,1
19733,568,243,325,98,73,56,44,204,99,105,32,32,22,10,1
19734,453,250,203,53,37,47,11,480,259,221,59,54,50,22,1
19735,323,159,164,49,28,38,22,318,176,142,25,32,35,25,1
19736,556,279,277,83,69,71,19,676,333,343,111,89,94,39,1
19737,428,236,192,50,46,61,16,672,334,338,110,93,91,41,1
19738,150,79,71,19,29,19,6,125,53,72,18,21,18,12,1
19739,494,257,237,76,53,51,19,261,130,131,27,41,19,16,1
19740,552,283,269,89,66,68,30,504,259,245,73,56,45,29,1
19741,474,258,216,63,48,51,24,217,109,108,34,32,35,7,1
19742,228,114,114,37,34,29,3,290,130,160,47,43,32,11,1
19743,294,126,168,56,30,29,19,1204,623,581,144,146,119,83,1
19744,1441,657,784,140,135,81,73,246,113,133,33,45,22,10,1
19745,512,261,251,79,73,60,21,1132,553,579,172,143,150,57,1
19746,512,216,296,92,68,51,19,982,545,437,119,100,92,40,1
19747,170,99,71,24,24,22,8,503,263,240,72,55,51,34,1
19748,1005,422,583,166,179,70,21,377,202,175,46,50,41,23,1
19749,390,220,170,55,37,44,19,435,221,214,72,45,47,19,1
19750,509,341,168,35,32,52,15,893,469,424,126,135,68,14,1
19751,684,288,396,107,90,54,42,1883,747,1136,295,247,152,59,1
19752,1006,551,455,115,97,110,41,304,159,145,38,40,32,3,1
19753,794,402,392,96,84,86,30,956,473,483,140,88,89,78,1
19754,159,84,75,13,28,10,8,319,154,165,41,41,38,21,1
19755,301,150,151,41,30,17,11,283,153,130,37,32,41,17,1
19756,380,212,168,47,38,19,11,710,342,368,99,82,76,46,1
19757,422,203,219,75,49,40,22,482,231,251,76,81,64,26,1
19758,288,120,168,54,52,21,12,603,291,312,98,87,61,28,1
19759,199,101,98,29,25,18,6,538,252,286,77,87,53,30,1
19760,426,228,198,62,42,47,22,504,255,249,56,59,45,13,1
19761,245,112,133,32,45,20,10,637,294,343,97,91,46,17,1
19762,313,134,179,58,37,43,19,298,167,131,47,33,40,8,1
19763,540,265,275,87,59,74,25,592,291,301,92,93,71,31,1
19764,372,237,135,38,22,39,26,355,165,190,53,56,42,19,1
19765,515,259,256,79,58,46,21,380,187,193,38,51,30,18,1
19766,692,305,387,100,97,78,30,708,303,405,115,115,70,23,1
19767,1328,661,667,210,147,126,55,1484,731,753,206,175,187,71,1
19768,233,121,112,24,31,30,7,467,269,198,46,51,60,18,1
19769,427,218,209,61,53,45,26,239,146,93,30,22,35,9,1
19770,651,306,345,85,64,61,32,497,185,312,63,92,38,28,1
19771,194,90,104,33,17,24,19,507,283,224,64,54,50,24,1
19772,360,188,172,49,48,47,17,902,526,376,94,103,78,23,1
19773,217,105,112,34,32,25,13,419,247,172,64,30,43,17,1
19774,595,316,279,86,60,65,40,568,294,274,80,64,55,25,1
19775,276,143,133,34,38,20,15,245,137,108,34,30,19,10,1
19776,372,187,185,55,36,45,21,300,145,155,53,43,42,9,1
19777,423,218,205,64,55,54,15,512,248,264,66,71,49,30,1
19778,812,456,356,105,74,101,29,2472,1055,1417,416,458,235,64,1
19779,290,127,163,47,58,23,12,840,385,455,118,137,66,39,1
19780,349,131,218,66,76,22,9,529,264,265,59,68,41,17,1
19781,615,312,303,86,54,75,45,345,174,171,46,34,45,28,1
19782,429,219,210,46,66,42,17,526,169,357,109,86,69,30,1
19783,4655,2074,2581,545,652,562,399,4563,2219,2344,620,531,527,104,1
19784,746,361,385,91,92,101,32,121,74,47,15,9,6,6,1
19785,672,334,338,110,93,91,41,215,117,98,43,22,27,5,1
19786,745,391,354,85,81,52,39,2871,1148,1723,496,469,204,98,1
19787,1074,538,536,154,140,111,51,1290,629,661,191,187,167,55,1
19788,706,346,360,118,92,98,56,503,298,205,62,28,20,4,1
19789,1219,599,620,159,198,155,42,267,129,138,45,40,23,14,1
19790,728,385,343,110,102,69,14,583,322,261,73,66,45,26,1
19791,189,88,101,31,29,18,10,437,241,196,49,48,61,24,1
19792,391,203,188,49,48,41,14,771,321,450,151,135,43,15,1
19793,1424,650,774,152,124,95,87,2442,1193,1249,278,183,170,145,1
19794,1233,635,598,187,149,146,51,314,190,124,40,20,35,14,1
19795,752,381,371,96,77,80,44,1663,835,828,224,213,163,63,1
19796,875,376,499,155,125,53,39,173,110,63,35,6,9,8,1
19797,982,494,488,150,117,91,45,452,256,196,32,44,27,11,1
19798,671,321,350,95,87,75,34,854,380,474,137,159,81,31,1
19799,652,342,310,71,68,66,17,119,57,62,18,16,17,4,1
19800,428,226,202,52,60,75,20,693,297,396,87,52,64,27,1
19801,249,114,135,47,33,25,4,505,226,279,68,51,30,15,1
19802,466,224,242,68,56,48,16,780,354,426,123,102,45,17,1
19803,912,461,451,127,109,96,48,282,135,147,36,49,25,10,1
19804,287,124,163,52,48,24,16,506,315,191,45,31,73,22,1
19805,301,150,151,41,30,17,11,311,154,157,47,29,34,13,1
19806,625,313,312,103,90,74,29,437,225,212,61,57,66,12,1
19807,645,268,377,104,73,55,30,585,277,308,92,73,61,32,1
19808,339,170,169,32,17,24,13,331,169,162,40,28,22,14,1
19809,256,125,131,34,27,24,14,625,316,309,77,79,54,34,1
19810,277,124,153,44,40,35,18,1336,633,703,182,197,110,52,1
19811,129,78,51,17,9,10,10,557,240,317,97,74,68,37,1
19812,1512,737,775,238,209,156,57,623,320,303,103,85,75,15,1
19813,415,209,206,60,67,39,18,918,490,428,114,100,115,41,1
19814,686,345,341,98,106,75,25,875,402,473,125,120,95,47,1
19815,467,226,241,55,48,54,23,729,391,338,80,64,71,34,1
19816,1087,523,564,146,177,103,33,880,355,525,122,139,75,36,1
19817,616,323,293,98,71,31,15,1130,614,516,129,138,98,42,1
19818,512,248,264,66,71,49,30,720,357,363,113,85,62,39,1
19819,148,89,59,14,15,15,14,474,274,200,59,36,86,31,1
19820,1098,432,666,166,199,76,28,817,397,420,120,152,48,17,1
19821,1190,638,552,162,95,112,18,1188,476,712,179,163,93,57,1
19822,672,334,338,110,93,91,41,390,191,199,66,49,43,12,1
19823,458,222,236,69,39,35,18,742,303,439,88,96,86,23,1
19824,509,254,255,67,55,52,35,363,200,163,55,39,42,18,1
19825,246,108,138,32,44,21,10,583,284,299,86,61,67,23,1
19826,509,341,168,35,32,52,15,1059,580,479,138,117,67,27,1
19827,426,228,198,62,42,47,22,453,191,262,58,55,39,22,1
19828,331,145,186,40,56,16,9,760,391,369,101,109,65,24,1
19829,756,348,408,101,103,60,40,551,298,253,63,65,45,19,1
19830,912,461,451,127,109,96,48,245,111,134,31,44,20,11,1
19831,370,205,165,50,41,54,18,522,235,287,78,67,60,50,1
19832,2351,1110,1241,337,269,300,87,592,283,309,84,137,60,20,1
19833,1056,506,550,147,129,106,48,225,102,123,32,32,31,15,1
19834,293,142,151,49,40,42,17,367,169,198,66,57,42,14,1
19835,1074,538,536,154,140,111,51,610,281,329,54,62,65,58,1
19836,264,122,142,33,29,13,13,622,354,268,89,60,64,18,1
19837,3433,1476,1957,522,578,264,123,377,202,175,46,50,41,23,1
19838,627,289,338,101,73,62,43,351,143,208,44,68,23,18,1
19839,1203,651,552,151,128,123,46,391,223,168,35,26,47,31,1
19840,97,46,51,11,12,9,6,1062,522,540,151,147,105,66,1
19841,475,238,237,73,53,63,17,176,84,92,46,10,28,11,1
19842,171,94,77,24,28,30,11,140,86,54,17,6,20,7,1
19843,128,52,76,27,25,11,8,163,79,84,22,24,13,5,1
19844,498,263,235,59,63,36,10,375,202,173,46,49,41,23,1
19845,558,306,252,75,55,74,23,604,320,284,80,62,90,28,1
19846,360,188,172,49,48,47,17,882,432,450,115,111,68,44,1
19847,926,435,491,133,132,85,17,377,202,175,46,50,41,23,1
19848,552,285,267,74,51,69,24,437,167,270,126,95,34,10,1
19849,542,249,293,82,69,58,31,776,356,420,122,103,85,30,1
19850,283,153,130,37,32,41,17,305,168,137,48,35,40,9,1
19851,977,500,477,139,115,121,31,2701,1334,1367,380,349,299,139,1
19852,669,382,287,67,35,70,16,2414,1189,1225,277,178,170,169,1
19853,147,72,75,26,26,11,8,627,323,304,81,90,53,27,1
19854,391,208,183,65,49,57,17,224,124,100,30,34,11,6,1
19855,583,322,261,73,66,45,26,153,73,80,19,15,14,10,1
19856,199,101,98,22,25,9,12,307,154,153,39,36,31,12,1
19857,120,61,59,17,8,8,5,390,218,172,48,21,66,17,1
19858,815,418,397,97,62,70,17,1177,666,511,131,99,88,35,1
19859,425,210,215,56,43,52,25,776,356,420,122,103,85,30,1
19860,826,362,464,107,118,71,43,497,185,312,63,92,38,28,1
19861,521,263,258,55,70,41,16,649,304,345,99,80,67,40,1
19862,176,73,103,22,29,13,9,216,109,107,32,26,35,10,1
19863,335,128,207,51,60,16,8,451,222,229,58,55,51,17,1
19864,246,108,138,32,44,21,10,473,212,261,72,64,45,28,1
19865,546,279,267,94,60,32,22,261,130,131,27,41,19,16,1
19866,465,218,247,64,51,50,42,211,88,123,38,28,26,10,1
19867,2303,1190,1113,331,253,115,66,781,418,363,92,90,64,41,1
19868,257,136,121,29,26,39,8,86,52,34,9,8,8,3,1
19869,298,140,158,51,33,21,22,731,338,393,114,126,53,17,1
19870,1189,653,536,152,118,109,56,215,80,135,54,56,21,9,1
19871,759,326,433,115,95,61,29,782,347,435,110,92,74,34,1
19872,777,387,390,90,87,65,37,256,127,129,31,34,27,18,1
19873,551,281,270,57,60,64,30,406,202,204,54,54,41,16,1
19874,502,240,262,78,61,54,32,454,224,230,71,39,62,22,1
19875,564,291,273,77,72,95,21,218,110,108,24,31,27,13,1
19876,278,131,147,29,30,33,12,592,283,309,84,137,60,20,1
19877,956,403,553,147,135,99,87,1691,1217,474,130,115,73,46,1
19878,1464,693,771,153,136,91,86,781,418,363,92,90,64,41,1
19879,551,298,253,63,65,45,19,427,236,191,49,54,46,13,1
19880,543,246,297,99,93,50,29,641,324,317,88,92,49,14,1
19881,508,295,213,42,61,53,17,217,109,108,34,32,35,7,1
19882,524,244,280,64,79,30,17,767,392,375,113,112,83,13,1
19883,330,166,164,57,51,36,16,468,233,235,65,61,49,34,1
19884,467,226,241,55,48,54,23,437,167,270,126,95,34,10,1
19885,234,129,105,31,22,19,18,254,107,147,42,37,24,10,1
19886,2224,1037,1187,288,276,273,74,255,130,125,44,18,22,12,1
19887,592,291,301,92,93,71,31,480,234,246,79,77,65,23,1
19888,203,97,106,30,22,18,10,632,326,306,92,71,56,19,1
19889,630,326,304,82,62,80,31,227,108,119,31,35,35,14,1
19890,464,225,239,85,57,65,19,283,153,130,37,32,41,17,1
19891,2699,1318,1381,322,297,313,126,552,285,267,74,51,69,24,1
19892,651,306,345,85,64,61,32,396,150,246,103,64,38,3,1
19893,860,396,464,161,137,66,30,341,178,163,48,44,42,20,1
19894,466,242,224,66,53,53,13,95,41,54,15,16,8,5,1
19895,719,343,376,108,78,92,29,280,118,162,35,32,41,37,1
19896,255,126,129,41,37,13,5,225,111,114,38,22,25,10,1
19897,441,201,240,70,58,55,24,320,159,161,44,54,29,9,1
19898,458,210,248,39,38,25,16,703,354,349,84,81,40,25,1
19899,520,272,248,74,71,44,15,370,194,176,51,57,43,17,1
19900,807,359,448,114,99,93,33,207,107,100,27,25,20,11,1
19901,360,188,172,49,48,47,17,784,337,447,127,135,59,29,1
19902,364,189,175,58,41,35,17,243,98,145,25,65,20,5,1
19903,1105,544,561,165,167,98,40,778,367,411,90,85,64,43,1
19904,592,275,317,100,86,57,31,297,123,174,51,49,16,10,1
19905,446,176,270,64,79,45,24,1978,807,1171,323,310,129,70,1
19906,257,148,109,28,20,21,14,458,225,233,67,61,43,33,1
19907,211,126,85,21,20,28,7,283,142,141,35,29,32,5,1
19908,1284,511,773,227,166,169,107,465,225,240,65,44,65,25,1
19909,306,155,151,43,34,36,17,205,99,106,24,29,20,5,1
19910,269,134,135,42,35,27,13,446,176,270,64,79,45,24,1
19911,1801,889,912,206,263,126,42,1336,828,508,166,121,152,48,1
19912,1544,670,874,236,239,128,49,1367,690,677,172,175,154,83,1
19913,1499,678,821,224,201,126,55,183,96,87,20,28,17,10,1
19914,158,85,73,24,18,18,8,781,367,414,60,67,43,17,1
19915,262,151,111,30,17,32,25,896,407,489,97,152,70,22,1
19916,391,223,168,35,26,47,31,1306,707,599,165,147,199,44,1
19917,261,130,131,27,41,19,16,356,175,181,58,40,33,26,1
19918,464,242,222,61,68,36,17,349,183,166,56,55,38,5,1
19919,299,158,141,45,31,21,5,582,293,289,94,80,77,32,1
19920,372,184,188,55,55,30,8,377,202,175,46,50,41,23,1
19921,297,148,149,64,35,37,15,898,467,431,101,127,90,53,1
19922,359,185,174,42,48,22,26,646,316,330,89,95,48,17,1
19923,815,418,397,97,62,70,17,594,321,273,98,59,57,23,1
19924,902,332,570,154,146,75,40,788,420,368,93,89,98,23,1
19925,730,442,288,104,88,42,68,702,345,357,54,53,69,15,1
19926,171,94,77,24,28,30,11,170,99,71,24,24,22,8,1
19927,415,242,173,53,21,70,21,354,168,186,50,53,39,20,1
19928,302,158,144,40,39,43,10,1048,564,484,118,122,113,40,1
19929,338,188,150,45,41,31,18,94,55,39,18,6,18,5,1
19930,1419,648,771,234,218,109,45,1132,624,508,199,79,127,41,1
19931,249,144,105,20,16,33,21,318,143,175,65,19,17,7,1
19932,530,259,271,83,50,54,41,403,190,213,63,52,48,21,1
19933,1089,700,389,111,73,140,39,219,133,86,19,9,36,11,1
19934,366,190,176,39,62,55,14,2035,1087,948,163,129,96,73,1
19935,394,220,174,50,28,53,21,246,108,138,32,44,21,10,1
19936,294,122,172,46,65,18,11,808,374,434,140,108,54,17,1
19937,956,403,553,147,135,99,87,1669,1162,507,154,128,86,51,1
19938,1132,646,486,99,102,71,41,443,181,262,83,81,28,19,1
19939,782,347,435,110,92,74,34,247,110,137,34,45,23,10,1
19940,2419,1042,1377,389,474,238,59,591,263,328,95,90,26,13,1
19941,297,145,152,49,30,23,21,622,299,323,86,86,69,35,1
19942,636,284,352,108,101,40,23,418,248,170,41,31,54,9,1
19943,360,192,168,55,45,48,16,426,234,192,46,41,39,37,1
19944,630,359,271,72,70,44,21,14507,6188,8319,1128,1263,895,394,1
19945,870,489,381,97,99,76,14,829,366,463,137,130,56,10,1
19946,1590,726,864,270,237,126,59,272,149,123,34,35,21,2,1
19947,206,86,120,40,13,23,14,431,219,212,68,46,67,18,1
19948,621,273,348,104,102,48,19,1117,423,694,182,134,88,31,1
19949,424,191,233,76,73,49,13,486,199,287,79,91,52,18,1
19950,770,374,396,95,91,79,41,111,29,82,10,54,0,1,1
19951,1183,595,588,182,136,76,24,206,85,121,31,42,6,17,1
19952,327,160,167,56,31,36,15,465,257,208,51,61,54,23,1
19953,434,237,197,52,64,37,14,360,168,192,57,49,48,19,1
19954,655,281,374,108,103,61,24,615,356,259,90,56,97,19,1
19955,480,252,228,55,37,49,20,920,492,428,100,92,88,49,1
19956,171,85,86,23,16,20,10,461,207,254,82,66,55,33,1
19957,976,496,480,128,111,121,48,750,347,403,105,103,83,29,1
19958,976,520,456,120,115,109,53,209,138,71,13,9,16,19,1
19959,1499,678,821,224,201,126,55,184,86,98,26,26,14,11,1
19960,393,186,207,58,50,36,22,368,158,210,64,61,39,14,1
19961,700,305,395,111,99,54,18,2442,1193,1249,278,183,170,145,1
19962,215,111,104,28,25,26,11,355,169,186,49,37,26,11,1
19963,356,185,171,37,31,17,21,366,191,175,37,33,19,19,1
19964,494,123,371,160,58,29,5,743,233,510,148,142,28,17,1
19965,1424,650,774,152,124,95,87,462,228,234,59,47,37,32,1
19966,1140,586,554,130,146,117,49,100,51,49,13,11,7,4,1
19967,115,57,58,32,7,9,7,191,93,98,20,41,14,9,1
19968,595,316,279,86,60,65,40,5537,2898,2639,598,623,347,214,1
19969,394,220,174,50,28,53,21,953,481,472,133,130,77,48,1
19970,165,84,81,29,18,8,5,185,70,115,37,48,15,5,1
19971,1016,495,521,138,138,94,50,1132,624,508,199,79,127,41,1
19972,619,332,287,95,77,74,38,398,174,224,46,58,36,17,1
19973,912,461,451,127,109,96,48,427,218,209,61,53,45,26,1
19974,391,208,183,65,49,57,17,486,229,257,75,104,49,10,1
19975,782,347,435,110,92,74,34,377,184,193,56,53,44,14,1
19976,396,189,207,24,19,47,18,2442,1193,1249,278,183,170,145,1
19977,2442,1193,1249,278,183,170,145,412,193,219,70,56,51,26,1
19978,706,372,334,93,67,94,48,351,159,192,58,35,35,31,1
19979,339,170,169,32,17,24,13,595,316,279,86,60,65,40,1
19980,245,111,134,31,44,20,11,657,293,364,109,75,66,28,1
19981,952,464,488,143,135,72,21,1801,889,912,206,263,126,42,1
19982,825,363,462,97,105,72,75,3396,1499,1897,325,572,309,90,1
19983,805,419,386,94,99,111,35,170,82,88,28,23,20,12,1
19984,784,391,393,105,113,86,21,745,391,354,85,81,52,39,1
19985,621,285,336,100,75,90,27,549,273,276,74,68,72,24,1
19986,245,137,108,34,30,19,10,462,251,211,74,53,41,18,1
19987,724,650,74,44,3,32,3,267,159,108,31,13,22,15,1
19988,928,442,486,139,118,91,43,331,169,162,40,28,22,14,1
19989,382,179,203,58,54,29,19,220,102,118,26,32,27,10,1
19990,1074,538,536,154,140,111,51,724,334,390,112,109,79,17,1
19991,1268,612,656,218,195,89,33,1226,594,632,189,142,120,47,1
19992,216,119,97,33,27,28,7,1149,568,581,177,133,101,30,1
19993,541,269,272,75,57,59,36,148,64,84,33,19,6,1,1
19994,1154,540,614,195,160,138,66,632,339,293,83,77,59,20,1
19995,1050,482,568,136,154,101,41,949,512,437,102,124,70,41,1
19996,303,175,128,43,36,34,12,503,263,240,72,55,51,34,1
19997,2541,1299,1242,306,302,121,98,377,202,175,46,50,41,23,1
19998,352,189,163,42,31,33,19,513,274,239,67,66,62,35,1
19999,575,318,257,65,65,70,24,1332,626,706,182,144,80,41,1
20000,1117,423,694,182,134,88,31,2472,1057,1415,331,352,159,96,1
20001,351,184,167,59,45,54,9,656,336,320,86,90,73,37,1
20002,210,84,126,44,43,9,4,427,210,217,64,66,45,24,1
20003,186,103,83,28,20,27,6,315,118,197,85,57,42,14,1
20004,204,119,85,28,18,27,8,218,127,91,27,23,23,10,1
20005,630,351,279,88,72,90,17,467,224,243,70,43,67,23,1
20006,907,475,432,124,92,65,14,3530,1947,1583,530,360,410,110,1
20007,822,416,406,111,105,84,44,288,158,130,59,23,21,10,1
20008,455,218,237,57,51,42,35,854,380,474,137,159,81,31,1
20009,626,291,335,83,93,50,17,648,307,341,101,58,76,34,1
20010,381,172,209,73,56,36,13,375,202,173,46,49,41,23,1
20011,520,272,248,74,71,44,15,480,234,246,79,77,65,23,1
20012,2471,1130,1341,240,281,219,290,1156,519,637,104,62,66,45,1
20013,745,366,379,110,93,79,45,673,318,355,61,71,40,31,1
20014,1035,559,476,128,122,122,50,314,108,206,45,75,34,8,1
20015,815,418,397,97,62,70,17,413,240,173,57,34,76,27,1
20016,825,363,462,97,105,72,75,592,283,309,84,137,60,20,1
20017,387,200,187,61,54,51,16,758,362,396,115,102,35,13,1
20018,530,261,269,71,65,49,33,2758,1332,1426,394,384,287,131,1
20019,709,359,350,107,102,65,20,698,365,333,108,83,65,21,1
20020,419,189,230,64,49,36,15,1432,652,780,217,205,131,81,1
20021,639,287,352,111,108,44,9,1332,652,680,210,180,155,49,1
20022,226,129,97,20,25,26,11,353,195,158,40,55,30,13,1
20023,412,202,210,64,46,43,34,501,293,208,58,58,64,14,1
20024,306,128,178,49,59,17,9,1093,568,525,149,131,128,38,1
20025,348,169,179,44,33,35,18,294,153,141,33,20,33,13,1
20026,199,87,112,31,27,8,15,373,204,169,43,45,13,14,1
20027,589,314,275,70,83,44,28,189,109,80,26,24,9,8,1
20028,2442,1193,1249,278,183,170,145,236,140,96,20,39,12,6,1
20029,156,64,92,39,19,15,8,465,225,240,65,44,65,25,1
20030,541,269,272,75,57,59,36,609,279,330,103,98,72,42,1
20031,666,344,322,91,73,91,20,448,198,250,77,66,37,20,1
20032,648,307,341,101,58,76,34,1154,540,614,195,160,138,66,1
20033,276,118,158,38,40,16,10,721,379,342,89,73,68,25,1
20034,815,418,397,97,62,70,17,2061,822,1239,312,324,170,85,1
20035,331,183,148,36,44,40,21,216,102,114,31,29,21,6,1
20036,239,146,93,30,22,35,9,351,184,167,59,45,54,9,1
20037,391,208,183,65,49,57,17,854,380,474,137,159,81,31,1
20038,221,110,111,28,32,25,11,447,232,215,55,65,50,25,1
20039,430,192,238,62,67,27,10,1210,592,618,157,138,116,85,1
20040,876,457,419,88,124,67,47,168,67,101,37,17,13,13,1
20041,331,145,186,40,56,16,9,336,154,182,51,48,39,22,1
20042,309,154,155,42,44,45,16,858,461,397,125,114,79,45,1
20043,738,339,399,102,88,68,35,781,418,363,92,90,64,41,1
20044,2639,1436,1203,317,307,242,77,191,99,92,25,24,18,8,1
20045,313,148,165,45,33,36,11,2442,1193,1249,278,183,170,145,1
20046,345,203,142,47,35,31,11,358,212,146,51,36,33,9,1
20047,700,348,352,93,115,85,27,689,343,346,119,100,86,38,1
20048,585,312,273,57,64,77,25,212,127,85,28,21,26,6,1
20049,367,217,150,51,30,24,12,489,242,247,83,63,62,19,1
20050,924,441,483,131,115,90,38,725,365,360,104,111,70,31,1
20051,224,108,116,31,32,22,8,654,344,310,80,69,57,15,1
20052,673,317,356,101,85,76,49,468,260,208,60,44,55,17,1
20053,146,83,63,19,12,13,8,331,165,166,52,34,48,22,1
20054,582,293,289,94,80,77,32,351,183,168,55,44,33,9,1
20055,411,171,240,61,81,30,15,1441,657,784,140,135,81,73,1
20056,829,396,433,141,82,93,36,648,307,341,101,58,76,34,1
20057,459,221,238,52,56,51,19,1124,615,509,157,125,128,52,1
20058,870,433,437,133,121,95,25,1464,715,749,200,167,181,70,1
20059,1608,924,684,163,133,89,29,1338,506,832,241,229,101,40,1
20060,207,108,99,25,15,27,16,991,483,508,166,120,94,42,1
20061,206,100,106,34,26,11,7,671,303,368,93,68,61,26,1
20062,1204,623,581,144,146,119,83,2090,1085,1005,167,141,168,40,1
20063,692,326,366,103,121,67,27,404,197,207,57,69,33,15,1
20064,592,275,317,100,86,57,31,126,66,60,24,10,7,9,1
20065,504,252,252,65,55,51,14,684,311,373,109,99,66,16,1
20066,1030,495,535,154,106,116,49,1292,592,700,186,169,108,22,1
20067,261,144,117,34,22,31,15,810,367,443,115,92,94,59,1
20068,204,99,105,32,32,22,10,724,334,390,112,109,79,17,1
20069,1893,850,1043,280,340,169,80,330,143,187,63,29,52,20,1
20070,352,166,186,55,59,31,16,864,429,435,129,118,68,35,1
20071,686,375,311,89,80,63,20,1192,579,613,120,215,79,24,1
20072,469,225,244,64,69,26,11,641,324,317,88,92,49,14,1
20073,341,178,163,48,44,42,20,233,121,112,24,31,30,7,1
20074,462,228,234,59,47,37,32,1581,684,897,220,153,118,63,1
20075,698,345,353,104,87,81,50,328,182,146,47,35,21,29,1
20076,885,424,461,143,114,92,32,228,130,98,27,28,21,19,1
20077,720,357,363,113,85,62,39,293,153,140,45,38,22,15,1
20078,1078,557,521,116,114,144,44,838,380,458,114,95,68,57,1
20079,624,204,420,166,101,32,13,644,343,301,96,69,59,28,1
20080,545,230,315,91,101,50,16,781,418,363,92,90,64,41,1
20081,513,271,242,54,52,44,13,148,63,85,23,22,7,7,1
20082,189,90,99,26,29,17,11,1032,565,467,133,81,135,49,1
20083,220,113,107,37,24,16,7,2524,1232,1292,398,317,186,61,1
20084,511,202,309,70,84,37,21,633,303,330,95,91,51,13,1
20085,183,78,105,30,31,26,8,652,272,380,116,113,55,27,1
20086,1432,652,780,217,205,131,81,616,304,312,75,71,55,25,1
20087,253,123,130,40,46,15,4,208,104,104,20,54,9,5,1
20088,270,143,127,35,21,29,9,635,333,302,99,75,83,28,1
20089,593,291,302,81,85,56,20,627,289,338,101,73,62,43,1
20090,380,227,153,36,30,48,25,374,181,193,63,49,46,20,1
20091,770,356,414,123,102,66,25,1194,543,651,190,197,65,43,1
20092,615,356,259,90,56,97,19,586,240,346,94,110,29,19,1
20093,125,46,79,24,16,12,2,347,198,149,45,29,29,8,1
20094,1484,731,753,206,175,187,71,1290,629,661,191,187,167,55,1
20095,397,194,203,45,47,38,14,233,120,113,38,32,20,15,1
20096,358,205,153,40,22,39,24,190,96,94,21,17,23,10,1
20097,715,355,360,118,79,71,29,425,199,226,54,71,56,11,1
20098,1907,1008,899,235,224,195,73,684,288,396,107,90,54,42,1
20099,108,59,49,17,13,12,5,5038,2652,2386,655,729,544,245,1
20100,930,367,563,181,153,83,48,639,368,271,72,51,38,38,1
20101,646,298,348,91,110,63,33,1270,682,588,165,147,136,54,1
20102,792,407,385,110,132,82,43,418,248,170,41,31,54,9,1
20103,445,202,243,70,73,51,15,650,304,346,80,106,62,28,1
20104,104,52,52,18,14,17,4,205,104,101,28,28,35,13,1
20105,267,147,120,37,28,35,12,354,193,161,51,41,58,13,1
20106,1723,788,935,177,156,127,48,601,313,288,42,48,25,36,1
20107,280,127,153,53,36,12,6,344,181,163,61,37,40,14,1
20108,576,250,326,93,71,34,15,480,244,236,74,47,50,21,1
20109,413,236,177,41,25,35,19,277,124,153,44,40,35,18,1
20110,151,83,68,18,19,17,7,354,166,188,53,55,40,19,1
20111,313,157,156,39,26,34,29,2843,1104,1739,429,357,178,95,1
20112,178,100,78,23,22,30,6,318,164,154,44,35,35,17,1
20113,573,316,257,78,80,21,21,1066,587,479,127,108,118,48,1
20114,410,200,210,60,54,46,19,2442,1193,1249,278,183,170,145,1
20115,420,197,223,72,57,54,19,1272,520,752,235,242,117,54,1
20116,748,355,393,121,91,95,26,535,249,286,79,64,55,22,1
20117,170,83,87,23,32,17,9,108,59,49,17,13,12,5,1
20118,316,157,159,45,38,22,19,2414,1189,1225,277,178,170,169,1
20119,351,184,167,59,45,54,9,1112,555,557,139,137,124,48,1
20120,825,422,403,100,90,62,43,157,79,78,24,26,19,7,1
20121,104,52,52,18,14,17,4,632,326,306,92,71,56,19,1
20122,770,385,385,78,83,60,16,217,109,108,34,32,35,7,1
20123,475,238,237,73,53,63,17,4544,2024,2520,579,628,480,403,1
20124,345,203,142,47,35,31,11,2442,1193,1249,278,183,170,145,1
20125,858,398,460,126,138,75,39,417,232,185,58,50,29,21,1
20126,356,142,214,55,47,29,16,2342,933,1409,330,354,199,108,1
20127,800,416,384,102,105,83,22,1085,646,439,108,65,36,19,1
20128,362,183,179,49,49,41,11,119,57,62,18,16,17,4,1
20129,352,212,140,37,17,61,20,1132,553,579,172,143,150,57,1
20130,1616,735,881,285,248,153,72,441,201,240,70,58,55,24,1
20131,298,167,131,47,33,40,8,320,163,157,44,44,26,15,1
20132,321,180,141,47,37,33,12,826,362,464,107,118,71,43,1
20133,195,100,95,27,20,17,11,291,146,145,39,45,22,16,1
20134,1099,586,513,134,145,97,36,552,285,267,74,51,69,24,1
20135,471,254,217,56,57,43,11,589,294,295,37,44,27,33,1
20136,435,187,248,62,51,51,21,576,250,326,93,71,34,15,1
20137,480,256,224,67,55,26,22,598,278,320,95,66,48,24,1
20138,360,188,172,49,48,47,17,473,217,256,59,44,34,21,1
20139,281,128,153,47,43,22,14,191,72,119,40,41,17,8,1
20140,639,298,341,77,61,70,20,193,83,110,26,20,16,9,1
20141,1130,639,491,87,188,57,41,595,316,279,86,60,65,40,1
20142,1591,734,857,229,225,171,75,288,118,170,50,57,18,15,1
20143,291,159,132,36,29,20,10,1144,622,522,140,128,132,65,1
20144,639,310,329,91,94,46,15,304,125,179,61,31,44,10,1
20145,369,200,169,42,46,39,16,323,181,142,40,37,26,16,1
20146,309,154,155,42,44,45,16,393,186,207,58,50,36,22,1
20147,236,145,91,17,19,30,18,673,317,356,101,85,76,49,1
20148,168,67,101,37,17,13,13,470,227,243,70,66,53,15,1
20149,244,135,109,36,24,20,10,308,171,137,40,29,24,11,1
20150,1691,1217,474,130,115,73,46,359,184,175,49,35,32,11,1
20151,461,207,254,82,66,55,33,1235,584,651,140,226,82,52,1
20152,345,141,204,64,58,13,11,641,324,317,88,92,49,14,1
20153,168,67,101,37,17,13,13,272,125,147,41,41,22,13,1
20154,150,79,71,19,29,19,6,58,23,35,14,8,5,7,1
20155,605,352,253,69,59,54,15,297,145,152,49,30,23,21,1
20156,686,345,341,98,106,75,25,323,159,164,49,28,38,22,1
20157,563,313,250,56,47,73,14,1132,624,508,199,79,127,41,1
20158,303,137,166,54,54,31,15,422,222,200,51,61,36,14,1
20159,154,75,79,17,24,16,13,624,334,290,35,40,26,31,1
20160,981,465,516,126,164,112,38,1992,927,1065,292,228,166,77,1
20161,380,187,193,38,51,30,18,446,265,181,51,35,27,17,1
20162,575,293,282,78,64,40,13,641,324,317,88,92,49,14,1
20163,436,235,201,62,45,56,17,245,111,134,31,44,20,11,1
20164,814,403,411,112,140,94,23,551,299,252,51,62,63,17,1
20165,594,274,320,89,63,66,28,393,210,183,55,50,34,19,1
20166,480,234,246,79,77,65,23,416,210,206,55,54,39,20,1
20167,379,203,176,55,48,45,16,1177,666,511,131,99,88,35,1
20168,391,208,183,65,49,57,17,376,176,200,31,53,27,8,1
20169,724,334,390,112,109,79,17,1114,581,533,145,132,126,54,1
20170,1016,495,521,138,138,94,50,3661,1791,1870,463,425,340,151,1
20171,299,153,146,32,28,29,12,2041,1035,1006,223,274,125,60,1
20172,130,71,59,30,9,8,1,224,123,101,23,24,33,6,1
20173,462,233,229,66,49,43,30,1690,810,880,248,238,168,67,1
20174,1001,417,584,186,147,96,47,758,338,420,132,87,67,29,1
20175,568,292,276,69,74,59,34,178,91,87,20,21,12,5,1
20176,440,250,190,51,35,64,27,404,197,207,57,69,33,15,1
20177,189,90,99,26,29,17,11,724,334,390,112,109,79,17,1
20178,989,513,476,125,106,92,60,468,233,235,65,61,49,34,1
20179,293,134,159,40,27,23,30,501,240,261,80,62,49,42,1
20180,360,188,172,49,48,47,17,350,180,170,64,46,55,12,1
20181,499,290,209,59,50,50,19,433,237,196,60,52,33,27,1
20182,2715,1239,1476,434,417,241,116,1425,670,755,153,189,122,85,1
20183,592,291,301,92,93,71,31,1212,645,567,145,117,122,72,1
20184,559,274,285,75,63,52,16,136,66,70,33,11,9,5,1
20185,391,201,190,52,47,35,24,105,51,54,13,17,12,8,1
20186,1290,597,693,182,182,119,63,315,169,146,51,49,27,9,1
20187,358,204,154,57,41,36,14,367,161,206,70,48,41,19,1
20188,394,207,187,52,42,37,24,427,218,209,61,53,45,26,1
20189,479,227,252,65,79,42,26,419,175,244,71,73,23,23,1
20190,903,437,466,117,112,108,32,1190,638,552,162,95,112,18,1
20191,1473,758,715,205,171,161,65,416,210,206,55,54,39,20,1
20192,476,218,258,69,51,71,34,439,177,262,78,73,40,21,1
20193,672,334,338,110,93,91,41,214,108,106,53,20,27,15,1
20194,393,186,207,58,50,36,22,63,29,34,13,10,4,8,1
20195,398,196,202,61,45,34,18,904,436,468,138,146,82,39,1
20196,540,265,275,87,59,74,25,1089,544,545,138,160,117,43,1
20197,369,216,153,36,22,46,23,724,334,390,112,109,79,17,1
20198,331,177,154,46,38,49,17,217,94,123,29,30,23,17,1
20199,502,240,262,78,61,54,32,1038,470,568,130,123,86,51,1
20200,247,110,137,34,45,23,10,282,105,177,77,28,39,6,1
20201,789,386,403,95,124,83,25,814,450,364,91,114,69,12,1
20202,647,282,365,104,90,53,27,875,376,499,155,125,53,39,1
20203,873,366,507,127,125,75,21,393,186,207,58,50,36,22,1
20204,920,492,428,100,92,88,49,401,204,197,49,33,29,17,1
20205,592,291,301,92,93,71,31,1113,480,633,170,173,81,34,1
20206,833,452,381,117,85,71,39,486,229,257,75,104,49,10,1
20207,646,316,330,89,95,48,17,248,129,119,26,46,21,6,1
20208,1039,597,442,101,110,106,33,1366,943,423,137,109,58,19,1
20209,767,392,375,113,112,83,13,1205,632,573,156,149,102,48,1
20210,281,125,156,44,47,17,7,386,163,223,51,51,28,14,1
20211,138,72,66,15,10,21,19,764,409,355,88,73,102,43,1
20212,235,135,100,30,13,25,11,358,179,179,49,48,49,8,1
20213,619,293,326,98,78,65,22,399,208,191,57,46,41,20,1
20214,2414,1189,1225,277,178,170,169,298,161,137,47,29,25,15,1
20215,583,322,261,73,66,45,26,1095,530,565,157,151,98,34,1
20216,416,210,206,55,54,39,20,1447,751,696,161,143,131,46,1
20217,536,278,258,72,63,62,20,527,263,264,81,63,72,31,1
20218,803,346,457,126,171,74,24,350,180,170,64,46,55,12,1
20219,671,318,353,83,124,46,34,396,197,199,75,49,49,16,1
20220,466,186,280,71,84,30,11,226,100,126,32,33,21,11,1
20221,212,88,124,46,24,22,16,601,313,288,42,48,25,36,1
20222,914,453,461,112,115,79,29,1834,823,1011,297,282,151,63,1
20223,963,385,578,171,162,62,35,245,111,134,31,44,20,11,1
20224,380,184,196,58,52,46,8,464,242,222,61,68,36,17,1
20225,272,173,99,32,32,11,8,775,443,332,109,86,86,20,1
20226,308,129,179,44,60,19,8,559,317,242,58,65,37,23,1
20227,297,158,139,47,37,37,9,179,76,103,36,32,9,9,1
20228,1201,557,644,151,125,117,50,415,203,212,77,44,49,18,1
20229,184,86,98,26,26,14,11,772,323,449,174,108,68,22,1
20230,1577,747,830,213,232,147,57,641,324,317,88,92,49,14,1
20231,184,78,106,21,25,25,12,522,235,287,78,67,60,50,1
20232,309,154,155,42,44,45,16,605,295,310,74,66,70,36,1
20233,1132,646,486,99,102,71,41,309,184,125,40,23,48,14,1
20234,183,89,94,19,24,22,15,1670,1140,530,173,120,89,53,1
20235,313,159,154,30,40,23,14,638,305,333,68,90,70,29,1
20236,387,249,138,44,14,48,22,123,67,56,18,15,10,3,1
20237,586,270,316,83,80,59,21,934,472,462,119,122,87,39,1
20238,582,328,254,78,48,35,9,160,53,107,31,29,13,3,1
20239,502,240,262,78,61,54,32,342,177,165,42,44,45,20,1
20240,1050,473,577,142,119,87,54,778,367,411,90,85,64,43,1
20241,202,102,100,29,35,6,9,414,212,202,65,52,32,17,1
20242,454,223,231,38,45,24,19,358,170,188,54,55,20,10,1
20243,396,223,173,57,37,44,19,473,270,203,63,34,44,18,1
20244,414,212,202,65,52,32,17,3312,1761,1551,403,345,309,127,1
20245,568,243,325,98,73,56,44,277,122,155,33,33,25,24,1
20246,876,473,403,110,106,73,24,757,359,398,109,127,80,26,1
20247,425,177,248,60,62,33,16,419,175,244,71,73,23,23,1
20248,372,189,183,60,44,41,18,359,150,209,57,75,29,12,1
20249,303,175,128,43,36,34,12,928,442,486,139,118,91,43,1
20250,464,167,297,90,81,33,9,360,192,168,55,45,48,16,1
20251,466,199,267,86,59,32,17,261,130,131,27,41,19,16,1
20252,446,252,194,41,23,54,35,149,68,81,15,38,11,10,1
20253,468,242,226,58,42,49,19,212,102,110,25,24,17,10,1
20254,14507,6188,8319,1128,1263,895,394,135,73,62,15,16,15,8,1
20255,1960,810,1150,358,377,121,72,757,359,398,109,127,80,26,1
20256,927,451,476,141,147,69,34,742,303,439,88,96,86,23,1
20257,291,141,150,50,29,35,7,770,390,380,104,76,78,32,1
20258,229,105,124,36,33,12,4,896,407,489,97,152,70,22,1
20259,256,125,131,34,27,24,14,839,427,412,91,83,114,37,1
20260,651,306,345,85,64,61,32,570,261,309,78,72,60,23,1
20261,758,360,398,114,107,51,19,377,158,219,80,68,26,14,1
20262,822,416,406,111,105,84,44,217,109,108,34,32,35,7,1
20263,707,320,387,86,115,59,23,930,367,563,181,153,83,48,1
20264,209,89,120,41,35,17,3,402,227,175,48,40,35,11,1
20265,181,75,106,35,26,11,9,169,64,105,23,37,11,3,1
20266,807,359,448,114,99,93,33,906,455,451,116,105,87,46,1
20267,744,383,361,104,80,66,28,911,423,488,140,150,102,32,1
20268,589,316,273,83,60,69,25,643,282,361,94,109,59,24,1
20269,2871,1148,1723,496,469,204,98,564,284,280,71,64,41,13,1
20270,513,260,253,71,50,58,23,513,274,239,67,66,62,35,1
20271,461,287,174,56,27,82,25,351,159,192,58,35,35,31,1
20272,476,233,243,76,61,52,21,490,198,292,65,81,39,27,1
20273,377,177,200,63,53,44,16,367,217,150,49,18,52,21,1
20274,299,128,171,57,40,13,25,124,62,62,17,14,7,5,1
20275,799,415,384,81,121,71,19,781,418,363,92,90,64,41,1
20276,651,306,345,85,64,61,32,407,207,200,53,36,38,8,1
20277,1356,672,684,171,172,134,59,854,380,474,137,159,81,31,1
20278,481,249,232,72,72,58,15,164,88,76,27,20,17,6,1
20279,395,197,198,44,57,27,18,153,109,44,10,7,35,5,1
20280,673,317,356,101,85,76,49,248,120,128,40,30,36,11,1
20281,360,192,168,55,45,48,16,452,256,196,32,44,27,11,1
20282,672,334,338,110,93,91,41,147,68,79,31,23,8,4,1
20283,714,282,432,119,128,69,15,172,74,98,32,30,11,7,1
20284,330,159,171,48,38,50,19,2961,1467,1494,392,384,307,154,1
20285,251,178,73,21,12,50,12,806,419,387,115,130,57,32,1
20286,492,238,254,72,56,49,20,217,109,108,34,32,35,7,1
20287,245,122,123,21,32,18,13,345,169,176,57,50,32,15,1
20288,556,269,287,86,66,62,22,748,386,362,111,75,71,40,1
20289,180,115,65,17,12,9,9,266,139,127,33,26,34,12,1
20290,442,230,212,50,58,56,23,407,230,177,53,42,34,20,1
20291,171,94,77,24,28,30,11,392,115,277,117,75,28,17,1
20292,193,88,105,29,32,25,9,815,418,397,97,62,70,17,1
20293,467,201,266,71,70,63,27,145,70,75,24,16,16,20,1
20294,261,143,118,33,24,32,16,464,231,233,65,62,49,21,1
20295,656,358,298,67,47,64,26,245,181,64,6,6,25,8,1
20296,171,94,77,24,28,30,11,769,329,440,116,66,55,22,1
20297,656,358,298,67,47,64,26,176,73,103,22,29,13,9,1
20298,548,309,239,73,62,54,13,215,80,135,54,56,21,9,1
20299,163,71,92,22,38,11,7,471,229,242,65,81,65,27,1
20300,375,202,173,46,49,41,23,383,204,179,61,32,54,16,1
20301,175,90,85,28,21,19,7,714,364,350,98,102,91,27,1
20302,911,423,488,140,150,102,32,901,443,458,134,141,88,40,1
20303,316,141,175,48,46,34,16,98,32,66,15,25,5,4,1
20304,218,127,91,27,23,23,10,298,184,114,45,22,45,12,1
20305,204,103,101,16,32,22,8,369,180,189,62,70,24,21,1
20306,551,298,253,63,65,45,19,729,358,371,116,99,89,33,1
20307,1257,647,610,156,146,145,35,1881,929,952,259,247,158,57,1
20308,1290,629,661,191,187,167,55,938,484,454,137,100,104,41,1
20309,283,172,111,39,31,29,8,654,344,310,80,69,57,15,1
20310,379,203,176,48,38,44,11,926,435,491,133,132,85,17,1
20311,4655,2074,2581,545,652,562,399,431,201,230,69,39,55,33,1
20312,427,218,209,61,53,45,26,210,121,89,22,23,23,7,1
20313,1573,791,782,198,173,148,46,987,515,472,107,110,106,61,1
20314,365,173,192,47,47,29,14,819,411,408,108,86,90,58,1
20315,832,428,404,131,89,88,38,462,228,234,59,47,37,32,1
20316,855,422,433,109,97,109,50,397,237,160,47,15,56,21,1
20317,462,251,211,74,53,41,18,89,42,47,16,12,15,6,1
20318,1140,495,645,129,95,128,159,435,221,214,72,45,47,19,1
20319,391,208,183,65,49,57,17,459,221,238,72,78,47,16,1
20320,702,387,315,100,89,128,25,483,268,215,65,56,55,23,1
20321,546,267,279,90,69,56,19,136,66,70,33,11,9,3,1
20322,5938,2573,3365,858,958,396,195,1925,1022,903,237,196,185,99,1
20323,611,246,365,116,82,71,27,1336,724,612,209,141,133,60,1
20324,501,240,261,80,62,49,42,263,146,117,30,26,25,5,1
20325,563,285,278,79,66,48,27,193,99,94,31,31,16,12,1
20326,289,125,164,51,55,17,10,100,51,49,13,11,7,4,1
20327,2261,1217,1044,271,243,267,101,1163,493,670,214,158,106,42,1
20328,810,367,443,115,92,94,59,529,314,215,59,64,39,14,1
20329,419,175,244,71,73,23,23,546,207,339,103,98,26,18,1
20330,168,76,92,26,21,19,4,175,91,84,19,21,21,10,1
20331,870,489,381,97,99,76,14,860,427,433,132,100,81,30,1
20332,672,334,338,110,93,91,41,505,244,261,77,65,56,22,1
20333,586,273,313,100,79,40,19,361,174,187,63,56,38,16,1
20334,660,359,301,81,87,102,31,2944,1827,1117,338,332,122,35,1
20335,1149,568,581,177,133,101,30,416,182,234,62,67,37,17,1
20336,317,164,153,47,33,47,12,317,153,164,34,52,30,14,1
20337,287,154,133,33,27,36,15,309,154,155,42,44,45,16,1
20338,320,159,161,44,54,29,9,1487,996,491,147,141,50,35,1
20339,183,97,86,30,18,20,12,1367,690,677,172,175,154,83,1
20340,330,157,173,56,42,51,8,219,124,95,22,22,23,5,1
20341,467,226,241,55,48,54,23,822,417,405,111,127,76,34,1
20342,384,238,146,38,26,66,19,92,44,48,6,8,9,8,1
20343,769,329,440,116,66,55,22,1523,758,765,188,183,157,58,1
20344,651,311,340,110,77,73,33,802,344,458,156,136,57,24,1
20345,1150,463,687,198,204,84,35,522,245,277,78,69,52,21,1
20346,632,350,282,82,58,111,42,767,392,375,113,112,83,13,1
20347,477,279,198,60,34,73,23,180,77,103,30,29,23,5,1
20348,639,287,352,111,108,44,9,1241,670,571,135,139,110,32,1
20349,777,408,369,100,96,56,17,611,246,365,116,82,71,27,1
20350,1251,635,616,155,215,101,48,2273,1248,1025,260,243,281,99,1
20351,296,147,149,44,27,33,18,467,226,241,55,48,54,23,1
20352,101,45,56,17,17,12,9,357,147,210,48,37,21,47,1
20353,631,376,255,74,53,87,27,111,51,60,20,21,10,11,1
20354,640,328,312,94,92,86,20,2270,1179,1091,320,246,268,115,1
20355,732,385,347,95,69,93,34,178,80,98,34,13,16,11,1
20356,501,240,261,80,62,49,42,277,141,136,35,21,16,22,1
20357,283,142,141,35,29,32,5,737,363,374,119,101,85,41,1
20358,2541,1299,1242,306,302,121,98,825,363,462,97,105,72,75,1
20359,334,190,144,42,42,16,5,1469,742,727,213,173,93,29,1
20360,509,262,247,64,70,64,20,583,322,261,73,66,45,26,1
20361,457,194,263,66,108,20,12,810,367,443,115,92,94,59,1
20362,246,128,118,39,34,22,7,592,283,309,84,137,60,20,1
20363,424,188,236,55,75,39,31,421,192,229,72,54,51,48,1
20364,400,203,197,30,36,31,10,140,86,54,17,6,20,7,1
20365,486,229,257,75,104,49,10,341,190,151,50,41,23,15,1
20366,67,34,33,10,12,6,5,340,169,171,40,39,36,22,1
20367,177,99,78,22,23,20,10,452,256,196,32,44,27,11,1
20368,585,314,271,80,64,85,28,317,153,164,39,30,35,13,1
20369,1308,652,656,166,153,149,87,540,306,234,74,52,43,22,1
20370,215,91,124,23,39,5,5,467,250,217,59,52,41,19,1
20371,185,83,102,30,19,21,8,4544,2024,2520,579,628,480,403,1
20372,81,41,40,15,13,3,2,745,354,391,116,100,95,46,1
20373,546,267,279,90,69,56,19,663,360,303,88,82,80,35,1
20374,1013,532,481,163,109,85,41,377,202,175,46,50,41,22,1
20375,655,328,327,65,54,55,35,462,228,234,59,47,37,32,1
20376,298,160,138,37,30,22,12,310,156,154,27,43,20,6,1
20377,1140,586,554,130,146,117,49,424,198,226,57,46,41,19,1
20378,318,212,106,16,15,41,16,297,160,137,46,38,41,10,1
20379,239,126,113,49,18,27,5,293,169,124,52,22,25,12,1
20380,1098,519,579,182,159,79,42,639,368,271,72,51,38,38,1
20381,283,159,124,41,21,39,17,226,128,98,32,18,37,16,1
20382,399,208,191,57,46,41,20,2725,1490,1235,339,333,254,78,1
20383,2871,1218,1653,290,374,238,414,4391,2256,2135,494,411,423,231,1
20384,408,179,229,86,72,32,5,651,306,345,85,64,61,32,1
20385,581,254,327,100,83,54,20,2414,1189,1225,277,178,170,169,1
20386,235,111,124,38,26,31,22,625,286,339,92,59,83,42,1
20387,955,465,490,137,138,119,28,154,75,79,28,23,16,6,1
20388,141,68,73,25,20,12,6,290,130,160,47,43,32,11,1
20389,1019,402,617,154,165,53,46,356,199,157,43,58,29,12,1
20390,1647,794,853,279,235,128,65,422,228,194,26,20,48,37,1
20391,2214,993,1221,361,324,190,74,595,289,306,87,62,84,40,1
20392,282,171,111,30,38,15,8,854,399,455,127,118,57,39,1
20393,462,251,211,74,53,41,18,309,137,172,51,50,28,14,1
20394,440,235,205,34,61,36,13,603,311,292,102,71,66,23,1
20395,624,308,316,92,72,68,22,1333,646,687,209,179,148,45,1
20396,815,418,397,97,62,70,17,168,120,48,7,5,20,7,1
20397,756,366,390,83,146,47,23,218,102,116,32,31,21,4,1
20398,382,183,199,55,60,38,22,467,226,241,55,48,54,23,1
20399,186,98,88,26,24,27,8,928,442,486,139,118,91,43,1
20400,262,144,118,19,39,22,8,561,292,269,88,68,64,22,1
20401,360,192,168,55,45,48,16,778,367,411,90,85,64,43,1
20402,737,363,374,119,101,85,41,766,386,380,101,81,78,31,1
20403,2946,1499,1447,365,342,315,119,1038,470,568,130,123,86,51,1
20404,670,333,337,95,79,62,21,382,183,199,55,60,38,22,1
20405,126,57,69,31,10,10,3,577,277,300,71,59,64,24,1
20406,626,357,269,81,61,51,26,246,108,138,32,44,21,10,1
20407,557,268,289,66,67,70,17,509,262,247,64,70,64,20,1
20408,535,251,284,65,78,47,20,192,106,86,27,21,20,10,1
20409,183,76,107,34,38,14,8,615,356,259,90,56,97,19,1
20410,1720,856,864,259,224,176,85,251,92,159,29,94,12,6,1
20411,582,293,289,94,80,77,32,1324,609,715,149,119,97,56,1
20412,930,367,563,181,153,83,48,475,235,240,77,58,43,22,1
20413,822,424,398,107,106,86,46,155,74,81,23,19,20,5,1
20414,708,328,380,113,100,82,34,206,94,112,37,36,18,9,1
20415,2442,1193,1249,278,183,170,145,656,358,298,67,47,64,26,1
20416,785,374,411,56,42,38,25,928,442,486,139,118,91,43,1
20417,1190,638,552,162,95,112,18,288,159,129,27,44,27,15,1
20418,351,184,167,59,45,54,9,509,262,247,64,70,64,20,1
20419,647,376,271,73,64,41,23,501,273,228,70,59,30,10,1
20420,146,75,71,13,32,15,11,448,210,238,75,57,22,9,1
20421,159,65,94,30,37,11,8,1147,471,676,229,164,86,37,1
20422,102,49,53,14,21,7,4,95,47,48,13,12,10,4,1
20423,318,176,142,25,32,35,25,383,201,182,44,37,32,51,1
20424,382,183,199,55,60,38,22,724,334,390,112,109,79,17,1
20425,427,191,236,67,60,41,34,99,35,64,25,18,0,1,1
20426,193,99,94,31,31,16,12,503,263,240,72,55,51,34,1
20427,144,69,75,11,21,8,5,400,203,197,30,36,31,10,1
20428,317,153,164,34,52,30,14,596,286,310,90,89,78,37,1
20429,462,251,211,74,53,41,18,142,61,81,28,21,22,9,1
20430,301,150,151,41,30,17,11,651,311,340,94,75,59,22,1
20431,4684,2161,2523,779,782,304,101,2419,1042,1377,389,474,238,59,1
20432,585,322,263,77,66,74,40,737,363,374,119,101,85,41,1
20433,460,251,209,61,48,43,21,724,325,399,98,92,64,24,1
20434,549,244,305,105,79,39,19,757,359,398,109,127,80,26,1
20435,925,484,441,112,86,84,31,431,235,196,64,33,48,20,1
20436,277,153,124,39,33,48,12,1170,510,660,142,182,115,84,1
20437,1477,738,739,176,176,145,72,271,120,151,41,28,38,10,1
20438,496,272,224,70,58,42,18,242,104,138,41,33,37,8,1
20439,750,347,403,105,103,83,29,515,253,262,46,83,57,21,1
20440,1215,572,643,151,105,127,54,686,334,352,107,93,73,43,1
20441,659,325,334,102,85,87,32,592,291,301,92,93,71,31,1
20442,1290,597,693,182,182,119,63,406,216,190,59,56,45,15,1
20443,728,369,359,79,93,97,40,248,130,118,26,28,16,11,1
20444,299,128,171,57,40,13,25,834,335,499,129,110,84,33,1
20445,391,208,183,65,49,57,17,104,48,56,15,15,13,7,1
20446,956,473,483,140,88,89,78,953,481,472,133,130,77,48,1
20447,783,429,354,100,77,54,25,215,105,110,26,22,19,9,1
20448,1074,538,536,154,140,111,51,1210,592,618,157,138,116,85,1
20449,206,94,112,37,36,18,9,181,96,85,25,23,20,7,1
20450,1441,657,784,140,135,81,73,2442,1193,1249,278,183,170,145,1
20451,425,210,215,56,43,52,25,2718,1148,1570,384,286,195,88,1
20452,142,77,65,24,16,12,6,601,313,288,42,48,25,36,1
20453,208,96,112,31,32,13,9,318,145,173,29,38,34,22,1
20454,462,251,211,74,53,41,18,606,296,310,93,73,37,15,1
20455,247,110,137,34,45,23,10,544,255,289,88,77,36,15,1
20456,192,91,101,29,28,17,7,748,355,393,121,91,95,26,1
20457,756,348,408,101,103,60,40,187,96,91,30,24,24,4,1
20458,323,198,125,28,25,34,15,377,224,153,52,23,51,20,1
20459,731,383,348,102,84,68,30,671,326,345,111,77,74,11,1
20460,154,75,79,17,24,16,13,982,494,488,150,117,91,45,1
20461,525,274,251,82,74,60,25,215,115,100,27,28,34,16,1
20462,770,355,415,103,142,75,42,175,86,89,33,25,27,2,1
20463,459,212,247,63,48,48,28,813,440,373,117,93,34,19,1
20464,864,429,435,129,118,68,35,377,184,193,56,53,44,14,1
20465,163,70,93,28,21,17,6,824,392,432,106,89,88,32,1
20466,161,102,59,16,13,11,5,637,321,316,70,96,30,18,1
20467,359,219,140,42,19,56,19,688,330,358,122,97,92,39,1
20468,875,376,499,155,125,53,39,560,260,300,100,58,29,28,1
20469,307,133,174,48,53,27,10,140,66,74,26,23,10,2,1
20470,294,122,172,46,65,18,11,393,186,207,58,50,36,22,1
20471,1532,800,732,212,183,205,71,270,133,137,42,37,34,8,1
20472,727,259,468,163,157,68,15,537,276,261,75,68,68,22,1
20473,368,158,210,64,61,39,14,1290,597,693,182,182,119,63,1
20474,330,143,187,63,29,52,20,596,288,308,77,51,58,30,1
20475,968,452,516,150,144,79,28,624,308,316,92,72,68,22,1
20476,136,65,71,33,11,9,6,313,166,147,47,44,41,10,1
20477,437,241,196,49,48,61,24,3114,1105,2009,505,603,150,122,1
20478,1014,490,524,177,137,94,38,710,307,403,117,176,37,9,1
20479,592,275,317,100,86,57,31,1508,733,775,216,186,172,60,1
20480,1124,615,509,157,125,128,52,1242,613,629,174,113,114,53,1
20481,415,209,206,60,67,39,18,1076,517,559,139,136,72,34,1
20482,245,111,134,31,44,20,11,980,381,599,165,159,57,34,1
20483,596,286,310,90,89,78,37,246,113,133,33,45,22,10,1
20484,533,297,236,74,57,39,28,374,187,187,51,52,40,27,1
20485,438,258,180,49,28,76,28,124,69,55,20,10,5,2,1
20486,151,83,68,18,19,17,7,290,149,141,37,28,42,17,1
20487,522,239,283,75,88,45,11,1382,689,693,186,176,167,77,1
20488,158,85,73,24,18,18,8,103,44,59,16,17,9,5,1
20489,280,97,183,55,48,20,20,465,225,240,65,44,65,25,1
20490,509,341,168,35,32,52,15,892,420,472,135,146,98,37,1
20491,312,173,139,43,47,28,6,322,164,158,46,44,29,7,1
20492,815,418,397,97,62,70,17,2103,985,1118,278,189,140,65,1
20493,146,75,71,13,32,15,11,560,228,332,113,58,79,38,1
20494,522,235,287,78,67,60,50,229,105,124,36,33,12,4,1
20495,2492,894,1598,466,444,164,102,339,183,156,43,45,28,17,1
20496,606,307,299,92,56,68,30,189,90,99,26,29,17,11,1
20497,205,100,105,25,25,20,9,162,86,76,26,19,23,8,1
20498,972,501,471,125,156,106,39,401,167,234,56,71,16,10,1
20499,152,98,54,13,10,21,9,1332,659,673,174,170,153,55,1
20500,1444,671,773,184,187,97,46,503,263,240,72,55,51,34,1
20501,207,124,83,22,19,24,11,1037,537,500,134,118,107,63,1
20502,225,129,96,32,33,20,8,191,99,92,25,24,18,8,1
20503,1691,1159,532,160,109,95,46,707,386,321,85,83,99,28,1
20504,2044,1089,955,267,233,241,109,458,222,236,69,39,35,18,1
20505,486,199,287,79,91,52,18,505,268,237,68,59,34,15,1
20506,518,241,277,87,53,58,30,1937,899,1038,336,332,181,86,1
20507,604,255,349,100,72,55,26,706,320,386,111,76,75,51,1
20508,1342,673,669,178,154,137,94,1207,593,614,151,148,131,95,1
20509,609,292,317,102,96,64,21,684,288,396,107,90,54,42,1
20510,181,75,106,35,26,11,9,425,210,215,56,43,52,25,1
20511,646,316,330,89,95,48,17,364,191,173,47,36,33,16,1
20512,346,208,138,46,39,51,18,140,86,54,17,6,20,7,1
20513,1115,570,545,143,121,113,43,211,83,128,28,35,5,11,1
20514,1278,593,685,198,201,71,43,376,203,173,57,52,48,11,1
20515,1444,671,773,184,187,97,46,1721,809,912,268,234,144,50,1
20516,536,222,314,101,100,34,22,202,102,100,29,35,6,9,1
20517,795,305,490,169,178,66,22,247,110,137,34,45,23,10,1
20518,777,387,390,90,87,65,37,671,318,353,83,124,46,34,1
20519,795,305,490,169,178,66,22,255,122,133,35,51,22,13,1
20520,208,104,104,20,54,9,5,394,212,182,59,42,54,22,1
20521,326,167,159,46,31,38,13,876,457,419,88,124,67,47,1
20522,2063,1024,1039,175,117,80,97,2442,1193,1249,278,183,170,145,1
20523,870,489,381,97,99,76,14,4303,2489,1814,436,369,444,134,1
20524,141,64,77,26,24,10,6,423,218,205,64,55,54,15,1
20525,360,188,172,49,48,47,17,930,477,453,111,92,92,29,1
20526,258,126,132,42,32,19,26,923,509,414,95,102,65,52,1
20527,892,420,472,135,146,98,37,412,260,152,39,24,49,23,1
20528,1335,701,634,163,140,140,64,525,274,251,82,74,60,25,1
20529,854,380,474,137,159,81,31,604,255,349,100,72,55,26,1
20530,150,81,69,24,23,16,4,2961,1467,1494,392,384,307,154,1
20531,646,316,330,89,95,48,17,508,267,241,57,49,40,13,1
20532,624,204,420,166,101,32,13,1014,490,524,177,137,94,38,1
20533,247,110,137,34,45,23,10,759,290,469,135,122,58,21,1
20534,406,195,211,71,58,53,14,211,114,97,32,24,19,10,1
20535,215,115,100,27,28,34,16,576,250,326,93,71,34,15,1
20536,95,44,51,14,13,7,4,355,179,176,51,45,45,11,1
20537,341,167,174,48,47,31,8,177,67,110,34,24,13,10,1
20538,390,191,199,66,49,43,12,570,318,252,77,48,93,26,1
20539,874,431,443,112,120,79,50,511,247,264,75,73,43,24,1
20540,427,218,209,56,57,53,24,1801,889,912,206,263,126,42,1
20541,910,431,479,138,103,98,41,755,348,407,109,98,49,23,1
20542,913,407,506,133,143,80,24,325,159,166,39,40,41,14,1
20543,1140,495,645,129,95,128,159,456,171,285,83,90,17,18,1
20544,262,151,111,30,17,32,25,469,225,244,64,69,26,11,1
20545,476,270,206,62,45,46,30,894,469,425,127,93,82,31,1
20546,601,313,288,42,48,25,36,208,127,81,20,18,25,7,1
20547,404,197,207,57,69,33,15,586,254,332,114,111,55,17,1
20548,537,276,261,75,68,68,22,223,132,91,18,16,27,17,1
20549,178,89,89,26,21,21,10,418,226,192,57,57,53,17,1
20550,596,288,308,77,51,58,30,673,329,344,111,95,92,41,1
20551,454,191,263,61,66,38,15,1025,576,449,111,140,69,32,1
20552,659,325,334,102,85,87,32,998,496,502,149,146,89,27,1
20553,1210,592,618,157,138,116,85,377,202,175,46,50,41,23,1
20554,131,66,65,21,14,23,7,213,109,104,26,26,21,6,1
20555,2328,1054,1274,377,410,232,62,758,362,396,115,102,35,13,1
20556,249,114,135,47,33,25,4,439,205,234,64,88,41,21,1
20557,1836,1051,785,185,221,239,110,926,435,491,133,132,85,17,1
20558,192,101,91,25,22,18,9,447,232,215,55,65,50,25,1
20559,705,421,284,78,58,122,38,798,385,413,120,115,79,30,1
20560,576,250,326,93,71,34,15,421,185,236,73,66,23,13,1
20561,366,204,162,47,41,31,23,393,210,183,58,37,34,20,1
20562,277,144,133,37,21,30,13,491,270,221,51,47,53,18,1
20563,512,261,251,79,73,60,21,1290,629,661,191,187,167,55,1
20564,247,110,137,34,45,23,10,1030,368,662,172,188,56,20,1
20565,870,489,381,97,99,76,14,822,402,420,125,107,82,26,1
20566,692,326,366,103,121,67,27,614,305,309,96,73,65,24,1
20567,196,107,89,20,31,17,4,270,137,133,30,28,27,11,1
20568,323,162,161,44,28,43,14,926,435,491,133,132,85,17,1
20569,1745,1125,620,193,177,88,24,1366,943,423,137,109,58,19,1
20570,407,217,190,50,44,54,19,221,128,93,24,19,15,11,1
20571,373,164,209,51,45,44,21,165,80,85,21,9,18,19,1
20572,326,217,109,32,20,43,18,363,193,170,52,51,41,14,1
20573,280,118,162,35,32,41,37,360,192,168,55,45,48,16,1
20574,154,75,79,17,24,16,13,1304,585,719,179,169,154,47,1
20575,211,113,98,38,17,25,8,256,125,131,34,27,24,14,1
20576,140,70,70,22,17,9,4,294,148,146,35,33,25,14,1
20577,4684,2161,2523,779,782,304,101,377,202,175,46,50,41,22,1
20578,953,481,472,133,130,77,48,211,88,123,38,28,26,10,1
20579,541,269,272,75,57,59,36,1158,481,677,169,129,86,40,1
20580,205,82,123,38,28,20,15,149,68,81,15,38,11,10,1
20581,328,156,172,44,37,44,15,482,231,251,76,81,64,26,1
20582,431,201,230,69,39,55,33,810,367,443,115,92,94,59,1
20583,591,319,272,96,62,43,19,1048,564,484,118,122,113,40,1
20584,900,480,420,108,105,96,30,454,240,214,57,68,39,11,1
20585,182,93,89,24,19,18,8,207,107,100,27,25,20,11,1
20586,427,214,213,65,58,26,18,402,227,175,48,40,35,11,1
20587,351,184,167,59,45,54,9,246,108,138,39,46,27,10,1
20588,427,214,213,65,58,26,18,401,167,234,56,71,16,10,1
20589,1390,695,695,180,137,170,71,277,124,153,44,40,35,18,1
20590,290,127,163,47,58,23,12,1215,652,563,129,142,121,62,1
20591,538,252,286,77,87,53,30,745,366,379,110,93,79,45,1
20592,894,492,402,95,103,88,42,593,266,327,102,84,69,24,1
20593,714,384,330,99,85,95,33,1129,589,540,134,122,108,46,1
20594,193,118,75,20,21,24,6,160,91,69,13,28,11,13,1
20595,77,36,41,18,7,13,9,355,168,187,48,57,30,15,1
20596,292,153,139,39,33,24,21,443,208,235,43,55,51,50,1
20597,325,189,136,44,25,30,14,194,112,82,26,13,17,8,1
20598,454,224,230,71,39,62,22,171,94,77,24,28,30,11,1
20599,2414,1189,1225,277,178,170,169,1149,568,581,177,133,101,30,1
20600,1382,689,693,186,176,167,77,183,97,86,30,18,20,12,1
20601,391,189,202,73,47,37,8,271,159,112,34,34,33,7,1
20602,236,110,126,31,39,10,8,288,118,170,50,57,18,15,1
20603,348,187,161,50,35,44,9,105,51,54,13,17,12,8,1
20604,489,242,247,83,63,62,19,1042,570,472,113,125,91,61,1
20605,734,366,368,121,99,63,39,808,366,442,130,133,66,31,1
20606,272,141,131,45,29,36,9,317,153,164,34,52,30,14,1
20607,609,292,317,102,96,64,21,164,78,86,28,23,12,8,1
20608,673,317,356,101,85,76,49,333,127,206,66,68,25,14,1
20609,525,299,226,54,54,51,19,503,263,240,72,55,51,34,1
20610,425,210,215,56,43,52,25,256,148,108,31,16,29,12,1
20611,1912,977,935,247,226,205,65,802,388,414,101,93,88,35,1
20612,561,292,269,88,68,64,22,847,402,445,137,119,102,41,1
20613,711,344,367,87,109,74,24,1336,633,703,182,197,110,52,1
20614,979,534,445,83,77,80,24,432,190,242,85,82,28,11,1
20615,377,224,153,52,23,51,20,788,360,428,93,106,67,72,1
20616,390,237,153,41,57,22,16,113,79,34,12,4,18,3,1
20617,267,124,143,45,46,26,4,326,182,144,31,32,27,15,1
20618,359,171,188,50,60,21,12,285,109,176,54,80,9,9,1
20619,546,285,261,71,49,47,24,261,130,131,27,41,19,16,1
20620,650,375,275,76,77,92,23,1425,670,755,153,189,122,85,1
20621,497,185,312,63,92,38,28,778,367,411,90,85,64,43,1
20622,512,269,243,69,70,62,29,407,225,182,58,44,44,22,1
20623,485,209,276,78,69,37,30,193,83,110,26,20,16,9,1
20624,403,188,215,70,42,41,11,1863,721,1142,262,283,139,74,1
20625,505,268,237,68,59,34,15,440,255,185,67,28,24,6,1
20626,894,492,402,95,103,88,42,906,455,451,116,105,87,46,1
20627,769,329,440,116,66,55,22,125,66,59,24,16,11,5,1
20628,424,197,227,67,62,43,17,224,103,121,34,47,11,9,1
20629,364,168,196,64,61,27,6,446,176,270,64,79,45,24,1
20630,181,93,88,29,20,26,9,320,163,157,44,44,26,15,1
20631,292,150,142,31,43,39,16,753,361,392,99,94,66,16,1
20632,303,141,162,42,57,37,20,4391,2256,2135,494,411,423,231,1
20633,924,521,403,99,98,62,35,769,362,407,99,88,66,67,1
20634,603,311,292,102,71,66,23,904,436,468,138,146,82,39,1
20635,66,36,30,11,3,5,5,476,305,171,40,33,57,25,1
20636,101,41,60,18,19,10,5,529,264,265,59,68,41,17,1
20637,298,167,131,47,33,40,8,560,260,300,100,58,29,28,1
20638,164,90,74,26,16,19,8,817,427,390,100,97,87,32,1
20639,469,253,216,49,51,48,18,329,171,158,49,41,31,10,1
20640,582,330,252,82,69,87,21,109,50,59,20,7,10,9,1
20641,377,177,200,63,53,44,16,927,451,476,141,147,69,34,1
20642,517,250,267,78,37,64,29,636,320,316,79,61,67,31,1
20643,350,175,175,49,45,44,23,503,263,240,72,55,51,34,1
20644,736,388,348,88,85,67,28,418,248,170,41,31,54,9,1
20645,331,193,138,44,37,18,9,158,74,84,26,23,18,18,1
20646,496,244,252,70,63,50,24,528,268,260,81,77,36,22,1
20647,171,94,77,24,28,30,11,611,246,365,116,82,71,27,1
20648,760,391,369,101,109,65,24,334,181,153,56,31,28,18,1
20649,161,76,85,18,21,13,5,254,107,147,42,37,24,10,1
20650,1861,896,965,265,187,156,70,354,137,217,53,57,30,5,1
20651,168,67,101,37,17,13,13,439,202,237,80,53,35,15,1
20652,1417,598,819,223,188,135,58,1233,498,735,252,232,88,41,1
20653,724,334,390,112,109,79,17,581,323,258,74,58,48,20,1
20654,815,382,433,97,50,88,31,680,308,372,81,72,70,40,1
20655,294,122,172,46,65,18,11,437,212,225,66,44,44,11,1
20656,467,226,241,55,48,54,23,770,385,385,78,83,60,16,1
20657,270,137,133,30,28,27,11,1117,423,694,182,134,88,31,1
20658,536,237,299,116,87,42,17,462,228,234,59,47,37,32,1
20659,460,199,261,72,63,60,9,788,360,428,93,106,67,72,1
20660,490,224,266,80,70,39,32,462,233,229,66,49,43,30,1
20661,796,390,406,105,81,106,39,784,373,411,101,90,91,37,1
20662,154,66,88,31,17,14,9,360,188,172,49,48,47,17,1
20663,393,215,178,44,56,49,15,423,210,213,54,59,50,18,1
20664,122,52,70,24,22,7,6,258,128,130,28,37,27,11,1
20665,287,154,133,33,27,36,15,286,183,103,24,22,29,9,1
20666,258,111,147,46,63,17,6,432,190,242,85,82,28,11,1
20667,1140,495,645,129,95,128,159,1918,868,1050,312,248,198,133,1
20668,388,199,189,50,51,33,14,1675,875,800,213,219,196,72,1
20669,130,71,59,30,9,8,2,452,239,213,62,46,38,22,1
20670,245,112,133,32,45,20,10,505,244,261,77,65,56,22,1
20671,546,267,279,90,69,56,19,837,478,359,101,102,61,31,1
20672,317,153,164,39,30,35,13,508,295,213,42,61,53,17,1
20673,327,172,155,38,41,41,15,1117,423,694,182,134,88,31,1
20674,267,159,108,31,13,22,15,132,65,67,21,9,8,21,1
20675,379,203,176,55,48,45,16,262,150,112,31,33,31,7,1
20676,1204,623,581,144,146,119,83,216,119,97,33,27,28,7,1
20677,326,149,177,51,51,28,10,404,197,207,57,69,33,15,1
20678,906,455,451,116,105,87,46,724,334,390,112,109,79,17,1
20679,1490,655,835,261,174,109,35,930,367,563,181,153,83,48,1
20680,301,172,129,45,34,39,15,147,78,69,22,16,20,4,1
20681,183,95,88,27,22,26,5,465,225,240,65,44,65,25,1
20682,1800,882,918,202,185,186,49,452,239,213,62,46,38,22,1
20683,533,285,248,69,62,87,17,201,101,100,28,28,26,11,1
20684,1577,747,830,213,232,147,57,377,202,175,46,50,41,23,1
20685,117,65,52,15,16,10,4,423,247,176,44,35,67,22,1
20686,240,125,115,34,32,30,8,254,146,108,36,20,34,10,1
20687,150,74,76,21,22,18,7,193,99,94,31,31,16,12,1
20688,379,203,176,55,48,45,16,1430,718,712,205,172,151,64,1
20689,168,76,92,26,21,19,4,245,111,134,31,44,20,11,1
20690,245,112,133,32,45,20,10,641,324,317,88,92,49,14,1
20691,247,110,137,34,45,23,10,862,335,527,136,169,47,28,1
20692,462,233,229,66,49,43,30,297,145,152,49,30,23,21,1
20693,316,157,159,45,38,22,19,461,257,204,63,49,50,29,1
20694,600,281,319,98,68,38,13,464,225,239,85,57,65,19,1
20695,430,192,238,62,67,27,10,1497,881,616,151,117,94,40,1
20696,193,118,75,25,19,10,7,239,146,93,30,22,35,9,1
20697,333,192,141,50,48,28,10,4544,2024,2520,579,628,480,403,1
20698,582,273,309,85,67,34,19,189,88,101,31,29,18,10,1
20699,582,293,289,94,80,77,32,425,198,227,57,69,59,13,1
20700,245,112,133,32,45,20,10,1367,690,677,172,175,154,83,1
20701,1484,731,753,206,175,187,71,714,364,350,98,102,91,27,1
20702,672,334,338,110,93,91,41,1434,727,707,210,173,161,54,1
20703,393,186,207,58,50,36,22,854,380,474,137,159,81,31,1
20704,1575,744,831,228,240,141,42,191,98,93,26,18,19,9,1
20705,1566,743,823,261,188,151,48,604,275,329,95,69,52,25,1
20706,270,147,123,34,17,39,21,826,362,464,107,118,71,43,1
20707,393,186,207,58,50,36,22,170,35,135,33,25,8,5,1
20708,402,227,175,48,40,35,11,136,72,64,22,16,7,3,1
20709,730,328,402,126,99,48,23,737,363,374,119,101,85,41,1
20710,354,188,166,44,31,48,11,1505,681,824,201,204,73,32,1
20711,2414,1189,1225,277,178,170,169,620,348,272,91,43,59,29,1
20712,1210,592,618,157,138,116,85,149,68,81,15,38,11,10,1
20713,264,122,142,33,29,13,13,218,133,85,20,19,13,6,1
20714,609,335,274,79,57,45,22,896,407,489,97,152,70,22,1
20715,1242,613,629,174,113,114,53,1052,587,465,117,121,86,54,1
20716,551,298,253,63,65,45,19,606,279,327,81,70,49,34,1
20717,293,142,151,49,40,42,17,763,354,409,101,90,63,26,1
20718,236,120,116,19,16,23,8,601,313,288,42,48,25,36,1
20719,4377,1898,2479,663,608,331,126,728,288,440,117,137,46,34,1
20720,537,270,267,53,60,56,41,321,154,167,49,49,27,16,1
20721,309,164,145,35,47,30,11,111,53,58,24,21,15,3,1
20722,473,230,243,80,56,52,35,1441,657,784,140,135,81,73,1
20723,467,226,241,55,48,54,23,1314,693,621,174,155,140,58,1
20724,346,193,153,64,27,41,14,299,140,159,27,59,20,18,1
20725,930,367,563,181,153,83,48,247,110,137,34,45,23,10,1
20726,815,382,433,97,50,88,31,729,391,338,80,64,71,34,1
20727,757,373,384,115,93,95,25,440,218,222,58,66,40,24,1
20728,767,392,375,113,112,83,13,499,272,227,49,66,66,21,1
20729,505,247,258,72,71,60,27,729,391,338,80,64,71,34,1
20730,620,305,315,97,80,87,28,675,311,364,111,80,96,30,1
20731,393,186,207,58,50,36,22,422,213,209,63,60,35,13,1
20732,392,156,236,40,91,28,16,485,273,212,92,63,37,8,1
20733,875,376,499,155,125,53,39,326,166,160,49,45,36,12,1
20734,355,169,186,49,37,26,11,295,145,150,41,45,36,18,1
20735,684,288,396,107,90,54,42,1375,695,680,156,173,181,57,1
20736,657,293,364,109,75,66,28,724,320,404,120,147,67,25,1
20737,962,430,532,109,142,61,34,395,195,200,41,55,23,10,1
20738,451,209,242,73,53,47,36,454,220,234,73,46,61,19,1
20739,750,371,379,95,98,86,29,178,80,98,34,13,16,11,1
20740,346,183,163,51,38,23,6,503,263,240,72,55,51,34,1
20741,1336,633,703,182,197,110,52,399,208,191,57,46,41,20,1
20742,453,240,213,46,42,64,17,761,351,410,117,73,103,45,1
20743,974,462,512,145,134,82,37,1484,731,753,206,175,187,71,1
20744,269,134,135,42,35,27,13,290,138,152,37,50,24,14,1
20745,331,169,162,40,28,22,14,320,163,157,44,44,26,15,1
20746,913,412,501,131,100,117,83,1091,543,548,146,136,110,34,1
20747,247,110,137,34,45,23,10,1584,602,982,275,238,110,34,1
20748,346,193,153,64,27,41,14,359,198,161,51,28,54,13,1
20749,212,88,124,46,24,22,16,1132,646,486,99,102,71,41,1
20750,350,180,170,64,46,55,12,205,77,128,31,45,12,11,1
20751,283,142,141,35,29,32,5,145,75,70,22,18,10,5,1
20752,326,170,156,41,39,49,16,503,263,240,72,55,51,34,1
20753,111,29,82,10,54,0,1,261,130,131,27,41,19,16,1
20754,170,81,89,25,24,15,4,460,274,186,50,34,69,27,1
20755,433,222,211,68,58,42,23,755,349,406,131,80,68,28,1
20756,250,137,113,33,19,24,9,283,141,142,32,26,23,26,1
20757,314,178,136,42,32,30,17,360,188,172,49,48,47,17,1
20758,222,106,116,31,27,27,15,480,234,246,79,77,65,23,1
20759,235,135,100,30,13,25,11,135,73,62,15,16,15,8,1
20760,33423,16370,17053,4965,4756,2786,883,894,420,474,136,146,93,39,1
20761,251,144,107,33,23,23,8,521,265,256,69,69,61,26,1
20762,208,96,112,31,32,13,9,538,252,286,77,87,53,30,1
20763,459,221,238,52,76,33,24,462,251,211,74,53,41,18,1
20764,277,124,153,44,40,35,18,215,80,135,54,56,21,9,1
20765,316,157,159,45,38,22,19,291,120,171,63,39,26,6,1
20766,413,194,219,77,72,28,11,546,267,279,90,69,56,19,1
20767,255,130,125,44,18,22,12,425,244,181,38,26,60,26,1
20768,632,285,347,102,78,43,29,845,402,443,137,126,105,47,1
20769,972,519,453,109,98,120,39,1189,559,630,179,147,118,35,1
20770,257,139,118,64,17,24,7,445,231,214,45,64,53,23,1
20771,472,263,209,61,56,56,18,432,218,214,57,55,42,11,1
20772,767,392,375,113,112,83,13,477,301,176,52,35,45,24,1
20773,338,202,136,39,9,31,15,466,186,280,71,84,30,11,1
20774,1154,540,614,195,160,138,66,897,487,410,92,97,83,31,1
20775,259,118,141,21,29,15,23,214,119,95,25,27,18,7,1
20776,540,271,269,80,77,51,16,233,111,122,38,27,17,8,1
20777,435,222,213,67,49,67,12,904,436,468,138,146,82,39,1
20778,724,334,390,112,109,79,17,526,264,262,77,71,61,27,1
20779,676,333,343,111,89,94,39,187,96,91,30,24,24,4,1
20780,896,407,489,97,152,70,22,550,319,231,49,65,35,16,1
20781,671,303,368,93,68,61,26,745,391,354,85,81,52,39,1
20782,191,72,119,40,41,17,8,179,87,92,25,21,22,11,1
20783,350,180,170,64,46,55,12,238,110,128,25,49,26,8,1
20784,504,290,214,60,50,46,21,467,224,243,70,43,67,23,1
20785,351,226,125,29,22,48,19,24,14,10,4,2,1,2,1
20786,150,74,76,21,22,18,7,203,93,110,36,26,18,9,1
20787,304,127,177,61,38,31,4,372,201,171,52,50,42,13,1
20788,1117,556,561,188,117,110,48,536,278,258,72,63,62,20,1
20789,384,216,168,43,50,24,13,424,257,167,41,28,46,27,1
20790,341,190,151,50,41,23,15,418,248,170,41,31,54,9,1
20791,888,478,410,105,73,58,33,859,429,430,126,115,64,33,1
20792,246,120,126,42,27,25,5,264,126,138,44,26,25,10,1
20793,2133,789,1344,342,419,135,88,101,41,60,18,19,10,5,1
20794,465,218,247,64,51,50,42,143,79,64,16,25,7,5,1
20795,344,181,163,61,37,40,14,726,340,386,125,100,60,17,1
20796,1114,581,533,145,132,126,54,211,101,110,40,27,17,12,1
20797,690,320,370,120,99,80,31,193,99,94,31,31,16,12,1
20798,1349,691,658,188,150,151,50,1009,506,503,146,141,97,55,1
20799,605,295,310,74,66,70,36,452,236,216,73,54,50,29,1
20800,2920,1191,1729,439,398,182,99,624,323,301,76,67,74,48,1
20801,144,69,75,11,21,8,5,461,207,254,82,66,55,33,1
20802,707,295,412,105,105,66,30,135,67,68,22,9,18,6,1
20803,676,333,343,111,89,94,39,1210,592,618,157,138,116,85,1
20804,344,151,193,59,51,30,9,249,111,138,40,30,22,17,1
20805,251,92,159,29,94,12,6,1071,549,522,133,127,130,59,1
20806,33423,16370,17053,4965,4756,2786,883,1881,929,952,259,247,158,57,1
20807,101,59,42,11,17,10,1,757,359,398,109,127,80,26,1
20808,464,236,228,64,56,53,28,2109,999,1110,332,294,187,89,1
20809,609,335,274,79,57,45,22,418,248,170,41,31,54,9,1
20810,158,85,73,24,18,18,8,3224,1440,1784,455,440,333,126,1
20811,1382,689,693,186,176,167,77,1154,540,614,195,160,138,66,1
20812,451,225,226,68,57,65,22,706,320,386,111,76,75,51,1
20813,81,41,40,15,13,3,2,200,106,94,24,26,18,6,1
20814,672,334,338,110,93,91,41,198,112,86,20,36,16,5,1
20815,417,232,185,58,50,29,21,335,185,150,46,34,36,13,1
20816,246,115,131,15,29,10,32,600,319,281,94,67,72,37,1
20817,861,433,428,134,82,98,35,1922,923,999,267,275,215,90,1
20818,697,373,324,105,83,95,38,187,96,91,30,24,24,4,1
20819,199,101,98,22,25,9,12,323,156,167,52,45,39,18,1
20820,376,199,177,38,58,19,11,595,316,279,86,60,65,40,1
20821,911,423,488,140,150,102,32,4432,2202,2230,635,547,518,176,1
20822,3075,1459,1616,390,359,298,207,1247,620,627,134,149,142,58,1
20823,278,164,114,35,23,30,18,757,365,392,113,97,80,41,1
20824,368,195,173,52,41,42,15,183,89,94,19,24,22,15,1
20825,694,441,253,69,47,82,42,610,328,282,78,65,57,33,1
20826,549,290,259,64,61,62,15,517,274,243,64,62,59,15,1
20827,822,374,448,134,118,76,39,1154,540,614,195,160,138,66,1
20828,564,305,259,82,64,57,27,570,305,265,70,64,56,24,1
20829,304,159,145,38,40,32,3,724,334,390,112,109,79,17,1
20830,1187,573,614,188,132,138,52,745,391,354,85,81,52,39,1
20831,702,298,404,134,111,48,18,158,85,73,24,18,18,8,1
20832,609,279,330,103,98,72,42,346,186,160,40,37,34,21,1
20833,868,448,420,108,103,76,25,1210,592,618,157,138,116,85,1
20834,582,330,252,82,69,87,21,138,73,65,18,9,10,3,1
20835,631,294,337,83,129,46,24,2115,838,1277,346,354,90,48,1
20836,582,293,289,94,80,77,32,220,113,107,37,24,16,7,1
20837,164,78,86,28,23,12,8,358,212,146,51,36,33,9,1
20838,481,268,213,54,48,53,14,330,148,182,42,35,42,25,1
20839,522,265,257,35,39,38,8,1115,586,529,124,161,111,69,1
20840,461,227,234,61,47,54,33,303,159,144,40,35,35,8,1
20841,504,277,227,80,38,47,17,288,158,130,59,23,21,10,1
20842,1979,739,1240,323,363,107,60,789,362,427,90,82,70,35,1
20843,1099,493,606,179,157,108,51,1214,612,602,169,173,98,35,1
20844,158,71,87,23,21,17,12,551,233,318,103,99,64,23,1
20845,970,440,530,142,102,111,39,391,193,198,51,52,49,16,1
20846,646,315,331,82,84,44,24,1270,557,713,130,195,57,30,1
20847,2442,1193,1249,278,183,170,145,467,226,241,55,48,54,23,1
20848,462,233,229,66,49,43,30,454,230,224,63,56,38,33,1
20849,394,202,192,44,43,38,28,504,272,232,75,57,53,19,1
20850,1332,637,695,214,178,117,40,245,112,133,32,45,20,10,1
20851,717,345,372,85,74,69,41,826,362,464,107,118,71,43,1
20852,425,177,248,60,62,33,16,416,201,215,54,52,39,25,1
20853,308,159,149,52,41,22,10,177,99,78,22,23,20,10,1
20854,425,210,215,56,43,52,25,556,269,287,86,66,62,22,1
20855,585,299,286,92,73,89,23,412,299,113,31,15,36,11,1
20856,539,317,222,66,42,72,31,493,275,218,64,36,49,30,1
20857,982,494,488,150,117,91,45,1247,548,699,168,150,140,43,1
20858,520,224,296,69,64,31,29,505,239,266,71,55,50,18,1
20859,99,49,50,16,8,7,8,355,214,141,43,29,63,13,1
20860,253,141,112,28,21,33,20,825,363,462,97,105,72,75,1
20861,669,382,287,67,35,70,16,2063,1024,1039,175,117,80,97,1
20862,180,77,103,30,29,23,5,333,171,162,41,44,48,23,1
20863,1382,689,693,186,176,167,77,724,325,399,98,92,64,24,1
20864,351,184,167,59,45,54,9,566,287,279,77,66,34,14,1
20865,170,90,80,22,27,15,4,698,365,333,108,83,65,21,1
20866,572,298,274,72,67,52,20,445,225,220,47,62,53,26,1
20867,473,248,225,64,50,38,24,189,90,99,26,29,17,11,1
20868,1356,672,684,171,172,134,59,675,311,364,111,80,96,30,1
20869,538,292,246,69,57,52,39,377,202,175,46,50,41,23,1
20870,1132,624,508,199,79,127,41,245,111,134,31,44,20,11,1
20871,1082,532,550,144,151,79,38,1675,875,800,213,219,196,72,1
20872,1441,657,784,140,135,81,73,595,316,279,86,60,65,40,1
20873,199,101,98,22,25,9,12,516,296,220,79,59,69,16,1
20874,154,75,79,17,24,16,13,723,380,343,80,84,47,18,1
20875,1149,568,581,177,133,101,30,341,154,187,34,36,11,11,1
20876,158,85,73,24,18,18,8,147,74,73,28,20,24,4,1
20877,428,226,202,52,60,75,20,959,496,463,144,132,75,35,1
20878,1484,731,753,206,175,187,71,593,266,327,102,84,69,24,1
20879,794,390,404,103,95,86,23,635,333,302,99,75,83,28,1
20880,309,137,172,51,50,28,14,393,186,207,58,50,36,22,1
20881,212,127,85,28,21,26,6,601,313,288,42,48,25,36,1
20882,466,186,280,71,84,30,11,1388,535,853,241,239,96,52,1
20883,838,385,453,110,137,78,28,479,281,198,59,36,57,30,1
20884,716,354,362,102,87,77,30,391,208,183,65,49,57,17,1
20885,1822,879,943,236,227,175,97,914,462,452,100,95,84,25,1
20886,860,457,403,118,103,103,36,505,273,232,70,57,60,33,1
20887,557,278,279,75,70,66,31,375,202,173,46,49,41,23,1
20888,918,427,491,113,111,113,33,1154,540,614,195,160,138,66,1
20889,277,124,153,44,40,35,18,862,335,527,136,169,47,28,1
20890,323,183,140,45,20,27,16,273,135,138,39,32,27,5,1
20891,1115,589,526,142,108,136,50,89,42,47,16,12,15,6,1
20892,845,402,443,137,126,105,47,870,436,434,131,114,72,25,1
20893,577,288,289,85,56,40,20,249,105,144,71,26,13,7,1
20894,435,208,227,68,64,53,23,892,420,472,135,146,98,37,1
20895,982,545,437,119,100,92,40,375,125,250,85,76,17,13,1
20896,280,121,159,60,45,22,12,769,329,440,116,66,55,22,1
20897,284,109,175,55,79,9,9,176,73,103,22,29,13,9,1
20898,202,103,99,28,20,12,8,551,298,253,63,65,45,19,1
20899,454,191,263,61,66,38,15,551,298,253,63,65,45,19,1
20900,715,355,360,118,79,71,29,590,306,284,69,82,68,27,1
20901,345,176,169,34,31,36,11,425,210,215,56,43,52,25,1
20902,501,240,261,80,62,49,42,736,388,348,88,85,67,28,1
20903,93,45,48,19,15,14,3,448,236,212,53,64,56,24,1
20904,323,181,142,40,37,26,16,794,362,432,119,132,63,34,1
20905,355,165,190,53,56,42,19,450,263,187,52,38,54,16,1
20906,333,171,162,41,44,48,23,2768,1380,1388,280,294,291,161,1
20907,476,270,206,62,45,46,30,528,268,260,81,77,36,22,1
20908,552,285,267,74,51,69,24,206,94,112,37,36,18,9,1
20909,974,462,512,145,134,82,37,206,94,112,37,36,18,9,1
20910,1290,629,661,191,187,167,55,845,402,443,137,126,105,47,1
20911,505,275,230,63,57,35,12,301,150,151,41,30,17,11,1
20912,716,354,362,102,87,77,30,193,101,92,35,18,25,6,1
20913,396,223,173,57,37,44,19,1192,579,613,120,215,79,24,1
20914,207,107,100,27,25,20,11,583,322,261,73,66,45,26,1
20915,480,234,246,79,77,65,23,256,134,122,29,42,14,7,1
20916,425,210,215,56,43,52,25,503,263,240,72,55,51,34,1
20917,764,409,355,88,73,102,43,1154,540,614,195,160,138,66,1
20918,136,72,64,22,16,7,3,125,58,67,20,16,10,5,1
20919,933,493,440,140,108,124,32,1335,701,634,163,140,140,64,1
20920,458,243,215,68,50,67,15,1663,835,828,224,213,163,63,1
20921,744,385,359,125,89,90,23,637,327,310,86,58,70,31,1
20922,233,96,137,40,40,13,9,437,210,227,73,62,38,19,1
20923,962,430,532,109,142,61,34,355,169,186,49,37,26,11,1
20924,1218,499,719,147,141,119,145,2556,1169,1387,248,291,227,275,1
20925,355,179,176,51,45,45,11,356,185,171,37,31,17,21,1
20926,3418,1378,2040,515,464,318,121,297,158,139,47,37,37,9,1
20927,211,83,128,28,35,5,11,673,313,360,101,101,46,17,1
20928,347,183,164,55,45,51,16,395,222,173,48,42,21,8,1
20929,359,153,206,47,43,28,18,398,181,217,65,69,42,17,1
20930,736,388,348,88,85,67,28,1078,498,580,184,164,96,44,1
20931,551,298,253,63,65,45,19,750,347,403,105,103,83,29,1
20932,360,188,172,49,48,47,17,338,164,174,45,32,37,13,1
20933,933,536,397,96,90,71,41,127,55,72,25,18,5,7,1
20934,1129,500,629,171,148,85,30,536,278,258,72,63,62,20,1
20935,815,418,397,97,62,70,17,589,272,317,69,60,48,24,1
20936,770,356,414,123,102,66,25,205,94,111,29,31,16,7,1
20937,2817,1216,1601,379,436,183,115,193,99,94,31,31,16,12,1
20938,430,218,212,58,47,34,20,427,218,209,107,27,31,15,1
20939,189,88,101,31,29,18,10,721,379,342,89,73,68,25,1
20940,328,176,152,43,38,34,11,529,314,215,59,64,39,14,1
20941,363,181,182,51,42,57,18,283,132,151,57,33,12,7,1
20942,520,223,297,90,60,48,13,808,419,389,109,87,86,32,1
20943,431,235,196,57,53,50,18,757,373,384,115,93,95,25,1
20944,93,63,30,8,4,7,5,216,104,112,27,18,35,20,1
20945,204,103,101,16,32,22,8,1893,850,1043,280,340,169,80,1
20946,288,120,168,54,52,21,12,134,54,80,29,35,5,8,1
20947,297,145,152,49,30,23,21,598,300,298,68,77,59,21,1
20948,949,512,437,102,124,70,41,181,96,85,25,23,20,7,1
20949,215,115,100,27,28,34,16,253,148,105,31,15,39,16,1
20950,3830,2000,1830,532,388,418,203,595,316,279,86,60,65,40,1
20951,923,480,443,110,114,98,55,748,355,393,121,91,95,26,1
20952,871,482,389,113,95,109,35,424,191,233,76,73,49,13,1
20953,271,126,145,33,38,31,10,569,288,281,86,69,74,24,1
20954,377,184,193,56,53,44,14,1210,592,618,157,138,116,85,1
20955,298,160,138,37,30,22,12,902,495,407,116,97,111,37,1
20956,1508,733,775,216,186,172,60,119,59,60,29,10,6,4,1
20957,427,186,241,55,52,42,23,478,239,239,65,66,65,21,1
20958,247,110,137,34,45,23,10,543,221,322,78,122,37,12,1
20959,1194,609,585,195,142,105,37,808,419,389,109,87,86,32,1
20960,504,247,257,85,57,59,20,580,339,241,72,47,66,21,1
20961,236,110,126,31,39,10,8,973,522,451,140,134,124,39,1
20962,1283,631,652,170,158,115,41,980,580,400,109,103,59,32,1
20963,533,254,279,81,78,52,10,624,308,316,92,72,68,22,1
20964,339,170,169,32,17,24,13,190,74,116,34,29,11,11,1
20965,2440,1061,1379,377,326,172,62,272,149,123,34,35,21,2,1
20966,93,46,47,6,8,8,8,352,212,140,37,17,61,20,1
20967,142,69,73,20,27,9,6,136,72,64,22,16,7,3,1
20968,993,492,501,116,119,135,57,217,109,108,34,32,35,7,1
20969,822,416,406,111,105,84,44,276,136,140,39,34,33,9,1
20970,1577,747,830,213,232,147,57,505,268,237,68,59,34,15,1
20971,724,334,390,112,109,79,17,537,276,261,75,68,68,22,1
20972,161,75,86,24,20,10,7,339,170,169,32,17,24,13,1
20973,928,442,486,139,118,91,43,320,163,157,44,44,26,15,1
20974,465,230,235,68,64,48,24,530,259,271,83,50,54,41,1
20975,1403,715,688,154,147,172,69,1254,631,623,152,160,66,44,1
20976,1441,657,784,140,135,81,73,778,367,411,90,85,64,43,1
20977,901,458,443,91,129,86,21,389,207,182,53,58,52,18,1
20978,357,184,173,51,55,35,11,239,146,93,30,22,35,9,1
20979,624,308,316,92,72,68,22,2347,1234,1113,252,242,302,85,1
20980,247,110,137,34,45,23,10,1087,480,607,155,179,99,28,1
20981,1378,680,698,160,154,111,38,454,242,212,54,42,61,24,1
20982,593,257,336,76,56,56,96,280,139,141,25,39,26,13,1
20983,346,183,163,51,38,23,6,245,112,133,32,45,20,10,1
20984,255,132,123,30,13,28,11,552,285,267,74,51,69,24,1
20985,1905,901,1004,269,248,149,78,905,371,534,192,135,81,28,1
20986,2035,1087,948,163,129,96,73,785,374,411,56,42,38,25,1
20987,301,142,159,52,37,21,15,1434,727,707,210,173,161,54,1
20988,147,78,69,20,15,20,7,490,198,292,65,81,39,27,1
20989,1105,544,561,165,167,98,40,410,208,202,59,58,43,26,1
20990,449,240,209,59,55,63,20,790,385,405,121,108,106,39,1
20991,896,407,489,97,152,70,22,304,159,145,38,40,32,3,1
20992,175,88,87,29,29,23,6,218,133,85,20,19,13,6,1
20993,751,285,466,185,70,117,46,202,102,100,29,35,6,9,1
20994,843,379,464,107,99,95,65,810,367,443,115,92,94,59,1
20995,396,181,215,52,47,48,19,82,43,39,16,8,16,2,1
20996,393,186,207,58,50,36,22,272,149,123,34,35,21,2,1
20997,283,141,142,32,26,23,26,595,316,279,86,60,65,40,1
20998,2351,1110,1241,337,269,300,87,622,299,323,86,86,69,35,1
20999,446,176,270,64,79,45,24,753,318,435,154,95,56,23,1
21000,471,221,250,87,68,42,25,718,283,435,126,127,34,29,1
21001,691,307,384,93,128,45,19,648,341,307,78,89,77,21,1
21002,354,137,217,53,57,30,5,4967,2501,2466,718,692,594,248,1
21003,461,197,264,86,97,43,10,1037,575,462,122,150,82,32,1
21004,709,373,336,73,72,78,24,1149,568,581,177,133,101,30,1
21005,378,178,200,52,52,50,19,448,275,173,32,53,55,27,1
21006,367,199,168,62,44,34,8,280,164,116,46,21,19,9,1
21007,233,120,113,38,32,20,15,390,207,183,50,48,38,15,1
21008,247,110,137,34,45,23,10,592,295,297,79,70,76,11,1
21009,246,108,138,32,44,21,10,790,352,438,132,87,91,60,1
21010,1675,875,800,213,219,196,72,445,204,241,59,56,34,26,1
21011,476,233,243,76,61,52,21,551,298,253,63,65,45,19,1
21012,201,78,123,38,31,19,4,202,102,100,29,35,6,9,1
21013,595,316,279,86,60,65,40,246,113,133,33,45,22,10,1
21014,467,227,240,76,61,60,19,508,254,254,74,99,61,12,1
21015,621,301,320,76,64,46,34,2488,1087,1401,346,253,162,76,1
21016,659,325,334,102,85,87,32,839,427,412,91,83,114,37,1
21017,354,128,226,63,61,27,7,1194,646,548,139,125,127,59,1
21018,165,77,88,28,27,19,10,303,175,128,43,36,34,12,1
21019,341,154,187,34,36,11,11,466,186,280,71,84,30,11,1
21020,551,298,253,63,65,45,19,211,113,98,38,17,25,8,1
21021,360,179,181,63,60,26,12,882,432,450,115,111,68,44,1
21022,217,121,96,27,34,18,10,125,58,67,20,16,10,5,1
21023,280,121,159,60,45,22,12,367,161,206,70,48,41,19,1
21024,333,127,206,66,68,25,14,254,107,147,42,37,24,10,1
21025,584,340,244,77,60,47,25,349,152,197,55,47,27,13,1
21026,789,386,403,95,124,83,25,781,418,363,92,90,64,41,1
21027,360,192,168,55,45,48,16,509,262,247,64,70,64,20,1
21028,2214,993,1221,361,324,190,74,392,115,277,117,75,28,17,1
21029,604,320,284,80,62,90,28,393,186,207,58,50,36,22,1
21030,449,232,217,53,64,57,22,454,191,263,61,66,38,15,1
21031,769,362,407,99,88,66,67,375,214,161,38,36,24,17,1
21032,527,245,282,87,62,65,16,854,380,474,137,159,81,31,1
21033,536,287,249,64,73,21,27,1471,709,762,198,184,154,62,1
21034,750,347,403,105,103,83,29,331,169,162,40,28,22,14,1
21035,1356,576,780,229,198,107,38,246,108,138,32,44,21,10,1
21036,420,165,255,84,99,47,14,321,180,141,47,37,33,12,1
21037,591,279,312,88,91,52,26,525,299,226,54,54,51,19,1
21038,1858,927,931,252,216,179,80,1477,738,739,176,176,145,72,1
21039,704,342,362,113,91,85,33,1970,978,992,245,206,198,80,1
21040,651,323,328,90,65,64,24,676,333,343,111,89,94,39,1
21041,603,311,292,102,71,66,23,327,172,155,38,41,41,15,1
21042,1214,612,602,169,173,98,35,275,125,150,37,48,27,7,1
21043,655,269,386,128,129,49,21,719,301,418,122,132,42,26,1
21044,646,316,330,89,95,48,17,4563,2219,2344,620,531,527,104,1
21045,724,325,399,98,92,64,24,282,135,147,36,49,25,10,1
21046,624,204,420,166,101,32,13,1217,647,570,142,160,129,45,1
21047,393,186,207,58,50,36,22,297,158,139,47,37,37,9,1
21048,824,365,459,121,123,88,50,2556,1169,1387,248,291,227,275,1
21049,264,122,142,33,29,13,13,1217,647,570,142,160,129,45,1
21050,391,243,148,32,24,40,29,637,335,302,83,77,85,26,1
21051,226,109,117,38,36,13,11,609,292,317,102,96,64,21,1
21052,625,316,309,77,79,54,34,296,154,142,38,38,24,16,1
21053,381,189,192,74,49,44,13,659,325,334,102,85,87,32,1
21054,360,161,199,72,36,35,13,537,276,261,75,68,68,22,1
21055,639,298,341,77,61,70,20,207,89,118,28,26,16,6,1
21056,342,196,146,55,27,56,9,811,400,411,107,87,116,43,1
21057,596,289,307,86,75,71,33,296,154,142,38,38,24,16,1
21058,562,265,297,79,56,72,45,866,382,484,116,114,91,28,1
21059,669,406,263,69,68,64,27,582,293,289,94,80,77,32,1
21060,1238,596,642,148,147,126,136,2556,1169,1387,248,291,227,275,1
21061,147,78,69,22,16,20,4,147,86,61,23,15,22,4,1
21062,418,215,203,62,45,64,19,379,203,176,48,38,44,11,1
21063,364,191,173,47,36,33,16,226,109,117,38,36,13,11,1
21064,462,251,211,74,53,41,18,286,148,138,29,51,25,6,1
21065,351,184,167,59,45,54,9,362,211,151,46,35,42,12,1
21066,501,240,261,80,62,49,42,1163,417,746,209,145,87,28,1
21067,313,157,156,39,26,34,29,1588,631,957,275,292,183,66,1
21068,1382,599,783,208,252,90,39,448,198,250,77,66,37,20,1
21069,371,233,138,39,32,28,11,3144,1617,1527,367,342,278,136,1
21070,593,295,298,70,85,48,13,1179,579,600,140,133,122,53,1
21071,982,494,488,150,117,91,45,1210,592,618,157,138,116,85,1
21072,680,320,360,111,55,84,30,201,98,103,26,35,16,5,1
21073,1087,523,564,146,177,103,33,755,271,484,113,226,61,20,1
21074,832,428,404,131,89,88,38,1505,681,824,201,204,73,32,1
21075,1801,889,912,206,263,126,42,1356,576,780,229,198,107,38,1
21076,902,332,570,154,146,75,40,165,80,85,21,9,18,19,1
21077,418,213,205,54,56,49,13,255,130,125,44,18,22,12,1
21078,1149,568,581,177,133,101,30,255,122,133,35,51,22,13,1
21079,551,298,253,63,65,45,19,1270,682,588,165,147,136,54,1
21080,1581,684,897,220,153,118,63,462,233,229,66,49,43,30,1
21081,784,391,393,105,113,86,21,2871,1148,1723,496,469,204,98,1
21082,218,133,85,20,19,13,6,595,316,279,86,60,65,40,1
21083,238,91,147,68,19,22,7,330,151,179,68,36,56,9,1
21084,330,157,173,56,42,51,8,972,519,453,109,98,120,39,1
21085,731,340,391,95,83,81,32,393,186,207,58,50,36,22,1
21086,396,190,206,76,57,44,14,393,186,207,58,50,36,22,1
21087,870,433,437,133,121,95,25,828,459,369,95,92,107,25,1
21088,204,96,108,31,37,20,5,955,465,490,137,138,119,28,1
21089,764,277,487,158,162,64,31,1139,536,603,162,139,109,50,1
21090,1115,552,563,104,116,115,35,1074,538,536,154,140,111,51,1
21091,186,84,102,27,29,21,10,537,276,261,75,68,68,22,1
21092,581,254,327,100,83,54,20,462,233,229,66,49,43,30,1
21093,354,169,185,54,54,41,19,508,295,213,42,61,53,17,1
21094,832,428,404,131,89,88,38,551,298,253,63,65,45,19,1
21095,493,222,271,44,53,45,51,313,159,154,30,40,23,14,1
21096,216,121,95,38,27,25,6,427,236,191,49,54,46,13,1
21097,158,85,73,24,18,18,8,560,279,281,113,64,58,15,1
21098,313,149,164,48,31,30,13,551,237,314,95,79,54,17,1
21099,355,169,186,49,37,26,11,758,360,398,114,107,51,19,1
21100,1537,701,836,209,187,129,58,332,185,147,47,40,49,13,1
21101,178,100,78,23,22,30,6,382,200,182,53,36,51,16,1
21102,509,214,295,88,76,57,38,902,332,570,154,146,75,40,1
21103,291,120,171,63,39,26,6,497,185,312,63,92,38,28,1
21104,778,367,411,90,85,64,43,358,212,146,51,36,33,9,1
21105,293,142,151,49,40,42,17,770,355,415,103,142,75,42,1
21106,243,140,103,33,27,31,12,74,32,42,13,18,2,6,1
21107,465,228,237,64,42,63,24,1304,696,608,195,169,122,53,1
21108,425,210,215,56,43,52,25,770,385,385,78,83,60,16,1
21109,207,99,108,27,27,21,9,653,298,355,70,101,64,39,1
21110,413,194,219,77,72,28,11,674,319,355,84,139,50,11,1
21111,586,270,316,83,80,59,21,467,231,236,71,65,58,18,1
21112,296,153,143,30,62,36,9,367,199,168,41,41,33,16,1
21113,436,205,231,39,51,26,20,390,191,199,57,49,45,25,1
21114,425,210,215,56,43,52,25,308,164,144,47,29,33,7,1
21115,461,208,253,79,76,61,21,631,309,322,106,83,89,33,1
21116,1265,580,685,205,188,166,53,505,272,233,76,66,57,23,1
21117,1038,470,568,130,123,86,51,1435,649,786,214,181,135,54,1
21118,277,124,153,44,40,35,18,780,304,476,160,173,66,23,1
21119,788,367,421,93,97,71,71,478,239,239,65,66,65,21,1
21120,707,386,321,85,83,99,28,114,66,48,13,7,3,7,1
21121,913,393,520,160,165,87,40,87,50,37,16,7,10,5,1
21122,423,247,176,58,55,29,20,458,225,233,67,61,43,33,1
21123,508,248,260,71,56,50,19,472,233,239,69,51,41,21,1
21124,792,407,385,110,132,82,43,2843,1104,1739,429,357,178,95,1
21125,254,117,137,33,35,38,6,355,168,187,48,57,30,15,1
21126,186,91,95,30,22,18,7,360,152,208,86,38,9,10,1
21127,632,285,347,102,78,43,29,468,225,243,80,61,62,22,1
21128,822,392,430,125,104,79,24,3530,1947,1583,530,360,410,110,1
21129,1464,693,771,153,136,91,86,963,385,578,171,162,62,35,1
21130,211,114,97,32,24,19,10,375,202,173,46,49,41,23,1
21131,148,64,84,33,19,6,1,149,68,81,15,38,11,10,1
21132,753,318,435,154,95,56,23,161,73,88,23,22,15,8,1
21133,1117,556,561,188,117,110,48,1139,536,603,162,139,109,50,1
21134,207,115,92,26,16,11,13,1338,633,705,199,151,144,65,1
21135,412,238,174,41,38,43,19,146,83,63,19,12,13,8,1
21136,646,316,330,89,95,48,17,104,48,56,15,15,13,7,1
21137,653,311,342,106,74,52,28,480,252,228,55,37,49,20,1
21138,255,122,133,35,51,22,13,1103,536,567,171,156,81,43,1
21139,285,165,120,31,29,17,9,390,207,183,50,48,38,15,1
21140,1034,451,583,165,146,104,40,767,392,375,113,112,83,13,1
21141,102,49,53,14,21,7,4,133,66,67,21,24,9,2,1
21142,522,283,239,65,64,76,22,552,285,267,74,51,69,24,1
21143,478,239,239,65,66,65,21,412,195,217,79,48,36,29,1
21144,383,182,201,39,41,31,42,345,198,147,37,39,23,27,1
21145,653,311,342,106,74,52,28,604,255,349,100,72,55,26,1
21146,1179,608,571,142,143,126,48,664,297,367,88,86,55,47,1
21147,509,341,168,35,32,52,15,509,283,226,69,53,44,21,1
21148,448,236,212,53,64,56,24,205,123,82,22,8,31,5,1
21149,756,348,408,101,103,60,40,449,244,205,68,53,49,12,1
21150,794,402,392,96,84,86,30,334,178,156,43,36,36,19,1
21151,622,263,359,78,49,74,27,1368,742,626,179,129,189,73,1
21152,603,291,312,98,87,61,28,749,360,389,91,122,59,37,1
21153,351,166,185,48,61,24,15,345,203,142,47,35,31,11,1
21154,676,333,343,111,89,94,39,918,427,491,113,111,113,33,1
21155,1290,597,693,182,182,119,63,431,235,196,57,53,50,18,1
21156,209,78,131,33,42,11,7,393,223,170,44,36,32,14,1
21157,392,218,174,43,42,32,27,467,250,217,59,52,41,19,1
21158,505,269,236,52,59,32,18,595,316,279,86,60,65,40,1
21159,418,189,229,76,72,45,14,592,264,328,86,85,62,41,1
21160,1972,846,1126,222,330,114,68,729,325,404,129,88,64,32,1
21161,885,424,461,143,114,92,32,1246,677,569,159,154,108,52,1
21162,977,406,571,151,128,84,47,1233,721,512,148,98,144,52,1
21163,346,168,178,36,43,20,9,1139,536,603,162,139,109,50,1
21164,898,467,431,101,127,90,53,1765,810,955,267,253,180,49,1
21165,586,270,316,83,80,59,21,524,237,287,87,75,54,26,1
21166,580,240,340,108,81,59,22,756,362,394,102,104,73,25,1
21167,393,186,207,58,50,36,22,324,154,170,57,40,26,4,1
21168,272,173,99,32,32,11,8,325,159,166,42,43,48,15,1
21169,326,160,166,38,38,33,13,271,159,112,34,34,33,7,1
21170,934,386,548,132,120,98,72,916,474,442,106,139,98,50,1
21171,989,439,550,142,121,75,29,767,392,375,113,112,83,13,1
21172,467,224,243,70,43,67,23,509,254,255,67,55,52,35,1
21173,241,106,135,48,29,17,15,4544,2024,2520,579,628,480,403,1
21174,724,334,390,112,109,79,17,551,299,252,51,62,63,17,1
21175,505,247,258,72,71,60,27,334,172,162,43,39,41,17,1
21176,509,254,255,67,55,52,35,192,91,101,29,28,17,7,1
21177,2328,1054,1274,377,410,232,62,864,362,502,142,150,70,19,1
21178,687,353,334,84,96,74,31,3144,1617,1527,367,342,278,136,1
21179,349,183,166,56,55,38,5,217,109,108,34,32,35,7,1
21180,181,95,86,21,22,18,9,767,305,462,120,135,38,25,1
21181,488,274,214,58,51,38,17,1670,1140,530,173,120,89,53,1
21182,1050,561,489,138,91,90,41,298,160,138,37,30,22,12,1
21183,272,136,136,49,20,28,17,706,300,406,94,74,61,22,1
21184,552,264,288,86,72,68,23,511,222,289,44,53,36,28,1
21185,1258,648,610,172,159,116,28,2725,1490,1235,339,333,254,78,1
21186,674,358,316,91,92,97,29,217,109,108,34,32,35,7,1
21187,501,267,234,83,62,38,20,483,155,328,138,109,32,9,1
21188,870,436,434,131,114,72,25,550,243,307,91,99,70,10,1
21189,504,272,232,72,41,57,23,785,374,411,56,42,38,25,1
21190,468,225,243,67,69,68,19,508,254,254,74,99,61,12,1
21191,746,361,385,91,92,101,32,180,77,103,30,29,23,5,1
21192,292,108,184,47,64,19,15,374,181,193,63,49,46,20,1
21193,583,322,261,73,66,45,26,864,510,354,89,81,76,42,1
21194,465,228,237,64,42,63,24,2639,1436,1203,317,307,242,77,1
21195,1225,593,632,158,125,102,38,901,458,443,91,129,86,21,1
21196,2031,983,1048,294,257,230,93,205,114,91,25,24,20,15,1
21197,564,303,261,79,49,98,27,195,129,66,21,13,19,6,1
21198,225,116,109,29,19,25,6,638,305,333,68,90,70,29,1
21199,624,308,316,92,72,68,22,906,455,451,116,105,87,46,1
21200,362,233,129,37,17,51,18,440,237,203,55,66,44,12,1
21201,221,113,108,23,17,11,11,212,116,96,22,19,24,17,1
21202,244,123,121,36,24,27,16,143,79,64,16,25,7,5,1
21203,226,118,108,32,30,18,11,928,442,486,139,118,91,43,1
21204,439,177,262,78,73,40,21,467,224,243,70,43,67,23,1
21205,81,41,40,15,13,3,2,1074,538,536,154,140,111,51,1
21206,906,455,451,116,105,87,46,1390,695,695,180,137,170,71,1
21207,593,283,310,91,57,27,25,832,428,404,131,89,88,38,1
21208,926,435,491,133,132,85,17,574,356,218,61,44,87,39,1
21209,888,478,410,105,73,58,33,954,521,433,135,118,78,26,1
21210,1970,978,992,245,206,198,80,644,290,354,125,72,85,42,1
21211,236,141,95,36,32,14,6,425,210,215,56,43,52,25,1
21212,589,256,333,112,67,63,28,101,41,60,18,19,10,5,1
21213,140,71,69,33,11,14,2,1272,651,621,178,194,79,59,1
21214,166,74,92,31,19,21,8,233,130,103,26,23,23,6,1
21215,250,114,136,45,42,18,8,2045,985,1060,359,339,199,74,1
21216,158,85,73,24,18,18,8,740,313,427,101,135,40,22,1
21217,381,206,175,42,53,36,20,245,157,88,25,16,26,10,1
21218,462,251,211,74,53,41,18,624,329,295,97,83,75,34,1
21219,399,216,183,60,53,43,18,151,75,76,21,22,9,5,1
21220,616,366,250,65,57,23,35,601,313,288,42,48,25,36,1
21221,359,153,206,47,43,28,18,399,189,210,65,70,42,16,1
21222,277,124,153,44,40,35,18,191,99,92,25,24,18,8,1
21223,1382,689,693,186,176,167,77,724,334,390,112,109,79,17,1
21224,2442,1193,1249,278,183,170,145,1051,432,619,179,147,126,54,1
21225,501,240,261,80,62,49,42,605,285,320,89,61,68,26,1
21226,1068,494,574,176,155,81,27,89,42,47,16,12,15,6,1
21227,483,235,248,67,62,55,29,226,109,117,38,36,13,11,1
21228,240,166,74,32,12,8,15,201,108,93,36,21,17,4,1
21229,1374,679,695,191,193,154,48,551,237,314,95,79,54,17,1
21230,459,206,253,56,66,32,17,1297,697,600,160,143,146,66,1
21231,335,155,180,64,48,36,10,261,130,131,27,41,19,16,1
21232,2442,1193,1249,278,183,170,145,949,512,437,102,124,70,41,1
21233,225,129,96,32,33,20,8,196,99,97,28,32,17,12,1
21234,583,322,261,73,66,45,26,724,334,390,112,109,79,17,1
21235,357,184,173,51,55,35,11,115,67,48,10,7,12,7,1
21236,546,285,261,71,49,47,24,723,309,414,106,106,41,40,1
21237,245,111,134,31,44,20,11,622,294,328,104,93,42,17,1
21238,947,482,465,143,107,89,37,416,201,215,54,52,39,25,1
21239,854,380,474,137,159,81,31,536,278,258,72,63,62,20,1
21240,502,240,262,78,61,54,32,532,269,263,72,59,59,39,1
21241,350,213,137,39,21,53,22,107,57,50,16,3,3,6,1
21242,328,173,155,43,36,24,17,231,126,105,37,26,29,6,1
21243,652,332,320,72,59,57,24,538,252,286,77,87,53,30,1
21244,546,267,279,90,69,56,19,969,505,464,123,133,92,33,1
21245,1013,546,467,116,127,94,51,815,418,397,97,62,70,17,1
21246,914,453,461,112,115,79,29,204,99,105,32,32,22,10,1
21247,211,88,123,38,28,26,10,1037,575,462,122,150,82,32,1
21248,201,108,93,36,21,17,4,757,373,384,115,93,95,25,1
21249,676,333,343,111,89,94,39,770,374,396,95,91,79,41,1
21250,501,240,261,80,62,49,42,363,182,181,33,55,23,11,1
21251,1231,603,628,121,162,109,120,724,650,74,44,3,32,3,1
21252,636,320,316,79,61,67,31,882,432,450,115,111,68,44,1
21253,219,100,119,32,43,9,10,1524,662,862,314,163,210,114,1
21254,926,435,491,133,132,85,17,586,254,332,114,111,55,17,1
21255,732,402,330,81,86,87,33,402,227,175,48,40,35,11,1
21256,351,184,167,59,45,54,9,689,343,346,119,100,86,38,1
21257,732,366,366,108,86,74,41,817,425,392,120,102,83,26,1
21258,199,125,74,26,15,10,5,429,219,210,46,66,42,17,1
21259,247,110,137,34,45,23,10,722,384,338,94,83,63,35,1
21260,455,191,264,68,86,21,19,427,218,209,61,53,45,26,1
21261,1170,510,660,142,182,115,84,660,359,301,81,87,102,31,1
21262,536,278,258,72,63,62,20,738,339,399,102,88,68,35,1
21263,350,180,170,64,46,55,12,118,56,62,13,14,6,6,1
21264,595,316,279,86,60,65,40,781,418,363,92,90,64,41,1
21265,958,492,466,119,104,119,35,1548,863,685,202,157,215,53,1
21266,317,153,164,34,52,30,14,419,175,244,71,73,23,23,1
21267,1071,549,522,133,127,130,59,1531,691,840,270,226,143,52,1
21268,769,405,364,97,101,49,35,497,270,227,63,48,59,21,1
21269,1338,506,832,241,229,101,40,794,390,404,103,95,86,23,1
21270,676,333,343,111,89,94,39,2442,1193,1249,278,183,170,145,1
21271,676,333,343,111,89,94,39,246,108,138,32,44,21,10,1
21272,208,122,86,27,13,23,7,806,436,370,101,100,76,34,1
21273,389,176,213,81,59,24,7,326,141,185,57,39,33,20,1
21274,832,428,404,131,89,88,38,477,232,245,67,64,70,30,1
21275,440,218,222,58,66,40,24,883,470,413,112,99,108,34,1
21276,700,357,343,99,84,88,34,613,354,259,72,72,61,19,1
21277,454,223,231,38,45,24,19,434,221,213,58,47,54,15,1
21278,581,254,327,100,83,54,20,1441,657,784,140,135,81,73,1
21279,465,257,208,51,61,54,23,609,292,317,102,96,64,21,1
21280,1270,682,588,165,147,136,54,294,148,146,35,33,25,14,1
21281,1441,657,784,140,135,81,73,423,222,201,51,33,41,28,1
21282,185,70,115,37,48,15,5,412,193,219,70,56,51,26,1
21283,605,295,310,74,66,70,36,647,324,323,101,80,76,43,1
21284,4377,1898,2479,663,608,331,126,335,128,207,59,43,24,23,1
21285,674,319,355,84,139,50,11,512,261,251,79,73,60,21,1
21286,1050,473,577,142,119,87,54,573,213,360,119,65,91,35,1
21287,291,133,158,46,51,21,15,411,209,202,69,43,18,15,1
21288,95,44,51,14,13,7,4,285,109,176,54,80,9,9,1
21289,920,435,485,115,113,94,49,664,297,367,88,86,55,47,1
21290,392,156,236,40,91,28,16,592,291,301,92,93,71,31,1
21291,327,175,152,48,45,36,16,335,185,150,46,34,36,13,1
21292,135,69,66,21,14,11,5,407,240,167,38,29,67,26,1
21293,473,254,219,66,67,41,16,1434,727,707,210,173,161,54,1
21294,432,218,214,57,55,42,11,843,449,394,112,86,82,32,1
21295,925,484,441,112,86,84,31,2442,1193,1249,278,183,170,145,1
21296,724,334,390,112,109,79,17,1068,539,529,161,134,132,71,1
21297,1412,603,809,184,195,112,45,1255,666,589,145,142,120,82,1
21298,517,295,222,60,55,55,19,140,86,54,17,6,20,7,1
21299,1392,695,697,162,160,139,74,921,455,466,144,127,108,39,1
21300,425,210,215,56,43,52,25,344,204,140,41,23,68,23,1
21301,422,200,222,90,54,24,14,530,259,271,83,50,54,41,1
21302,673,329,344,111,95,92,41,1078,557,521,116,114,144,44,1
21303,240,125,115,34,32,30,8,947,506,441,105,126,75,14,1
21304,1132,553,579,172,143,150,57,166,93,73,28,15,17,6,1
21305,309,161,148,38,34,40,15,292,141,151,45,23,35,13,1
21306,1255,666,589,145,142,120,82,854,380,474,137,159,81,31,1
21307,607,311,296,73,81,33,33,189,88,101,31,29,18,10,1
21308,477,239,238,63,58,45,16,930,367,563,181,153,83,48,1
21309,394,152,242,80,57,47,23,450,232,218,58,54,42,20,1
21310,245,122,123,21,32,18,13,1012,411,601,177,174,75,32,1
21311,1441,657,784,140,135,81,73,920,492,428,100,92,88,49,1
21312,391,208,183,65,49,57,17,508,267,241,43,35,25,17,1
21313,583,322,261,73,66,45,26,1338,633,705,199,151,144,65,1
21314,215,138,77,26,7,40,16,250,164,86,22,15,30,4,1
21315,470,211,259,59,75,45,7,332,185,147,47,40,49,13,1
21316,1273,592,681,199,164,139,39,512,254,258,70,48,37,32,1
21317,202,102,100,29,35,6,9,575,218,357,135,58,89,41,1
21318,352,164,188,53,43,31,16,822,402,420,125,107,82,26,1
21319,124,69,55,15,13,12,2,379,203,176,55,48,45,16,1
21320,493,290,203,47,53,53,16,482,274,208,53,49,63,24,1
21321,245,112,133,32,45,20,10,521,279,242,47,50,58,30,1
21322,764,277,487,158,162,64,31,928,442,486,139,118,91,43,1
21323,476,233,243,76,61,52,21,497,227,270,70,63,66,30,1
21324,227,141,86,16,22,29,13,1210,592,618,157,138,116,85,1
21325,920,492,428,100,92,88,49,337,179,158,48,43,25,9,1
21326,2442,1193,1249,278,183,170,145,485,183,302,79,81,73,33,1
21327,588,255,333,94,82,58,27,126,71,55,22,16,15,6,1
21328,839,408,431,138,122,105,46,906,455,451,116,105,87,46,1
21329,163,71,92,22,38,11,7,577,277,300,71,59,64,24,1
21330,505,226,279,68,51,30,15,483,237,246,63,47,25,21,1
21331,786,378,408,101,79,104,35,1032,565,467,133,81,135,49,1
21332,963,447,516,120,146,87,74,938,484,454,137,100,104,41,1
21333,246,108,138,32,44,21,10,1487,694,793,192,220,120,62,1
21334,166,86,80,24,19,17,10,346,181,165,36,27,21,23,1
21335,252,138,114,31,26,34,6,1581,891,690,189,147,181,64,1
21336,2524,1232,1292,398,317,186,61,604,255,349,100,72,55,26,1
21337,592,291,301,92,93,71,31,537,276,261,75,68,68,22,1
21338,683,288,395,125,94,77,39,376,199,177,54,49,48,22,1
21339,400,195,205,63,67,40,18,175,90,85,28,21,19,7,1
21340,1193,532,661,160,154,90,90,1231,603,628,121,162,109,120,1
21341,769,391,378,101,78,78,55,302,138,164,50,36,30,20,1
21342,195,99,96,30,17,22,14,557,268,289,66,67,70,17,1
21343,824,386,438,94,77,81,34,1424,650,774,152,124,95,87,1
21344,1217,647,570,142,160,129,45,213,76,137,63,36,13,2,1
21345,372,201,171,52,50,42,13,505,226,279,68,51,30,15,1
21346,193,92,101,29,32,25,11,289,164,125,37,31,35,16,1
21347,1007,353,654,277,147,70,26,288,140,148,59,33,27,12,1
21348,522,235,287,78,67,60,50,670,306,364,95,74,73,45,1
21349,1308,652,656,166,153,149,87,742,303,439,88,96,86,23,1
21350,582,293,289,94,80,77,32,412,193,219,70,56,51,26,1
21351,536,278,258,72,63,62,20,346,167,179,56,52,28,13,1
21352,362,174,188,46,55,35,23,557,240,317,97,74,68,37,1
21353,583,284,299,86,61,67,23,247,110,137,34,45,23,10,1
21354,292,175,117,37,29,21,14,1336,828,508,166,121,152,48,1
21355,963,455,508,127,130,115,48,700,265,435,134,106,16,3,1
21356,603,311,292,102,71,66,23,1121,458,663,158,210,76,47,1
21357,1149,568,581,177,133,101,30,659,325,334,102,85,87,32,1
21358,207,93,114,20,33,19,10,324,154,170,57,40,26,4,1
21359,672,334,338,110,93,91,41,641,324,317,88,92,49,14,1
21360,396,213,183,68,44,47,18,246,107,139,55,33,27,11,1
21361,570,292,278,80,65,72,23,269,133,136,30,41,34,17,1
21362,689,343,346,119,100,86,38,1207,593,614,151,148,131,95,1
21363,2045,985,1060,359,339,199,74,509,214,295,88,76,57,38,1
21364,593,266,327,102,84,69,24,1333,646,687,209,179,148,45,1
21365,383,204,179,61,32,54,16,2804,1163,1641,470,400,203,116,1
21366,279,106,173,48,35,41,39,280,114,166,56,28,48,35,1
21367,335,155,180,64,48,36,10,770,390,380,104,76,78,32,1
21368,374,201,173,51,34,53,24,247,110,137,34,45,23,10,1
21369,172,83,89,26,25,18,7,257,139,118,64,17,24,7,1
21370,400,191,209,51,60,30,9,564,283,281,71,64,40,13,1
21371,479,227,252,65,79,42,26,298,167,131,47,33,40,8,1
21372,98,46,52,16,6,2,9,3396,1499,1897,325,572,309,90,1
21373,665,293,372,112,107,55,15,503,263,240,72,55,51,34,1
21374,276,151,125,35,28,33,20,808,484,324,80,63,76,24,1
21375,689,343,346,119,100,86,38,418,204,214,68,66,38,12,1
21376,424,191,233,76,73,49,13,863,458,405,97,82,63,57,1
21377,432,181,251,48,75,27,17,509,262,247,64,70,64,20,1
21378,427,218,209,61,53,45,26,163,71,92,33,26,5,7,1
21379,458,222,236,69,39,35,18,300,136,164,44,35,33,21,1
21380,1358,659,699,129,178,134,63,911,493,418,89,140,83,34,1
21381,562,282,280,76,80,43,12,221,110,111,28,32,25,11,1
21382,1863,721,1142,262,283,139,74,467,226,241,55,48,54,23,1
21383,374,227,147,44,22,54,20,109,50,59,20,7,10,9,1
21384,747,316,431,143,127,53,21,954,521,433,135,118,78,26,1
21385,2602,1424,1178,314,320,249,75,626,333,293,64,55,61,15,1
21386,1242,613,629,174,113,114,53,294,122,172,46,65,18,11,1
21387,690,327,363,115,91,54,31,1477,738,739,176,176,145,72,1
21388,979,534,445,83,77,80,24,2446,1099,1347,363,294,233,100,1
21389,1982,710,1272,353,319,146,76,208,96,112,31,32,13,9,1
21390,245,137,108,34,30,19,10,885,424,461,143,114,92,32,1
21391,412,195,217,79,48,36,29,349,166,183,49,37,25,52,1
21392,204,93,111,35,35,16,11,456,232,224,69,65,30,19,1
21393,227,124,103,33,21,16,19,684,288,396,107,90,54,42,1
21394,170,82,88,28,23,20,12,831,426,405,101,102,105,32,1
21395,803,358,445,135,117,80,44,454,191,263,61,66,38,15,1
21396,372,187,185,55,36,45,21,502,299,203,57,52,32,11,1
21397,1198,571,627,177,168,97,54,346,186,160,48,32,35,14,1
21398,323,181,142,40,37,26,16,346,180,166,55,49,38,6,1
21399,778,353,425,140,89,92,51,593,291,302,81,85,56,20,1
21400,2035,1087,948,163,129,96,73,641,324,317,88,92,49,14,1
21401,508,295,213,42,61,53,17,1265,580,685,205,188,166,53,1
21402,388,245,143,45,25,41,16,477,249,228,65,52,56,30,1
21403,247,135,112,38,18,29,13,140,76,64,17,13,13,8,1
21404,620,299,321,75,60,68,30,1336,736,600,137,136,163,69,1
21405,277,122,155,33,33,25,24,646,316,330,89,95,48,17,1
21406,1124,578,546,149,127,122,61,217,109,108,34,32,35,7,1
21407,334,165,169,57,41,43,23,298,149,149,47,37,46,15,1
21408,199,106,93,29,23,26,7,480,254,226,67,65,65,20,1
21409,422,213,209,63,60,35,13,673,317,356,101,85,76,49,1
21410,1187,631,556,182,139,152,56,750,347,403,105,103,83,29,1
21411,330,157,173,56,42,51,8,201,42,159,19,3,2,75,1
21412,314,151,163,42,61,39,16,187,95,92,27,20,16,8,1
21413,465,228,237,64,42,63,24,509,254,255,67,55,52,35,1
21414,155,79,76,26,13,15,6,364,241,123,33,16,38,19,1
21415,111,48,63,19,22,4,5,1210,578,632,172,184,94,66,1
21416,2556,1169,1387,248,291,227,275,509,262,247,64,70,64,20,1
21417,979,534,445,83,77,80,24,215,80,135,54,56,21,9,1
21418,193,105,88,33,16,9,4,149,68,81,15,38,11,10,1
21419,245,122,123,21,32,18,13,770,356,414,123,102,66,25,1
21420,1222,601,621,182,145,115,52,806,419,387,115,130,57,32,1
21421,2440,1061,1379,377,326,172,62,778,367,411,90,85,64,43,1
21422,824,365,459,121,123,88,50,160,86,74,21,11,16,16,1
21423,1286,576,710,202,207,121,41,1426,752,674,202,139,155,42,1
21424,173,110,63,35,6,9,8,437,228,209,47,61,26,11,1
21425,618,333,285,76,75,66,24,1425,670,755,153,189,122,85,1
21426,753,346,407,122,101,94,33,149,68,81,15,38,11,10,1
21427,229,120,109,31,30,22,9,465,218,247,64,51,50,42,1
21428,777,345,432,128,88,65,39,1863,721,1142,262,283,139,74,1
21429,610,284,326,99,98,58,38,643,294,349,92,97,53,35,1
21430,491,232,259,80,65,54,21,839,444,395,107,95,104,39,1
21431,440,218,222,58,66,40,24,894,479,415,117,93,119,38,1
21432,276,143,133,34,38,20,15,133,66,67,21,24,9,2,1
21433,906,485,421,112,98,112,39,908,488,420,115,97,111,43,1
21434,847,402,445,137,119,102,41,1367,690,677,172,175,154,83,1
21435,466,186,280,71,84,30,11,1058,497,561,194,142,87,63,1
21436,913,393,520,160,165,87,40,467,224,243,70,43,67,23,1
21437,483,236,247,82,60,43,18,461,257,204,63,49,50,29,1
21438,367,195,172,57,54,43,16,367,203,164,41,32,39,20,1
21439,630,393,237,47,45,100,30,417,182,235,57,109,50,8,1
21440,193,118,75,25,19,10,7,233,121,112,24,31,30,7,1
21441,105,50,55,14,13,11,7,710,307,403,117,176,37,9,1
21442,922,418,504,120,120,106,31,746,442,304,82,71,99,36,1
21443,368,185,183,61,41,56,8,469,253,216,49,51,48,18,1
21444,537,276,261,75,68,68,22,538,252,286,77,87,53,30,1
21445,351,181,170,55,26,47,21,745,379,366,86,76,92,43,1
21446,584,272,312,76,72,66,42,202,116,86,25,17,24,5,1
21447,1009,506,503,146,141,97,55,806,436,370,101,100,76,34,1
21448,136,66,70,33,11,9,3,2920,1191,1729,439,398,182,99,1
21449,815,418,397,97,62,70,17,1608,924,684,163,133,89,29,1
21450,1272,561,711,178,194,101,34,341,178,163,48,44,42,20,1
21451,391,222,169,46,36,30,9,201,42,159,19,3,2,75,1
21452,1007,523,484,116,113,117,43,834,395,439,117,92,96,28,1
21453,558,306,252,75,55,74,23,142,91,51,11,6,13,7,1
21454,543,287,256,71,66,64,23,399,222,177,48,44,52,23,1
21455,1190,638,552,162,95,112,18,255,134,121,36,40,29,13,1
21456,1134,574,560,157,164,47,48,1675,875,800,213,219,196,72,1
21457,423,222,201,51,33,41,28,813,440,373,117,93,34,19,1
21458,336,191,145,38,34,57,13,643,263,380,107,72,79,23,1
21459,179,89,90,36,28,31,9,355,168,187,48,57,30,15,1
21460,400,195,205,63,67,40,18,769,362,407,99,88,66,67,1
21461,3230,1723,1507,361,358,157,75,608,336,272,61,49,78,31,1
21462,264,126,138,44,26,25,10,919,376,543,129,122,55,30,1
21463,418,189,229,76,72,45,14,512,269,243,69,70,62,29,1
21464,154,75,79,17,24,16,13,437,167,270,126,95,34,10,1
21465,1692,713,979,325,210,122,58,256,138,118,43,28,26,9,1
21466,168,82,86,30,23,19,10,153,77,76,23,22,11,3,1
21467,593,266,327,102,84,69,24,893,469,424,126,135,68,14,1
21468,72,30,42,12,8,3,4,340,163,177,39,38,37,23,1
21469,672,334,338,110,93,91,41,1216,552,664,194,189,110,49,1
21470,71,37,34,11,9,5,5,2353,1314,1039,308,250,253,112,1
21471,763,343,420,127,70,105,34,1304,696,608,195,169,122,53,1
21472,1320,566,754,235,198,122,36,377,184,193,56,53,44,14,1
21473,815,418,397,97,62,70,17,515,274,241,85,42,77,23,1
21474,1074,538,536,190,131,157,35,175,90,85,28,21,19,7,1
21475,1304,679,625,153,158,131,35,1040,562,478,125,101,103,32,1
21476,227,127,100,32,24,31,5,157,78,79,18,29,16,10,1
21477,1338,756,582,155,105,104,44,581,323,258,74,58,48,20,1
21478,418,248,170,41,31,54,9,342,208,134,36,31,29,15,1
21479,611,246,365,116,82,71,27,904,436,468,138,146,82,39,1
21480,211,88,123,38,28,26,10,770,356,414,123,102,66,25,1
21481,2556,1169,1387,248,291,227,275,497,227,270,70,63,66,30,1
21482,288,142,146,52,32,26,8,454,187,267,66,80,36,15,1
21483,239,146,93,30,22,35,9,882,432,450,115,111,68,44,1
21484,351,184,167,59,45,54,9,705,396,309,87,48,53,17,1
21485,408,215,193,47,31,42,17,219,124,95,22,22,23,5,1
21486,158,85,73,24,18,18,8,482,231,251,76,81,64,26,1
21487,250,126,124,29,19,16,31,2491,1175,1316,303,302,273,147,1
21488,418,215,203,60,69,35,14,433,220,213,67,68,31,19,1
21489,448,236,212,53,64,56,24,556,290,266,75,74,29,24,1
21490,160,67,93,32,37,15,9,367,161,206,70,48,41,19,1
21491,558,306,252,75,55,74,23,180,103,77,22,19,29,8,1
21492,635,326,309,70,61,77,30,211,113,98,38,17,25,8,1
21493,229,105,124,36,33,12,4,785,325,460,114,123,61,28,1
21494,634,317,317,79,67,76,28,439,177,262,78,73,40,21,1
21495,362,211,151,46,35,42,12,1105,544,561,165,167,98,40,1
21496,716,354,362,102,87,77,30,298,140,158,51,33,21,22,1
21497,392,156,236,40,91,28,16,515,259,256,79,58,46,21,1
21498,548,292,256,67,65,68,26,583,248,335,115,111,52,16,1
21499,245,112,133,32,45,20,10,466,186,280,71,84,30,11,1
21500,416,230,186,54,53,42,17,753,370,383,110,85,96,47,1
21501,1581,684,897,220,153,118,63,497,185,312,63,92,38,28,1
21502,469,221,248,49,60,55,21,444,212,232,74,25,60,24,1
21503,291,120,171,63,39,26,6,782,372,410,127,111,89,36,1
21504,719,343,376,108,78,92,29,191,99,92,25,24,18,8,1
21505,377,187,190,51,44,46,26,71,37,34,11,9,5,5,1
21506,373,194,179,42,54,26,13,156,64,92,31,19,5,4,1
21507,377,171,206,59,58,41,22,770,355,415,103,142,75,42,1
21508,1417,598,819,223,188,135,58,393,186,207,58,50,36,22,1
21509,573,278,295,58,79,37,23,1270,557,713,130,195,57,30,1
21510,282,165,117,26,34,37,11,377,201,176,46,50,41,23,1
21511,728,385,343,110,102,69,14,1207,593,614,151,148,131,95,1
21512,697,373,324,105,83,95,38,1484,731,753,206,175,187,71,1
21513,1235,637,598,191,162,99,36,1140,495,645,129,95,128,159,1
21514,4544,2024,2520,579,628,480,403,352,169,183,57,36,47,31,1
21515,2414,1189,1225,277,178,170,169,399,201,198,65,45,48,17,1
21516,538,286,252,80,58,48,14,3685,1574,2111,579,580,303,116,1
21517,596,289,307,86,75,71,33,712,396,316,78,69,65,25,1
21518,367,199,168,41,41,33,16,359,184,175,49,35,32,11,1
21519,1048,564,484,118,122,113,40,1089,544,545,138,160,117,43,1
21520,471,221,250,87,68,42,25,260,133,127,43,32,39,3,1
21521,232,127,105,36,22,23,15,396,192,204,71,41,51,15,1
21522,462,251,211,74,53,41,18,415,228,187,44,44,48,15,1
21523,1801,889,912,206,263,126,42,1233,721,512,148,98,144,52,1
21524,404,190,214,55,55,35,27,269,133,136,30,41,34,17,1
21525,991,537,454,134,99,80,34,247,110,137,34,45,23,10,1
21526,1271,599,672,194,175,118,47,1834,823,1011,297,282,151,63,1
21527,392,156,236,40,91,28,16,855,473,382,112,99,68,35,1
21528,940,464,476,116,135,108,58,1943,846,1097,301,257,135,77,1
21529,316,157,159,45,38,22,19,517,196,321,103,98,34,12,1
21530,963,447,516,120,146,87,74,767,392,375,113,112,83,13,1
21531,250,164,86,22,15,30,4,724,650,74,44,3,32,3,1
21532,672,334,338,110,93,91,41,210,89,121,51,34,11,6,1
21533,1248,584,664,184,164,155,67,277,124,153,44,40,35,18,1
21534,933,493,440,140,108,124,32,375,202,173,46,49,41,23,1
21535,921,455,466,144,127,108,39,201,98,103,26,35,16,5,1
21536,870,489,381,97,99,76,14,377,184,193,56,53,44,14,1
21537,1190,638,552,162,95,112,18,1541,713,828,176,147,151,250,1
21538,161,75,86,24,20,10,7,218,133,85,20,19,13,6,1
21539,451,239,212,53,64,56,22,535,249,286,79,64,55,22,1
21540,885,424,461,143,114,92,32,823,336,487,138,120,69,44,1
21541,903,457,446,99,127,62,29,404,197,207,57,69,33,15,1
21542,546,267,279,90,69,56,19,1117,423,694,182,134,88,31,1
21543,971,516,455,114,115,116,35,643,373,270,91,43,113,21,1
21544,107,36,71,27,15,0,1,345,203,142,47,35,31,11,1
21545,557,268,289,66,67,70,17,1304,585,719,179,169,154,47,1
21546,906,460,446,117,131,108,33,737,363,374,119,101,85,41,1
21547,595,316,279,86,60,65,40,1863,721,1142,262,283,139,74,1
21548,247,110,137,34,45,23,10,520,272,248,74,71,44,15,1
21549,728,385,343,110,102,69,14,503,263,240,72,55,51,34,1
21550,252,121,131,42,34,12,16,904,436,468,138,146,82,39,1
21551,770,374,396,95,91,79,41,1367,690,677,172,175,154,83,1
21552,360,192,168,55,45,48,16,425,210,215,56,43,52,25,1
21553,276,118,158,38,40,16,10,206,85,121,31,42,6,17,1
21554,102,49,53,14,21,7,4,771,321,450,151,135,43,15,1
21555,446,246,200,46,32,53,25,363,193,170,52,51,41,14,1
21556,496,276,220,87,47,60,31,237,127,110,34,30,16,9,1
21557,734,366,368,121,99,63,39,252,121,131,42,34,12,16,1
21558,1090,533,557,137,125,75,28,341,178,163,48,44,42,20,1
21559,363,182,181,33,55,23,11,380,200,180,35,42,31,10,1
21560,674,268,406,118,96,70,21,808,366,442,130,133,66,31,1
21561,181,96,85,25,23,20,7,1382,689,693,186,176,167,77,1
21562,416,210,206,55,54,39,20,277,124,153,44,40,35,18,1
21563,513,246,267,71,66,60,35,580,328,252,63,50,80,31,1
21564,806,419,387,115,130,57,32,1863,721,1142,262,283,139,74,1
21565,940,417,523,190,146,85,26,782,372,410,127,111,89,36,1
21566,376,203,173,57,52,48,11,2364,1004,1360,406,426,226,79,1
21567,656,358,298,67,47,64,26,361,223,138,28,24,34,27,1
21568,184,131,53,15,15,16,5,437,212,225,66,44,44,11,1
21569,777,408,369,100,96,56,17,254,107,147,42,37,24,10,1
21570,609,292,317,102,96,64,21,318,164,154,52,43,34,10,1
21571,458,177,281,90,69,48,9,466,186,280,71,84,30,11,1
21572,817,397,420,120,152,48,17,441,189,252,73,50,47,23,1
21573,304,159,145,38,40,32,3,583,322,261,73,66,45,26,1
21574,2045,985,1060,359,339,199,74,858,398,460,126,138,75,39,1
21575,709,294,415,132,123,76,23,508,267,241,43,35,25,17,1
21576,2639,1436,1203,317,307,242,77,206,94,112,37,36,18,9,1
21577,764,409,355,88,73,102,43,359,174,185,54,56,43,16,1
21578,1018,547,471,122,122,120,33,2201,1053,1148,238,312,200,122,1
21579,366,211,155,35,42,24,12,1333,646,687,209,179,148,45,1
21580,133,66,67,21,24,9,2,328,183,145,43,37,23,13,1
21581,596,288,308,77,51,58,30,2339,1260,1079,336,252,279,106,1
21582,1290,629,661,191,187,167,55,462,251,211,74,53,41,18,1
21583,467,226,241,55,48,54,23,424,197,227,67,62,43,17,1
21584,875,376,499,155,125,53,39,577,251,326,92,84,60,11,1
21585,245,137,108,34,30,19,10,1258,531,727,218,216,108,35,1
21586,647,324,323,101,80,76,43,1038,470,568,130,123,86,51,1
21587,834,405,429,112,95,84,34,654,344,310,80,69,57,15,1
21588,416,209,207,76,45,50,17,910,431,479,138,103,98,41,1
21589,834,405,429,112,95,84,34,605,295,310,74,66,70,36,1
21590,549,318,231,82,41,47,21,386,199,187,40,30,51,21,1
21591,419,274,145,41,23,28,27,217,109,108,34,32,35,7,1
21592,465,229,236,68,62,40,22,749,374,375,99,108,98,37,1
21593,258,111,147,46,63,17,6,395,186,209,53,48,46,30,1
21594,297,158,139,47,37,37,9,928,442,486,139,118,91,43,1
21595,464,242,222,61,68,36,17,537,276,261,75,68,68,22,1
21596,546,207,339,103,98,26,18,297,123,174,51,49,16,10,1
21597,553,261,292,73,79,40,26,191,99,92,25,24,18,8,1
21598,392,228,164,53,36,41,17,631,332,299,61,104,60,19,1
21599,441,201,240,70,58,55,24,1179,608,571,142,143,126,48,1
21600,590,298,292,73,45,71,25,181,96,85,25,23,20,7,1
21601,290,157,133,40,28,24,15,2725,1490,1235,339,333,254,78,1
21602,201,101,100,28,28,26,11,609,279,330,103,98,72,42,1
21603,815,418,397,97,62,70,17,1154,405,749,164,255,63,65,1
21604,582,293,289,94,80,77,32,414,194,220,76,66,49,16,1
21605,962,500,462,146,134,62,27,906,474,432,90,125,74,24,1
21606,540,306,234,74,52,43,22,3685,1574,2111,579,580,303,116,1
21607,261,130,131,27,41,19,16,313,170,143,51,28,43,6,1
21608,676,333,343,111,89,94,39,398,181,217,65,69,42,17,1
21609,462,251,211,74,53,41,18,368,158,210,64,61,39,14,1
21610,255,126,129,36,20,21,29,568,243,325,98,73,56,44,1
21611,391,208,183,65,49,57,17,709,294,415,132,123,76,23,1
21612,220,110,110,27,28,33,14,703,388,315,82,78,81,37,1
21613,288,169,119,31,27,30,13,100,51,49,12,12,8,4,1
21614,313,160,153,51,33,43,23,503,263,240,72,55,51,34,1
21615,537,315,222,55,46,69,39,1150,585,565,162,148,102,36,1
21616,309,154,155,42,44,45,16,427,191,236,67,60,41,34,1
21617,400,208,192,62,44,42,21,674,358,316,91,92,97,29,1
21618,583,279,304,99,71,59,31,599,292,307,74,126,45,14,1
21619,150,74,76,21,22,18,7,204,104,100,26,27,21,11,1
21620,939,493,446,113,100,87,31,583,322,261,73,66,45,26,1
21621,1395,627,768,172,263,141,59,398,249,149,40,19,66,25,1
21622,985,551,434,123,93,91,26,2168,890,1278,350,329,141,76,1
21623,552,285,267,74,51,69,24,1268,612,656,218,195,89,33,1
21624,1328,661,667,210,147,126,55,938,484,454,137,100,104,41,1
21625,482,231,251,76,81,64,26,429,223,206,50,32,46,17,1
21626,1132,549,583,164,145,88,43,555,278,277,60,70,48,18,1
21627,709,373,336,73,72,78,24,448,275,173,32,53,55,27,1
21628,412,238,174,41,38,43,19,297,145,152,49,30,23,21,1
21629,1032,526,506,129,117,119,47,2477,1186,1291,256,271,249,90,1
21630,370,216,154,56,27,72,12,316,157,159,45,38,22,19,1
21631,444,218,226,71,64,37,11,437,210,227,73,62,38,19,1
21632,593,266,327,102,84,69,24,794,390,404,103,95,86,23,1
21633,67,40,27,10,8,7,6,202,102,100,29,35,6,9,1
21634,139,75,64,17,17,23,9,375,202,173,46,49,41,23,1
21635,360,192,168,55,45,48,16,1441,657,784,140,135,81,73,1
21636,446,176,270,64,79,45,24,259,119,140,48,28,29,19,1
21637,509,341,168,35,32,52,15,166,81,85,30,27,13,8,1
21638,593,266,327,102,84,69,24,233,102,131,35,22,24,13,1
21639,131,74,57,17,14,12,4,294,148,146,35,33,25,14,1
21640,267,159,108,31,13,22,15,2224,1037,1187,288,276,273,74,1
21641,798,287,511,126,125,77,26,482,224,258,71,62,52,39,1
21642,391,208,183,65,49,57,17,300,140,160,39,35,14,12,1
21643,639,322,317,73,82,39,23,770,403,367,91,87,68,52,1
21644,253,125,128,37,39,25,11,375,202,173,46,49,41,23,1
21645,1382,599,783,208,252,90,39,554,215,339,102,65,85,42,1
21646,480,234,246,79,77,65,23,1203,651,552,151,128,123,46,1
21647,738,339,399,102,88,68,35,930,367,563,181,153,83,48,1
21648,1048,564,484,118,122,113,40,417,182,235,57,109,50,8,1
21649,279,106,173,48,35,41,39,448,275,173,32,53,55,27,1
21650,871,482,389,113,95,109,35,486,199,287,79,91,52,18,1
21651,457,237,220,69,44,53,26,346,165,181,69,43,22,9,1
21652,462,251,211,74,53,41,18,140,74,66,15,14,14,10,1
21653,325,186,139,49,36,20,5,2414,1189,1225,277,178,170,169,1
21654,938,484,454,137,100,104,41,987,515,472,107,110,106,61,1
21655,1215,572,643,151,105,127,54,461,227,234,61,47,54,33,1
21656,512,269,243,69,70,62,29,522,239,283,75,88,45,11,1
21657,146,75,71,13,32,15,11,560,244,316,92,118,47,12,1
21658,265,103,162,61,58,25,3,131,66,65,21,14,23,7,1
21659,158,71,87,23,21,17,12,987,515,472,107,110,106,61,1
21660,894,469,425,127,93,82,31,201,42,159,19,3,2,75,1
21661,362,174,188,46,55,35,23,501,240,261,80,62,49,42,1
21662,1417,598,819,223,188,135,58,500,236,264,85,69,33,17,1
21663,84,61,23,9,2,13,2,297,183,114,31,22,46,14,1
21664,1849,882,967,239,239,191,84,142,77,65,24,16,12,6,1
21665,251,178,73,21,12,50,12,189,91,97,36,24,13,6,1
21666,263,136,127,29,24,19,31,552,285,267,74,51,69,24,1
21667,333,192,141,50,48,28,10,837,447,390,95,81,93,34,1
21668,603,311,292,102,71,66,23,883,403,480,140,119,85,38,1
21669,339,170,169,32,17,24,13,619,292,327,73,73,61,32,1
21670,947,482,465,143,107,89,37,538,252,286,77,87,53,30,1
21671,513,246,267,71,66,60,35,445,219,226,61,60,60,21,1
21672,418,213,205,54,70,38,18,323,159,164,49,28,38,22,1
21673,593,266,327,102,84,69,24,1290,629,661,191,187,167,55,1
21674,408,205,203,80,40,55,23,201,42,159,19,3,2,75,1
21675,263,159,104,30,27,31,11,808,484,324,80,63,76,24,1
21676,277,151,126,35,30,24,15,603,311,292,102,71,66,23,1
21677,2016,1107,909,214,229,238,111,926,435,491,133,132,85,17,1
21678,280,142,138,35,37,22,13,126,66,60,24,10,7,9,1
21679,638,305,333,68,90,70,29,1154,540,614,195,160,138,66,1
21680,155,74,81,23,19,20,5,923,471,452,119,117,119,41,1
21681,502,299,203,57,52,32,11,529,283,246,66,69,66,25,1
21682,1140,495,645,129,95,128,159,963,468,495,155,164,92,40,1
21683,339,170,169,32,17,24,13,393,186,207,58,50,36,22,1
21684,1094,508,586,152,151,77,36,365,180,185,63,35,48,19,1
21685,158,85,73,24,18,18,8,393,186,207,58,50,36,22,1
21686,227,110,117,33,26,24,13,216,121,95,38,27,25,6,1
21687,401,226,175,53,18,38,20,551,298,253,63,65,45,19,1
21688,558,306,252,75,55,74,23,115,83,32,4,8,15,9,1
21689,435,221,214,72,45,47,19,270,128,142,36,43,15,11,1
21690,461,223,238,66,57,36,23,462,233,229,66,49,43,30,1
21691,2261,1217,1044,271,243,267,101,197,99,98,35,27,14,6,1
21692,340,169,171,49,42,31,14,354,192,162,46,43,30,20,1
21693,1210,485,725,205,139,79,34,568,193,375,112,83,50,15,1
21694,221,110,111,28,32,25,11,1117,423,694,182,134,88,31,1
21695,667,360,307,76,92,46,27,399,177,222,53,74,19,4,1
21696,530,259,271,83,50,54,41,149,68,81,15,38,11,10,1
21697,490,198,292,65,81,39,27,1102,511,591,171,179,148,52,1
21698,736,388,348,88,85,67,28,671,326,345,111,77,74,11,1
21699,470,230,240,67,60,42,16,4544,2024,2520,579,628,480,403,1
21700,309,154,155,42,44,45,16,435,243,192,52,66,43,14,1
21701,298,167,131,47,33,40,8,493,230,263,73,47,47,13,1
21702,567,296,271,88,53,55,30,219,124,95,22,22,23,5,1
21703,140,62,78,28,14,8,5,229,100,129,34,32,15,6,1
21704,185,94,91,23,19,17,9,211,90,121,49,27,14,11,1
21705,512,269,243,69,70,62,29,501,265,236,89,52,45,16,1
21706,737,363,374,119,101,85,41,374,191,183,70,48,61,13,1
21707,502,299,203,57,52,32,11,486,229,257,75,104,49,10,1
21708,145,75,70,19,17,18,10,123,67,56,12,13,18,7,1
21709,1154,540,614,195,160,138,66,1106,579,527,121,152,113,45,1
21710,303,141,162,42,57,37,20,1466,991,475,136,129,59,39,1
21711,247,110,137,34,45,23,10,535,288,247,79,72,35,21,1
21712,532,269,263,72,59,59,39,396,192,204,71,41,51,15,1
21713,212,114,98,25,26,19,11,853,401,452,121,118,74,38,1
21714,1821,809,1012,317,235,180,69,1242,613,629,174,113,114,53,1
21715,235,94,141,45,37,31,7,355,165,190,53,56,42,19,1
21716,466,186,280,71,84,30,11,336,134,202,51,64,27,12,1
21717,1154,540,614,195,160,138,66,822,402,420,125,107,82,26,1
21718,1508,733,775,216,186,172,60,92,46,46,14,9,8,6,1
21719,422,200,222,90,54,24,14,595,316,279,86,60,65,40,1
21720,249,111,138,40,30,22,17,172,74,98,32,30,11,7,1
21721,465,225,240,65,44,65,25,278,111,167,66,66,19,8,1
21722,1178,661,517,166,140,126,48,430,239,191,63,42,51,19,1
21723,1071,455,616,169,151,92,49,1651,798,853,203,199,137,50,1
21724,217,115,102,40,24,26,6,672,334,338,110,93,91,41,1
21725,472,259,213,51,44,56,21,512,261,251,79,73,60,21,1
21726,501,240,261,80,62,49,42,780,409,371,125,80,60,34,1
21727,2524,1232,1292,398,317,186,61,463,236,227,64,50,44,29,1
21728,352,212,140,37,17,61,20,527,263,264,81,63,72,31,1
21729,267,124,143,45,46,26,4,493,281,212,57,50,51,20,1
21730,1210,592,618,157,138,116,85,661,361,300,65,82,57,15,1
21731,222,97,125,36,23,21,12,288,118,170,50,57,18,15,1
21732,705,396,309,87,48,53,17,94,45,49,11,20,10,4,1
21733,1032,426,606,172,172,80,35,1464,693,771,153,136,91,86,1
21734,948,484,464,134,131,75,27,543,221,322,78,122,37,12,1
21735,767,392,375,113,112,83,13,921,455,466,144,127,108,39,1
21736,145,75,70,19,17,18,10,135,73,62,15,16,15,8,1
21737,432,190,242,85,82,28,11,393,186,207,58,50,36,22,1
21738,652,329,323,65,70,51,50,201,78,123,42,47,19,8,1
21739,181,84,97,32,29,19,8,354,168,186,50,53,39,20,1
21740,418,180,238,76,64,54,34,193,99,94,31,31,16,12,1
21741,344,181,163,61,37,40,14,918,357,561,191,150,42,24,1
21742,836,416,420,106,80,85,40,810,367,443,115,92,94,59,1
21743,716,354,362,102,87,77,30,382,183,199,55,60,38,22,1
21744,433,229,204,60,59,53,24,743,341,402,104,89,68,38,1
21745,190,94,96,24,33,24,6,689,343,346,119,100,86,38,1
21746,210,115,95,31,22,27,10,748,355,393,121,91,95,26,1
21747,151,84,67,17,17,22,11,550,337,213,47,33,55,31,1
21748,425,210,215,56,43,52,25,467,224,243,70,43,67,23,1
21749,184,78,106,21,25,25,12,501,240,261,80,62,49,42,1
21750,336,154,182,51,48,39,22,521,265,256,56,44,35,12,1
21751,528,228,300,60,119,43,28,966,530,436,128,119,134,29,1
21752,436,201,235,54,37,34,20,332,172,160,50,33,35,9,1
21753,525,237,288,121,59,105,20,253,155,98,27,20,22,14,1
21754,530,281,249,58,60,33,21,158,85,73,24,18,18,8,1
21755,593,257,336,76,56,56,96,923,509,414,95,102,65,52,1
21756,530,259,271,83,50,54,41,651,306,345,85,64,61,32,1
21757,1179,608,571,142,143,126,48,798,378,420,99,94,71,63,1
21758,162,73,89,32,19,4,4,245,111,134,36,27,18,6,1
21759,894,492,402,95,103,88,42,748,341,407,121,87,96,52,1
21760,698,345,353,104,87,81,50,450,229,221,49,63,54,27,1
21761,1290,597,693,182,182,119,63,482,231,251,76,81,64,26,1
21762,475,203,272,90,58,50,16,503,263,240,72,55,51,34,1
21763,142,77,65,24,16,12,6,1132,646,486,99,102,71,41,1
21764,497,257,240,71,63,62,16,862,409,453,149,125,86,29,1
21765,433,222,211,68,58,42,23,758,338,420,132,87,67,29,1
21766,501,240,261,80,62,49,42,178,100,78,23,22,30,6,1
21767,848,461,387,111,102,108,42,2671,1322,1349,379,345,290,135,1
21768,180,97,83,29,20,26,8,1167,418,749,226,204,88,39,1
21769,855,422,433,109,97,109,50,431,201,230,69,39,55,33,1
21770,767,392,375,113,112,83,13,894,420,474,136,146,93,39,1
21771,509,254,255,67,55,52,35,745,351,394,88,95,68,56,1
21772,862,427,435,139,98,100,59,165,76,89,26,24,18,15,1
21773,318,150,168,60,42,32,12,480,232,248,83,64,51,25,1
21774,309,144,165,54,39,25,12,854,380,474,137,159,81,31,1
21775,920,492,428,100,92,88,49,336,154,182,51,48,39,22,1
21776,519,246,273,78,82,42,16,866,503,363,97,94,116,39,1
21777,360,201,159,38,38,34,13,469,221,248,49,60,55,21,1
21778,229,120,109,31,30,22,9,1221,595,626,201,152,83,31,1
21779,624,204,420,166,101,32,13,378,209,169,57,42,49,11,1
21780,208,99,109,28,30,18,9,656,292,364,79,102,69,35,1
21781,646,304,342,104,93,58,26,298,167,131,47,33,40,8,1
21782,947,506,441,105,126,75,14,3460,1748,1712,369,360,496,190,1
21783,476,251,225,57,67,57,18,616,304,312,75,71,55,25,1
21784,593,266,327,102,84,69,24,724,334,390,112,109,79,17,1
21785,669,340,329,77,61,94,40,288,118,170,50,57,18,15,1
21786,279,106,173,48,35,41,39,815,418,397,97,62,70,17,1
21787,238,151,87,15,14,35,18,228,139,89,24,21,32,18,1
21788,2414,1189,1225,277,178,170,169,1360,644,716,213,194,136,62,1
21789,1382,599,783,208,252,90,39,182,96,86,24,17,18,13,1
21790,351,184,167,59,45,54,9,660,272,388,122,92,62,15,1
21791,160,77,83,14,27,11,10,505,247,258,72,71,60,27,1
21792,458,210,248,39,38,25,16,207,93,114,20,33,19,10,1
21793,894,492,402,95,103,88,42,461,208,253,79,76,61,21,1
21794,499,253,246,74,39,64,23,4563,2219,2344,620,531,527,104,1
21795,450,232,218,58,54,42,20,444,191,253,77,65,53,21,1
21796,268,157,111,26,30,28,13,439,177,262,78,73,40,21,1
21797,241,115,126,44,21,29,10,427,204,223,38,57,26,32,1
21798,789,362,427,90,82,70,35,667,366,301,96,55,84,25,1
21799,168,71,97,29,19,20,10,392,218,174,43,42,32,27,1
21800,394,202,192,44,43,38,28,732,355,377,108,109,79,27,1
21801,400,221,179,51,42,38,16,679,338,341,96,95,40,23,1
21802,822,416,406,111,105,84,44,216,94,122,43,17,23,9,1
21803,1124,441,683,148,189,72,43,2414,1189,1225,277,178,170,169,1
21804,981,465,516,126,164,112,38,253,148,105,31,15,39,16,1
21805,537,276,261,75,68,68,22,858,417,441,93,124,75,26,1
21806,627,351,276,78,62,71,32,502,279,223,62,54,66,28,1
21807,375,198,177,48,44,45,22,503,263,240,72,55,51,34,1
21808,369,181,188,41,36,54,16,1154,540,614,195,160,138,66,1
21809,594,274,320,89,63,66,28,480,234,246,79,77,65,23,1
21810,342,178,164,33,38,35,15,245,111,134,31,44,20,11,1
21811,763,343,420,127,70,105,34,247,110,137,34,45,23,10,1
21812,712,331,381,111,86,86,34,303,175,128,43,36,34,12,1
21813,690,327,363,115,91,54,31,208,97,111,39,19,22,11,1
21814,863,450,413,116,122,106,41,3530,1947,1583,530,360,410,110,1
21815,346,183,163,51,38,23,6,205,114,91,25,24,20,15,1
21816,317,181,136,36,36,26,12,709,269,440,140,163,66,18,1
21817,193,108,85,24,15,18,9,524,270,254,84,72,70,23,1
21818,160,67,93,32,37,15,9,769,329,440,116,66,55,22,1
21819,817,397,420,120,152,48,17,443,240,203,66,31,57,27,1
21820,288,159,129,27,44,27,15,211,137,74,16,9,22,21,1
21821,278,121,157,47,50,19,8,875,376,499,155,125,53,39,1
21822,150,81,69,24,23,16,4,1290,597,693,182,182,119,63,1
21823,410,222,188,54,49,43,13,522,235,287,78,67,60,50,1
21824,439,260,179,47,40,23,19,443,277,166,51,30,30,22,1
21825,737,363,374,119,101,85,41,143,79,64,16,25,7,5,1
21826,454,229,225,61,53,63,18,776,356,420,122,103,85,30,1
21827,198,102,96,30,21,20,12,859,395,464,157,119,59,31,1
21828,375,214,161,38,36,24,17,904,443,461,118,89,124,30,1
21829,1496,760,736,217,184,151,41,1696,771,925,257,225,149,63,1
21830,92,40,52,14,23,13,7,562,309,253,70,65,58,17,1
21831,585,289,296,102,86,61,18,293,169,124,52,22,25,12,1
21832,201,93,108,34,39,21,6,211,114,97,32,24,19,10,1
21833,510,264,246,67,66,38,29,684,288,396,107,90,54,42,1
21834,1115,552,563,104,116,115,35,360,192,168,55,45,48,16,1
21835,351,184,167,59,45,54,9,1223,633,590,157,149,133,54,1
21836,354,171,183,54,36,31,10,215,80,135,54,56,21,9,1
21837,684,288,396,107,90,54,42,235,111,124,38,26,31,22,1
21838,1919,871,1048,315,265,148,61,781,418,363,92,90,64,41,1
21839,1215,572,643,151,105,127,54,335,128,207,59,43,24,23,1
21840,596,289,307,86,75,71,33,625,316,309,77,79,54,34,1
21841,3336,1358,1978,571,599,203,101,854,399,455,127,118,57,39,1
21842,168,120,48,7,5,20,7,1425,670,755,153,189,122,85,1
21843,482,231,251,76,81,64,26,497,185,312,63,92,38,28,1
21844,854,380,474,137,159,81,31,291,131,160,40,42,36,14,1
21845,255,143,112,22,29,34,12,261,134,127,39,27,30,11,1
21846,219,99,120,46,31,17,5,335,185,150,46,34,36,13,1
21847,1192,579,613,120,215,79,24,448,236,212,53,64,56,24,1
21848,972,463,509,138,117,91,53,714,364,350,98,102,91,27,1
21849,247,127,120,43,20,27,14,894,479,415,117,93,119,38,1
21850,1149,568,581,177,133,101,30,1271,599,672,194,175,118,47,1
21851,211,83,128,28,35,5,11,276,134,142,46,50,32,16,1
21852,979,492,487,120,122,89,51,302,158,144,48,35,38,20,1
21853,176,92,84,25,26,15,8,710,357,353,99,79,72,39,1
21854,298,167,131,47,33,40,8,764,277,487,158,162,64,31,1
21855,700,348,352,93,115,85,27,317,153,164,34,52,30,14,1
21856,443,208,235,43,55,51,50,272,131,141,36,26,36,16,1
21857,835,381,454,133,112,81,44,414,216,198,51,32,42,28,1
21858,651,311,340,110,77,73,33,586,240,346,94,110,29,19,1
21859,3664,1638,2026,598,519,231,63,289,143,146,38,18,40,8,1
21860,673,317,356,101,85,76,49,391,201,190,52,47,35,24,1
21861,2440,1061,1379,377,326,172,62,706,320,386,111,76,75,51,1
21862,1039,597,442,101,110,106,33,417,182,235,57,109,50,8,1
21863,595,316,279,86,60,65,40,351,184,167,59,45,54,9,1
21864,1581,684,897,220,153,118,63,413,236,177,41,25,35,19,1
21865,360,161,199,72,36,35,13,243,120,123,30,24,26,13,1
21866,318,176,142,25,32,35,25,673,317,356,101,85,76,49,1
21867,1140,586,554,130,146,117,49,600,254,346,95,90,52,42,1
21868,301,150,151,41,30,17,11,246,123,123,40,31,27,7,1
21869,647,324,323,101,80,76,43,659,323,336,80,89,53,18,1
21870,379,203,176,55,48,45,16,1076,563,513,129,114,90,37,1
21871,520,261,259,82,76,71,24,854,380,474,137,159,81,31,1
21872,267,159,108,31,13,22,15,2040,956,1084,202,190,258,147,1
21873,234,129,105,31,22,19,18,393,186,207,58,50,36,22,1
21874,900,480,420,108,105,96,30,856,429,427,113,105,96,24,1
21875,648,307,341,101,58,76,34,1412,603,809,184,195,112,45,1
21876,870,433,437,133,121,95,25,1484,731,753,206,175,187,71,1
21877,557,306,251,66,42,52,15,446,176,270,64,79,45,24,1
21878,430,218,212,58,47,34,20,193,83,110,26,20,16,9,1
21879,195,100,95,26,39,20,4,1279,733,546,143,121,130,49,1
21880,290,162,128,38,33,22,17,395,191,204,50,66,29,12,1
21881,628,324,304,83,85,75,23,240,125,115,34,32,30,8,1
21882,534,266,268,86,62,37,14,808,374,434,140,108,54,17,1
21883,307,181,126,45,18,40,10,299,140,159,27,59,20,18,1
21884,558,306,252,75,55,74,23,459,287,172,33,12,59,30,1
21885,604,255,349,100,72,55,26,601,313,288,42,48,25,36,1
21886,164,61,103,47,19,14,5,366,191,175,37,33,19,19,1
21887,770,356,414,123,102,66,25,1257,525,732,216,210,79,52,1
21888,179,78,101,29,22,10,8,654,344,310,80,69,57,15,1
21889,575,290,285,67,70,28,9,215,80,135,54,56,21,9,1
21890,1118,551,567,128,145,95,36,797,406,391,121,86,64,15,1
21891,372,196,176,51,36,51,8,317,153,164,34,52,30,14,1
21892,941,459,482,167,140,82,38,595,316,279,86,60,65,40,1
21893,361,167,194,55,35,41,11,451,278,173,71,35,58,12,1
21894,294,148,146,35,33,25,14,800,387,413,122,77,90,34,1
21895,193,105,88,33,16,9,4,149,68,81,15,38,11,10,1
21896,970,440,530,142,102,111,39,503,263,240,72,55,51,34,1
21897,115,62,53,13,10,9,7,1124,615,509,157,125,128,52,1
21898,646,304,342,104,93,58,26,277,124,153,44,40,35,18,1
21899,551,298,253,63,65,45,19,778,367,411,90,85,64,43,1
21900,1032,426,606,172,172,80,35,963,385,578,171,162,62,35,1
21901,688,310,378,130,82,78,47,122,64,58,13,11,15,8,1
21902,815,418,397,97,62,70,17,367,197,170,49,36,36,18,1
21903,920,492,428,100,92,88,49,1158,481,677,169,129,86,40,1
21904,901,443,458,134,141,88,40,894,420,474,136,146,93,39,1
21905,749,360,389,91,122,59,37,4544,2024,2520,579,628,480,403,1
21906,1356,672,684,171,172,134,59,1657,800,857,249,235,154,51,1
21907,800,416,384,102,105,83,22,1443,776,667,191,175,160,56,1
21908,505,273,232,70,57,60,33,1336,736,600,137,136,163,69,1
21909,338,193,145,34,27,53,17,211,83,128,28,35,5,11,1
21910,598,323,275,68,53,60,17,362,183,179,49,49,41,11,1
21911,1272,520,752,235,242,117,54,483,155,328,138,109,32,9,1
21912,1609,694,915,204,241,132,122,1270,557,713,130,195,57,30,1
21913,437,225,212,61,57,66,12,400,221,179,51,42,38,16,1
21914,295,143,152,38,47,22,25,1068,527,541,160,131,112,52,1
21915,379,203,176,55,48,45,16,468,233,235,65,61,49,34,1
21916,1103,536,567,171,156,81,43,245,112,133,32,45,20,10,1
21917,288,104,184,80,30,39,6,642,325,317,74,78,73,43,1
21918,368,158,210,64,61,39,14,771,321,450,151,135,43,15,1
21919,293,134,159,40,27,23,30,250,137,113,33,19,24,9,1
21920,130,55,75,21,26,10,3,933,493,440,140,108,124,32,1
21921,303,141,162,42,57,37,20,1464,987,477,137,141,55,31,1
21922,267,129,138,45,40,23,14,332,198,134,29,17,46,28,1
21923,391,208,183,65,49,57,17,633,303,330,95,91,51,13,1
21924,624,308,316,92,72,68,22,1434,727,707,210,173,161,54,1
21925,441,201,240,70,58,55,24,582,293,289,94,80,77,32,1
21926,1395,627,768,172,263,141,59,908,481,427,118,88,109,49,1
21927,347,154,193,48,51,25,11,476,235,241,62,57,34,22,1
21928,972,435,537,135,126,100,48,467,224,243,70,43,67,23,1
21929,695,373,322,80,59,89,39,765,295,470,200,142,84,27,1
21930,76,42,34,12,8,5,7,140,86,54,17,6,20,7,1
21931,802,388,414,131,105,96,29,136,65,71,33,11,9,6,1
21932,372,189,183,60,44,41,18,1970,978,992,245,206,198,80,1
21933,330,157,173,56,42,51,8,1332,652,680,210,180,155,49,1
21934,622,299,323,86,86,69,35,499,251,248,69,59,61,22,1
21935,380,212,168,47,38,19,11,342,208,134,36,31,29,15,1
21936,298,167,131,47,33,40,8,152,74,78,17,20,16,6,1
21937,430,198,232,57,46,37,19,436,201,235,54,37,34,20,1
21938,494,234,260,88,81,61,29,280,136,144,41,34,26,16,1
21939,178,100,78,23,22,30,6,382,214,168,49,20,47,23,1
21940,294,122,172,46,65,18,11,1265,580,685,205,188,166,53,1
21941,441,175,266,73,88,26,8,639,322,317,73,82,39,23,1
21942,311,154,157,47,29,34,13,194,112,82,26,13,17,8,1
21943,1424,650,774,152,124,95,87,533,297,236,74,57,39,28,1
21944,784,391,393,105,113,86,21,583,322,261,73,66,45,26,1
21945,751,312,439,131,115,78,48,366,193,173,46,57,38,18,1
21946,843,391,452,139,104,91,34,2843,1104,1739,429,357,178,95,1
21947,4829,2417,2412,551,526,409,214,458,269,189,56,40,29,7,1
21948,732,355,377,108,109,79,27,1621,750,871,276,243,162,51,1
21949,163,70,93,28,21,17,6,613,333,280,71,66,47,26,1
21950,131,78,53,8,5,9,13,164,88,76,27,20,17,6,1
21951,1655,891,764,205,245,81,30,782,347,435,110,92,74,34,1
21952,509,262,247,64,70,64,20,243,120,123,30,24,26,13,1
21953,1038,527,511,118,163,120,52,876,457,419,88,124,67,47,1
21954,467,226,241,55,48,54,23,2912,1266,1646,268,360,243,422,1
21955,1423,620,803,193,207,127,66,375,202,173,46,49,41,23,1
21956,416,209,207,76,45,50,17,716,354,362,102,87,77,30,1
21957,656,358,298,67,47,64,26,349,183,166,56,55,38,5,1
21958,298,154,144,44,34,25,11,788,381,407,77,41,46,35,1
21959,853,400,453,137,109,88,42,751,312,439,131,115,78,48,1
21960,509,254,255,67,55,52,35,207,89,118,28,26,16,6,1
21961,361,184,177,50,53,51,22,1158,481,677,169,129,86,40,1
21962,695,264,431,172,114,51,23,248,118,130,54,31,26,5,1
21963,592,291,301,92,93,71,31,189,90,99,26,29,17,11,1
21964,171,94,77,24,28,30,11,770,390,380,104,76,78,32,1
21965,3418,1378,2040,515,464,318,121,1863,721,1142,262,283,139,74,1
21966,185,115,70,19,17,26,6,307,154,153,39,36,31,12,1
21967,822,417,405,112,97,88,40,136,65,71,33,11,9,6,1
21968,364,241,123,33,16,38,19,631,332,299,61,104,60,19,1
21969,511,290,221,67,59,77,22,4377,1898,2479,663,608,331,126,1
21970,1313,644,669,169,90,111,43,1098,552,546,157,133,110,58,1
21971,982,494,488,150,117,91,45,619,332,287,95,77,74,38,1
21972,480,234,246,79,77,65,23,505,269,236,52,59,32,18,1
21973,152,74,78,16,20,16,5,240,125,115,34,32,30,8,1
21974,309,149,160,55,33,27,15,239,121,118,28,38,15,7,1
21975,211,88,123,38,28,26,10,2016,1107,909,214,229,238,111,1
21976,355,165,190,53,56,42,19,1119,647,472,144,100,118,61,1
21977,222,110,112,43,30,14,6,160,77,83,14,27,11,10,1
21978,1203,462,741,215,230,40,22,1748,791,957,281,247,173,25,1
21979,448,281,167,47,37,45,13,953,481,472,133,130,77,48,1
21980,770,390,380,104,76,78,32,168,90,78,22,19,13,4,1
21981,277,100,177,35,88,30,2,457,228,229,64,36,52,21,1
21982,291,146,145,39,45,22,16,276,143,133,34,38,20,15,1
21983,433,226,207,52,60,58,20,342,208,134,36,31,29,15,1
21984,512,248,264,66,71,49,30,145,70,75,24,16,16,20,1
21985,1058,558,500,132,127,121,53,628,341,287,77,59,55,31,1
21986,2639,1436,1203,317,307,242,77,794,402,392,96,84,86,30,1
21987,522,235,287,78,67,60,50,389,201,188,61,64,47,18,1
21988,1047,562,485,141,127,114,41,673,328,345,107,112,63,27,1
21989,272,173,99,32,32,11,8,540,271,269,80,77,51,16,1
21990,443,226,217,67,34,53,10,265,103,162,61,58,25,3,1
21991,740,313,427,101,135,40,22,482,231,251,76,81,64,26,1
21992,331,169,162,40,28,22,14,98,32,66,15,25,5,4,1
21993,413,206,207,38,55,19,10,700,265,435,134,106,16,3,1
21994,626,272,354,96,80,71,36,2090,1085,1005,167,141,168,40,1
21995,185,94,91,23,19,17,9,194,94,100,35,19,25,16,1
21996,480,256,224,67,55,26,22,791,306,485,142,157,21,18,1
21997,1463,698,765,194,180,248,80,144,62,82,29,8,19,17,1
21998,874,431,443,112,120,79,50,587,310,277,80,64,84,26,1
21999,202,102,100,29,35,6,9,271,159,112,34,34,33,7,1
22000,815,382,433,97,50,88,31,640,279,361,102,83,69,21,1
22001,508,268,240,92,58,56,21,472,259,213,51,44,56,21,1
22002,772,323,449,174,108,68,22,144,69,75,11,21,8,5,1
22003,350,180,170,64,46,55,12,171,94,77,24,28,30,11,1
22004,450,229,221,49,63,54,27,437,225,212,61,57,66,12,1
22005,402,227,175,48,40,35,11,533,331,202,52,33,73,23,1
22006,2303,1190,1113,331,253,115,66,268,140,128,33,39,26,9,1
22007,208,96,112,31,32,13,9,522,245,277,78,69,52,21,1
22008,1377,579,798,179,169,139,99,396,150,246,103,64,38,3,1
22009,105,51,54,13,17,12,8,1464,987,477,137,141,55,31,1
22010,489,242,247,83,63,62,19,894,420,474,136,146,93,39,1
22011,363,200,163,55,39,42,18,503,263,240,72,55,51,34,1
22012,278,111,167,66,66,19,8,353,195,158,40,55,30,13,1
22013,520,224,296,69,64,31,29,781,418,363,92,90,64,41,1
22014,185,97,88,15,38,12,5,951,506,445,107,118,79,40,1
22015,350,181,169,44,52,43,13,294,148,146,35,33,25,14,1
22016,568,193,375,112,83,50,15,168,67,101,37,17,13,13,1
22017,499,249,250,79,63,61,22,495,233,262,64,39,49,32,1
22018,340,158,182,51,56,9,7,517,250,267,78,37,64,29,1
22019,760,322,438,81,130,57,19,1270,557,713,130,195,57,30,1
22020,838,385,453,110,137,78,28,477,301,176,52,35,45,24,1
22021,163,70,93,28,21,17,6,239,146,93,30,22,35,9,1
22022,246,108,138,32,44,21,10,685,315,370,108,99,36,9,1
22023,852,424,428,114,81,90,47,1922,923,999,267,275,215,90,1
22024,597,313,284,87,75,82,28,219,124,95,22,22,23,5,1
22025,211,127,84,30,26,13,6,118,60,58,22,9,8,9,1
22026,1290,629,661,191,187,167,55,217,109,108,34,30,34,5,1
22027,264,122,142,33,29,13,13,1085,646,439,108,65,36,19,1
22028,1905,901,1004,269,248,149,78,1052,492,560,184,163,103,44,1
22029,156,64,92,39,19,15,8,757,373,384,115,93,95,25,1
22030,3695,1922,1773,449,360,352,261,746,361,385,91,92,101,32,1
22031,1158,481,677,169,129,86,40,597,246,351,95,98,45,25,1
22032,724,320,404,120,147,67,25,439,227,212,60,55,58,8,1
22033,272,173,99,32,32,11,8,291,146,145,39,45,22,16,1
22034,308,146,162,42,39,24,12,437,212,225,66,44,44,11,1
22035,732,355,377,108,109,79,27,609,292,317,102,96,64,21,1
22036,428,248,180,44,39,28,9,427,218,209,61,53,45,26,1
22037,817,427,390,100,97,87,32,462,157,305,93,51,54,3,1
22038,225,106,119,32,33,24,10,933,536,397,96,90,71,41,1
22039,429,219,210,46,66,42,17,179,89,90,36,28,31,9,1
22040,802,370,432,134,111,81,31,191,99,92,25,24,18,8,1
22041,1424,650,774,152,124,95,87,246,113,133,33,45,22,10,1
22042,196,113,83,26,17,11,6,438,258,180,49,28,76,28,1
22043,861,393,468,150,101,69,35,904,436,468,138,146,82,39,1
22044,426,224,202,48,38,53,13,769,329,440,116,66,55,22,1
22045,1690,795,895,271,257,150,101,427,191,236,67,60,41,34,1
22046,608,336,272,61,49,78,31,1441,657,784,140,135,81,73,1
22047,977,492,485,135,122,116,35,467,269,198,46,51,60,18,1
22048,854,380,474,137,159,81,31,778,367,411,90,85,64,43,1
22049,639,368,271,72,51,38,38,239,146,93,30,22,35,9,1
22050,451,222,229,72,46,57,17,164,78,86,28,23,12,8,1
22051,235,104,131,29,35,26,10,522,235,287,78,67,60,50,1
22052,524,281,243,71,58,63,21,501,240,261,80,62,49,42,1
22053,735,352,383,98,77,98,37,749,354,395,77,74,76,35,1
22054,95,44,51,14,13,7,4,397,186,211,73,63,36,25,1
22055,1278,593,685,198,201,71,43,336,154,182,51,48,39,22,1
22056,325,159,166,42,43,48,15,390,203,187,58,40,43,19,1
22057,598,322,276,67,57,63,26,745,392,353,110,102,91,33,1
22058,247,110,137,34,45,23,10,193,93,100,33,18,25,7,1
22059,1163,615,548,122,109,128,41,321,141,180,45,47,32,17,1
22060,719,364,355,104,100,58,34,616,304,312,75,71,55,25,1
22061,611,314,297,79,75,78,22,178,89,89,26,21,21,10,1
22062,482,231,251,76,81,64,26,643,263,380,107,72,79,23,1
22063,574,295,279,78,65,61,22,522,235,287,78,67,60,50,1
22064,5202,2614,2588,543,451,623,272,430,192,238,62,67,27,10,1
22065,158,85,73,24,18,18,8,509,341,168,35,32,52,15,1
22066,1274,669,605,185,172,116,43,33423,16370,17053,4965,4756,2786,883,1
22067,647,282,365,104,90,53,27,575,218,357,135,58,89,41,1
22068,415,189,226,69,54,50,21,794,390,404,103,95,86,23,1
22069,1721,809,912,268,234,144,50,480,234,246,79,77,65,23,1
22070,396,192,204,71,41,51,15,236,118,118,26,20,18,7,1
22071,705,396,309,87,48,53,17,304,159,145,38,40,32,3,1
22072,620,335,285,70,41,62,33,543,287,256,71,66,64,23,1
22073,360,192,168,55,45,48,16,1177,666,511,131,99,88,35,1
22074,377,177,200,63,53,44,16,925,432,493,137,135,106,43,1
22075,556,283,273,77,55,70,27,256,125,131,34,27,24,14,1
22076,676,333,343,111,89,94,39,770,385,385,78,83,60,16,1
22077,293,142,151,49,40,42,17,1756,697,1059,328,345,110,27,1
22078,559,281,278,87,70,67,34,1255,708,547,120,68,88,7,1
22079,204,84,120,29,30,16,9,245,112,133,32,45,20,10,1
22080,330,208,122,44,20,44,12,246,113,133,33,45,22,10,1
22081,672,334,338,110,93,91,41,129,67,62,16,13,17,5,1
22082,1956,1067,889,219,218,245,93,375,202,173,46,49,41,23,1
22083,837,399,438,112,144,71,32,770,355,415,103,142,75,42,1
22084,797,395,402,107,117,77,22,447,194,253,70,67,57,19,1
22085,354,181,173,52,18,50,15,798,393,405,112,80,83,33,1
22086,401,198,203,70,29,38,15,644,343,301,96,69,59,28,1
22087,401,198,203,70,29,38,15,246,115,131,15,29,10,32,1
22088,779,354,425,96,69,57,36,601,313,288,42,48,25,36,1
22089,501,216,285,79,70,54,30,355,197,158,38,43,49,9,1
22090,243,113,130,38,35,16,12,116,67,49,13,12,6,5,1
22091,843,404,439,107,112,93,34,503,263,240,72,55,51,34,1
22092,1190,638,552,162,95,112,18,1035,499,536,150,164,78,24,1
22093,435,208,227,68,64,53,23,787,386,401,98,95,86,25,1
22094,579,330,249,52,27,90,11,341,190,151,50,41,23,15,1
22095,381,189,192,74,49,44,13,477,281,196,38,41,63,29,1
22096,836,391,445,146,108,60,23,437,230,207,41,55,27,13,1
22097,511,202,309,70,84,37,21,336,134,202,51,64,27,12,1
22098,355,168,187,48,57,30,15,304,144,160,54,31,22,10,1
22099,707,386,321,85,83,99,28,354,193,161,51,41,58,13,1
22100,256,125,131,36,39,32,13,300,140,160,39,35,14,12,1
22101,674,319,355,84,139,50,11,171,69,102,28,26,7,7,1
22102,956,473,483,140,88,89,78,645,268,377,104,73,55,30,1
22103,182,90,92,25,23,14,5,350,169,181,42,51,40,21,1
22104,1970,978,992,245,206,198,80,1087,523,564,146,177,103,33,1
22105,327,177,150,40,40,38,18,527,257,270,72,68,50,28,1
22106,456,228,228,49,70,32,19,366,211,155,35,42,24,12,1
22107,859,398,461,96,109,89,57,136,72,64,22,16,7,3,1
22108,250,126,124,29,19,16,31,1367,690,677,172,175,154,83,1
22109,393,186,207,58,50,36,22,280,121,159,60,45,22,12,1
22110,337,222,115,33,21,38,20,1744,920,824,223,192,177,58,1
22111,673,329,344,111,95,92,41,736,388,348,88,85,67,28,1
22112,1132,624,508,199,79,127,41,525,274,251,82,74,60,25,1
22113,318,143,175,65,19,17,7,402,227,175,48,40,35,11,1
22114,1256,595,661,153,143,106,130,442,208,234,68,49,51,25,1
22115,522,283,239,65,64,76,22,1748,791,957,281,247,173,25,1
22116,190,74,116,34,29,11,11,920,492,428,100,92,88,49,1
22117,505,239,266,71,55,50,18,304,125,179,61,31,44,10,1
22118,709,326,383,109,93,50,17,416,228,188,63,25,40,20,1
22119,368,158,210,64,61,39,14,367,161,206,70,48,41,19,1
22120,920,492,428,100,92,88,49,2524,1232,1292,398,317,186,61,1
22121,374,184,190,52,38,48,11,223,127,96,25,23,33,4,1
22122,816,463,353,99,99,61,26,382,200,182,53,36,51,16,1
22123,729,358,371,116,99,89,33,540,282,258,50,53,33,16,1
22124,355,205,150,35,19,62,24,92,49,43,7,8,10,9,1
22125,302,138,164,50,36,30,20,275,125,150,37,48,27,7,1
22126,186,84,102,27,29,21,10,278,131,147,29,30,33,12,1
22127,304,125,179,61,31,44,10,440,267,173,52,29,42,12,1
22128,406,187,219,55,64,24,9,401,167,234,56,71,16,10,1
22129,938,484,454,137,100,104,41,737,363,374,119,101,85,41,1
22130,315,129,186,51,29,24,29,458,245,213,52,43,27,24,1
22131,391,208,183,65,49,57,17,448,275,173,32,53,55,27,1
22132,279,106,173,48,35,41,39,655,328,327,65,54,55,35,1
22133,129,78,51,17,9,10,10,501,240,261,80,62,49,42,1
22134,683,320,363,117,100,76,32,972,519,453,109,98,120,39,1
22135,961,463,498,139,156,62,34,371,197,174,36,41,38,18,1
22136,652,329,323,65,70,51,50,1712,1175,537,179,142,113,46,1
22137,480,234,246,79,77,65,23,648,307,341,101,58,76,34,1
22138,378,192,186,49,36,45,23,152,79,73,18,13,11,6,1
22139,980,537,443,125,99,98,50,919,502,417,121,100,116,48,1
22140,459,212,247,63,48,48,28,151,82,69,16,17,11,7,1
22141,593,266,327,102,84,69,24,508,295,213,42,61,53,17,1
22142,748,355,393,121,91,95,26,415,179,236,58,55,46,12,1
22143,459,212,247,63,48,48,28,139,62,77,23,6,14,4,1
22144,476,227,249,52,59,38,17,508,218,290,80,79,36,13,1
22145,529,274,255,57,62,38,14,452,224,228,69,56,50,31,1
22146,1721,809,912,268,234,144,50,1214,612,602,169,173,98,35,1
22147,503,259,244,73,53,52,28,390,203,187,58,40,43,19,1
22148,2549,1331,1218,366,296,271,130,184,95,89,22,22,19,7,1
22149,551,298,253,63,65,45,19,526,268,258,54,37,55,12,1
22150,1162,515,647,191,143,97,35,640,279,361,102,83,69,21,1
22151,257,148,109,28,20,21,14,824,397,427,113,95,82,33,1
22152,361,223,138,28,24,34,27,155,89,66,13,15,17,9,1
22153,468,233,235,65,61,49,34,364,172,192,67,61,40,14,1
22154,657,293,364,109,75,66,28,673,317,356,101,85,76,49,1
22155,1848,833,1015,304,257,195,71,576,250,326,93,71,34,15,1
22156,440,246,194,62,49,41,16,1434,727,707,210,173,161,54,1
22157,933,493,440,140,108,124,32,509,262,247,64,70,64,20,1
22158,305,168,137,48,35,40,9,444,232,212,66,34,61,22,1
22159,1162,528,634,193,161,107,74,426,228,198,62,42,47,22,1
22160,412,263,149,48,24,45,19,423,247,176,44,35,67,22,1
22161,3911,1465,2446,610,767,240,133,404,197,207,57,69,33,15,1
22162,754,318,436,114,106,58,28,4128,2104,2024,581,505,453,205,1
22163,4655,2074,2581,545,652,562,399,609,279,330,103,98,72,42,1
22164,290,127,163,47,58,23,12,425,199,226,54,71,56,11,1
22165,1202,506,696,209,198,74,44,1948,1039,909,242,227,200,67,1
22166,335,188,147,40,37,30,22,626,333,293,64,55,61,15,1
22167,2045,985,1060,359,339,199,74,763,354,409,101,90,63,26,1
22168,236,145,91,17,19,30,18,879,439,440,120,108,101,30,1
22169,619,290,329,97,79,62,19,397,191,206,60,41,41,24,1
22170,191,85,106,24,34,19,5,1132,624,508,199,79,127,41,1
22171,502,240,262,78,61,54,32,213,109,104,26,26,21,6,1
22172,175,90,85,28,21,19,7,949,512,437,102,124,70,41,1
22173,776,401,375,81,122,54,16,986,561,425,121,106,80,34,1
22174,380,184,196,58,52,46,8,722,384,338,94,83,63,35,1
22175,261,140,121,38,23,45,16,226,128,98,32,18,37,16,1
22176,906,455,451,116,105,87,46,512,261,251,79,73,60,21,1
22177,862,409,453,149,125,86,29,249,90,159,29,89,12,4,1
22178,390,218,172,48,21,66,17,374,181,193,63,49,46,20,1
22179,1893,850,1043,280,340,169,80,928,442,486,139,118,91,43,1
22180,410,186,224,72,57,52,22,391,208,183,65,49,57,17,1
22181,1304,585,719,179,169,154,47,1242,613,629,174,113,114,53,1
22182,552,285,267,74,51,69,24,467,224,243,70,43,67,23,1
22183,570,292,278,80,65,72,23,569,288,281,86,69,74,24,1
22184,982,545,437,119,100,92,40,402,227,175,48,40,35,11,1
22185,221,111,110,42,35,33,6,208,104,104,20,54,9,5,1
22186,315,150,165,52,36,22,15,572,309,263,64,55,47,29,1
22187,914,612,302,77,60,92,28,269,127,142,43,24,34,26,1
22188,2843,1104,1739,429,357,178,95,745,391,354,85,81,52,39,1
22189,306,128,178,49,59,17,9,145,70,75,24,16,16,20,1
22190,92,47,45,15,9,9,5,351,184,167,59,45,54,9,1
22191,308,160,148,39,46,30,12,181,96,85,25,23,20,7,1
22192,284,104,180,54,81,8,10,284,109,175,55,79,9,9,1
22193,89,44,45,15,12,15,6,1855,852,1003,329,264,184,83,1
22194,158,85,73,24,18,18,8,460,228,232,70,46,46,17,1
22195,380,184,196,58,52,46,8,862,409,453,149,125,86,29,1
22196,740,313,427,101,135,40,22,1616,735,881,285,248,153,72,1
22197,427,218,209,61,53,45,26,245,112,133,32,45,20,10,1
22198,355,205,150,35,19,62,24,94,48,46,16,7,8,6,1
22199,595,292,303,79,83,69,24,819,411,408,108,86,90,58,1
22200,1113,520,593,168,139,109,49,888,476,412,98,89,72,61,1
22201,454,224,230,71,39,62,22,525,299,226,54,54,51,19,1
22202,434,221,213,58,47,54,15,400,191,209,41,40,33,21,1
22203,165,89,76,19,16,12,5,372,174,198,56,42,43,30,1
22204,334,96,238,104,49,19,2,418,232,186,57,57,54,19,1
22205,651,331,320,93,93,51,28,234,129,105,31,22,19,18,1
22206,398,202,196,46,56,49,23,117,60,57,20,17,16,5,1
22207,545,230,315,91,101,50,16,87,48,39,15,9,9,3,1
22208,336,192,144,30,36,40,14,757,373,384,115,93,95,25,1
22209,241,124,117,30,35,24,8,140,75,65,22,18,30,7,1
22210,465,225,240,65,44,65,25,683,235,448,148,76,97,42,1
22211,321,173,148,47,27,39,17,2471,1130,1341,240,281,219,290,1
22212,738,339,399,102,88,68,35,300,136,164,44,35,33,21,1
22213,938,484,454,137,100,104,41,592,283,309,84,137,60,20,1
22214,1508,738,770,194,169,119,53,342,160,182,69,40,37,16,1
22215,181,96,85,25,23,20,7,415,209,206,60,67,39,18,1
22216,778,353,425,140,89,92,51,703,356,347,96,97,38,22,1
22217,158,71,87,23,21,17,12,1382,689,693,186,176,167,77,1
22218,380,212,168,47,38,19,11,1134,574,560,157,164,47,48,1
22219,862,409,453,149,125,86,29,524,270,254,84,72,70,23,1
22220,871,395,476,155,141,75,30,3144,1617,1527,367,342,278,136,1
22221,461,223,238,66,57,36,23,479,300,179,52,37,63,18,1
22222,154,75,79,17,24,16,13,757,359,398,109,127,80,26,1
22223,2157,1171,986,306,238,131,32,217,109,108,34,32,35,7,1
22224,297,158,139,47,37,37,9,1152,556,596,146,159,31,39,1
22225,750,347,403,105,103,83,29,794,390,404,103,95,86,23,1
22226,454,223,231,38,45,24,19,411,208,203,63,44,52,19,1
22227,557,268,289,66,67,70,17,619,332,287,95,77,74,38,1
22228,712,396,316,78,69,65,25,606,279,327,81,70,49,34,1
22229,737,363,374,119,101,85,41,748,386,362,111,75,71,40,1
22230,1154,540,614,195,160,138,66,863,470,393,82,72,92,44,1
22231,425,198,227,57,69,59,13,664,316,348,75,96,53,31,1
22232,556,274,282,74,68,62,37,288,158,130,59,23,21,10,1
22233,305,178,127,34,24,43,24,1748,791,957,281,247,173,25,1
22234,403,185,218,67,62,63,19,327,177,150,40,40,38,18,1
22235,1170,510,660,142,182,115,84,525,237,288,121,59,105,20,1
22236,853,400,453,137,109,88,42,441,201,240,70,58,55,24,1
22237,1100,474,626,197,143,126,41,906,455,451,116,105,87,46,1
22238,591,279,312,88,91,52,26,376,183,193,50,50,43,21,1
22239,514,254,260,55,57,56,19,327,160,167,56,31,36,15,1
22240,333,171,162,41,44,48,23,297,145,152,49,30,23,21,1
22241,484,225,259,85,76,58,26,490,216,274,67,77,52,21,1
22242,172,88,84,24,31,20,12,418,189,229,76,72,45,14,1
22243,218,127,91,27,23,23,10,193,118,75,25,19,10,7,1
22244,391,208,183,65,49,57,17,2364,1004,1360,406,426,226,79,1
22245,242,111,131,35,35,17,13,149,68,81,15,38,11,10,1
22246,730,442,288,104,88,42,68,145,70,75,24,16,16,20,1
22247,1464,987,477,137,141,55,31,2944,1827,1117,338,332,122,35,1
22248,355,166,189,54,54,39,17,370,232,138,36,23,42,21,1
22249,427,218,209,61,53,45,26,605,295,310,74,66,70,36,1
22250,391,189,202,55,56,56,12,267,159,108,31,13,22,15,1
22251,1257,662,595,176,142,106,42,581,323,258,74,58,48,20,1
22252,396,189,207,24,19,47,18,2414,1189,1225,277,178,170,169,1
22253,427,191,236,67,60,41,34,463,236,227,64,50,44,29,1
22254,352,179,173,54,46,35,22,629,338,291,92,57,64,22,1
22255,260,133,127,43,32,39,3,1392,799,593,150,115,175,56,1
22256,406,194,212,68,57,63,14,621,331,290,90,86,68,28,1
22257,375,202,173,46,49,41,23,1270,557,713,130,195,57,30,1
22258,640,348,292,80,65,77,17,467,224,243,70,43,67,23,1
22259,436,182,254,61,76,49,33,424,188,236,55,75,39,31,1
22260,895,474,421,122,93,69,25,217,109,108,34,32,35,7,1
22261,459,212,247,63,48,48,28,327,177,150,56,20,25,6,1
22262,490,224,266,80,70,39,32,743,366,377,41,37,26,14,1
22263,631,309,322,106,83,89,33,845,402,443,137,126,105,47,1
22264,225,125,100,33,32,29,12,330,175,155,44,42,35,14,1
22265,1037,461,576,146,163,75,44,1675,875,800,213,219,196,72,1
22266,406,211,195,55,37,47,16,562,265,297,79,56,72,45,1
22267,303,201,102,34,29,45,19,340,215,125,44,30,33,13,1
22268,744,385,359,125,89,90,23,246,108,138,32,44,21,10,1
22269,979,534,445,83,77,80,24,1149,568,581,177,133,101,30,1
22270,536,278,258,72,63,62,20,508,215,293,72,71,42,15,1
22271,518,262,256,70,52,49,27,1382,599,783,208,252,90,39,1
22272,1447,698,749,214,180,116,46,354,166,188,53,55,40,19,1
22273,124,69,55,15,13,12,2,393,210,183,55,50,34,19,1
22274,1251,591,660,183,137,106,50,575,295,280,89,68,54,18,1
22275,171,94,77,24,28,30,11,165,76,89,22,17,16,10,1
22276,763,354,409,101,90,63,26,158,85,73,24,18,18,8,1
22277,246,115,131,15,29,10,32,532,254,278,91,48,23,17,1
22278,427,218,209,61,53,45,26,184,95,89,17,21,18,8,1
22279,179,89,90,36,28,31,9,1332,659,673,174,170,153,55,1
22280,312,172,140,41,40,21,8,568,243,325,98,73,56,44,1
22281,1042,530,512,162,150,103,52,235,119,116,31,26,15,13,1
22282,185,83,102,30,19,21,8,620,307,313,92,91,92,33,1
22283,470,226,244,81,53,59,39,435,233,202,43,42,39,32,1
22284,756,366,390,83,146,47,23,216,102,114,31,29,21,6,1
22285,870,436,434,131,114,72,25,428,214,214,65,67,45,23,1
22286,769,362,407,99,88,66,67,1152,586,566,131,112,117,42,1
22287,2351,1110,1241,337,269,300,87,2813,1331,1482,320,339,261,290,1
22288,524,264,260,75,75,40,21,526,264,262,77,71,61,27,1
22289,127,49,78,27,20,6,5,504,259,245,73,56,45,29,1
22290,208,107,101,42,22,18,10,742,303,439,88,96,86,23,1
22291,4128,2104,2024,581,505,453,205,393,186,207,58,50,36,22,1
22292,446,246,200,46,32,53,25,2639,1436,1203,317,307,242,77,1
22293,331,169,162,40,28,22,14,551,298,253,63,65,45,19,1
22294,853,401,452,121,118,74,38,854,367,487,127,113,59,59,1
22295,1134,574,560,157,164,47,48,782,421,361,101,97,82,20,1
22296,465,245,220,71,45,76,25,2468,1038,1430,333,465,167,62,1
22297,1434,727,707,210,173,161,54,391,223,168,35,26,47,31,1
22298,1943,846,1097,301,257,135,77,671,326,345,111,77,74,11,1
22299,335,185,150,46,34,36,13,234,129,105,31,22,19,18,1
22300,671,326,345,111,77,74,11,1074,539,535,136,87,87,66,1
22301,455,218,237,57,51,42,35,426,234,192,46,41,39,37,1
22302,458,225,233,67,61,43,33,737,320,417,112,94,73,34,1
22303,430,192,238,62,67,27,10,277,124,153,44,40,35,18,1
22304,94,45,49,11,20,10,4,673,328,345,107,112,63,27,1
22305,815,418,397,97,62,70,17,674,248,426,169,95,56,16,1
22306,540,271,269,80,77,51,16,245,137,108,34,30,19,10,1
22307,604,275,329,95,69,52,25,480,252,228,55,37,49,20,1
22308,615,339,276,82,76,63,16,5537,2898,2639,598,623,347,214,1
22309,1235,637,598,191,162,99,36,352,179,173,54,46,35,22,1
22310,670,333,337,95,79,62,21,822,392,430,125,104,79,24,1
22311,335,185,150,46,34,36,13,376,183,193,50,50,43,21,1
22312,1122,546,576,140,158,103,50,573,247,326,98,95,46,22,1
22313,528,283,245,77,72,63,11,391,208,183,65,49,57,17,1
22314,213,127,86,26,20,33,9,976,520,456,120,115,109,53,1
22315,673,317,356,101,85,76,49,363,221,142,36,16,56,25,1
22316,757,373,384,115,93,95,25,350,181,169,44,52,43,13,1
22317,1049,530,519,102,125,89,48,901,423,478,106,117,83,38,1
22318,1132,553,579,172,143,150,57,770,374,396,95,91,79,41,1
22319,347,181,166,27,20,12,12,956,450,506,122,117,82,36,1
22320,459,212,247,63,48,48,28,1158,481,677,169,129,86,40,1
22321,312,143,169,55,61,12,11,503,263,240,72,55,51,34,1
22322,327,177,150,40,40,38,18,466,186,280,71,84,30,11,1
22323,537,276,261,75,68,68,22,442,252,190,35,52,20,4,1
22324,286,111,175,51,47,21,12,372,189,183,60,44,41,18,1
22325,461,231,230,61,67,41,15,467,224,243,70,43,67,23,1
22326,210,121,89,22,23,23,7,168,67,101,37,17,13,13,1
22327,427,186,241,55,52,42,23,333,171,162,41,44,48,23,1
22328,1384,769,615,178,141,219,56,536,278,258,72,63,62,20,1
22329,452,224,228,69,56,50,31,2871,1148,1723,496,469,204,98,1
22330,181,93,88,29,20,26,9,478,220,258,47,69,41,10,1
22331,778,398,380,131,85,69,24,473,212,261,72,64,45,28,1
22332,748,355,393,121,91,95,26,700,392,308,94,75,87,24,1
22333,341,167,174,48,47,31,8,181,96,85,26,23,18,7,1
22334,519,258,261,87,78,59,22,822,417,405,112,97,88,40,1
22335,247,110,137,34,45,23,10,641,318,323,69,61,41,19,1
22336,1270,557,713,130,195,57,30,1290,597,693,182,182,119,63,1
22337,215,115,100,27,28,34,16,1156,538,618,144,139,117,90,1
22338,609,292,317,102,96,64,21,486,276,210,74,34,65,11,1
22339,185,81,104,32,23,19,9,226,115,111,38,16,26,6,1
22340,589,294,295,37,44,27,33,162,93,69,24,19,17,7,1
22341,747,371,376,87,134,54,29,2414,1189,1225,277,178,170,169,1
22342,778,398,380,131,85,69,24,646,304,342,104,93,58,26,1
22343,854,367,487,127,113,59,59,381,191,190,55,61,33,11,1
22344,245,122,123,21,32,18,13,769,329,440,116,66,55,22,1
22345,1748,791,957,281,247,173,25,1834,823,1011,297,282,151,63,1
22346,605,231,374,102,109,27,34,1117,423,694,182,134,88,31,1
22347,672,334,338,110,93,91,41,215,80,135,54,56,21,9,1
22348,298,154,144,44,34,25,11,213,86,127,37,33,5,16,1
22349,163,104,59,15,9,26,11,595,289,306,87,62,84,40,1
22350,724,325,399,98,92,64,24,583,322,261,73,66,45,26,1
22351,756,348,408,101,103,60,40,854,380,474,137,159,81,31,1
22352,2843,1104,1739,429,357,178,95,448,236,212,53,64,56,24,1
22353,297,158,139,47,37,37,9,1505,681,824,201,204,73,32,1
22354,277,124,153,44,40,35,18,443,217,226,65,67,40,11,1
22355,556,269,287,86,66,62,22,261,148,113,31,28,14,10,1
22356,973,522,451,140,134,124,39,261,108,153,35,37,16,6,1
22357,2442,1193,1249,278,183,170,145,425,210,215,56,43,52,25,1
22358,368,158,210,64,61,39,14,673,317,356,101,85,76,49,1
22359,388,199,189,50,51,33,14,342,200,142,39,18,55,20,1
22360,1162,548,614,191,166,142,38,519,219,300,86,72,50,39,1
22361,743,341,402,104,89,68,38,3433,1476,1957,522,578,264,123,1
22362,605,295,310,74,66,70,36,825,363,462,97,105,72,75,1
22363,956,403,553,147,135,99,87,2477,1186,1291,256,271,249,90,1
22364,123,49,74,11,30,12,7,636,336,300,94,65,58,32,1
22365,424,248,176,45,27,46,23,164,87,77,16,18,12,20,1
22366,462,251,211,74,53,41,18,173,88,85,20,21,9,12,1
22367,323,169,154,47,44,39,20,551,237,314,95,79,54,17,1
22368,670,316,354,84,69,47,24,703,354,349,84,81,40,25,1
22369,198,112,86,20,36,16,5,333,192,141,50,48,28,10,1
22370,969,505,464,123,133,92,33,551,298,253,63,65,45,19,1
22371,358,170,188,54,55,20,10,577,241,336,112,109,47,21,1
22372,93,45,48,19,15,14,3,1871,919,952,318,233,164,56,1
22373,538,252,286,77,87,53,30,655,269,386,128,129,49,21,1
22374,615,339,276,82,76,63,16,465,228,237,64,42,63,24,1
22375,1231,603,628,121,162,109,120,1690,1173,517,186,130,110,56,1
22376,2442,1193,1249,278,183,170,145,601,290,311,92,89,55,30,1
22377,450,233,217,68,45,45,17,193,107,86,13,20,13,6,1
22378,3664,1638,2026,598,519,231,63,509,241,268,67,53,56,13,1
22379,379,203,176,55,48,45,16,1621,750,871,276,243,162,51,1
22380,335,175,160,45,42,38,13,920,492,428,100,92,88,49,1
22381,2439,1074,1365,226,131,238,141,84,43,41,5,11,6,11,1
22382,772,364,408,114,106,98,33,183,76,107,34,38,14,8,1
22383,583,322,261,73,66,45,26,825,427,398,79,95,81,48,1
22384,456,228,228,49,70,32,19,691,307,384,93,128,45,19,1
22385,339,177,162,40,36,51,24,110,67,43,9,10,11,8,1
22386,379,203,176,55,48,45,16,508,295,213,42,61,53,17,1
22387,566,300,266,49,88,47,20,462,224,238,77,75,37,13,1
22388,418,204,214,68,66,38,12,467,201,266,71,70,63,27,1
22389,96,50,46,8,15,6,2,344,181,163,45,49,40,24,1
22390,1009,506,503,146,141,97,55,304,159,145,38,40,32,3,1
22391,336,154,182,51,48,39,22,211,114,97,32,24,19,10,1
22392,501,240,261,80,62,49,42,427,204,223,38,57,26,32,1
22393,326,167,159,46,31,38,13,251,92,159,29,94,12,6,1
22394,464,167,297,90,81,33,9,297,158,139,47,37,37,9,1
22395,364,172,192,67,61,40,14,170,35,135,33,25,8,5,1
22396,124,72,52,14,12,13,6,268,143,125,43,29,22,10,1
22397,295,158,137,42,34,38,14,323,181,142,40,37,26,16,1
22398,278,131,147,29,30,33,12,171,88,83,20,21,16,7,1
22399,228,72,156,42,27,8,7,437,230,207,41,55,27,13,1
22400,1157,610,547,182,157,93,46,1894,962,932,232,209,205,90,1
22401,1608,924,684,163,133,89,29,2061,822,1239,312,324,170,85,1
22402,548,292,256,67,65,68,26,499,252,247,75,71,65,25,1
22403,756,366,390,83,146,47,23,180,95,85,22,21,17,8,1
22404,1117,423,694,182,134,88,31,182,84,98,20,52,9,9,1
22405,1412,603,809,184,195,112,45,968,452,516,150,144,79,28,1
22406,129,70,59,29,9,7,2,425,199,226,54,71,56,11,1
22407,910,462,448,143,126,90,25,640,279,361,102,83,69,21,1
22408,473,224,249,82,63,48,24,1979,815,1164,354,379,126,62,1
22409,476,190,286,116,95,33,11,619,290,329,97,79,62,19,1
22410,1129,500,629,171,148,85,30,1074,538,536,154,140,111,51,1
22411,338,192,146,41,29,22,14,466,260,206,62,44,56,19,1
22412,373,194,179,42,54,26,13,330,159,171,48,38,50,19,1
22413,1441,657,784,140,135,81,73,848,394,454,100,90,101,41,1
22414,241,115,126,35,30,17,14,350,200,150,45,47,23,8,1
22415,159,84,75,13,28,10,8,462,251,211,74,53,41,18,1
22416,1544,670,874,236,239,128,49,381,189,192,74,49,44,13,1
22417,619,290,329,97,79,62,19,197,82,115,27,22,29,7,1
22418,180,95,85,30,20,29,10,219,124,95,22,22,23,5,1
22419,292,152,140,46,38,35,12,496,247,249,82,69,47,14,1
22420,309,155,154,41,44,45,16,758,362,396,115,102,35,13,1
22421,111,51,60,20,21,10,11,202,102,100,29,35,6,9,1
22422,350,181,169,44,52,43,13,240,109,131,48,37,24,7,1
22423,1336,828,508,166,121,152,48,906,474,432,90,125,74,24,1
22424,1861,896,965,265,187,156,70,977,406,571,151,128,84,47,1
22425,836,391,445,146,108,60,23,103,56,47,27,7,8,2,1
22426,880,355,525,122,139,75,36,503,263,240,72,55,51,34,1
22427,509,254,255,67,55,52,35,889,450,439,119,104,81,27,1
22428,220,127,93,26,19,27,7,928,442,486,139,118,91,43,1
22429,350,214,136,33,23,49,27,109,57,52,19,7,8,8,1
22430,130,55,75,21,26,10,3,379,203,176,55,48,45,16,1
22431,233,94,139,36,37,15,8,480,234,246,79,77,65,23,1
22432,314,108,206,45,75,34,8,1049,585,464,107,108,120,28,1
22433,292,152,140,46,38,35,12,892,420,472,135,146,98,37,1
22434,98,41,57,19,19,8,2,330,159,171,48,38,50,19,1
22435,211,83,128,28,35,5,11,288,118,170,50,57,18,15,1
22436,211,114,97,32,24,19,10,377,202,175,46,50,41,23,1
22437,609,292,317,102,96,64,21,114,71,43,8,18,7,4,1
22438,920,492,428,100,92,88,49,589,281,308,69,39,63,20,1
22439,443,240,203,66,31,57,27,1353,661,692,192,197,139,63,1
22440,158,85,73,24,18,18,8,335,128,207,59,43,24,23,1
22441,501,285,216,52,55,62,25,770,355,415,103,142,75,42,1
22442,390,191,199,57,49,45,25,301,157,144,31,28,34,9,1
22443,756,457,299,67,74,72,21,710,357,353,99,79,72,39,1
22444,656,358,298,67,47,64,26,725,303,422,79,138,45,33,1
22445,1068,494,574,176,155,81,27,1675,875,800,213,219,196,72,1
22446,468,215,253,65,60,34,13,876,457,419,88,124,67,47,1
22447,340,169,171,40,39,36,22,360,188,172,67,48,52,12,1
22448,922,418,504,120,120,106,31,895,474,421,122,93,69,25,1
22449,263,136,127,29,24,19,31,375,183,192,52,48,39,23,1
22450,421,185,236,73,66,23,13,1756,697,1059,328,345,110,27,1
22451,291,131,160,49,35,32,15,778,367,411,90,85,64,43,1
22452,1106,579,527,121,152,113,45,1328,661,667,210,147,126,55,1
22453,619,332,287,95,77,74,38,1047,562,485,141,127,114,41,1
22454,1013,457,556,124,157,81,26,1192,579,613,120,215,79,24,1
22455,359,171,188,49,74,45,11,526,264,262,77,71,61,27,1
22456,437,228,209,47,61,26,11,305,168,137,48,35,40,9,1
22457,262,78,184,78,28,32,4,282,105,177,77,28,39,6,1
22458,969,505,464,123,133,92,33,521,267,254,53,68,39,15,1
22459,680,312,368,98,56,38,27,482,223,259,74,67,39,12,1
22460,235,129,106,24,19,20,10,140,81,59,16,15,15,12,1
22461,926,474,452,106,103,84,42,693,359,334,75,54,59,20,1
22462,622,309,313,98,70,81,29,2477,1186,1291,256,271,249,90,1
22463,355,197,158,38,43,49,9,609,279,330,103,98,72,42,1
22464,1018,547,471,122,122,120,33,640,339,301,70,64,90,41,1
22465,1257,647,610,156,146,145,35,586,254,332,114,111,55,17,1
22466,159,105,54,22,9,14,25,656,358,298,67,47,64,26,1
22467,240,125,115,34,32,30,8,158,85,73,24,18,18,8,1
22468,122,80,42,11,8,12,5,84,61,23,9,2,13,2,1
22469,839,427,412,91,83,114,37,803,346,457,126,171,74,24,1
22470,545,269,276,80,76,27,32,646,316,330,89,95,48,17,1
22471,323,159,164,49,28,38,22,375,202,173,46,49,41,23,1
22472,906,455,451,116,105,87,46,509,262,247,64,70,64,20,1
22473,526,264,262,77,71,61,27,1047,562,485,141,127,114,41,1
22474,616,304,312,75,71,55,25,339,183,156,43,45,28,17,1
22475,443,198,245,68,72,48,19,393,186,207,58,50,36,22,1
22476,604,255,349,100,72,55,26,1190,638,552,162,95,112,18,1
22477,552,285,267,74,51,69,24,401,213,188,64,48,35,18,1
22478,1117,556,561,188,117,110,48,538,286,252,80,58,48,14,1
22479,589,294,295,37,44,27,33,361,155,206,43,61,29,18,1
22480,360,218,142,39,26,50,18,374,181,193,63,49,46,20,1
22481,559,296,263,77,69,42,13,168,76,92,26,21,19,4,1
22482,1147,471,676,229,164,86,37,354,192,162,46,43,30,20,1
22483,419,197,222,43,33,46,18,781,418,363,92,90,64,41,1
22484,450,215,235,73,72,53,18,1382,689,693,186,176,167,77,1
22485,1669,1162,507,154,128,86,51,122,67,55,19,14,18,4,1
22486,1210,601,609,126,80,120,39,480,252,228,55,37,49,20,1
22487,201,98,103,26,35,16,5,728,343,385,116,82,96,57,1
22488,1893,850,1043,280,340,169,80,529,264,265,59,68,41,17,1
22489,2045,985,1060,359,339,199,74,636,320,316,79,61,67,31,1
22490,1738,821,917,242,196,181,58,304,159,145,38,40,32,3,1
22491,125,63,62,20,16,15,7,448,236,212,53,64,56,24,1
22492,875,376,499,155,125,53,39,904,436,468,138,146,82,39,1
22493,257,157,100,30,12,40,16,662,380,282,64,76,55,20,1
22494,723,380,343,80,84,47,18,156,64,92,39,19,15,8,1
22495,522,265,257,35,39,38,8,3224,1440,1784,455,440,333,126,1
22496,388,214,174,46,38,47,23,784,391,393,105,113,86,21,1
22497,283,132,151,57,33,12,7,1024,486,538,186,113,94,51,1
22498,394,220,174,50,28,53,21,97,50,47,17,14,14,10,1
22499,677,310,367,103,93,70,26,2115,838,1277,346,354,90,48,1
22500,262,123,139,44,32,25,18,476,251,225,57,67,57,18,1
22501,1435,679,756,177,150,118,29,1129,589,540,134,122,108,46,1
22502,276,154,122,36,19,27,17,769,329,440,116,66,55,22,1
22503,1061,586,475,141,127,120,38,1270,557,713,130,195,57,30,1
22504,1004,498,506,94,59,46,33,660,326,334,106,61,71,32,1
22505,120,66,54,20,8,11,2,285,173,112,32,15,38,15,1
22506,1230,623,607,154,156,94,61,753,361,392,99,94,66,16,1
22507,220,113,107,37,24,16,7,414,194,220,76,66,49,16,1
22508,602,310,292,87,66,70,36,1198,571,627,177,168,97,54,1
22509,870,436,434,131,114,72,25,1270,557,713,130,195,57,30,1
22510,726,312,414,121,73,82,23,882,432,450,115,111,68,44,1
22511,298,154,144,44,34,25,11,751,285,466,185,70,117,46,1
22512,1100,581,519,144,149,78,42,140,76,64,17,13,13,8,1
22513,431,186,245,79,83,37,18,144,63,81,28,32,11,5,1
22514,839,408,431,138,122,105,46,556,300,256,58,73,55,22,1
22515,493,284,209,76,29,48,30,1447,751,696,161,143,131,46,1
22516,820,431,389,109,98,84,30,207,99,108,34,27,22,9,1
22517,894,492,402,95,103,88,42,583,322,261,73,66,45,26,1
22518,590,279,311,103,83,69,30,466,247,219,51,32,49,26,1
22519,279,106,173,48,35,41,39,1425,670,755,153,189,122,85,1
22520,776,346,430,103,102,61,40,425,210,215,56,43,52,25,1
22521,1432,652,780,217,205,131,81,4128,2104,2024,581,505,453,205,1
22522,1090,533,557,137,125,75,28,636,320,316,79,61,67,31,1
22523,742,303,439,88,96,86,23,406,215,191,34,46,21,9,1
22524,272,173,99,32,32,11,8,227,124,103,37,23,26,10,1
22525,381,191,190,55,61,33,11,195,109,86,25,24,17,6,1
22526,748,355,393,121,91,95,26,437,167,270,126,95,34,10,1
22527,1336,633,703,182,197,110,52,824,403,421,80,150,65,35,1
22528,957,473,484,141,131,112,42,1037,575,462,122,150,82,32,1
22529,540,265,275,87,59,74,25,947,482,465,143,107,89,37,1
22530,298,160,138,37,30,22,12,215,105,110,26,22,19,9,1
22531,493,222,271,44,53,45,51,606,307,299,92,56,68,30,1
22532,377,201,176,46,50,41,23,2414,1189,1225,277,178,170,169,1
22533,672,334,338,110,93,91,41,702,298,404,134,111,48,18,1
22534,2376,1263,1113,304,241,264,115,639,298,341,77,61,70,20,1
22535,202,105,97,28,27,14,6,393,186,207,58,50,36,22,1
22536,1270,682,588,165,147,136,54,1058,558,500,132,127,121,53,1
22537,1390,695,695,180,137,170,71,136,72,64,22,16,7,3,1
22538,211,112,99,30,15,34,18,477,256,221,69,66,70,12,1
22539,229,105,124,36,33,12,4,700,305,395,111,99,54,18,1
22540,452,224,228,69,56,50,31,189,101,88,23,24,16,11,1
22541,357,169,188,61,53,32,15,185,107,78,20,29,10,4,1
22542,362,181,181,67,46,43,8,127,57,70,18,33,8,7,1
22543,415,209,206,60,67,39,18,370,237,133,43,19,48,14,1
22544,556,199,357,125,112,22,13,126,57,69,31,10,10,3,1
22545,160,86,74,21,11,16,16,1455,760,695,205,191,124,40,1
22546,593,321,272,64,84,33,20,207,89,118,28,26,16,6,1
22547,624,204,420,166,101,32,13,235,135,100,30,13,25,11,1
22548,1356,672,684,171,172,134,59,320,159,161,44,54,29,9,1
22549,341,190,151,50,41,23,15,531,286,245,61,45,46,16,1
22550,503,259,244,73,53,52,28,503,263,240,72,55,51,34,1
22551,285,143,142,45,32,21,17,392,156,236,40,91,28,16,1
22552,862,335,527,136,169,47,28,785,419,366,105,90,64,31,1
22553,192,106,86,27,21,20,10,920,492,428,100,92,88,49,1
22554,815,418,397,97,62,70,17,621,320,301,51,62,33,27,1
22555,499,290,209,59,50,50,19,297,158,139,47,37,37,9,1
22556,210,102,108,33,33,20,9,58,23,35,14,8,5,7,1
22557,1972,846,1126,222,330,114,68,551,298,253,63,65,45,19,1
22558,1342,673,669,178,154,137,94,715,359,356,125,96,59,36,1
22559,1035,559,476,128,122,122,50,605,295,310,74,66,70,36,1
22560,677,245,432,129,155,72,11,953,377,576,203,197,65,29,1
22561,624,204,420,166,101,32,13,294,122,172,46,65,18,11,1
22562,229,105,124,36,33,12,4,777,387,390,90,87,65,37,1
22563,152,79,73,18,13,11,6,189,90,99,26,29,17,11,1
22564,461,287,174,56,27,82,25,359,169,190,55,37,37,33,1
22565,450,241,209,67,58,54,23,418,204,214,68,66,38,12,1
22566,595,316,279,86,60,65,40,190,74,116,34,29,11,11,1
22567,712,331,381,111,86,86,34,861,393,468,150,101,69,35,1
22568,441,218,223,69,55,50,27,729,391,338,80,64,71,34,1
22569,595,316,279,86,60,65,40,149,68,81,15,38,11,10,1
22570,724,325,399,98,92,64,24,1333,646,687,209,179,148,45,1
22571,295,139,156,48,31,30,17,227,141,86,16,22,29,13,1
22572,918,357,561,191,150,42,24,309,163,146,56,38,36,11,1
22573,226,129,97,20,25,26,11,684,333,351,89,76,77,30,1
22574,227,130,97,32,25,22,12,2442,1193,1249,278,183,170,145,1
22575,870,415,455,112,103,93,51,789,362,427,90,82,70,35,1
22576,111,29,82,10,54,0,1,433,237,196,60,52,33,27,1
22577,625,298,327,90,78,57,33,295,146,149,50,42,24,10,1
22578,233,94,139,36,37,15,8,312,172,140,41,40,21,8,1
22579,126,66,60,24,10,7,9,240,167,73,32,12,8,21,1
22580,217,105,112,34,32,25,13,1914,768,1146,327,268,227,120,1
22581,449,232,217,53,64,57,22,313,157,156,39,26,34,29,1
22582,191,99,92,25,24,18,8,617,255,362,105,108,61,23,1
22583,317,167,150,45,21,30,26,461,257,204,63,49,50,29,1
22584,947,482,465,143,107,89,37,756,348,408,101,103,60,40,1
22585,926,437,489,135,107,113,42,1464,715,749,200,167,181,70,1
22586,796,445,351,96,80,90,38,1149,568,581,177,133,101,30,1
22587,262,123,139,44,32,25,18,1263,616,647,185,180,140,56,1
22588,125,46,79,24,16,12,2,98,32,66,15,25,5,4,1
22589,787,351,436,135,98,82,23,211,83,128,28,35,5,11,1
22590,475,238,237,73,53,63,17,1117,423,694,182,134,88,31,1
22591,620,305,315,97,80,87,28,537,276,261,75,68,68,22,1
22592,722,404,318,93,78,84,37,338,168,170,60,38,48,17,1
22593,120,67,53,13,15,9,6,266,152,114,31,13,37,11,1
22594,815,418,397,97,62,70,17,424,234,190,60,42,46,12,1
22595,248,119,129,33,48,20,10,411,213,198,63,43,47,16,1
22596,1271,599,672,194,175,118,47,217,109,108,34,32,35,7,1
22597,483,215,268,66,70,30,16,1210,592,618,157,138,116,85,1
22598,219,104,115,25,31,25,11,149,68,81,15,38,11,10,1
22599,313,149,164,48,31,30,13,1922,923,999,267,275,215,90,1
22600,462,251,211,74,53,41,18,1744,920,824,225,190,178,57,1
22601,113,47,66,14,15,11,17,776,356,420,122,103,85,30,1
22602,351,184,167,59,45,54,9,179,76,103,36,32,9,9,1
22603,789,362,427,90,82,70,35,337,171,166,46,27,33,16,1
22604,291,133,158,46,51,21,15,425,199,226,54,71,56,11,1
22605,817,425,392,120,102,83,26,1770,824,946,245,258,179,60,1
22606,700,357,343,99,84,88,34,543,287,256,71,66,64,23,1
22607,502,236,266,66,66,58,17,576,250,326,93,71,34,15,1
22608,556,269,287,86,66,62,22,1914,892,1022,272,267,143,79,1
22609,680,308,372,81,72,70,40,332,175,157,46,43,41,9,1
22610,624,275,349,93,99,74,22,1192,579,613,120,215,79,24,1
22611,858,417,441,124,101,85,41,206,85,121,31,42,6,17,1
22612,3056,1457,1599,438,389,329,168,437,228,209,47,61,26,11,1
22613,627,314,313,61,59,71,22,348,184,164,48,38,47,14,1
22614,1101,626,475,145,122,120,50,351,184,167,59,45,54,9,1
22615,246,128,118,39,34,22,7,375,202,173,46,49,41,23,1
22616,215,115,100,27,28,34,16,962,430,532,109,142,61,34,1
22617,1006,478,528,153,127,80,61,770,385,385,78,83,60,16,1
22618,246,115,131,15,29,10,32,910,524,386,106,97,73,26,1
22619,414,194,220,76,66,49,16,224,101,123,45,32,21,3,1
22620,245,112,133,32,45,20,10,672,334,338,110,93,91,41,1
22621,536,278,258,72,63,62,20,616,296,320,69,76,49,48,1
22622,710,357,353,99,79,72,39,4544,2024,2520,579,628,480,403,1
22623,246,108,138,32,44,21,10,648,307,341,101,58,76,34,1
22624,297,145,152,49,30,23,21,1464,987,477,137,141,55,31,1
22625,2414,1189,1225,277,178,170,169,882,432,450,115,111,68,44,1
22626,433,237,196,60,52,33,27,322,160,162,44,52,33,16,1
22627,143,79,64,16,25,7,5,105,53,52,23,11,12,6,1
22628,467,269,198,46,51,60,18,745,391,354,85,81,52,39,1
22629,725,339,386,112,122,93,32,482,262,220,72,60,52,15,1
22630,1149,568,581,177,133,101,30,1137,531,606,185,135,94,43,1
22631,546,267,279,90,69,56,19,103,56,47,27,7,8,2,1
22632,252,133,119,35,40,29,9,657,293,364,109,75,66,28,1
22633,272,173,99,32,32,11,8,96,50,46,8,15,6,2,1
22634,826,362,464,107,118,71,43,2442,1193,1249,278,183,170,145,1
22635,2468,1038,1430,333,465,167,62,146,74,72,26,25,23,4,1
22636,646,316,330,89,95,48,17,641,324,317,88,92,49,14,1
22637,303,159,144,40,35,35,8,557,268,289,66,67,70,17,1
22638,714,364,350,98,102,91,27,242,112,130,39,41,21,13,1
22639,324,219,105,25,24,27,14,509,243,266,80,57,45,19,1
22640,247,110,137,34,45,23,10,2610,1215,1395,338,372,220,107,1
22641,172,98,74,20,21,22,8,656,358,298,67,47,64,26,1
22642,416,201,215,54,52,39,25,595,284,311,69,71,35,49,1
22643,4128,2104,2024,581,505,453,205,273,126,147,54,49,25,18,1
22644,651,331,320,93,93,51,28,44,13,31,9,11,1,2,1
22645,366,211,155,35,42,24,12,524,264,260,75,75,40,21,1
22646,933,536,397,96,90,71,41,536,278,258,72,63,62,20,1
22647,863,418,445,127,114,70,31,465,257,208,51,61,54,23,1
22648,537,276,261,75,68,68,22,897,487,410,92,97,83,31,1
22649,168,120,48,7,5,20,7,197,92,105,38,16,26,15,1
22650,641,351,290,109,83,96,18,467,224,243,70,43,67,23,1
22651,4128,2104,2024,581,505,453,205,508,267,241,43,35,25,17,1
22652,404,190,214,50,54,35,13,526,254,272,44,43,49,13,1
22653,1159,641,518,148,115,114,48,531,260,271,97,68,47,11,1
22654,941,459,482,167,140,82,38,778,367,411,90,85,64,43,1
22655,466,186,280,71,84,30,11,769,329,440,116,66,55,22,1
22656,1419,759,660,198,135,147,51,788,360,428,93,106,67,72,1
22657,635,333,302,99,75,83,28,509,262,247,64,70,64,20,1
22658,558,306,252,75,55,74,23,554,249,305,100,87,44,13,1
22659,185,107,78,20,29,10,4,876,457,419,88,124,67,47,1
22660,708,303,405,115,115,70,23,919,444,475,141,148,62,20,1
22661,510,264,246,67,66,38,29,467,226,241,55,48,54,23,1
22662,2414,1189,1225,277,178,170,169,737,320,417,112,94,73,34,1
22663,245,111,134,31,44,20,11,1400,800,600,158,134,150,65,1
22664,528,268,260,81,77,36,22,214,119,95,25,27,18,7,1
22665,710,361,349,81,98,63,26,651,331,320,93,93,51,28,1
22666,263,159,104,30,27,31,11,269,134,135,42,35,27,13,1
22667,330,198,132,40,21,45,13,1141,583,558,141,98,91,45,1
22668,813,440,373,117,93,34,19,416,201,215,54,52,39,25,1
22669,1009,506,503,146,141,97,55,1255,666,589,145,142,120,82,1
22670,211,114,97,32,24,19,10,3097,1431,1666,473,433,300,121,1
22671,1152,459,693,138,343,75,33,833,408,425,118,115,82,33,1
22672,404,231,173,44,43,24,10,215,80,135,54,56,21,9,1
22673,1471,709,762,198,184,154,62,754,318,436,114,106,58,28,1
22674,89,42,47,16,12,15,6,76,31,45,8,14,3,1,1
22675,744,569,175,71,37,51,25,443,208,235,43,55,51,50,1
22676,545,230,315,91,101,50,16,536,278,258,72,63,62,20,1
22677,247,110,137,34,45,23,10,2817,1216,1601,379,436,183,115,1
22678,262,144,118,19,39,22,8,845,402,443,137,126,105,47,1
22679,254,139,115,29,35,27,11,698,365,333,108,83,65,21,1
22680,192,101,91,25,22,18,9,526,266,260,76,75,53,22,1
22681,674,268,406,118,96,70,21,96,50,46,8,15,6,2,1
22682,432,219,213,58,51,39,20,225,102,123,32,32,31,15,1
22683,131,56,75,20,24,9,4,1052,492,560,184,163,103,44,1
22684,596,288,308,77,51,58,30,697,373,324,105,83,95,38,1
22685,192,101,91,25,22,18,9,375,202,173,46,49,41,23,1
22686,122,52,70,24,22,7,6,250,114,136,45,42,18,8,1
22687,219,104,115,25,31,25,11,503,263,240,72,55,51,34,1
22688,626,333,293,64,55,61,15,560,334,226,69,37,52,18,1
22689,505,272,233,76,66,57,23,1271,599,672,194,175,118,47,1
22690,336,134,202,51,64,27,12,5890,3314,2576,970,956,293,265,1
22691,933,493,440,140,108,124,32,892,420,472,135,146,98,37,1
22692,951,506,445,107,118,79,40,1085,529,556,149,133,126,54,1
22693,415,189,226,69,54,50,21,1382,689,693,186,176,167,77,1
22694,1102,511,591,171,179,148,52,458,269,189,56,40,29,7,1
22695,299,128,171,57,40,13,25,256,134,122,29,42,14,7,1
22696,422,211,211,73,61,43,17,437,212,225,66,44,44,11,1
22697,1249,543,706,187,164,125,52,1863,721,1142,262,283,139,74,1
22698,1049,585,464,107,108,120,28,1464,987,477,137,141,55,31,1
22699,178,100,78,23,22,30,6,659,325,334,102,85,87,32,1
22700,505,254,251,80,77,60,15,128,73,55,11,15,13,8,1
22701,644,343,301,96,69,59,28,454,224,230,71,39,62,22,1
22702,854,380,474,137,159,81,31,244,136,108,21,25,25,13,1
22703,203,120,83,27,17,24,12,201,108,93,36,21,17,4,1
22704,847,452,395,100,94,81,36,345,203,142,47,35,31,11,1
22705,430,192,238,62,67,27,10,146,75,71,13,32,15,11,1
22706,3336,1358,1978,571,599,203,101,3911,1465,2446,610,767,240,133,1
22707,526,254,272,44,43,49,13,2639,1436,1203,317,307,242,77,1
22708,538,252,286,77,87,53,30,901,458,443,91,129,86,21,1
22709,1770,824,946,245,258,179,60,1801,889,912,206,263,126,42,1
22710,775,407,368,122,100,97,32,330,151,179,68,36,56,9,1
22711,857,387,470,119,94,71,30,619,305,314,85,93,71,29,1
22712,1691,1217,474,130,115,73,46,652,329,323,65,70,51,50,1
22713,430,192,238,62,67,27,10,641,324,317,88,92,49,14,1
22714,325,181,144,46,31,48,9,314,108,206,45,75,34,8,1
22715,205,106,99,28,26,23,3,1599,806,793,213,237,100,45,1
22716,859,398,461,96,109,89,57,1425,670,755,153,189,122,85,1
22717,411,207,204,60,57,35,21,245,111,134,31,44,20,11,1
22718,676,295,381,94,71,65,24,330,157,173,56,42,51,8,1
22719,700,335,365,83,84,95,33,746,361,385,91,92,101,32,1
22720,450,129,321,128,70,43,15,221,75,146,68,21,16,5,1
22721,509,241,268,67,53,56,13,2177,1034,1143,274,228,201,95,1
22722,154,75,79,17,24,16,13,550,319,231,49,65,35,16,1
22723,446,246,200,46,32,53,25,326,217,109,32,20,43,18,1
22724,659,325,334,102,85,87,32,794,390,404,103,95,86,23,1
22725,175,90,85,28,21,19,7,586,254,332,114,111,55,17,1
22726,606,279,327,81,70,49,34,657,293,364,109,75,66,28,1
22727,500,242,258,53,48,44,18,810,367,443,115,92,94,59,1
22728,161,74,87,17,46,12,13,295,95,200,70,89,17,6,1
22729,1591,704,887,253,227,156,50,976,520,456,120,115,109,53,1
22730,647,376,271,73,64,41,23,436,235,201,62,45,56,17,1
22731,465,228,237,64,42,63,24,412,193,219,70,56,51,26,1
22732,848,461,387,111,102,108,42,1234,590,644,180,182,95,40,1
22733,442,254,188,46,22,40,19,208,104,104,39,20,26,15,1
22734,295,140,155,44,37,26,27,431,233,198,54,40,42,12,1
22735,705,396,309,87,48,53,17,390,191,199,66,49,43,12,1
22736,461,233,228,75,64,36,18,149,68,81,15,38,11,10,1
22737,245,112,133,32,45,20,10,409,199,210,62,54,50,25,1
22738,671,318,353,83,124,46,34,3144,1617,1527,367,342,278,136,1
22739,1149,568,581,177,133,101,30,245,112,133,32,45,20,10,1
22740,388,199,189,50,51,33,14,587,259,328,92,94,56,23,1
22741,188,91,97,24,22,21,12,557,268,289,66,67,70,17,1
22742,1400,800,600,158,134,150,65,248,119,129,33,48,20,10,1
22743,372,193,179,60,43,29,2,207,93,114,20,33,19,10,1
22744,627,289,338,101,73,62,43,202,102,100,29,35,6,9,1
22745,556,279,277,83,69,71,19,479,228,251,79,78,64,24,1
22746,261,137,124,33,25,49,9,707,386,321,85,83,99,28,1
22747,1202,506,696,209,198,74,44,1194,543,651,190,197,65,43,1
22748,1440,759,681,173,170,178,71,781,418,363,92,90,64,41,1
22749,593,266,327,102,84,69,24,315,129,186,51,29,24,29,1
22750,1290,597,693,182,182,119,63,136,66,70,33,11,9,5,1
22751,193,99,94,31,31,16,12,641,324,317,88,92,49,14,1
22752,815,418,397,97,62,70,17,776,381,395,72,71,65,22,1
22753,750,347,403,105,103,83,29,1863,721,1142,262,283,139,74,1
22754,297,148,149,64,35,37,15,154,78,76,22,25,12,10,1
22755,76,30,46,7,15,1,5,194,91,103,17,32,9,6,1
22756,281,154,127,45,31,24,9,928,442,486,139,118,91,43,1
22757,204,99,105,32,32,22,10,425,210,215,56,43,52,25,1
22758,639,368,271,72,51,38,38,318,176,142,25,32,35,25,1
22759,298,154,144,44,34,25,11,83,33,50,14,11,7,9,1
22760,1342,673,669,178,154,137,94,1333,646,687,209,179,148,45,1
22761,391,208,183,65,49,57,17,464,237,227,64,66,33,12,1
22762,499,253,246,74,39,64,23,4544,2024,2520,579,628,480,403,1
22763,620,335,285,70,41,62,33,224,123,101,23,24,33,6,1
22764,551,237,314,95,79,54,17,1106,579,527,121,152,113,45,1
22765,461,238,223,67,61,41,23,1170,510,660,142,182,115,84,1
22766,414,211,203,45,44,41,24,1290,597,693,182,182,119,63,1
22767,318,176,142,25,32,35,25,186,95,91,19,15,14,14,1
22768,1820,673,1147,312,325,115,50,163,70,93,28,21,17,6,1
22769,480,234,246,79,77,65,23,425,210,215,56,43,52,25,1
22770,589,256,333,112,67,63,28,862,409,453,149,125,86,29,1
22771,313,166,147,47,44,41,10,2115,838,1277,346,354,90,48,1
22772,254,139,115,29,35,27,11,1017,498,519,136,107,82,52,1
22773,346,180,166,55,49,38,6,496,209,287,113,55,72,14,1
22774,296,154,142,38,38,24,16,514,283,231,60,60,52,19,1
22775,467,231,236,71,65,58,18,467,224,243,70,43,67,23,1
22776,197,99,98,35,27,14,6,458,265,193,55,35,49,27,1
22777,710,361,349,81,98,63,26,763,361,402,103,144,78,45,1
22778,593,266,327,102,84,69,24,489,235,254,53,69,49,20,1
22779,619,343,276,88,65,84,25,273,148,125,38,31,16,19,1
22780,1432,652,780,217,205,131,81,143,81,62,28,9,8,1,1
22781,740,313,427,101,135,40,22,2492,894,1598,466,444,164,102,1
22782,101,45,56,17,17,12,9,1976,810,1166,364,387,134,59,1
22783,374,191,183,40,52,40,16,273,126,147,54,49,25,18,1
22784,510,264,246,67,66,38,29,514,278,236,70,62,46,22,1
22785,129,66,63,23,17,18,4,465,279,186,48,24,70,25,1
22786,802,388,414,131,105,96,29,126,56,70,31,10,10,3,1
22787,984,461,523,109,89,91,52,628,341,287,77,59,55,31,1
22788,387,198,189,48,48,47,23,912,460,452,139,132,89,53,1
22789,1424,650,774,152,124,95,87,454,230,224,63,56,38,33,1
22790,536,278,258,72,63,62,20,737,363,374,119,101,85,41,1
22791,325,196,129,35,17,48,33,132,57,75,25,9,6,13,1
22792,102,51,51,12,15,12,3,368,141,227,64,61,24,13,1
22793,366,190,176,39,62,55,14,218,133,85,20,19,13,6,1
22794,450,129,321,128,70,43,15,536,237,299,116,87,42,17,1
22795,127,49,78,27,20,6,5,577,342,235,63,57,23,37,1
22796,1014,490,524,177,137,94,38,599,292,307,74,126,45,14,1
22797,298,154,144,44,34,25,11,354,188,166,44,31,48,11,1
22798,984,461,523,109,89,91,52,737,320,417,112,94,73,34,1
22799,673,317,356,101,85,76,49,403,220,183,50,40,39,27,1
22800,676,333,343,111,89,94,39,457,228,229,64,36,52,21,1
22801,1251,671,580,162,132,148,51,309,154,155,42,44,45,16,1
22802,1865,943,922,270,209,228,91,2022,976,1046,305,232,254,95,1
22803,1241,670,571,135,139,110,32,921,455,466,144,127,108,39,1
22804,1066,587,479,127,108,118,48,279,106,173,48,35,41,39,1
22805,673,329,344,111,95,92,41,413,194,219,77,72,28,11,1
22806,248,118,130,54,31,26,5,632,326,306,92,71,56,19,1
22807,815,418,397,97,62,70,17,796,398,398,107,87,56,36,1
22808,444,189,255,72,82,45,17,864,429,435,129,118,68,35,1
22809,1102,511,591,171,179,148,52,498,231,267,72,61,54,29,1
22810,351,166,185,48,61,24,15,327,160,167,56,31,36,15,1
22811,109,57,52,19,7,8,8,98,53,45,14,6,7,6,1
22812,747,469,278,60,41,53,23,246,123,123,40,31,27,7,1
22813,378,154,224,74,84,35,22,854,380,474,137,159,81,31,1
22814,246,115,131,15,29,10,32,229,134,95,25,13,28,10,1
22815,284,111,173,47,34,47,43,465,225,240,65,44,65,25,1
22816,1344,728,616,152,150,96,35,191,99,92,25,24,18,8,1
22817,247,110,137,34,45,23,10,615,356,259,90,56,97,19,1
22818,267,161,106,22,25,35,20,741,374,367,103,105,75,32,1
22819,396,223,173,57,37,44,19,641,341,300,101,91,29,22,1
22820,377,184,193,50,43,33,17,395,222,173,48,42,21,8,1
22821,834,465,369,82,84,81,21,267,147,120,40,24,25,8,1
22822,246,108,138,32,44,21,10,255,122,133,35,51,22,13,1
22823,280,142,138,35,37,22,13,118,51,67,25,13,6,7,1
22824,422,228,194,26,20,48,37,1590,726,864,270,237,126,59,1
22825,454,191,263,61,66,38,15,297,158,139,47,37,37,9,1
22826,489,253,236,73,36,62,17,280,156,124,36,19,20,13,1
22827,911,493,418,89,140,83,34,1231,603,628,121,162,109,120,1
22828,365,222,143,44,24,35,11,425,210,215,56,43,52,25,1
22829,1338,506,832,241,229,101,40,864,362,502,142,150,70,19,1
22830,340,215,125,44,30,33,13,998,532,466,113,109,97,53,1
22831,277,124,153,44,40,35,18,448,275,173,32,53,55,27,1
22832,461,207,254,82,66,55,33,404,239,165,48,38,38,19,1
22833,329,155,174,46,38,29,14,911,423,488,140,150,102,32,1
22834,653,309,344,107,75,49,14,637,267,370,94,126,43,27,1
22835,766,386,380,101,81,78,31,393,210,183,55,50,34,19,1
22836,173,110,63,35,6,9,8,454,191,263,61,66,38,15,1
22837,461,217,244,44,41,27,36,1471,709,762,198,184,154,62,1
22838,955,314,641,241,135,97,11,247,110,137,34,45,23,10,1
22839,280,118,162,35,32,41,37,359,167,192,49,37,27,19,1
22840,335,148,187,52,26,51,12,165,76,89,26,24,18,15,1
22841,920,492,428,100,92,88,49,595,316,279,86,60,65,40,1
22842,211,88,123,38,28,26,10,1382,599,783,208,252,90,39,1
22843,672,334,338,110,93,91,41,283,159,124,41,21,39,17,1
22844,477,256,221,69,66,70,12,109,50,59,20,7,10,9,1
22845,330,143,187,63,29,52,20,405,189,216,53,60,39,14,1
22846,896,407,489,97,152,70,22,777,387,390,90,87,65,37,1
22847,840,468,372,96,85,121,29,396,174,222,62,68,28,6,1
22848,2442,1193,1249,278,183,170,145,401,226,175,53,18,38,20,1
22849,432,181,251,48,75,27,17,450,241,209,67,58,54,23,1
22850,369,166,203,59,55,41,14,377,201,176,46,50,41,23,1
22851,210,106,104,34,28,31,13,297,141,156,49,46,36,15,1
22852,154,78,76,23,21,13,5,625,313,312,103,90,74,29,1
22853,277,124,153,44,40,35,18,350,200,150,45,47,23,8,1
22854,194,97,97,25,20,26,14,225,99,126,25,24,20,10,1
22855,464,167,297,90,81,33,9,3336,1358,1978,571,599,203,101,1
22856,372,196,176,51,36,51,8,306,167,139,42,51,23,8,1
22857,267,159,108,31,13,22,15,739,359,380,83,95,53,38,1
22858,561,279,282,85,81,88,24,376,199,177,54,49,48,22,1
22859,755,390,365,103,84,85,34,757,373,384,115,93,95,25,1
22860,423,212,211,51,44,48,28,334,172,162,43,39,41,17,1
22861,650,304,346,80,106,62,28,208,96,112,31,32,13,9,1
22862,1005,540,465,133,101,106,55,537,276,261,75,68,68,22,1
22863,351,184,167,59,45,54,9,204,80,124,29,51,10,5,1
22864,482,231,251,76,81,64,26,111,29,82,10,54,0,1,1
22865,537,276,261,75,68,68,22,178,100,78,23,22,30,6,1
22866,211,113,98,38,17,25,8,377,184,193,56,53,44,14,1
22867,595,316,279,86,60,65,40,445,225,220,47,62,53,26,1
22868,418,226,192,57,57,53,17,191,99,92,25,24,18,8,1
22869,367,195,172,57,54,43,16,455,191,264,68,86,21,19,1
22870,963,455,508,126,110,68,29,968,498,470,129,133,115,37,1
22871,366,191,175,37,33,19,19,2639,1436,1203,317,307,242,77,1
22872,512,261,251,79,73,60,21,297,158,139,47,37,37,9,1
22873,235,166,69,18,13,43,10,418,213,205,54,56,49,13,1
22874,603,348,255,82,70,87,16,4544,2024,2520,579,628,480,403,1
22875,430,198,232,57,46,37,19,436,205,231,39,51,26,20,1
22876,642,326,316,86,83,63,26,355,169,186,49,37,26,11,1
22877,3418,1378,2040,515,464,318,121,339,183,156,43,45,28,17,1
22878,240,125,115,34,32,30,8,150,81,69,24,23,16,4,1
22879,81,41,40,15,13,3,2,223,113,110,31,33,22,12,1
22880,911,493,418,89,140,83,34,477,256,221,69,66,70,12,1
22881,732,355,377,108,109,79,27,1014,490,524,177,137,94,38,1
22882,297,158,139,47,37,37,9,430,192,238,62,67,27,10,1
22883,297,160,137,27,33,26,19,509,262,247,64,70,64,20,1
22884,1222,652,570,151,135,145,36,241,115,126,44,21,29,10,1
22885,636,320,316,79,61,67,31,593,295,298,70,85,48,13,1
22886,33423,16370,17053,4965,4756,2786,883,892,420,472,135,146,98,37,1
22887,707,386,321,85,83,99,28,1690,1173,517,186,130,110,56,1
22888,401,167,234,56,71,16,10,826,423,403,129,93,82,42,1
22889,665,341,324,92,88,59,27,1432,652,780,217,205,131,81,1
22890,537,315,222,55,46,69,39,767,392,375,113,112,83,13,1
22891,406,238,168,71,35,42,16,724,320,404,120,147,67,25,1
22892,755,347,408,101,90,53,29,3144,1617,1527,367,342,278,136,1
22893,593,266,327,102,84,69,24,825,427,398,79,95,81,48,1
22894,1006,569,437,133,96,76,36,862,427,435,139,98,100,59,1
22895,351,184,167,59,45,54,9,496,247,249,82,69,47,14,1
22896,602,299,303,98,81,72,21,217,115,102,40,24,26,6,1
22897,637,267,370,94,126,43,27,216,102,114,31,29,21,6,1
22898,468,233,235,65,61,49,34,854,380,474,137,159,81,31,1
22899,106,54,52,12,9,7,6,435,208,227,68,64,53,23,1
22900,450,229,221,49,63,54,27,979,538,441,128,106,158,30,1
22901,454,230,224,63,56,38,33,425,210,215,56,43,52,25,1
22902,1222,649,573,136,140,132,36,563,313,250,73,61,65,20,1
22903,312,180,132,36,22,32,21,245,111,134,31,44,20,11,1
22904,735,352,383,98,77,98,37,723,371,352,86,69,80,27,1
22905,1342,675,667,162,154,123,39,441,189,252,73,50,47,23,1
22906,462,251,211,74,53,41,18,568,193,375,112,83,50,15,1
22907,845,412,433,146,103,112,18,215,105,110,26,22,19,9,1
22908,635,333,302,99,75,83,28,508,295,213,42,61,53,17,1
22909,925,444,481,131,141,106,36,1156,578,578,130,155,118,39,1
22910,139,78,61,17,14,17,5,826,362,464,107,118,71,43,1
22911,426,213,213,60,56,46,24,522,235,287,78,67,60,50,1
22912,701,368,333,90,81,39,27,536,278,258,72,63,62,20,1
22913,509,243,266,80,57,45,19,1154,540,614,195,160,138,66,1
22914,557,240,317,97,74,68,37,435,233,202,43,42,39,32,1
22915,443,248,195,67,54,40,15,377,184,193,56,53,44,14,1
22916,283,112,171,48,39,34,15,252,128,124,46,31,18,8,1
22917,673,317,356,101,85,76,49,405,218,187,49,45,45,22,1
22918,229,120,109,31,30,22,9,1341,481,860,275,264,57,21,1
22919,469,247,222,70,58,82,13,297,145,152,49,30,23,21,1
22920,114,71,43,8,18,7,4,172,83,89,26,25,18,7,1
22921,459,221,238,52,56,51,19,794,390,404,103,95,86,23,1
22922,1149,568,581,177,133,101,30,427,215,212,69,35,51,21,1
22923,460,274,186,50,34,69,27,111,29,82,10,54,0,1,1
22924,625,316,309,77,79,54,34,757,373,384,115,93,95,25,1
22925,4861,2440,2421,597,576,422,237,262,151,111,30,17,32,25,1
22926,419,212,207,61,44,35,21,499,272,227,49,66,66,21,1
22927,185,115,70,19,17,26,6,189,90,99,26,29,17,11,1
22928,619,293,326,98,78,65,22,984,459,525,150,145,89,37,1
22929,268,124,144,36,34,12,4,646,304,342,104,93,58,26,1
22930,557,269,288,83,56,56,22,217,109,108,34,32,35,7,1
22931,170,81,89,25,24,15,4,601,313,288,42,48,25,36,1
22932,1228,545,683,164,133,105,50,2224,1037,1187,288,276,273,74,1
22933,552,285,267,74,51,69,24,920,492,428,100,92,88,49,1
22934,95,44,51,14,13,7,4,778,367,411,90,85,64,43,1
22935,756,444,312,95,64,60,17,892,420,472,135,146,98,37,1
22936,240,141,99,31,20,28,7,283,141,142,32,26,23,26,1
22937,445,209,236,63,50,42,28,729,391,338,80,64,71,34,1
22938,154,75,79,17,24,16,13,156,64,92,39,19,15,8,1
22939,95,44,51,14,13,7,4,417,182,235,57,109,50,8,1
22940,442,254,188,46,22,40,19,518,251,267,74,49,71,27,1
22941,615,339,276,82,76,63,16,1471,709,762,198,184,154,62,1
22942,3224,1440,1784,455,440,333,126,497,185,312,63,92,38,28,1
22943,425,199,226,54,71,56,11,781,367,414,60,67,43,17,1
22944,318,176,142,25,32,35,25,325,184,141,43,34,22,18,1
22945,169,99,70,26,21,20,7,601,313,288,42,48,25,36,1
22946,787,386,401,98,95,86,25,360,192,168,55,45,48,16,1
22947,331,169,162,40,28,22,14,1863,721,1142,262,283,139,74,1
22948,592,291,301,92,93,71,31,676,333,343,111,89,94,39,1
22949,3259,1163,2096,526,657,162,86,1117,423,694,182,134,88,31,1
22950,297,158,139,47,37,37,9,702,298,404,134,111,48,18,1
22951,646,315,331,82,84,44,24,537,276,261,75,68,68,22,1
22952,478,223,255,80,81,41,24,360,192,168,55,45,48,16,1
22953,354,137,217,63,43,38,38,1035,559,476,128,122,122,50,1
22954,134,60,74,19,13,10,7,769,329,440,116,66,55,22,1
22955,616,296,320,69,76,49,48,501,240,261,80,62,49,42,1
22956,1549,848,701,182,150,179,69,332,180,152,46,36,28,14,1
22957,387,198,189,48,48,47,23,163,67,96,45,21,17,12,1
22958,303,159,144,40,35,35,8,217,109,108,34,32,35,7,1
22959,1572,733,839,207,223,171,47,636,320,316,79,61,67,31,1
22960,262,129,133,39,26,32,25,402,227,175,48,40,35,11,1
22961,297,123,174,51,49,16,10,215,105,110,26,22,19,9,1
22962,101,57,44,14,8,6,6,288,158,130,59,23,21,10,1
22963,136,66,70,33,11,9,3,1017,498,519,136,107,82,52,1
22964,454,224,230,71,39,62,22,188,97,91,27,16,24,21,1
22965,429,219,210,46,66,42,17,234,111,123,38,35,38,8,1
22966,298,138,160,50,37,22,6,660,272,388,122,92,62,15,1
22967,467,226,241,55,48,54,23,443,248,195,67,54,40,15,1
22968,246,115,131,15,29,10,32,309,159,150,47,43,43,13,1
22969,399,189,210,65,70,42,16,691,307,384,93,128,45,19,1
22970,225,116,109,29,19,25,6,622,309,313,75,81,76,29,1
22971,358,204,154,57,41,36,14,437,225,212,61,57,66,12,1
22972,358,170,188,54,55,20,10,1185,585,600,180,174,113,58,1
22973,1257,525,732,216,210,79,52,1948,1039,909,242,227,200,67,1
22974,415,203,212,77,44,49,18,781,418,363,92,90,64,41,1
22975,511,271,240,64,55,81,23,377,180,197,37,20,24,8,1
22976,211,83,128,28,35,5,11,100,51,49,13,11,7,4,1
22977,691,241,450,151,139,24,20,568,243,325,98,73,56,44,1
22978,784,373,411,101,90,91,37,248,144,104,24,30,21,15,1
22979,720,356,364,90,98,61,22,954,521,433,135,118,78,26,1
22980,464,167,297,90,81,33,9,3911,1465,2446,610,767,240,133,1
22981,341,167,174,48,47,31,8,175,90,85,28,21,19,7,1
22982,261,108,153,35,37,16,6,295,145,150,41,45,36,18,1
22983,577,342,235,63,57,23,37,758,360,398,114,107,51,19,1
22984,904,318,586,264,81,35,10,247,110,137,34,45,23,10,1
22985,1399,600,799,236,201,109,58,3312,1761,1551,403,345,309,127,1
22986,2000,1085,915,224,231,243,114,4544,2024,2520,579,628,480,403,1
22987,323,198,125,28,25,34,15,1048,564,484,118,122,113,40,1
22988,182,105,77,18,11,21,3,350,180,170,64,46,55,12,1
22989,357,184,173,51,55,35,11,439,227,212,60,55,58,8,1
22990,381,206,175,42,53,36,20,288,158,130,59,23,21,10,1
22991,536,278,258,72,63,62,20,1258,648,610,172,159,116,28,1
22992,848,461,387,111,102,108,42,116,67,49,13,12,6,5,1
22993,261,144,117,34,22,31,15,462,157,305,93,51,54,3,1
22994,710,361,349,81,98,63,26,380,212,168,47,38,19,11,1
22995,381,189,192,74,49,44,13,375,202,173,46,49,41,23,1
22996,225,129,96,32,33,20,8,211,114,97,32,24,19,10,1
22997,432,219,213,58,51,39,20,2045,985,1060,359,339,199,74,1
22998,745,354,391,116,100,95,46,112,59,53,12,17,14,8,1
22999,1464,693,771,153,136,91,86,826,362,464,107,118,71,43,1
23000,1153,588,565,174,128,149,56,192,101,91,25,22,18,9,1
23001,255,113,142,45,30,24,13,744,384,360,104,96,57,31,1
23002,521,279,242,47,50,58,30,144,68,76,17,9,9,18,1
23003,598,322,276,67,57,63,26,815,418,397,97,62,70,17,1
23004,263,159,104,30,27,31,11,141,70,71,16,19,12,6,1
23005,134,56,78,17,30,7,7,448,236,212,53,64,56,24,1
23006,494,253,241,70,63,47,20,562,273,289,76,92,45,24,1
23007,213,91,122,42,30,23,12,170,35,135,33,25,8,5,1
23008,383,182,201,39,41,31,42,593,257,336,76,56,56,96,1
23009,2414,1189,1225,277,178,170,169,770,374,396,95,91,79,41,1
23010,1539,685,854,166,229,123,67,492,242,250,52,78,28,19,1
23011,465,257,208,51,61,54,23,297,158,139,47,37,37,9,1
23012,870,433,437,133,121,95,25,653,326,327,83,96,83,27,1
23013,881,419,462,132,82,81,24,745,391,354,85,81,52,39,1
23014,595,316,279,86,60,65,40,323,156,167,52,45,39,18,1
23015,832,428,404,131,89,88,38,1158,481,677,169,129,86,40,1
23016,863,417,446,130,112,53,29,247,110,137,34,45,23,10,1
23017,144,69,75,11,21,8,5,1863,721,1142,262,283,139,74,1
23018,1786,793,993,213,271,163,159,722,344,378,126,71,46,42,1
23019,316,156,160,43,42,28,17,2624,999,1625,416,495,109,81,1
23020,137,60,77,37,4,10,6,183,115,68,21,12,22,6,1
23021,673,317,356,101,85,76,49,427,191,236,67,60,41,34,1
23022,1201,557,644,151,125,117,50,785,374,411,56,42,38,25,1
23023,239,146,93,30,22,35,9,154,78,76,23,21,13,5,1
23024,1566,743,823,261,188,151,48,493,222,271,44,53,45,51,1
23025,390,191,199,57,49,45,25,313,148,165,45,33,36,11,1
23026,179,80,99,16,18,24,13,338,179,159,44,45,42,16,1
23027,1087,536,551,123,115,122,55,1475,658,817,149,114,120,43,1
23028,427,186,241,55,52,42,23,331,165,166,52,34,48,22,1
23029,1424,650,774,152,124,95,87,267,127,140,43,42,24,9,1
23030,304,125,179,61,31,44,10,520,243,277,83,66,51,21,1
23031,150,81,69,24,23,16,4,239,114,125,31,22,16,5,1
23032,350,180,170,64,46,55,12,503,263,240,72,55,51,34,1
23033,381,191,190,55,61,33,11,410,208,202,59,58,43,26,1
23034,646,316,330,89,95,48,17,1132,553,579,172,143,150,57,1
23035,860,457,403,118,103,103,36,552,285,267,74,51,69,24,1
23036,822,374,448,134,118,76,39,550,243,307,91,99,70,10,1
23037,445,198,247,85,67,38,19,360,192,168,55,45,48,16,1
23038,537,276,261,75,68,68,22,281,166,115,34,17,36,16,1
23039,247,127,120,43,20,27,14,241,115,126,35,30,17,14,1
23040,1573,791,782,198,173,148,46,695,340,355,79,124,53,13,1
23041,101,41,60,18,19,10,5,339,183,156,43,45,28,17,1
23042,466,224,242,68,56,48,16,128,73,55,11,15,13,8,1
23043,537,276,261,75,68,68,22,742,303,439,88,96,86,23,1
23044,274,158,116,27,27,22,18,784,373,411,101,90,91,37,1
23045,297,158,139,47,37,37,9,1056,432,624,159,165,73,36,1
23046,594,340,254,77,64,62,21,236,121,115,39,20,44,15,1
23047,415,209,206,60,67,39,18,4432,2202,2230,635,547,518,176,1
23048,505,272,233,76,66,57,23,230,115,115,29,29,22,14,1
23049,703,308,395,81,91,66,80,208,107,101,42,22,18,10,1
23050,577,251,326,92,84,60,11,566,263,303,83,87,74,31,1
23051,1858,805,1053,271,345,116,41,217,109,108,34,32,35,7,1
23052,356,142,214,55,47,29,16,183,76,107,34,38,14,8,1
23053,269,134,135,42,35,27,13,307,133,174,48,53,27,10,1
23054,200,91,109,29,34,24,7,689,343,346,119,100,86,38,1
23055,583,322,261,73,66,45,26,794,390,404,103,95,86,23,1
23056,1102,511,591,171,179,148,52,620,319,301,87,74,75,37,1
23057,240,125,115,34,32,30,8,389,176,213,81,59,24,7,1
23058,212,130,82,31,20,22,9,175,91,84,19,21,21,10,1
23059,344,181,163,61,37,40,14,136,66,70,33,11,9,5,1
23060,142,60,82,20,28,13,5,1270,557,713,130,195,57,30,1
23061,619,290,329,97,79,62,19,248,118,130,54,31,26,5,1
23062,1970,978,992,245,206,198,80,464,225,239,85,57,65,19,1
23063,247,110,137,34,45,23,10,4646,2328,2318,674,639,475,170,1
23064,606,279,327,81,70,49,34,739,369,370,102,81,95,38,1
23065,1222,648,574,138,139,132,38,402,227,175,48,40,35,11,1
23066,320,163,157,44,44,26,15,854,380,474,137,159,81,31,1
23067,1149,568,581,177,133,101,30,2347,1234,1113,252,242,302,85,1
23068,210,121,89,22,23,23,7,501,240,261,80,62,49,42,1
23069,394,207,187,52,42,37,24,360,192,168,55,45,48,16,1
23070,846,425,421,126,97,98,38,425,177,248,60,62,33,16,1
23071,606,279,327,81,70,49,34,756,348,408,101,103,60,40,1
23072,534,266,268,86,62,37,14,740,313,427,101,135,40,22,1
23073,199,101,98,29,25,18,6,671,321,350,95,87,75,34,1
23074,641,318,323,69,61,41,19,1675,875,800,213,219,196,72,1
23075,1132,646,486,99,102,71,41,758,360,398,114,107,51,19,1
23076,245,112,133,32,45,20,10,646,304,342,104,93,58,26,1
23077,708,303,405,115,115,70,23,410,208,202,59,58,43,26,1
23078,427,218,209,61,53,45,26,619,292,327,73,73,61,32,1
23079,335,155,180,64,48,36,10,672,334,338,110,93,91,41,1
23080,255,113,142,31,40,18,9,973,522,451,140,134,124,39,1
23081,351,195,156,47,53,25,14,233,121,112,24,31,30,7,1
23082,1009,506,503,146,141,97,55,817,425,392,120,102,83,26,1
23083,1132,646,486,99,102,71,41,358,180,178,57,55,39,11,1
23084,355,168,187,48,57,30,15,251,145,106,30,31,28,7,1
23085,176,122,54,8,7,30,9,229,100,129,34,32,15,6,1
23086,189,88,101,31,29,18,10,239,146,93,30,22,35,9,1
23087,391,208,183,65,49,57,17,154,73,81,24,27,18,9,1
23088,767,392,375,113,112,83,13,817,425,392,120,102,83,26,1
23089,1123,554,569,142,130,85,36,521,265,256,56,44,35,12,1
23090,496,251,245,78,62,61,23,1203,651,552,151,128,123,46,1
23091,240,125,115,34,32,30,8,76,38,38,6,13,4,8,1
23092,509,254,255,67,55,52,35,951,506,445,107,118,79,40,1
23093,416,210,206,55,54,39,20,928,442,486,139,118,91,43,1
23094,180,57,123,39,22,10,8,414,194,220,76,66,49,16,1
23095,639,397,242,64,37,64,30,854,380,474,137,159,81,31,1
23096,216,117,99,24,21,16,11,474,257,217,59,59,40,12,1
23097,811,361,450,124,107,80,31,254,107,147,42,37,24,10,1
23098,2090,1085,1005,167,141,168,40,425,210,215,56,43,52,25,1
23099,697,373,324,105,83,95,38,413,194,219,77,72,28,11,1
23100,465,206,259,59,46,40,38,1114,581,533,145,132,126,54,1
23101,828,459,369,95,92,107,25,817,425,392,120,102,83,26,1
23102,161,75,86,24,20,10,7,349,131,218,66,76,22,9,1
23103,2351,1110,1241,337,269,300,87,654,317,337,95,111,44,13,1
23104,613,333,280,71,66,47,26,625,293,332,74,71,50,40,1
23105,738,339,399,102,88,68,35,724,334,390,112,109,79,17,1
23106,993,423,570,157,113,102,104,988,422,566,141,115,105,101,1
23107,551,298,253,63,65,45,19,429,227,202,49,51,46,26,1
23108,1893,850,1043,280,340,169,80,380,187,193,38,51,30,18,1
23109,122,52,70,24,22,7,6,424,198,226,57,46,41,19,1
23110,166,83,83,24,30,18,7,353,147,206,47,61,30,25,1
23111,2319,934,1385,304,376,173,104,404,197,207,57,69,33,15,1
23112,640,297,343,120,68,68,39,651,311,340,94,75,59,22,1
23113,1210,592,618,157,138,116,85,1290,629,661,191,187,167,55,1
23114,457,237,220,69,44,53,26,552,356,196,60,55,52,22,1
23115,224,101,123,45,32,21,3,350,180,170,64,46,55,12,1
23116,194,99,95,29,24,20,8,748,355,393,121,91,95,26,1
23117,660,359,301,81,87,102,31,1482,762,720,156,144,154,52,1
23118,781,418,363,92,90,64,41,826,362,464,107,118,71,43,1
23119,255,144,111,26,27,44,10,375,226,149,39,38,19,14,1
23120,202,86,116,33,29,26,10,359,173,186,55,57,44,16,1
23121,196,110,86,23,15,14,16,620,307,313,92,91,92,33,1
23122,825,427,398,79,95,81,48,847,452,395,100,94,81,36,1
23123,671,321,350,95,87,75,34,1210,592,618,157,138,116,85,1
23124,1349,691,658,188,150,151,50,537,288,249,60,60,61,19,1
23125,393,223,170,44,36,32,14,389,199,190,51,56,41,21,1
23126,425,210,215,56,43,52,25,3574,1733,1841,371,392,414,304,1
23127,368,195,173,52,41,42,15,770,355,415,103,142,75,42,1
23128,1473,758,715,205,171,161,65,404,190,214,55,55,35,27,1
23129,360,192,168,55,45,48,16,1097,526,571,131,134,120,43,1
23130,280,142,138,35,37,22,13,593,305,288,91,83,54,24,1
23131,490,239,251,78,63,66,38,215,91,124,23,39,5,5,1
23132,1367,690,677,172,175,154,83,326,151,175,50,39,36,17,1
23133,642,271,371,106,111,57,23,691,307,384,93,128,45,19,1
23134,493,222,271,44,53,45,51,648,307,341,101,58,76,34,1
23135,240,125,115,34,32,30,8,620,267,353,98,101,35,39,1
23136,493,208,285,75,77,70,40,981,448,533,142,130,104,32,1
23137,752,381,371,96,77,80,44,1676,860,816,208,192,204,56,1
23138,1203,651,552,151,128,123,46,262,123,139,44,32,25,18,1
23139,454,229,225,61,53,63,18,163,71,92,22,38,11,7,1
23140,702,298,404,134,111,48,18,344,168,176,50,39,30,20,1
23141,384,212,172,44,43,34,14,360,192,168,55,45,48,16,1
23142,164,88,76,27,20,17,6,913,426,487,136,109,112,43,1
23143,593,321,272,64,84,33,20,437,230,207,41,55,27,13,1
23144,922,418,504,120,120,106,31,588,331,257,86,71,52,12,1
23145,95,44,51,14,13,7,4,421,231,190,60,50,43,21,1
23146,119,59,60,29,10,6,4,294,148,146,35,33,25,14,1
23147,641,324,317,88,92,49,14,420,189,231,79,67,33,17,1
23148,142,68,74,21,22,16,4,377,202,175,46,50,41,23,1
23149,605,295,310,74,66,70,36,1149,568,581,177,133,101,30,1
23150,182,90,92,25,23,14,5,451,239,212,53,64,56,22,1
23151,750,347,403,105,103,83,29,520,300,220,66,36,57,23,1
23152,670,358,312,95,75,58,26,720,356,364,90,98,61,22,1
23153,1018,547,471,122,122,120,33,1997,972,1025,262,209,239,52,1
23154,414,193,221,54,49,45,28,391,204,187,47,48,38,18,1
23155,368,195,173,52,41,42,15,1712,1175,537,179,142,113,46,1
23156,756,348,408,101,103,60,40,969,505,464,123,133,92,33,1
23157,912,497,415,126,83,106,48,359,173,186,55,57,44,16,1
23158,360,181,179,40,54,25,18,396,197,199,75,49,49,16,1
23159,280,121,159,60,45,22,12,437,225,212,61,57,66,12,1
23160,646,304,342,104,93,58,26,297,158,139,47,37,37,9,1
23161,297,158,139,47,37,37,9,164,78,86,28,23,12,8,1
23162,771,321,450,151,135,43,15,410,175,235,73,61,37,27,1
23163,220,113,107,37,24,16,7,482,231,251,76,81,64,26,1
23164,815,418,397,97,62,70,17,2440,1061,1379,377,326,172,62,1
23165,770,390,380,104,76,78,32,201,108,93,36,21,17,4,1
23166,906,455,451,116,105,87,46,845,402,443,137,126,105,47,1
23167,183,95,88,27,22,26,5,467,226,241,55,48,54,23,1
23168,462,251,211,74,53,41,18,396,169,227,74,59,35,17,1
23169,592,291,301,92,93,71,31,246,108,138,32,44,21,10,1
23170,822,416,406,111,105,84,44,208,110,98,32,25,28,4,1
23171,229,98,131,32,37,22,13,826,362,464,107,118,71,43,1
23172,815,418,397,97,62,70,17,977,467,510,153,129,106,55,1
23173,160,53,107,31,29,13,3,249,111,138,40,30,22,17,1
23174,254,134,120,34,27,26,14,769,329,440,116,66,55,22,1
23175,444,255,189,60,46,54,16,329,190,139,24,23,50,13,1
23176,368,170,198,59,64,29,13,355,168,187,48,57,30,15,1
23177,118,51,67,25,13,6,7,294,148,146,35,33,25,14,1
23178,1050,473,577,142,119,87,54,462,233,229,66,49,43,30,1
23179,450,243,207,56,51,71,18,239,146,93,30,22,35,9,1
23180,971,516,455,114,115,116,35,216,119,97,33,27,28,7,1
23181,502,240,262,78,61,54,32,380,175,205,57,64,28,11,1
23182,554,290,264,73,43,61,30,697,373,324,105,83,95,38,1
23183,166,81,85,30,27,13,8,377,201,176,46,50,41,23,1
23184,92,49,43,7,8,10,9,92,44,48,6,8,9,8,1
23185,770,385,385,78,83,60,16,163,70,93,28,21,17,6,1
23186,975,505,470,110,124,117,48,216,119,97,33,27,28,7,1
23187,459,221,238,72,78,47,16,338,168,170,60,38,48,17,1
23188,747,360,387,125,92,70,32,339,183,156,43,45,28,17,1
23189,478,239,239,65,66,65,21,453,216,237,58,60,67,20,1
23190,2442,1193,1249,278,183,170,145,246,113,133,33,45,22,10,1
23191,1412,603,809,184,195,112,45,1040,564,476,134,110,114,51,1
23192,245,111,134,31,44,20,11,1096,513,583,195,156,113,24,1
23193,1198,571,627,177,168,97,54,245,111,134,31,44,20,11,1
23194,191,91,100,28,33,23,12,627,351,276,78,62,71,32,1
23195,276,143,133,34,38,20,15,456,220,236,67,75,30,21,1
23196,1412,603,809,184,195,112,45,962,500,462,146,134,62,27,1
23197,673,317,356,101,85,76,49,462,233,229,66,49,43,30,1
23198,940,417,523,190,146,85,26,465,225,240,65,44,65,25,1
23199,606,279,327,81,70,49,34,540,282,258,50,53,33,16,1
23200,609,292,317,102,96,64,21,425,199,226,54,71,56,11,1
23201,216,102,114,31,29,21,6,1855,852,1003,329,264,184,83,1
23202,639,397,242,64,37,64,30,358,170,188,54,55,20,10,1
23203,239,110,129,32,32,24,10,604,282,322,76,74,69,35,1
23204,727,389,338,90,88,50,42,338,192,146,41,29,22,14,1
23205,456,228,228,49,70,32,19,144,57,87,38,26,10,4,1
23206,360,192,168,55,45,48,16,557,268,289,66,67,70,17,1
23207,253,148,105,31,15,39,16,810,367,443,115,92,94,59,1
23208,427,218,209,56,57,53,24,2639,1436,1203,317,307,242,77,1
23209,635,333,302,99,75,83,28,744,385,359,125,89,90,23,1
23210,1210,601,609,126,80,120,39,396,150,246,103,64,38,3,1
23211,509,262,247,64,70,64,20,1255,708,547,120,68,88,7,1
23212,1132,646,486,99,102,71,41,1222,648,574,138,139,132,38,1
23213,331,169,162,40,28,22,14,441,216,225,57,66,57,19,1
23214,384,196,188,42,43,32,20,136,66,70,33,11,9,5,1
23215,429,187,242,79,72,28,19,515,259,256,79,58,46,21,1
23216,254,146,108,28,35,33,8,261,159,102,19,29,41,11,1
23217,785,374,411,56,42,38,25,425,210,215,56,43,52,25,1
23218,4128,2104,2024,581,505,453,205,616,304,312,75,71,55,25,1
23219,327,177,150,40,40,38,18,254,146,108,36,20,34,10,1
23220,433,221,212,59,42,47,14,901,458,443,91,129,86,21,1
23221,1255,586,669,167,149,113,59,1290,658,632,145,139,94,44,1
23222,185,115,70,19,17,26,6,447,232,215,55,65,50,25,1
23223,635,333,302,99,75,83,28,833,452,381,117,85,71,39,1
23224,269,134,135,42,35,27,13,395,222,173,48,42,21,8,1
23225,1432,652,780,217,205,131,81,261,130,131,27,41,19,16,1
23226,439,199,240,66,64,49,30,582,330,252,82,69,87,21,1
23227,357,187,170,51,34,40,23,462,233,229,66,49,43,30,1
23228,1093,593,500,153,129,134,60,1480,789,691,195,151,173,55,1
23229,553,261,292,73,79,40,26,780,304,476,160,173,66,23,1
23230,595,316,279,86,60,65,40,347,198,149,45,29,29,8,1
23231,561,255,306,95,67,44,17,1149,568,581,177,133,101,30,1
23232,1185,585,600,180,174,113,58,352,179,173,54,46,35,22,1
23233,527,264,263,60,61,45,30,428,226,202,52,60,75,20,1
23234,1342,673,669,178,154,137,94,1255,666,589,145,142,120,82,1
23235,267,147,120,37,28,35,12,742,303,439,88,96,86,23,1
23236,370,196,174,63,52,21,18,2512,1328,1184,379,280,301,113,1
23237,303,137,166,54,54,31,15,467,226,241,55,48,54,23,1
23238,1375,695,680,156,173,181,57,724,650,74,44,3,32,3,1
23239,527,263,264,75,71,41,15,757,373,384,115,93,95,25,1
23240,627,314,313,61,59,71,22,226,129,97,20,25,26,11,1
23241,1382,689,693,186,176,167,77,326,151,175,50,39,36,17,1
23242,334,172,162,43,39,41,17,1441,657,784,140,135,81,73,1
23243,5147,2557,2590,501,472,455,607,1254,633,621,140,111,100,41,1
23244,845,402,443,137,126,105,47,304,159,145,38,40,32,3,1
23245,529,203,326,125,84,49,10,202,102,100,29,35,6,9,1
23246,710,302,408,112,118,60,29,986,499,487,123,116,98,54,1
23247,343,165,178,57,48,36,14,632,326,306,92,71,56,19,1
23248,425,210,215,56,43,52,25,589,281,308,69,39,63,20,1
23249,217,109,108,34,30,34,5,281,166,115,34,17,36,16,1
23250,938,484,454,137,100,104,41,446,246,200,46,32,53,25,1
23251,769,362,407,99,88,66,67,321,141,180,45,47,32,17,1
23252,652,272,380,116,113,55,27,856,429,427,113,105,96,24,1
23253,1014,490,524,177,137,94,38,437,228,209,47,61,26,11,1
23254,281,137,144,39,41,34,11,327,149,178,47,49,38,11,1
23255,176,74,102,20,29,7,7,147,54,93,26,38,6,5,1
23256,240,98,142,49,42,23,17,432,190,242,85,82,28,11,1
23257,250,122,128,27,23,30,19,397,186,211,73,63,36,25,1
23258,940,464,476,116,135,108,58,1284,740,544,151,119,106,27,1
23259,211,112,99,30,15,34,18,707,386,321,85,83,99,28,1
23260,605,295,310,74,66,70,36,2541,1299,1242,306,302,121,98,1
23261,412,216,196,24,48,18,16,610,281,329,54,62,65,58,1
23262,764,372,392,109,94,85,36,1744,920,824,225,190,178,57,1
23263,415,203,212,77,44,49,18,501,285,216,52,55,62,25,1
23264,1379,599,780,214,189,91,33,309,106,203,66,49,25,10,1
23265,760,322,438,81,130,57,19,289,139,150,38,44,23,20,1
23266,537,276,261,75,68,68,22,815,418,397,97,62,70,17,1
23267,1338,756,582,155,105,104,44,1187,631,556,182,139,152,56,1
23268,288,118,170,50,57,18,15,291,158,133,35,29,46,17,1
23269,246,115,131,15,29,10,32,296,186,110,27,12,48,14,1
23270,522,285,237,68,38,73,29,113,60,53,11,13,10,3,1
23271,380,184,196,58,52,46,8,1106,579,527,121,152,113,45,1
23272,225,102,123,32,32,31,15,769,329,440,116,66,55,22,1
23273,410,200,210,60,54,46,19,428,214,214,65,67,45,23,1
23274,1861,896,965,265,187,156,70,2161,1233,928,269,199,178,42,1
23275,847,434,413,132,66,91,47,930,367,563,181,153,83,48,1
23276,116,50,66,12,28,5,7,526,257,269,72,63,62,30,1
23277,207,86,121,34,39,12,13,716,364,352,107,80,75,26,1
23278,1050,473,577,142,119,87,54,641,324,317,88,92,49,14,1
23279,517,295,222,60,55,55,19,686,375,311,89,80,63,20,1
23280,194,92,102,43,30,12,4,202,102,100,29,35,6,9,1
23281,1706,830,876,265,209,230,63,492,290,202,56,53,67,15,1
23282,2442,1193,1249,278,183,170,145,1338,506,832,241,229,101,40,1
23283,377,212,165,56,37,34,21,412,216,196,24,48,18,16,1
23284,154,75,79,17,24,16,13,1493,672,821,258,211,146,47,1
23285,354,169,185,54,54,41,19,472,263,209,57,39,60,29,1
23286,964,408,556,131,153,76,55,846,349,497,149,114,57,33,1
23287,247,135,112,38,18,29,13,469,247,222,70,58,82,13,1
23288,314,142,172,29,48,21,16,835,420,415,104,105,57,47,1
23289,1581,684,897,220,153,118,63,556,259,297,75,69,63,38,1
23290,219,124,95,22,22,23,5,451,267,184,43,39,50,7,1
23291,260,136,124,24,41,19,4,616,323,293,98,71,31,15,1
23292,427,218,209,61,53,45,26,407,207,200,53,36,38,8,1
23293,257,132,125,39,27,26,10,425,210,215,56,43,52,25,1
23294,576,250,326,93,71,34,15,622,294,328,104,93,42,17,1
23295,334,171,163,48,42,32,18,748,360,388,101,89,82,36,1
23296,736,367,369,107,97,46,24,399,238,161,55,41,42,12,1
23297,530,244,286,103,62,42,20,2063,1024,1039,175,117,80,97,1
23298,2351,1110,1241,337,269,300,87,311,145,166,43,37,45,14,1
23299,313,159,154,44,41,40,16,503,263,240,72,55,51,34,1
23300,1242,613,629,174,113,114,53,1001,557,444,113,132,81,53,1
23301,537,272,265,75,83,41,29,769,292,477,176,71,124,50,1
23302,563,271,292,72,91,34,27,336,134,202,51,64,27,12,1
23303,748,355,393,121,91,95,26,1502,683,819,241,216,172,52,1
23304,227,109,118,42,35,29,8,2115,838,1277,346,354,90,48,1
23305,677,361,316,81,61,42,22,551,298,253,63,65,45,19,1
23306,654,409,245,88,73,20,24,770,355,415,103,142,75,42,1
23307,681,322,359,100,87,71,26,719,364,355,104,100,58,34,1
23308,529,274,255,57,62,38,14,778,367,411,90,85,64,43,1
23309,318,176,142,25,32,35,25,628,297,331,103,65,85,59,1
23310,592,264,328,86,85,62,41,728,385,343,110,102,69,14,1
23311,252,145,107,43,16,24,10,1273,592,681,199,164,139,39,1
23312,394,220,174,50,28,53,21,245,112,133,32,45,20,10,1
23313,158,85,73,24,18,18,8,750,347,403,105,103,83,29,1
23314,360,192,168,55,45,48,16,649,326,323,83,66,87,38,1
23315,344,168,176,65,44,33,15,189,90,99,26,29,17,11,1
23316,95,44,51,14,13,7,4,231,126,105,37,26,29,6,1
23317,671,318,353,83,124,46,34,171,107,64,14,12,16,9,1
23318,485,209,276,78,69,37,30,207,89,118,28,26,16,6,1
23319,725,365,360,104,111,70,31,424,179,245,65,67,29,11,1
23320,615,312,303,86,54,75,45,652,329,323,65,70,51,50,1
23321,955,465,490,137,138,119,28,669,340,329,77,61,94,40,1
23322,381,191,190,55,61,33,11,1210,592,618,157,138,116,85,1
23323,737,363,374,119,101,85,41,147,68,79,31,23,8,4,1
23324,425,210,215,56,43,52,25,801,372,429,112,91,92,51,1
23325,422,211,211,73,61,43,17,149,68,81,15,38,11,10,1
23326,333,167,166,45,30,34,14,738,339,399,102,88,68,35,1
23327,2471,1130,1341,240,281,219,290,448,275,173,32,53,55,27,1
23328,987,515,472,107,110,106,61,839,408,431,138,122,105,46,1
23329,648,307,341,101,58,76,34,315,129,186,51,29,24,29,1
23330,777,387,390,90,87,65,37,390,207,183,50,48,38,15,1
23331,606,343,263,69,65,66,22,105,53,52,23,11,12,6,1
23332,593,257,336,76,56,56,96,132,65,67,21,9,8,21,1
23333,770,390,380,104,76,78,32,465,261,204,51,35,48,21,1
23334,587,259,328,92,94,56,23,2696,1169,1527,432,347,193,146,1
23335,508,251,257,74,53,51,18,140,62,78,28,14,8,5,1
23336,446,176,270,64,79,45,24,875,376,499,155,125,53,39,1
23337,2414,1189,1225,277,178,170,169,598,322,276,67,57,63,26,1
23338,538,252,286,77,87,53,30,480,232,248,83,64,51,25,1
23339,291,133,158,46,51,21,15,425,198,227,57,69,59,13,1
23340,1647,794,853,222,218,151,65,468,243,225,60,50,34,32,1
23341,990,410,580,140,175,44,36,327,160,167,56,31,36,15,1
23342,712,331,381,111,86,86,34,560,260,300,100,58,29,28,1
23343,619,332,287,95,77,74,38,906,455,451,116,105,87,46,1
23344,337,189,148,30,32,45,11,778,367,411,90,85,64,43,1
23345,325,181,144,46,31,48,9,270,137,133,30,28,27,11,1
23346,642,271,371,106,111,57,23,780,354,426,123,102,45,17,1
23347,573,278,295,58,79,37,23,158,85,73,24,18,18,8,1
23348,103,56,47,27,7,8,2,425,199,226,54,71,56,11,1
23349,593,342,251,73,55,82,29,115,55,60,25,14,7,7,1
23350,743,341,402,104,89,68,38,330,143,187,63,29,52,20,1
23351,870,433,437,133,121,95,25,2803,1300,1503,392,510,170,57,1
23352,503,263,240,72,55,51,34,465,225,240,65,44,65,25,1
23353,1721,838,883,241,218,144,54,568,193,375,112,83,50,15,1
23354,331,169,162,40,28,22,14,272,141,131,45,29,36,9,1
23355,1134,539,595,150,146,78,40,551,298,253,63,65,45,19,1
23356,870,489,381,97,99,76,14,1115,552,563,104,116,115,35,1
23357,1137,543,594,179,140,113,38,261,130,131,27,41,19,16,1
23358,215,115,100,27,28,34,16,1242,613,629,174,113,114,53,1
23359,288,118,170,50,57,18,15,466,186,280,71,84,30,11,1
23360,2490,1126,1364,352,325,219,89,111,51,60,20,21,10,11,1
23361,501,216,285,79,70,54,30,167,89,78,16,14,18,7,1
23362,987,515,472,107,110,106,61,298,160,138,37,30,22,12,1
23363,154,66,88,31,17,14,9,393,186,207,58,50,36,22,1
23364,176,84,92,46,10,28,11,309,106,203,66,49,25,10,1
23365,378,154,224,74,84,35,22,756,348,408,101,103,60,40,1
23366,374,187,187,51,52,40,27,416,201,215,54,52,39,25,1
23367,454,224,230,71,39,62,22,205,94,111,29,31,16,7,1
23368,698,345,353,104,87,81,50,272,124,148,51,36,23,27,1
23369,656,358,298,67,47,64,26,318,176,142,25,32,35,25,1
23370,551,298,253,63,65,45,19,309,154,155,42,44,45,16,1
23371,564,284,280,71,64,41,13,194,91,103,17,32,9,6,1
23372,585,289,296,102,86,61,18,685,323,362,120,80,89,39,1
23373,429,219,210,46,66,42,17,676,331,345,105,98,68,25,1
23374,339,157,182,39,49,43,19,401,167,234,56,71,16,10,1
23375,360,188,172,49,48,47,17,473,212,261,72,64,45,28,1
23376,509,262,247,64,70,64,20,164,88,76,27,20,17,6,1
23377,603,311,292,102,71,66,23,241,132,109,33,26,27,13,1
23378,1573,791,782,198,173,148,46,1721,809,912,268,234,144,50,1
23379,796,408,388,95,124,82,19,781,418,363,92,90,64,41,1
23380,595,316,279,86,60,65,40,504,259,245,73,56,45,29,1
23381,232,108,124,33,27,19,16,470,227,243,70,66,53,15,1
23382,483,258,225,70,53,54,20,72,35,37,10,9,7,6,1
23383,947,506,441,105,126,75,14,254,107,147,42,37,24,10,1
23384,473,224,249,82,63,48,24,721,331,390,100,122,92,28,1
23385,158,71,87,23,21,17,12,2472,1055,1417,416,458,235,64,1
23386,536,278,258,72,63,62,20,870,489,381,97,99,76,14,1
23387,667,360,307,76,92,46,27,1480,789,691,195,151,173,55,1
23388,412,223,189,55,55,41,10,621,310,311,100,106,77,27,1
23389,425,244,181,38,26,60,26,374,181,193,63,49,46,20,1
23390,464,236,228,64,56,53,28,179,76,103,36,32,9,9,1
23391,577,251,326,92,84,60,11,298,167,131,47,33,40,8,1
23392,947,482,465,143,107,89,37,378,154,224,74,84,35,22,1
23393,159,84,75,13,28,10,8,671,318,353,83,124,46,34,1
23394,529,283,246,66,69,66,25,245,111,134,31,44,20,11,1
23395,416,201,215,54,52,39,25,184,87,97,19,21,12,17,1
23396,897,487,410,92,97,83,31,509,262,247,64,70,64,20,1
23397,280,114,166,56,28,48,35,406,212,194,50,52,24,18,1
23398,169,64,105,23,37,11,3,374,187,187,51,52,40,27,1
23399,308,129,179,44,60,19,8,220,113,107,37,24,16,7,1
23400,221,111,110,42,35,33,6,282,135,147,36,49,25,10,1
23401,1215,572,643,151,105,127,54,396,150,246,103,64,38,3,1
23402,382,230,152,46,22,47,23,1562,742,820,219,231,104,46,1
23403,445,228,217,47,62,53,26,535,249,286,79,64,55,22,1
23404,1152,459,693,138,343,75,33,451,222,229,58,55,51,17,1
23405,4061,1099,2962,910,478,510,7,391,208,183,65,49,57,17,1
23406,425,210,215,56,43,52,25,615,339,276,82,76,63,16,1
23407,1273,592,681,199,164,139,39,331,193,138,44,37,18,9,1
23408,283,172,111,39,31,29,8,89,45,44,13,4,8,3,1
23409,208,101,107,38,28,24,7,766,386,380,101,81,78,31,1
23410,264,122,142,33,29,13,13,1199,589,610,189,128,167,65,1
23411,636,336,300,94,65,58,32,605,295,310,74,66,70,36,1
23412,671,326,345,111,77,74,11,953,377,576,203,197,65,29,1
23413,855,359,496,142,153,53,24,1278,593,685,198,201,71,43,1
23414,94,51,43,18,6,4,9,415,250,165,43,28,50,21,1
23415,218,105,113,31,28,24,14,541,260,281,87,65,70,24,1
23416,327,160,167,56,31,36,15,393,186,207,58,50,36,22,1
23417,974,509,465,133,107,102,40,1009,506,503,146,141,97,55,1
23418,1117,556,561,188,117,110,48,505,275,230,63,57,35,12,1
23419,482,228,254,87,71,67,15,339,189,150,34,27,55,13,1
23420,500,266,234,56,56,55,25,858,417,441,124,101,85,41,1
23421,961,507,454,130,102,115,37,664,297,367,88,86,55,47,1
23422,1170,510,660,142,182,115,84,810,367,443,115,92,94,59,1
23423,598,301,297,76,53,71,36,316,201,115,29,31,12,6,1
23424,480,234,246,79,77,65,23,2549,1331,1218,366,296,271,130,1
23425,159,84,75,13,28,10,8,297,158,139,47,37,37,9,1
23426,401,204,197,49,33,29,17,215,80,135,54,56,21,9,1
23427,578,278,300,101,88,67,31,149,68,81,15,38,11,10,1
23428,1440,759,681,173,170,178,71,745,391,354,85,81,52,39,1
23429,673,313,360,101,101,46,17,512,248,264,66,71,49,30,1
23430,1382,689,693,186,176,167,77,198,98,100,30,21,21,8,1
23431,423,222,201,60,51,51,11,158,82,76,25,26,19,12,1
23432,787,351,436,135,98,82,23,771,331,440,136,104,72,27,1
23433,505,275,230,63,57,35,12,669,363,306,93,72,74,36,1
23434,536,278,258,72,63,62,20,408,271,137,36,18,38,23,1
23435,316,156,160,43,42,28,17,677,323,354,101,109,45,31,1
23436,202,105,97,28,27,14,6,180,87,93,31,19,12,18,1
23437,183,115,68,21,12,22,6,183,95,88,25,22,15,15,1
23438,392,186,206,62,56,29,15,452,236,216,73,54,50,29,1
23439,719,301,418,122,132,42,26,755,348,407,109,98,49,23,1
23440,802,388,414,131,105,96,29,551,298,253,63,65,45,19,1
23441,431,219,212,68,46,67,18,509,254,255,67,55,52,35,1
23442,1692,713,979,325,210,122,58,246,113,133,33,45,22,10,1
23443,450,129,321,128,70,43,15,582,293,289,94,80,77,32,1
23444,400,187,213,57,46,51,16,724,334,390,112,109,79,17,1
23445,370,173,197,65,57,42,10,377,223,154,35,31,36,20,1
23446,1210,592,618,157,138,116,85,360,192,168,55,45,48,16,1
23447,870,489,381,97,99,76,14,509,262,247,64,70,64,20,1
23448,295,181,114,34,19,43,21,233,121,112,24,31,30,7,1
23449,504,237,267,62,66,48,17,2871,1218,1653,290,374,238,414,1
23450,556,259,297,75,69,63,38,737,320,417,112,94,73,34,1
23451,79,38,41,19,11,15,4,198,80,118,35,31,14,7,1
23452,557,240,317,97,74,68,37,277,122,155,33,33,25,24,1
23453,360,161,199,72,36,35,13,135,73,62,15,16,15,8,1
23454,234,125,109,23,16,27,11,147,72,75,26,10,17,9,1
23455,624,204,420,166,101,32,13,428,214,214,65,67,45,23,1
23456,408,179,229,86,72,32,5,628,341,287,77,59,55,31,1
23457,424,209,215,56,58,45,24,347,212,135,35,32,17,6,1
23458,789,319,470,129,139,81,35,522,235,287,78,67,60,50,1
23459,480,244,236,74,47,50,21,641,324,317,88,92,49,14,1
23460,419,175,244,71,73,23,23,756,348,408,101,103,60,40,1
23461,160,91,69,13,28,11,13,239,146,93,30,22,35,9,1
23462,876,397,479,168,168,84,24,1058,558,500,132,127,121,53,1
23463,1256,595,661,153,143,106,130,799,377,422,98,95,80,70,1
23464,333,192,141,50,48,28,10,1367,690,677,172,175,154,83,1
23465,624,308,316,92,72,68,22,400,203,197,30,36,31,10,1
23466,451,209,242,73,53,47,36,431,219,212,68,46,67,18,1
23467,367,181,186,63,51,37,20,586,270,316,83,80,59,21,1
23468,537,276,261,75,68,68,22,1242,613,629,174,113,114,53,1
23469,1232,497,735,204,201,64,53,317,149,168,62,44,27,10,1
23470,598,300,298,68,77,59,21,1462,711,751,219,222,148,65,1
23471,275,140,135,38,32,18,5,334,172,162,43,39,41,17,1
23472,330,207,123,25,17,49,21,155,79,76,26,13,15,6,1
23473,474,208,266,65,69,43,36,377,201,176,46,50,41,23,1
23474,450,242,208,53,63,56,22,454,191,263,61,66,38,15,1
23475,360,168,192,57,49,48,19,1071,549,522,133,127,130,59,1
23476,1264,655,609,141,119,131,50,781,418,363,92,90,64,41,1
23477,895,437,458,150,156,60,30,1098,519,579,182,159,79,42,1
23478,95,44,51,14,13,7,4,545,283,262,85,69,69,24,1
23479,394,202,192,44,43,38,28,772,382,390,107,74,83,34,1
23480,52,30,22,6,2,3,6,1042,570,472,113,125,91,61,1
23481,198,107,91,26,18,27,6,707,386,321,85,83,99,28,1
23482,1124,615,509,157,125,128,52,551,299,252,51,62,63,17,1
23483,505,226,279,68,51,30,15,350,180,170,64,46,55,12,1
23484,623,233,390,145,83,43,20,239,121,118,28,38,15,7,1
23485,613,354,259,72,72,61,19,536,278,258,72,63,62,20,1
23486,318,176,142,25,32,35,25,346,165,181,69,43,22,9,1
23487,1235,637,598,191,162,99,36,448,236,212,53,64,56,24,1
23488,509,243,266,80,57,45,19,304,159,145,38,40,32,3,1
23489,318,176,142,25,32,35,25,1210,592,618,157,138,116,85,1
23490,178,100,78,23,22,30,6,547,300,247,68,60,55,30,1
23491,418,213,205,54,56,49,13,256,148,108,31,16,29,12,1
23492,1257,662,595,176,142,106,42,593,266,327,102,84,69,24,1
23493,368,158,210,64,61,39,14,396,169,227,74,59,35,17,1
23494,361,174,187,63,56,38,16,434,189,245,76,69,43,18,1
23495,756,265,491,129,127,51,17,509,245,264,85,71,56,22,1
23496,208,104,104,39,20,26,15,508,267,241,43,35,25,17,1
23497,494,266,228,64,60,58,28,545,284,261,72,67,72,25,1
23498,573,271,302,56,64,55,18,291,141,150,50,29,35,7,1
23499,400,215,185,59,54,33,16,379,203,176,55,48,45,16,1
23500,216,104,112,27,18,35,20,263,141,122,33,25,32,16,1
23501,372,237,135,38,22,39,26,354,168,186,50,53,39,20,1
23502,642,325,317,74,78,73,43,623,320,303,103,85,75,15,1
23503,1388,535,853,241,239,96,52,125,63,62,20,16,15,7,1
23504,557,250,307,70,47,51,22,631,315,316,64,57,49,15,1
23505,351,166,185,48,61,24,15,689,336,353,99,92,79,31,1
23506,165,87,78,24,19,22,9,93,45,48,19,15,14,3,1
23507,305,166,139,42,38,28,12,333,127,206,66,68,25,14,1
23508,728,385,343,110,102,69,14,1242,613,629,174,113,114,53,1
23509,379,203,176,55,48,45,16,196,105,91,22,26,21,8,1
23510,440,268,172,45,42,66,16,1474,756,718,175,158,169,51,1
23511,425,210,215,56,43,52,25,573,278,295,58,79,37,23,1
23512,686,345,341,98,106,75,25,208,104,104,39,20,26,15,1
23513,336,140,196,51,44,27,18,748,355,393,121,91,95,26,1
23514,233,96,137,40,40,13,9,951,497,454,142,127,49,24,1
23515,235,135,100,30,13,25,11,338,179,159,44,45,42,16,1
23516,298,167,131,47,33,40,8,79,38,41,19,11,15,4,1
23517,332,185,147,47,40,49,13,143,79,64,16,25,7,5,1
23518,404,190,214,55,55,35,27,780,304,476,160,173,66,23,1
23519,503,263,240,72,55,51,34,704,356,348,112,94,71,24,1
23520,1338,756,582,155,105,104,44,508,295,213,42,61,53,17,1
23521,377,171,206,59,58,41,22,749,374,375,99,108,98,37,1
23522,781,418,363,92,90,64,41,505,269,236,52,59,32,18,1
23523,2517,1275,1242,304,324,245,135,393,186,207,58,50,36,22,1
23524,354,137,217,53,57,30,5,601,278,323,81,65,27,12,1
23525,382,207,175,55,32,40,13,1231,603,628,121,162,109,120,1
23526,1084,537,547,154,121,92,35,379,203,176,55,48,45,16,1
23527,454,191,263,61,66,38,15,371,174,197,53,56,43,15,1
23528,1290,597,693,182,182,119,63,391,203,188,49,48,41,14,1
23529,608,308,300,91,84,53,29,641,324,317,88,92,49,14,1
23530,163,70,93,28,21,17,6,333,163,170,53,41,20,11,1
23531,1719,754,965,277,258,158,80,172,77,95,27,35,21,11,1
23532,280,156,124,36,19,20,13,374,202,172,58,40,41,7,1
23533,815,418,397,97,62,70,17,2229,1036,1193,337,286,161,62,1
23534,684,288,396,107,90,54,42,1055,482,573,156,172,119,33,1
23535,619,290,329,97,79,62,19,2803,1300,1503,392,510,170,57,1
23536,1822,879,943,236,227,175,97,672,334,338,110,93,91,41,1
23537,1100,581,519,144,149,78,42,930,367,563,181,153,83,48,1
23538,461,257,204,63,49,50,29,900,484,416,119,110,77,29,1
23539,1336,828,508,166,121,152,48,864,429,435,129,118,68,35,1
23540,2946,1499,1447,365,342,315,119,404,197,207,57,69,33,15,1
23541,991,483,508,166,120,94,42,938,441,497,154,131,94,25,1
23542,502,237,265,82,68,54,23,702,298,404,134,111,48,18,1
23543,756,368,388,114,99,89,30,149,68,81,15,38,11,10,1
23544,1464,693,771,153,136,91,86,789,362,427,90,82,70,35,1
23545,561,210,351,108,77,41,22,602,299,303,98,81,72,21,1
23546,592,275,317,100,86,57,31,1058,558,500,132,127,121,53,1
23547,729,321,408,128,84,63,26,89,42,47,16,12,15,6,1
23548,604,255,349,100,72,55,26,482,231,251,76,81,64,26,1
23549,1338,756,582,155,105,104,44,724,334,390,112,109,79,17,1
23550,293,142,151,49,40,42,17,277,124,153,44,40,35,18,1
23551,1354,537,817,245,247,117,57,524,237,287,87,75,54,26,1
23552,303,137,166,54,54,31,15,613,342,271,69,50,60,41,1
23553,546,267,279,90,69,56,19,493,208,285,75,77,70,40,1
23554,288,158,130,59,23,21,10,391,208,183,65,49,57,17,1
23555,431,227,204,53,60,58,12,90,41,49,17,15,5,8,1
23556,601,313,288,42,48,25,36,434,128,306,138,58,27,13,1
23557,583,322,261,73,66,45,26,446,265,181,51,35,27,17,1
23558,4870,2464,2406,658,676,550,245,4967,2501,2466,718,692,594,248,1
23559,415,209,206,60,67,39,18,299,153,146,32,28,29,12,1
23560,501,265,236,89,52,45,16,1038,470,568,130,123,86,51,1
23561,628,324,304,83,85,75,23,467,224,243,70,43,67,23,1
23562,736,367,369,107,97,46,24,433,221,212,59,42,47,14,1
23563,335,185,150,46,34,36,13,525,299,226,54,54,51,19,1
23564,310,161,149,34,31,35,12,624,308,316,92,72,68,22,1
23565,115,67,48,10,7,12,7,177,99,78,22,23,20,10,1
23566,206,94,112,37,36,18,9,149,68,81,15,38,11,10,1
23567,671,321,350,95,87,75,34,455,218,237,57,51,42,35,1
23568,794,402,392,96,84,86,30,999,504,495,95,119,78,42,1
23569,255,122,133,35,51,22,13,954,521,433,135,118,78,26,1
23570,352,212,140,37,17,61,20,1154,540,614,195,160,138,66,1
23571,1255,708,547,120,68,88,7,217,109,108,34,32,35,7,1
23572,593,295,298,70,85,48,13,454,191,263,61,66,38,15,1
23573,1117,556,561,188,117,110,48,1165,567,598,134,119,158,63,1
23574,1531,691,840,270,226,143,52,655,281,374,108,103,61,24,1
23575,979,535,444,123,99,79,34,601,313,288,42,48,25,36,1
23576,277,124,153,44,40,35,18,749,374,375,99,108,98,37,1
23577,375,214,161,43,22,52,25,95,58,37,11,9,8,5,1
23578,223,93,130,38,27,39,10,504,352,152,42,44,43,23,1
23579,336,140,196,51,44,27,18,502,236,266,66,66,58,17,1
23580,870,433,437,133,121,95,25,1336,828,508,166,121,152,48,1
23581,593,266,327,102,84,69,24,825,399,426,128,128,77,32,1
23582,218,108,110,28,28,22,10,379,203,176,55,48,45,16,1
23583,678,344,334,85,87,67,46,890,512,378,92,95,75,41,1
23584,277,124,153,44,40,35,18,781,418,363,92,90,64,41,1
23585,524,264,260,75,75,40,21,647,324,323,101,80,76,43,1
23586,217,109,108,34,32,35,7,744,385,359,125,89,90,23,1
23587,391,165,226,67,64,36,27,579,321,258,74,70,47,22,1
23588,815,382,433,97,50,88,31,2442,1193,1249,278,183,170,145,1
23589,606,279,327,81,70,49,34,1147,483,664,200,195,95,53,1
23590,807,359,448,114,99,93,33,164,88,76,27,20,17,6,1
23591,400,208,192,62,44,42,21,858,431,427,94,57,54,30,1
23592,111,51,60,20,21,10,11,501,240,261,80,62,49,42,1
23593,379,203,176,55,48,45,16,154,73,81,24,27,18,9,1
23594,2912,1266,1646,268,360,243,422,183,89,94,19,24,22,15,1
23595,219,124,95,22,22,23,5,335,172,163,54,29,39,13,1
23596,499,272,227,49,66,66,21,477,232,245,67,64,70,30,1
23597,154,75,79,17,24,16,13,748,355,393,121,91,95,26,1
23598,822,416,406,111,105,84,44,923,471,452,119,117,119,41,1
23599,429,219,210,46,66,42,17,327,164,163,53,45,51,8,1
23600,651,331,320,93,93,51,28,368,158,210,64,61,39,14,1
23601,569,290,279,86,58,61,16,331,170,161,47,39,41,8,1
23602,635,333,302,99,75,83,28,863,470,393,82,72,92,44,1
23603,2005,1074,931,235,243,249,109,419,226,193,58,38,39,22,1
23604,1332,626,706,182,144,80,41,379,203,176,48,38,44,11,1
23605,551,298,253,63,65,45,19,659,325,334,102,85,87,32,1
23606,601,308,293,102,51,62,28,136,65,71,33,11,9,6,1
23607,409,208,201,33,45,23,10,410,200,210,60,54,46,19,1
23608,201,94,107,25,31,27,6,609,279,330,103,98,72,42,1
23609,1342,675,667,162,154,123,39,215,114,101,21,32,26,12,1
23610,1273,592,681,199,164,139,39,486,217,269,110,62,23,10,1
23611,1400,800,600,158,134,150,65,543,287,256,71,66,64,23,1
23612,215,80,135,54,56,21,9,769,329,440,116,66,55,22,1
23613,525,299,226,54,54,51,19,765,295,470,200,142,84,27,1
23614,464,236,228,64,56,53,28,240,125,115,34,32,30,8,1
23615,833,390,443,140,111,76,34,685,304,381,124,103,71,22,1
23616,246,113,133,33,45,22,10,1400,800,600,158,134,150,65,1
23617,376,199,177,38,58,19,11,380,187,193,38,51,30,18,1
23618,480,244,236,74,47,50,21,337,189,148,30,32,45,11,1
23619,373,213,160,44,33,27,17,461,207,254,82,66,55,33,1
23620,279,106,173,48,35,41,39,215,117,98,43,22,27,5,1
23621,2045,985,1060,359,339,199,74,227,130,97,32,25,22,12,1
23622,585,289,296,102,86,61,18,630,289,341,100,121,62,34,1
23623,217,98,119,38,35,18,9,462,233,229,66,49,43,30,1
23624,211,113,98,38,17,25,8,537,276,261,75,68,68,22,1
23625,356,161,195,52,57,40,17,149,68,81,15,38,11,10,1
23626,686,375,311,89,80,63,20,215,80,135,54,56,21,9,1
23627,335,185,150,46,34,36,13,231,126,105,37,26,29,6,1
23628,509,262,247,64,70,64,20,1265,580,685,205,188,166,53,1
23629,112,61,51,9,8,7,9,1103,651,452,144,118,96,44,1
23630,310,161,149,34,31,35,12,131,78,53,8,5,9,13,1
23631,555,278,277,60,70,48,18,313,157,156,39,26,34,29,1
23632,287,124,163,52,48,24,16,211,83,128,28,35,5,11,1
23633,2468,1038,1430,333,465,167,62,577,288,289,85,56,40,20,1
23634,963,480,483,126,105,98,33,247,110,137,34,45,23,10,1
23635,772,382,390,107,74,83,34,489,253,236,73,36,62,17,1
23636,582,293,289,94,80,77,32,1531,691,840,270,226,143,52,1
23637,501,285,216,52,55,62,25,729,391,338,80,64,71,34,1
23638,722,384,338,94,83,63,35,377,184,193,56,53,44,14,1
23639,170,82,88,28,23,20,12,746,361,385,91,92,101,32,1
23640,595,316,279,86,60,65,40,303,176,127,30,21,36,22,1
23641,94,48,46,16,7,8,6,739,359,380,83,95,53,38,1
23642,360,192,168,55,45,48,16,341,178,163,48,44,42,20,1
23643,466,242,224,66,53,53,13,264,121,143,46,24,35,10,1
23644,168,76,92,26,21,19,4,143,79,64,16,25,7,5,1
23645,767,392,375,113,112,83,13,2803,1300,1503,392,510,170,57,1
23646,1948,1039,909,242,227,200,67,700,357,343,99,84,88,34,1
23647,762,363,399,132,107,82,26,323,159,164,49,28,38,22,1
23648,464,249,215,73,42,65,12,550,243,307,91,99,70,10,1
23649,158,83,75,22,14,17,9,465,225,240,65,44,65,25,1
23650,369,216,153,36,22,46,23,354,169,185,54,54,41,19,1
23651,154,75,79,17,24,16,13,639,322,317,73,82,39,23,1
23652,890,512,378,92,95,75,41,536,278,258,72,63,62,20,1
23653,150,60,90,27,16,6,3,505,226,279,68,51,30,15,1
23654,3801,1837,1964,510,442,418,170,876,457,419,88,124,67,47,1
23655,277,124,153,44,40,35,18,246,128,118,39,34,22,7,1
23656,574,273,301,101,74,68,26,1480,789,691,195,151,173,55,1
23657,651,306,345,85,64,61,32,621,301,320,76,64,46,34,1
23658,1311,690,621,158,161,128,51,292,152,140,46,38,35,12,1
23659,216,122,94,33,25,28,12,802,449,353,102,87,82,29,1
23660,1203,462,741,215,230,40,22,247,110,137,34,45,23,10,1
23661,568,243,325,98,73,56,44,318,145,173,29,38,34,22,1
23662,1034,452,582,169,127,123,28,399,189,210,65,70,42,16,1
23663,405,205,200,59,55,39,9,348,226,122,23,20,59,25,1
23664,197,95,102,31,23,18,12,431,227,204,53,60,58,12,1
23665,322,160,162,44,52,33,16,606,307,299,92,56,68,30,1
23666,641,324,317,88,92,49,14,255,142,113,40,32,27,6,1
23667,727,259,468,163,157,68,15,536,278,258,72,63,62,20,1
23668,376,176,200,31,53,27,8,439,205,234,64,88,41,21,1
23669,533,254,279,81,78,52,10,509,243,266,80,57,45,19,1
23670,637,335,302,83,77,85,26,1124,615,509,157,125,128,52,1
23671,580,339,241,72,47,66,21,928,455,473,108,90,107,43,1
23672,1257,647,610,156,146,145,35,253,148,105,31,15,39,16,1
23673,712,313,399,125,119,51,24,2414,1189,1225,277,178,170,169,1
23674,625,316,309,77,79,54,34,522,235,287,78,67,60,50,1
23675,307,150,157,44,23,30,13,292,152,140,46,38,35,12,1
23676,793,413,380,105,120,57,23,785,374,411,56,42,38,25,1
23677,336,140,196,51,44,27,18,326,141,185,57,39,33,20,1
23678,419,197,222,70,51,36,19,510,246,264,80,71,15,18,1
23679,839,408,431,138,122,105,46,742,303,439,88,96,86,23,1
23680,769,329,440,116,66,55,22,770,356,414,123,102,66,25,1
23681,54,26,28,11,4,3,3,128,58,70,22,14,4,7,1
23682,161,83,78,33,12,17,5,415,242,173,53,21,70,21,1
23683,1039,597,442,101,110,106,33,476,263,213,56,44,50,16,1
23684,329,155,174,46,38,29,14,422,213,209,59,47,42,14,1
23685,589,296,293,99,76,64,29,590,298,292,73,45,71,25,1
23686,244,105,139,38,28,20,15,1354,537,817,245,247,117,57,1
23687,785,374,411,56,42,38,25,2414,1189,1225,277,178,170,169,1
23688,345,203,142,47,35,31,11,377,221,156,55,38,45,12,1
23689,3911,1465,2446,610,767,240,133,415,203,212,77,44,49,18,1
23690,903,457,446,99,127,62,29,381,188,193,59,60,35,12,1
23691,497,227,270,70,63,66,30,89,44,45,15,12,15,6,1
23692,603,311,292,102,71,66,23,991,483,508,166,120,94,42,1
23693,264,126,138,44,26,25,10,330,143,187,63,29,52,20,1
23694,824,386,438,94,77,81,34,2414,1189,1225,277,178,170,169,1
23695,537,276,261,75,68,68,22,1265,580,685,205,188,166,53,1
23696,554,269,285,60,67,38,21,362,183,179,49,49,41,11,1
23697,508,267,241,43,35,25,17,517,196,321,103,98,34,12,1
23698,521,265,256,56,44,35,12,245,111,134,31,44,20,11,1
23699,522,273,249,62,57,51,18,618,290,328,82,74,69,42,1
23700,479,228,251,79,78,64,24,114,64,50,16,19,14,5,1
23701,926,437,489,135,107,113,42,437,225,212,61,57,66,12,1
23702,863,458,405,97,82,63,57,352,166,186,55,59,31,16,1
23703,206,85,121,31,42,6,17,288,118,170,50,57,18,15,1
23704,101,45,56,17,17,12,9,1005,439,566,159,165,70,43,1
23705,150,81,69,24,23,16,4,769,329,440,116,66,55,22,1
23706,354,169,185,54,54,41,19,400,228,172,43,20,47,24,1
23707,1231,603,628,121,162,109,120,1712,1175,537,179,142,113,46,1
23708,665,304,361,90,72,63,28,424,209,215,56,58,45,24,1
23709,736,367,369,107,97,46,24,466,186,280,71,84,30,11,1
23710,360,192,168,55,45,48,16,314,178,136,42,32,30,17,1
23711,1970,978,992,245,206,198,80,777,345,432,128,88,65,39,1
23712,736,388,348,88,85,67,28,298,140,158,51,33,21,22,1
23713,624,204,420,166,101,32,13,272,94,178,76,33,19,4,1
23714,848,461,387,111,102,108,42,1216,552,664,194,189,110,49,1
23715,716,354,362,102,87,77,30,770,385,385,78,83,60,16,1
23716,1566,743,823,261,188,151,48,2229,1036,1193,337,286,161,62,1
23717,870,433,437,133,121,95,25,977,406,571,151,128,84,47,1
23718,326,153,173,63,48,25,8,292,163,129,50,27,46,16,1
23719,1273,592,681,199,164,139,39,221,80,141,48,37,14,10,1
23720,386,181,205,55,51,57,31,554,215,339,102,65,85,42,1
23721,326,161,165,55,43,21,12,480,232,248,83,64,51,25,1
23722,1473,758,715,205,171,161,65,953,489,464,126,104,111,44,1
23723,2202,1121,1081,338,274,269,81,581,254,327,100,83,54,20,1
23724,715,324,391,107,92,71,31,128,54,74,30,13,8,7,1
23725,346,183,163,51,38,23,6,683,341,342,107,77,93,43,1
23726,559,296,263,77,69,42,13,191,99,92,25,24,18,8,1
23727,817,425,392,120,102,83,26,1233,721,512,148,98,144,52,1
23728,447,222,225,71,54,44,25,892,420,472,135,146,98,37,1
23729,296,147,149,45,29,30,23,254,146,108,28,35,33,8,1
23730,346,208,138,46,39,51,18,98,48,50,18,4,9,8,1
23731,349,152,197,55,47,27,13,391,208,183,65,49,57,17,1
23732,1791,870,921,217,230,203,112,1270,557,713,130,195,57,30,1
23733,328,148,180,44,45,40,14,253,127,126,31,25,21,21,1
23734,162,93,69,24,19,17,7,601,313,288,42,48,25,36,1
23735,213,84,129,38,27,19,9,181,96,85,25,23,20,7,1
23736,977,406,571,151,128,84,47,2161,1233,928,269,199,178,42,1
23737,268,113,155,34,37,14,9,640,270,370,111,79,57,17,1
23738,770,356,414,123,102,66,25,782,347,435,110,92,74,34,1
23739,374,181,193,55,58,48,23,794,402,392,96,84,86,30,1
23740,229,120,109,31,30,22,9,782,382,400,124,131,35,16,1
23741,95,44,51,14,13,7,4,770,374,396,95,91,79,41,1
23742,400,208,192,62,44,42,21,725,339,386,112,122,93,32,1
23743,465,229,236,68,62,40,22,304,127,177,61,38,31,4,1
23744,842,452,390,101,85,91,33,834,465,369,82,84,81,21,1
23745,414,194,220,76,66,49,16,108,59,49,17,13,12,5,1
23746,659,325,334,102,85,87,32,406,195,211,71,58,53,14,1
23747,686,345,341,98,106,75,25,903,433,470,122,127,48,30,1
23748,233,138,95,27,29,5,6,433,221,212,59,42,47,14,1
23749,1391,729,662,159,151,135,64,698,325,373,112,95,69,33,1
23750,355,168,187,48,57,30,15,572,312,260,80,65,55,25,1
23751,860,457,403,118,103,103,36,592,264,328,86,85,62,41,1
23752,471,246,225,46,38,52,30,354,169,185,54,54,41,19,1
23753,841,370,471,103,123,61,56,687,351,336,106,67,70,41,1
23754,1663,835,828,224,213,163,63,4544,2024,2520,579,628,480,403,1
23755,360,192,168,55,45,48,16,382,200,182,53,36,51,16,1
23756,501,240,261,80,62,49,42,491,234,257,55,56,36,21,1
23757,189,90,99,26,29,17,11,596,286,310,90,89,78,37,1
23758,1657,800,857,249,235,154,51,351,184,167,59,45,54,9,1
23759,1194,543,651,190,197,65,43,1005,439,566,159,165,70,43,1
23760,1006,468,538,151,135,82,39,605,295,310,74,66,70,36,1
23761,427,210,217,49,59,36,31,329,159,170,46,51,34,15,1
23762,1273,592,681,199,164,139,39,337,171,166,46,27,33,16,1
23763,331,169,162,40,28,22,14,728,358,370,118,100,55,29,1
23764,2363,875,1488,361,444,95,53,1475,658,817,149,114,120,43,1
23765,136,66,70,33,11,9,5,185,70,115,37,48,15,5,1
23766,1336,633,703,182,197,110,52,462,232,230,78,54,42,23,1
23767,219,100,119,32,43,9,10,212,100,112,34,31,20,10,1
23768,487,223,264,81,68,63,15,4303,2489,1814,436,369,444,134,1
23769,585,299,286,92,73,89,23,333,160,173,45,53,37,18,1
23770,344,160,184,52,45,44,19,1124,535,589,182,127,131,45,1
23771,287,159,128,19,26,25,10,260,150,110,20,22,42,22,1
23772,1130,614,516,129,138,98,42,207,93,114,20,33,19,10,1
23773,215,80,135,54,56,21,9,839,427,412,91,83,114,37,1
23774,345,208,137,44,27,33,8,1038,470,568,130,123,86,51,1
23775,1080,601,479,144,100,124,70,676,333,343,111,89,94,39,1
23776,316,157,159,45,38,22,19,249,114,135,47,33,25,4,1
23777,256,148,108,31,16,29,12,425,244,181,38,26,60,26,1
23778,641,324,317,88,92,49,14,359,185,174,42,48,22,26,1
23779,213,91,122,42,30,23,12,720,357,363,113,85,62,39,1
23780,525,274,251,82,74,60,25,611,229,382,121,126,46,5,1
23781,205,99,106,24,29,20,5,211,109,102,33,27,24,11,1
23782,1970,978,992,245,206,198,80,431,202,229,57,50,50,25,1
23783,248,119,129,33,48,20,10,611,229,382,121,126,46,5,1
23784,591,279,312,88,91,52,26,351,183,168,55,44,33,9,1
23785,180,103,77,22,19,29,8,605,295,310,74,66,70,36,1
23786,1432,652,780,217,205,131,81,381,188,193,59,60,35,12,1
23787,277,124,153,44,40,35,18,770,355,415,103,142,75,42,1
23788,2442,1193,1249,278,183,170,145,752,313,439,121,106,68,27,1
23789,95,44,51,14,13,7,4,335,185,150,46,34,36,13,1
23790,163,70,93,28,21,17,6,435,208,227,68,64,53,23,1
23791,873,366,507,127,125,75,21,777,345,432,128,88,65,39,1
23792,504,273,231,72,51,52,25,350,168,182,61,47,39,10,1
23793,360,192,168,55,45,48,16,1242,613,629,174,113,114,53,1
23794,684,288,396,107,90,54,42,937,445,492,143,127,92,35,1
23795,333,171,162,41,44,48,23,507,314,193,49,45,59,25,1
23796,469,247,222,70,58,82,13,109,50,59,20,7,10,9,1
23797,226,135,91,23,22,28,10,186,91,95,30,22,18,7,1
23798,213,86,127,37,33,5,16,234,127,107,33,35,23,15,1
23799,360,192,168,55,45,48,16,467,226,241,55,48,54,23,1
23800,990,410,580,140,175,44,36,984,516,468,78,45,73,12,1
23801,4684,2161,2523,779,782,304,101,586,240,346,94,110,29,19,1
23802,128,52,76,27,25,11,8,202,102,100,29,35,6,9,1
23803,546,267,279,90,69,56,19,557,211,346,129,125,48,19,1
23804,1647,794,853,279,235,128,65,375,202,173,46,49,41,23,1
23805,872,468,404,129,85,92,34,149,68,81,15,38,11,10,1
23806,920,492,428,100,92,88,49,536,278,258,72,63,62,20,1
23807,2414,1189,1225,277,178,170,169,787,386,401,98,95,86,25,1
23808,510,264,246,67,66,38,29,466,186,280,71,84,30,11,1
23809,288,159,129,27,44,27,15,167,70,97,23,14,23,7,1
23810,205,94,111,29,31,16,7,264,127,137,35,34,18,10,1
23811,2261,1217,1044,271,243,267,101,538,286,252,80,58,48,14,1
23812,297,158,139,47,37,37,9,443,248,195,67,54,40,15,1
23813,349,166,183,58,32,38,33,760,391,369,101,109,65,24,1
23814,746,361,385,91,92,101,32,267,129,138,45,40,23,14,1
23815,239,146,93,30,22,35,9,360,188,172,49,48,47,17,1
23816,1158,481,677,169,129,86,40,894,420,474,136,146,93,39,1
23817,374,187,187,51,52,40,27,283,172,111,39,31,29,8,1
23818,632,285,347,102,78,43,29,451,222,229,58,55,51,17,1
23819,2556,1169,1387,248,291,227,275,399,201,198,65,45,48,17,1
23820,369,237,132,33,16,38,18,216,102,114,31,29,21,6,1
23821,551,237,314,95,79,54,17,641,324,317,88,92,49,14,1
23822,400,191,209,51,60,30,9,220,106,114,32,26,15,7,1
23823,119,67,52,15,15,7,7,654,344,310,80,69,57,15,1
23824,256,105,151,61,39,28,11,393,223,170,60,35,50,14,1
23825,400,195,205,63,67,40,18,574,277,297,88,77,58,36,1
23826,255,130,125,44,18,22,12,1663,835,828,224,213,163,63,1
23827,708,384,324,97,86,87,30,324,174,150,37,24,35,27,1
23828,95,41,54,15,16,8,5,885,339,546,159,135,81,49,1
23829,329,168,161,48,34,41,16,303,141,162,42,57,37,20,1
23830,1313,644,669,169,90,111,43,352,166,186,55,59,31,16,1
23831,559,274,285,75,63,52,16,298,167,131,47,33,40,8,1
23832,695,373,322,80,59,89,39,128,54,74,30,13,8,7,1
23833,216,120,96,21,24,31,13,198,113,85,19,20,26,12,1
23834,520,224,296,69,64,31,29,360,192,168,55,45,48,16,1
23835,422,198,224,52,52,42,43,327,177,150,40,40,38,18,1
23836,502,240,262,78,61,54,32,527,263,264,75,71,41,15,1
23837,609,318,291,80,72,55,36,1117,423,694,182,134,88,31,1
23838,511,202,309,70,84,37,21,483,276,207,54,49,47,13,1
23839,489,242,247,83,63,62,19,345,203,142,47,35,31,11,1
23840,277,124,153,44,40,35,18,999,504,495,95,119,78,42,1
23841,501,240,261,80,62,49,42,673,313,360,101,101,46,17,1
23842,967,463,504,133,114,99,62,412,195,217,79,48,36,29,1
23843,339,140,199,46,67,19,8,375,202,173,46,49,41,23,1
23844,1270,682,588,165,147,136,54,261,130,131,27,41,19,16,1
23845,207,109,98,31,16,21,10,298,184,114,45,22,45,12,1
23846,253,148,105,31,15,39,16,317,156,161,49,51,18,10,1
23847,423,218,205,64,55,54,15,223,132,91,18,16,27,17,1
23848,613,333,280,71,66,47,26,2491,1175,1316,303,302,273,147,1
23849,127,55,72,25,18,5,7,181,75,106,35,26,11,9,1
23850,485,242,243,42,81,32,10,117,60,57,20,17,16,5,1
23851,656,358,298,67,47,64,26,464,255,209,69,54,48,21,1
23852,851,417,434,109,116,83,28,847,452,395,100,94,81,36,1
23853,301,133,168,41,60,26,18,689,343,346,119,100,86,38,1
23854,919,376,543,129,122,55,30,143,79,64,16,25,7,5,1
23855,687,353,334,84,96,74,31,825,363,462,97,105,72,75,1
23856,454,224,230,71,39,62,22,334,96,238,104,49,19,2,1
23857,784,284,500,114,177,34,25,1269,624,645,183,180,136,52,1
23858,360,188,172,49,48,47,17,2639,1436,1203,317,307,242,77,1
23859,908,324,584,180,162,81,29,276,143,133,34,38,20,15,1
23860,123,69,54,12,10,7,2,675,305,370,114,109,60,21,1
23861,2016,1107,909,214,229,238,111,540,306,234,74,52,43,22,1
23862,793,240,553,196,206,28,13,149,68,81,15,38,11,10,1
23863,746,361,385,91,92,101,32,427,186,241,55,52,42,23,1
23864,794,322,472,122,108,79,34,770,374,396,95,91,79,41,1
23865,245,122,123,21,32,18,13,667,312,355,100,134,47,20,1
23866,635,333,302,99,75,83,28,267,130,137,31,18,19,13,1
23867,298,138,160,50,37,22,6,246,113,133,33,45,22,10,1
23868,1052,574,478,139,101,128,39,592,283,309,84,137,60,20,1
23869,1901,796,1105,253,274,183,76,323,169,154,47,44,39,20,1
23870,477,281,196,38,41,63,29,190,94,96,24,33,24,6,1
23871,201,102,99,25,26,19,7,447,232,215,55,65,50,25,1
23872,325,181,144,46,31,48,9,371,237,134,31,25,43,17,1
23873,895,479,416,96,119,92,56,619,290,329,97,79,62,19,1
23874,165,77,88,28,27,19,10,1071,549,522,133,127,130,59,1
23875,198,80,118,35,31,14,7,501,240,261,80,62,49,42,1
23876,1336,633,703,182,197,110,52,537,272,265,75,83,41,29,1
23877,547,245,302,77,45,32,20,233,120,113,38,32,20,15,1
23878,219,104,115,43,32,24,11,1834,823,1011,297,282,151,63,1
23879,568,243,325,98,73,56,44,435,233,202,43,42,39,32,1
23880,443,208,235,43,55,51,50,270,136,134,38,31,31,4,1
23881,184,114,70,28,19,22,2,299,164,135,30,21,29,10,1
23882,845,402,443,137,126,105,47,193,99,94,31,31,16,12,1
23883,1972,846,1126,222,330,114,68,103,56,47,27,7,8,2,1
23884,470,256,214,56,39,47,34,423,247,176,58,55,29,20,1
23885,635,333,302,99,75,83,28,561,292,269,88,68,64,22,1
23886,613,352,261,77,47,83,31,362,233,129,37,17,51,18,1
23887,1675,875,800,213,219,196,72,437,212,225,66,44,44,11,1
23888,248,119,129,33,48,20,10,808,419,389,109,87,86,32,1
23889,188,97,91,27,16,24,21,769,329,440,116,66,55,22,1
23890,550,319,231,49,65,35,16,982,545,437,119,100,92,40,1
23891,431,218,213,57,49,55,18,341,162,179,54,49,41,12,1
23892,2843,1104,1739,429,357,178,95,1657,800,857,249,235,154,51,1
23893,1210,578,632,172,184,94,66,136,65,71,33,11,9,6,1
23894,456,228,228,49,70,32,19,564,283,281,71,64,40,13,1
23895,401,204,197,49,33,29,17,440,246,194,62,49,41,16,1
23896,169,64,105,23,37,11,3,351,166,185,48,61,24,15,1
23897,330,143,187,63,29,52,20,958,492,466,119,104,119,35,1
23898,360,201,159,38,38,34,13,656,358,298,67,47,64,26,1
23899,518,251,267,74,49,71,27,324,190,134,41,27,28,9,1
23900,347,192,155,50,33,28,19,622,328,294,75,42,67,31,1
23901,95,44,51,14,13,7,4,679,338,341,96,95,40,23,1
23902,2090,1085,1005,167,141,168,40,552,285,267,74,51,69,24,1
23903,336,154,182,51,48,39,22,191,99,92,25,24,18,8,1
23904,340,181,159,44,39,35,21,185,115,70,19,17,26,6,1
23905,763,343,420,127,70,105,34,520,236,284,115,52,45,16,1
23906,427,226,201,63,44,66,13,262,138,124,25,34,34,16,1
23907,4432,2202,2230,635,547,518,176,395,222,173,48,42,21,8,1
23908,249,90,159,29,89,12,4,2468,1038,1430,333,465,167,62,1
23909,2041,1035,1006,223,274,125,60,458,265,193,55,35,49,27,1
23910,784,404,380,127,97,78,27,676,333,343,111,89,94,39,1
23911,272,135,137,34,30,31,8,580,339,241,72,47,66,21,1
23912,1074,538,536,154,140,111,51,1447,751,696,161,143,131,46,1
23913,123,69,54,12,10,7,2,346,183,163,51,38,23,6,1
23914,425,210,215,56,43,52,25,227,128,99,20,37,20,10,1
23915,512,248,264,66,71,49,30,597,246,351,95,98,45,25,1
23916,184,88,96,24,25,14,9,1095,530,565,157,151,98,34,1
23917,239,146,93,30,22,35,9,605,295,310,74,66,70,36,1
23918,1609,694,915,204,241,132,122,1247,620,627,134,149,142,58,1
23919,875,376,499,155,125,53,39,164,78,86,28,23,12,8,1
23920,429,227,202,49,51,46,26,1590,726,864,270,237,126,59,1
23921,701,392,309,98,75,104,30,590,303,287,69,65,46,17,1
23922,601,313,288,42,48,25,36,420,205,215,60,44,52,21,1
23923,390,191,199,66,49,43,12,550,243,307,91,99,70,10,1
23924,536,237,299,116,87,42,17,728,358,370,118,100,55,29,1
23925,271,120,151,41,31,24,10,295,145,150,41,45,36,18,1
23926,603,291,312,98,87,61,28,1020,410,610,220,221,32,13,1
23927,168,72,96,30,17,16,11,396,192,204,71,41,51,15,1
23928,670,309,361,120,78,60,24,715,355,360,118,79,71,29,1
23929,280,156,124,36,19,20,13,155,85,70,17,16,4,8,1
23930,1134,574,560,157,164,47,48,476,270,206,62,45,46,30,1
23931,504,245,259,64,54,42,14,744,354,390,98,82,70,28,1
23932,7968,4016,3952,1072,1051,652,307,149,68,81,15,38,11,10,1
23933,533,254,279,81,78,52,10,377,184,193,56,53,44,14,1
23934,432,228,204,59,53,43,15,171,85,86,23,16,20,10,1
23935,352,166,186,55,59,31,16,593,295,298,70,85,48,13,1
23936,280,142,138,35,37,22,13,248,118,130,54,31,26,5,1
23937,1477,738,739,176,176,145,72,837,399,438,112,144,71,32,1
23938,419,175,244,71,73,23,23,641,324,317,88,92,49,14,1
23939,341,178,163,48,44,42,20,143,81,62,28,9,8,1,1
23940,502,240,262,78,61,54,32,426,228,198,62,42,47,22,1
23941,336,221,115,22,17,40,16,114,66,48,13,7,3,7,1
23942,703,308,395,81,91,66,80,552,285,267,74,51,69,24,1
23943,662,297,365,92,88,44,29,963,385,578,171,162,62,35,1
23944,186,84,102,27,29,21,10,509,262,247,64,70,64,20,1
23945,783,429,354,100,77,54,25,204,99,105,32,32,22,10,1
23946,415,203,212,77,44,49,18,1255,586,669,167,149,113,59,1
23947,178,100,78,23,22,30,6,435,208,227,68,64,53,23,1
23948,656,358,298,67,47,64,26,253,151,102,23,23,33,18,1
23949,226,129,97,20,25,26,11,556,300,256,58,73,55,22,1
23950,119,57,62,18,16,17,4,235,135,100,30,13,25,11,1
23951,355,220,135,43,26,65,20,98,46,52,16,6,2,9,1
23952,336,192,144,30,36,40,14,870,418,452,121,102,109,28,1
23953,462,233,229,66,49,43,30,468,233,235,65,61,49,34,1
23954,205,91,114,31,36,13,8,1124,441,683,148,189,72,43,1
23955,246,115,131,15,29,10,32,538,199,339,116,59,90,41,1
23956,562,273,289,76,92,45,24,449,255,194,56,40,46,21,1
23957,160,68,92,28,20,14,6,1177,666,511,131,99,88,35,1
23958,985,445,540,164,146,68,36,193,99,94,31,31,16,12,1
23959,425,210,215,56,43,52,25,413,206,207,38,55,19,10,1
23960,440,246,194,62,49,41,16,407,207,200,53,36,38,8,1
23961,96,50,46,8,15,6,2,102,49,53,14,21,7,4,1
23962,474,224,250,50,72,51,43,614,263,351,85,84,54,35,1
23963,1132,549,583,164,145,88,43,1374,679,695,191,193,154,48,1
23964,255,157,98,26,22,28,11,418,220,198,69,51,44,16,1
23965,560,228,332,113,58,79,38,202,102,100,29,35,6,9,1
23966,136,66,70,33,11,9,3,422,228,194,26,20,48,37,1
23967,1205,632,573,156,149,102,48,344,168,176,65,44,33,15,1
23968,537,288,249,60,60,61,19,1292,633,659,171,202,109,47,1
23969,1270,682,588,165,147,136,54,294,148,146,35,33,25,14,1
23970,462,251,211,74,53,41,18,166,78,88,27,25,19,7,1
23971,376,176,200,31,53,27,8,517,196,321,103,98,34,12,1
23972,352,212,140,37,17,61,20,458,222,236,69,39,35,18,1
23973,1474,808,666,160,146,166,60,1134,535,599,165,148,93,36,1
23974,470,289,181,58,47,45,25,537,276,261,75,68,68,22,1
23975,520,261,259,82,76,71,24,1807,933,874,248,203,173,71,1
23976,289,139,150,38,44,23,20,303,175,128,43,36,34,12,1
23977,1023,449,574,140,174,76,43,595,316,279,86,60,65,40,1
23978,206,94,112,37,36,18,9,667,360,307,76,92,46,27,1
23979,1054,453,601,183,183,107,35,207,93,114,20,33,19,10,1
23980,313,178,135,43,18,35,6,2442,1193,1249,278,183,170,145,1
23981,437,225,212,61,57,66,12,1123,554,569,142,130,85,36,1
23982,672,334,338,110,93,91,41,228,139,89,24,21,32,18,1
23983,357,169,188,61,53,32,15,97,50,47,17,14,14,10,1
23984,309,137,172,51,50,28,14,367,161,206,70,48,41,19,1
23985,154,75,79,17,24,16,13,532,226,306,102,55,69,29,1
23986,335,155,180,64,48,36,10,318,164,154,52,43,34,10,1
23987,646,316,330,89,95,48,17,202,123,79,12,15,26,21,1
23988,881,419,462,132,82,81,24,901,423,478,106,117,83,38,1
23989,1336,828,508,166,121,152,48,740,385,355,114,97,91,27,1
23990,986,561,425,121,106,80,34,1013,457,556,124,157,81,26,1
23991,249,90,159,29,89,12,4,1304,585,719,179,169,154,47,1
23992,435,208,227,68,64,53,23,262,144,118,19,39,22,8,1
23993,345,176,169,34,31,36,11,552,285,267,74,51,69,24,1
23994,342,150,192,52,43,31,17,824,392,432,106,89,88,32,1
23995,181,75,106,35,26,11,9,464,197,267,87,73,43,20,1
23996,480,234,246,79,77,65,23,584,307,277,54,63,53,10,1
23997,354,168,186,50,53,39,20,181,71,110,34,30,21,7,1
23998,72,35,37,10,9,7,6,709,359,350,107,102,65,20,1
23999,290,149,141,37,26,41,12,300,136,164,44,35,33,21,1
24000,237,127,110,34,30,16,9,299,164,135,30,21,29,10,1
24001,445,225,220,47,62,53,26,3144,1617,1527,367,342,278,136,1
24002,770,390,380,104,76,78,32,333,127,206,66,68,25,14,1
24003,152,79,73,18,13,11,6,897,487,410,92,97,83,31,1
24004,498,244,254,81,67,58,19,277,124,153,44,40,35,18,1
24005,391,208,183,65,49,57,17,2224,1037,1187,288,276,273,74,1
24006,201,108,93,36,21,17,4,240,125,115,34,32,30,8,1
24007,340,158,182,51,56,9,7,592,291,301,92,93,71,31,1
24008,272,173,99,32,32,11,8,423,247,176,58,55,29,20,1
24009,792,407,385,110,132,82,43,954,521,433,135,118,78,26,1
24010,391,208,183,65,49,57,17,452,224,228,69,56,50,31,1
24011,735,357,378,88,83,95,59,228,139,89,24,21,32,18,1
24012,512,261,251,79,73,60,21,750,371,379,95,98,86,29,1
24013,724,320,404,120,147,67,25,595,316,279,86,60,65,40,1
24014,792,407,385,110,132,82,43,536,278,258,72,63,62,20,1
24015,730,328,402,126,99,48,23,592,291,301,92,93,71,31,1
24016,375,202,173,46,49,41,23,165,85,80,29,25,16,13,1
24017,1077,501,576,138,159,111,48,1972,846,1126,222,330,114,68,1
24018,3911,1465,2446,610,767,240,133,838,386,452,108,132,45,29,1
24019,425,199,226,54,71,56,11,425,198,227,57,69,59,13,1
24020,490,224,266,80,70,39,32,882,432,450,115,111,68,44,1
24021,369,181,188,41,36,54,16,532,276,256,57,50,32,19,1
24022,202,99,103,24,25,19,12,810,367,443,115,92,94,59,1
24023,264,121,143,57,32,22,15,153,71,82,28,20,15,7,1
24024,551,298,253,63,65,45,19,770,374,396,95,91,79,41,1
24025,330,143,187,63,29,52,20,480,244,236,74,47,50,21,1
24026,671,364,307,75,71,58,22,838,431,407,107,90,107,43,1
24027,219,133,86,18,12,32,18,153,65,88,27,14,18,9,1
24028,272,173,99,32,32,11,8,133,66,67,21,24,9,2,1
24029,126,68,58,16,8,20,11,621,310,311,100,106,77,27,1
24030,259,151,108,39,18,23,11,299,140,159,27,59,20,18,1
24031,1712,926,786,199,198,156,71,1801,889,912,206,263,126,42,1
24032,815,418,397,97,62,70,17,2004,839,1165,291,300,148,108,1
24033,246,128,118,39,34,22,7,404,190,214,55,55,35,27,1
24034,270,130,140,43,24,36,10,655,328,327,65,54,55,35,1
24035,2339,1260,1079,336,252,279,106,340,162,178,40,39,35,22,1
24036,295,95,200,70,89,17,6,284,109,175,55,79,9,9,1
24037,1263,616,647,185,180,140,56,3685,1574,2111,579,580,303,116,1
24038,451,222,229,58,55,51,17,724,334,390,112,109,79,17,1
24039,676,333,343,111,89,94,39,1216,552,664,194,189,110,49,1
24040,620,335,285,70,41,62,33,537,276,261,75,68,68,22,1
24041,246,115,131,15,29,10,32,740,392,348,75,58,60,28,1
24042,134,55,79,22,24,16,6,230,129,101,29,23,27,10,1
24043,500,242,258,53,48,44,18,622,299,323,86,86,69,35,1
24044,2157,1033,1124,365,281,199,63,149,68,81,15,38,11,10,1
24045,377,171,206,46,59,22,6,873,366,507,127,125,75,21,1
24046,360,192,168,55,45,48,16,441,216,225,57,66,57,19,1
24047,240,125,115,34,32,30,8,332,206,126,36,30,30,12,1
24048,756,348,408,101,103,60,40,501,240,261,80,62,49,42,1
24049,1037,537,500,134,118,107,63,205,101,104,34,25,34,8,1
24050,832,428,404,131,89,88,38,2556,1169,1387,248,291,227,275,1
24051,1038,422,616,183,175,75,32,193,99,94,31,31,16,12,1
24052,149,68,81,15,38,11,10,440,250,190,51,35,64,27,1
24053,591,279,312,88,91,52,26,621,273,348,104,102,48,19,1
24054,283,141,142,32,26,23,26,501,240,261,80,62,49,42,1
24055,163,70,93,28,21,17,6,775,443,332,109,86,86,20,1
24056,458,210,248,39,38,25,16,454,191,263,61,66,38,15,1
24057,310,161,149,34,31,35,12,223,127,96,25,23,33,4,1
24058,940,464,476,116,135,108,58,623,269,354,100,86,62,24,1
24059,692,305,387,100,97,78,30,4128,2104,2024,581,505,453,205,1
24060,957,385,572,173,168,62,33,136,72,64,22,16,7,3,1
24061,227,109,118,42,35,29,8,385,179,206,58,56,38,19,1
24062,964,408,556,131,153,76,55,557,240,317,97,74,68,37,1
24063,354,128,226,63,61,27,7,651,307,344,74,130,45,18,1
24064,134,60,74,19,13,10,7,654,344,310,80,69,57,15,1
24065,1043,479,564,200,131,123,62,215,80,135,54,56,21,9,1
24066,560,279,281,113,64,58,15,280,114,166,56,28,48,35,1
24067,124,69,55,15,13,12,2,360,192,168,55,45,48,16,1
24068,551,237,314,95,79,54,17,581,274,307,75,69,28,24,1
24069,723,335,388,90,84,77,74,2471,1130,1341,240,281,219,290,1
24070,1327,690,637,194,140,130,52,1025,527,498,120,122,142,40,1
24071,443,240,203,66,31,57,27,412,260,152,39,24,49,23,1
24072,2718,1148,1570,384,286,195,88,342,160,182,69,40,37,16,1
24073,1101,626,475,145,122,120,50,433,221,212,59,42,47,14,1
24074,673,318,355,61,71,40,31,467,226,241,55,48,54,23,1
24075,4432,2202,2230,635,547,518,176,126,55,71,14,17,12,16,1
24076,360,192,168,55,45,48,16,393,186,207,58,50,36,22,1
24077,4655,2074,2581,545,652,562,399,834,483,351,102,83,103,22,1
24078,723,380,343,80,84,47,18,1314,648,666,135,166,103,52,1
24079,465,230,235,68,64,48,24,360,192,168,55,45,48,16,1
24080,570,292,278,80,65,72,23,271,126,145,33,38,31,10,1
24081,1069,494,575,133,111,110,39,1972,846,1126,222,330,114,68,1
24082,1461,741,720,176,155,140,45,604,272,332,112,62,67,51,1
24083,456,209,247,72,58,40,9,1265,580,685,205,188,166,53,1
24084,785,374,411,56,42,38,25,1068,527,541,160,131,112,52,1
24085,246,115,131,15,29,10,32,686,337,349,96,116,45,19,1
24086,1114,581,533,145,132,126,54,404,197,207,57,69,33,15,1
24087,393,186,207,58,50,36,22,598,322,276,67,57,63,26,1
24088,1084,537,547,154,121,92,35,313,155,158,33,39,28,16,1
24089,607,317,290,87,80,73,10,410,222,188,54,49,43,13,1
24090,1562,742,820,219,231,104,46,564,350,214,56,42,50,29,1
24091,391,208,183,65,49,57,17,1103,536,567,171,156,81,43,1
24092,674,319,355,84,139,50,11,315,150,165,49,59,23,15,1
24093,603,291,312,98,87,61,28,288,118,170,50,57,18,15,1
24094,339,170,169,32,17,24,13,380,187,193,38,51,30,18,1
24095,366,191,175,37,33,19,19,930,367,563,181,153,83,48,1
24096,546,267,279,90,69,56,19,926,437,489,135,107,113,42,1
24097,847,402,445,109,91,100,37,556,300,256,58,73,55,22,1
24098,314,158,156,41,57,30,12,191,99,92,25,24,18,8,1
24099,750,347,403,105,103,83,29,208,96,112,31,32,13,9,1
24100,464,242,222,61,68,36,17,345,203,142,47,35,31,11,1
24101,292,108,184,47,64,19,15,1037,575,462,122,150,82,32,1
24102,536,237,299,116,87,42,17,467,226,241,55,48,54,23,1
24103,352,166,186,55,59,31,16,299,128,171,57,40,13,25,1
24104,445,212,233,60,47,46,31,283,142,141,41,33,26,18,1
24105,360,192,168,55,45,48,16,413,236,177,41,25,35,19,1
24106,376,183,193,50,50,43,21,140,86,54,17,6,20,7,1
24107,540,269,271,51,70,43,26,97,39,58,12,14,9,7,1
24108,903,437,466,117,112,108,32,2556,1169,1387,248,291,227,275,1
24109,443,210,233,87,49,70,18,699,376,323,79,53,86,41,1
24110,350,224,126,34,14,48,18,2639,1436,1203,317,307,242,77,1
24111,990,410,580,140,175,44,36,560,228,332,113,58,79,38,1
24112,253,143,110,38,26,20,12,259,143,116,39,37,23,9,1
24113,408,179,229,86,72,32,5,640,308,332,91,102,49,21,1
24114,270,147,123,34,17,39,21,2442,1193,1249,278,183,170,145,1
24115,672,334,338,110,93,91,41,509,262,247,64,70,64,20,1
24116,480,234,246,79,77,65,23,724,334,390,112,109,79,17,1
24117,853,355,498,122,156,91,29,2442,1193,1249,278,183,170,145,1
24118,1332,637,695,214,178,117,40,1192,545,647,161,116,105,34,1
24119,113,68,45,18,11,6,2,328,210,118,29,18,38,15,1
24120,462,291,171,57,25,53,17,305,166,139,42,38,28,12,1
24121,374,191,183,70,48,61,13,596,286,310,90,89,78,37,1
24122,578,294,284,60,66,63,17,178,85,93,27,21,19,14,1
24123,776,356,420,122,103,85,30,500,268,232,65,56,28,17,1
24124,303,159,144,40,35,35,8,503,298,205,62,28,20,4,1
24125,225,131,94,29,19,29,9,422,227,195,62,36,45,15,1
24126,923,420,503,128,159,100,49,839,427,412,91,83,114,37,1
24127,418,199,219,55,44,22,15,1577,747,830,213,232,147,57,1
24128,770,355,415,103,142,75,42,390,203,187,58,40,43,19,1
24129,425,210,215,56,43,52,25,490,198,292,65,81,39,27,1
24130,590,279,311,103,83,69,30,371,230,141,42,21,41,21,1
24131,906,455,451,116,105,87,46,430,192,238,62,67,27,10,1
24132,412,223,189,55,55,41,10,1114,581,533,145,132,126,54,1
24133,350,220,130,32,18,45,17,375,202,173,46,49,41,23,1
24134,769,329,440,116,66,55,22,159,84,75,13,28,10,8,1
24135,537,276,261,75,68,68,22,329,161,168,40,39,35,14,1
24136,244,160,84,20,22,20,4,205,123,82,22,8,31,5,1
24137,486,217,269,110,62,23,10,1590,726,864,270,237,126,59,1
24138,480,234,246,79,77,65,23,505,244,261,77,65,56,22,1
24139,130,69,61,26,12,14,7,265,117,148,39,36,47,17,1
24140,824,397,427,113,95,82,33,2524,1232,1292,398,317,186,61,1
24141,410,222,188,54,49,43,13,569,288,281,86,69,74,24,1
24142,230,119,111,30,29,26,12,825,363,462,97,105,72,75,1
24143,443,208,235,43,55,51,50,335,177,158,45,49,34,13,1
24144,536,278,258,72,63,62,20,364,182,182,49,30,41,14,1
24145,276,143,133,34,38,20,15,344,168,176,65,44,33,15,1
24146,415,209,206,60,67,39,18,781,418,363,92,90,64,41,1
24147,185,70,115,37,48,15,5,853,400,453,137,109,88,42,1
24148,95,49,46,12,16,9,5,404,231,173,44,43,24,10,1
24149,391,208,183,65,49,57,17,454,191,263,61,66,38,15,1
24150,1357,505,852,245,256,70,35,191,99,92,25,24,18,8,1
24151,758,360,398,114,107,51,19,748,328,420,126,88,57,32,1
24152,926,435,491,133,132,85,17,1308,652,656,166,153,149,87,1
24153,876,473,403,110,106,73,24,254,107,147,42,37,24,10,1
24154,780,414,366,112,89,73,38,1434,727,707,210,173,161,54,1
24155,522,235,287,78,67,60,50,790,352,438,132,87,91,60,1
24156,296,115,181,48,39,32,15,202,102,100,29,35,6,9,1
24157,258,113,145,43,44,16,7,240,134,106,21,17,16,11,1
24158,466,199,267,86,59,32,17,1107,601,506,155,138,104,49,1
24159,335,148,187,52,26,51,12,654,344,310,80,69,57,15,1
24160,667,360,307,76,92,46,27,780,370,410,107,120,75,22,1
24161,406,210,196,68,60,25,20,218,133,85,20,19,13,6,1
24162,1338,506,832,241,229,101,40,247,110,137,34,45,23,10,1
24163,154,75,79,17,24,16,13,260,122,138,47,38,25,9,1
24164,602,310,292,87,66,70,36,926,435,491,133,132,85,17,1
24165,267,161,106,22,25,35,20,556,300,256,58,73,55,22,1
24166,417,238,179,60,56,62,27,406,219,187,44,39,52,20,1
24167,587,260,327,84,69,55,23,512,261,251,79,73,60,21,1
24168,222,110,112,43,30,14,6,165,83,82,16,29,11,9,1
24169,401,167,234,56,71,16,10,378,227,151,57,30,50,20,1
24170,377,171,206,46,59,22,6,373,194,179,42,54,26,13,1
24171,213,127,86,26,20,33,9,1037,537,500,134,118,107,63,1
24172,530,259,271,83,50,54,41,149,68,81,15,38,11,10,1
24173,413,194,219,77,72,28,11,158,85,73,24,18,18,8,1
24174,309,144,165,54,39,25,12,574,273,301,101,74,68,26,1
24175,360,188,172,49,48,47,17,749,374,375,99,108,98,37,1
24176,632,285,347,102,78,43,29,1608,778,830,243,230,159,74,1
24177,998,496,502,149,146,89,27,770,374,396,95,91,79,41,1
24178,703,308,395,81,91,66,80,491,233,258,73,58,56,30,1
24179,388,199,189,50,51,33,14,295,158,137,42,34,38,14,1
24180,593,266,327,102,84,69,24,225,116,109,29,19,25,6,1
24181,1220,590,630,176,160,107,55,1214,573,641,184,152,101,66,1
24182,1349,534,815,216,198,111,41,344,201,143,34,22,46,18,1
24183,341,178,163,48,44,42,20,776,356,420,122,103,85,30,1
24184,1027,512,515,163,148,92,40,930,367,563,181,153,83,48,1
24185,499,252,247,74,42,55,14,432,228,204,59,53,43,15,1
24186,312,155,157,38,34,25,15,318,156,162,42,29,26,17,1
24187,395,195,200,41,55,23,10,454,214,240,56,71,35,16,1
24188,245,112,133,32,45,20,10,308,159,149,52,41,22,10,1
24189,574,295,279,78,65,61,22,745,366,379,110,93,79,45,1
24190,666,344,322,95,69,88,30,1568,754,814,219,181,166,72,1
24191,2639,1436,1203,317,307,242,77,409,200,209,69,56,44,13,1
24192,432,228,204,59,53,43,15,1863,721,1142,262,283,139,74,1
24193,1220,640,580,160,161,101,43,149,68,81,15,38,11,10,1
24194,1434,727,707,210,173,161,54,520,300,220,66,36,57,23,1
24195,424,191,233,76,73,49,13,1332,652,680,210,180,155,49,1
24196,716,354,362,102,87,77,30,568,292,276,69,74,59,34,1
24197,24,14,10,4,2,1,2,860,349,511,166,166,58,19,1
24198,981,465,516,126,164,112,38,1290,597,693,182,182,119,63,1
24199,1086,603,483,147,121,95,40,537,276,261,75,68,68,22,1
24200,445,212,233,60,47,46,31,172,77,95,25,34,19,10,1
24201,536,278,258,72,63,62,20,555,278,277,60,70,48,18,1
24202,425,210,215,56,43,52,25,320,163,157,44,44,26,15,1
24203,862,335,527,136,169,47,28,238,95,143,37,55,4,4,1
24204,3969,1703,2266,619,432,259,144,628,324,304,83,85,75,23,1
24205,242,112,130,39,41,21,13,404,190,214,55,55,35,27,1
24206,963,477,486,134,143,123,38,808,419,389,109,87,86,32,1
24207,751,312,439,131,115,78,48,1382,599,783,208,252,90,39,1
24208,335,185,150,46,34,36,13,195,86,109,31,37,19,5,1
24209,496,244,252,70,63,50,24,292,152,140,46,38,35,12,1
24210,1669,1162,507,154,128,86,51,130,70,60,19,14,19,5,1
24211,541,273,268,67,48,48,30,201,92,109,27,24,16,8,1
24212,673,329,344,111,95,92,41,748,386,362,111,75,71,40,1
24213,1190,638,552,162,95,112,18,611,246,365,116,82,71,27,1
24214,379,203,176,55,48,45,16,1382,689,693,186,176,167,77,1
24215,147,86,61,23,15,22,4,406,209,197,57,50,50,17,1
24216,594,305,289,86,63,51,21,770,355,415,103,142,75,42,1
24217,805,338,467,109,145,49,25,103,51,52,15,17,6,5,1
24218,526,264,262,77,71,61,27,1265,580,685,205,188,166,53,1
24219,393,186,207,58,50,36,22,231,126,105,37,26,29,6,1
24220,204,119,85,28,18,27,8,233,121,112,24,31,30,7,1
24221,559,296,263,77,69,42,13,399,216,183,60,53,43,18,1
24222,168,120,48,7,5,20,7,261,147,114,29,22,22,22,1
24223,928,442,486,139,118,91,43,317,153,164,39,30,35,13,1
24224,541,269,272,75,57,59,36,151,82,69,16,17,11,7,1
24225,168,71,97,29,19,20,10,859,395,464,157,119,59,31,1
24226,595,309,286,63,54,62,25,434,216,218,72,58,40,20,1
24227,242,111,131,35,35,17,13,149,68,81,15,38,11,10,1
24228,791,306,485,142,157,21,18,701,331,370,116,95,59,28,1
24229,224,116,108,28,38,28,7,236,121,115,39,20,44,15,1
24230,990,410,580,140,175,44,36,205,100,105,25,25,20,9,1
24231,591,263,328,95,90,26,13,140,76,64,17,13,13,8,1
24232,902,332,570,154,146,75,40,1863,721,1142,262,283,139,74,1
24233,282,152,130,35,27,13,21,98,46,52,16,6,2,9,1
24234,211,114,97,32,24,19,10,448,236,212,53,64,56,24,1
24235,585,275,310,69,57,69,24,417,231,186,37,32,43,18,1
24236,575,301,274,84,65,63,20,2639,1436,1203,317,307,242,77,1
24237,3333,1606,1727,446,357,333,206,1172,545,627,156,135,85,96,1
24238,244,135,109,36,24,20,10,443,248,195,67,54,40,15,1
24239,672,334,338,110,93,91,41,78,45,33,12,10,2,5,1
24240,1475,658,817,149,114,120,43,529,274,255,57,62,38,14,1
24241,433,221,212,59,42,47,14,1613,806,807,190,211,180,84,1
24242,614,305,309,96,73,65,24,595,316,279,86,60,65,40,1
24243,671,318,353,83,124,46,34,122,52,70,24,22,7,6,1
24244,1149,568,581,177,133,101,30,526,264,262,77,71,61,27,1
24245,669,389,280,96,79,97,22,4544,2024,2520,579,628,480,403,1
24246,496,247,249,82,69,47,14,1132,646,486,99,102,71,41,1
24247,646,316,330,89,95,48,17,345,141,204,64,58,13,11,1
24248,652,329,323,65,70,51,50,1464,987,477,137,141,55,31,1
24249,688,323,365,121,69,55,22,758,362,396,115,102,35,13,1
24250,856,429,427,113,105,96,24,619,290,329,97,79,62,19,1
24251,583,240,343,93,81,52,9,702,298,404,134,111,48,18,1
24252,854,380,474,137,159,81,31,595,316,279,86,60,65,40,1
24253,305,162,143,45,34,38,18,428,248,180,44,39,28,9,1
24254,323,123,200,59,69,30,15,582,293,289,94,80,77,32,1
24255,845,402,443,137,126,105,47,211,114,97,32,24,19,10,1
24256,91,50,41,12,5,10,7,336,221,115,22,17,40,16,1
24257,298,167,131,47,33,40,8,2414,1189,1225,277,178,170,169,1
24258,111,29,82,10,54,0,1,297,158,139,47,37,37,9,1
24259,1084,537,547,154,121,92,35,360,192,168,55,45,48,16,1
24260,431,235,196,57,53,50,18,552,285,267,74,51,69,24,1
24261,478,219,259,82,80,51,18,134,72,62,14,28,8,4,1
24262,841,329,512,137,163,35,26,757,373,384,115,93,95,25,1
24263,522,239,283,75,88,45,11,1210,592,618,157,138,116,85,1
24264,536,237,299,116,87,42,17,757,359,398,109,127,80,26,1
24265,697,373,324,105,83,95,38,1212,645,567,145,117,122,72,1
24266,1068,559,509,158,132,122,57,233,119,114,32,26,24,12,1
24267,272,141,131,45,29,36,9,390,191,199,57,49,45,25,1
24268,837,464,373,104,72,85,49,61,17,44,8,4,0,21,1
24269,1154,540,614,195,160,138,66,1265,580,685,205,188,166,53,1
24270,465,228,237,64,42,63,24,282,163,119,40,23,25,17,1
24271,656,358,298,67,47,64,26,280,139,141,25,39,26,13,1
24272,483,237,246,63,47,25,21,161,75,86,24,20,10,7,1
24273,757,373,384,115,93,95,25,193,99,94,31,31,16,12,1
24274,1009,506,503,146,141,97,55,845,402,443,137,126,105,47,1
24275,720,357,363,113,85,62,39,862,427,435,139,98,100,59,1
24276,1004,498,506,94,59,46,33,336,140,196,51,44,27,18,1
24277,367,217,150,51,30,24,12,892,420,472,135,146,98,37,1
24278,870,489,381,97,99,76,14,605,295,310,74,66,70,36,1
24279,366,211,155,35,42,24,12,351,143,208,44,68,23,18,1
24280,904,436,468,138,146,82,39,395,186,209,53,48,46,30,1
24281,209,96,113,35,28,22,13,1073,547,526,60,60,47,19,1
24282,758,362,396,115,102,35,13,467,269,198,46,51,60,18,1
24283,536,278,258,72,63,62,20,784,391,393,105,113,86,21,1
24284,287,137,150,36,37,25,7,450,241,209,67,58,54,23,1
24285,328,182,146,38,43,29,10,706,300,406,94,74,61,22,1
24286,707,386,321,85,83,99,28,1670,1140,530,173,120,89,53,1
24287,817,397,420,120,152,48,17,480,196,284,72,74,25,2,1
24288,240,125,115,34,32,30,8,140,74,66,15,14,14,10,1
24289,491,270,221,51,47,53,18,866,382,484,116,114,91,28,1
24290,2644,1346,1298,391,304,315,148,1356,672,684,171,172,134,59,1
24291,501,240,261,80,62,49,42,323,181,142,40,37,26,16,1
24292,161,90,71,20,15,17,5,184,78,106,21,25,25,12,1
24293,437,225,212,61,57,66,12,831,402,429,136,121,96,33,1
24294,1164,622,542,150,143,78,35,1025,527,498,120,122,142,40,1
24295,467,226,241,55,48,54,23,728,358,370,118,100,55,29,1
24296,307,162,145,38,46,41,15,602,299,303,98,81,72,21,1
24297,180,103,77,22,19,29,8,1480,789,691,195,151,173,55,1
24298,521,263,258,55,70,41,16,687,353,334,84,96,74,31,1
24299,546,267,279,90,69,56,19,1893,764,1129,308,323,126,60,1
24300,1308,652,656,166,153,149,87,178,86,92,30,21,12,17,1
24301,516,193,323,132,42,99,36,467,224,243,70,43,67,23,1
24302,369,167,202,66,59,39,20,361,174,187,63,56,38,16,1
24303,1487,996,491,147,141,50,35,396,192,204,71,41,51,15,1
24304,333,189,144,42,33,23,10,346,190,156,46,44,12,12,1
24305,639,322,317,73,82,39,23,936,396,540,96,166,77,29,1
24306,264,126,138,44,26,25,10,131,66,65,21,14,23,7,1
24307,785,374,411,56,42,38,25,347,181,166,27,20,12,12,1
24308,469,221,248,49,60,55,21,2442,1193,1249,278,183,170,145,1
24309,686,345,341,98,106,75,25,1030,368,662,172,188,56,20,1
24310,1098,519,579,182,159,79,42,777,345,432,128,88,65,39,1
24311,509,254,255,67,55,52,35,535,249,286,79,64,55,22,1
24312,701,368,333,90,81,39,27,193,99,94,31,31,16,12,1
24313,230,115,115,29,29,22,14,624,308,316,92,72,68,22,1
24314,104,48,56,15,15,13,7,131,66,65,21,14,23,7,1
24315,1283,595,688,170,184,67,34,218,108,110,28,28,22,10,1
24316,397,186,211,73,63,36,25,202,123,79,12,15,26,21,1
24317,806,436,370,101,100,76,34,194,94,100,35,19,25,16,1
24318,1255,708,547,120,68,88,7,781,418,363,92,90,64,41,1
24319,897,487,410,92,97,83,31,673,329,344,111,95,92,41,1
24320,605,295,310,74,66,70,36,1009,506,503,146,141,97,55,1
24321,713,298,415,133,90,63,46,249,140,109,34,26,25,12,1
24322,452,236,216,73,54,50,29,480,234,246,79,77,65,23,1
24323,951,506,445,107,118,79,40,309,106,203,66,49,25,10,1
24324,194,103,91,26,32,13,8,864,362,502,142,150,70,19,1
24325,625,293,332,74,71,50,40,982,545,437,119,100,92,40,1
24326,432,190,242,85,82,28,11,153,71,82,28,20,15,7,1
24327,423,218,205,64,55,54,15,184,78,106,21,25,25,12,1
24328,363,182,181,33,55,23,11,601,313,288,42,48,25,36,1
24329,345,141,204,64,58,13,11,595,316,279,86,60,65,40,1
24330,187,80,107,34,36,19,8,677,245,432,129,155,72,11,1
24331,464,242,222,61,68,36,17,324,154,170,57,40,26,4,1
24332,424,284,140,51,28,47,20,921,534,387,104,95,101,38,1
24333,379,203,176,55,48,45,16,465,229,236,68,62,40,22,1
24334,710,357,353,99,79,72,39,149,68,81,15,38,11,10,1
24335,434,237,197,52,64,37,14,1152,556,596,146,159,31,39,1
24336,500,268,232,65,56,28,17,271,126,145,33,38,31,10,1
24337,555,278,277,60,70,48,18,873,381,492,98,137,76,78,1
24338,330,143,187,63,29,52,20,450,194,256,57,75,45,22,1
24339,635,333,302,99,75,83,28,1290,629,661,191,187,167,55,1
24340,359,173,186,55,57,44,16,689,343,346,119,100,86,38,1
24341,671,318,353,83,124,46,34,304,138,166,53,32,34,13,1
24342,837,444,393,128,89,87,37,2556,1169,1387,248,291,227,275,1
24343,1223,593,630,161,135,142,71,1067,566,501,108,72,106,59,1
24344,205,101,104,34,25,34,8,984,509,475,114,109,106,56,1
24345,312,164,148,45,34,35,15,911,551,360,92,106,107,29,1
24346,715,322,393,105,82,77,51,339,150,189,55,60,34,12,1
24347,3056,1457,1599,438,389,329,168,791,391,400,103,94,59,38,1
24348,637,267,370,94,126,43,27,756,366,390,83,146,47,23,1
24349,204,80,124,29,51,10,5,341,178,163,48,44,42,20,1
24350,285,107,178,49,58,27,17,384,210,174,49,48,49,20,1
24351,425,210,215,56,43,52,25,729,391,338,80,64,71,34,1
24352,626,345,281,62,76,66,25,684,487,197,65,60,10,12,1
24353,466,270,196,70,48,41,25,858,417,441,124,101,85,41,1
24354,375,194,181,58,31,47,12,858,417,441,93,124,75,26,1
24355,673,317,356,101,85,76,49,706,320,386,111,76,75,51,1
24356,676,333,343,111,89,94,39,586,240,346,94,110,29,19,1
24357,354,181,173,52,18,50,15,201,42,159,19,3,2,75,1
24358,359,184,175,49,35,32,11,1690,1173,517,186,130,110,56,1
24359,409,208,201,33,45,23,10,298,161,137,47,29,25,15,1
24360,854,380,474,137,159,81,31,615,293,322,70,67,45,29,1
24361,577,251,326,92,84,60,11,270,137,133,30,28,27,11,1
24362,758,421,337,95,73,116,28,466,233,233,65,51,50,32,1
24363,875,402,473,125,120,95,47,277,124,153,44,40,35,18,1
24364,623,320,303,103,85,75,15,294,148,146,35,33,25,14,1
24365,1327,690,637,194,140,130,52,439,177,262,78,73,40,21,1
24366,589,314,275,70,83,44,28,536,230,306,64,88,40,12,1
24367,168,120,48,7,5,20,7,408,215,193,47,31,42,17,1
24368,394,183,211,65,60,35,18,920,492,428,100,92,88,49,1
24369,375,202,173,46,49,41,23,352,166,186,55,59,31,16,1
24370,508,215,293,72,71,42,15,1356,672,684,171,172,134,59,1
24371,2210,1122,1088,243,234,214,111,2174,1054,1120,240,247,216,112,1
24372,870,436,434,131,114,72,25,140,76,64,17,13,13,8,1
24373,1382,689,693,186,176,167,77,794,390,404,103,95,86,23,1
24374,816,463,353,99,99,61,26,473,217,256,59,44,34,21,1
24375,1132,646,486,99,102,71,41,294,148,146,35,33,25,14,1
24376,95,41,54,15,16,8,5,346,173,173,50,56,31,14,1
24377,766,395,371,89,86,127,27,94,51,43,18,6,4,9,1
24378,803,358,445,135,117,80,44,2035,1087,948,163,129,96,73,1
24379,247,110,137,34,45,23,10,573,316,257,78,80,21,21,1
24380,1435,649,786,214,181,135,54,500,257,243,60,55,27,22,1
24381,777,345,432,128,88,65,39,2089,917,1172,285,306,83,39,1
24382,2414,1189,1225,277,178,170,169,640,279,361,102,83,69,21,1
24383,334,172,162,43,39,41,17,223,113,110,31,33,22,12,1
24384,439,177,262,78,73,40,21,1919,871,1048,315,265,148,61,1
24385,1712,926,786,199,198,156,71,1834,823,1011,297,282,151,63,1
24386,1014,427,587,195,162,105,40,892,420,472,135,146,98,37,1
24387,595,272,323,111,107,54,28,1255,666,589,145,142,120,82,1
24388,445,209,236,63,50,42,28,224,125,99,33,32,22,6,1
24389,247,110,137,34,45,23,10,800,365,435,129,102,97,31,1
24390,771,361,410,131,99,115,34,749,398,351,118,77,87,29,1
24391,1134,539,595,150,146,78,40,770,355,415,103,142,75,42,1
24392,185,107,78,20,29,10,4,435,203,232,57,67,40,12,1
24393,505,272,233,76,66,57,23,310,161,149,34,31,35,12,1
24394,294,140,154,47,35,22,17,744,384,360,104,96,57,31,1
24395,875,376,499,155,125,53,39,436,209,227,66,47,52,22,1
24396,504,272,232,72,41,57,23,428,248,180,44,39,28,9,1
24397,218,105,113,31,28,24,14,425,210,215,56,43,52,25,1
24398,2045,985,1060,359,339,199,74,543,221,322,78,122,37,12,1
24399,456,228,228,49,70,32,19,269,134,135,42,35,27,13,1
24400,94,45,49,11,20,10,4,52,30,22,6,2,3,6,1
24401,551,298,253,63,65,45,19,500,268,232,65,56,28,17,1
24402,194,94,100,35,19,25,16,1487,996,491,147,141,50,35,1
24403,179,92,87,23,18,16,12,325,169,156,32,37,49,20,1
24404,370,194,176,51,57,43,17,149,68,81,15,38,11,10,1
24405,939,493,446,113,100,87,31,593,295,298,70,85,48,13,1
24406,2477,1186,1291,256,271,249,90,263,136,127,29,24,19,31,1
24407,351,184,167,59,45,54,9,2364,1004,1360,406,426,226,79,1
24408,2923,1529,1394,308,341,287,114,410,175,235,73,61,37,27,1
24409,307,162,145,38,46,41,15,619,292,327,73,73,61,32,1
24410,593,266,327,102,84,69,24,745,366,379,110,93,79,45,1
24411,168,67,101,37,17,13,13,135,69,66,21,14,11,5,1
24412,673,313,360,101,101,46,17,446,176,270,64,79,45,24,1
24413,508,267,241,43,35,25,17,462,233,229,66,49,43,30,1
24414,113,61,52,13,15,7,5,407,240,167,38,29,67,26,1
24415,244,120,124,34,40,26,8,448,236,212,53,64,56,24,1
24416,330,157,173,56,42,51,8,255,122,133,35,51,22,13,1
24417,548,292,256,67,65,68,26,183,89,94,27,24,20,8,1
24418,455,218,237,57,51,42,35,205,123,82,22,8,31,5,1
24419,654,317,337,95,111,44,13,859,395,464,157,119,59,31,1
24420,1730,801,929,328,213,219,64,375,202,173,46,49,41,23,1
24421,770,356,414,123,102,66,25,536,278,258,72,63,62,20,1
24422,540,357,183,68,65,9,11,794,402,392,96,84,86,30,1
24423,352,212,140,37,17,61,20,750,347,403,105,103,83,29,1
24424,278,111,167,66,66,19,8,284,109,175,55,79,9,9,1
24425,475,254,221,74,51,50,15,380,212,168,47,38,19,11,1
24426,708,334,374,105,96,61,37,862,335,527,136,169,47,28,1
24427,829,396,433,141,82,93,36,379,203,176,55,48,45,16,1
24428,467,238,229,52,42,28,25,748,355,393,121,91,95,26,1
24429,1338,633,705,199,151,144,65,1290,629,661,191,187,167,55,1
24430,95,41,54,15,16,8,5,882,432,450,115,111,68,44,1
24431,433,221,212,59,42,47,14,758,362,396,115,102,35,13,1
24432,1034,451,583,165,146,104,40,206,94,112,37,36,18,9,1
24433,198,80,118,35,31,14,7,292,153,139,39,33,24,21,1
24434,323,195,128,39,22,51,11,110,49,61,19,7,2,5,1
24435,575,301,274,81,62,76,28,193,85,108,24,37,20,13,1
24436,350,180,170,64,46,55,12,582,293,289,94,80,77,32,1
24437,574,277,297,88,77,58,36,197,92,105,38,16,26,15,1
24438,191,99,92,25,24,18,8,150,74,76,21,22,18,7,1
24439,656,358,298,67,47,64,26,437,225,212,36,34,32,39,1
24440,584,319,265,72,83,53,22,706,320,386,111,76,75,51,1
24441,307,154,153,39,36,31,12,673,317,356,101,85,76,49,1
24442,686,345,341,98,106,75,25,1061,586,475,141,127,120,38,1
24443,247,110,137,34,45,23,10,148,77,71,26,24,23,4,1
24444,846,425,421,126,97,98,38,304,159,145,38,40,32,3,1
24445,631,315,316,64,57,49,15,1271,599,672,194,175,118,47,1
24446,462,251,211,74,53,41,18,102,49,53,14,21,7,4,1
24447,918,427,491,113,111,113,33,1342,673,669,178,154,137,94,1
24448,1170,510,660,142,182,115,84,267,159,108,31,13,22,15,1
24449,1970,978,992,245,206,198,80,301,119,182,53,47,14,20,1
24450,1023,449,574,140,174,76,43,504,259,245,73,56,45,29,1
24451,430,192,238,62,67,27,10,483,215,268,66,70,30,16,1
24452,1264,655,609,141,119,131,50,1115,599,516,125,105,95,51,1
24453,238,91,147,68,19,22,7,502,247,255,82,57,64,16,1
24454,799,377,422,98,95,80,70,279,106,173,48,35,41,39,1
24455,483,274,209,54,39,45,13,721,363,358,87,104,70,28,1
24456,715,355,360,118,79,71,29,309,137,172,51,50,28,14,1
24457,377,171,206,46,59,22,6,323,171,152,36,36,47,15,1
24458,1304,679,625,153,158,131,35,1997,972,1025,262,209,239,52,1
24459,666,347,319,92,73,63,25,1464,715,749,200,167,181,70,1
24460,289,125,164,51,55,17,10,425,204,221,71,56,45,13,1
24461,673,313,360,101,101,46,17,1013,457,556,124,157,81,26,1
24462,382,214,168,49,20,47,23,354,166,188,53,55,40,19,1
24463,285,109,176,54,80,9,9,253,123,130,40,46,15,4,1
24464,794,390,404,103,95,86,23,551,299,252,51,62,63,17,1
24465,815,418,397,97,62,70,17,125,68,57,19,18,18,6,1
24466,418,248,170,41,31,54,9,669,323,346,94,89,34,18,1
24467,467,226,241,55,48,54,23,369,180,189,62,70,24,21,1
24468,537,288,249,60,60,61,19,183,89,94,27,24,20,8,1
24469,999,541,458,110,110,104,42,1038,470,568,130,123,86,51,1
24470,214,109,105,31,26,25,17,191,99,92,25,24,18,8,1
24471,1032,526,506,129,117,119,47,3396,1499,1897,325,572,309,90,1
24472,635,333,302,99,75,83,28,805,382,423,109,118,77,33,1
24473,465,228,237,64,42,63,24,569,283,286,40,16,60,7,1
24474,770,390,380,104,76,78,32,288,142,146,52,32,26,8,1
24475,1132,553,579,172,143,150,57,787,386,401,98,95,86,25,1
24476,962,430,532,109,142,61,34,111,55,56,16,15,8,7,1
24477,330,143,187,63,29,52,20,703,356,347,96,97,38,22,1
24478,264,126,138,44,26,25,10,551,298,253,63,65,45,19,1
24479,2044,1089,955,267,233,241,109,270,130,140,48,44,37,12,1
24480,103,56,47,27,7,8,2,220,113,107,37,24,16,7,1
24481,360,161,199,72,36,35,13,458,222,236,69,39,35,18,1
24482,250,137,113,33,19,24,9,285,145,140,37,36,22,11,1
24483,346,192,154,47,29,33,13,641,324,317,88,92,49,14,1
24484,1712,926,786,199,198,156,71,828,459,369,95,92,107,25,1
24485,163,70,93,28,21,17,6,758,362,396,115,102,35,13,1
24486,503,232,271,69,45,46,22,1124,578,546,149,127,122,61,1
24487,1861,896,965,265,187,156,70,926,435,491,133,132,85,17,1
24488,498,277,221,51,46,70,22,410,208,202,35,36,50,15,1
24489,394,202,192,44,43,38,28,720,382,338,99,76,78,37,1
24490,1085,471,614,181,156,110,46,1651,798,853,203,199,137,50,1
24491,124,69,55,20,10,5,2,167,89,78,16,14,18,7,1
24492,209,125,84,20,22,22,6,317,153,164,34,52,30,14,1
24493,624,275,349,93,99,74,22,1013,457,556,124,157,81,26,1
24494,758,362,396,115,102,35,13,149,68,81,15,38,11,10,1
24495,111,51,60,20,21,10,11,307,154,153,39,36,31,12,1
24496,278,164,114,35,23,30,18,3433,1476,1957,522,578,264,123,1
24497,684,288,396,107,90,54,42,500,234,266,72,63,58,33,1
24498,178,100,78,23,22,30,6,1089,544,545,138,160,117,43,1
24499,1427,759,668,165,136,121,106,2813,1331,1482,320,339,261,290,1
24500,787,386,401,98,95,86,25,624,308,316,92,72,68,22,1
24501,835,419,416,119,94,106,40,377,202,175,46,50,41,22,1
24502,441,175,266,73,88,26,8,613,333,280,71,66,47,26,1
24503,744,371,373,103,82,79,39,745,354,391,116,100,95,46,1
24504,283,172,111,39,31,29,8,341,154,187,34,36,11,11,1
24505,624,308,316,92,72,68,22,520,231,289,89,59,58,26,1
24506,756,385,371,119,99,93,29,467,224,243,70,43,67,23,1
24507,719,343,376,108,78,92,29,669,323,346,94,89,34,18,1
24508,278,137,141,47,32,28,20,552,285,267,74,51,69,24,1
24509,1304,585,719,179,169,154,47,537,276,261,75,68,68,22,1
24510,687,353,334,84,96,74,31,364,195,169,50,38,33,12,1
24511,186,84,102,27,29,21,10,207,107,100,27,25,20,11,1
24512,536,278,258,72,63,62,20,4544,2024,2520,579,628,480,403,1
24513,639,322,317,73,82,39,23,1314,648,666,135,166,103,52,1
24514,183,97,86,23,24,22,8,667,294,373,97,80,70,38,1
24515,2442,1193,1249,278,183,170,145,303,187,116,41,23,23,9,1
24516,977,406,571,151,128,84,47,89,42,47,16,12,15,6,1
24517,427,218,209,61,53,45,26,492,280,212,56,61,30,13,1
24518,464,225,239,85,57,65,19,2177,1034,1143,274,228,201,95,1
24519,381,189,192,74,49,44,13,340,162,178,40,39,35,22,1
24520,271,136,135,37,30,18,10,146,75,71,13,32,15,11,1
24521,613,334,279,90,71,51,17,698,365,333,108,83,65,21,1
24522,339,170,169,32,17,24,13,439,260,179,47,40,23,19,1
24523,415,209,206,60,67,39,18,538,293,245,48,66,45,16,1
24524,777,408,369,100,96,56,17,240,125,115,34,32,30,8,1
24525,231,126,105,37,26,29,6,367,161,206,70,48,41,19,1
24526,653,326,327,83,96,83,27,171,94,77,24,28,30,11,1
24527,496,251,245,78,62,61,23,179,87,92,25,21,22,11,1
24528,199,105,94,27,27,28,9,923,509,414,95,102,65,52,1
24529,264,121,143,57,32,22,15,1270,557,713,130,195,57,30,1
24530,380,184,196,58,52,46,8,1865,918,947,300,256,217,76,1
24531,1124,578,546,149,127,122,61,583,322,261,73,66,45,26,1
24532,1023,561,462,117,125,96,48,768,378,390,105,104,63,26,1
24533,390,207,183,50,48,38,15,497,185,312,63,92,38,28,1
24534,85,34,51,17,17,4,2,824,392,432,106,89,88,32,1
24535,569,268,301,70,60,70,44,1663,835,828,224,213,163,63,1
24536,431,228,203,66,46,59,15,341,154,187,34,36,11,11,1
24537,372,189,183,60,44,41,18,236,121,115,26,45,28,6,1
24538,1005,422,583,166,179,70,21,326,217,109,32,20,43,18,1
24539,580,308,272,82,79,58,25,595,316,279,86,60,65,40,1
24540,395,226,169,57,44,32,8,879,466,413,103,85,111,54,1
24541,1692,713,979,325,210,122,58,200,97,103,33,26,21,9,1
24542,278,131,147,29,30,33,12,399,201,198,65,45,48,17,1
24543,513,246,267,71,66,60,35,234,114,120,34,28,25,9,1
24544,903,437,466,117,112,108,32,154,75,79,17,24,16,13,1
24545,2089,917,1172,285,306,83,39,1863,721,1142,262,283,139,74,1
24546,245,112,133,32,45,20,10,1117,423,694,182,134,88,31,1
24547,474,255,219,61,47,63,23,282,135,147,36,49,25,10,1
24548,1392,695,697,162,160,139,74,1834,823,1011,297,282,151,63,1
24549,146,71,75,20,17,8,7,301,150,151,41,30,17,11,1
24550,840,385,455,118,137,66,39,273,130,143,34,29,29,16,1
24551,346,180,166,55,49,38,6,720,357,363,113,85,62,39,1
24552,217,109,108,34,32,35,7,359,157,202,44,34,31,17,1
24553,509,262,247,64,70,64,20,207,107,100,27,25,20,11,1
24554,1382,689,693,186,176,167,77,1242,613,629,174,113,114,53,1
24555,339,170,169,32,17,24,13,497,185,312,63,92,38,28,1
24556,272,141,131,45,29,36,9,318,176,142,25,32,35,25,1
24557,2146,1050,1096,330,305,194,74,930,367,563,181,153,83,48,1
24558,250,123,127,40,28,29,8,171,94,77,24,28,30,11,1
24559,507,286,221,63,70,57,18,475,261,214,67,67,55,18,1
24560,309,154,155,42,44,45,16,2005,1075,930,234,243,249,109,1
24561,646,316,330,89,95,48,17,619,292,327,73,73,61,32,1
24562,1271,599,672,194,175,118,47,248,119,129,33,48,20,10,1
24563,4544,2024,2520,579,628,480,403,317,156,161,49,51,18,10,1
24564,1338,756,582,155,105,104,44,825,427,398,79,95,81,48,1
24565,397,186,211,73,63,36,25,590,306,284,69,82,68,27,1
24566,155,79,76,26,13,15,6,388,253,135,37,21,39,23,1
24567,154,75,79,17,24,16,13,4374,2058,2316,531,605,321,183,1
24568,183,95,88,27,22,26,5,552,285,267,74,51,69,24,1
24569,2058,933,1125,317,304,250,74,165,91,74,18,16,16,20,1
24570,248,118,130,54,31,26,5,478,215,263,103,72,47,3,1
24571,2045,985,1060,359,339,199,74,1388,535,853,241,239,96,52,1
24572,185,70,115,37,48,15,5,183,76,107,34,38,14,8,1
24573,504,237,267,62,66,48,17,213,110,103,26,11,19,8,1
24574,1132,553,579,172,143,150,57,750,347,403,105,103,83,29,1
24575,398,257,141,43,19,29,19,354,168,186,50,53,39,20,1
24576,505,226,279,68,51,30,15,754,318,436,114,106,58,28,1
24577,777,387,390,90,87,65,37,601,313,288,42,48,25,36,1
24578,356,208,148,42,26,57,15,688,330,358,122,97,92,39,1
24579,546,279,267,94,60,32,22,560,260,300,100,58,29,28,1
24580,350,168,182,59,50,42,15,412,203,209,69,57,68,21,1
24581,193,118,75,25,19,10,7,175,91,84,19,21,21,10,1
24582,656,358,298,67,47,64,26,393,196,197,56,47,41,26,1
24583,593,266,327,102,84,69,24,1114,581,533,145,132,126,54,1
24584,382,183,199,55,60,38,22,577,241,336,112,109,47,21,1
24585,95,41,54,15,16,8,5,2985,1374,1611,450,433,312,111,1
24586,930,367,563,181,153,83,48,437,167,270,126,95,34,10,1
24587,437,210,227,73,62,38,19,227,105,122,37,29,19,12,1
24588,144,62,82,29,8,19,17,148,67,81,20,14,18,16,1
24589,845,402,443,137,126,105,47,445,225,220,47,62,53,26,1
24590,4303,2489,1814,436,369,444,134,536,278,258,72,63,62,20,1
24591,698,345,353,104,87,81,50,240,119,121,31,24,10,19,1
24592,938,484,454,137,100,104,41,641,324,317,88,92,49,14,1
24593,473,224,249,82,63,48,24,304,127,177,61,38,31,4,1
24594,221,110,111,28,32,25,11,673,317,356,101,85,76,49,1
24595,390,207,183,50,48,38,15,876,407,469,137,130,73,29,1
24596,571,298,273,81,72,57,25,165,85,80,29,25,16,13,1
24597,363,182,181,33,55,23,11,298,161,137,47,29,25,15,1
24598,263,125,138,36,25,40,16,179,92,87,23,18,16,12,1
24599,710,375,335,95,94,110,28,427,186,241,55,52,42,23,1
24600,467,201,266,71,70,63,27,575,218,357,135,58,89,41,1
24601,648,307,341,101,58,76,34,189,88,101,31,29,18,10,1
24602,353,196,157,51,39,49,8,213,107,106,28,41,19,5,1
24603,352,166,186,55,59,31,16,553,253,300,92,66,56,47,1
24604,277,100,177,35,88,30,2,211,114,97,32,24,19,10,1
24605,196,92,104,35,33,19,6,834,483,351,102,83,103,22,1
24606,1158,573,585,165,196,114,35,654,344,310,80,69,57,15,1
24607,480,234,246,79,77,65,23,1023,449,574,140,174,76,43,1
24608,225,106,119,32,33,24,10,505,272,233,76,66,57,23,1
24609,221,110,111,28,32,25,11,1163,493,670,214,158,106,42,1
24610,498,289,209,62,41,63,18,219,97,122,30,29,23,9,1
24611,695,373,322,80,59,89,39,129,56,73,17,14,19,18,1
24612,502,279,223,62,54,66,28,529,305,224,59,55,75,27,1
24613,842,446,396,132,114,110,31,94,45,49,11,20,10,4,1
24614,1179,579,600,140,133,122,53,717,469,248,92,67,22,21,1
24615,613,303,310,70,28,28,18,437,228,209,47,61,26,11,1
24616,561,210,351,108,77,41,22,667,360,307,76,92,46,27,1
24617,216,113,103,28,24,22,17,589,294,295,37,44,27,33,1
24618,280,156,124,36,19,20,13,161,94,67,23,13,8,10,1
24619,268,157,111,26,30,28,13,205,100,105,25,25,20,9,1
24620,1115,552,563,104,116,115,35,509,262,247,64,70,64,20,1
24621,596,292,304,92,60,56,19,467,269,198,46,51,60,18,1
24622,2364,1004,1360,406,426,226,79,467,224,243,70,43,67,23,1
24623,465,230,235,68,64,48,24,217,98,119,33,32,27,7,1
24624,330,157,173,56,42,51,8,509,243,266,80,57,45,19,1
24625,277,151,126,35,30,24,15,244,135,109,36,24,20,10,1
24626,1411,472,939,252,262,58,31,492,242,250,52,78,28,19,1
24627,585,299,286,92,73,89,23,563,347,216,53,32,64,33,1
24628,221,111,110,42,35,33,6,915,336,579,185,199,56,29,1
24629,587,260,327,84,69,55,23,537,276,261,75,68,68,22,1
24630,1054,453,601,183,183,107,35,393,186,207,58,50,36,22,1
24631,636,284,352,108,101,40,23,297,148,149,64,35,37,15,1
24632,201,42,159,19,3,2,75,753,318,435,154,95,56,23,1
24633,1040,564,476,134,110,114,51,540,257,283,81,63,57,24,1
24634,90,52,38,11,8,7,8,93,45,48,6,14,8,8,1
24635,922,491,431,112,92,97,52,2639,1436,1203,317,307,242,77,1
24636,553,261,292,73,79,40,26,655,328,327,65,54,55,35,1
24637,800,416,384,102,105,83,22,592,295,297,79,70,76,11,1
24638,555,278,277,60,70,48,18,651,331,320,93,93,51,28,1
24639,2414,1189,1225,277,178,170,169,217,115,102,40,24,26,6,1
24640,146,75,71,13,32,15,11,295,124,171,57,27,31,18,1
24641,166,78,88,27,25,19,7,254,107,147,42,37,24,10,1
24642,454,224,230,71,39,62,22,221,110,111,28,32,25,11,1
24643,233,111,122,38,27,17,8,921,455,466,144,127,108,39,1
24644,643,338,305,81,72,78,35,147,79,68,20,15,19,8,1
24645,666,344,322,91,73,91,20,703,356,347,96,97,38,22,1
24646,736,388,348,88,85,67,28,683,288,395,125,94,77,39,1
24647,330,208,122,33,18,45,13,359,173,186,55,57,44,16,1
24648,437,225,212,61,57,66,12,647,322,325,104,98,54,14,1
24649,1123,554,569,142,130,85,36,260,136,124,24,41,19,4,1
24650,374,184,190,52,38,48,11,526,264,262,77,71,61,27,1
24651,930,463,467,151,83,106,52,471,255,216,66,68,81,16,1
24652,926,435,491,133,132,85,17,1271,599,672,194,175,118,47,1
24653,462,228,234,59,47,37,32,457,228,229,64,36,52,21,1
24654,466,186,280,71,84,30,11,329,155,174,46,38,29,14,1
24655,467,261,206,54,49,48,24,657,293,364,109,75,66,28,1
24656,127,58,69,17,22,3,2,379,203,176,55,48,45,16,1
24657,557,278,279,75,70,66,31,183,89,94,27,24,20,8,1
24658,185,83,102,30,19,21,8,425,210,215,56,43,52,25,1
24659,435,208,227,68,64,53,23,217,109,108,34,32,35,7,1
24660,558,302,256,66,62,65,30,2419,1042,1377,389,474,238,59,1
24661,1134,539,595,150,146,78,40,393,186,207,58,50,36,22,1
24662,356,185,171,37,31,17,21,167,70,97,23,14,23,7,1
24663,340,172,168,60,50,36,10,154,78,76,23,21,13,5,1
24664,2472,1055,1417,416,458,235,64,721,379,342,89,73,68,25,1
24665,1544,670,874,236,239,128,49,2135,1170,965,232,246,196,89,1
24666,609,292,317,102,96,64,21,632,388,244,75,56,56,23,1
24667,440,235,205,34,61,36,13,277,124,153,44,40,35,18,1
24668,1114,581,533,145,132,126,54,304,159,145,38,40,32,3,1
24669,838,380,458,114,95,68,57,154,75,79,28,23,16,6,1
24670,731,383,348,102,84,68,30,482,231,251,76,81,64,26,1
24671,379,203,176,55,48,45,16,428,248,180,44,39,28,9,1
24672,255,134,121,36,40,29,13,86,50,36,9,14,8,7,1
24673,486,217,269,110,62,23,10,385,179,206,58,56,38,19,1
24674,535,249,286,79,64,55,22,1257,662,595,176,142,106,42,1
24675,577,342,235,63,57,23,37,1117,423,694,182,134,88,31,1
24676,403,185,218,67,62,63,19,393,186,207,58,50,36,22,1
24677,950,497,453,146,127,115,43,460,263,197,55,53,32,19,1
24678,2416,1280,1136,140,374,175,47,703,308,395,81,91,66,80,1
24679,681,348,333,100,63,53,27,920,492,428,100,92,88,49,1
24680,1865,943,922,270,209,228,91,346,167,179,56,52,28,13,1
24681,445,198,247,85,67,38,19,642,271,371,106,111,57,23,1
24682,594,296,298,73,81,57,27,108,59,49,17,13,12,5,1
24683,720,356,364,90,98,61,22,400,215,185,59,54,33,16,1
24684,452,217,235,59,47,60,20,479,238,241,64,47,62,22,1
24685,818,357,461,122,136,54,25,1047,562,485,141,127,114,41,1
24686,247,110,137,34,45,23,10,335,128,207,51,60,16,8,1
24687,659,325,334,102,85,87,32,526,264,262,77,71,61,27,1
24688,643,294,349,92,97,53,35,632,326,306,92,71,56,19,1
24689,360,167,193,61,34,43,35,591,366,225,66,42,76,43,1
24690,201,42,159,19,3,2,75,720,357,363,113,85,62,39,1
24691,673,313,360,101,101,46,17,298,140,158,51,33,21,22,1
24692,1015,526,489,133,133,86,34,601,313,288,42,48,25,36,1
24693,513,362,151,36,25,97,33,169,85,84,33,20,24,9,1
24694,482,242,240,60,39,60,17,233,118,115,26,21,34,8,1
24695,512,261,251,79,73,60,21,972,519,453,109,98,120,39,1
24696,295,147,148,36,24,36,11,168,120,48,7,5,20,7,1
24697,410,186,224,72,57,52,22,441,189,252,73,50,47,23,1
24698,605,295,310,74,66,70,36,1091,543,548,146,136,110,34,1
24699,355,205,150,35,19,62,24,120,61,59,17,8,8,5,1
24700,1374,679,695,191,193,154,48,524,237,287,87,75,54,26,1
24701,785,374,411,56,42,38,25,339,170,169,32,17,24,13,1
24702,624,308,316,92,72,68,22,217,109,108,34,32,35,7,1
24703,163,70,93,28,21,17,6,601,313,288,42,48,25,36,1
24704,375,214,161,43,22,52,25,97,53,44,13,12,7,5,1
24705,147,81,66,18,18,18,4,2045,985,1060,359,339,199,74,1
24706,396,215,181,53,43,55,17,291,146,145,39,45,22,16,1
24707,1050,473,577,142,119,87,54,835,420,415,104,105,57,47,1
24708,956,405,551,170,171,64,35,298,167,131,47,33,40,8,1
24709,274,158,116,27,27,22,18,839,427,412,91,83,114,37,1
24710,358,170,188,54,55,20,10,764,454,310,87,66,91,21,1
24711,707,295,412,105,105,66,30,837,489,348,101,71,83,38,1
24712,412,217,195,57,42,53,24,776,356,420,122,103,85,30,1
24713,710,420,290,60,54,79,49,326,153,173,63,48,25,8,1
24714,478,256,222,79,44,38,15,1149,568,581,177,133,101,30,1
24715,163,70,93,28,21,17,6,215,115,100,27,28,34,16,1
24716,1007,503,504,117,105,72,38,659,334,325,90,79,72,36,1
24717,465,240,225,50,54,24,14,410,188,222,53,52,31,14,1
24718,712,380,332,69,74,57,30,540,282,258,50,53,33,16,1
24719,105,50,55,14,13,11,7,346,167,179,56,52,28,13,1
24720,1270,682,588,165,147,136,54,619,290,329,97,79,62,19,1
24721,561,255,306,95,67,44,17,724,334,390,112,109,79,17,1
24722,1054,530,524,172,119,133,37,536,278,258,72,63,62,20,1
24723,615,339,276,82,76,63,16,674,268,406,118,96,70,21,1
24724,1332,626,706,182,144,80,41,458,222,236,69,39,35,18,1
24725,213,86,127,37,33,5,16,533,300,233,56,51,32,26,1
24726,2524,1232,1292,398,317,186,61,530,259,271,83,50,54,41,1
24727,288,159,129,27,44,27,15,1075,594,481,132,108,101,42,1
24728,388,199,189,50,51,33,14,489,302,187,49,23,67,26,1
24729,456,272,184,53,43,37,29,869,464,405,107,91,89,56,1
24730,374,191,183,70,48,61,13,194,96,98,50,24,17,3,1
24731,576,250,326,93,71,34,15,415,209,206,60,67,39,18,1
24732,647,322,325,104,98,54,14,391,208,183,65,49,57,17,1
24733,546,279,267,94,60,32,22,424,198,226,57,46,41,19,1
24734,1115,586,529,124,161,111,69,216,119,97,33,27,28,7,1
24735,491,270,221,51,47,53,18,431,201,230,69,39,55,33,1
24736,406,202,204,54,54,41,16,637,321,316,70,96,30,18,1
24737,508,295,213,42,61,53,17,193,109,84,24,19,16,7,1
24738,465,218,247,64,51,50,42,3224,1440,1784,455,440,333,126,1
24739,3075,1459,1616,390,359,298,207,617,387,230,65,57,77,16,1
24740,430,264,166,53,24,60,24,113,60,53,11,13,10,3,1
24741,476,259,217,64,64,81,15,354,193,161,51,41,58,13,1
24742,391,208,183,65,49,57,17,288,118,170,50,57,18,15,1
24743,963,447,516,120,146,87,74,501,216,285,79,70,54,30,1
24744,125,46,79,24,16,12,2,347,212,135,35,32,17,6,1
24745,190,94,96,25,24,18,5,98,50,48,10,10,10,6,1
24746,293,167,126,42,28,73,13,815,418,397,97,62,70,17,1
24747,202,102,100,29,35,6,9,632,326,306,92,71,56,19,1
24748,263,159,104,30,27,31,11,724,334,390,112,109,79,17,1
24749,505,239,266,71,55,50,18,303,187,116,41,23,23,9,1
24750,336,154,182,51,48,39,22,267,127,140,43,42,24,9,1
24751,2414,1189,1225,277,178,170,169,202,103,99,28,20,12,8,1
24752,777,387,390,90,87,65,37,168,120,48,7,5,20,7,1
24753,595,292,303,79,83,69,24,864,429,435,129,118,68,35,1
24754,1332,626,706,182,144,80,41,445,255,190,57,53,56,28,1
24755,183,91,92,25,20,23,7,501,240,261,80,62,49,42,1
24756,317,153,164,34,52,30,14,745,366,379,110,93,79,45,1
24757,147,95,52,16,7,24,5,259,143,116,39,37,23,9,1
24758,394,207,187,52,42,37,24,379,203,176,55,48,45,16,1
24759,711,435,276,72,62,51,20,293,153,140,45,38,22,15,1
24760,672,334,338,110,93,91,41,196,105,91,22,26,21,8,1
24761,1247,548,699,168,150,140,43,1367,690,677,172,175,154,83,1
24762,270,137,133,30,28,27,11,367,161,206,70,48,41,19,1
24763,1172,521,651,132,180,129,80,707,386,321,85,83,99,28,1
24764,1982,710,1272,353,319,146,76,501,240,261,80,62,49,42,1
24765,374,191,183,70,48,61,13,127,49,78,27,20,6,5,1
24766,1377,579,798,179,169,139,99,557,306,251,66,42,52,15,1
24767,824,397,427,113,95,82,33,1270,682,588,165,147,136,54,1
24768,870,436,434,131,114,72,25,564,291,273,77,72,95,21,1
24769,425,198,227,57,69,59,13,482,231,251,76,81,64,26,1
24770,289,125,164,51,55,17,10,220,113,107,31,21,25,12,1
24771,213,107,106,28,41,19,5,172,98,74,20,21,22,8,1
24772,360,192,168,55,45,48,16,548,309,239,73,62,54,13,1
24773,312,172,140,41,40,21,8,750,347,403,105,103,83,29,1
24774,810,367,443,115,92,94,59,295,146,149,33,32,33,7,1
24775,280,156,124,36,19,20,13,1455,765,690,189,162,166,66,1
24776,951,506,445,107,118,79,40,507,248,259,56,49,44,10,1
24777,751,312,439,131,115,78,48,305,156,149,37,39,42,5,1
24778,740,313,427,101,135,40,22,391,203,188,49,34,36,9,1
24779,1290,597,693,182,182,119,63,947,506,441,105,126,75,14,1
24780,209,89,120,41,35,17,3,1273,592,681,199,164,139,39,1
24781,1368,742,626,179,129,189,73,345,203,142,47,35,31,11,1
24782,706,346,360,118,92,98,56,545,289,256,75,72,42,22,1
24783,824,386,438,94,77,81,34,625,298,327,90,78,57,33,1
24784,1122,437,685,152,187,105,40,52,30,22,6,2,3,6,1
24785,858,441,417,110,135,90,40,432,190,242,85,82,28,11,1
24786,766,395,371,89,86,127,27,98,46,52,16,6,2,9,1
24787,1074,538,536,154,140,111,51,825,363,462,97,105,72,75,1
24788,141,83,58,15,10,10,17,355,165,190,53,56,42,19,1
24789,189,90,99,26,29,17,11,217,109,108,34,32,35,7,1
24790,1117,556,561,188,117,110,48,1290,629,661,191,187,167,55,1
24791,1912,977,935,247,226,205,65,700,357,343,99,84,88,34,1
24792,1216,628,588,134,130,172,51,313,166,147,47,44,41,10,1
24793,167,87,80,28,20,19,11,331,183,148,36,44,40,21,1
24794,270,130,140,43,24,36,10,202,103,99,28,20,12,8,1
24795,193,102,91,23,25,20,10,1153,535,618,204,158,93,50,1
24796,154,73,81,24,27,18,9,360,188,172,49,48,47,17,1
24797,923,420,503,128,159,100,49,858,448,410,98,83,122,29,1
24798,619,290,329,97,79,62,19,601,313,288,42,48,25,36,1
24799,260,136,124,24,41,19,4,648,307,341,101,58,76,34,1
24800,2644,1346,1298,391,304,315,148,586,270,316,83,80,59,21,1
24801,837,464,373,104,72,85,49,2416,1280,1136,140,374,175,47,1
24802,1024,510,514,152,122,131,52,295,143,152,38,47,22,25,1
24803,437,225,212,61,57,66,12,779,392,387,124,79,52,13,1
24804,2549,1331,1218,366,296,271,130,1242,613,629,174,113,114,53,1
24805,836,391,445,146,108,60,23,126,56,70,31,10,10,3,1
24806,360,188,172,49,48,47,17,215,115,100,27,28,34,16,1
24807,102,61,41,15,13,8,2,140,86,54,17,6,20,7,1
24808,303,137,166,54,54,31,15,229,105,124,36,33,12,4,1
24809,115,67,48,10,7,12,7,452,256,196,32,44,27,11,1
24810,412,200,212,67,62,39,22,641,324,317,88,92,49,14,1
24811,2639,1436,1203,317,307,242,77,402,227,175,48,40,35,11,1
24812,480,232,248,83,64,51,25,416,201,215,54,52,39,25,1
24813,198,115,83,30,22,8,8,253,127,126,34,36,17,8,1
24814,217,112,105,28,29,27,15,423,279,144,48,24,88,20,1
24815,360,188,172,49,48,47,17,341,154,187,34,36,11,11,1
24816,982,494,488,150,117,91,45,377,184,193,56,53,44,14,1
24817,979,535,444,123,99,79,34,1434,727,707,210,173,161,54,1
24818,636,320,316,79,61,67,31,2442,1193,1249,278,183,170,145,1
24819,1332,637,695,214,178,117,40,2468,1038,1430,333,465,167,62,1
24820,223,138,85,22,21,38,5,3957,1683,2274,560,659,267,109,1
24821,987,515,472,107,110,106,61,1149,568,581,177,133,101,30,1
24822,2419,1042,1377,389,474,238,59,418,199,219,55,44,22,15,1
24823,875,376,499,155,125,53,39,821,387,434,121,131,76,29,1
24824,392,156,236,40,91,28,16,755,271,484,113,226,61,20,1
24825,1608,778,830,243,230,159,74,393,210,183,55,50,34,19,1
24826,427,218,209,61,53,45,26,431,233,198,54,40,42,12,1
24827,616,304,312,75,71,55,25,439,202,237,80,53,35,15,1
24828,969,505,464,123,133,92,33,419,175,244,71,73,23,23,1
24829,1462,652,810,243,199,115,30,744,385,359,125,89,90,23,1
24830,589,294,295,37,44,27,33,601,313,288,42,48,25,36,1
24831,432,228,204,59,53,43,15,933,536,397,96,90,71,41,1
24832,827,422,405,111,104,94,28,940,464,476,116,135,108,58,1
24833,1366,943,423,137,109,58,19,742,303,439,88,96,86,23,1
24834,734,340,394,108,99,52,32,1258,531,727,218,216,108,35,1
24835,407,180,227,79,42,32,16,393,186,207,58,50,36,22,1
24836,977,492,485,135,122,116,35,1374,679,695,191,193,154,48,1
24837,218,108,110,28,28,22,10,375,202,173,46,49,41,23,1
24838,482,231,251,76,81,64,26,401,204,197,49,33,29,17,1
24839,70,27,43,7,27,9,2,3418,1378,2040,515,464,318,121,1
24840,354,169,185,54,54,41,19,559,296,263,77,69,42,13,1
24841,376,176,200,31,53,27,8,446,265,181,51,35,27,17,1
24842,67,36,31,16,2,8,7,374,210,164,41,22,53,27,1
24843,430,239,191,63,42,51,19,413,230,183,57,36,65,34,1
24844,431,228,203,66,46,59,15,433,221,212,59,42,47,14,1
24845,270,143,127,35,21,29,9,619,332,287,95,77,74,38,1
24846,219,124,95,22,22,23,5,686,337,349,96,116,45,19,1
24847,207,107,100,27,25,20,11,171,88,83,20,21,16,7,1
24848,870,436,434,131,114,72,25,208,80,128,26,22,13,16,1
24849,296,154,142,38,38,24,16,569,288,281,86,69,74,24,1
24850,795,384,411,133,109,85,38,246,108,138,32,44,21,10,1
24851,719,301,418,122,132,42,26,309,106,203,66,49,25,10,1
24852,593,295,298,70,85,48,13,1074,538,536,154,140,111,51,1
24853,184,78,106,21,25,25,12,712,396,316,78,69,65,25,1
24854,1203,741,462,114,97,141,46,787,456,331,93,66,89,41,1
24855,359,171,188,50,60,21,12,6669,2978,3691,1310,930,829,237,1
24856,684,288,396,107,90,54,42,703,308,395,81,91,66,80,1
24857,1233,635,598,187,149,146,51,1106,579,527,121,152,113,45,1
24858,350,224,126,34,14,48,18,354,169,185,54,54,41,19,1
24859,589,294,295,37,44,27,33,896,407,489,97,152,70,22,1
24860,556,259,297,75,69,63,38,267,149,118,45,33,31,14,1
24861,2440,1061,1379,377,326,172,62,604,255,349,100,72,55,26,1
24862,412,193,219,70,56,51,26,480,252,228,55,37,49,20,1
24863,484,254,230,60,66,56,14,1580,742,838,208,146,144,71,1
24864,247,110,137,34,45,23,10,511,236,275,81,62,44,18,1
24865,267,127,140,43,42,24,9,170,35,135,33,25,8,5,1
24866,480,252,228,55,37,49,20,2414,1189,1225,277,178,170,169,1
24867,356,199,157,43,58,29,12,745,366,379,110,93,79,45,1
24868,359,163,196,47,78,47,9,829,366,463,137,130,56,10,1
24869,562,214,348,120,86,69,42,532,269,263,72,59,59,39,1
24870,1074,538,536,154,140,111,51,892,420,472,135,146,98,37,1
24871,368,158,210,64,61,39,14,437,225,212,61,57,66,12,1
24872,136,72,64,22,16,7,3,611,246,365,116,82,71,27,1
24873,330,159,171,48,38,50,19,335,169,166,30,48,33,16,1
24874,902,332,570,154,146,75,40,205,104,101,28,28,35,13,1
24875,375,202,173,46,49,41,23,166,81,85,30,27,13,8,1
24876,272,125,147,41,41,22,13,149,77,72,37,10,20,5,1
24877,214,109,105,31,26,25,17,553,261,292,73,79,40,26,1
24878,201,92,109,27,29,27,8,447,232,215,55,65,50,25,1
24879,563,299,264,78,79,68,26,348,226,122,23,20,59,25,1
24880,585,289,296,102,86,61,18,698,365,333,108,83,65,21,1
24881,266,133,133,43,28,30,8,465,225,240,65,44,65,25,1
24882,467,226,241,55,48,54,23,4374,2058,2316,531,605,321,183,1
24883,1691,1217,474,130,115,73,46,1231,603,628,121,162,109,120,1
24884,462,228,234,59,47,37,32,410,211,199,55,42,34,27,1
24885,723,380,343,80,84,47,18,862,335,527,136,169,47,28,1
24886,556,279,277,83,69,71,19,673,329,344,111,95,92,41,1
24887,609,292,317,102,96,64,21,1210,592,618,157,138,116,85,1
24888,524,361,163,41,8,28,16,356,175,181,58,40,33,26,1
24889,1321,679,642,154,167,133,58,2201,1053,1148,238,312,200,122,1
24890,245,122,123,21,32,18,13,759,367,392,118,104,66,33,1
24891,592,291,301,92,93,71,31,672,334,338,110,93,91,41,1
24892,356,199,157,43,58,29,12,551,298,253,63,65,45,19,1
24893,247,127,120,43,20,27,14,4128,2104,2024,581,505,453,205,1
24894,837,464,373,104,72,85,49,423,220,203,51,54,46,17,1
24895,209,89,120,41,35,17,3,160,53,107,31,29,13,3,1
24896,2416,1280,1136,140,374,175,47,582,330,252,82,69,87,21,1
24897,781,418,363,92,90,64,41,1462,652,810,243,199,115,30,1
24898,684,288,396,107,90,54,42,1756,697,1059,328,345,110,27,1
24899,1194,609,585,195,142,105,37,1068,527,541,160,131,112,52,1
24900,372,237,135,38,22,39,26,374,181,193,63,49,46,20,1
24901,68,34,34,9,2,9,9,671,318,353,83,124,46,34,1
24902,289,125,164,51,55,17,10,211,83,128,28,35,5,11,1
24903,582,293,289,94,80,77,32,715,355,360,118,79,71,29,1
24904,971,516,455,114,115,116,35,750,347,403,105,103,83,29,1
24905,590,324,266,79,58,82,32,437,167,270,126,95,34,10,1
24906,239,164,75,18,16,47,10,418,213,205,54,56,49,13,1
24907,301,150,151,41,30,17,11,2177,1034,1143,274,228,201,95,1
24908,2442,1193,1249,278,183,170,145,440,246,194,62,49,41,16,1
24909,415,209,206,60,67,39,18,342,160,182,69,40,37,16,1
24910,775,324,451,130,140,45,15,588,255,333,94,82,58,27,1
24911,654,344,310,80,69,57,15,149,68,81,15,38,11,10,1
24912,247,110,137,34,45,23,10,1084,537,547,154,121,92,35,1
24913,601,313,288,42,48,25,36,563,291,272,77,67,73,34,1
24914,179,76,103,36,32,9,9,490,230,260,78,70,53,18,1
24915,784,391,393,105,113,86,21,1356,672,684,171,172,134,59,1
24916,601,290,311,92,89,55,30,215,115,100,27,28,34,16,1
24917,1117,423,694,182,134,88,31,3144,1617,1527,367,342,278,136,1
24918,551,299,252,51,62,63,17,217,109,108,34,32,35,7,1
24919,267,149,118,45,33,31,14,439,177,262,78,73,40,21,1
24920,858,447,411,116,76,73,34,461,223,238,66,57,36,23,1
24921,592,275,317,100,86,57,31,240,167,73,32,12,8,21,1
24922,128,54,74,30,13,8,7,777,387,390,90,87,65,37,1
24923,769,329,440,116,66,55,22,2045,985,1060,359,339,199,74,1
24924,920,492,428,100,92,88,49,605,295,310,74,66,70,36,1
24925,317,153,164,34,52,30,14,163,71,92,22,38,11,7,1
24926,900,484,416,119,110,77,29,756,348,408,101,103,60,40,1
24927,135,65,70,21,25,15,9,220,113,107,37,24,16,7,1
24928,2414,1189,1225,277,178,170,169,345,203,142,47,35,31,11,1
24929,802,388,414,131,105,96,29,341,154,187,34,36,11,11,1
24930,93,46,47,6,8,8,8,355,214,141,43,29,63,13,1
24931,712,327,385,86,54,64,31,242,119,123,30,40,18,13,1
24932,158,74,84,26,23,18,18,750,347,403,105,103,83,29,1
24933,512,261,251,79,73,60,21,257,128,129,35,22,42,23,1
24934,389,197,192,63,52,49,15,416,223,193,56,55,50,17,1
24935,473,212,261,72,64,45,28,246,113,133,33,45,22,10,1
24936,485,187,298,95,71,61,25,450,232,218,58,54,42,20,1
24937,802,449,353,102,87,82,29,750,347,403,105,103,83,29,1
24938,246,113,133,33,45,22,10,184,77,107,34,17,14,13,1
24939,158,85,73,24,18,18,8,245,181,64,6,6,25,8,1
24940,669,348,321,83,80,55,23,407,230,177,53,42,34,20,1
24941,211,114,97,32,24,19,10,178,100,78,23,22,30,6,1
24942,543,277,266,62,54,70,19,781,384,397,73,74,57,19,1
24943,327,160,167,56,31,36,15,577,277,300,71,59,64,24,1
24944,246,108,138,32,44,21,10,724,320,404,120,147,67,25,1
24945,114,58,56,20,14,5,6,484,259,225,69,44,60,21,1
24946,583,322,261,73,66,45,26,855,456,399,96,105,108,47,1
24947,403,191,212,64,66,22,16,723,309,414,106,106,41,40,1
24948,561,278,283,75,60,63,25,96,45,51,13,12,6,4,1
24949,750,347,403,105,103,83,29,787,386,401,98,95,86,25,1
24950,443,248,195,67,54,40,15,906,455,451,116,105,87,46,1
24951,1477,738,739,176,176,145,72,1272,561,711,178,194,101,34,1
24952,453,242,211,59,47,49,11,181,96,85,25,23,20,7,1
24953,700,335,365,83,84,95,33,180,77,103,30,29,23,5,1
24954,102,61,41,15,13,8,2,769,329,440,116,66,55,22,1
24955,500,242,258,53,48,44,18,705,357,348,90,84,100,41,1
24956,345,141,204,64,58,13,11,1106,579,527,121,152,113,45,1
24957,277,100,177,35,88,30,2,249,90,159,29,89,12,4,1
24958,98,41,57,19,19,8,2,155,74,81,23,19,20,5,1
24959,2414,1189,1225,277,178,170,169,429,223,206,50,32,46,17,1
24960,164,78,86,28,23,12,8,770,374,396,95,91,79,41,1
24961,277,124,153,44,40,35,18,825,399,426,128,128,77,32,1
24962,503,263,240,72,55,51,34,367,181,186,63,51,37,20,1
24963,345,155,190,49,56,23,6,344,151,193,59,51,30,9,1
24964,178,100,78,23,22,30,6,604,320,284,80,62,90,28,1
24965,316,198,118,23,20,54,12,335,128,207,59,43,24,23,1
24966,538,252,286,77,87,53,30,246,128,118,39,34,22,7,1
24967,345,203,142,47,35,31,11,269,156,113,37,32,17,7,1
24968,435,222,213,67,49,67,12,734,366,368,121,99,63,39,1
24969,834,405,429,112,95,84,34,593,266,327,102,84,69,24,1
24970,546,279,267,94,60,32,22,861,393,468,150,101,69,35,1
24971,450,129,321,128,70,43,15,2524,1232,1292,398,317,186,61,1
24972,1074,538,536,190,131,157,35,143,79,64,16,25,7,5,1
24973,467,226,241,55,48,54,23,399,201,198,65,45,48,17,1
24974,509,254,255,67,55,52,35,214,109,105,31,26,25,17,1
24975,784,337,447,127,135,59,29,212,107,105,29,26,25,8,1
24976,168,76,92,26,21,19,4,233,121,112,24,31,30,7,1
24977,466,242,224,66,53,53,13,158,85,73,24,18,18,8,1
24978,1066,587,479,127,108,118,48,2477,1186,1291,256,271,249,90,1
24979,535,354,181,39,39,68,23,685,337,348,86,84,100,28,1
24980,909,455,454,137,82,85,68,894,420,474,136,146,93,39,1
24981,277,124,153,44,40,35,18,331,145,186,40,56,16,9,1
24982,398,203,195,58,43,54,16,271,126,145,33,38,31,10,1
24983,747,371,376,87,134,54,29,337,171,166,46,27,33,16,1
24984,1030,566,464,119,107,96,49,530,259,271,83,50,54,41,1
24985,451,223,228,56,56,52,17,605,295,310,74,66,70,36,1
24986,839,408,431,138,122,105,46,193,99,94,31,31,16,12,1
24987,277,100,177,35,88,30,2,262,136,126,41,24,23,17,1
24988,1098,519,579,182,159,79,42,641,324,317,88,92,49,14,1
24989,355,168,187,48,57,30,15,352,166,186,55,59,31,16,1
24990,508,267,241,43,35,25,17,551,298,253,63,65,45,19,1
24991,2351,1110,1241,337,269,300,87,417,182,235,57,109,50,8,1
24992,672,334,338,110,93,91,41,736,388,348,88,85,67,28,1
24993,1722,774,948,199,192,158,167,2477,1186,1291,256,271,249,90,1
24994,1508,733,775,216,186,172,60,294,148,146,35,33,25,14,1
24995,186,99,87,30,17,18,8,201,88,113,33,27,20,8,1
24996,1194,609,585,195,142,105,37,428,226,202,52,60,75,20,1
24997,304,159,145,38,40,32,3,1085,529,556,149,133,126,54,1
24998,386,203,183,50,46,58,17,402,227,175,48,40,35,11,1
24999,351,183,168,50,46,37,16,377,184,193,56,53,44,14,1
25000,573,316,257,78,80,21,21,786,378,408,101,79,104,35,1
25001,267,161,106,22,25,35,20,4544,2024,2520,579,628,480,403,1
25002,360,188,172,49,48,47,17,413,227,186,47,64,26,16,1
25003,1132,646,486,99,102,71,41,443,208,235,43,55,51,50,1
25004,95,41,54,15,16,8,5,410,200,210,60,54,46,19,1
25005,535,249,286,79,64,55,22,161,73,88,23,22,15,8,1
25006,866,417,449,131,126,92,39,1004,498,506,94,59,46,33,1
25007,185,115,70,19,17,26,6,204,99,105,32,32,22,10,1
25008,425,210,215,56,43,52,25,285,109,176,54,80,9,9,1
25009,150,74,76,21,22,18,7,1047,562,485,141,127,114,41,1
25010,1247,620,627,134,149,142,58,717,469,248,92,67,22,21,1
25011,341,178,163,48,44,42,20,239,146,93,30,22,35,9,1
25012,603,282,321,74,68,60,38,595,316,279,86,60,65,40,1
25013,767,392,375,113,112,83,13,1336,828,508,166,121,152,48,1
25014,79,38,41,19,11,17,4,395,222,173,48,42,21,8,1
25015,448,223,225,50,58,39,34,568,243,325,98,73,56,44,1
25016,583,322,261,73,66,45,26,770,355,415,103,142,75,42,1
25017,1394,717,677,194,190,135,53,356,199,157,43,58,29,12,1
25018,400,191,209,51,60,30,9,451,222,229,58,55,51,17,1
25019,467,226,241,55,48,54,23,388,245,143,45,25,41,16,1
25020,399,202,197,43,40,40,19,1663,835,828,224,213,163,63,1
25021,308,165,143,43,30,45,28,430,218,212,58,47,34,20,1
25022,553,311,242,75,44,82,28,180,77,103,30,29,23,5,1
25023,729,321,408,128,84,63,26,504,290,214,60,50,46,21,1
25024,110,67,43,9,10,11,8,928,442,486,139,118,91,43,1
25025,330,159,171,48,38,50,19,301,150,151,45,47,33,13,1
25026,308,160,148,39,46,30,12,871,437,434,112,113,83,49,1
25027,125,60,65,22,17,14,5,176,73,103,22,29,13,9,1
25028,1132,553,579,172,143,150,57,1265,580,685,205,188,166,53,1
25029,326,182,144,42,37,39,15,390,203,187,58,40,43,19,1
25030,927,451,476,141,147,69,34,720,356,364,90,98,61,22,1
25031,582,273,309,85,67,34,19,648,307,341,101,58,76,34,1
25032,390,191,199,57,49,45,25,569,283,286,40,16,60,7,1
25033,859,398,461,96,109,89,57,230,119,111,30,29,26,12,1
25034,358,204,154,57,41,36,14,551,298,253,63,65,45,19,1
25035,1116,539,577,149,161,115,43,654,317,337,95,111,44,13,1
25036,552,285,267,74,51,69,24,347,133,214,64,60,29,9,1
25037,585,277,308,92,73,61,32,519,219,300,86,72,50,39,1
25038,200,89,111,26,25,17,7,736,362,374,115,83,86,31,1
25039,114,53,61,17,6,5,6,333,198,135,33,15,63,17,1
25040,2261,1217,1044,271,243,267,101,817,425,392,120,102,83,26,1
25041,359,150,209,57,75,29,12,726,312,414,121,73,82,23,1
25042,455,218,237,57,51,42,35,1074,538,536,154,140,111,51,1
25043,686,345,341,98,106,75,25,5038,2652,2386,655,729,544,245,1
25044,159,72,87,52,7,10,5,2045,985,1060,359,339,199,74,1
25045,1025,527,498,120,122,142,40,1166,597,569,181,132,123,45,1
25046,358,180,178,57,55,39,11,641,324,317,88,92,49,14,1
25047,347,154,193,48,51,25,11,520,224,296,69,64,31,29,1
25048,136,66,70,33,11,9,3,1047,475,572,176,183,110,39,1
25049,365,180,185,63,35,48,19,1075,515,560,126,106,107,40,1
25050,1085,646,439,108,65,36,19,109,50,59,12,12,9,3,1
25051,595,316,279,86,60,65,40,803,358,445,135,117,80,44,1
25052,707,391,316,111,80,54,30,526,268,258,54,37,55,12,1
25053,2442,1193,1249,278,183,170,145,748,360,388,101,89,82,36,1
25054,857,455,402,135,81,104,40,859,438,421,142,80,105,43,1
25055,443,208,235,43,55,51,50,921,534,387,104,95,101,38,1
25056,323,181,142,40,37,26,16,382,179,203,58,54,29,19,1
25057,529,264,265,59,68,41,17,641,324,317,88,92,49,14,1
25058,496,269,227,67,55,37,19,1189,559,630,179,147,118,35,1
25059,115,67,48,10,7,12,7,393,186,207,58,50,36,22,1
25060,1161,620,541,119,120,119,47,769,362,407,99,88,66,67,1
25061,697,373,324,105,83,95,38,483,274,209,54,39,45,13,1
25062,1377,579,798,179,169,139,99,552,285,267,74,51,69,24,1
25063,673,313,360,101,101,46,17,386,189,197,54,57,39,16,1
25064,207,105,102,35,27,15,5,921,455,466,144,127,108,39,1
25065,1149,568,581,177,133,101,30,508,267,241,57,49,40,13,1
25066,549,290,259,64,61,62,15,417,231,186,37,32,43,18,1
25067,858,398,460,126,138,75,39,448,236,212,53,64,56,24,1
25068,1244,674,570,145,141,131,42,603,311,292,102,71,66,23,1
25069,756,444,312,95,64,60,17,1134,574,560,157,164,47,48,1
25070,1538,704,834,239,176,120,42,281,137,144,39,41,34,11,1
25071,234,93,141,42,26,17,15,601,313,288,42,48,25,36,1
25072,1201,557,644,151,125,117,50,846,356,490,102,79,88,34,1
25073,711,344,367,87,109,74,24,573,247,326,98,95,46,22,1
25074,1647,794,853,279,235,128,65,411,171,240,61,81,30,15,1
25075,467,261,206,54,49,48,24,596,286,310,90,89,78,37,1
25076,1475,658,817,149,114,120,43,619,290,329,97,79,62,19,1
25077,262,150,112,31,33,31,7,451,225,226,68,57,65,22,1
25078,522,235,287,78,67,60,50,635,333,302,99,75,83,28,1
25079,385,248,137,30,24,36,29,155,89,66,13,15,17,9,1
25080,743,407,336,99,85,98,32,373,183,190,49,45,41,19,1
25081,766,395,371,89,86,127,27,93,46,47,6,8,8,8,1
25082,191,99,92,25,24,18,8,2548,1117,1431,444,335,260,93,1
25083,428,226,202,52,60,75,20,653,311,342,106,74,52,28,1
25084,339,170,169,32,17,24,13,529,264,265,59,68,41,17,1
25085,1164,531,633,179,157,107,46,255,122,133,35,51,22,13,1
25086,703,253,450,130,124,51,32,703,356,347,96,97,38,22,1
25087,154,77,77,35,17,20,9,94,55,39,18,6,18,5,1
25088,1367,690,677,172,175,154,83,450,241,209,67,58,54,23,1
25089,200,90,110,22,29,10,13,380,187,193,38,51,30,18,1
25090,309,137,172,51,50,28,14,327,177,150,40,40,38,18,1
25091,333,127,206,66,68,25,14,431,186,245,79,83,37,18,1
25092,149,68,81,15,38,11,10,553,311,242,75,44,82,28,1
25093,1390,705,685,219,164,129,74,881,419,462,132,82,81,24,1
25094,379,203,176,55,48,45,16,529,264,265,59,68,41,17,1
25095,316,156,160,43,42,28,17,822,417,405,112,97,88,40,1
25096,374,202,172,58,40,41,7,729,321,408,128,84,63,26,1
25097,1464,693,771,153,136,91,86,246,113,133,33,45,22,10,1
25098,1657,800,857,249,235,154,51,312,147,165,52,44,12,13,1
25099,523,273,250,73,68,44,13,218,108,110,28,28,22,10,1
25100,684,288,396,107,90,54,42,789,395,394,121,102,81,33,1
25101,447,222,225,71,54,44,25,479,300,179,52,37,63,18,1
25102,156,74,82,24,18,16,22,133,69,64,25,18,10,5,1
25103,231,126,105,37,26,29,6,240,125,115,34,32,30,8,1
25104,544,295,249,84,56,49,14,236,123,113,36,33,26,8,1
25105,410,211,199,55,42,34,27,1328,648,680,220,151,112,40,1
25106,585,299,286,92,73,89,23,359,169,190,55,37,37,33,1
25107,443,248,195,67,54,40,15,390,191,199,66,49,43,12,1
25108,272,149,123,34,35,21,2,1071,549,522,133,127,130,59,1
25109,885,424,461,143,114,92,32,96,50,46,8,15,6,2,1
25110,651,306,345,85,64,61,32,912,460,452,139,132,89,53,1
25111,201,111,90,25,29,26,13,181,96,85,25,23,20,7,1
25112,205,106,99,28,26,23,3,461,227,234,61,47,54,33,1
25113,1004,498,506,94,59,46,33,209,78,131,33,42,11,7,1
25114,356,142,214,55,47,29,16,205,94,111,29,31,16,7,1
25115,2414,1189,1225,277,178,170,169,427,236,191,49,54,46,13,1
25116,987,515,472,107,110,106,61,776,346,430,103,102,61,40,1
25117,437,230,207,41,55,27,13,305,168,137,48,35,40,9,1
25118,863,458,405,97,82,63,57,526,264,262,77,71,61,27,1
25119,522,266,256,64,57,59,26,1891,1066,825,207,184,181,83,1
25120,686,345,341,98,106,75,25,998,496,502,149,146,89,27,1
25121,282,135,147,36,49,25,10,248,118,130,54,31,26,5,1
25122,781,418,363,92,90,64,41,1499,864,635,141,99,76,110,1
25123,450,129,321,128,70,43,15,301,119,182,53,47,14,20,1
25124,458,222,236,69,39,35,18,356,208,148,42,26,57,15,1
25125,694,315,379,101,87,47,17,586,240,346,94,110,29,19,1
25126,136,66,70,33,11,9,5,204,103,101,16,32,22,8,1
25127,518,235,283,94,77,55,22,147,78,69,19,15,19,7,1
25128,247,110,137,34,45,23,10,795,384,411,133,109,85,38,1
25129,395,197,198,44,57,27,18,462,186,276,73,62,38,15,1
25130,758,360,398,114,107,51,19,876,473,403,110,106,73,24,1
25131,462,229,233,63,49,42,18,1255,666,589,145,142,120,82,1
25132,360,218,142,39,26,50,18,107,58,49,18,3,2,7,1
25133,565,285,280,72,73,47,31,1050,482,568,136,154,101,41,1
25134,391,208,183,65,49,57,17,587,300,287,67,102,34,20,1
25135,509,341,168,35,32,52,15,515,282,233,72,48,68,21,1
25136,473,248,225,64,50,38,24,206,92,114,37,36,19,7,1
25137,330,208,122,44,20,44,12,245,111,134,31,44,20,11,1
25138,327,185,142,43,28,53,29,475,247,228,62,45,75,24,1
25139,775,324,451,130,140,45,15,202,102,100,29,35,6,9,1
25140,204,103,101,16,32,22,8,771,331,440,136,104,72,27,1
25141,1258,648,610,172,159,116,28,1390,695,695,180,137,170,71,1
25142,687,353,334,84,96,74,31,101,43,58,18,16,12,7,1
25143,569,290,279,86,58,61,16,270,133,137,42,37,34,8,1
25144,247,110,137,34,45,23,10,776,346,430,103,102,61,40,1
25145,199,107,92,41,15,14,8,538,292,246,69,57,52,39,1
25146,2058,933,1125,317,304,250,74,149,67,82,19,37,11,10,1
25147,306,144,162,52,35,40,16,838,431,407,107,90,107,43,1
25148,1140,586,554,130,146,117,49,730,329,401,96,64,63,36,1
25149,709,294,415,132,123,76,23,863,418,445,127,114,70,31,1
25150,289,156,133,39,27,34,11,497,232,265,84,73,45,19,1
25151,400,208,192,62,44,42,21,1807,933,874,248,203,173,71,1
25152,919,538,381,111,98,103,41,593,266,327,102,84,69,24,1
25153,318,176,142,25,32,35,25,516,296,220,79,59,69,16,1
25154,258,133,125,24,13,30,11,226,137,89,20,20,18,5,1
25155,837,464,373,104,72,85,49,406,209,197,57,50,50,17,1
25156,571,298,273,81,72,57,25,166,81,85,30,27,13,8,1
25157,244,123,121,36,24,27,16,464,231,233,65,62,49,21,1
25158,917,470,447,139,135,88,63,803,358,445,135,117,80,44,1
25159,652,342,310,71,68,66,17,338,179,159,44,45,42,16,1
25160,694,360,334,90,88,77,32,323,181,142,40,37,26,16,1
25161,297,183,114,31,15,46,24,132,57,75,25,9,6,13,1
25162,168,67,101,37,17,13,13,317,153,164,39,30,35,13,1
25163,382,190,192,59,48,40,21,654,344,310,80,69,57,15,1
25164,391,189,202,73,47,37,8,671,326,345,111,77,74,11,1
25165,222,123,99,32,20,32,6,259,143,116,39,37,23,9,1
25166,536,278,258,72,63,62,20,419,175,244,71,73,23,23,1
25167,538,252,286,77,87,53,30,416,201,215,54,52,39,25,1
25168,377,224,153,52,23,51,20,536,278,258,72,63,62,20,1
25169,2524,1232,1292,398,317,186,61,482,224,258,71,62,52,39,1
25170,754,412,342,92,53,110,49,185,89,96,28,19,17,13,1
25171,583,322,261,73,66,45,26,787,386,401,98,95,86,25,1
25172,451,235,216,64,49,38,21,500,236,264,85,69,33,17,1
25173,277,124,153,44,40,35,18,2225,1244,981,271,243,217,93,1
25174,701,392,309,98,75,104,30,702,298,404,134,111,48,18,1
25175,790,343,447,90,191,35,17,136,66,70,33,11,9,5,1
25176,915,336,579,185,199,56,29,595,316,279,86,60,65,40,1
25177,690,310,380,114,85,66,27,900,484,416,119,110,77,29,1
25178,351,184,167,59,45,54,9,377,211,166,45,46,51,20,1
25179,247,110,137,34,45,23,10,887,439,448,131,119,98,39,1
25180,207,105,102,35,27,15,5,767,392,375,113,112,83,13,1
25181,938,484,454,137,100,104,41,697,373,324,105,83,95,38,1
25182,1275,579,696,200,172,125,51,839,439,400,101,86,102,43,1
25183,1914,892,1022,272,267,143,79,149,68,81,15,38,11,10,1
25184,356,142,214,55,47,29,16,277,128,149,40,47,15,6,1
25185,2033,877,1156,359,333,106,44,585,214,371,77,124,34,8,1
25186,124,62,62,17,14,7,5,602,310,292,87,66,70,36,1
25187,330,143,187,63,29,52,20,1029,482,547,147,158,71,32,1
25188,1412,603,809,184,195,112,45,467,226,241,55,48,54,23,1
25189,240,125,115,34,32,30,8,526,264,262,77,71,61,27,1
25190,1210,592,618,157,138,116,85,1640,855,785,215,212,201,77,1
25191,351,184,167,59,45,54,9,207,114,93,33,20,31,13,1
25192,231,126,105,37,26,29,6,632,326,306,92,71,56,19,1
25193,736,388,348,88,85,67,28,471,231,240,76,58,44,8,1
25194,270,128,142,36,43,15,11,1270,557,713,130,195,57,30,1
25195,180,93,87,24,22,19,8,756,366,390,83,146,47,23,1
25196,767,392,375,113,112,83,13,653,326,327,83,96,83,27,1
25197,665,297,368,111,107,34,12,870,489,381,97,99,76,14,1
25198,202,102,100,29,35,6,9,731,338,393,114,126,53,17,1
25199,552,285,267,74,51,69,24,393,196,197,56,47,41,26,1
25200,95,44,51,14,13,7,4,440,237,203,55,66,44,12,1
25201,1203,651,552,151,128,123,46,854,380,474,137,159,81,31,1
25202,455,229,226,66,62,63,29,770,355,415,103,142,75,42,1
25203,342,190,152,41,20,50,18,355,165,190,53,56,42,19,1
25204,225,102,123,32,32,31,15,841,427,414,112,88,56,25,1
25205,400,201,199,51,34,36,42,237,148,89,34,10,12,10,1
25206,189,90,99,26,29,17,11,524,237,287,87,75,54,26,1
25207,1400,800,600,158,134,150,65,217,109,108,34,32,35,7,1
25208,427,214,213,65,58,26,18,428,223,205,59,67,23,16,1
25209,393,186,207,58,50,36,22,318,164,154,52,43,34,10,1
25210,788,360,428,93,106,67,72,1231,603,628,121,162,109,120,1
25211,33423,16370,17053,4965,4756,2786,883,377,202,175,46,50,41,23,1
25212,316,201,115,29,31,12,6,320,163,157,44,44,26,15,1
25213,241,106,135,48,29,17,15,189,90,99,26,29,17,11,1
25214,2261,1217,1044,271,243,267,101,1591,704,887,253,227,156,50,1
25215,253,123,130,40,46,15,4,268,113,155,34,37,14,9,1
25216,491,233,258,73,58,56,30,866,382,484,116,114,91,28,1
25217,1241,670,571,135,139,110,32,1657,800,857,249,235,154,51,1
25218,330,143,187,63,29,52,20,1072,538,534,145,128,106,68,1
25219,509,254,255,67,55,52,35,189,93,96,24,28,17,12,1
25220,756,265,491,129,127,51,17,261,130,131,27,41,19,16,1
25221,1243,633,610,149,160,87,39,220,142,78,15,12,17,15,1
25222,1395,627,768,172,263,141,59,590,298,292,73,45,71,25,1
25223,1395,579,816,166,234,132,62,371,237,134,31,25,43,17,1
25224,714,364,350,98,102,91,27,279,106,173,48,35,41,39,1
25225,256,153,103,19,23,23,8,463,238,225,49,35,31,14,1
25226,297,158,139,47,37,37,9,592,264,328,86,85,62,41,1
25227,742,303,439,88,96,86,23,751,390,361,116,98,80,34,1
25228,545,289,256,75,72,42,22,430,237,193,56,36,33,24,1
25229,2351,1110,1241,337,269,300,87,4544,2024,2520,579,628,480,403,1
25230,740,377,363,118,94,62,29,100,51,49,13,11,7,4,1
25231,245,112,133,32,45,20,10,560,334,226,69,37,52,18,1
25232,659,325,334,102,85,87,32,502,299,203,57,52,32,11,1
25233,754,318,436,114,106,58,28,1863,721,1142,262,283,139,74,1
25234,862,335,527,136,169,47,28,825,422,403,100,90,62,43,1
25235,330,208,122,44,20,44,12,248,119,129,33,48,20,10,1
25236,390,203,187,58,40,43,19,349,166,183,49,37,25,52,1
25237,354,137,217,53,57,30,5,2161,1233,928,269,199,178,42,1
25238,583,322,261,73,66,45,26,217,109,108,34,30,34,5,1
25239,240,125,115,34,32,30,8,391,203,188,49,48,41,14,1
25240,686,345,341,98,106,75,25,473,245,228,67,52,70,24,1
25241,297,158,139,47,37,37,9,863,418,445,127,114,70,31,1
25242,509,341,168,35,32,52,15,243,154,89,26,23,28,5,1
25243,229,105,124,36,33,12,4,440,218,222,58,66,40,24,1
25244,822,417,405,111,127,76,34,179,96,83,21,18,19,6,1
25245,2376,1263,1113,304,241,264,115,462,228,234,59,47,37,32,1
25246,2016,1107,909,214,229,238,111,817,425,392,120,102,83,26,1
25247,863,458,405,97,82,63,57,536,278,258,72,63,62,20,1
25248,176,84,92,46,10,28,11,331,169,162,40,28,22,14,1
25249,920,492,428,100,92,88,49,601,290,311,92,89,55,30,1
25250,970,484,486,131,134,78,28,193,99,94,31,31,16,12,1
25251,350,224,126,34,14,48,18,195,100,95,26,39,20,4,1
25252,322,143,179,41,62,23,11,3418,1378,2040,515,464,318,121,1
25253,1202,506,696,209,198,74,44,1116,413,703,214,213,53,41,1
25254,238,151,87,21,16,24,24,207,108,99,25,15,27,16,1
25255,218,127,91,27,23,23,10,977,492,485,135,122,116,35,1
25256,288,120,168,54,52,21,12,206,85,121,31,42,6,17,1
25257,294,148,146,35,33,25,14,92,46,46,14,9,8,6,1
25258,671,321,350,95,87,75,34,969,505,464,123,133,92,33,1
25259,732,366,366,108,86,74,41,926,435,491,133,132,85,17,1
25260,393,185,208,55,64,37,21,261,130,131,27,41,19,16,1
25261,798,287,511,126,125,77,26,468,233,235,65,61,49,34,1
25262,276,142,134,30,23,28,11,113,66,47,11,9,6,5,1
25263,422,213,209,63,60,35,13,652,272,380,116,113,55,27,1
25264,556,259,297,75,69,63,38,177,99,78,22,23,20,10,1
25265,258,113,145,43,44,16,7,534,285,249,87,77,59,16,1
25266,793,400,393,113,92,120,37,654,317,337,95,111,44,13,1
25267,365,188,177,60,47,48,16,725,339,386,112,122,93,32,1
25268,871,482,389,113,95,109,35,749,306,443,155,121,31,10,1
25269,466,186,280,71,84,30,11,351,184,167,59,45,54,9,1
25270,448,275,173,32,53,55,27,2639,1436,1203,317,307,242,77,1
25271,1170,510,660,142,182,115,84,622,299,323,86,86,69,35,1
25272,2442,1193,1249,278,183,170,145,271,110,161,33,27,11,8,1
25273,785,419,366,105,90,64,31,158,82,76,25,26,19,12,1
25274,507,235,272,74,71,48,21,96,50,46,8,15,6,2,1
25275,489,242,247,83,63,62,19,441,216,225,57,66,57,19,1
25276,142,74,68,21,20,24,7,951,506,445,107,118,79,40,1
25277,329,171,158,49,41,31,10,632,326,306,92,71,56,19,1
25278,1675,875,800,213,219,196,72,418,204,214,68,66,38,12,1
25279,324,174,150,37,24,35,27,902,332,570,154,146,75,40,1
25280,63,33,30,12,11,5,1,393,186,207,58,50,36,22,1
25281,289,164,125,37,31,35,16,393,186,207,58,50,36,22,1
25282,603,291,312,98,87,61,28,292,152,140,46,38,35,12,1
25283,589,314,275,70,83,44,28,425,210,215,56,43,52,25,1
25284,873,366,507,127,125,75,21,1336,724,612,209,141,133,60,1
25285,246,108,138,32,44,21,10,282,135,147,36,49,25,10,1
25286,707,386,321,85,83,99,28,107,58,49,17,4,2,6,1
25287,509,243,266,80,57,45,19,536,278,258,72,63,62,20,1
25288,1298,591,707,196,168,124,58,3122,1625,1497,374,265,205,79,1
25289,119,86,33,6,1,4,5,303,175,128,43,36,34,12,1
25290,509,245,264,85,71,56,22,609,292,317,102,96,64,21,1
25291,583,322,261,73,66,45,26,369,181,188,41,36,54,16,1
25292,1102,552,550,174,137,137,45,918,427,491,113,111,113,33,1
25293,1098,519,579,182,159,79,42,510,264,246,67,66,38,29,1
25294,963,532,431,99,110,105,44,436,201,235,54,37,34,20,1
25295,190,74,116,34,29,11,11,205,118,87,35,14,11,11,1
25296,1441,657,784,140,135,81,73,490,224,266,80,70,39,32,1
25297,546,267,279,90,69,56,19,182,84,98,20,52,9,9,1
25298,294,164,130,42,39,22,7,806,436,370,101,100,76,34,1
25299,552,285,267,74,51,69,24,507,242,265,53,44,31,22,1
25300,306,155,151,43,34,36,17,769,329,440,116,66,55,22,1
25301,858,398,460,126,138,75,39,410,186,224,72,57,52,22,1
25302,191,72,119,40,41,17,8,605,281,324,111,67,40,44,1
25303,374,191,183,70,48,61,13,249,90,159,29,89,12,4,1
25304,643,282,361,94,109,59,24,757,359,398,109,127,80,26,1
25305,271,110,161,33,27,11,8,350,180,170,64,46,55,12,1
25306,2440,1061,1379,377,326,172,62,728,358,370,118,100,55,29,1
25307,400,228,172,43,20,47,24,377,184,193,56,53,44,14,1
25308,530,259,271,83,50,54,41,1158,481,677,169,129,86,40,1
25309,267,161,106,22,25,35,20,458,222,236,69,39,35,18,1
25310,615,293,322,70,67,45,29,920,492,428,100,92,88,49,1
25311,208,101,107,38,28,24,7,648,307,341,101,58,76,34,1
25312,525,245,280,59,72,47,21,705,356,349,111,97,84,36,1
25313,404,190,214,50,54,35,13,275,140,135,34,24,32,15,1
25314,484,192,292,118,68,83,22,435,208,227,68,64,53,23,1
25315,466,186,280,71,84,30,11,332,173,159,48,40,31,11,1
25316,288,159,129,27,44,27,15,738,400,338,102,98,109,25,1
25317,501,240,261,80,62,49,42,520,279,241,62,72,35,25,1
25318,317,164,153,47,33,47,12,956,473,483,140,88,89,78,1
25319,591,279,312,88,91,52,26,231,126,105,37,26,29,6,1
25320,815,382,433,97,50,88,31,832,428,404,131,89,88,38,1
25321,1179,579,600,140,133,122,53,2541,1299,1242,306,302,121,98,1
25322,512,261,251,79,73,60,21,631,309,322,106,83,89,33,1
25323,366,183,183,48,47,36,17,119,57,62,18,16,17,4,1
25324,201,108,93,36,21,17,4,183,115,68,21,12,22,6,1
25325,333,192,141,50,48,28,10,4655,2074,2581,545,652,562,399,1
25326,704,356,348,112,94,71,24,718,390,328,93,86,94,30,1
25327,247,110,137,34,45,23,10,622,309,313,75,81,76,29,1
25328,950,450,500,110,157,82,50,307,162,145,38,46,41,15,1
25329,356,142,214,55,47,29,16,205,91,114,31,32,23,12,1
25330,406,211,195,55,37,47,16,453,216,237,58,60,67,20,1
25331,1233,498,735,252,232,88,41,1863,721,1142,262,283,139,74,1
25332,841,329,512,137,163,35,26,467,226,241,55,48,54,23,1
25333,987,515,472,107,110,106,61,2985,1374,1611,450,433,312,111,1
25334,666,370,296,84,61,99,51,333,192,141,50,48,28,10,1
25335,270,137,133,30,28,27,11,770,374,396,95,91,79,41,1
25336,261,162,99,24,21,14,10,770,355,415,103,142,75,42,1
25337,744,385,359,125,89,90,23,317,153,164,34,52,30,14,1
25338,485,273,212,52,47,51,17,957,485,472,111,119,127,29,1
25339,334,190,144,42,42,16,5,339,170,169,32,17,24,13,1
25340,757,373,384,115,93,95,25,814,343,471,133,101,80,41,1
25341,2477,1186,1291,256,271,249,90,1487,996,491,147,141,50,35,1
25342,583,279,304,99,71,59,31,1014,490,524,177,137,94,38,1
25343,1106,579,527,121,152,113,45,750,347,403,105,103,83,29,1
25344,178,100,78,23,22,30,6,503,263,240,72,55,51,34,1
25345,462,251,211,74,53,41,18,330,159,171,48,38,50,19,1
25346,624,308,316,92,72,68,22,897,487,410,92,97,83,31,1
25347,182,90,92,25,23,14,5,769,329,440,116,66,55,22,1
25348,1647,794,853,279,235,128,65,436,201,235,54,37,34,20,1
25349,885,424,461,143,114,92,32,291,146,145,39,45,22,16,1
25350,343,200,143,30,29,36,14,1270,557,713,130,195,57,30,1
25351,288,118,170,50,57,18,15,941,448,493,150,118,127,39,1
25352,1084,537,547,154,121,92,35,283,141,142,32,26,23,26,1
25353,976,496,480,128,111,121,48,508,295,213,42,61,53,17,1
25354,894,469,425,127,93,82,31,526,268,258,54,37,55,12,1
25355,459,262,197,46,68,38,11,781,418,363,92,90,64,41,1
25356,377,171,206,46,59,22,6,631,332,299,61,104,60,19,1
25357,464,244,220,61,56,46,20,775,407,368,122,100,97,32,1
25358,503,263,240,72,55,51,34,292,108,184,47,64,19,15,1
25359,1462,652,810,243,199,115,30,1047,562,485,141,127,114,41,1
25360,724,261,463,135,139,39,20,742,303,439,88,96,86,23,1
25361,675,305,370,114,109,60,21,233,111,122,38,27,17,8,1
25362,392,156,236,40,91,28,16,1058,497,561,194,142,87,63,1
25363,432,181,251,48,75,27,17,583,322,261,73,66,45,26,1
25364,285,148,137,31,42,42,16,326,166,160,49,45,36,12,1
25365,603,311,292,102,71,66,23,448,236,212,53,64,56,24,1
25366,666,347,319,92,73,63,25,441,216,225,57,66,57,19,1
25367,568,243,325,98,73,56,44,184,87,97,19,21,12,17,1
25368,245,112,133,32,45,20,10,450,263,187,52,38,54,16,1
25369,1190,638,552,162,95,112,18,810,345,465,104,99,83,103,1
25370,360,218,142,39,26,50,18,1848,833,1015,304,257,195,71,1
25371,1537,701,836,209,187,129,58,1034,451,583,165,146,104,40,1
25372,280,156,124,36,19,20,13,536,287,249,64,73,21,27,1
25373,1095,530,565,157,151,98,34,205,114,91,25,24,20,15,1
25374,652,332,320,72,59,57,24,1290,629,661,191,187,167,55,1
25375,807,359,448,114,99,93,33,845,402,443,137,126,105,47,1
25376,351,184,167,59,45,54,9,215,117,98,43,22,27,5,1
25377,684,274,410,105,135,37,21,297,123,174,51,49,16,10,1
25378,288,159,129,27,44,27,15,389,207,182,55,47,53,23,1
25379,222,123,99,32,20,32,6,213,76,137,63,36,13,2,1
25380,547,290,257,94,65,64,28,465,225,240,65,44,65,25,1
25381,247,110,137,34,45,23,10,778,353,425,140,89,92,51,1
25382,298,167,131,47,33,40,8,410,208,202,59,58,43,26,1
25383,391,212,179,40,45,47,10,467,269,198,46,51,60,18,1
25384,418,189,229,76,72,45,14,522,239,283,75,88,45,11,1
25385,424,191,233,76,73,49,13,864,429,435,129,118,68,35,1
25386,253,148,105,31,15,39,16,255,134,121,36,40,29,13,1
25387,517,249,268,65,59,58,26,743,341,402,104,89,68,38,1
25388,568,193,375,112,83,50,15,367,161,206,70,48,41,19,1
25389,692,326,366,103,121,67,27,295,143,152,38,47,22,25,1
25390,574,269,305,91,63,54,27,863,418,445,127,114,70,31,1
25391,659,325,334,102,85,87,32,556,300,256,58,73,55,22,1
25392,969,505,464,123,133,92,33,500,268,232,65,56,28,17,1
25393,894,492,402,95,103,88,42,1290,629,661,191,187,167,55,1
25394,344,181,163,61,37,40,14,767,379,388,119,106,75,35,1
25395,1192,649,543,153,145,116,57,184,91,93,26,25,16,7,1
25396,297,160,137,27,33,26,19,512,261,251,79,73,60,21,1
25397,349,152,197,55,47,27,13,750,347,403,105,103,83,29,1
25398,1332,637,695,214,178,117,40,246,108,138,32,44,21,10,1
25399,2414,1189,1225,277,178,170,169,477,232,245,67,64,70,30,1
25400,671,318,353,83,124,46,34,182,84,98,20,52,9,9,1
25401,249,90,159,29,89,12,4,1071,549,522,133,127,130,59,1
25402,907,442,465,139,105,106,33,451,223,228,56,56,52,17,1
25403,527,257,270,72,68,50,28,414,211,203,52,49,40,19,1
25404,673,391,282,70,57,40,25,390,203,187,58,40,43,19,1
25405,347,198,149,45,29,29,8,271,136,135,37,30,18,10,1
25406,402,227,175,48,40,35,11,357,206,151,49,36,31,20,1
25407,592,291,301,92,93,71,31,390,191,199,66,49,43,12,1
25408,982,545,437,119,100,92,40,638,305,333,68,90,70,29,1
25409,445,198,247,85,67,38,19,2442,933,1509,388,478,90,56,1
25410,231,126,105,28,26,34,9,452,256,196,32,44,27,11,1
25411,261,121,140,35,48,28,12,729,412,317,85,76,92,36,1
25412,1369,651,718,219,182,129,41,561,281,280,80,71,36,14,1
25413,238,127,111,25,18,33,8,461,221,240,70,64,56,32,1
25414,982,545,437,119,100,92,40,219,104,115,43,32,24,11,1
25415,625,286,339,92,59,83,42,427,186,241,55,52,42,23,1
25416,415,189,226,69,54,50,21,1106,579,527,121,152,113,45,1
25417,168,67,101,37,17,13,13,479,202,277,94,99,30,5,1
25418,180,96,84,21,22,17,15,1304,585,719,179,169,154,47,1
25419,930,367,563,181,153,83,48,125,63,62,20,16,15,7,1
25420,590,279,311,103,83,69,30,200,91,109,29,34,24,7,1
25421,361,184,177,50,53,51,22,526,268,258,54,37,55,12,1
25422,205,118,87,24,23,20,20,603,311,292,102,71,66,23,1
25423,560,260,300,100,58,29,28,808,366,442,130,133,66,31,1
25424,161,73,88,23,22,15,8,772,323,449,174,108,68,22,1
25425,338,192,146,41,29,22,14,471,238,233,66,63,62,19,1
25426,695,373,322,80,59,89,39,689,343,346,119,100,86,38,1
25427,642,271,371,106,111,57,23,1233,498,735,252,232,88,41,1
25428,257,118,139,44,28,23,11,262,123,139,44,32,25,18,1
25429,551,286,265,62,55,51,23,432,218,214,57,55,42,11,1
25430,332,206,126,36,30,30,12,189,102,87,28,17,22,5,1
25431,746,361,385,91,92,101,32,3075,1459,1616,390,359,298,207,1
25432,299,128,171,57,40,13,25,841,329,512,137,163,35,26,1
25433,247,110,137,34,45,23,10,326,176,150,35,22,29,11,1
25434,383,204,179,61,32,54,16,195,86,109,31,37,19,5,1
25435,448,236,212,53,64,56,24,619,332,287,95,77,74,38,1
25436,628,330,298,73,73,50,25,864,362,502,142,150,70,19,1
25437,745,366,379,110,93,79,45,756,348,408,101,103,60,40,1
25438,169,92,77,21,21,18,7,482,231,251,76,81,64,26,1
25439,480,234,246,79,77,65,23,399,208,191,57,46,41,20,1
25440,930,367,563,181,153,83,48,281,166,115,34,17,36,16,1
25441,546,267,279,90,69,56,19,705,396,309,87,48,53,17,1
25442,962,500,462,146,134,62,27,901,458,443,91,129,86,21,1
25443,297,144,153,47,29,34,13,149,68,81,15,38,11,10,1
25444,89,42,47,16,12,15,6,553,261,292,73,79,40,26,1
25445,1190,638,552,162,95,112,18,416,162,254,45,60,23,27,1
25446,526,266,260,76,75,53,22,93,45,48,19,15,14,3,1
25447,613,354,259,72,72,61,19,499,272,227,49,66,66,21,1
25448,1115,589,526,142,108,136,50,767,392,375,113,112,83,13,1
25449,815,382,433,97,50,88,31,636,320,316,79,61,67,31,1
25450,207,108,99,25,15,27,16,660,359,301,81,87,102,31,1
25451,607,311,296,73,81,33,33,193,99,94,31,31,16,12,1
25452,110,49,61,19,7,2,5,1848,833,1015,304,257,195,71,1
25453,411,207,204,60,57,35,21,174,79,95,36,37,18,6,1
25454,900,480,420,108,105,96,30,156,64,92,31,19,5,4,1
25455,1270,682,588,165,147,136,54,2335,1200,1135,374,268,340,83,1
25456,589,294,295,37,44,27,33,493,273,220,50,50,35,19,1
25457,103,56,47,27,7,8,2,111,29,82,10,54,0,1,1
25458,277,124,153,44,40,35,18,1190,638,552,162,95,112,18,1
25459,751,350,401,119,77,94,40,931,464,467,109,126,119,42,1
25460,592,264,328,86,85,62,41,951,506,445,107,118,79,40,1
25461,605,295,310,74,66,70,36,524,270,254,84,72,70,23,1
25462,400,191,209,51,60,30,9,622,331,291,69,74,45,21,1
25463,380,184,196,58,52,46,8,1943,846,1097,301,257,135,77,1
25464,1015,457,558,110,160,49,26,1573,791,782,198,173,148,46,1
25465,493,263,230,52,49,59,20,178,89,89,26,21,21,10,1
25466,810,367,443,115,92,94,59,3075,1459,1616,390,359,298,207,1
25467,501,258,243,52,52,52,24,601,313,288,42,48,25,36,1
25468,356,197,159,50,43,29,17,318,165,153,45,38,25,18,1
25469,537,276,261,75,68,68,22,1822,879,943,236,227,175,97,1
25470,887,439,448,131,119,98,39,149,68,81,15,38,11,10,1
25471,339,170,169,32,17,24,13,462,233,229,66,49,43,30,1
25472,261,130,131,27,41,19,16,318,164,154,52,43,34,10,1
25473,660,359,301,81,87,102,31,269,133,136,30,41,34,17,1
25474,450,229,221,49,63,54,27,71,52,19,5,3,16,8,1
25475,297,145,152,49,30,23,21,178,100,78,23,22,30,6,1
25476,483,283,200,56,51,45,18,376,202,174,54,39,28,8,1
25477,1210,592,618,157,138,116,85,217,109,108,34,32,35,7,1
25478,197,104,93,21,14,20,11,218,105,113,31,28,24,14,1
25479,719,343,376,108,78,92,29,457,237,220,69,44,53,26,1
25480,512,261,251,79,73,60,21,556,300,256,58,73,55,22,1
25481,218,133,85,20,19,13,6,1893,850,1043,280,340,169,80,1
25482,548,250,298,85,64,56,21,782,372,410,127,111,89,36,1
25483,609,292,317,102,96,64,21,606,340,266,67,62,76,22,1
25484,686,375,311,89,80,63,20,543,293,250,77,67,40,25,1
25485,418,205,213,69,50,29,15,183,91,92,21,29,16,10,1
25486,130,55,75,21,26,10,3,392,115,277,117,75,28,17,1
25487,467,226,241,55,48,54,23,1834,823,1011,297,282,151,63,1
25488,475,238,237,73,53,63,17,392,115,277,117,75,28,17,1
25489,986,418,568,159,99,110,42,426,228,198,62,42,47,22,1
25490,499,272,227,49,66,66,21,1331,657,674,159,137,182,58,1
25491,320,171,149,40,29,30,14,632,326,306,92,71,56,19,1
25492,743,366,377,41,37,26,14,609,292,317,102,96,64,21,1
25493,847,402,445,137,119,102,41,2347,1234,1113,252,242,302,85,1
25494,454,223,231,38,45,24,19,480,252,228,55,37,49,20,1
25495,592,283,309,84,137,60,20,4563,2219,2344,620,531,527,104,1
25496,202,102,100,29,35,6,9,585,234,351,95,97,43,19,1
25497,258,141,117,39,35,27,8,176,85,91,24,23,24,7,1
25498,470,226,244,81,53,59,39,712,380,332,69,74,57,30,1
25499,912,461,451,127,109,96,48,331,169,162,40,28,22,14,1
25500,335,128,207,51,60,16,8,410,186,224,72,57,52,22,1
25501,267,161,106,22,25,35,20,592,283,309,84,137,60,20,1
25502,2440,1061,1379,377,326,172,62,673,300,373,77,92,57,22,1
25503,297,158,139,47,37,37,9,1164,531,633,179,157,107,46,1
25504,816,332,484,106,106,89,103,330,143,187,63,29,52,20,1
25505,551,298,253,63,65,45,19,467,240,227,65,65,51,23,1
25506,532,226,306,102,55,69,29,1270,557,713,130,195,57,30,1
25507,588,255,333,94,82,58,27,467,224,243,70,43,67,23,1
25508,758,360,398,114,107,51,19,226,90,136,43,43,26,7,1
25509,211,126,85,21,20,28,7,977,492,485,135,122,116,35,1
25510,666,329,337,90,90,54,19,451,239,212,53,64,56,22,1
25511,985,445,540,164,146,68,36,247,110,137,34,45,23,10,1
25512,81,41,40,15,13,3,2,393,186,207,58,50,36,22,1
25513,198,102,96,27,20,21,12,239,146,93,30,22,35,9,1
25514,325,181,144,46,31,48,9,673,317,356,101,85,76,49,1
25515,442,230,212,50,58,56,23,428,228,200,47,33,53,14,1
25516,247,110,137,34,45,23,10,695,291,404,107,69,73,13,1
25517,650,304,346,80,106,62,28,335,128,207,59,43,24,23,1
25518,1490,655,835,261,174,109,35,221,75,146,68,21,16,5,1
25519,292,162,130,43,27,21,12,1342,675,667,162,154,123,39,1
25520,297,158,139,47,37,37,9,525,274,251,82,74,60,25,1
25521,158,76,82,18,23,14,8,101,57,44,14,8,6,6,1
25522,393,186,207,58,50,36,22,3144,1617,1527,367,342,278,136,1
25523,256,125,131,36,39,32,13,448,275,173,32,53,55,27,1
25524,1356,672,684,171,172,134,59,425,224,201,58,56,40,16,1
25525,185,70,115,37,48,15,5,912,460,452,139,132,89,53,1
25526,854,451,403,121,98,65,32,552,264,288,82,64,48,20,1
25527,750,371,379,95,98,86,29,212,88,124,46,24,22,16,1
25528,440,218,222,58,66,40,24,966,459,507,123,145,83,39,1
25529,467,226,241,55,48,54,23,1674,699,975,311,277,134,51,1
25530,1674,699,975,311,277,134,51,763,354,409,101,90,63,26,1
25531,1113,520,593,168,139,109,49,881,383,498,142,148,77,24,1
25532,527,263,264,75,71,41,15,1212,709,503,137,127,132,42,1
25533,351,184,167,59,45,54,9,155,66,89,36,28,11,7,1
25534,545,284,261,72,67,72,25,858,417,441,124,101,85,41,1
25535,633,335,298,81,76,73,28,446,176,270,64,79,45,24,1
25536,798,287,511,126,125,77,26,2035,1087,948,163,129,96,73,1
25537,292,152,140,46,38,35,12,204,80,124,29,51,10,5,1
25538,341,190,151,50,41,23,15,669,382,287,67,35,70,16,1
25539,976,496,480,128,111,121,48,659,325,334,102,85,87,32,1
25540,440,214,226,59,62,27,28,671,321,350,95,87,75,34,1
25541,176,106,70,30,15,18,5,460,274,186,50,34,69,27,1
25542,481,256,225,60,56,48,12,1149,568,581,177,133,101,30,1
25543,1545,828,717,186,149,176,58,491,283,208,55,61,40,13,1
25544,200,106,94,24,26,18,6,3144,1617,1527,367,342,278,136,1
25545,815,418,397,97,62,70,17,316,159,157,38,48,30,11,1
25546,445,219,226,61,60,60,21,621,404,217,61,42,73,21,1
25547,201,86,115,33,37,8,7,258,141,117,39,35,27,8,1
25548,529,274,255,57,62,38,14,620,305,315,97,80,87,28,1
25549,392,156,236,40,91,28,16,433,232,201,61,39,19,20,1
25550,667,360,307,76,92,46,27,1132,553,579,172,143,150,57,1
25551,363,201,162,39,47,36,16,315,118,197,85,57,42,14,1
25552,326,156,170,60,47,43,5,1118,471,647,204,164,102,34,1
25553,797,394,403,109,89,83,40,419,175,244,71,73,23,23,1
25554,728,369,359,79,93,97,40,1663,835,828,224,213,163,63,1
25555,255,122,133,35,51,22,13,390,203,187,58,40,43,19,1
25556,497,270,227,64,43,62,22,399,221,178,59,40,58,18,1
25557,667,312,355,100,134,47,20,826,362,464,107,118,71,43,1
25558,556,279,277,83,69,71,19,2549,1331,1218,366,296,271,130,1
25559,925,484,441,112,86,84,31,131,66,65,21,14,23,7,1
25560,2363,875,1488,361,444,95,53,245,111,134,31,44,20,11,1
25561,622,331,291,69,74,45,21,503,279,224,72,59,62,35,1
25562,811,361,450,124,107,80,31,769,329,440,116,66,55,22,1
25563,375,173,202,50,46,43,25,385,248,137,30,24,36,29,1
25564,499,252,247,75,71,65,25,824,392,432,106,89,88,32,1
25565,245,112,133,32,45,20,10,372,179,193,50,52,33,6,1
25566,837,444,393,128,89,87,37,516,298,218,62,57,49,19,1
25567,491,232,259,80,65,54,21,206,85,121,31,42,6,17,1
25568,784,373,411,101,90,91,37,712,380,332,69,74,57,30,1
25569,476,270,206,62,45,46,30,272,131,141,36,26,36,16,1
25570,429,227,202,49,51,46,26,1647,794,853,279,235,128,65,1
25571,247,110,137,34,45,23,10,274,142,132,33,34,18,14,1
25572,736,388,348,88,85,67,28,534,266,268,86,62,37,14,1
25573,255,144,111,23,27,32,11,352,166,186,55,59,31,16,1
25574,222,97,125,36,23,21,12,297,123,174,51,49,16,10,1
25575,451,213,238,72,63,42,27,219,104,115,43,32,24,11,1
25576,987,515,472,107,110,106,61,1182,599,583,162,130,106,41,1
25577,1970,978,992,245,206,198,80,210,102,108,33,33,20,9,1
25578,1068,539,529,161,134,132,71,1484,731,753,206,175,187,71,1
25579,1071,455,616,169,151,92,49,247,110,137,34,45,23,10,1
25580,954,521,433,135,118,78,26,1675,875,800,213,219,196,72,1
25581,909,455,454,137,82,85,68,263,136,127,29,24,19,31,1
25582,536,278,258,72,63,62,20,631,315,316,64,57,49,15,1
25583,477,256,221,69,66,70,12,354,193,161,51,41,58,13,1
25584,219,100,119,32,43,9,10,70,30,40,21,9,4,2,1
25585,368,177,191,41,56,30,27,351,166,185,48,61,24,15,1
25586,330,143,187,63,29,52,20,273,137,136,38,24,23,23,1
25587,1124,615,509,157,125,128,52,1620,884,736,194,161,162,80,1
25588,1114,581,533,145,132,126,54,379,203,176,55,48,45,16,1
25589,1193,492,701,152,190,66,53,297,158,139,47,37,37,9,1
25590,245,122,123,21,32,18,13,390,209,181,59,47,41,26,1
25591,1230,623,607,154,156,94,61,108,51,57,16,12,16,11,1
25592,552,285,267,74,51,69,24,590,306,284,69,82,68,27,1
25593,620,334,286,82,55,71,25,473,270,203,63,34,44,18,1
25594,538,252,286,77,87,53,30,1045,374,671,217,143,103,29,1
25595,522,235,287,78,67,60,50,657,293,364,109,75,66,28,1
25596,574,356,218,61,44,87,39,601,313,288,42,48,25,36,1
25597,208,110,98,32,25,28,4,822,424,398,107,106,86,46,1
25598,163,70,93,28,21,17,6,395,222,173,48,42,21,8,1
25599,1434,727,707,210,173,161,54,475,268,207,61,27,56,30,1
25600,745,366,379,110,93,79,45,615,293,322,70,67,45,29,1
25601,1098,432,666,166,199,76,28,381,188,193,59,60,35,12,1
25602,440,215,225,76,74,29,16,806,419,387,115,130,57,32,1
25603,639,337,302,75,65,52,12,425,210,215,56,43,52,25,1
25604,566,287,279,77,66,34,14,354,168,186,50,53,39,20,1
25605,186,110,76,26,22,32,14,311,187,124,39,38,35,12,1
25606,211,90,121,49,27,14,11,4391,2256,2135,494,411,423,231,1
25607,522,235,287,78,67,60,50,152,87,65,20,19,14,5,1
25608,294,148,146,35,33,25,14,824,397,427,113,95,82,33,1
25609,229,120,109,31,30,22,9,328,120,208,76,50,23,9,1
25610,466,186,280,71,84,30,11,95,41,54,15,16,8,5,1
25611,380,185,195,68,54,32,16,372,196,176,51,36,51,8,1
25612,653,298,355,70,101,64,39,219,104,115,25,31,25,11,1
25613,292,152,140,46,38,35,12,156,74,82,17,14,19,9,1
25614,724,334,390,112,109,79,17,191,99,92,25,24,18,8,1
25615,509,254,255,67,55,52,35,312,143,169,55,61,12,11,1
25616,432,218,214,57,55,42,11,285,169,116,33,32,17,8,1
25617,400,191,209,51,60,30,9,212,106,106,35,19,15,9,1
25618,456,228,228,49,70,32,19,220,106,114,32,26,15,7,1
25619,303,159,144,40,35,35,8,583,322,261,73,66,45,26,1
25620,1162,548,614,191,166,142,38,1097,464,633,190,166,80,60,1
25621,377,187,190,51,44,46,26,196,99,97,28,32,17,12,1
25622,398,216,182,52,33,40,15,1670,1140,530,173,120,89,53,1
25623,144,69,75,11,21,8,5,206,96,110,33,25,8,6,1
25624,502,240,262,78,61,54,32,303,137,166,54,54,31,15,1
25625,576,250,326,93,71,34,15,510,264,246,67,66,38,29,1
25626,1134,535,599,165,148,93,36,247,110,137,34,45,23,10,1
25627,2161,1233,928,269,199,178,42,1585,840,745,184,152,155,100,1
25628,1242,613,629,174,113,114,53,796,445,351,96,80,90,38,1
25629,431,227,204,53,60,58,12,416,210,206,55,54,39,20,1
25630,2089,917,1172,285,306,83,39,143,81,62,28,9,8,1,1
25631,536,278,258,72,63,62,20,592,291,301,92,93,71,31,1
25632,419,175,244,71,73,23,23,729,358,371,116,99,89,33,1
25633,390,179,211,53,51,52,15,331,165,166,52,34,48,22,1
25634,1156,538,618,144,139,117,90,1960,810,1150,358,377,121,72,1
25635,318,158,160,41,40,31,15,1232,683,549,165,167,122,42,1
25636,503,259,244,73,53,52,28,497,227,270,70,63,66,30,1
25637,1162,548,614,191,166,142,38,1069,512,557,148,126,84,36,1
25638,1299,517,782,209,222,93,37,932,575,357,94,69,76,40,1
25639,1161,620,541,119,120,119,47,547,292,255,51,55,46,28,1
25640,394,202,192,44,43,38,28,614,305,309,96,73,65,24,1
25641,246,115,131,15,29,10,32,697,283,414,123,84,78,33,1
25642,615,339,276,82,76,63,16,538,263,275,71,85,44,18,1
25643,283,159,124,41,21,39,17,149,68,81,15,38,11,10,1
25644,903,437,466,117,112,108,32,977,500,477,139,115,121,31,1
25645,476,227,249,52,59,38,17,483,210,273,74,97,45,27,1
25646,558,306,252,75,55,74,23,271,131,140,55,17,30,16,1
25647,838,380,458,114,95,68,57,484,254,230,60,66,56,14,1
25648,207,105,102,35,27,15,5,552,264,288,82,64,48,20,1
25649,107,36,71,27,15,0,1,505,247,258,72,71,60,27,1
25650,714,364,350,98,102,91,27,1466,991,475,136,129,59,39,1
25651,874,431,443,112,120,79,50,308,160,148,39,46,30,12,1
25652,329,148,181,44,38,36,21,220,126,94,29,12,34,11,1
25653,987,515,472,107,110,106,61,1074,538,536,154,140,111,51,1
25654,481,256,225,60,56,48,12,976,496,480,128,111,121,48,1
25655,462,251,211,74,53,41,18,375,202,173,46,49,41,23,1
25656,243,120,123,30,24,26,13,599,298,301,84,64,72,22,1
25657,179,89,90,36,28,31,9,392,156,236,40,91,28,16,1
25658,948,484,464,134,131,75,27,1020,410,610,220,221,32,13,1
25659,851,446,405,93,94,92,37,409,200,209,69,56,44,13,1
25660,740,313,427,101,135,40,22,592,264,328,86,85,62,41,1
25661,350,224,126,34,14,48,18,421,210,211,72,55,44,14,1
25662,1616,735,881,285,248,153,72,513,246,267,71,66,60,35,1
25663,554,215,339,102,65,85,42,202,102,100,29,35,6,9,1
25664,342,178,164,33,38,35,15,126,66,60,24,10,7,9,1
25665,250,137,113,33,19,24,9,455,218,237,57,51,42,35,1
25666,678,362,316,89,60,88,24,1960,810,1150,358,377,121,72,1
25667,393,186,207,58,50,36,22,548,250,298,85,64,56,21,1
25668,454,224,230,71,39,62,22,422,198,224,52,52,42,43,1
25669,856,429,427,113,105,96,24,930,367,563,181,153,83,48,1
25670,330,157,173,56,42,51,8,220,126,94,29,12,34,11,1
25671,789,389,400,121,80,92,40,815,418,397,97,62,70,17,1
25672,351,143,208,44,68,23,18,136,72,64,22,16,7,3,1
25673,746,361,385,91,92,101,32,92,43,49,14,13,7,4,1
25674,1455,760,695,205,191,124,40,403,185,218,67,62,63,19,1
25675,482,231,251,76,81,64,26,1863,721,1142,262,283,139,74,1
25676,2477,1186,1291,256,271,249,90,552,285,267,74,51,69,24,1
25677,406,259,147,30,26,31,20,1426,807,619,140,99,79,94,1
25678,1100,474,626,197,143,126,41,531,286,245,81,67,42,29,1
25679,261,143,118,33,24,32,16,1474,756,718,175,158,169,51,1
25680,111,51,60,20,21,10,11,557,240,317,97,74,68,37,1
25681,806,436,370,101,100,76,34,216,94,122,43,17,23,9,1
25682,143,65,78,32,11,11,11,601,313,288,42,48,25,36,1
25683,1016,557,459,107,124,57,30,307,133,174,48,53,27,10,1
25684,89,42,47,16,12,15,6,1198,620,578,155,151,147,56,1
25685,758,360,398,114,107,51,19,876,397,479,168,168,84,24,1
25686,303,141,162,42,57,37,20,717,469,248,92,67,22,21,1
25687,333,197,136,31,29,44,13,119,57,62,18,16,17,4,1
25688,576,250,326,93,71,34,15,1191,639,552,140,144,106,50,1
25689,673,317,356,101,85,76,49,173,88,85,20,21,9,12,1
25690,260,120,140,34,39,36,12,401,167,234,56,71,16,10,1
25691,1210,485,725,205,139,79,34,324,174,150,37,24,35,27,1
25692,95,41,54,15,16,8,5,380,187,193,38,51,30,18,1
25693,374,181,193,63,49,46,20,472,263,209,57,39,60,29,1
25694,385,179,206,58,56,38,19,345,203,142,47,35,31,11,1
25695,450,229,221,49,63,54,27,211,99,112,34,43,10,6,1
25696,320,171,149,40,29,30,14,637,321,316,70,96,30,18,1
25697,714,364,350,98,102,91,27,788,360,428,93,106,67,72,1
25698,244,145,99,27,27,34,7,713,370,343,74,93,58,21,1
25699,777,387,390,90,87,65,37,767,392,375,113,112,83,13,1
25700,1086,603,483,147,121,95,40,377,184,193,56,53,44,14,1
25701,688,323,365,121,69,55,22,433,222,211,68,58,42,23,1
25702,1338,633,705,199,151,144,65,543,287,256,71,66,64,23,1
25703,822,416,406,111,105,84,44,739,369,370,102,81,95,38,1
25704,1075,515,560,126,106,107,40,905,371,534,192,135,81,28,1
25705,139,73,66,26,13,9,9,294,148,146,35,33,25,14,1
25706,322,160,162,44,52,33,16,393,186,207,58,50,36,22,1
25707,760,401,359,96,89,98,22,215,105,110,27,22,20,9,1
25708,1948,1039,909,242,227,200,67,437,225,212,61,57,66,12,1
25709,467,226,241,55,48,54,23,331,169,162,40,28,22,14,1
25710,255,122,133,35,51,22,13,1242,613,629,174,113,114,53,1
25711,393,210,183,55,50,34,19,416,210,206,55,54,39,20,1
25712,524,264,260,75,75,40,21,1149,568,581,177,133,101,30,1
25713,1198,571,627,177,168,97,54,245,112,133,32,45,20,10,1
25714,2045,985,1060,359,339,199,74,876,397,479,168,168,84,24,1
25715,1210,592,618,157,138,116,85,136,65,71,33,11,9,6,1
25716,245,137,108,34,30,19,10,269,148,121,33,22,30,6,1
25717,2517,1275,1242,304,324,245,135,1891,1066,825,207,184,181,83,1
25718,232,108,124,33,27,19,16,2135,1170,965,232,246,196,89,1
25719,826,423,403,129,93,82,42,406,212,194,50,52,24,18,1
25720,482,242,240,60,39,60,17,261,127,134,33,24,30,13,1
25721,350,200,150,45,47,23,8,261,130,131,27,41,19,16,1
25722,95,44,51,14,13,7,4,531,277,254,82,75,33,22,1
25723,154,75,79,17,24,16,13,632,320,312,74,75,47,14,1
25724,698,245,453,133,133,34,39,826,362,464,107,118,71,43,1
25725,406,210,196,68,60,25,20,439,220,219,63,72,25,20,1
25726,284,160,124,37,23,32,11,390,191,199,57,49,45,25,1
25727,492,238,254,72,56,49,20,796,445,351,96,80,90,38,1
25728,257,134,123,35,32,33,9,467,224,243,70,43,67,23,1
25729,354,188,166,44,31,48,11,267,141,126,53,27,23,7,1
25730,577,288,289,85,56,40,20,758,362,396,115,102,35,13,1
25731,456,228,228,49,70,32,19,875,376,499,155,125,53,39,1
25732,1400,800,600,158,134,150,65,711,340,371,106,77,87,55,1
25733,605,281,324,111,67,40,44,651,306,345,85,64,61,32,1
25734,743,366,377,41,37,26,14,209,75,134,53,48,20,9,1
25735,1132,624,508,199,79,127,41,2549,1331,1218,366,296,271,130,1
25736,593,321,272,64,84,33,20,882,432,450,115,111,68,44,1
25737,512,216,296,92,68,51,19,360,218,142,39,26,50,18,1
25738,442,254,188,46,22,40,19,1151,493,658,157,141,108,62,1
25739,167,87,80,28,20,19,11,483,237,246,63,47,25,21,1
25740,557,240,317,97,74,68,37,277,141,136,35,21,16,22,1
25741,586,236,350,124,109,66,24,202,102,100,29,35,6,9,1
25742,2286,1154,1132,338,314,278,103,1462,711,751,219,222,148,65,1
25743,515,253,262,46,83,57,21,851,417,434,109,116,83,28,1
25744,686,375,311,89,80,63,20,670,309,361,120,78,60,24,1
25745,1170,510,660,142,182,115,84,255,130,125,44,18,22,12,1
25746,551,298,253,63,65,45,19,317,153,164,34,52,30,14,1
25747,1087,480,607,155,179,99,28,1331,657,674,159,137,182,58,1
25748,926,437,489,135,107,113,42,247,132,115,24,22,24,13,1
25749,504,245,259,64,54,42,14,208,104,104,20,54,9,5,1
25750,103,44,59,16,17,9,5,1134,539,595,150,146,78,40,1
25751,598,300,298,68,77,59,21,390,237,153,41,57,22,16,1
25752,201,86,115,33,37,8,7,176,85,91,24,23,24,7,1
25753,338,188,150,45,41,31,18,673,313,360,101,101,46,17,1
25754,2644,1346,1298,391,304,315,148,681,322,359,100,87,71,26,1
25755,193,83,110,26,20,16,9,180,103,77,22,19,29,8,1
25756,832,428,404,131,89,88,38,1130,614,516,129,138,98,42,1
25757,593,266,327,102,84,69,24,624,308,316,92,72,68,22,1
25758,461,223,238,66,57,36,23,533,297,236,74,57,39,28,1
25759,427,218,209,56,57,53,24,921,455,466,144,127,108,39,1
25760,132,78,54,12,8,15,9,689,336,353,99,92,79,31,1
25761,345,203,142,47,35,31,11,655,328,327,65,54,55,35,1
25762,394,202,192,44,43,38,28,146,79,67,32,12,13,4,1
25763,656,358,298,67,47,64,26,471,231,240,76,58,44,8,1
25764,513,246,267,71,66,60,35,588,255,333,94,82,58,27,1
25765,414,207,207,59,47,54,18,229,105,124,36,33,12,4,1
25766,708,334,374,105,96,61,37,825,422,403,100,90,62,43,1
25767,482,231,251,76,81,64,26,317,153,164,34,52,30,14,1
25768,424,209,215,56,58,45,24,623,329,294,84,86,74,27,1
25769,1049,585,464,107,108,120,28,1255,666,589,145,142,120,82,1
25770,508,254,254,74,99,61,12,315,150,165,49,59,23,15,1
25771,537,272,265,75,83,41,29,355,165,190,53,56,42,19,1
25772,190,94,96,24,33,24,6,443,240,203,66,31,57,27,1
25773,350,214,136,33,23,49,27,99,48,51,15,7,7,7,1
25774,1058,558,500,132,127,121,53,119,59,60,29,10,6,4,1
25775,508,267,241,43,35,25,17,293,142,151,49,40,42,17,1
25776,211,114,97,32,24,19,10,551,237,314,95,79,54,17,1
25777,363,181,182,51,42,57,18,268,143,125,43,29,22,10,1
25778,327,177,150,40,40,38,18,443,198,245,68,72,48,19,1
25779,96,50,46,8,15,6,2,80,42,38,12,7,7,4,1
25780,593,321,272,64,84,33,20,413,206,207,38,55,19,10,1
25781,1255,666,589,145,142,120,82,1686,829,857,235,189,190,57,1
25782,235,135,100,30,13,25,11,365,186,179,48,47,42,13,1
25783,464,242,222,61,68,36,17,450,241,209,67,58,54,23,1
25784,1133,549,584,99,76,66,54,2556,1169,1387,248,291,227,275,1
25785,398,200,198,68,43,51,14,778,367,411,90,85,64,43,1
25786,245,112,133,32,45,20,10,450,275,175,57,32,48,15,1
25787,589,314,275,70,83,44,28,486,236,250,73,67,59,16,1
25788,323,169,154,47,44,39,20,351,183,168,55,44,33,9,1
25789,324,154,170,57,40,26,4,437,212,225,66,44,44,11,1
25790,527,262,265,62,73,39,49,327,177,150,40,40,38,18,1
25791,216,121,95,38,27,25,6,4563,2219,2344,620,531,527,104,1
25792,1893,850,1043,280,340,169,80,656,358,298,67,47,64,26,1
25793,331,169,162,40,28,22,14,271,136,135,37,30,18,10,1
25794,784,373,411,101,90,91,37,1336,633,703,182,197,110,52,1
25795,509,261,248,62,65,35,20,543,246,297,99,93,50,29,1
25796,770,390,380,104,76,78,32,811,361,450,124,107,80,31,1
25797,769,362,407,99,88,66,67,1163,615,548,122,109,128,41,1
25798,427,191,236,67,60,41,34,410,200,210,60,54,46,19,1
25799,403,221,182,47,41,47,8,299,140,159,27,59,20,18,1
25800,306,156,150,47,37,21,3,1523,758,765,188,183,157,58,1
25801,332,172,160,50,33,35,9,637,327,310,86,58,70,31,1
25802,391,222,169,46,36,30,9,280,118,162,35,32,41,37,1
25803,1141,583,558,141,98,91,45,360,192,168,55,45,48,16,1
25804,446,246,200,64,48,54,12,323,183,140,45,20,27,16,1
25805,723,371,352,86,69,80,27,246,115,131,15,29,10,32,1
25806,266,124,142,44,21,28,26,1615,835,780,189,208,172,86,1
25807,189,89,100,24,26,18,15,393,198,195,47,48,39,14,1
25808,2472,1055,1417,416,458,235,64,859,395,464,157,119,59,31,1
25809,491,233,258,73,58,56,30,417,182,235,57,109,50,8,1
25810,467,232,235,52,40,46,20,593,266,327,102,84,69,24,1
25811,746,361,385,91,92,101,32,2477,1186,1291,256,271,249,90,1
25812,860,378,482,101,123,82,74,317,156,161,49,51,18,10,1
25813,410,222,188,54,49,43,13,839,427,412,91,83,114,37,1
25814,385,194,191,49,50,40,12,178,100,78,23,22,30,6,1
25815,461,207,254,82,66,55,33,2063,1024,1039,175,117,80,97,1
25816,862,409,453,149,125,86,29,771,321,450,151,135,43,15,1
25817,267,127,140,43,42,24,9,673,313,360,101,101,46,17,1
25818,345,176,169,34,31,36,11,496,272,224,70,58,42,18,1
25819,2157,1033,1124,365,281,199,63,812,427,385,109,81,69,35,1
25820,177,99,78,22,23,20,10,762,363,399,127,85,83,31,1
25821,415,189,226,69,54,50,21,459,221,238,72,78,47,16,1
25822,136,66,70,33,11,9,3,1210,578,632,172,184,94,66,1
25823,335,185,150,46,34,36,13,370,194,176,51,57,43,17,1
25824,189,93,96,24,28,17,12,748,355,393,121,91,95,26,1
25825,1328,648,680,220,151,112,40,920,492,428,100,92,88,49,1
25826,743,346,397,91,90,62,10,660,332,328,84,73,47,19,1
25827,433,211,222,72,63,57,31,393,186,207,58,50,36,22,1
25828,4303,2489,1814,436,369,444,134,1074,538,536,154,140,111,51,1
25829,587,300,287,67,102,34,20,101,41,60,18,19,10,5,1
25830,125,72,53,10,11,9,7,124,69,55,15,13,12,2,1
25831,815,418,397,97,62,70,17,779,354,425,96,69,57,36,1
25832,295,161,134,30,40,31,9,83,42,41,13,10,7,5,1
25833,3574,1733,1841,371,392,414,304,1270,557,713,130,195,57,30,1
25834,606,307,299,92,56,68,30,218,121,97,29,26,21,6,1
25835,940,464,476,116,135,108,58,309,106,203,66,49,25,10,1
25836,2089,917,1172,285,306,83,39,3056,1457,1599,438,389,329,168,1
25837,493,240,253,72,62,59,15,672,334,338,110,93,91,41,1
25838,296,154,142,38,38,24,16,374,187,187,51,52,40,27,1
25839,476,251,225,57,67,57,18,368,185,183,61,41,56,8,1
25840,480,234,246,79,77,65,23,5890,3314,2576,970,956,293,265,1
25841,3685,1574,2111,579,580,303,116,281,166,115,34,17,36,16,1
25842,211,109,102,33,27,24,11,2157,1171,986,306,238,131,32,1
25843,975,400,575,160,162,62,31,528,300,228,54,54,54,19,1
25844,566,263,303,83,87,74,31,1462,711,751,219,222,148,65,1
25845,436,201,235,54,37,34,20,339,170,169,32,17,24,13,1
25846,297,158,139,47,37,37,9,473,217,256,59,44,34,21,1
25847,4128,2104,2024,581,505,453,205,264,121,143,46,24,35,10,1
25848,297,177,120,36,23,29,16,532,267,265,86,55,64,22,1
25849,707,386,321,85,83,99,28,1712,1175,537,179,142,113,46,1
25850,258,141,117,39,35,27,8,621,284,337,108,68,50,17,1
25851,514,251,263,87,50,63,16,802,344,458,156,136,57,24,1
25852,404,183,221,63,50,39,16,2041,1035,1006,223,274,125,60,1
25853,127,49,78,27,20,6,5,339,170,169,32,17,24,13,1
25854,101,57,44,14,8,6,6,201,98,103,26,35,16,5,1
25855,465,224,241,63,54,54,31,339,177,162,40,36,51,24,1
25856,316,157,159,45,38,22,19,339,170,169,32,17,24,13,1
25857,491,241,250,73,58,61,25,404,239,165,48,38,38,19,1
25858,440,214,226,59,62,27,28,208,96,112,31,32,13,9,1
25859,125,52,73,27,23,11,10,427,204,223,38,57,26,32,1
25860,292,152,140,46,38,35,12,1621,752,869,171,356,65,23,1
25861,837,444,393,128,89,87,37,805,338,467,109,145,49,25,1
25862,349,167,182,54,38,30,28,382,169,213,55,47,38,27,1
25863,1292,592,700,186,169,108,22,632,339,293,83,77,59,20,1
25864,413,236,177,41,25,35,19,271,131,140,47,37,41,11,1
25865,786,409,377,119,93,84,32,374,191,183,70,48,61,13,1
25866,516,227,289,75,36,54,28,466,186,280,71,84,30,11,1
25867,318,176,142,25,32,35,25,258,157,101,28,27,21,7,1
25868,503,298,205,62,28,20,4,550,243,307,91,99,70,10,1
25869,407,180,227,79,42,32,16,928,442,486,139,118,91,43,1
25870,486,229,257,75,104,49,10,226,129,97,20,25,26,11,1
25871,381,191,190,55,61,33,11,95,45,50,12,16,11,8,1
25872,128,65,63,18,13,7,6,769,329,440,116,66,55,22,1
25873,1374,679,695,191,193,154,48,522,235,287,78,67,60,50,1
25874,490,224,266,80,70,39,32,341,154,187,34,36,11,11,1
25875,318,212,106,16,15,41,16,213,129,84,32,14,21,15,1
25876,98,49,49,14,15,9,2,335,183,152,40,26,54,23,1
25877,138,80,58,22,20,8,6,254,107,147,42,37,24,10,1
25878,186,99,87,30,17,18,8,689,336,353,99,92,79,31,1
25879,107,58,49,14,16,14,4,480,234,246,79,77,65,23,1
25880,715,361,354,99,102,82,21,375,202,173,46,49,41,23,1
25881,538,252,286,77,87,53,30,928,442,486,139,118,91,43,1
25882,1140,495,645,129,95,128,159,2136,1063,1073,317,308,223,90,1
25883,947,441,506,166,143,80,30,103,49,54,21,21,10,2,1
25884,893,469,424,126,135,68,14,595,316,279,86,60,65,40,1
25885,312,147,165,52,44,12,13,553,309,244,75,60,39,14,1
25886,378,178,200,52,52,50,19,467,269,198,46,51,60,18,1
25887,757,333,424,81,132,61,54,1487,996,491,147,141,50,35,1
25888,484,254,230,60,66,56,14,722,390,332,125,68,67,25,1
25889,595,316,279,86,60,65,40,1333,646,687,209,179,148,45,1
25890,289,147,142,45,45,38,13,1290,597,693,182,182,119,63,1
25891,505,277,228,70,57,45,20,185,84,101,21,23,18,12,1
25892,601,313,288,42,48,25,36,454,273,181,49,58,33,11,1
25893,543,221,322,78,122,37,12,1855,852,1003,329,264,184,83,1
25894,771,321,450,151,135,43,15,292,154,138,46,29,41,7,1
25895,510,264,246,67,66,38,29,103,44,59,16,17,9,5,1
25896,931,491,440,127,116,118,44,536,278,258,72,63,62,20,1
25897,2135,1170,965,232,246,196,89,3969,1703,2266,619,432,259,144,1
25898,354,168,186,50,53,39,20,406,187,219,55,64,24,9,1
25899,524,237,287,87,75,54,26,235,106,129,38,39,24,12,1
25900,620,396,224,53,44,97,26,288,118,170,50,57,18,15,1
25901,5179,2082,3097,270,269,273,249,1056,506,550,147,129,106,48,1
25902,732,402,330,81,86,87,33,643,373,270,91,43,113,21,1
25903,1009,487,522,177,121,103,51,608,301,307,93,71,84,20,1
25904,454,191,263,61,66,38,15,2442,1193,1249,278,183,170,145,1
25905,356,171,185,51,59,24,11,205,114,91,25,24,20,15,1
25906,293,142,151,49,40,42,17,2871,1148,1723,496,469,204,98,1
25907,376,183,193,50,50,43,21,1290,597,693,182,182,119,63,1
25908,198,80,118,35,31,14,7,223,113,110,31,33,22,12,1
25909,3056,1457,1599,438,389,329,168,476,233,243,76,61,52,21,1
25910,870,489,381,97,99,76,14,782,421,361,101,97,82,20,1
25911,607,311,296,73,81,33,33,189,90,99,26,29,17,11,1
25912,220,126,94,29,12,34,11,253,127,126,31,25,21,21,1
25913,519,219,300,86,72,50,39,339,170,169,32,17,24,13,1
25914,314,158,156,41,57,30,12,239,146,93,30,22,35,9,1
25915,154,75,79,17,24,16,13,424,197,227,67,62,43,17,1
25916,1085,646,439,108,65,36,19,191,72,119,40,41,17,8,1
25917,331,145,186,40,56,16,9,386,189,197,54,57,39,16,1
25918,530,244,286,103,62,42,20,428,214,214,65,67,45,23,1
25919,1149,568,581,177,133,101,30,1047,562,485,141,127,114,41,1
25920,145,75,70,18,17,10,9,769,329,440,116,66,55,22,1
25921,370,190,180,60,52,37,13,770,355,415,103,142,75,42,1
25922,429,219,210,46,66,42,17,756,349,407,114,113,98,20,1
25923,476,263,213,56,44,50,16,1181,612,569,107,121,123,43,1
25924,440,250,190,51,35,64,27,672,334,338,110,93,91,41,1
25925,326,166,160,49,45,36,12,173,110,63,35,6,9,8,1
25926,334,172,162,43,39,41,17,205,90,115,40,32,25,15,1
25927,461,207,254,82,66,55,33,463,236,227,64,50,44,29,1
25928,160,60,100,23,40,19,11,848,394,454,100,90,101,41,1
25929,651,331,320,93,93,51,28,1073,547,526,60,60,47,19,1
25930,815,418,397,97,62,70,17,471,231,240,76,58,44,8,1
25931,119,59,60,29,10,6,4,240,167,73,32,12,8,21,1
25932,424,198,226,57,46,41,19,410,208,202,59,58,43,26,1
25933,201,126,75,25,13,22,8,128,62,66,13,11,17,12,1
25934,707,386,321,85,83,99,28,810,367,443,115,92,94,59,1
25935,667,360,307,76,92,46,27,808,366,442,130,133,66,31,1
25936,727,346,381,106,100,75,41,526,264,262,77,71,61,27,1
25937,451,238,213,53,64,56,22,537,276,261,75,68,68,22,1
25938,160,60,100,23,40,19,11,595,316,279,86,60,65,40,1
25939,672,334,338,110,93,91,41,520,300,220,66,36,57,23,1
25940,462,251,211,74,53,41,18,335,128,207,59,43,24,23,1
25941,853,400,453,137,109,88,42,412,193,219,70,56,51,26,1
25942,1067,566,501,108,72,106,59,1331,657,674,159,137,182,58,1
25943,906,474,432,90,125,74,24,1225,593,632,158,125,102,38,1
25944,467,226,241,55,48,54,23,1124,441,683,148,189,72,43,1
25945,148,64,84,33,19,6,1,461,257,204,63,49,50,29,1
25946,267,145,122,38,30,32,13,501,285,216,52,55,62,25,1
25947,297,158,139,47,37,37,9,586,240,346,94,110,29,19,1
25948,279,135,144,40,52,40,5,1286,726,560,154,127,143,37,1
25949,491,269,222,80,40,63,28,901,458,443,91,129,86,21,1
25950,461,227,234,61,47,54,33,759,326,433,115,95,61,29,1
25951,177,67,110,34,24,13,10,799,377,422,98,95,80,70,1
25952,124,72,52,14,12,13,6,363,181,182,51,42,57,18,1
25953,268,113,155,34,37,14,9,621,284,337,108,68,50,17,1
25954,476,233,243,76,61,52,21,339,183,156,43,45,28,17,1
25955,923,420,503,128,159,100,49,671,321,350,95,87,75,34,1
25956,697,373,324,105,83,95,38,689,343,346,119,100,86,38,1
25957,204,86,118,38,21,23,15,1167,458,709,296,130,206,86,1
25958,295,143,152,38,47,22,25,1863,721,1142,262,283,139,74,1
25959,476,220,256,65,65,41,21,220,102,118,26,32,27,10,1
25960,303,175,128,43,36,34,12,1132,646,486,99,102,71,41,1
25961,207,99,108,22,33,20,12,392,115,277,117,75,28,17,1
25962,158,85,73,24,18,18,8,536,230,306,64,88,40,12,1
25963,234,129,105,31,22,19,18,367,161,206,70,48,41,19,1
25964,639,368,271,72,51,38,38,656,358,298,67,47,64,26,1
25965,3801,1837,1964,510,442,418,170,246,108,138,32,44,21,10,1
25966,462,251,211,74,53,41,18,1721,809,912,268,234,144,50,1
25967,357,169,188,61,53,32,15,191,99,92,25,24,18,8,1
25968,149,68,81,15,38,11,10,460,274,186,50,34,69,27,1
25969,272,94,178,76,33,19,4,1021,487,534,135,113,119,32,1
25970,472,290,182,45,30,61,32,586,254,332,114,111,55,17,1
25971,350,180,170,64,46,55,12,2383,1253,1130,323,292,273,107,1
25972,782,382,400,124,131,35,16,166,83,83,24,30,18,7,1
25973,707,422,285,84,82,59,13,201,42,159,19,3,2,75,1
25974,1143,557,586,198,157,92,32,247,110,137,34,45,23,10,1
25975,1354,537,817,245,247,117,57,470,205,265,71,80,33,11,1
25976,376,183,193,50,50,43,21,1056,506,550,147,129,106,48,1
25977,380,165,215,47,72,26,14,392,156,236,40,91,28,16,1
25978,184,86,98,26,26,14,11,1647,794,853,279,235,128,65,1
25979,382,183,199,55,60,38,22,425,210,215,56,43,52,25,1
25980,548,309,239,73,62,54,13,365,180,185,63,35,48,19,1
25981,237,105,132,32,28,36,14,624,308,316,92,72,68,22,1
25982,1194,646,548,139,125,127,59,333,167,166,45,30,34,14,1
25983,331,169,162,40,28,22,14,772,363,409,76,120,57,20,1
25984,1032,493,539,160,161,61,38,419,175,244,71,73,23,23,1
25985,379,184,195,51,61,49,8,173,91,82,32,18,19,11,1
25986,147,79,68,20,15,19,8,643,282,361,94,109,59,24,1
25987,674,383,291,73,40,103,29,819,399,420,112,114,85,29,1
25988,339,177,162,40,36,51,24,2416,1280,1136,140,374,175,47,1
25989,638,327,311,88,79,77,28,89,45,44,13,4,8,3,1
25990,261,126,135,41,36,24,11,616,304,312,75,71,55,25,1
25991,379,203,176,55,48,45,16,108,55,53,19,7,11,2,1
25992,269,165,104,24,19,27,7,202,102,100,29,35,6,9,1
25993,2663,1073,1590,548,499,192,64,428,226,202,52,60,75,20,1
25994,234,129,105,31,22,19,18,240,125,115,34,32,30,8,1
25995,1027,444,583,127,80,80,36,422,228,194,26,20,48,37,1
25996,264,126,138,44,26,25,10,109,50,59,20,7,10,9,1
25997,98,41,57,19,19,8,2,271,126,145,33,38,31,10,1
25998,595,316,279,86,60,65,40,149,68,81,15,38,11,10,1
25999,674,358,316,91,92,97,29,375,202,173,46,49,41,23,1
26000,391,204,187,47,48,38,18,239,146,93,30,22,35,9,1
26001,605,295,310,74,66,70,36,1047,562,485,141,127,114,41,1
26002,388,199,189,50,51,33,14,268,157,111,26,30,28,13,1
26003,553,261,292,73,79,40,26,676,333,343,111,89,94,39,1
26004,392,203,189,44,42,33,22,389,195,194,68,60,30,17,1
26005,428,214,214,65,67,45,23,760,391,369,101,109,65,24,1
26006,437,225,212,61,57,66,12,664,297,367,88,86,55,47,1
26007,255,134,121,36,40,29,13,175,86,89,33,25,27,2,1
26008,929,473,456,138,80,98,27,780,337,443,112,116,77,28,1
26009,488,284,204,43,45,52,21,191,101,90,21,23,28,5,1
26010,163,71,92,33,26,5,7,505,226,279,68,51,30,15,1
26011,118,63,55,18,19,11,5,969,505,464,123,133,92,33,1
26012,705,396,309,87,48,53,17,536,278,258,72,63,62,20,1
26013,351,184,167,59,45,54,9,725,339,386,112,122,93,32,1
26014,1292,592,700,186,169,108,22,1149,568,581,177,133,101,30,1
26015,191,99,92,25,24,18,8,427,218,209,61,53,45,26,1
26016,237,112,125,19,57,25,10,864,362,502,142,150,70,19,1
26017,208,96,112,31,32,13,9,296,154,142,38,38,24,16,1
26018,635,333,302,99,75,83,28,185,94,91,23,19,17,9,1
26019,293,142,151,49,40,42,17,592,291,301,92,93,71,31,1
26020,548,252,296,65,93,42,28,353,147,206,47,61,30,25,1
26021,1496,760,736,217,184,151,41,377,184,193,56,53,44,14,1
26022,89,42,47,16,12,15,6,335,185,150,46,34,36,13,1
26023,873,381,492,98,137,76,78,501,216,285,79,70,54,30,1
26024,117,62,55,24,18,21,2,769,405,364,97,101,49,35,1
26025,89,42,47,16,12,15,6,2468,1038,1430,333,465,167,62,1
26026,1258,531,727,218,216,108,35,532,226,306,102,55,69,29,1
26027,836,370,466,126,96,72,30,281,125,156,44,47,17,7,1
26028,184,86,98,26,26,14,11,482,231,251,76,81,64,26,1
26029,647,282,365,104,90,53,27,632,326,306,92,71,56,19,1
26030,478,239,239,65,66,65,21,288,158,130,59,23,21,10,1
26031,1005,422,583,166,179,70,21,446,246,200,46,32,53,25,1
26032,309,154,155,42,44,45,16,990,410,580,140,175,44,36,1
26033,144,57,87,38,26,10,4,1382,599,783,208,252,90,39,1
26034,288,112,176,55,55,18,15,116,67,49,13,12,6,5,1
26035,366,184,182,46,42,23,18,259,143,116,39,37,23,9,1
26036,705,421,284,78,58,122,38,267,145,122,38,30,32,13,1
26037,171,94,77,24,28,30,11,230,119,111,30,29,26,12,1
26038,676,295,381,94,71,65,24,724,334,390,112,109,79,17,1
26039,525,274,251,82,74,60,25,1071,549,522,133,127,130,59,1
26040,875,421,454,124,142,98,43,842,366,476,148,119,79,46,1
26041,1290,597,693,182,182,119,63,504,321,183,43,30,70,28,1
26042,470,289,181,58,47,45,25,501,240,261,80,62,49,42,1
26043,684,274,410,105,135,37,21,288,118,170,50,57,18,15,1
26044,1017,498,519,136,107,82,52,520,261,259,74,52,49,22,1
26045,330,190,140,42,21,30,13,508,251,257,74,53,51,18,1
26046,291,162,129,40,21,32,16,503,263,240,72,55,51,34,1
26047,817,427,390,100,97,87,32,143,65,78,32,11,11,11,1
26048,673,313,360,101,101,46,17,176,73,103,22,29,13,9,1
26049,676,333,343,111,89,94,39,1091,543,548,146,136,110,34,1
26050,462,251,211,74,53,41,18,862,409,453,149,125,86,29,1
26051,429,219,210,46,66,42,17,396,147,249,50,58,21,12,1
26052,358,170,188,54,55,20,10,226,109,117,38,36,13,11,1
26053,93,46,47,6,8,8,8,384,238,146,38,26,66,19,1
26054,383,204,179,61,32,54,16,219,128,91,26,25,27,8,1
26055,235,166,69,18,13,43,10,738,399,339,88,86,83,39,1
26056,646,316,330,89,95,48,17,737,397,340,87,104,90,14,1
26057,410,225,185,49,33,48,30,458,222,236,69,39,35,18,1
26058,135,65,70,21,25,15,9,290,127,163,47,58,23,12,1
26059,231,126,105,37,26,29,6,229,120,109,31,30,22,9,1
26060,574,269,305,91,63,54,27,734,366,368,121,99,63,39,1
26061,391,208,183,65,49,57,17,336,134,202,51,64,27,12,1
26062,515,274,241,85,42,77,23,770,374,396,95,91,79,41,1
26063,1738,821,917,242,196,181,58,537,276,261,75,68,68,22,1
26064,672,334,338,110,93,91,41,478,239,239,65,66,65,21,1
26065,529,283,246,66,69,66,25,536,278,258,72,63,62,20,1
26066,627,302,325,101,91,43,13,537,288,249,60,60,61,19,1
26067,1290,597,693,182,182,119,63,835,420,415,104,105,57,47,1
26068,505,268,237,68,59,34,15,217,109,108,34,32,35,7,1
26069,299,128,171,57,40,13,25,501,248,253,67,71,41,13,1
26070,443,248,195,67,54,40,15,1265,580,685,205,188,166,53,1
26071,413,206,207,38,55,19,10,410,188,222,53,52,31,14,1
26072,381,189,192,74,49,44,13,369,237,132,33,16,38,18,1
26073,138,74,64,14,15,8,2,1247,620,627,134,149,142,58,1
26074,95,44,51,14,13,7,4,414,213,201,61,54,50,19,1
26075,481,256,225,60,56,48,12,825,363,462,97,105,72,75,1
26076,585,289,296,102,86,61,18,195,99,96,29,24,20,12,1
26077,164,61,103,47,19,14,5,496,209,287,113,55,72,14,1
26078,621,320,301,51,62,33,27,1215,572,643,151,105,127,54,1
26079,605,295,310,74,66,70,36,526,254,272,44,43,49,13,1
26080,451,233,218,51,59,52,27,857,370,487,127,103,76,37,1
26081,710,361,349,81,98,63,26,4544,2024,2520,579,628,480,403,1
26082,1382,689,693,186,176,167,77,149,68,81,15,38,11,10,1
26083,386,230,156,49,38,73,24,244,145,99,27,27,34,7,1
26084,631,294,337,83,129,46,24,1233,498,735,252,232,88,41,1
26085,552,285,267,74,51,69,24,1356,576,780,229,198,107,38,1
26086,372,189,183,60,44,41,18,754,318,436,114,106,58,28,1
26087,1193,532,661,160,154,90,90,2944,1827,1117,338,332,122,35,1
26088,509,262,247,64,70,64,20,481,256,225,60,56,48,12,1
26089,704,373,331,74,153,34,10,419,274,145,41,23,28,27,1
26090,370,196,174,63,52,21,18,2671,1322,1349,379,345,290,135,1
26091,252,133,119,39,32,31,18,466,186,280,71,84,30,11,1
26092,758,360,398,114,107,51,19,216,84,132,47,43,17,12,1
26093,246,115,131,15,29,10,32,780,359,421,160,78,169,16,1
26094,294,148,146,35,33,25,14,393,186,207,58,50,36,22,1
26095,275,140,135,34,24,32,15,1152,586,566,131,112,117,42,1
26096,480,234,246,79,77,65,23,480,257,223,74,26,60,27,1
26097,196,107,89,19,18,15,7,217,109,108,34,32,35,7,1
26098,688,323,365,121,69,55,22,1152,556,596,146,159,31,39,1
26099,635,333,302,99,75,83,28,839,408,431,138,122,105,46,1
26100,3224,1440,1784,455,440,333,126,1084,537,547,154,121,92,35,1
26101,447,232,215,55,65,50,25,601,313,288,42,48,25,36,1
26102,667,366,301,96,55,84,25,465,218,247,64,51,50,42,1
26103,481,256,225,60,56,48,12,1189,559,630,179,147,118,35,1
26104,635,333,302,99,75,83,28,537,276,261,75,68,68,22,1
26105,346,173,173,50,56,31,14,640,308,332,91,102,49,21,1
26106,169,87,82,20,15,19,16,1210,592,618,157,138,116,85,1
26107,279,106,173,48,35,41,39,381,186,195,69,55,46,15,1
26108,647,324,323,101,80,76,43,245,112,133,32,45,20,10,1
26109,325,184,141,43,34,22,18,295,143,152,38,47,22,25,1
26110,672,334,338,110,93,91,41,300,140,160,39,35,14,12,1
26111,351,184,167,59,45,54,9,780,369,411,130,113,79,35,1
26112,382,183,199,55,60,38,22,2512,1328,1184,379,280,301,113,1
26113,559,296,263,77,69,42,13,99,50,49,18,11,8,6,1
26114,500,266,234,56,56,55,25,911,416,495,129,125,87,39,1
26115,767,392,375,113,112,83,13,1484,731,753,206,175,187,71,1
26116,517,249,268,65,59,58,26,503,263,240,72,55,51,34,1
26117,1045,374,671,217,143,103,29,101,41,60,18,19,10,5,1
26118,782,347,435,110,92,74,34,982,494,488,150,117,91,45,1
26119,1610,844,766,228,180,232,110,364,241,123,33,16,38,19,1
26120,437,241,196,49,48,61,24,379,184,195,51,61,49,8,1
26121,360,188,172,49,48,47,17,505,226,279,68,51,30,15,1
26122,419,175,244,71,73,23,23,1147,483,664,200,195,95,53,1
26123,249,90,159,29,89,12,4,815,418,397,97,62,70,17,1
26124,474,258,216,63,48,51,24,315,129,186,51,29,24,29,1
26125,2799,1324,1475,369,371,215,124,360,192,168,55,45,48,16,1
26126,537,276,261,75,68,68,22,1858,805,1053,271,345,116,41,1
26127,404,190,214,55,55,35,27,3144,1617,1527,367,342,278,136,1
26128,639,373,266,77,89,68,25,182,99,83,26,30,22,2,1
26129,873,366,507,127,125,75,21,337,175,162,51,47,32,12,1
26130,480,232,248,83,64,51,25,540,257,283,81,63,57,24,1
26131,551,298,253,63,65,45,19,619,292,327,73,73,61,32,1
26132,263,181,82,19,11,39,8,149,68,81,15,38,11,10,1
26133,1417,598,819,223,188,135,58,1471,709,762,198,184,154,62,1
26134,854,380,474,137,159,81,31,165,77,88,28,27,19,10,1
26135,2045,985,1060,359,339,199,74,158,85,73,24,18,18,8,1
26136,333,192,141,50,48,28,10,477,301,176,52,35,45,24,1
26137,1304,585,719,179,169,154,47,1382,689,693,186,176,167,77,1
26138,462,261,201,69,52,48,12,700,343,357,110,83,81,47,1
26139,2045,985,1060,359,339,199,74,876,457,419,88,124,67,47,1
26140,55,36,19,8,3,7,2,142,81,61,11,24,9,6,1
26141,396,147,249,50,58,21,12,517,250,267,78,37,64,29,1
26142,552,285,267,74,51,69,24,621,301,320,76,64,46,34,1
26143,785,374,411,56,42,38,25,4128,2104,2024,581,505,453,205,1
26144,205,82,123,38,28,20,15,354,168,186,50,53,39,20,1
26145,556,283,273,77,55,70,27,296,154,142,38,38,24,16,1
26146,225,102,123,32,32,31,15,267,149,118,45,33,31,14,1
26147,815,418,397,97,62,70,17,1072,538,534,145,128,106,68,1
26148,462,232,230,78,54,42,23,424,209,215,56,58,45,24,1
26149,624,204,420,166,101,32,13,825,399,426,128,128,77,32,1
26150,358,180,178,57,55,39,11,236,121,115,39,20,44,15,1
26151,435,221,214,72,45,47,19,673,313,360,101,101,46,17,1
26152,1186,567,619,161,156,122,49,105,53,52,23,11,12,6,1
26153,224,139,85,20,13,31,12,1141,583,558,141,98,91,45,1
26154,1970,978,992,245,206,198,80,275,125,150,37,48,27,7,1
26155,458,225,233,67,61,43,33,740,313,427,101,135,40,22,1
26156,310,141,169,36,38,20,8,271,136,135,37,30,18,10,1
26157,365,215,150,39,35,43,10,119,57,62,18,16,17,4,1
26158,505,275,230,63,57,35,12,2016,1107,909,214,229,238,111,1
26159,209,125,84,20,22,22,6,327,177,150,40,40,38,18,1
26160,393,186,207,58,50,36,22,418,255,163,42,31,42,22,1
26161,960,409,551,166,134,77,44,377,202,175,46,50,41,23,1
26162,623,320,303,103,85,75,15,425,204,221,71,56,45,13,1
26163,583,322,261,73,66,45,26,532,267,265,86,55,64,22,1
26164,432,219,213,58,51,39,20,673,313,360,101,101,46,17,1
26165,454,191,263,61,66,38,15,207,93,114,20,33,19,10,1
26166,374,247,127,36,14,48,14,427,186,241,55,52,42,23,1
26167,782,378,404,120,112,87,31,193,94,99,34,17,25,19,1
26168,920,492,428,100,92,88,49,433,221,212,59,42,47,14,1
26169,1095,530,565,157,151,98,34,189,90,99,26,29,17,11,1
26170,747,469,278,60,41,53,23,788,381,407,77,41,46,35,1
26171,546,267,279,90,69,56,19,131,74,57,17,14,12,4,1
26172,536,237,299,116,87,42,17,894,420,474,136,146,93,39,1
26173,277,124,153,44,40,35,18,508,267,241,43,35,25,17,1
26174,624,204,420,166,101,32,13,282,96,186,80,21,28,7,1
26175,589,314,275,70,83,44,28,1425,670,755,153,189,122,85,1
26176,1304,696,608,195,169,122,53,467,224,243,70,43,67,23,1
26177,655,281,374,108,103,61,24,904,318,586,264,81,35,10,1
26178,360,218,142,39,26,50,18,355,166,189,54,54,39,17,1
26179,561,255,306,95,67,44,17,217,109,108,34,32,35,7,1
26180,748,355,393,121,91,95,26,465,225,240,65,44,65,25,1
26181,518,274,244,76,58,55,20,277,124,153,44,40,35,18,1
26182,652,329,323,65,70,51,50,577,241,336,112,109,47,21,1
26183,794,390,404,103,95,86,23,1154,540,614,195,160,138,66,1
26184,864,429,435,129,118,68,35,593,295,298,70,85,48,13,1
26185,836,416,420,106,80,85,40,676,333,343,111,89,94,39,1
26186,374,181,193,63,49,46,20,466,247,219,51,32,49,26,1
26187,255,136,119,39,20,32,10,2442,1193,1249,278,183,170,145,1
26188,556,279,277,83,69,71,19,1227,670,557,148,133,97,42,1
26189,3122,1625,1497,374,265,205,79,3830,2000,1830,532,388,418,203,1
26190,1152,459,693,138,343,75,33,255,122,133,35,51,22,13,1
26191,2442,1193,1249,278,183,170,145,508,251,257,74,53,51,18,1
26192,624,275,349,93,99,74,22,984,516,468,78,45,73,12,1
26193,294,122,172,46,65,18,11,583,322,261,73,66,45,26,1
26194,313,159,154,30,40,23,14,379,197,182,52,38,53,32,1
26195,275,125,150,37,48,27,7,172,98,74,20,21,22,8,1
26196,146,71,75,20,17,8,7,131,66,65,21,14,23,7,1
26197,228,105,123,38,29,25,9,189,102,87,23,24,20,11,1
26198,454,191,263,61,66,38,15,1863,721,1142,262,283,139,74,1
26199,1258,531,727,218,216,108,35,226,137,89,20,20,18,5,1
26200,1424,650,774,152,124,95,87,2524,1232,1292,398,317,186,61,1
26201,295,122,173,52,42,22,10,160,53,107,31,29,13,3,1
26202,94,44,50,18,2,12,6,355,220,135,43,26,65,20,1
26203,5938,2573,3365,858,958,396,195,1270,557,713,130,195,57,30,1
26204,529,264,265,63,59,60,35,655,349,306,78,59,76,42,1
26205,248,119,129,33,48,20,10,458,245,213,52,43,27,24,1
26206,169,64,105,23,37,11,3,358,204,154,57,41,36,14,1
26207,975,417,558,161,126,96,44,767,392,375,113,112,83,13,1
26208,303,137,166,54,54,31,15,425,210,215,56,43,52,25,1
26209,282,152,130,35,27,13,21,183,97,86,30,18,20,12,1
26210,656,358,298,67,47,64,26,287,151,136,36,50,21,13,1
26211,1210,592,618,157,138,116,85,583,283,300,73,71,55,23,1
26212,429,219,210,46,66,42,17,299,128,171,57,40,13,25,1
26213,765,351,414,118,102,65,32,641,324,317,88,92,49,14,1
26214,262,151,111,30,17,32,25,128,54,74,30,13,8,7,1
26215,829,366,463,137,130,56,10,380,212,168,47,38,19,11,1
26216,358,170,188,54,55,20,10,373,227,146,40,19,58,21,1
26217,358,192,166,49,48,49,16,536,278,258,72,63,62,20,1
26218,583,279,304,99,71,59,31,140,71,69,33,11,14,2,1
26219,683,365,318,89,69,56,25,1474,756,718,175,158,169,51,1
26220,379,203,176,55,48,45,16,737,363,374,119,101,85,41,1
26221,636,320,316,79,61,67,31,1247,548,699,168,150,140,43,1
26222,249,138,111,32,29,21,8,1290,597,693,182,182,119,63,1
26223,158,72,86,27,14,15,11,383,185,198,50,40,42,18,1
26224,540,257,283,81,63,57,24,538,252,286,77,87,53,30,1
26225,987,515,472,107,110,106,61,536,278,258,72,63,62,20,1
26226,1023,561,462,117,125,96,48,751,312,439,131,115,78,48,1
26227,253,148,105,31,15,39,16,1132,646,486,99,102,71,41,1
26228,443,248,195,67,54,40,15,1124,615,509,157,125,128,52,1
26229,476,270,206,62,45,46,30,1074,538,536,154,140,111,51,1
26230,462,251,211,74,53,41,18,140,81,59,16,15,15,12,1
26231,834,405,429,112,95,84,34,780,337,443,112,116,77,28,1
26232,740,313,427,101,135,40,22,529,264,265,59,68,41,17,1
26233,671,318,353,83,124,46,34,179,89,90,36,28,31,9,1
26234,810,367,443,115,92,94,59,425,244,181,38,26,60,26,1
26235,433,221,212,59,42,47,14,645,297,348,89,105,74,24,1
26236,508,295,213,42,61,53,17,632,339,293,83,77,59,20,1
26237,106,54,52,12,9,7,6,508,251,257,74,53,51,18,1
26238,613,333,280,71,66,47,26,1314,648,666,135,166,103,52,1
26239,470,289,181,58,47,45,25,1225,593,632,158,125,102,38,1
26240,1166,597,569,181,132,123,45,1327,690,637,194,140,130,52,1
26241,1188,476,712,179,163,93,57,1164,622,542,150,143,78,35,1
26242,432,115,317,127,90,24,15,248,118,130,54,31,26,5,1
26243,306,144,162,52,35,40,16,839,439,400,101,86,102,43,1
26244,2063,1024,1039,175,117,80,97,530,259,271,83,50,54,41,1
26245,509,241,268,67,53,56,13,403,220,183,57,39,45,11,1
26246,832,428,404,131,89,88,38,894,420,474,136,146,93,39,1
26247,44,13,31,9,11,1,2,467,250,217,59,52,41,19,1
26248,346,165,181,69,43,22,9,395,222,173,48,42,21,8,1
26249,825,422,403,100,90,62,43,737,362,375,64,74,64,73,1
26250,298,167,131,47,33,40,8,469,253,216,49,51,48,18,1
26251,546,267,279,90,69,56,19,249,140,109,34,26,25,12,1
26252,651,331,320,93,93,51,28,947,506,441,105,126,75,14,1
26253,398,224,174,35,24,54,26,242,114,128,44,47,21,3,1
26254,168,120,48,7,5,20,7,715,324,391,107,92,71,31,1
26255,532,276,256,57,50,32,19,586,254,332,114,111,55,17,1
26256,1192,579,613,120,215,79,24,249,111,138,40,30,22,17,1
26257,390,191,199,66,49,43,12,553,261,292,73,79,40,26,1
26258,303,175,128,43,36,34,12,526,169,357,109,86,69,30,1
26259,339,170,169,32,17,24,13,463,238,225,49,35,31,14,1
26260,493,281,212,57,50,51,20,2261,1217,1044,271,243,267,101,1
26261,505,226,279,68,51,30,15,2063,1024,1039,175,117,80,97,1
26262,295,145,150,41,45,36,18,100,50,50,15,13,10,4,1
26263,255,122,133,35,51,22,13,648,307,341,101,58,76,34,1
26264,2414,1189,1225,277,178,170,169,636,320,316,79,61,67,31,1
26265,210,84,126,44,43,9,4,428,214,214,65,67,45,23,1
26266,425,210,215,56,43,52,25,684,288,396,107,90,54,42,1
26267,185,70,115,37,48,15,5,956,405,551,170,171,64,35,1
26268,621,301,320,76,64,46,34,189,109,80,26,24,9,8,1
26269,847,467,380,117,101,67,24,191,99,92,25,24,18,8,1
26270,906,455,451,116,105,87,46,1129,500,629,171,148,85,30,1
26271,210,89,121,51,34,11,6,241,109,132,29,46,24,12,1
26272,638,300,338,83,53,81,49,615,312,303,86,54,75,45,1
26273,370,176,194,61,30,40,28,1613,806,807,190,211,180,84,1
26274,439,177,262,78,73,40,21,770,356,414,123,102,66,25,1
26275,727,259,468,163,157,68,15,248,118,130,54,31,26,5,1
26276,370,194,176,51,57,43,17,1585,741,844,220,242,103,53,1
26277,329,161,168,40,39,35,14,627,323,304,81,90,53,27,1
26278,393,186,207,58,50,36,22,782,372,410,127,111,89,36,1
26279,228,92,136,43,39,16,7,92,40,52,14,23,13,7,1
26280,4935,2170,2765,672,643,296,115,770,356,414,123,102,66,25,1
26281,597,246,351,95,98,45,25,753,318,435,154,95,56,23,1
26282,417,212,205,55,50,54,24,203,120,83,27,17,24,12,1
26283,297,158,139,47,37,37,9,79,38,41,19,11,17,4,1
26284,918,427,491,113,111,113,33,252,124,128,49,22,19,13,1
26285,480,232,248,83,64,51,25,671,321,350,95,87,75,34,1
26286,400,215,185,59,54,33,16,766,386,380,101,81,78,31,1
26287,778,353,425,140,89,92,51,433,229,204,60,59,53,24,1
26288,624,308,316,92,72,68,22,595,316,279,86,60,65,40,1
26289,1216,552,664,194,189,110,49,359,173,186,55,57,44,16,1
26290,158,85,73,24,18,18,8,1141,583,558,141,98,91,45,1
26291,472,263,209,61,56,56,18,131,66,65,21,14,23,7,1
26292,434,237,197,52,64,37,14,179,96,83,21,18,19,6,1
26293,810,367,443,115,92,94,59,464,231,233,65,62,49,21,1
26294,3116,1179,1937,544,517,223,76,342,160,182,69,40,37,16,1
26295,317,165,152,33,50,27,9,111,53,58,24,21,15,3,1
26296,715,324,391,107,92,71,31,229,105,124,36,33,12,4,1
26297,720,361,359,98,98,70,37,191,98,93,26,18,19,9,1
26298,284,109,175,55,79,9,9,331,169,162,40,28,22,14,1
26299,223,99,124,24,26,27,33,986,465,521,152,132,138,51,1
26300,673,317,356,101,85,76,49,374,187,187,51,52,40,27,1
26301,295,143,152,38,47,22,25,303,175,128,43,36,34,12,1
26302,115,59,56,21,9,9,8,947,482,465,143,107,89,37,1
26303,508,268,240,92,58,56,21,796,445,351,96,80,90,38,1
26304,277,124,153,44,40,35,18,605,263,342,73,103,54,18,1
26305,240,125,115,34,32,30,8,420,218,202,47,49,52,15,1
26306,413,183,230,69,55,37,18,202,102,100,29,35,6,9,1
26307,101,41,60,18,19,10,5,331,169,162,40,28,22,14,1
26308,2080,1094,986,284,295,253,78,151,84,67,17,17,22,11,1
26309,406,211,195,55,37,47,16,622,299,323,86,86,69,35,1
26310,245,137,108,34,30,19,10,1129,589,540,134,122,108,46,1
26311,1045,374,671,217,143,103,29,765,295,470,200,142,84,27,1
26312,336,154,182,51,48,39,22,455,218,237,57,51,42,35,1
26313,892,420,472,135,146,98,37,336,134,202,51,64,27,12,1
26314,426,228,198,62,42,47,22,783,266,517,204,79,127,53,1
26315,443,248,195,67,54,40,15,303,137,166,54,54,31,15,1
26316,855,456,399,96,105,108,47,1464,987,477,137,141,55,31,1
26317,142,72,70,16,20,17,11,398,227,171,47,32,44,17,1
26318,1210,592,618,157,138,116,85,750,347,403,105,103,83,29,1
26319,737,363,374,119,101,85,41,825,363,462,97,105,72,75,1
26320,304,161,143,37,30,43,15,366,183,183,48,47,36,17,1
26321,777,345,432,128,88,65,39,656,358,298,67,47,64,26,1
26322,729,420,309,73,78,57,37,3801,1837,1964,510,442,418,170,1
26323,676,330,346,106,80,83,33,1368,742,626,179,129,189,73,1
26324,614,263,351,85,84,54,35,505,247,258,72,71,60,27,1
26325,1939,813,1126,349,359,143,72,577,288,289,85,56,40,20,1
26326,478,220,258,47,69,41,10,109,50,59,12,12,9,3,1
26327,598,292,306,103,72,56,21,149,68,81,15,38,11,10,1
26328,1058,558,500,132,127,121,53,240,167,73,32,12,8,21,1
26329,650,304,346,80,106,62,28,757,359,398,109,127,80,26,1
26330,730,402,328,69,79,44,44,375,198,177,48,44,45,22,1
26331,71,37,34,11,9,5,5,340,162,178,40,39,35,22,1
26332,356,185,171,37,31,17,21,847,372,475,141,134,77,27,1
26333,297,158,139,47,37,37,9,1085,529,556,149,133,126,54,1
26334,480,234,246,79,77,65,23,413,236,177,41,25,35,19,1
26335,452,202,250,83,60,56,19,1069,512,557,148,126,84,36,1
26336,461,257,204,48,37,78,28,148,89,59,14,15,15,14,1
26337,794,390,404,103,95,86,23,3418,1378,2040,515,464,318,121,1
26338,58,23,35,14,8,5,7,1863,721,1142,262,283,139,74,1
26339,211,126,85,21,20,28,7,239,146,93,30,22,35,9,1
26340,452,217,235,59,47,60,20,467,224,243,70,43,67,23,1
26341,418,213,205,54,56,49,13,267,159,108,31,13,22,15,1
26342,148,77,71,26,24,23,4,174,79,95,36,37,18,6,1
26343,619,292,327,73,73,61,32,410,208,202,59,58,43,26,1
26344,446,246,200,64,48,54,12,500,297,203,66,33,53,15,1
26345,480,234,246,79,77,65,23,476,233,243,76,61,52,21,1
26346,467,201,266,71,70,63,27,632,326,306,92,71,56,19,1
26347,142,73,69,16,14,17,10,331,165,166,52,34,48,22,1
26348,333,192,141,50,48,28,10,892,420,472,135,146,98,37,1
26349,103,51,52,15,17,6,5,80,42,38,12,7,7,4,1
26350,520,261,259,82,76,71,24,505,269,236,52,59,32,18,1
26351,672,334,338,110,93,91,41,148,64,84,33,19,6,1,1
26352,446,176,270,64,79,45,24,117,60,57,24,19,21,2,1
26353,246,108,138,32,44,21,10,143,79,64,16,25,7,5,1
26354,247,110,137,34,45,23,10,504,256,248,78,70,36,9,1
26355,197,99,98,27,26,20,6,521,265,256,69,69,61,26,1
26356,522,235,287,78,67,60,50,440,215,225,76,74,29,16,1
26357,382,230,152,46,22,47,23,476,270,206,62,45,46,30,1
26358,24,14,10,4,2,1,2,218,127,91,27,23,23,10,1
26359,1165,567,598,134,119,158,63,163,70,93,28,21,17,6,1
26360,301,142,159,52,37,21,15,1203,651,552,151,128,123,46,1
26361,928,442,486,139,118,91,43,341,178,163,48,44,42,20,1
26362,651,306,345,85,64,61,32,281,154,127,45,31,24,9,1
26363,837,399,438,112,144,71,32,467,269,198,46,51,60,18,1
26364,346,167,179,56,52,28,13,483,215,268,66,70,30,16,1
26365,595,272,323,111,107,54,28,825,363,462,97,105,72,75,1
26366,245,112,133,32,45,20,10,505,269,236,52,59,32,18,1
26367,676,386,290,102,53,78,19,129,67,62,16,13,17,5,1
26368,247,110,137,34,45,23,10,706,346,360,118,92,98,56,1
26369,560,244,316,92,118,47,12,340,158,182,51,56,9,7,1
26370,2440,1061,1379,377,326,172,62,530,259,271,83,50,54,41,1
26371,205,114,91,25,24,20,15,545,230,315,91,101,50,16,1
26372,280,97,183,55,48,20,20,103,56,47,27,7,8,2,1
26373,754,318,436,114,106,58,28,143,81,62,28,9,8,1,1
26374,484,254,230,60,66,56,14,328,158,170,52,68,45,7,1
26375,458,222,236,69,39,35,18,468,243,225,60,50,34,32,1
26376,349,131,218,66,76,22,9,1443,776,667,191,175,160,56,1
26377,413,194,219,77,72,28,11,393,186,207,58,50,36,22,1
26378,770,355,415,103,142,75,42,609,335,274,79,57,45,22,1
26379,471,246,225,46,38,52,30,172,77,95,32,26,20,13,1
26380,1290,597,693,182,182,119,63,598,300,298,68,77,59,21,1
26381,1493,672,821,258,211,146,47,1186,493,693,184,208,88,32,1
26382,1865,918,947,300,256,217,76,211,114,97,32,24,19,10,1
26383,544,291,253,62,53,35,26,634,317,317,79,67,76,28,1
26384,942,412,530,145,152,88,32,595,316,279,86,60,65,40,1
26385,910,431,479,138,103,98,41,632,326,306,92,71,56,19,1
26386,465,257,208,51,61,54,23,1139,536,603,162,139,109,50,1
26387,500,272,228,44,31,29,18,451,222,229,58,55,51,17,1
26388,569,293,276,63,52,43,20,552,285,267,74,51,69,24,1
26389,673,317,356,101,85,76,49,480,257,223,74,26,60,27,1
26390,388,199,189,50,51,33,14,736,388,348,88,85,67,28,1
26391,358,212,146,51,36,33,9,1147,471,676,229,164,86,37,1
26392,673,313,360,101,101,46,17,223,76,147,49,29,31,5,1
26393,3336,1358,1978,571,599,203,101,149,68,81,15,38,11,10,1
26394,204,84,120,39,39,18,10,377,184,193,50,43,33,17,1
26395,225,116,109,29,19,25,6,356,208,148,42,26,57,15,1
26396,360,192,168,55,45,48,16,418,204,214,68,66,38,12,1
26397,785,374,411,56,42,38,25,207,93,114,20,33,19,10,1
26398,609,292,317,102,96,64,21,376,183,193,50,50,43,21,1
26399,1706,830,876,265,209,230,63,1129,589,540,134,122,108,46,1
26400,211,138,73,14,11,22,17,1801,889,912,206,263,126,42,1
26401,1030,368,662,172,188,56,20,193,99,94,31,31,16,12,1
26402,740,331,409,125,97,79,35,854,434,420,118,91,94,43,1
26403,194,90,104,33,17,24,19,320,163,157,44,44,26,15,1
26404,683,341,342,107,77,93,43,298,167,131,47,33,40,8,1
26405,342,160,182,69,40,37,16,925,414,511,137,144,59,18,1
26406,446,176,270,64,79,45,24,554,215,339,102,65,85,42,1
26407,3695,1922,1773,449,360,352,261,1270,557,713,130,195,57,30,1
26408,148,64,84,33,19,6,1,1893,850,1043,280,340,169,80,1
26409,291,120,171,63,39,26,6,439,205,234,64,88,41,21,1
26410,1227,501,726,198,196,98,51,1706,830,876,265,209,230,63,1
26411,672,334,338,110,93,91,41,1531,691,840,270,226,143,52,1
26412,213,89,124,33,33,17,7,136,72,64,22,16,7,3,1
26413,984,516,468,78,45,73,12,464,167,297,90,81,33,9,1
26414,299,153,146,32,28,29,12,921,455,466,144,127,108,39,1
26415,574,318,256,73,61,66,22,2477,1186,1291,256,271,249,90,1
26416,1052,574,478,139,101,128,39,262,123,139,44,32,25,18,1
26417,764,409,355,88,73,102,43,359,173,186,55,57,44,16,1
26418,275,125,150,37,48,27,7,1270,557,713,130,195,57,30,1
26419,509,254,255,67,55,52,35,128,54,74,30,13,8,7,1
26420,388,199,189,50,51,33,14,348,226,122,23,20,59,25,1
26421,147,81,66,18,18,18,4,392,156,236,40,91,28,16,1
26422,153,82,71,26,12,23,7,426,256,170,52,25,53,34,1
26423,508,215,293,72,71,42,15,1907,1008,899,235,224,195,73,1
26424,1374,679,695,191,193,154,48,409,200,209,69,56,44,13,1
26425,2003,1022,981,195,194,164,229,552,285,267,74,51,69,24,1
26426,204,93,111,35,35,16,11,201,78,123,38,31,19,4,1
26427,553,261,292,73,79,40,26,168,76,92,26,21,19,4,1
26428,245,122,123,21,32,18,13,1822,879,943,236,227,175,97,1
26429,798,287,511,126,125,77,26,462,233,229,66,49,43,30,1
26430,1332,659,673,174,170,153,55,136,72,64,22,16,7,3,1
26431,424,179,245,65,67,29,11,564,315,249,73,60,53,13,1
26432,432,228,204,59,53,43,15,1017,498,519,136,107,82,52,1
26433,671,295,376,126,93,61,28,110,67,43,9,10,11,8,1
26434,352,212,140,37,17,61,20,359,173,186,55,57,44,16,1
26435,635,428,207,46,43,105,41,128,62,66,13,11,17,12,1
26436,377,180,197,45,63,19,17,654,344,310,80,69,57,15,1
26437,1181,612,569,107,121,123,43,469,247,222,70,58,82,13,1
26438,584,293,291,82,67,47,24,617,387,230,65,57,77,16,1
26439,97,50,47,17,14,14,10,1290,597,693,182,182,119,63,1
26440,473,224,249,82,63,48,24,118,56,62,13,14,6,6,1
26441,922,418,504,120,120,106,31,355,222,133,54,32,40,14,1
26442,1102,511,591,171,179,148,52,568,243,325,98,73,56,44,1
26443,622,299,323,86,86,69,35,423,219,204,58,41,69,15,1
26444,140,76,64,17,13,13,8,770,390,380,104,76,78,32,1
26445,427,186,241,55,52,42,23,622,299,323,86,86,69,35,1
26446,1464,715,749,200,167,181,70,423,218,205,64,55,54,15,1
26447,549,277,272,94,63,60,25,191,99,92,25,24,18,8,1
26448,961,463,498,139,156,62,34,240,167,73,32,12,8,21,1
26449,1865,943,922,270,209,228,91,1216,552,664,194,189,110,49,1
26450,862,409,453,149,125,86,29,365,180,185,63,35,48,19,1
26451,369,176,193,56,53,39,35,854,380,474,137,159,81,31,1
26452,1194,543,651,190,197,65,43,1907,1008,899,235,224,195,73,1
26453,673,329,344,111,95,92,41,659,325,334,102,85,87,32,1
26454,433,221,212,59,42,47,14,572,298,274,72,67,52,20,1
26455,161,74,87,17,46,12,13,278,111,167,66,66,19,8,1
26456,688,323,365,121,69,55,22,451,222,229,58,55,51,17,1
26457,132,62,70,21,20,11,7,1076,563,513,129,114,90,37,1
26458,206,85,121,31,42,6,17,220,113,107,31,21,25,12,1
26459,986,499,487,123,116,98,54,207,124,83,22,19,24,11,1
26460,770,305,465,153,120,82,19,202,102,100,29,35,6,9,1
26461,335,188,147,40,37,30,22,1255,708,547,120,68,88,7,1
26462,317,181,136,36,36,26,12,229,120,109,31,30,22,9,1
26463,124,58,66,20,28,11,7,592,295,297,79,70,76,11,1
26464,205,82,123,38,28,20,15,355,165,190,53,56,42,19,1
26465,97,53,44,13,12,7,5,332,198,134,29,17,46,28,1
26466,376,203,173,57,52,48,11,2390,1131,1259,395,383,203,74,1
26467,81,41,40,15,13,3,2,212,105,107,26,25,31,9,1
26468,341,162,179,54,49,41,12,574,273,301,101,74,68,26,1
26469,448,236,212,53,64,56,24,834,465,369,82,84,81,21,1
26470,131,66,65,21,14,23,7,254,146,108,36,20,34,10,1
26471,655,328,327,65,54,55,35,595,316,279,86,60,65,40,1
26472,134,60,74,19,13,10,7,367,161,206,70,48,41,19,1
26473,626,345,281,62,76,66,25,689,484,205,73,55,18,15,1
26474,985,445,540,164,146,68,36,255,122,133,35,51,22,13,1
26475,540,271,269,80,77,51,16,870,436,434,131,114,72,25,1
26476,281,154,127,45,31,24,9,1377,579,798,179,169,139,99,1
26477,577,342,235,63,57,23,37,392,156,236,40,91,28,16,1
26478,191,72,119,40,41,17,8,853,400,453,137,109,88,42,1
26479,647,255,392,99,55,52,17,601,313,288,42,48,25,36,1
26480,1098,519,579,182,159,79,42,371,123,248,104,70,26,15,1
26481,505,226,279,68,51,30,15,358,212,146,51,36,33,9,1
26482,372,184,188,55,55,30,8,325,153,172,62,37,50,39,1
26483,391,208,183,65,49,57,17,362,211,151,46,35,42,12,1
26484,500,215,285,120,41,66,35,835,420,415,104,105,57,47,1
26485,673,329,344,111,95,92,41,769,362,407,99,88,66,67,1
26486,1125,581,544,135,124,137,47,1272,651,621,178,194,79,59,1
26487,432,190,242,85,82,28,11,443,207,236,76,68,52,28,1
26488,513,271,242,54,52,44,13,194,91,103,17,32,9,6,1
26489,193,94,99,34,17,25,19,462,251,211,74,53,41,18,1
26490,237,119,118,34,30,17,8,2442,1193,1249,278,183,170,145,1
26491,522,245,277,78,69,52,21,277,124,153,44,40,35,18,1
26492,908,481,427,118,88,109,49,621,301,320,76,64,46,34,1
26493,2414,1189,1225,277,178,170,169,111,29,82,10,54,0,1,1
26494,1972,846,1126,222,330,114,68,969,505,464,123,133,92,33,1
26495,411,209,202,69,43,18,15,1270,682,588,165,147,136,54,1
26496,347,212,135,35,32,17,6,360,192,168,55,45,48,16,1
26497,261,130,131,27,41,19,16,295,143,152,38,47,22,25,1
26498,474,255,219,61,47,63,23,1068,539,529,161,134,132,71,1
26499,536,278,258,72,63,62,20,1255,666,589,145,142,120,82,1
26500,342,200,142,39,18,55,20,409,200,209,69,56,44,13,1
26501,931,464,467,109,126,119,42,785,412,373,114,84,95,38,1
26502,406,191,215,63,39,42,25,624,222,402,92,81,39,15,1
26503,2109,999,1110,332,294,187,89,757,359,398,109,127,80,26,1
26504,448,199,249,65,54,38,33,533,297,236,74,57,39,28,1
26505,261,144,117,34,22,31,15,582,189,393,117,66,66,6,1
26506,1142,515,627,56,128,113,16,1388,574,814,247,246,108,61,1
26507,855,359,496,142,153,53,24,406,187,219,55,64,24,9,1
26508,1454,780,674,182,120,135,67,894,420,474,136,146,93,39,1
26509,553,261,292,73,79,40,26,705,396,309,87,48,53,17,1
26510,1290,597,693,182,182,119,63,479,238,241,64,47,62,22,1
26511,461,229,232,62,52,56,28,178,100,78,23,22,30,6,1
26512,498,263,235,59,63,36,10,366,211,155,35,42,24,12,1
26513,767,392,375,113,112,83,13,458,265,193,55,35,49,27,1
26514,183,76,107,34,38,14,8,313,166,147,47,44,41,10,1
26515,1591,704,887,253,227,156,50,737,363,374,119,101,85,41,1
26516,1115,586,529,124,161,111,69,140,81,59,27,9,8,6,1
26517,475,238,237,73,53,63,17,493,263,230,52,49,59,20,1
26518,280,136,144,41,34,26,16,261,130,131,27,41,19,16,1
26519,1192,545,647,161,116,105,34,784,391,393,105,113,86,21,1
26520,663,360,303,88,82,80,35,702,298,404,134,111,48,18,1
26521,195,86,109,31,37,19,5,1770,824,946,245,258,179,60,1
26522,757,373,384,115,93,95,25,278,111,167,66,66,19,8,1
26523,524,274,250,79,59,66,16,267,161,106,22,25,35,20,1
26524,624,308,316,92,72,68,22,845,402,443,137,126,105,47,1
26525,651,340,311,81,84,80,29,1720,856,864,259,224,176,85,1
26526,1333,646,687,209,179,148,45,304,159,145,38,40,32,3,1
26527,784,393,391,117,102,65,35,928,442,486,139,118,91,43,1
26528,711,344,367,87,109,74,24,462,232,230,78,54,42,23,1
26529,380,227,153,36,30,48,25,372,237,135,38,22,39,26,1
26530,609,292,317,102,96,64,21,252,123,129,44,32,13,8,1
26531,1182,612,570,142,118,140,62,1074,538,536,154,140,111,51,1
26532,459,221,238,52,56,51,19,724,334,390,112,109,79,17,1
26533,144,69,75,11,21,8,5,464,225,239,85,57,65,19,1
26534,672,334,338,110,93,91,41,1117,556,561,188,117,110,48,1
26535,418,205,213,69,50,29,15,344,168,176,65,44,33,15,1
26536,490,239,251,78,63,66,38,582,293,289,94,80,77,32,1
26537,538,252,286,77,87,53,30,198,80,118,35,31,14,7,1
26538,406,187,219,55,64,24,9,779,370,409,111,105,73,37,1
26539,419,189,230,64,49,36,15,916,442,474,150,133,91,32,1
26540,1822,879,943,236,227,175,97,543,287,256,71,66,64,23,1
26541,312,172,140,41,40,21,8,430,192,238,62,67,27,10,1
26542,989,439,550,142,121,75,29,1328,661,667,210,147,126,55,1
26543,630,294,336,92,90,57,21,854,380,474,137,159,81,31,1
26544,1067,566,501,108,72,106,59,920,492,428,100,92,88,49,1
26545,1357,505,852,245,256,70,35,191,98,93,26,18,19,9,1
26546,697,373,324,105,83,95,38,708,328,380,113,100,82,34,1
26547,546,267,279,90,69,56,19,341,154,187,34,36,11,11,1
26548,448,236,212,53,64,56,24,271,131,140,40,47,34,14,1
26549,509,341,168,35,32,52,15,804,423,381,102,103,105,35,1
26550,377,184,193,56,53,44,14,906,455,451,116,105,87,46,1
26551,1332,659,673,174,170,153,55,3144,1617,1527,367,342,278,136,1
26552,315,129,186,51,29,24,29,201,42,159,19,3,2,75,1
26553,389,146,243,83,47,62,30,621,310,311,100,106,77,27,1
26554,330,159,171,48,38,50,19,504,290,214,60,50,46,21,1
26555,2416,1280,1136,140,374,175,47,467,251,216,56,49,79,11,1
26556,240,134,106,21,17,16,11,333,171,162,41,44,48,23,1
26557,195,109,86,25,24,17,6,1024,507,517,141,122,119,46,1
26558,538,300,238,45,67,66,23,1154,540,614,195,160,138,66,1
26559,478,219,259,82,80,51,18,465,218,247,64,51,50,42,1
26560,206,135,71,18,17,34,10,230,146,84,27,16,45,7,1
26561,667,360,307,76,92,46,27,524,270,254,84,72,70,23,1
26562,158,72,86,27,14,15,11,368,177,191,49,35,50,20,1
26563,160,77,83,14,27,11,10,261,130,131,27,41,19,16,1
26564,398,225,173,43,33,67,14,112,54,58,12,9,7,13,1
26565,282,135,147,27,37,30,19,125,60,65,22,17,14,5,1
26566,236,145,91,17,19,30,18,228,139,89,24,21,32,18,1
26567,1647,794,853,279,235,128,65,385,179,206,58,56,38,19,1
26568,350,180,170,64,46,55,12,314,108,206,45,75,34,8,1
26569,712,396,316,78,69,65,25,304,127,177,61,38,31,4,1
26570,594,274,320,89,63,66,28,1356,672,684,171,172,134,59,1
26571,427,164,263,62,80,14,10,672,334,338,110,93,91,41,1
26572,513,135,378,51,142,24,8,742,303,439,88,96,86,23,1
26573,502,240,262,78,61,54,32,1085,471,614,181,156,110,46,1
26574,96,50,46,8,15,6,2,91,50,41,8,14,4,5,1
26575,989,439,550,142,121,75,29,974,462,512,145,134,82,37,1
26576,366,191,175,37,33,19,19,341,190,151,50,41,23,15,1
26577,802,449,353,102,87,82,29,268,129,139,50,15,33,7,1
26578,360,188,172,49,48,47,17,483,215,268,66,70,30,16,1
26579,556,269,287,86,66,62,22,894,420,474,136,146,93,39,1
26580,568,292,276,69,74,59,34,316,161,155,56,39,34,14,1
26581,1462,652,810,243,199,115,30,746,442,304,82,71,99,36,1
26582,1083,566,517,142,128,136,44,908,489,419,114,131,79,46,1
26583,554,249,305,100,87,44,13,930,479,451,113,101,88,26,1
26584,238,151,87,21,16,24,24,228,139,89,24,21,32,18,1
26585,550,243,307,91,99,70,10,217,109,108,34,32,35,7,1
26586,535,286,249,87,80,59,17,258,113,145,43,44,16,7,1
26587,146,71,75,20,17,8,7,1368,742,626,179,129,189,73,1
26588,295,145,150,41,45,36,18,288,118,170,50,57,18,15,1
26589,536,278,258,72,63,62,20,472,259,213,51,44,56,21,1
26590,271,131,140,47,37,41,11,300,140,160,39,35,14,12,1
26591,598,322,276,67,57,63,26,245,112,133,32,45,20,10,1
26592,225,106,119,32,33,24,10,595,316,279,86,60,65,40,1
26593,341,154,187,34,36,11,11,763,343,420,127,70,105,34,1
26594,245,122,123,21,32,18,13,1117,423,694,182,134,88,31,1
26595,1165,567,598,134,119,158,63,770,374,396,95,91,79,41,1
26596,433,221,212,59,42,47,14,292,152,140,46,38,35,12,1
26597,68,36,32,11,8,9,2,467,250,217,59,52,41,19,1
26598,452,236,216,73,54,50,29,769,362,407,99,88,66,67,1
26599,767,392,375,113,112,83,13,427,205,222,53,52,51,22,1
26600,149,68,81,15,38,11,10,1180,598,582,184,63,87,66,1
26601,1039,597,442,101,110,106,33,472,259,213,51,44,56,21,1
26602,925,484,441,112,86,84,31,543,265,278,52,37,54,19,1
26603,576,284,292,72,68,56,57,375,183,192,52,48,39,23,1
26604,1070,558,512,154,134,126,54,245,111,134,31,44,20,11,1
26605,684,288,396,107,90,54,42,664,241,423,99,138,66,27,1
26606,303,175,128,43,36,34,12,1863,721,1142,262,283,139,74,1
26607,95,44,51,14,13,7,4,271,150,121,39,36,37,5,1
26608,969,505,464,123,133,92,33,619,292,327,73,73,61,32,1
26609,933,536,397,96,90,71,41,1050,473,577,142,119,87,54,1
26610,915,336,579,185,199,56,29,355,179,176,51,45,45,11,1
26611,393,186,207,58,50,36,22,882,432,450,115,111,68,44,1
26612,590,279,311,103,83,69,30,369,237,132,33,16,38,18,1
26613,393,186,207,58,50,36,22,631,309,322,106,83,89,33,1
26614,1288,668,620,163,121,152,55,837,399,438,112,144,71,32,1
26615,777,387,390,90,87,65,37,525,245,280,59,72,47,21,1
26616,1084,537,547,154,121,92,35,191,72,119,40,41,17,8,1
26617,1865,918,947,300,256,217,76,727,346,381,106,100,75,41,1
26618,455,218,237,57,51,42,35,244,160,84,20,22,20,4,1
26619,345,203,142,47,35,31,11,150,60,90,27,16,6,3,1
26620,763,343,420,127,70,105,34,246,108,138,32,44,21,10,1
26621,1091,543,548,146,136,110,34,253,141,112,28,21,33,20,1
26622,683,367,316,87,73,40,17,1273,592,681,199,164,139,39,1
26623,962,430,532,109,142,61,34,408,215,193,47,31,42,17,1
26624,384,238,146,38,26,66,19,134,63,71,27,9,6,8,1
26625,687,355,332,81,59,76,31,1198,620,578,155,151,147,56,1
26626,737,363,374,119,101,85,41,644,329,315,70,64,50,11,1
26627,991,537,454,134,99,80,34,245,111,134,31,44,20,11,1
26628,322,164,158,46,44,29,7,437,228,209,47,61,26,11,1
26629,1231,566,665,164,147,154,103,1663,835,828,224,213,163,63,1
26630,3969,1703,2266,619,432,259,144,467,237,230,73,58,62,15,1
26631,1527,633,894,314,260,134,67,1214,612,602,169,173,98,35,1
26632,1292,592,700,186,169,108,22,346,186,160,48,32,35,14,1
26633,341,170,171,41,66,27,10,941,459,482,167,140,82,38,1
26634,270,147,123,34,17,39,21,402,205,197,62,48,38,19,1
26635,104,48,56,15,15,13,7,352,166,186,55,59,31,16,1
26636,255,113,142,31,40,18,9,1411,472,939,252,262,58,31,1
26637,136,66,70,33,11,9,3,743,377,366,87,74,68,30,1
26638,131,56,75,20,24,9,4,147,54,93,26,38,6,5,1
26639,581,302,279,73,72,53,37,486,230,256,70,60,43,34,1
26640,489,242,247,83,63,62,19,1464,715,749,200,167,181,70,1
26641,191,98,93,26,18,19,9,552,285,267,74,51,69,24,1
26642,648,307,341,101,58,76,34,646,316,330,89,95,48,17,1
26643,1210,592,618,157,138,116,85,1390,695,695,180,137,170,71,1
26644,364,241,123,33,16,38,19,462,224,238,77,75,37,13,1
26645,1573,791,782,198,173,148,46,368,170,198,59,64,29,13,1
26646,362,178,184,50,63,17,8,757,373,384,115,93,95,25,1
26647,508,267,241,57,49,40,13,2472,1055,1417,416,458,235,64,1
26648,669,348,321,83,80,55,23,239,129,110,39,31,33,13,1
26649,637,335,302,83,77,85,26,126,66,60,24,10,7,9,1
26650,146,71,75,20,17,8,7,200,91,109,23,35,13,7,1
26651,469,247,222,70,58,82,13,423,220,203,51,54,46,17,1
26652,1970,978,992,245,206,198,80,172,98,74,20,21,22,8,1
26653,139,73,66,26,13,9,9,92,46,46,14,9,8,6,1
26654,400,215,185,59,54,33,16,360,192,168,55,45,48,16,1
26655,428,226,202,52,60,75,20,603,282,321,74,68,60,38,1
26656,766,395,371,89,86,127,27,458,222,236,69,39,35,18,1
26657,1087,523,564,146,177,103,33,252,128,124,46,31,18,8,1
26658,537,276,261,75,68,68,22,626,345,281,62,76,66,25,1
26659,330,143,187,63,29,52,20,2003,892,1111,347,366,113,46,1
26660,206,85,121,31,42,6,17,297,123,174,51,49,16,10,1
26661,1009,506,503,146,141,97,55,646,315,331,82,84,44,24,1
26662,775,407,368,122,100,97,32,537,273,264,61,62,59,26,1
26663,360,175,185,73,36,27,7,240,167,73,32,12,8,21,1
26664,183,97,86,30,18,20,12,328,182,146,47,35,21,29,1
26665,488,217,271,71,71,50,32,295,146,149,33,32,33,7,1
26666,519,246,273,78,82,42,16,1480,789,691,195,151,173,55,1
26667,1037,461,576,146,163,75,44,245,122,123,21,32,18,13,1
26668,493,230,263,73,47,47,13,433,237,196,60,52,33,27,1
26669,437,225,212,61,57,66,12,243,100,143,38,34,11,13,1
26670,926,435,491,133,132,85,17,218,111,107,45,29,24,6,1
26671,377,171,206,59,58,41,22,269,133,136,30,41,34,17,1
26672,429,219,210,46,66,42,17,307,154,153,39,36,31,12,1
26673,1210,592,618,157,138,116,85,781,418,363,92,90,64,41,1
26674,188,92,96,25,27,18,7,709,359,350,107,102,65,20,1
26675,458,222,236,69,39,35,18,495,233,262,64,39,49,32,1
26676,671,364,307,75,71,58,22,796,445,351,96,80,90,38,1
26677,1816,865,951,246,230,189,76,240,125,115,34,32,30,8,1
26678,204,93,111,35,35,16,11,467,221,246,98,68,43,11,1
26679,423,218,205,64,55,54,15,480,196,284,72,74,25,2,1
26680,904,436,468,138,146,82,39,585,289,296,102,86,61,18,1
26681,482,231,251,76,81,64,26,1051,432,619,179,147,126,54,1
26682,1084,537,547,154,121,92,35,1130,614,516,129,138,98,42,1
26683,1073,547,526,60,60,47,19,480,243,237,75,59,51,25,1
26684,1247,548,699,168,150,140,43,665,297,368,111,107,34,12,1
26685,914,453,461,112,115,79,29,418,204,214,68,66,38,12,1
26686,400,187,213,57,46,51,16,756,348,408,101,103,60,40,1
26687,429,219,210,46,66,42,17,894,469,425,127,93,82,31,1
26688,960,428,532,165,156,94,22,780,337,443,112,116,77,28,1
26689,261,143,118,33,24,32,16,328,182,146,47,35,21,29,1
26690,323,123,200,59,69,30,15,425,199,226,54,71,56,11,1
26691,377,214,163,41,22,48,15,390,224,166,41,27,47,19,1
26692,450,215,235,73,72,53,18,1210,592,618,157,138,116,85,1
26693,442,235,207,53,39,51,16,167,89,78,16,14,18,7,1
26694,359,184,175,49,35,32,11,1796,979,817,189,211,160,52,1
26695,501,240,261,80,62,49,42,271,159,112,34,34,33,7,1
26696,267,159,108,31,13,22,15,119,53,66,33,8,7,6,1
26697,589,296,293,99,76,64,29,200,91,109,29,34,24,7,1
26698,123,69,54,12,10,7,2,1801,889,912,206,263,126,42,1
26699,139,73,66,26,13,9,9,307,133,174,48,53,27,10,1
26700,1102,511,591,171,179,148,52,1284,511,773,227,166,169,107,1
26701,576,250,326,93,71,34,15,323,181,142,40,37,26,16,1
26702,833,390,443,140,111,76,34,930,367,563,181,153,83,48,1
26703,1469,742,727,213,173,93,29,339,170,169,32,17,24,13,1
26704,309,144,165,54,39,25,12,806,419,387,115,130,57,32,1
26705,591,263,328,95,90,26,13,366,211,155,35,42,24,12,1
26706,1591,704,887,253,227,156,50,676,333,343,111,89,94,39,1
26707,330,208,122,44,20,44,12,255,122,133,35,51,22,13,1
26708,4967,2501,2466,718,692,594,248,2138,1161,977,258,229,249,95,1
26709,323,195,128,39,22,51,11,204,99,105,32,32,22,10,1
26710,1257,662,595,176,142,106,42,1068,539,529,161,134,132,71,1
26711,1374,679,695,191,193,154,48,245,112,133,32,45,20,10,1
26712,245,112,133,32,45,20,10,758,362,396,115,102,35,13,1
26713,513,135,378,51,142,24,8,1231,566,665,164,147,154,103,1
26714,347,181,166,27,20,12,12,358,212,146,51,36,33,9,1
26715,826,410,416,98,94,107,39,1154,540,614,195,160,138,66,1
26716,390,191,199,66,49,43,12,1857,992,865,192,204,271,60,1
26717,179,102,77,23,20,6,3,734,339,395,135,89,79,36,1
26718,140,81,59,16,15,15,12,165,90,75,36,18,20,6,1
26719,330,77,253,86,52,20,12,294,148,146,35,33,25,14,1
26720,261,130,131,27,41,19,16,324,154,170,57,40,26,4,1
26721,247,110,137,34,45,23,10,1116,464,652,186,156,99,42,1
26722,611,246,365,116,82,71,27,466,186,280,71,84,30,11,1
26723,186,91,95,30,22,18,7,203,120,83,27,17,24,12,1
26724,209,78,131,33,42,11,7,332,172,160,50,33,35,9,1
26725,1290,597,693,182,182,119,63,2472,1057,1415,331,352,159,96,1
26726,247,110,137,34,45,23,10,293,169,124,52,22,25,12,1
26727,220,110,110,27,28,33,14,275,139,136,42,42,43,13,1
26728,469,247,222,70,58,82,13,304,135,169,48,36,38,26,1
26729,317,153,164,39,30,35,13,912,461,451,127,109,96,48,1
26730,588,296,292,85,76,45,30,473,254,219,66,67,41,16,1
26731,760,322,438,81,130,57,19,295,143,152,38,47,22,25,1
26732,1009,506,503,146,141,97,55,2541,1299,1242,306,302,121,98,1
26733,2045,985,1060,359,339,199,74,327,160,167,56,31,36,15,1
26734,641,341,300,101,91,29,22,466,186,280,71,84,30,11,1
26735,158,85,73,24,18,18,8,1832,784,1048,330,229,199,102,1
26736,1192,649,543,153,145,116,57,445,225,220,47,62,53,26,1
26737,3433,1476,1957,522,578,264,123,780,337,443,112,116,77,28,1
26738,480,256,224,67,55,26,22,990,410,580,140,175,44,36,1
26739,394,207,187,52,42,37,24,424,209,215,56,58,45,24,1
26740,320,163,157,44,44,26,15,552,285,267,74,51,69,24,1
26741,351,184,167,59,45,54,9,381,191,190,55,61,33,11,1
26742,423,198,225,43,47,36,41,416,201,215,54,52,39,25,1
26743,564,315,249,73,60,53,13,525,274,251,82,74,60,25,1
26744,972,519,453,109,98,120,39,583,322,261,73,66,45,26,1
26745,535,249,286,79,64,55,22,728,385,343,110,102,69,14,1
26746,345,176,169,34,31,36,11,660,326,334,106,61,71,32,1
26747,631,288,343,102,92,70,32,509,285,224,61,52,40,19,1
26748,839,446,393,125,110,94,35,941,448,493,150,118,127,39,1
26749,537,270,267,76,63,74,20,676,333,343,111,89,94,39,1
26750,2414,1189,1225,277,178,170,169,422,228,194,26,20,48,37,1
26751,2376,1263,1113,304,241,264,115,462,233,229,66,49,43,30,1
26752,671,318,353,83,124,46,34,229,112,117,42,23,13,10,1
26753,467,226,241,55,48,54,23,876,457,419,88,124,67,47,1
26754,586,270,316,83,80,59,21,1493,672,821,258,211,146,47,1
26755,210,116,94,24,28,21,9,874,431,443,112,120,79,50,1
26756,135,69,66,21,14,11,5,254,107,147,42,37,24,10,1
26757,1154,540,614,195,160,138,66,378,192,186,49,36,45,23,1
26758,360,161,199,72,36,35,13,495,233,262,64,39,49,32,1
26759,490,198,292,65,81,39,27,393,186,207,58,50,36,22,1
26760,458,177,281,90,69,48,9,687,353,334,84,96,74,31,1
26761,123,61,62,17,18,17,7,89,42,47,16,12,15,6,1
26762,2758,1332,1426,394,384,287,131,290,152,138,35,47,38,7,1
26763,163,71,92,22,38,11,7,434,239,195,63,42,71,20,1
26764,983,487,496,126,115,104,52,770,374,396,95,91,79,41,1
26765,2261,1217,1044,271,243,267,101,647,324,323,101,80,76,43,1
26766,108,59,49,17,13,12,5,2549,1331,1218,366,296,271,130,1
26767,1356,576,780,229,198,107,38,353,195,158,40,55,30,13,1
26768,380,187,193,38,51,30,18,441,216,225,57,66,57,19,1
26769,619,332,287,95,77,74,38,575,301,274,84,65,63,20,1
26770,360,188,172,49,48,47,17,798,287,511,126,125,77,26,1
26771,297,158,139,47,37,37,9,432,188,244,76,81,26,13,1
26772,303,159,144,40,35,35,8,1271,599,672,194,175,118,47,1
26773,509,262,247,64,70,64,20,341,174,167,44,34,46,15,1
26774,460,228,232,70,46,46,17,941,448,493,150,118,127,39,1
26775,410,200,210,60,54,46,19,595,316,279,86,60,65,40,1
26776,276,136,140,39,34,33,9,845,402,443,137,126,105,47,1
26777,418,222,196,69,43,40,20,750,404,346,106,95,70,32,1
26778,462,228,234,59,47,37,32,1050,473,577,142,119,87,54,1
26779,467,226,241,55,48,54,23,781,418,363,92,90,64,41,1
26780,272,173,99,32,32,11,8,276,143,133,34,38,20,15,1
26781,113,66,47,11,9,6,5,619,332,287,95,77,74,38,1
26782,522,245,277,78,69,52,21,241,115,126,35,30,17,14,1
26783,1042,530,512,162,150,103,52,430,218,212,58,47,34,20,1
26784,4128,2104,2024,581,505,453,205,270,137,133,30,28,27,11,1
26785,767,392,375,113,112,83,13,954,521,433,135,118,78,26,1
26786,154,78,76,23,21,13,5,521,265,256,69,69,61,26,1
26787,267,159,108,31,13,22,15,423,220,203,51,54,46,17,1
26788,615,339,276,82,76,63,16,1657,800,857,249,235,154,51,1
26789,216,119,97,33,27,28,7,748,355,393,121,91,95,26,1
26790,424,198,226,57,46,41,19,198,80,118,35,31,14,7,1
26791,770,385,385,78,83,60,16,1285,578,707,239,191,136,57,1
26792,209,125,84,20,22,22,6,423,212,211,51,44,48,28,1
26793,52,24,28,6,4,3,5,220,113,107,37,24,16,7,1
26794,747,333,414,102,64,63,46,1049,530,519,102,125,89,48,1
26795,401,213,188,64,48,35,18,503,263,240,72,55,51,34,1
26796,295,158,137,42,34,38,14,377,184,193,50,43,33,17,1
26797,2035,1087,948,163,129,96,73,476,254,222,58,33,46,23,1
26798,2881,1254,1627,442,386,273,102,357,187,170,51,34,40,23,1
26799,189,90,99,26,29,17,11,1382,689,693,186,176,167,77,1
26800,757,373,384,115,93,95,25,305,156,149,37,39,42,5,1
26801,143,79,64,16,25,7,5,261,165,96,25,10,62,12,1
26802,673,287,386,89,111,66,30,317,153,164,39,30,35,13,1
26803,72,35,37,10,9,7,6,254,107,147,42,37,24,10,1
26804,170,80,90,31,22,12,8,255,130,125,44,18,22,12,1
26805,719,364,355,104,100,58,34,560,260,300,100,58,29,28,1
26806,1016,501,515,109,71,76,37,2321,1177,1144,236,255,174,254,1
26807,962,502,460,112,122,109,50,216,119,97,33,27,28,7,1
26808,1608,924,684,163,133,89,29,320,184,136,38,29,20,16,1
26809,524,264,260,75,75,40,21,512,261,251,79,73,60,21,1
26810,1102,511,591,171,179,148,52,717,345,372,85,74,69,41,1
26811,815,418,397,97,62,70,17,167,77,90,22,25,11,11,1
26812,868,448,420,108,103,76,25,355,168,187,48,57,30,15,1
26813,588,255,333,94,82,58,27,597,246,351,95,98,45,25,1
26814,577,241,336,112,109,47,21,586,254,332,114,111,55,17,1
26815,422,203,219,75,49,40,22,255,122,133,35,51,22,13,1
26816,1068,539,529,161,134,132,71,712,380,332,69,74,57,30,1
26817,355,168,187,48,57,30,15,367,161,206,70,48,41,19,1
26818,619,332,287,95,77,74,38,1290,629,661,191,187,167,55,1
26819,537,288,249,60,60,61,19,375,202,173,46,49,41,23,1
26820,594,274,320,89,63,66,28,984,509,475,114,109,106,56,1
26821,964,408,556,131,153,76,55,620,258,362,106,100,47,28,1
26822,686,345,341,93,81,69,30,503,263,240,72,55,51,34,1
26823,461,221,240,70,64,56,32,376,190,186,48,52,44,25,1
26824,969,505,464,123,133,92,33,480,232,248,83,64,51,25,1
26825,163,70,93,28,21,17,6,770,355,415,103,142,75,42,1
26826,420,197,223,72,57,54,19,618,307,311,73,54,46,18,1
26827,953,489,464,126,104,111,44,416,210,206,55,54,39,20,1
26828,1369,651,718,219,182,129,41,648,341,307,78,89,77,21,1
26829,506,243,263,75,70,39,17,4544,2024,2520,579,628,480,403,1
26830,384,238,146,38,26,66,19,99,48,51,15,7,7,7,1
26831,168,76,92,26,21,19,4,245,112,133,32,45,20,10,1
26832,320,163,157,44,44,26,15,654,344,310,80,69,57,15,1
26833,427,218,209,61,53,45,26,505,226,279,68,51,30,15,1
26834,473,230,243,80,56,52,35,463,236,227,64,50,44,29,1
26835,1124,615,509,157,125,128,52,724,334,390,112,109,79,17,1
26836,1374,679,695,191,193,154,48,218,117,101,35,32,34,12,1
26837,683,288,395,125,94,77,39,630,289,341,100,121,62,34,1
26838,1102,511,591,171,179,148,52,1188,476,712,179,163,93,57,1
26839,1675,875,800,213,219,196,72,229,103,126,28,44,17,5,1
26840,234,93,141,42,26,17,15,4391,2256,2135,494,411,423,231,1
26841,697,356,341,82,58,70,25,2639,1436,1203,317,307,242,77,1
26842,473,224,249,82,63,48,24,367,195,172,57,54,43,16,1
26843,317,185,132,34,23,48,12,411,208,203,63,44,52,19,1
26844,1068,559,509,158,132,122,57,153,65,88,27,14,18,9,1
26845,489,242,247,83,63,62,19,467,226,241,55,48,54,23,1
26846,580,339,241,72,47,66,21,386,189,197,54,57,39,16,1
26847,419,175,244,71,73,23,23,790,352,438,132,87,91,60,1
26848,744,354,390,98,82,70,28,1855,852,1003,329,264,184,83,1
26849,1130,639,491,87,188,57,41,928,442,486,139,118,91,43,1
26850,186,98,88,30,22,19,4,639,292,347,95,92,83,20,1
26851,552,285,267,74,51,69,24,347,198,149,45,29,29,8,1
26852,1270,557,713,130,195,57,30,291,120,171,63,39,26,6,1
26853,745,366,379,110,93,79,45,790,352,438,132,87,91,60,1
26854,163,70,93,28,21,17,6,391,208,183,65,49,57,17,1
26855,1960,810,1150,358,377,121,72,172,77,95,27,35,21,11,1
26856,341,178,163,48,44,42,20,168,76,92,26,21,19,4,1
26857,277,100,177,35,88,30,2,450,231,219,77,50,76,16,1
26858,127,55,72,35,7,15,10,362,225,137,43,22,30,11,1
26859,248,143,105,25,29,21,13,652,329,323,65,70,51,50,1
26860,592,291,301,92,93,71,31,521,265,256,69,69,61,26,1
26861,690,310,380,114,85,66,27,619,292,327,73,73,61,32,1
26862,387,198,189,48,48,47,23,482,231,251,76,81,64,26,1
26863,512,261,251,79,73,60,21,198,80,118,35,31,14,7,1
26864,1539,685,854,166,229,123,67,341,178,163,48,44,42,20,1
26865,432,181,251,48,75,27,17,845,402,443,137,126,105,47,1
26866,165,87,78,24,19,22,9,385,194,191,49,50,40,12,1
26867,356,208,148,42,26,57,15,1132,553,579,172,143,150,57,1
26868,467,226,241,55,48,54,23,1258,590,668,190,198,127,62,1
26869,2817,1216,1601,379,436,183,115,255,122,133,35,51,22,13,1
26870,425,210,215,56,43,52,25,2063,1024,1039,175,117,80,97,1
26871,391,208,183,65,49,57,17,160,53,107,31,29,13,3,1
26872,212,93,119,30,27,21,14,524,237,287,87,75,54,26,1
26873,1106,579,527,121,152,113,45,606,307,299,92,56,68,30,1
26874,95,44,51,14,13,7,4,449,237,212,53,63,56,22,1
26875,432,188,244,76,81,26,13,457,237,220,69,44,53,26,1
26876,4829,2417,2412,551,526,409,214,416,210,206,55,54,39,20,1
26877,538,282,256,58,36,60,31,532,337,195,44,42,40,19,1
26878,181,96,85,25,23,20,7,437,200,237,54,48,32,16,1
26879,103,44,59,16,17,9,5,808,357,451,116,98,56,36,1
26880,1195,561,634,155,148,130,74,1215,572,643,151,105,127,54,1
26881,401,167,234,56,71,16,10,227,77,150,35,30,13,21,1
26882,2426,1147,1279,307,320,114,128,396,150,246,103,64,38,3,1
26883,229,103,126,28,44,17,5,149,68,81,15,38,11,10,1
26884,656,358,298,67,47,64,26,1098,558,540,176,133,122,39,1
26885,660,359,301,81,87,102,31,297,145,152,49,30,23,21,1
26886,527,263,264,81,63,72,31,590,306,284,69,82,68,27,1
26887,415,203,212,77,44,49,18,448,275,173,32,53,55,27,1
26888,635,333,302,99,75,83,28,911,551,360,92,106,107,29,1
26889,857,370,487,127,103,76,37,445,225,220,47,62,53,26,1
26890,489,242,247,83,63,62,19,1328,661,667,210,147,126,55,1
26891,415,189,226,69,54,50,21,787,386,401,98,95,86,25,1
26892,480,234,246,79,77,65,23,655,328,327,65,54,55,35,1
26893,273,126,147,54,49,25,18,548,250,298,85,64,56,21,1
26894,219,105,114,36,29,19,8,427,204,223,38,57,26,32,1
26895,580,339,241,72,47,66,21,395,222,173,48,42,21,8,1
26896,400,208,192,62,44,42,21,305,177,128,42,25,39,6,1
26897,168,120,48,7,5,20,7,748,355,393,121,91,95,26,1
26898,782,347,435,110,92,74,34,1254,631,623,152,160,66,44,1
26899,156,64,92,39,19,15,8,791,404,387,103,64,40,24,1
26900,885,424,461,143,114,92,32,463,231,232,66,69,29,18,1
26901,299,128,171,57,40,13,25,1133,491,642,192,170,61,29,1
26902,738,400,338,102,98,109,25,298,140,158,51,33,21,22,1
26903,1336,736,600,137,136,163,69,407,225,182,58,44,44,22,1
26904,1253,639,614,181,155,164,73,673,313,360,101,101,46,17,1
26905,262,123,139,44,32,25,18,831,426,405,101,102,105,32,1
26906,561,255,306,95,67,44,17,536,278,258,72,63,62,20,1
26907,676,295,381,94,71,65,24,217,109,108,34,32,35,7,1
26908,454,224,230,71,39,62,22,102,49,53,14,21,7,4,1
26909,407,180,227,79,42,32,16,1139,536,603,162,139,109,50,1
26910,354,137,217,53,57,30,5,2758,1332,1426,394,384,287,131,1
26911,628,324,304,83,85,75,23,99,47,52,12,16,6,2,1
26912,1308,652,656,166,153,149,87,1342,673,669,178,154,137,94,1
26913,465,218,247,64,51,50,42,229,105,124,36,33,12,4,1
26914,729,391,338,80,64,71,34,467,224,243,70,43,67,23,1
26915,409,208,201,33,45,23,10,940,417,523,190,146,85,26,1
26916,503,263,240,72,55,51,34,379,184,195,51,61,49,8,1
26917,624,308,316,92,72,68,22,536,278,258,72,63,62,20,1
26918,252,125,127,47,22,37,2,217,98,119,33,32,27,7,1
26919,652,329,323,65,70,51,50,1690,1173,517,186,130,110,56,1
26920,163,71,92,22,38,11,7,479,233,246,68,66,36,21,1
26921,199,87,112,31,27,8,15,2136,1063,1073,317,308,223,90,1
26922,372,179,193,50,52,33,6,1356,576,780,229,198,107,38,1
26923,178,100,78,23,22,30,6,532,267,265,86,55,64,22,1
26924,1095,530,565,157,151,98,34,217,109,108,34,32,35,7,1
26925,281,154,127,45,31,24,9,1804,789,1015,274,218,176,63,1
26926,192,92,100,36,20,14,6,243,139,104,41,26,17,9,1
26927,4684,2161,2523,779,782,304,101,375,202,173,46,49,41,23,1
26928,426,234,192,46,41,39,37,249,142,107,36,24,21,5,1
26929,216,103,113,31,25,24,9,552,285,267,74,51,69,24,1
26930,407,182,225,48,38,30,30,632,326,306,92,71,56,19,1
26931,409,200,209,69,56,44,13,736,388,348,88,85,67,28,1
26932,2024,765,1259,283,343,137,76,194,91,103,17,32,9,6,1
26933,117,62,55,24,18,21,2,744,384,360,104,96,57,31,1
26934,1121,458,663,158,210,76,47,297,158,139,47,37,37,9,1
26935,595,316,279,86,60,65,40,279,106,173,48,35,41,39,1
26936,483,274,209,54,39,45,13,247,110,137,34,45,23,10,1
26937,509,254,255,67,55,52,35,1141,562,579,169,144,135,43,1
26938,559,274,285,75,63,52,16,297,158,139,47,37,37,9,1
26939,354,185,169,50,37,40,15,145,75,70,22,18,10,5,1
26940,938,484,454,137,100,104,41,2839,1413,1426,384,301,308,145,1
26941,494,234,260,88,81,61,29,467,224,243,70,43,67,23,1
26942,653,389,264,69,59,51,19,486,254,232,45,33,38,28,1
26943,770,356,414,123,102,66,25,3144,1617,1527,367,342,278,136,1
26944,684,288,396,107,90,54,42,475,224,251,72,64,55,20,1
26945,314,108,206,45,75,34,8,601,313,288,42,48,25,36,1
26946,530,281,249,58,60,33,21,573,278,295,58,79,37,23,1
26947,673,313,360,101,101,46,17,202,102,100,29,35,6,9,1
26948,360,192,168,55,45,48,16,326,176,150,35,22,29,11,1
26949,1085,646,439,108,65,36,19,1199,589,610,189,128,167,65,1
26950,509,262,247,64,70,64,20,335,128,207,59,43,24,23,1
26951,566,263,303,83,87,74,31,173,110,63,35,6,9,8,1
26952,445,228,217,47,62,53,26,581,323,258,74,58,48,20,1
26953,307,150,157,44,23,30,13,395,222,173,48,42,21,8,1
26954,750,347,403,105,103,83,29,461,217,244,44,41,27,36,1
26955,686,345,341,98,106,75,25,278,111,167,66,66,19,8,1
26956,351,184,167,59,45,54,9,154,73,81,24,27,18,9,1
26957,1098,552,546,157,133,110,58,805,338,467,109,145,49,25,1
26958,1571,864,707,201,151,137,67,328,173,155,39,16,45,6,1
26959,577,288,289,85,56,40,20,632,280,352,111,96,55,16,1
26960,1202,506,696,209,198,74,44,1304,585,719,179,169,154,47,1
26961,436,201,235,54,37,34,20,468,238,230,67,69,39,26,1
26962,355,215,140,33,38,27,10,513,271,242,54,52,44,13,1
26963,3256,1307,1949,625,448,159,88,183,76,107,34,38,14,8,1
26964,934,472,462,119,122,87,39,2442,1193,1249,278,183,170,145,1
26965,373,194,179,42,54,26,13,2442,1193,1249,278,183,170,145,1
26966,177,99,78,22,23,20,10,825,363,462,97,105,72,75,1
26967,874,431,443,112,120,79,50,871,437,434,112,113,83,49,1
26968,595,316,279,86,60,65,40,359,150,209,57,75,29,12,1
26969,589,296,293,99,76,64,29,427,230,197,48,28,60,37,1
26970,815,382,433,97,50,88,31,740,313,427,101,135,40,22,1
26971,4374,2058,2316,531,605,321,183,393,186,207,58,50,36,22,1
26972,356,208,148,42,26,57,15,377,177,200,63,53,44,16,1
26973,662,312,350,103,104,59,20,973,497,476,131,108,126,49,1
26974,876,407,469,137,130,73,29,1304,585,719,179,169,154,47,1
26975,393,186,207,58,50,36,22,101,45,56,17,17,12,9,1
26976,261,130,131,27,41,19,16,433,237,196,60,52,33,27,1
26977,360,181,179,40,54,25,18,295,143,152,38,47,22,25,1
26978,478,239,239,65,66,65,21,417,231,186,37,32,43,18,1
26979,217,96,121,38,37,12,9,325,149,176,51,49,24,11,1
26980,1425,670,755,153,189,122,85,341,178,163,48,44,42,20,1
26981,201,112,89,28,24,26,9,603,311,292,102,71,66,23,1
26982,1311,690,621,158,161,128,51,1675,875,800,213,219,196,72,1
26983,284,104,180,54,81,8,10,331,169,162,40,28,22,14,1
26984,202,113,89,16,27,21,11,771,331,440,136,104,72,27,1
26985,1599,806,793,213,237,100,45,407,209,198,55,59,38,19,1
26986,630,345,285,89,60,41,16,703,356,347,96,97,38,22,1
26987,1290,597,693,182,182,119,63,525,299,226,54,54,51,19,1
26988,324,151,173,61,54,32,6,205,100,105,25,25,20,9,1
26989,435,208,227,68,64,53,23,1132,553,579,172,143,150,57,1
26990,941,448,493,150,118,127,39,133,66,67,21,24,9,2,1
26991,272,124,148,51,36,23,27,1791,870,921,217,230,203,112,1
26992,311,187,124,39,38,35,12,1094,543,551,171,121,129,54,1
26993,620,307,313,92,91,92,33,597,313,284,87,75,82,28,1
26994,1255,708,547,120,68,88,7,1149,568,581,177,133,101,30,1
26995,204,84,120,29,30,16,9,229,100,129,34,32,15,6,1
26996,211,92,119,33,44,11,7,533,297,236,74,57,39,28,1
26997,313,166,147,47,44,41,10,854,380,474,137,159,81,31,1
26998,908,489,419,114,131,79,46,318,162,156,53,50,32,13,1
26999,444,232,212,66,34,61,22,362,183,179,49,49,41,11,1
27000,310,161,149,34,31,35,12,1189,559,630,179,147,118,35,1
27001,272,173,99,32,32,11,8,164,61,103,47,19,14,5,1
27002,334,155,179,47,34,38,11,344,151,193,59,51,30,9,1
27003,291,146,145,39,45,22,16,245,137,108,34,30,19,10,1
27004,677,361,316,81,61,42,22,439,205,234,64,88,41,21,1
27005,465,228,237,64,42,63,24,763,364,399,106,96,54,30,1
27006,726,312,414,121,73,82,23,495,218,277,94,62,58,19,1
27007,241,106,135,48,29,17,15,1089,544,545,138,160,117,43,1
27008,593,266,327,102,84,69,24,1102,552,550,174,137,137,45,1
27009,392,156,236,40,91,28,16,1258,531,727,218,216,108,35,1
27010,2044,1089,955,267,233,241,109,240,134,106,21,17,16,11,1
27011,68,34,34,11,8,3,4,585,289,296,102,86,61,18,1
27012,394,183,211,65,60,35,18,1342,673,669,178,154,137,94,1
27013,247,110,137,34,45,23,10,591,304,287,87,79,67,25,1
27014,603,291,312,98,87,61,28,837,399,438,112,144,71,32,1
27015,509,262,247,64,70,64,20,281,166,115,34,17,36,16,1
27016,1722,774,948,199,192,158,167,799,377,422,98,95,80,70,1
27017,374,191,183,70,48,61,13,322,164,158,46,44,29,7,1
27018,815,418,397,97,62,70,17,408,215,193,47,31,42,17,1
27019,501,285,216,52,55,62,25,660,359,301,81,87,102,31,1
27020,940,464,476,116,135,108,58,204,123,81,24,24,22,7,1
27021,841,329,512,137,163,35,26,906,485,421,112,98,112,39,1
27022,358,170,188,54,55,20,10,834,483,351,102,83,103,22,1
27023,287,129,158,48,48,20,9,468,233,235,65,61,49,34,1
27024,716,364,352,107,80,75,26,724,320,404,120,147,67,25,1
27025,876,457,419,88,124,67,47,111,29,82,10,54,0,1,1
27026,426,204,222,73,63,49,9,990,410,580,140,175,44,36,1
27027,276,151,125,44,36,26,9,441,216,225,57,66,57,19,1
27028,2063,1024,1039,175,117,80,97,2115,838,1277,346,354,90,48,1
27029,367,195,172,57,54,43,16,505,275,230,63,57,35,12,1
27030,289,125,164,51,55,17,10,206,85,121,31,42,6,17,1
27031,651,311,340,110,77,73,33,226,120,106,68,8,2,1,1
27032,394,171,223,68,62,24,12,808,415,393,112,107,81,25,1
27033,431,228,203,66,46,59,15,766,386,380,101,81,78,31,1
27034,1657,800,857,249,235,154,51,92,40,52,14,23,13,7,1
27035,912,461,451,127,109,96,48,1771,864,907,239,217,158,63,1
27036,297,158,139,47,37,37,9,215,115,100,27,28,34,16,1
27037,244,122,122,42,38,25,5,2133,789,1344,342,419,135,88,1
27038,1290,629,661,191,187,167,55,1620,884,736,194,161,162,80,1
27039,647,282,365,104,90,53,27,673,317,356,101,85,76,49,1
27040,381,191,190,55,61,33,11,217,109,108,34,32,35,7,1
27041,896,407,489,97,152,70,22,939,493,446,113,100,87,31,1
27042,161,83,78,24,27,17,5,327,172,155,38,41,41,15,1
27043,441,201,240,70,58,55,24,853,355,498,122,156,91,29,1
27044,470,256,214,56,39,47,34,461,257,204,63,49,50,29,1
27045,330,161,169,50,41,27,17,215,80,135,54,56,21,9,1
27046,370,197,173,63,40,40,23,355,214,141,43,29,63,13,1
27047,1474,756,718,175,158,169,51,402,227,175,48,40,35,11,1
27048,245,157,88,25,16,26,10,253,155,98,27,20,22,14,1
27049,379,203,176,55,48,45,16,185,94,91,23,19,17,9,1
27050,390,191,199,66,49,43,12,211,114,97,32,24,19,10,1
27051,281,166,115,34,17,36,16,217,109,108,34,32,35,7,1
27052,386,181,205,55,51,57,31,1032,526,506,129,117,119,47,1
27053,189,91,97,36,24,13,6,122,69,53,18,16,20,4,1
27054,221,75,146,68,21,16,5,240,99,141,53,38,29,15,1
27055,164,61,103,47,19,14,5,1710,650,1060,338,287,185,46,1
27056,930,367,563,181,153,83,48,1132,646,486,99,102,71,41,1
27057,1270,557,713,130,195,57,30,469,225,244,64,69,26,11,1
27058,560,254,306,78,67,75,47,427,186,241,55,52,42,23,1
27059,227,128,99,20,37,20,10,556,283,273,77,55,70,27,1
27060,319,153,166,61,52,26,12,33423,16370,17053,4965,4756,2786,883,1
27061,1424,650,774,152,124,95,87,431,219,212,68,46,67,18,1
27062,105,51,54,13,17,12,8,205,90,115,40,32,25,15,1
27063,2566,1142,1424,414,381,158,90,406,210,196,68,60,25,20,1
27064,219,116,103,36,31,27,9,265,183,82,22,17,41,7,1
27065,1332,659,673,174,170,153,55,166,78,88,27,25,19,7,1
27066,2442,1193,1249,278,183,170,145,193,107,86,13,20,13,6,1
27067,95,44,51,14,13,7,4,535,288,247,79,72,35,21,1
27068,797,382,415,126,94,89,41,1117,556,561,188,117,110,48,1
27069,458,243,215,68,50,67,15,427,186,241,55,52,42,23,1
27070,139,62,77,23,6,14,4,595,316,279,86,60,65,40,1
27071,558,306,252,75,55,74,23,208,128,80,20,17,32,16,1
27072,433,221,212,59,42,47,14,721,363,358,87,104,70,28,1
27073,247,127,120,43,20,27,14,1014,490,524,177,137,94,38,1
27074,219,134,85,22,27,22,10,1441,657,784,140,135,81,73,1
27075,633,303,330,95,91,51,13,261,130,131,27,41,19,16,1
27076,315,135,180,52,82,46,11,223,127,96,25,23,33,4,1
27077,435,221,214,72,45,47,19,512,248,264,66,71,49,30,1
27078,2045,985,1060,359,339,199,74,466,186,280,71,84,30,11,1
27079,285,109,176,54,80,9,9,375,202,173,46,49,41,23,1
27080,351,185,166,45,57,51,14,389,207,182,53,58,52,18,1
27081,522,283,239,65,64,76,22,503,263,240,72,55,51,34,1
27082,913,426,487,136,109,112,43,246,108,138,32,44,21,10,1
27083,1484,731,753,206,175,187,71,435,221,214,72,45,47,19,1
27084,548,320,228,66,54,50,24,500,262,238,74,59,62,28,1
27085,593,291,302,81,85,56,20,560,228,332,113,58,79,38,1
27086,267,124,143,45,46,26,4,493,263,230,52,49,59,20,1
27087,335,183,152,36,27,45,11,119,57,62,18,16,17,4,1
27088,208,96,112,31,32,13,9,655,269,386,128,129,49,21,1
27089,1086,603,483,147,121,95,40,994,547,447,96,106,113,37,1
27090,344,181,163,45,49,40,24,2440,1061,1379,377,326,172,62,1
27091,171,94,77,24,28,30,11,254,107,147,42,37,24,10,1
27092,888,478,410,105,73,58,33,520,261,259,82,76,71,24,1
27093,198,80,118,35,31,14,7,303,175,128,43,36,34,12,1
27094,1009,506,503,146,141,97,55,788,360,428,93,106,67,72,1
27095,1395,627,768,172,263,141,59,460,254,206,58,35,47,28,1
27096,454,224,230,71,39,62,22,231,126,105,37,26,29,6,1
27097,926,435,491,133,132,85,17,906,485,421,112,98,112,39,1
27098,1117,423,694,182,134,88,31,770,356,414,123,102,66,25,1
27099,501,240,261,80,62,49,42,520,231,289,89,59,58,26,1
27100,485,187,298,95,71,61,25,560,228,332,113,58,79,38,1
27101,803,345,458,109,110,68,40,219,104,115,43,32,24,11,1
27102,858,431,427,94,57,54,30,904,436,468,138,146,82,39,1
27103,418,248,170,41,31,54,9,1313,644,669,169,90,111,43,1
27104,316,201,115,29,31,12,6,404,197,207,60,48,47,20,1
27105,683,288,395,125,94,77,39,249,111,138,40,30,22,17,1
27106,586,270,316,83,80,59,21,473,212,261,72,64,45,28,1
27107,986,499,487,123,116,98,54,822,424,398,107,106,86,46,1
27108,2556,1169,1387,248,291,227,275,551,298,253,63,65,45,19,1
27109,240,125,115,34,32,30,8,410,175,235,73,61,37,27,1
27110,390,207,183,50,48,38,15,778,367,411,90,85,64,43,1
27111,969,505,464,123,133,92,33,615,339,276,82,76,63,16,1
27112,797,406,391,121,86,64,15,894,417,477,114,123,89,38,1
27113,720,357,363,113,85,62,39,95,47,48,13,12,10,4,1
27114,148,63,85,23,22,7,7,429,198,231,62,78,42,15,1
27115,117,68,49,13,17,5,3,527,276,251,64,60,70,20,1
27116,802,388,414,131,105,96,29,2414,1189,1225,277,178,170,169,1
27117,390,191,199,66,49,43,12,483,283,200,56,51,45,18,1
27118,275,125,150,37,48,27,7,210,102,108,33,33,20,9,1
27119,211,113,98,38,17,25,8,1210,592,618,157,138,116,85,1
27120,2881,1254,1627,442,386,273,102,778,367,411,90,85,64,43,1
27121,1290,629,661,191,187,167,55,1097,526,571,131,134,120,43,1
27122,802,344,458,156,136,57,24,808,366,442,130,133,66,31,1
27123,625,313,312,103,90,74,29,320,171,149,40,29,30,14,1
27124,711,322,389,112,85,68,40,552,285,267,74,51,69,24,1
27125,401,226,175,53,18,38,20,360,192,168,55,45,48,16,1
27126,415,203,212,77,44,49,18,292,152,140,46,38,35,12,1
27127,296,145,151,42,37,27,13,4074,2166,1908,428,367,446,170,1
27128,613,263,350,106,75,51,28,202,102,100,29,35,6,9,1
27129,1187,631,556,182,139,152,56,512,261,251,79,73,60,21,1
27130,454,224,230,71,39,62,22,294,148,146,35,33,25,14,1
27131,768,354,414,133,106,79,42,410,208,202,59,58,43,26,1
27132,403,185,218,67,62,63,19,771,321,450,151,135,43,15,1
27133,775,407,368,122,100,97,32,1374,679,695,191,193,154,48,1
27134,454,224,230,71,39,62,22,72,35,37,10,9,7,6,1
27135,826,362,464,107,118,71,43,417,232,185,58,50,29,21,1
27136,95,44,51,14,13,7,4,394,183,211,65,60,35,18,1
27137,220,113,107,37,24,16,7,422,203,219,75,49,40,22,1
27138,297,144,153,47,29,34,13,285,109,176,54,80,9,9,1
27139,683,365,318,89,69,56,25,1669,1162,507,154,128,86,51,1
27140,930,367,563,181,153,83,48,2715,1447,1268,409,320,193,113,1
27141,262,144,118,19,39,22,8,1337,667,670,137,143,140,35,1
27142,293,142,151,49,40,42,17,480,232,248,83,64,51,25,1
27143,330,143,187,63,29,52,20,792,399,393,96,103,85,37,1
27144,509,262,247,64,70,64,20,530,259,271,83,50,54,41,1
27145,1314,648,666,135,166,103,52,825,422,403,100,90,62,43,1
27146,462,251,211,74,53,41,18,334,96,238,104,49,19,2,1
27147,173,110,63,35,6,9,8,724,320,404,120,147,67,25,1
27148,320,159,161,44,54,29,9,680,493,187,64,34,48,12,1
27149,660,359,301,81,87,102,31,1464,987,477,137,141,55,31,1
27150,184,78,106,21,25,25,12,377,184,193,50,43,33,17,1
27151,375,173,202,50,46,43,25,158,74,84,26,23,18,18,1
27152,89,42,47,16,12,15,6,4646,2328,2318,674,639,475,170,1
27153,261,130,131,27,41,19,16,1147,471,676,229,164,86,37,1
27154,356,199,157,36,43,28,12,2442,1193,1249,278,183,170,145,1
27155,607,317,290,87,80,73,10,601,313,288,42,48,25,36,1
27156,334,182,152,45,41,27,13,585,289,296,102,86,61,18,1
27157,195,86,109,31,37,19,5,812,456,356,105,74,101,29,1
27158,673,317,356,101,85,76,49,2440,1061,1379,377,326,172,62,1
27159,2639,1436,1203,317,307,242,77,811,400,411,107,87,116,43,1
27160,901,439,462,133,123,102,45,191,99,92,25,24,18,8,1
27161,142,81,61,16,17,14,10,757,414,343,85,59,112,47,1
27162,390,175,215,53,61,26,22,448,198,250,77,66,37,20,1
27163,759,326,433,115,95,61,29,770,356,414,123,102,66,25,1
27164,1290,597,693,182,182,119,63,241,127,114,34,33,29,12,1
27165,498,263,235,59,63,36,10,418,226,192,57,57,53,17,1
27166,552,285,267,74,51,69,24,303,137,166,54,54,31,15,1
27167,658,303,355,97,118,65,28,290,130,160,47,43,32,11,1
27168,583,322,261,73,66,45,26,847,402,445,109,91,100,37,1
27169,378,154,224,74,84,35,22,303,175,128,43,36,34,12,1
27170,862,409,453,149,125,86,29,781,418,363,92,90,64,41,1
27171,377,184,193,56,53,44,14,1149,568,581,177,133,101,30,1
27172,350,215,135,36,21,48,14,418,204,214,68,66,38,12,1
27173,219,104,115,25,31,25,11,149,68,81,15,38,11,10,1
27174,219,97,122,30,29,23,9,192,106,86,25,19,26,9,1
27175,142,60,82,20,28,13,5,67,40,27,10,8,7,6,1
27176,922,418,504,120,120,106,31,437,212,225,66,44,44,11,1
27177,280,118,162,35,32,41,37,1137,641,496,132,130,114,42,1
27178,1066,587,479,127,108,118,48,825,363,462,97,105,72,75,1
27179,748,341,407,121,87,96,52,205,101,104,34,25,34,8,1
27180,1046,562,484,139,116,124,51,2035,1087,948,163,129,96,73,1
27181,603,311,292,102,71,66,23,1164,531,633,179,157,107,46,1
27182,303,147,156,43,20,32,6,593,266,327,102,84,69,24,1
27183,551,286,265,79,71,45,24,673,313,360,101,101,46,17,1
27184,198,80,118,35,31,14,7,433,237,196,60,52,33,27,1
27185,854,380,474,137,159,81,31,264,121,143,57,32,22,15,1
27186,233,94,139,36,37,15,8,225,116,109,29,19,25,6,1
27187,502,240,262,78,61,54,32,266,133,133,43,28,30,8,1
27188,116,58,58,13,14,7,8,364,241,123,33,16,38,19,1
27189,609,292,317,102,96,64,21,505,275,230,63,57,35,12,1
27190,602,310,292,87,66,70,36,1801,889,912,206,263,126,42,1
27191,356,185,171,37,31,17,21,424,255,169,38,26,27,14,1
27192,1730,801,929,328,213,219,64,606,316,290,81,91,60,25,1
27193,298,129,169,51,40,29,8,117,60,57,20,17,16,5,1
27194,295,143,152,38,47,22,25,149,68,81,15,38,11,10,1
27195,229,115,114,27,30,16,9,1379,599,780,214,189,91,33,1
27196,923,509,414,95,102,65,52,190,96,94,21,17,23,10,1
27197,99,56,43,17,9,9,8,368,141,227,64,61,24,13,1
27198,326,176,150,35,22,29,11,246,113,133,33,45,22,10,1
27199,360,167,193,61,34,43,35,647,387,260,69,51,86,38,1
27200,359,163,196,47,78,47,9,537,276,261,75,68,68,22,1
27201,188,92,96,25,27,18,7,192,92,100,36,20,14,6,1
27202,1258,648,610,172,159,116,28,1210,592,618,157,138,116,85,1
27203,264,122,142,33,29,13,13,800,416,384,102,105,83,22,1
27204,352,166,186,55,59,31,16,695,340,355,79,124,53,13,1
27205,459,221,238,72,78,47,16,108,59,49,17,13,12,5,1
27206,123,58,65,22,14,13,3,270,106,164,55,48,27,12,1
27207,686,375,311,89,80,63,20,856,429,427,113,105,96,24,1
27208,789,376,413,101,116,66,40,980,481,499,131,107,85,44,1
27209,2442,1193,1249,278,183,170,145,1505,681,824,201,204,73,32,1
27210,483,274,209,54,39,45,13,300,140,160,39,35,14,12,1
27211,1231,566,665,164,147,154,103,1152,586,566,131,112,117,42,1
27212,105,48,57,37,8,9,6,176,84,92,46,10,28,11,1
27213,267,161,106,22,25,35,20,263,142,121,27,18,34,14,1
27214,267,124,143,45,46,26,4,4563,2219,2344,620,531,527,104,1
27215,744,385,359,125,89,90,23,647,322,325,104,98,54,14,1
27216,206,129,77,27,15,21,6,923,471,452,119,117,119,41,1
27217,497,185,312,63,92,38,28,409,200,209,69,56,44,13,1
27218,839,439,400,101,86,102,43,1290,629,661,191,187,167,55,1
27219,769,405,364,97,101,49,35,89,44,45,15,12,15,6,1
27220,428,226,202,52,60,75,20,425,199,226,54,71,56,11,1
27221,509,254,255,67,55,52,35,208,100,108,27,29,18,9,1
27222,211,114,97,32,24,19,10,577,288,289,85,56,40,20,1
27223,379,203,176,55,48,45,16,341,178,163,48,44,42,20,1
27224,456,209,247,72,58,40,9,635,333,302,99,75,83,28,1
27225,275,125,150,37,48,27,7,351,166,185,48,61,24,15,1
27226,2442,1193,1249,278,183,170,145,341,154,187,34,36,11,11,1
27227,2639,1436,1203,317,307,242,77,295,146,149,33,32,33,7,1
27228,236,141,95,36,32,14,6,582,293,289,94,80,77,32,1
27229,117,57,60,17,14,11,10,755,271,484,113,226,61,20,1
27230,706,346,360,118,92,98,56,1212,645,567,145,117,122,72,1
27231,229,105,124,36,33,12,4,331,169,162,40,28,22,14,1
27232,352,212,140,37,17,61,20,355,165,190,53,56,42,19,1
27233,465,240,225,50,54,24,14,928,442,486,139,118,91,43,1
27234,1406,676,730,210,164,160,73,919,461,458,134,113,91,44,1
27235,455,218,237,57,51,42,35,1154,540,614,195,160,138,66,1
27236,2442,1193,1249,278,183,170,145,316,157,159,45,38,22,19,1
27237,423,222,201,60,51,51,11,949,512,437,102,124,70,41,1
27238,667,312,355,100,134,47,20,557,279,278,66,70,59,26,1
27239,613,334,279,90,71,51,17,320,143,177,51,51,24,10,1
27240,769,405,364,97,101,49,35,2549,1331,1218,366,296,271,130,1
27241,595,272,323,111,107,54,28,366,184,182,46,42,23,18,1
27242,264,122,142,33,29,13,13,211,92,119,33,44,11,7,1
27243,411,171,240,61,81,30,15,530,259,271,83,50,54,41,1
27244,101,41,60,18,19,10,5,920,492,428,100,92,88,49,1
27245,614,305,309,96,73,65,24,321,187,134,59,29,32,8,1
27246,170,83,87,23,32,17,9,1374,679,695,191,193,154,48,1
27247,51,25,26,16,3,15,3,377,180,197,37,20,24,8,1
27248,2045,985,1060,359,339,199,74,106,46,60,27,18,12,3,1
27249,262,144,118,19,39,22,8,1265,580,685,205,188,166,53,1
27250,168,67,101,37,17,13,13,194,91,103,17,32,9,6,1
27251,378,154,224,74,84,35,22,292,152,140,46,38,35,12,1
27252,424,209,215,56,58,45,24,455,191,264,68,86,21,19,1
27253,211,113,98,38,17,25,8,1367,690,677,172,175,154,83,1
27254,1313,644,669,169,90,111,43,126,55,71,14,17,12,16,1
27255,757,373,384,115,93,95,25,426,228,198,62,42,47,22,1
27256,687,353,334,84,96,74,31,928,442,486,139,118,91,43,1
27257,425,150,275,122,65,31,15,202,102,100,29,35,6,9,1
27258,274,158,116,27,27,22,18,712,396,316,78,69,65,25,1
27259,933,536,397,96,90,71,41,287,151,136,36,50,21,13,1
27260,3056,1457,1599,438,389,329,168,1863,721,1142,262,283,139,74,1
27261,402,222,180,50,39,51,19,272,124,148,51,36,23,27,1
27262,483,274,209,54,39,45,13,350,200,150,45,47,23,8,1
27263,1367,690,677,172,175,154,83,354,169,185,54,54,41,19,1
27264,470,226,244,67,80,40,15,247,110,137,34,45,23,10,1
27265,398,224,174,35,24,54,26,418,204,214,68,66,38,12,1
27266,519,246,273,78,82,42,16,1545,828,717,186,149,176,58,1
27267,1881,929,952,259,247,158,57,2472,1055,1417,416,458,235,64,1
27268,201,93,108,34,39,21,6,586,254,332,114,111,55,17,1
27269,502,299,203,57,52,32,11,350,215,135,36,21,48,14,1
27270,190,94,96,24,33,24,6,622,328,294,75,42,67,31,1
27271,546,279,267,94,60,32,22,802,344,458,156,136,57,24,1
27272,450,129,321,128,70,43,15,220,113,107,37,24,16,7,1
27273,652,342,310,71,68,66,17,362,183,179,49,49,41,11,1
27274,1464,715,749,200,167,181,70,892,420,472,135,146,98,37,1
27275,309,106,203,66,49,25,10,643,282,361,94,109,59,24,1
27276,89,42,47,16,12,15,6,1616,735,881,285,248,153,72,1
27277,468,225,243,80,61,62,22,503,263,240,72,55,51,34,1
27278,381,220,161,43,34,47,16,97,53,44,13,12,7,5,1
27279,1464,693,771,153,136,91,86,894,420,474,136,146,93,39,1
27280,890,432,458,127,107,99,50,483,274,209,54,39,45,13,1
27281,1403,702,701,176,173,168,74,606,279,327,81,70,49,34,1
27282,147,79,68,20,15,19,8,906,455,451,116,105,87,46,1
27283,472,259,213,51,44,56,21,788,360,428,93,106,67,72,1
27284,309,155,154,41,44,45,16,673,329,344,111,95,92,41,1
27285,135,65,70,21,25,15,9,482,231,251,76,81,64,26,1
27286,384,212,172,44,43,34,14,360,188,172,49,48,47,17,1
27287,152,87,65,20,19,14,5,229,105,124,36,33,12,4,1
27288,183,76,107,34,38,14,8,1085,646,439,108,65,36,19,1
27289,390,191,199,66,49,43,12,221,75,146,68,21,16,5,1
27290,1865,918,947,300,256,217,76,304,159,145,38,40,32,3,1
27291,378,222,156,49,17,45,26,422,245,177,50,31,42,22,1
27292,2231,1188,1043,225,189,188,118,467,224,243,70,43,67,23,1
27293,732,355,377,108,109,79,27,4128,2104,2024,581,505,453,205,1
27294,380,175,205,57,64,28,11,552,285,267,74,51,69,24,1
27295,358,170,188,54,55,20,10,551,352,199,46,43,77,26,1
27296,437,230,207,41,55,27,13,410,188,222,53,52,31,14,1
27297,261,171,90,21,21,35,17,450,227,223,53,36,48,12,1
27298,510,264,246,67,66,38,29,920,492,428,100,92,88,49,1
27299,245,112,133,32,45,20,10,411,267,144,55,23,24,21,1
27300,465,228,237,64,42,63,24,777,385,392,112,82,100,28,1
27301,1328,661,667,210,147,126,55,2041,1035,1006,223,274,125,60,1
27302,630,326,304,82,62,80,31,2725,1490,1235,339,333,254,78,1
27303,218,133,85,20,19,13,6,677,361,316,81,61,42,22,1
27304,467,226,241,55,48,54,23,258,141,117,33,29,23,10,1
27305,448,236,212,53,64,56,24,537,276,261,75,68,68,22,1
27306,390,209,181,59,47,41,26,359,213,146,44,40,35,20,1
27307,918,427,491,113,111,113,33,201,122,79,27,19,12,3,1
27308,359,173,186,55,57,44,16,458,265,193,55,35,49,27,1
27309,759,391,368,103,82,101,45,2671,1322,1349,379,345,290,135,1
27310,297,158,139,47,37,37,9,137,66,71,16,23,14,4,1
27311,599,301,298,82,56,36,33,832,428,404,131,89,88,38,1
27312,720,356,364,90,98,61,22,648,307,341,101,58,76,34,1
27313,317,153,164,34,52,30,14,657,293,364,109,75,66,28,1
27314,136,66,70,33,11,9,3,1052,492,560,184,163,103,44,1
27315,1500,793,707,169,159,117,70,1065,533,532,147,148,176,40,1
27316,538,252,286,77,87,53,30,318,145,173,29,38,34,22,1
27317,1006,569,437,133,96,76,36,333,192,141,50,48,28,10,1
27318,750,347,403,105,103,83,29,675,311,364,111,80,96,30,1
27319,352,212,140,37,17,61,20,689,343,346,119,100,86,38,1
27320,2944,1827,1117,338,332,122,35,971,447,524,153,124,120,58,1
27321,674,319,355,84,139,50,11,385,179,206,58,56,38,19,1
27322,686,360,326,79,81,96,36,313,174,139,38,34,39,14,1
27323,640,311,329,61,69,70,63,467,251,216,56,49,79,11,1
27324,423,198,225,43,47,36,41,557,240,317,97,74,68,37,1
27325,1270,557,713,130,195,57,30,552,285,267,74,51,69,24,1
27326,656,358,298,67,47,64,26,363,182,181,33,55,23,11,1
27327,589,314,275,70,83,44,28,573,316,257,78,80,21,21,1
27328,1970,978,992,245,206,198,80,265,103,162,61,58,25,3,1
27329,435,208,227,68,64,53,23,725,408,317,93,75,90,45,1
27330,644,343,301,96,69,59,28,467,224,243,70,43,67,23,1
27331,1586,815,771,196,135,138,67,341,154,187,34,36,11,11,1
27332,501,240,261,80,62,49,42,213,86,127,37,33,5,16,1
27333,181,84,97,32,29,19,8,359,173,186,55,57,44,16,1
27334,629,301,328,65,69,77,27,189,104,85,20,16,20,8,1
27335,52,30,22,6,2,3,6,639,373,266,77,89,68,25,1
27336,277,124,153,44,40,35,18,111,29,82,10,54,0,1,1
27337,327,172,155,38,41,41,15,838,460,378,110,79,46,24,1
27338,556,269,287,86,66,62,22,300,140,160,39,35,14,12,1
27339,292,152,140,46,38,35,12,345,155,190,49,56,23,6,1
27340,320,171,149,40,29,30,14,145,70,75,24,16,16,20,1
27341,1314,693,621,174,155,140,58,467,224,243,70,43,67,23,1
27342,418,201,217,53,39,56,15,497,227,270,70,63,66,30,1
27343,183,78,105,30,31,26,8,1749,880,869,237,228,214,112,1
27344,219,105,114,36,29,19,8,182,84,98,20,52,9,9,1
27345,902,332,570,154,146,75,40,928,442,486,139,118,91,43,1
27346,643,294,349,92,97,53,35,294,146,148,50,45,51,15,1
27347,653,326,327,83,96,83,27,894,420,474,136,146,93,39,1
27348,409,200,209,69,56,44,13,302,138,164,50,36,30,20,1
27349,1202,506,696,209,198,74,44,344,151,193,59,51,30,9,1
27350,117,58,59,17,17,12,2,560,244,316,92,118,47,12,1
27351,288,156,132,37,32,22,11,574,298,276,79,75,79,40,1
27352,990,410,580,140,175,44,36,666,344,322,91,73,91,20,1
27353,341,190,151,50,41,23,15,245,93,152,35,28,32,21,1
27354,1749,913,836,255,245,212,68,402,205,197,62,48,38,19,1
27355,828,463,365,94,86,65,21,551,298,253,63,65,45,19,1
27356,305,162,143,45,34,38,18,290,138,152,37,50,24,14,1
27357,632,285,347,102,78,43,29,189,93,96,24,28,17,12,1
27358,307,162,145,38,46,41,15,969,505,464,123,133,92,33,1
27359,108,59,49,17,13,12,5,187,97,90,28,25,21,8,1
27360,262,144,118,19,39,22,8,217,109,108,34,32,35,7,1
27361,550,319,231,49,65,35,16,1117,423,694,182,134,88,31,1
27362,296,147,149,45,29,30,23,261,134,127,39,27,30,11,1
27363,1647,794,853,222,218,151,65,440,214,226,59,62,27,28,1
27364,168,120,48,7,5,20,7,257,109,148,37,30,18,24,1
27365,255,113,142,31,40,18,9,261,108,153,35,37,16,6,1
27366,335,172,163,40,29,31,15,128,67,61,19,13,15,4,1
27367,910,462,448,143,126,90,25,500,244,256,66,57,52,27,1
27368,161,102,59,16,13,11,5,202,102,100,29,35,6,9,1
27369,692,326,366,103,121,67,27,904,436,468,138,146,82,39,1
27370,202,102,100,29,35,6,9,474,214,260,73,58,53,17,1
27371,327,172,155,38,41,41,15,113,79,34,12,4,18,3,1
27372,1106,579,527,121,152,113,45,304,159,145,38,40,32,3,1
27373,423,247,176,58,55,29,20,316,157,159,45,38,22,19,1
27374,660,359,301,81,87,102,31,987,515,472,107,110,106,61,1
27375,714,364,350,98,102,91,27,496,285,211,62,54,46,22,1
27376,770,390,380,104,76,78,32,182,90,92,25,23,14,5,1
27377,462,228,234,59,47,37,32,346,191,155,52,38,40,13,1
27378,905,434,471,136,137,52,40,81,38,43,11,12,5,5,1
27379,780,337,443,112,116,77,28,465,228,237,64,42,63,24,1
27380,1328,661,667,210,147,126,55,767,392,375,113,112,83,13,1
27381,3056,1457,1599,438,389,329,168,631,332,299,61,104,60,19,1
27382,1290,629,661,191,187,167,55,331,165,166,52,34,48,22,1
27383,1382,689,693,186,176,167,77,906,455,451,116,105,87,46,1
27384,489,242,247,83,63,62,19,1210,592,618,157,138,116,85,1
27385,483,274,209,54,39,45,13,975,400,575,160,162,62,31,1
27386,410,222,188,54,49,43,13,1032,565,467,133,81,135,49,1
27387,512,261,251,79,73,60,21,416,210,206,55,54,39,20,1
27388,1046,562,484,139,116,124,51,785,374,411,56,42,38,25,1
27389,684,288,396,107,90,54,42,1194,609,585,195,142,105,37,1
27390,4391,2256,2135,494,411,423,231,1181,612,569,107,121,123,43,1
27391,545,299,246,75,59,38,23,2442,1193,1249,278,183,170,145,1
27392,390,191,199,57,49,45,25,251,139,112,41,18,27,11,1
27393,369,181,188,41,36,54,16,177,85,92,30,21,18,12,1
27394,373,213,160,44,33,27,17,468,233,235,65,61,49,34,1
27395,201,126,75,25,13,22,8,164,88,76,27,20,17,6,1
27396,236,110,126,31,39,10,8,744,384,360,104,96,57,31,1
27397,1089,544,545,138,160,117,43,794,390,404,103,95,86,23,1
27398,192,101,91,25,22,18,9,465,225,240,65,44,65,25,1
27399,94,45,49,11,20,10,4,377,202,175,46,50,41,23,1
27400,2778,1487,1291,317,245,311,226,330,143,187,63,29,52,20,1
27401,198,112,86,20,36,16,5,298,160,138,37,30,22,12,1
27402,364,185,179,58,53,48,15,234,93,141,42,26,17,15,1
27403,1424,650,774,152,124,95,87,447,222,225,71,54,44,25,1
27404,551,237,314,95,79,54,17,1187,631,556,182,139,152,56,1
27405,277,124,153,44,40,35,18,3144,1617,1527,367,342,278,136,1
27406,1807,933,874,248,203,173,71,425,210,215,56,43,52,25,1
27407,388,209,179,51,42,42,16,426,228,198,62,42,47,22,1
27408,194,94,100,35,19,25,16,1466,991,475,136,129,59,39,1
27409,710,307,403,117,176,37,9,262,136,126,41,24,23,17,1
27410,326,153,173,63,48,25,8,670,384,286,58,58,79,52,1
27411,345,203,142,47,35,31,11,92,44,48,6,8,9,8,1
27412,351,184,167,59,45,54,9,969,505,464,123,133,92,33,1
27413,140,76,64,17,13,13,8,377,202,175,46,50,41,23,1
27414,863,470,393,82,72,92,44,258,141,117,33,29,23,10,1
27415,365,206,159,54,22,66,21,534,293,241,72,49,52,18,1
27416,198,98,100,39,23,36,10,616,304,312,75,71,55,25,1
27417,388,195,193,54,48,35,23,355,168,187,55,48,40,15,1
27418,202,102,100,29,35,6,9,684,311,373,109,99,66,16,1
27419,1187,631,556,182,139,152,56,624,308,316,92,72,68,22,1
27420,656,358,298,67,47,64,26,396,256,140,29,24,77,16,1
27421,361,184,177,50,53,51,22,158,83,75,22,14,17,9,1
27422,261,137,124,38,37,29,9,268,124,144,36,34,12,4,1
27423,863,470,393,82,72,92,44,1189,559,630,179,147,118,35,1
27424,2045,985,1060,359,339,199,74,550,243,307,91,99,70,10,1
27425,968,452,516,150,144,79,28,1255,708,547,120,68,88,7,1
27426,477,256,221,69,66,70,12,297,145,152,49,30,23,21,1
27427,1941,910,1031,249,228,160,62,402,227,175,48,40,35,11,1
27428,845,402,443,137,126,105,47,556,300,256,58,73,55,22,1
27429,1278,593,685,198,201,71,43,186,97,89,26,28,13,5,1
27430,504,255,249,56,59,45,13,501,240,261,80,62,49,42,1
27431,919,467,452,125,87,88,37,298,129,169,51,40,29,8,1
27432,778,367,411,90,85,64,43,417,182,235,57,109,50,8,1
27433,453,242,211,59,47,49,11,238,151,87,21,16,24,24,1
27434,1320,599,721,177,156,104,47,894,420,474,136,146,93,39,1
27435,3574,1733,1841,371,392,414,304,1425,670,755,153,189,122,85,1
27436,425,210,215,56,43,52,25,1377,579,798,179,169,139,99,1
27437,621,301,320,76,64,46,34,101,41,60,18,19,10,5,1
27438,799,377,422,98,95,80,70,1049,585,464,107,108,120,28,1
27439,1004,498,506,94,59,46,33,326,141,185,57,39,33,20,1
27440,800,416,384,102,105,83,22,339,170,169,32,17,24,13,1
27441,119,53,66,33,8,7,6,356,208,148,42,26,57,15,1
27442,158,85,73,24,18,18,8,404,157,247,52,69,20,11,1
27443,278,146,132,43,27,22,11,414,193,221,54,49,45,28,1
27444,365,171,194,48,56,36,11,90,46,44,14,15,8,3,1
27445,698,352,346,83,68,89,32,380,187,193,38,51,30,18,1
27446,307,154,153,39,36,31,12,386,189,197,54,57,39,16,1
27447,236,110,126,31,39,10,8,747,366,381,99,90,80,31,1
27448,282,152,130,35,27,13,21,134,63,71,27,9,6,8,1
27449,484,182,302,124,66,20,8,765,295,470,200,142,84,27,1
27450,332,211,121,27,16,41,22,586,254,332,114,111,55,17,1
27451,289,164,125,37,31,35,16,367,161,206,70,48,41,19,1
27452,870,436,434,131,114,72,25,89,42,47,16,12,15,6,1
27453,822,374,448,134,118,76,39,1210,592,618,157,138,116,85,1
27454,957,346,611,205,175,61,29,4935,2170,2765,672,643,296,115,1
27455,1231,603,628,121,162,109,120,3396,1499,1897,325,572,309,90,1
27456,876,457,419,88,124,67,47,272,124,148,51,36,23,27,1
27457,593,266,327,102,84,69,24,244,136,108,21,25,25,13,1
27458,229,111,118,35,24,32,19,1382,599,783,208,252,90,39,1
27459,373,189,184,54,46,50,23,323,181,142,40,37,26,16,1
27460,603,291,312,98,87,61,28,671,295,376,126,93,61,28,1
27461,3056,1457,1599,438,389,329,168,4128,2104,2024,581,505,453,205,1
27462,655,300,355,94,69,53,37,312,172,140,41,40,21,8,1
27463,391,222,169,46,36,30,9,219,124,95,22,22,23,5,1
27464,1354,537,817,245,247,117,57,748,313,435,108,100,65,35,1
27465,509,262,247,64,70,64,20,894,492,402,95,103,88,42,1
27466,729,391,338,80,64,71,34,1170,627,543,131,136,132,47,1
27467,502,247,255,82,57,64,16,357,214,143,30,32,27,13,1
27468,742,303,439,88,96,86,23,948,484,464,134,131,75,27,1
27469,297,158,139,47,37,37,9,252,146,106,38,23,21,9,1
27470,275,151,124,36,24,37,8,165,95,70,18,23,19,11,1
27471,490,224,266,80,70,39,32,2817,1216,1601,379,436,183,115,1
27472,970,440,530,142,102,111,39,631,309,322,106,83,89,33,1
27473,392,206,186,83,49,38,10,288,104,184,80,30,39,6,1
27474,3056,1457,1599,438,389,329,168,143,81,62,28,9,8,1,1
27475,207,97,110,34,27,22,10,448,236,212,53,64,56,24,1
27476,307,133,174,48,53,27,10,777,387,390,90,87,65,37,1
27477,187,81,106,47,32,10,11,202,102,100,29,35,6,9,1
27478,545,230,315,91,101,50,16,462,233,229,66,49,43,30,1
27479,1153,535,618,204,158,93,50,193,105,88,22,25,22,9,1
27480,445,225,220,47,62,53,26,1152,556,596,146,159,31,39,1
27481,1012,532,480,126,125,125,35,402,227,175,48,40,35,11,1
27482,546,267,279,90,69,56,19,2442,1193,1249,278,183,170,145,1
27483,971,516,455,114,115,116,35,499,252,247,75,71,65,25,1
27484,1130,639,491,87,188,57,41,920,492,428,100,92,88,49,1
27485,906,460,446,117,131,108,33,511,247,264,75,73,43,24,1
27486,475,203,272,90,58,50,16,757,373,384,115,93,95,25,1
27487,413,194,219,77,72,28,11,317,153,164,39,30,35,13,1
27488,374,202,172,58,40,41,7,622,331,291,69,74,45,21,1
27489,750,371,379,95,98,86,29,185,94,91,36,13,17,7,1
27490,616,323,293,98,71,31,15,272,136,136,32,34,12,12,1
27491,2315,1086,1229,231,306,248,64,781,418,363,92,90,64,41,1
27492,673,313,360,101,101,46,17,219,124,95,22,22,23,5,1
27493,730,402,328,69,79,44,44,859,411,448,118,100,95,49,1
27494,1400,800,600,158,134,150,65,245,112,133,32,45,20,10,1
27495,687,353,334,84,96,74,31,303,141,162,42,57,37,20,1
27496,201,42,159,19,3,2,75,615,307,308,96,58,66,35,1
27497,724,334,390,112,109,79,17,146,85,61,15,9,12,10,1
27498,399,208,191,57,46,41,20,467,240,227,65,65,51,23,1
27499,707,391,316,111,80,54,30,523,270,253,85,80,39,31,1
27500,1058,558,500,132,127,121,53,593,305,288,91,83,54,24,1
27501,864,429,435,129,118,68,35,550,243,307,91,99,70,10,1
27502,763,361,402,103,144,78,45,1068,539,529,161,134,132,71,1
27503,184,86,98,26,26,14,11,208,96,112,31,32,13,9,1
27504,580,293,287,74,47,52,24,582,313,269,69,53,55,21,1
27505,351,184,167,59,45,54,9,207,128,79,26,17,19,9,1
27506,201,86,115,33,37,8,7,318,176,142,38,33,43,14,1
27507,246,123,123,40,31,27,7,465,225,240,65,44,65,25,1
27508,469,253,216,49,51,48,18,164,78,86,28,23,12,8,1
27509,160,60,100,23,40,19,11,871,437,434,112,113,83,49,1
27510,437,225,212,61,57,66,12,381,189,192,72,48,51,13,1
27511,868,448,420,108,103,76,25,191,101,90,21,23,28,5,1
27512,522,293,229,74,51,49,27,643,282,361,94,109,59,24,1
27513,240,166,74,32,12,8,15,355,168,187,48,57,30,15,1
27514,165,85,80,29,25,16,13,467,224,243,70,43,67,23,1
27515,425,210,215,56,43,52,25,422,213,209,63,60,35,13,1
27516,1210,592,618,157,138,116,85,93,44,49,10,13,6,3,1
27517,272,140,132,38,31,17,9,236,118,118,26,20,18,7,1
27518,1210,592,618,157,138,116,85,325,159,166,39,40,41,14,1
27519,689,343,346,119,100,86,38,87,48,39,15,9,9,3,1
27520,117,65,52,15,16,10,4,366,220,146,36,28,52,17,1
27521,903,437,466,117,112,108,32,588,331,257,86,71,52,12,1
27522,511,257,254,79,67,43,23,350,182,168,39,41,49,14,1
27523,2414,1189,1225,277,178,170,169,216,119,97,33,27,28,7,1
27524,851,417,434,109,116,83,28,393,198,195,47,48,39,14,1
27525,336,154,182,51,48,39,22,618,290,328,82,74,69,42,1
27526,614,305,309,96,73,65,24,1464,693,771,153,136,91,86,1
27527,193,120,73,33,3,16,8,402,227,175,48,40,35,11,1
27528,354,168,186,50,53,39,20,354,169,185,54,54,41,19,1
27529,822,424,398,107,106,86,46,268,129,139,50,15,33,7,1
27530,218,118,100,33,30,25,11,225,125,100,33,32,29,12,1
27531,224,108,116,31,32,22,8,149,68,81,15,38,11,10,1
27532,586,240,346,94,110,29,19,702,298,404,134,111,48,18,1
27533,189,102,87,28,17,22,5,757,359,398,109,127,80,26,1
27534,2328,1054,1274,377,410,232,62,405,180,225,72,57,31,12,1
27535,423,220,203,51,54,46,17,770,355,415,103,142,75,42,1
27536,358,212,146,51,36,33,9,2414,1189,1225,277,178,170,169,1
27537,557,211,346,129,125,48,19,1087,523,564,146,177,103,33,1
27538,94,55,39,18,6,18,5,289,123,166,75,33,13,7,1
27539,938,484,454,137,100,104,41,767,392,375,113,112,83,13,1
27540,977,500,477,139,115,121,31,2671,1322,1349,379,345,290,135,1
27541,815,418,397,97,62,70,17,609,335,274,79,57,45,22,1
27542,1152,556,596,146,159,31,39,433,237,196,60,52,33,27,1
27543,323,154,169,52,52,32,9,467,250,217,59,52,41,19,1
27544,551,298,253,63,65,45,19,349,152,197,55,47,27,13,1
27545,807,360,447,115,114,69,73,770,355,415,103,142,75,42,1
27546,358,170,188,54,55,20,10,513,283,230,61,63,50,24,1
27547,671,303,368,93,68,61,26,149,68,81,15,38,11,10,1
27548,672,334,338,110,93,91,41,825,363,462,97,105,72,75,1
27549,1475,658,817,149,114,120,43,898,467,431,101,127,90,53,1
27550,931,476,455,101,101,44,24,158,85,73,24,18,18,8,1
27551,473,230,243,80,56,52,35,291,131,160,49,35,32,15,1
27552,673,329,344,111,95,92,41,522,283,239,65,64,76,22,1
27553,885,424,461,143,114,92,32,377,221,156,55,38,45,12,1
27554,1042,530,512,162,150,103,52,245,137,108,34,30,19,10,1
27555,492,238,254,72,56,49,20,1038,470,568,130,123,86,51,1
27556,596,286,310,90,89,78,37,745,366,379,110,93,79,45,1
27557,361,184,177,50,53,51,22,443,248,195,67,54,40,15,1
27558,2524,1232,1292,398,317,186,61,448,199,249,65,54,38,33,1
27559,1018,547,471,122,122,120,33,2556,1169,1387,248,291,227,275,1
27560,160,86,74,21,11,16,16,1308,652,656,166,153,149,87,1
27561,3256,1307,1949,625,448,159,88,191,72,119,40,41,17,8,1
27562,722,384,338,94,83,63,35,1101,521,580,177,168,86,45,1
27563,227,110,117,33,26,24,13,622,309,313,75,81,76,29,1
27564,864,429,435,129,118,68,35,267,149,118,45,33,31,14,1
27565,471,254,217,56,57,43,11,601,313,288,42,48,25,36,1
27566,876,457,419,88,124,67,47,439,177,262,78,73,40,21,1
27567,834,405,429,112,95,84,34,512,261,251,79,73,60,21,1
27568,677,245,432,129,155,72,11,210,102,108,33,33,20,9,1
27569,1193,532,661,160,154,90,90,1247,620,627,134,149,142,58,1
27570,361,155,206,43,61,29,18,324,151,173,61,54,32,6,1
27571,285,148,137,31,42,42,16,298,167,131,47,33,40,8,1
27572,79,38,41,8,7,5,7,724,650,74,44,3,32,3,1
27573,1948,1039,909,242,227,200,67,1117,423,694,182,134,88,31,1
27574,222,105,117,37,44,6,18,282,152,130,35,27,13,21,1
27575,469,224,245,67,77,34,17,1599,806,793,213,237,100,45,1
27576,375,200,175,65,30,59,17,672,388,284,75,64,79,36,1
27577,714,364,350,98,102,91,27,1274,669,605,185,172,116,43,1
27578,354,137,217,53,57,30,5,836,407,429,122,89,61,21,1
27579,789,362,427,90,82,70,35,308,164,144,47,29,33,7,1
27580,2063,1024,1039,175,117,80,97,427,191,236,67,60,41,34,1
27581,79,38,41,19,11,17,4,79,38,41,19,11,15,4,1
27582,2027,896,1131,340,313,172,86,854,399,455,127,118,57,39,1
27583,521,265,256,69,69,61,26,168,76,92,26,21,19,4,1
27584,255,134,121,36,40,29,13,344,181,163,61,37,40,14,1
27585,447,194,253,70,67,57,19,503,263,240,72,55,51,34,1
27586,594,274,320,89,63,66,28,1210,592,618,157,138,116,85,1
27587,961,463,498,139,156,62,34,437,228,209,47,61,26,11,1
27588,593,266,327,102,84,69,24,269,148,121,33,22,30,6,1
27589,669,348,321,83,80,55,23,826,362,464,107,118,71,43,1
27590,558,302,256,66,62,65,30,641,324,317,88,92,49,14,1
27591,269,165,104,24,19,27,7,476,270,206,62,45,46,30,1
27592,360,161,199,72,36,35,13,250,122,128,27,23,30,19,1
27593,128,68,60,18,15,17,4,895,479,416,96,119,92,56,1
27594,298,167,131,47,33,40,8,198,80,118,35,31,14,7,1
27595,1336,828,508,166,121,152,48,737,363,374,119,101,85,41,1
27596,101,41,60,18,19,10,5,380,187,193,38,51,30,18,1
27597,391,208,183,65,49,57,17,324,190,134,41,27,28,9,1
27598,241,132,109,33,26,27,13,141,70,71,16,19,12,6,1
27599,427,218,209,61,53,45,26,367,203,164,41,32,39,20,1
27600,707,386,321,85,83,99,28,138,73,65,18,9,10,3,1
27601,509,254,255,67,55,52,35,833,389,444,126,111,85,31,1
27602,247,110,137,34,45,23,10,793,343,450,88,145,65,37,1
27603,671,321,350,95,87,75,34,568,243,325,98,73,56,44,1
27604,277,122,155,33,33,25,24,467,240,227,65,65,51,23,1
27605,274,158,116,27,27,22,18,570,292,278,80,65,72,23,1
27606,297,158,139,47,37,37,9,391,208,183,65,49,57,17,1
27607,509,243,266,80,57,45,19,1089,544,545,138,160,117,43,1
27608,1247,548,699,168,150,140,43,669,340,329,77,61,94,40,1
27609,164,78,86,28,23,12,8,215,115,100,27,28,34,16,1
27610,441,218,223,69,55,50,27,737,320,417,112,94,73,34,1
27611,433,229,204,60,59,53,24,921,455,466,144,127,108,39,1
27612,101,41,60,18,19,10,5,492,317,175,42,31,63,23,1
27613,684,288,396,107,90,54,42,775,443,332,109,86,86,20,1
27614,703,253,450,130,124,51,32,344,151,193,59,51,30,9,1
27615,548,250,298,85,64,56,21,724,334,390,112,109,79,17,1
27616,202,102,100,29,35,6,9,620,258,362,106,100,47,28,1
27617,2083,1005,1078,281,258,228,84,654,344,310,80,69,57,15,1
27618,384,183,201,68,51,46,10,377,202,175,46,50,41,22,1
27619,1117,556,561,188,117,110,48,540,306,234,74,52,43,22,1
27620,684,487,197,65,60,10,12,1487,996,491,147,141,50,35,1
27621,255,130,125,44,18,22,12,412,216,196,24,48,18,16,1
27622,1210,592,618,157,138,116,85,359,184,175,49,35,32,11,1
27623,380,185,195,68,54,32,16,318,164,154,52,43,34,10,1
27624,504,237,267,62,66,48,17,166,83,83,24,30,18,7,1
27625,155,85,70,17,16,4,8,671,303,368,93,68,61,26,1
27626,423,241,182,57,41,67,18,1102,552,550,174,137,137,45,1
27627,863,458,405,97,82,63,57,509,262,247,64,70,64,20,1
27628,357,153,204,84,62,39,2,1192,579,613,120,215,79,24,1
27629,832,428,404,131,89,88,38,1424,650,774,152,124,95,87,1
27630,938,415,523,115,101,69,30,508,267,241,43,35,25,17,1
27631,514,254,260,55,57,56,19,525,264,261,78,61,62,23,1
27632,721,346,375,89,73,65,30,526,264,262,77,71,61,27,1
27633,1106,579,527,121,152,113,45,211,113,98,38,17,25,8,1
27634,398,181,217,65,69,42,17,181,96,85,25,23,20,7,1
27635,337,189,148,30,32,45,11,320,159,161,44,54,29,9,1
27636,106,52,54,18,4,9,8,1059,580,479,138,117,67,27,1
27637,694,360,334,90,88,77,32,180,97,83,29,20,26,8,1
27638,428,226,202,52,60,75,20,577,277,300,71,59,64,24,1
27639,3075,1459,1616,390,359,298,207,122,69,53,18,16,20,4,1
27640,976,496,480,128,111,121,48,1189,559,630,179,147,118,35,1
27641,391,208,183,65,49,57,17,208,104,104,20,54,9,5,1
27642,345,176,169,34,31,36,11,467,224,243,70,43,67,23,1
27643,201,108,93,36,21,17,4,467,226,241,55,48,54,23,1
27644,1140,495,645,129,95,128,159,1399,600,799,236,201,109,58,1
27645,110,53,57,14,15,4,6,404,190,214,55,55,35,27,1
27646,1093,593,500,153,129,134,60,260,133,127,43,32,39,3,1
27647,1014,490,524,177,137,94,38,743,366,377,41,37,26,14,1
27648,91,45,46,9,11,3,9,489,304,185,48,37,65,24,1
27649,140,75,65,22,18,30,7,248,130,118,26,28,16,11,1
27650,67,34,33,10,12,6,5,395,186,209,53,48,46,30,1
27651,546,279,267,94,60,32,22,821,387,434,121,131,76,29,1
27652,360,188,172,49,48,47,17,425,210,215,56,43,52,25,1
27653,252,124,128,49,22,19,13,1669,1162,507,154,128,86,51,1
27654,542,249,293,82,69,58,31,317,153,164,34,52,30,14,1
27655,673,317,356,101,85,76,49,255,142,113,40,32,27,6,1
27656,501,240,261,80,62,49,42,518,262,256,70,52,49,27,1
27657,2442,1193,1249,278,183,170,145,3969,1703,2266,619,432,259,144,1
27658,898,467,431,101,127,90,53,306,167,139,42,51,23,8,1
27659,1274,674,600,169,166,82,50,529,264,265,59,68,41,17,1
27660,262,114,148,46,44,30,16,426,221,205,71,51,39,21,1
27661,261,108,153,35,37,16,6,100,50,50,15,13,10,4,1
27662,443,248,195,67,54,40,15,537,276,261,75,68,68,22,1
27663,179,102,77,23,20,6,3,754,301,453,139,95,99,45,1
27664,1706,830,876,265,209,230,63,644,343,301,96,69,59,28,1
27665,2442,1193,1249,278,183,170,145,346,168,178,36,43,20,9,1
27666,153,81,72,22,18,16,8,630,290,340,102,70,70,37,1
27667,1537,701,836,209,187,129,58,894,420,474,136,146,93,39,1
27668,158,85,73,24,18,18,8,789,362,427,90,82,70,35,1
27669,369,167,202,66,59,39,20,611,246,365,116,82,71,27,1
27670,115,57,58,14,10,19,8,1308,652,656,166,153,149,87,1
27671,273,137,136,34,19,22,13,342,204,138,36,21,63,22,1
27672,1009,506,503,146,141,97,55,906,455,451,116,105,87,46,1
27673,396,226,170,26,35,47,18,1132,646,486,99,102,71,41,1
27674,686,345,341,98,106,75,25,345,169,176,57,50,32,15,1
27675,605,295,310,74,66,70,36,377,184,193,56,53,44,14,1
27676,347,194,153,53,44,40,10,1215,652,563,129,142,121,62,1
27677,2813,1331,1482,320,339,261,290,1366,943,423,137,109,58,19,1
27678,1565,699,866,236,276,110,26,743,341,402,104,89,68,38,1
27679,815,418,397,97,62,70,17,296,149,147,54,34,39,16,1
27680,569,290,279,86,58,61,16,272,133,139,40,35,33,8,1
27681,549,303,246,64,54,59,35,1801,889,912,206,263,126,42,1
27682,375,167,208,55,83,44,9,350,180,170,64,46,55,12,1
27683,113,47,66,14,15,11,17,412,244,168,47,42,56,15,1
27684,332,185,147,31,59,7,4,339,177,162,40,36,51,24,1
27685,178,100,78,23,22,30,6,624,308,316,92,72,68,22,1
27686,1006,468,538,151,135,82,39,175,90,85,28,21,19,7,1
27687,605,283,322,94,72,64,39,236,121,115,26,45,28,6,1
27688,1332,626,706,182,144,80,41,427,218,209,56,57,53,24,1
27689,482,231,251,76,81,64,26,882,432,450,115,111,68,44,1
27690,180,95,85,22,21,17,8,1210,592,618,157,138,116,85,1
27691,224,108,116,31,32,22,8,155,85,70,17,16,4,8,1
27692,158,85,73,24,18,18,8,552,285,267,74,51,69,24,1
27693,764,277,487,158,162,64,31,1242,613,629,174,113,114,53,1
27694,349,186,163,43,45,51,12,582,293,289,94,80,77,32,1
27695,259,128,131,42,38,28,7,335,185,150,46,34,36,13,1
27696,787,386,401,98,95,86,25,441,216,225,57,66,57,19,1
27697,199,101,98,29,25,18,6,834,335,499,129,110,84,33,1
27698,292,154,138,46,29,41,7,556,279,277,83,69,71,19,1
27699,140,62,78,28,14,8,5,224,99,125,27,37,14,3,1
27700,921,455,466,144,127,108,39,1205,632,573,156,149,102,48,1
27701,222,106,116,31,27,27,15,1627,782,845,204,187,202,108,1
27702,1342,640,702,187,163,123,57,2063,1024,1039,175,117,80,97,1
27703,283,112,171,48,39,34,15,2109,999,1110,332,294,187,89,1
27704,906,455,451,116,105,87,46,829,366,463,137,130,56,10,1
27705,95,44,51,14,13,7,4,433,220,213,67,68,31,19,1
27706,330,143,187,63,29,52,20,1624,808,816,183,197,132,170,1
27707,1893,850,1043,280,340,169,80,295,143,152,38,47,22,25,1
27708,265,119,146,44,52,12,9,474,214,260,73,58,53,17,1
27709,165,80,85,30,20,12,9,601,272,329,100,100,51,22,1
27710,467,226,241,55,48,54,23,1137,531,606,185,135,94,43,1
27711,690,327,363,115,91,54,31,250,130,120,40,32,19,13,1
27712,303,159,144,40,35,35,8,385,174,211,38,32,23,12,1
27713,838,385,453,110,137,78,28,460,254,206,58,35,47,28,1
27714,411,208,203,63,44,52,19,365,210,155,46,30,24,12,1
27715,747,469,278,60,41,53,23,2035,1087,948,163,129,96,73,1
27716,380,212,168,47,38,19,11,508,267,241,57,49,40,13,1
27717,709,294,415,132,123,76,23,216,119,97,33,27,28,7,1
27718,391,203,188,49,48,41,14,327,177,150,40,40,38,18,1
27719,1094,508,586,152,151,77,36,193,105,88,22,25,22,9,1
27720,771,321,450,151,135,43,15,1382,599,783,208,252,90,39,1
27721,124,72,52,14,12,13,6,283,132,151,57,33,12,7,1
27722,354,137,217,53,57,30,5,918,490,428,114,100,115,41,1
27723,186,91,95,30,22,18,7,96,55,41,13,2,8,5,1
27724,583,322,261,73,66,45,26,1106,579,527,121,152,113,45,1
27725,962,502,460,112,122,109,50,2090,1085,1005,167,141,168,40,1
27726,586,273,313,100,79,40,19,200,97,103,33,26,21,9,1
27727,456,228,228,49,70,32,19,1943,846,1097,301,257,135,77,1
27728,1168,652,516,155,113,134,68,1037,575,462,122,150,82,32,1
27729,450,241,209,67,58,54,23,382,200,182,53,36,51,16,1
27730,525,264,261,78,61,62,23,577,277,300,71,59,64,24,1
27731,442,254,188,54,31,50,30,212,88,124,46,24,22,16,1
27732,512,261,251,79,73,60,21,336,154,182,51,48,39,22,1
27733,297,158,139,47,37,37,9,636,320,316,79,61,67,31,1
27734,326,166,160,49,45,36,12,261,130,131,27,41,19,16,1
27735,910,431,479,138,103,98,41,597,313,284,87,75,82,28,1
27736,233,121,112,24,31,30,7,391,204,187,47,48,38,18,1
27737,1009,506,503,146,141,97,55,217,109,108,34,32,35,7,1
27738,787,386,401,98,95,86,25,309,154,155,42,44,45,16,1
27739,794,390,404,103,95,86,23,1863,721,1142,262,283,139,74,1
27740,279,106,173,48,35,41,39,781,418,363,92,90,64,41,1
27741,408,271,137,36,18,38,23,413,227,186,45,34,58,23,1
27742,1087,481,606,102,80,92,18,1894,962,932,232,209,205,90,1
27743,581,254,327,100,83,54,20,595,316,279,86,60,65,40,1
27744,369,180,189,62,70,24,21,1021,487,534,135,113,119,32,1
27745,214,108,106,29,32,21,7,294,148,146,35,33,25,14,1
27746,290,149,141,46,38,33,9,441,211,230,67,45,53,14,1
27747,496,256,240,78,67,75,13,903,437,466,117,112,108,32,1
27748,415,189,226,69,54,50,21,638,305,333,68,90,70,29,1
27749,446,176,270,64,79,45,24,755,348,407,109,98,49,23,1
27750,538,252,286,77,87,53,30,443,217,226,65,67,40,11,1
27751,589,314,275,70,83,44,28,797,395,402,107,117,77,22,1
27752,2524,1232,1292,398,317,186,61,320,163,157,44,44,26,15,1
27753,740,313,427,101,135,40,22,596,292,304,92,60,56,19,1
27754,1165,567,598,134,119,158,63,1132,553,579,172,143,150,57,1
27755,1462,652,810,243,199,115,30,437,212,225,66,44,44,11,1
27756,361,155,206,43,61,29,18,940,464,476,116,135,108,58,1
27757,536,278,258,72,63,62,20,1390,695,695,180,137,170,71,1
27758,629,338,291,92,57,64,22,360,188,172,49,48,47,17,1
27759,378,154,224,74,84,35,22,326,166,160,49,45,36,12,1
27760,461,238,223,67,61,41,23,375,202,173,46,49,41,23,1
27761,317,165,152,33,50,27,9,500,234,266,72,63,58,33,1
27762,450,241,209,67,58,54,23,537,276,261,75,68,68,22,1
27763,1034,451,583,165,146,104,40,926,435,491,133,132,85,17,1
27764,815,418,397,97,62,70,17,576,250,326,93,71,34,15,1
27765,593,266,327,102,84,69,24,676,295,381,94,71,65,24,1
27766,205,82,123,38,28,20,15,953,481,472,133,130,77,48,1
27767,938,484,454,137,100,104,41,183,91,92,21,29,16,10,1
27768,331,177,154,46,38,49,17,211,88,123,38,28,26,10,1
27769,422,213,209,63,60,35,13,769,329,440,116,66,55,22,1
27770,382,214,168,49,20,47,23,354,169,185,54,54,41,19,1
27771,400,208,192,62,44,42,21,211,86,125,35,32,10,9,1
27772,3685,1574,2111,579,580,303,116,400,191,209,51,60,30,9,1
27773,646,316,330,89,95,48,17,698,365,333,108,83,65,21,1
27774,979,480,499,109,108,130,45,918,427,491,113,111,113,33,1
27775,524,264,260,75,75,40,21,509,262,247,64,70,64,20,1
27776,931,464,467,109,126,119,42,749,398,351,118,77,87,29,1
27777,374,191,183,70,48,61,13,365,180,185,63,35,48,19,1
27778,2063,1024,1039,175,117,80,97,778,367,411,90,85,64,43,1
27779,86,52,34,9,8,8,3,290,149,141,37,26,41,12,1
27780,454,223,231,38,45,24,19,589,281,308,69,39,63,20,1
27781,582,293,289,94,80,77,32,429,223,206,50,32,46,17,1
27782,710,361,349,81,98,63,26,815,418,397,97,62,70,17,1
27783,245,112,133,32,45,20,10,583,284,299,86,61,67,23,1
27784,573,278,295,58,79,37,23,416,210,206,55,54,39,20,1
27785,691,307,384,93,128,45,19,2414,1189,1225,277,178,170,169,1
27786,848,394,454,100,90,101,41,920,492,428,100,92,88,49,1
27787,499,298,201,55,52,37,15,431,234,197,51,53,33,13,1
27788,703,308,395,81,91,66,80,770,355,415,103,142,75,42,1
27789,360,192,168,55,45,48,16,118,56,62,13,14,6,6,1
27790,920,492,428,100,92,88,49,1019,522,497,159,138,142,40,1
27791,412,195,217,79,48,36,29,324,154,170,57,40,26,4,1
27792,345,203,142,47,35,31,11,480,252,228,55,37,49,20,1
27793,165,78,87,23,21,17,8,97,53,44,13,12,7,5,1
27794,593,266,327,102,84,69,24,439,227,212,60,55,58,8,1
27795,168,67,101,37,17,13,13,219,104,115,43,32,24,11,1
27796,467,226,241,55,48,54,23,1627,782,845,204,187,202,108,1
27797,727,259,468,163,157,68,15,254,117,137,33,35,38,6,1
27798,228,72,156,42,27,8,7,522,245,277,78,69,52,21,1
27799,446,176,270,64,79,45,24,549,318,231,82,41,47,21,1
27800,275,140,135,38,32,18,5,445,219,226,61,60,60,21,1
27801,476,227,249,52,59,38,17,1222,648,574,138,139,132,38,1
27802,537,288,249,60,60,61,19,396,147,249,50,58,21,12,1
27803,172,83,89,26,25,18,7,212,107,105,32,25,22,7,1
27804,524,264,260,75,75,40,21,377,184,193,56,53,44,14,1
27805,340,172,168,60,50,36,10,677,392,285,77,67,102,19,1
27806,926,435,491,133,132,85,17,499,272,227,49,66,66,21,1
27807,298,181,117,43,23,40,12,760,391,369,101,109,65,24,1
27808,2442,1193,1249,278,183,170,145,740,385,355,114,97,91,27,1
27809,336,154,182,51,48,39,22,1498,615,883,226,244,60,46,1
27810,1669,1162,507,154,128,86,51,770,355,415,103,142,75,42,1
27811,411,221,190,49,46,46,17,621,310,311,100,106,77,27,1
27812,252,146,106,38,23,21,9,520,231,289,89,59,58,26,1
27813,912,461,451,127,109,96,48,147,68,79,31,23,8,4,1
27814,428,226,202,52,60,75,20,505,247,258,72,71,60,27,1
27815,925,484,441,112,86,84,31,466,186,280,71,84,30,11,1
27816,393,186,207,58,50,36,22,306,155,151,43,34,36,17,1
27817,412,192,220,71,50,48,23,349,166,183,49,37,25,52,1
27818,456,228,228,49,70,32,19,377,184,193,50,43,33,17,1
27819,802,375,427,133,103,81,41,178,74,104,31,28,9,4,1
27820,938,484,454,137,100,104,41,1484,731,753,206,175,187,71,1
27821,1205,632,573,156,149,102,48,521,265,256,69,69,61,26,1
27822,393,186,207,58,50,36,22,160,67,93,32,37,15,9,1
27823,785,374,411,56,42,38,25,461,257,204,63,49,50,29,1
27824,432,218,214,57,55,42,11,98,42,56,6,6,5,20,1
27825,885,424,461,143,114,92,32,1706,830,876,265,209,230,63,1
27826,363,182,181,33,55,23,11,361,155,206,43,61,29,18,1
27827,619,293,326,98,78,65,22,427,218,209,61,53,45,26,1
27828,901,458,443,91,129,86,21,798,378,420,99,94,71,63,1
27829,677,310,367,103,93,70,26,354,166,188,53,55,40,19,1
27830,264,130,134,38,33,26,10,894,420,474,136,146,93,39,1
27831,1332,626,706,182,144,80,41,703,356,347,96,97,38,22,1
27832,412,193,219,70,56,51,26,320,163,157,44,44,26,15,1
27833,504,237,267,62,66,48,17,377,201,176,46,50,41,23,1
27834,341,178,163,48,44,42,20,403,188,215,70,42,41,11,1
27835,218,110,108,24,31,27,13,320,143,177,51,51,24,10,1
27836,744,385,359,125,89,90,23,301,163,138,49,36,40,11,1
27837,406,238,168,71,35,42,16,641,324,317,88,92,49,14,1
27838,1267,576,691,200,133,121,68,467,224,243,70,43,67,23,1
27839,560,244,316,92,118,47,12,758,362,396,115,102,35,13,1
27840,509,341,168,35,32,52,15,613,263,350,106,75,51,28,1
27841,780,359,421,160,78,169,16,165,76,89,26,24,18,15,1
27842,425,210,215,56,43,52,25,1048,553,495,125,62,58,31,1
27843,740,313,427,101,135,40,22,390,203,187,58,40,43,19,1
27844,318,176,142,25,32,35,25,335,177,158,45,49,34,13,1
27845,2044,1089,955,267,233,241,109,760,391,369,101,109,65,24,1
27846,384,224,160,42,37,58,22,592,264,328,86,85,62,41,1
27847,401,226,175,53,18,38,20,450,227,223,53,36,48,12,1
27848,336,191,145,38,34,57,13,158,85,73,24,18,18,8,1
27849,248,130,118,26,28,16,11,644,329,315,70,64,50,11,1
27850,823,336,487,138,120,69,44,297,158,139,47,37,37,9,1
27851,911,493,418,89,140,83,34,469,247,222,70,58,82,13,1
27852,286,111,175,51,47,21,12,726,312,414,121,73,82,23,1
27853,695,373,322,80,59,89,39,97,50,47,17,14,14,10,1
27854,346,173,173,50,56,31,14,103,44,59,16,17,9,5,1
27855,345,155,190,49,56,23,6,854,399,455,127,118,57,39,1
27856,389,210,179,51,37,43,9,620,305,315,97,80,87,28,1
27857,346,183,163,51,38,23,6,755,349,406,131,80,68,28,1
27858,1907,1008,899,235,224,195,73,781,418,363,92,90,64,41,1
27859,907,442,465,139,105,106,33,3336,1358,1978,571,599,203,101,1
27860,695,264,431,172,114,51,23,330,77,253,86,52,20,12,1
27861,390,220,170,55,37,44,19,1581,891,690,189,147,181,64,1
27862,577,251,326,92,84,60,11,719,364,355,104,100,58,34,1
27863,198,80,118,35,31,14,7,295,143,152,38,47,22,25,1
27864,770,390,380,104,76,78,32,422,213,209,63,60,35,13,1
27865,304,143,161,39,39,43,14,207,99,108,27,27,21,9,1
27866,221,80,141,48,37,14,10,464,237,227,64,66,33,12,1
27867,1395,595,800,223,206,113,61,298,167,131,47,33,40,8,1
27868,269,156,113,37,32,17,7,281,154,127,45,31,24,9,1
27869,1163,677,486,125,108,98,28,757,359,398,109,127,80,26,1
27870,238,138,100,31,15,38,11,976,520,456,120,115,109,53,1
27871,485,187,298,95,71,61,25,179,102,77,23,20,6,3,1
27872,2045,985,1060,359,339,199,74,336,134,202,51,64,27,12,1
27873,150,81,69,24,23,16,4,115,62,53,18,3,19,5,1
27874,564,305,259,82,64,57,27,572,298,274,72,67,52,20,1
27875,351,184,167,59,45,54,9,1210,592,618,157,138,116,85,1
27876,517,303,214,50,47,56,24,482,274,208,53,49,63,24,1
27877,208,99,109,28,30,18,9,447,232,215,55,65,50,25,1
27878,427,186,241,55,52,42,23,335,143,192,45,36,32,37,1
27879,919,468,451,123,117,118,35,476,227,249,52,59,38,17,1
27880,427,204,223,38,57,26,32,312,172,140,41,40,21,8,1
27881,360,192,168,55,45,48,16,399,206,193,57,45,41,17,1
27882,3685,1574,2111,579,580,303,116,3433,1476,1957,522,578,264,123,1
27883,649,323,326,80,65,64,24,822,416,406,111,105,84,44,1
27884,639,287,352,111,108,44,9,537,276,261,75,68,68,22,1
27885,296,153,143,30,62,36,9,163,71,92,22,38,11,7,1
27886,266,146,120,34,40,34,14,239,146,93,30,22,35,9,1
27887,941,504,437,119,86,103,44,422,245,177,50,31,42,22,1
27888,252,125,127,33,25,26,19,890,456,434,117,119,105,27,1
27889,808,366,442,130,133,66,31,750,347,403,105,103,83,29,1
27890,164,61,103,47,19,14,5,280,142,138,35,37,22,13,1
27891,673,329,344,111,95,92,41,201,98,103,26,35,16,5,1
27892,1474,756,718,175,158,169,51,1270,557,713,130,195,57,30,1
27893,303,175,128,43,36,34,12,363,178,185,54,48,21,13,1
27894,714,360,354,120,78,67,32,862,335,527,136,169,47,28,1
27895,662,312,350,103,104,59,20,977,500,477,139,115,121,31,1
27896,160,60,100,23,40,19,11,778,367,411,90,85,64,43,1
27897,706,320,386,111,76,75,51,441,218,223,69,55,50,27,1
27898,791,391,400,103,94,59,38,934,472,462,119,122,87,39,1
27899,317,153,164,34,52,30,14,2490,1126,1364,352,325,219,89,1
27900,417,179,238,62,74,34,12,899,453,446,149,128,78,24,1
27901,225,131,94,29,19,29,9,372,206,166,43,32,49,12,1
27902,2442,1193,1249,278,183,170,145,655,328,327,65,54,55,35,1
27903,465,218,247,64,51,50,42,282,135,147,27,37,30,19,1
27904,496,251,245,78,62,61,23,536,278,258,72,63,62,20,1
27905,228,139,89,24,21,32,18,1049,585,464,107,108,120,28,1
27906,356,185,171,37,31,17,21,542,270,272,76,60,61,27,1
27907,414,185,229,53,54,49,11,415,203,212,77,44,49,18,1
27908,752,381,371,96,77,80,44,1744,920,824,225,190,178,57,1
27909,732,355,377,108,109,79,27,1462,711,751,219,222,148,65,1
27910,130,41,89,38,29,12,7,854,367,487,127,113,59,59,1
27911,1400,800,600,158,134,150,65,255,122,133,35,51,22,13,1
27912,310,156,154,27,43,20,6,267,159,108,31,13,22,15,1
27913,344,151,193,59,51,30,9,202,102,100,29,35,6,9,1
27914,384,238,146,38,26,66,19,112,59,53,17,8,12,8,1
27915,406,211,195,55,37,47,16,575,317,258,48,62,49,55,1
27916,1482,762,720,156,144,154,52,423,219,204,58,41,69,15,1
27917,303,146,157,40,28,28,41,164,78,86,28,23,12,8,1
27918,700,265,435,134,106,16,3,215,115,100,27,28,34,16,1
27919,100,50,50,15,13,10,4,116,67,49,13,12,6,5,1
27920,224,103,121,34,47,11,9,868,448,420,108,103,76,25,1
27921,117,60,57,20,17,16,5,1050,561,489,138,91,90,41,1
27922,550,243,307,91,99,70,10,1068,494,574,176,155,81,27,1
27923,87,48,39,15,9,9,3,870,436,434,131,114,72,25,1
27924,323,156,167,52,45,39,18,393,186,207,58,50,36,22,1
27925,211,126,85,21,20,28,7,233,121,112,24,31,30,7,1
27926,509,341,168,35,32,52,15,893,470,423,131,102,74,23,1
27927,418,199,219,55,44,22,15,2472,1055,1417,416,458,235,64,1
27928,709,373,336,73,72,78,24,467,269,198,46,51,60,18,1
27929,1194,543,651,190,197,65,43,1446,762,684,193,160,182,67,1
27930,615,293,322,70,67,45,29,693,297,396,87,52,64,27,1
27931,416,210,206,55,54,39,20,2871,1148,1723,496,469,204,98,1
27932,258,164,94,19,21,41,24,184,117,67,18,8,10,9,1
27933,178,100,78,23,22,30,6,452,236,216,73,54,50,29,1
27934,120,67,53,13,15,9,6,367,161,206,70,48,41,19,1
27935,469,224,245,67,77,34,17,297,148,149,64,35,37,15,1
27936,280,114,166,56,28,48,35,1171,586,585,177,177,111,39,1
27937,630,345,285,89,60,41,16,168,120,48,7,5,20,7,1
27938,308,163,145,38,33,30,20,782,372,410,127,111,89,36,1
27939,864,362,502,142,150,70,19,175,86,89,33,25,27,2,1
27940,346,196,150,43,26,27,14,384,216,168,43,50,24,13,1
27941,956,405,551,170,171,64,35,835,420,415,104,105,57,47,1
27942,902,332,570,154,146,75,40,1139,536,603,162,139,109,50,1
27943,923,471,452,119,117,119,41,207,115,92,26,16,11,13,1
27944,1067,555,512,141,129,100,36,201,102,99,25,26,19,7,1
27945,454,214,240,56,71,35,16,2035,1087,948,163,129,96,73,1
27946,546,285,261,71,49,47,24,318,164,154,52,43,34,10,1
27947,505,244,261,77,65,56,22,466,230,236,63,74,42,35,1
27948,452,224,228,69,56,50,31,928,442,486,139,118,91,43,1
27949,104,48,56,15,15,13,7,467,250,217,59,52,41,19,1
27950,572,353,219,70,42,57,25,505,275,230,63,57,35,12,1
27951,519,257,262,63,73,45,19,461,231,230,52,61,26,14,1
27952,271,150,121,39,36,37,5,199,106,93,29,23,26,7,1
27953,876,457,419,88,124,67,47,194,81,113,64,9,7,2,1
27954,310,158,152,43,45,34,6,906,437,469,135,132,49,40,1
27955,1058,558,500,132,127,121,53,446,176,270,64,79,45,24,1
27956,203,80,123,40,37,20,3,748,355,393,121,91,95,26,1
27957,390,191,199,66,49,43,12,195,129,66,21,13,19,6,1
27958,552,285,267,74,51,69,24,693,323,370,105,80,76,33,1
27959,605,283,322,94,72,64,39,900,484,416,119,110,77,29,1
27960,195,129,66,21,13,19,6,526,266,260,76,75,53,22,1
27961,455,255,200,72,57,38,19,1960,810,1150,358,377,121,72,1
27962,223,103,120,25,20,47,20,331,193,138,44,37,18,9,1
27963,1807,933,874,248,203,173,71,479,228,251,79,78,64,24,1
27964,756,348,408,101,103,60,40,317,153,164,34,52,30,14,1
27965,356,161,195,52,57,40,17,671,318,353,83,124,46,34,1
27966,1087,480,607,155,179,99,28,246,113,133,33,45,22,10,1
27967,1194,609,585,195,142,105,37,1273,592,681,199,164,139,39,1
27968,688,323,365,121,69,55,22,697,373,324,105,83,95,38,1
27969,1477,738,739,176,176,145,72,749,360,389,91,122,59,37,1
27970,941,459,482,167,140,82,38,606,307,299,92,56,68,30,1
27971,660,328,332,103,88,76,22,402,227,175,48,40,35,11,1
27972,151,84,67,17,17,22,11,1434,727,707,210,173,161,54,1
27973,585,299,286,92,73,89,23,814,354,460,137,116,70,28,1
27974,688,323,365,121,69,55,22,596,286,310,90,89,78,37,1
27975,724,334,390,112,109,79,17,1210,592,618,157,138,116,85,1
27976,1142,515,627,56,128,113,16,261,152,109,37,27,12,13,1
27977,380,187,193,38,51,30,18,169,64,105,23,37,11,3,1
27978,1139,536,603,162,139,109,50,792,399,393,96,103,85,37,1
27979,565,285,280,72,73,47,31,901,458,443,91,129,86,21,1
27980,401,167,234,56,71,16,10,204,116,88,16,22,20,12,1
27981,492,242,250,74,69,44,15,405,180,225,72,57,31,12,1
27982,642,271,371,106,111,57,23,194,91,103,17,32,9,6,1
27983,117,62,55,24,18,21,2,467,241,226,54,47,67,26,1
27984,92,47,45,15,9,9,5,303,158,145,47,40,41,12,1
27985,393,186,207,58,50,36,22,377,202,175,46,50,41,23,1
27986,107,36,71,27,15,0,1,462,233,229,66,49,43,30,1
27987,168,67,101,37,17,13,13,124,57,67,8,11,5,19,1
27988,967,463,504,133,114,99,62,1474,756,718,175,158,169,51,1
27989,446,176,270,64,79,45,24,552,356,196,60,55,52,22,1
27990,1113,520,593,168,139,109,49,1585,840,745,184,152,155,100,1
27991,252,133,119,35,40,29,9,169,87,82,28,23,20,6,1
27992,351,184,167,59,45,54,9,5038,2652,2386,655,729,544,245,1
27993,718,283,435,126,127,34,29,666,344,322,91,73,91,20,1
27994,277,124,153,44,40,35,18,768,378,390,105,104,63,26,1
27995,2041,1035,1006,223,274,125,60,2322,1315,1007,242,257,220,38,1
27996,808,484,324,80,63,76,24,595,316,279,86,60,65,40,1
27997,1308,652,656,166,153,149,87,645,268,377,104,73,55,30,1
27998,175,91,84,18,14,22,12,166,79,87,16,16,25,11,1
27999,388,209,179,51,42,42,16,465,228,237,64,42,63,24,1
28000,531,212,319,92,75,32,20,568,243,325,98,73,56,44,1
28001,815,382,433,97,50,88,31,728,358,370,118,100,55,29,1
28002,75,36,39,11,10,5,7,340,163,177,39,38,37,23,1
28003,926,435,491,133,132,85,17,403,185,218,67,62,63,19,1
28004,1242,613,629,174,113,114,53,638,305,333,68,90,70,29,1
28005,933,493,440,140,108,124,32,676,333,343,111,89,94,39,1
28006,414,211,203,45,44,41,24,370,177,193,51,61,32,4,1
28007,585,289,296,102,86,61,18,289,123,166,75,33,13,7,1
28008,570,261,309,78,72,60,23,482,231,251,76,81,64,26,1
28009,1164,622,542,150,143,78,35,686,345,341,98,106,75,25,1
28010,117,66,51,15,8,4,11,2033,877,1156,359,333,106,44,1
28011,414,216,198,51,32,42,28,2414,1189,1225,277,178,170,169,1
28012,432,218,214,57,55,42,11,632,326,306,92,71,56,19,1
28013,297,158,139,47,37,37,9,1863,721,1142,262,283,139,74,1
28014,769,362,407,99,88,66,67,256,148,108,31,16,29,12,1
28015,461,213,248,58,62,54,30,4544,2024,2520,579,628,480,403,1
28016,380,212,168,47,38,19,11,782,421,361,101,97,82,20,1
28017,1085,646,439,108,65,36,19,1893,850,1043,280,340,169,80,1
28018,409,200,209,69,56,44,13,317,153,164,34,52,30,14,1
28019,205,82,123,38,28,20,15,1342,673,669,178,154,137,94,1
28020,1374,679,695,191,193,154,48,295,95,200,70,89,17,6,1
28021,764,409,355,88,73,102,43,2477,1186,1291,256,271,249,90,1
28022,363,201,162,39,47,36,16,493,275,218,64,36,49,30,1
28023,1881,929,952,259,247,158,57,409,268,141,32,26,57,25,1
28024,1210,592,618,157,138,116,85,347,209,138,30,26,47,14,1
28025,745,366,379,110,93,79,45,187,96,91,30,24,24,4,1
28026,1484,737,747,216,178,148,71,169,87,82,28,23,20,6,1
28027,815,418,397,97,62,70,17,2542,1245,1297,285,287,170,84,1
28028,617,255,362,105,108,61,23,519,244,275,76,90,44,16,1
28029,638,305,333,68,90,70,29,583,322,261,73,66,45,26,1
28030,253,141,112,28,21,33,20,879,439,440,120,108,101,30,1
28031,309,137,172,51,50,28,14,775,480,295,82,78,58,19,1
28032,241,106,135,48,29,17,15,4391,2256,2135,494,411,423,231,1
28033,806,419,387,115,130,57,32,317,153,164,34,52,30,14,1
28034,2414,1189,1225,277,178,170,169,331,193,138,44,37,18,9,1
28035,928,442,486,139,118,91,43,2414,1189,1225,277,178,170,169,1
28036,1455,760,695,205,191,124,40,477,301,176,52,35,45,24,1
28037,1129,500,629,171,148,85,30,605,295,310,74,66,70,36,1
28038,476,251,225,57,67,57,18,771,321,450,151,135,43,15,1
28039,536,278,258,72,63,62,20,464,242,222,61,68,36,17,1
28040,287,129,158,48,48,20,9,504,259,245,73,56,45,29,1
28041,306,155,151,43,34,36,17,1117,423,694,182,134,88,31,1
28042,716,354,362,102,87,77,30,470,211,259,95,60,52,11,1
28043,355,169,186,49,37,26,11,327,177,150,40,40,38,18,1
28044,744,384,360,104,96,57,31,418,204,214,68,66,38,12,1
28045,490,224,266,80,70,39,32,423,222,201,51,33,41,28,1
28046,536,278,258,72,63,62,20,550,243,307,91,99,70,10,1
28047,480,244,236,74,47,50,21,634,348,286,72,64,51,28,1
28048,1115,586,529,124,161,111,69,194,81,113,64,9,7,2,1
28049,391,203,188,49,34,36,9,928,442,486,139,118,91,43,1
28050,163,70,93,28,21,17,6,219,124,95,22,22,23,5,1
28051,480,256,224,67,55,26,22,1487,996,491,147,141,50,35,1
28052,245,110,135,42,32,29,9,201,42,159,19,3,2,75,1
28053,802,388,414,131,105,96,29,749,374,375,99,108,98,37,1
28054,247,136,111,20,26,25,10,132,65,67,21,9,8,21,1
28055,168,67,101,37,17,13,13,1816,865,951,246,230,189,76,1
28056,321,180,141,47,37,33,12,320,168,152,38,42,24,18,1
28057,1190,537,653,207,186,101,26,247,110,137,34,45,23,10,1
28058,920,492,428,100,92,88,49,648,307,341,101,58,76,34,1
28059,597,312,285,80,80,71,37,2468,1038,1430,333,465,167,62,1
28060,185,70,115,37,48,15,5,313,166,147,47,44,41,10,1
28061,543,296,247,86,79,60,19,435,221,214,72,45,47,19,1
28062,397,237,160,47,15,56,21,906,455,451,116,105,87,46,1
28063,304,155,149,40,31,44,13,366,183,183,48,47,36,17,1
28064,224,124,100,30,34,11,6,280,156,124,36,19,20,13,1
28065,494,123,371,160,58,29,5,1463,521,942,252,204,105,52,1
28066,326,153,173,63,48,25,8,313,157,156,39,26,34,29,1
28067,72,35,37,10,9,7,6,327,177,150,40,40,38,18,1
28068,342,178,164,33,38,35,15,118,51,67,25,13,6,7,1
28069,1001,422,579,185,180,51,32,153,81,72,22,18,16,8,1
28070,501,240,261,80,62,49,42,368,173,195,59,41,17,17,1
28071,480,234,246,79,77,65,23,341,154,187,34,36,11,11,1
28072,425,210,215,56,43,52,25,777,387,390,90,87,65,37,1
28073,357,214,143,30,32,27,13,374,180,194,53,55,36,18,1
28074,789,386,403,95,124,83,25,790,384,406,93,120,79,16,1
28075,333,167,166,45,30,34,14,467,269,198,46,51,60,18,1
28076,623,329,294,84,86,74,27,598,300,298,68,77,59,21,1
28077,195,83,112,40,16,19,16,1367,690,677,172,175,154,83,1
28078,390,203,187,58,40,43,19,396,192,204,71,41,51,15,1
28079,738,400,338,102,98,109,25,202,102,100,29,35,6,9,1
28080,800,328,472,159,159,41,15,73,35,38,14,10,9,4,1
28081,885,424,461,143,114,92,32,709,294,415,132,123,76,23,1
28082,615,293,322,70,67,45,29,457,220,237,78,79,45,23,1
28083,1464,715,749,200,167,181,70,453,242,211,59,47,49,11,1
28084,615,293,322,70,67,45,29,187,96,91,30,24,24,4,1
28085,368,195,173,52,41,42,15,4563,2219,2344,620,531,527,104,1
28086,1721,809,912,268,234,144,50,1333,646,687,209,179,148,45,1
28087,457,242,215,39,46,53,10,426,234,192,46,41,39,37,1
28088,518,264,254,58,55,42,23,455,218,237,57,51,42,35,1
28089,843,379,464,107,99,95,65,501,216,285,79,70,54,30,1
28090,297,158,139,47,37,37,9,1332,626,706,182,144,80,41,1
28091,2472,1055,1417,416,458,235,64,2364,1004,1360,406,426,226,79,1
28092,341,178,163,48,44,42,20,92,47,45,15,9,9,5,1
28093,330,157,173,56,42,51,8,443,248,195,67,54,40,15,1
28094,660,304,356,97,89,85,33,549,273,276,74,68,72,24,1
28095,883,470,413,112,99,108,34,298,160,138,37,30,22,12,1
28096,198,102,96,27,20,21,12,89,42,47,16,12,15,6,1
28097,911,449,462,134,111,81,34,467,226,241,55,48,54,23,1
28098,518,264,254,58,55,42,23,501,240,261,80,62,49,42,1
28099,317,153,164,39,30,35,13,737,363,374,119,101,85,41,1
28100,552,285,267,74,51,69,24,399,201,198,65,45,48,17,1
28101,1138,615,523,142,120,116,57,593,266,327,102,84,69,24,1
28102,280,118,162,35,32,41,37,279,106,173,48,35,41,39,1
28103,566,263,303,83,87,74,31,719,364,355,104,100,58,34,1
28104,432,181,251,48,75,27,17,593,266,327,102,84,69,24,1
28105,390,207,183,50,48,38,15,920,492,428,100,92,88,49,1
28106,380,165,215,47,72,26,14,1258,531,727,218,216,108,35,1
28107,2442,1193,1249,278,183,170,145,288,140,148,59,33,27,12,1
28108,163,71,92,22,38,11,7,319,156,163,48,37,44,15,1
28109,476,270,206,62,45,46,30,984,516,468,78,45,73,12,1
28110,1130,538,592,158,118,113,44,572,309,263,64,55,47,29,1
28111,298,154,144,44,34,25,11,529,314,215,59,64,39,14,1
28112,279,135,144,40,52,40,5,968,498,470,129,133,115,37,1
28113,501,240,261,80,62,49,42,184,87,97,19,21,12,17,1
28114,350,200,150,45,47,23,8,233,121,112,24,31,30,7,1
28115,723,335,388,90,84,77,74,467,269,198,46,51,60,18,1
28116,922,418,504,120,120,106,31,478,215,263,103,72,47,3,1
28117,271,131,140,47,37,41,11,358,212,146,51,36,33,9,1
28118,1333,646,687,209,179,148,45,1210,592,618,157,138,116,85,1
28119,337,171,166,46,27,33,16,318,176,142,25,32,35,25,1
28120,140,76,64,17,13,13,8,769,329,440,116,66,55,22,1
28121,433,226,207,52,60,58,20,471,231,240,76,58,44,8,1
28122,388,199,189,50,51,33,14,462,232,230,78,54,42,23,1
28123,380,184,196,58,52,46,8,984,459,525,150,145,89,37,1
28124,676,319,357,83,86,62,46,461,221,240,70,64,56,32,1
28125,409,200,209,69,56,44,13,359,219,140,42,19,56,19,1
28126,587,260,327,84,69,55,23,217,109,108,34,32,35,7,1
28127,143,79,64,16,25,7,5,149,68,81,15,38,11,10,1
28128,1117,556,561,188,117,110,48,3685,1574,2111,579,580,303,116,1
28129,391,208,183,65,49,57,17,473,245,228,67,52,70,24,1
28130,815,418,397,97,62,70,17,1842,988,854,232,191,184,74,1
28131,706,346,360,118,92,98,56,1242,613,629,174,113,114,53,1
28132,377,184,193,56,53,44,14,1047,562,485,141,127,114,41,1
28133,298,160,138,37,30,22,12,420,218,202,47,49,52,15,1
28134,457,261,196,55,27,57,34,263,181,82,19,11,39,8,1
28135,397,196,201,64,59,42,15,452,236,216,73,54,50,29,1
28136,277,124,153,44,40,35,18,507,242,265,53,44,31,22,1
28137,920,492,428,100,92,88,49,548,250,298,85,64,56,21,1
28138,460,228,232,70,46,46,17,454,191,263,61,66,38,15,1
28139,566,287,279,77,66,34,14,355,165,190,53,56,42,19,1
28140,255,113,142,31,40,18,9,462,224,238,77,75,37,13,1
28141,503,263,240,72,55,51,34,328,170,158,48,31,45,15,1
28142,750,465,285,95,50,126,29,747,443,304,92,51,120,36,1
28143,114,64,50,16,19,14,5,130,70,60,30,9,8,1,1
28144,180,57,123,39,22,10,8,464,237,227,64,66,33,12,1
28145,2045,985,1060,359,339,199,74,412,203,209,65,47,37,18,1
28146,1231,603,628,121,162,109,120,2871,1218,1653,290,374,238,414,1
28147,534,266,268,86,62,37,14,430,218,212,58,47,34,20,1
28148,296,154,142,38,38,24,16,516,298,218,62,57,49,19,1
28149,980,381,599,165,159,57,34,247,110,137,34,45,23,10,1
28150,676,386,290,102,53,78,19,123,62,61,15,15,19,6,1
28151,327,177,150,40,40,38,18,403,220,183,50,40,39,27,1
28152,163,70,93,28,21,17,6,621,404,217,61,42,73,21,1
28153,303,159,144,40,35,35,8,1095,530,565,157,151,98,34,1
28154,1358,685,673,191,157,146,53,887,439,448,131,119,98,39,1
28155,961,507,454,130,102,115,37,245,112,133,32,45,20,10,1
28156,624,308,316,92,72,68,22,607,280,327,65,60,74,30,1
28157,135,57,78,21,20,9,11,101,43,58,18,16,12,7,1
28158,95,47,48,13,12,10,4,294,148,146,35,33,25,14,1
28159,777,395,382,111,88,98,22,1894,962,932,232,209,205,90,1
28160,326,153,173,63,48,25,8,431,228,203,66,46,59,15,1
28161,217,98,119,38,35,18,9,530,259,271,83,50,54,41,1
28162,435,221,214,72,45,47,19,405,189,216,53,60,39,14,1
28163,660,359,301,81,87,102,31,1474,756,718,175,158,169,51,1
28164,1432,652,780,217,205,131,81,500,236,264,85,69,33,17,1
28165,577,342,235,63,57,23,37,437,225,212,61,57,66,12,1
28166,2803,1300,1503,392,510,170,57,377,202,175,46,50,41,23,1
28167,279,106,173,48,35,41,39,920,492,428,100,92,88,49,1
28168,415,242,173,53,21,70,21,354,169,185,54,54,41,19,1
28169,582,273,309,85,67,34,19,189,93,96,24,28,17,12,1
28170,417,231,186,55,39,44,12,503,263,240,72,55,51,34,1
28171,187,97,90,28,25,21,8,573,316,257,78,80,21,21,1
28172,154,75,79,17,24,16,13,636,284,352,108,101,40,23,1
28173,882,432,450,115,111,68,44,403,188,215,70,42,41,11,1
28174,1253,634,619,182,155,162,70,632,280,352,111,96,55,16,1
28175,1290,597,693,182,182,119,63,140,74,66,15,14,14,10,1
28176,103,56,47,27,7,8,2,384,196,188,42,43,32,20,1
28177,292,150,142,31,43,39,16,158,83,75,22,14,17,9,1
28178,356,185,171,37,31,17,21,508,253,255,73,60,50,13,1
28179,592,291,301,92,93,71,31,756,348,408,101,103,60,40,1
28180,546,207,339,103,98,26,18,288,118,170,50,57,18,15,1
28181,999,541,458,110,110,104,42,845,402,443,137,126,105,47,1
28182,394,207,187,52,42,37,24,360,188,172,49,48,47,17,1
28183,201,42,159,19,3,2,75,554,215,339,102,65,85,42,1
28184,1140,495,645,129,95,128,159,1084,537,547,154,121,92,35,1
28185,956,403,553,147,135,99,87,1690,1173,517,186,130,110,56,1
28186,1158,481,677,169,129,86,40,985,551,434,123,93,91,26,1
28187,794,322,472,122,108,79,34,2414,1189,1225,277,178,170,169,1
28188,1311,690,621,158,161,128,51,862,409,453,149,125,86,29,1
28189,1356,576,780,229,198,107,38,467,226,241,55,48,54,23,1
28190,586,270,316,83,80,59,21,447,194,253,70,67,57,19,1
28191,524,264,260,75,75,40,21,1599,806,793,213,237,100,45,1
28192,253,148,105,31,15,39,16,865,435,430,120,110,113,26,1
28193,834,390,444,133,114,109,34,184,86,98,26,26,14,11,1
28194,822,392,430,125,104,79,24,719,301,418,122,132,42,26,1
28195,507,248,259,56,49,44,10,202,102,100,29,35,6,9,1
28196,317,153,164,34,52,30,14,619,292,327,73,73,61,32,1
28197,1085,639,446,121,110,131,57,1270,557,713,130,195,57,30,1
28198,489,242,247,83,63,62,19,1434,727,707,210,173,161,54,1
28199,1738,821,917,242,196,181,58,594,305,289,86,63,51,21,1
28200,585,299,286,92,73,89,23,402,196,206,60,59,29,18,1
28201,788,381,407,77,41,46,35,685,315,370,108,99,36,9,1
28202,1434,727,707,210,173,161,54,572,353,219,70,42,57,25,1
28203,462,233,229,66,49,43,30,333,171,162,41,44,48,23,1
28204,552,285,267,74,51,69,24,572,299,273,64,56,71,23,1
28205,927,451,476,141,147,69,34,672,334,338,110,93,91,41,1
28206,498,224,274,69,49,45,16,2639,1436,1203,317,307,242,77,1
28207,360,192,168,55,45,48,16,505,247,258,72,71,60,27,1
28208,227,127,100,32,24,31,5,377,184,193,50,43,33,17,1
28209,341,154,187,34,36,11,11,991,483,508,166,120,94,42,1
28210,394,220,174,50,28,53,21,248,119,129,33,48,20,10,1
28211,379,203,176,55,48,45,16,441,216,225,57,66,57,19,1
28212,963,477,486,134,143,123,38,1290,597,693,182,182,119,63,1
28213,1084,537,547,154,121,92,35,3130,1364,1766,481,369,294,126,1
28214,1441,657,784,140,135,81,73,450,238,212,56,52,49,14,1
28215,1046,562,484,139,116,124,51,391,208,183,65,49,57,17,1
28216,928,442,486,139,118,91,43,437,212,225,66,44,44,11,1
28217,536,278,258,72,63,62,20,1356,672,684,171,172,134,59,1
28218,1047,475,572,176,183,110,39,291,120,171,63,39,26,6,1
28219,397,194,203,45,47,38,14,777,387,390,90,87,65,37,1
28220,187,96,91,30,24,24,4,606,279,327,81,70,49,34,1
28221,655,269,386,128,129,49,21,435,221,214,72,45,47,19,1
28222,454,191,263,61,66,38,15,358,212,146,51,36,33,9,1
28223,1313,644,669,169,90,111,43,1132,646,486,99,102,71,41,1
28224,144,57,87,38,26,10,4,202,102,100,29,35,6,9,1
28225,460,251,209,61,48,43,21,536,278,258,72,63,62,20,1
28226,171,94,77,24,28,30,11,847,371,476,168,149,64,20,1
28227,1061,440,621,189,149,153,72,607,311,296,73,81,33,33,1
28228,4303,2489,1814,436,369,444,134,466,186,280,71,84,30,11,1
28229,1253,639,614,181,155,164,73,632,280,352,111,96,55,16,1
28230,136,66,70,26,11,7,5,370,177,193,51,61,32,4,1
28231,628,297,331,103,65,85,59,1074,539,535,136,87,87,66,1
28232,671,318,353,83,124,46,34,145,75,70,22,18,10,5,1
28233,24,14,10,4,2,1,2,199,106,93,29,23,26,7,1
28234,84,61,23,9,2,13,2,263,142,121,27,18,34,14,1
28235,450,232,218,58,54,42,20,587,259,328,92,94,56,23,1
28236,91,50,41,12,5,10,7,764,380,384,89,92,67,25,1
28237,2799,1324,1475,369,371,215,124,529,274,255,57,62,38,14,1
28238,140,86,54,17,6,20,7,1893,764,1129,308,323,126,60,1
28239,173,110,63,35,6,9,8,2062,706,1356,414,368,158,63,1
28240,785,419,366,96,94,89,33,165,78,87,23,21,17,8,1
28241,437,228,209,47,61,26,11,2442,1193,1249,278,183,170,145,1
28242,536,278,258,72,63,62,20,1047,562,485,141,127,114,41,1
28243,1029,482,547,147,158,71,32,284,111,173,47,34,47,43,1
28244,475,247,228,62,45,75,24,477,281,196,38,41,63,29,1
28245,398,181,217,65,69,42,17,377,202,175,46,50,41,23,1
28246,391,208,183,65,49,57,17,250,164,86,22,15,30,4,1
28247,375,202,173,46,49,41,23,825,399,426,128,128,77,32,1
28248,392,221,171,53,30,25,8,331,169,162,40,28,22,14,1
28249,465,228,237,64,42,63,24,521,289,232,71,58,49,16,1
28250,312,172,140,41,40,21,8,455,218,237,57,51,42,35,1
28251,211,114,97,32,24,19,10,195,129,66,21,13,19,6,1
28252,359,173,186,55,57,44,16,211,88,123,38,28,26,10,1
28253,480,234,246,79,77,65,23,198,80,118,35,31,14,7,1
28254,427,230,197,48,28,60,37,238,117,121,32,27,22,14,1
28255,81,38,43,11,12,5,5,781,418,363,92,90,64,41,1
28256,333,167,166,45,30,34,14,1066,468,598,175,170,89,55,1
28257,455,242,213,69,50,45,18,502,240,262,78,61,54,32,1
28258,287,153,134,36,26,32,11,327,177,150,40,40,38,18,1
28259,688,310,378,130,82,78,47,716,354,362,102,87,77,30,1
28260,594,296,298,73,81,57,27,1390,695,695,180,137,170,71,1
28261,95,41,54,15,16,8,5,808,357,451,116,98,56,36,1
28262,1115,570,545,143,121,113,43,288,118,170,50,57,18,15,1
28263,437,241,196,49,48,61,24,189,90,99,26,29,17,11,1
28264,808,366,442,130,133,66,31,577,251,326,92,84,60,11,1
28265,493,270,223,65,65,61,27,815,418,397,97,62,70,17,1
28266,245,111,134,31,44,20,11,601,313,288,42,48,25,36,1
28267,247,110,137,34,45,23,10,2136,1063,1073,317,308,223,90,1
28268,491,234,257,55,56,36,21,393,186,207,58,50,36,22,1
28269,116,31,85,17,7,4,22,201,42,159,19,3,2,75,1
28270,824,397,427,113,95,82,33,593,305,288,91,83,54,24,1
28271,615,308,307,83,75,58,32,726,312,414,121,73,82,23,1
28272,1290,597,693,182,182,119,63,1073,547,526,60,60,47,19,1
28273,646,316,330,89,95,48,17,854,380,474,137,159,81,31,1
28274,179,76,103,36,32,9,9,388,195,193,54,48,35,23,1
28275,400,191,209,41,40,33,21,401,226,175,53,18,38,20,1
28276,928,442,486,139,118,91,43,431,233,198,54,40,42,12,1
28277,303,137,166,54,54,31,15,529,264,265,59,68,41,17,1
28278,625,342,283,62,53,56,28,396,192,204,71,41,51,15,1
28279,44,13,31,9,11,1,3,375,202,173,46,49,41,23,1
28280,395,195,200,41,55,23,10,271,110,161,33,27,11,8,1
28281,1738,821,917,242,196,181,58,303,159,144,40,35,35,8,1
28282,519,262,257,94,72,77,24,601,313,288,42,48,25,36,1
28283,2517,1275,1242,304,324,245,135,154,75,79,28,23,16,6,1
28284,143,81,62,28,9,8,1,1087,523,564,146,177,103,33,1
28285,359,169,190,56,36,35,24,349,167,182,54,38,30,28,1
28286,1100,474,626,197,143,126,41,1134,574,560,157,164,47,48,1
28287,54,26,28,11,4,3,3,218,127,91,27,23,23,10,1
28288,707,386,321,85,83,99,28,252,114,138,41,35,22,12,1
28289,411,171,240,61,81,30,15,1424,650,774,152,124,95,87,1
28290,171,94,77,24,28,30,11,392,218,174,43,42,32,27,1
28291,267,127,140,43,42,24,9,374,191,183,70,48,61,13,1
28292,399,208,191,57,46,41,20,427,218,209,61,53,45,26,1
28293,93,45,48,19,15,14,3,622,294,328,104,93,42,17,1
28294,606,279,327,81,70,49,34,427,218,209,61,53,45,26,1
28295,973,497,476,131,108,126,49,2671,1322,1349,379,345,290,135,1
28296,350,180,170,64,46,55,12,204,80,124,29,51,10,5,1
28297,603,291,312,98,87,61,28,916,344,572,168,220,47,10,1
28298,456,272,184,53,43,37,29,617,387,230,65,57,77,16,1
28299,288,118,170,50,57,18,15,118,67,51,13,13,7,7,1
28300,247,110,137,34,45,23,10,490,205,285,119,63,82,23,1
28301,1132,553,579,172,143,150,57,822,402,420,125,107,82,26,1
28302,170,81,89,25,24,15,4,831,354,477,129,121,97,53,1
28303,251,136,115,38,19,35,15,749,383,366,114,90,101,29,1
28304,593,266,327,102,84,69,24,897,487,410,92,97,83,31,1
28305,1501,679,822,251,196,174,67,920,492,428,100,92,88,49,1
28306,710,420,290,60,54,79,49,358,170,188,54,55,20,10,1
28307,324,145,179,45,23,32,17,781,418,363,92,90,64,41,1
28308,250,116,134,34,39,29,14,630,326,304,82,62,80,31,1
28309,375,200,175,65,30,59,17,1369,651,718,219,182,129,41,1
28310,525,274,251,82,74,60,25,191,99,92,25,24,18,8,1
28311,305,164,141,43,23,47,18,140,86,54,17,6,20,7,1
28312,443,240,203,66,31,57,27,1263,616,647,185,180,140,56,1
28313,469,242,227,66,48,48,26,712,396,316,78,69,65,25,1
28314,536,278,258,72,63,62,20,787,386,401,98,95,86,25,1
28315,727,259,468,163,157,68,15,443,248,195,67,54,40,15,1
28316,424,284,140,51,28,47,20,1098,519,579,182,159,79,42,1
28317,780,304,476,160,173,66,23,611,246,365,116,82,71,27,1
28318,247,110,137,34,45,23,10,393,186,207,58,50,36,22,1
28319,509,262,247,64,70,64,20,381,184,197,40,33,33,21,1
28320,211,108,103,34,25,26,12,552,285,267,74,51,69,24,1
28321,505,268,237,68,59,34,15,503,298,205,62,28,20,4,1
28322,453,255,198,62,49,29,19,673,317,356,101,85,76,49,1
28323,284,173,111,19,18,37,15,191,101,90,21,23,28,5,1
28324,457,220,237,78,79,45,23,745,366,379,110,93,79,45,1
28325,533,254,279,81,78,52,10,512,261,251,79,73,60,21,1
28326,183,97,86,30,18,20,12,258,126,132,42,32,19,26,1
28327,1342,675,667,162,154,123,39,1881,929,952,259,247,158,57,1
28328,1218,499,719,147,141,119,145,388,221,167,56,36,61,20,1
28329,622,299,323,86,86,69,35,655,349,306,78,59,76,42,1
28330,979,535,444,123,99,79,34,1948,1039,909,242,227,200,67,1
28331,1235,584,651,140,226,82,52,646,304,342,104,93,58,26,1
28332,1135,529,606,134,156,110,36,555,278,277,60,70,48,18,1
28333,631,332,299,61,104,60,19,641,324,317,88,92,49,14,1
28334,770,390,380,104,76,78,32,489,253,236,73,36,62,17,1
28335,441,216,225,57,66,57,19,444,212,232,74,25,60,24,1
28336,537,276,261,75,68,68,22,335,128,207,59,43,24,23,1
28337,2663,1073,1590,548,499,192,64,1464,693,771,153,136,91,86,1
28338,163,70,93,28,21,17,6,313,160,153,51,33,43,23,1
28339,1919,871,1048,315,265,148,61,475,208,267,84,67,50,20,1
28340,1201,557,644,151,125,117,50,593,325,268,84,66,73,24,1
28341,1669,1162,507,154,128,86,51,1712,1175,537,179,142,113,46,1
28342,1241,670,571,135,139,110,32,380,184,196,58,52,46,8,1
28343,389,199,190,51,56,41,21,1215,652,563,129,142,121,62,1
28344,466,186,280,71,84,30,11,559,317,242,58,65,37,23,1
28345,510,264,246,67,66,38,29,125,63,62,20,16,15,7,1
28346,560,260,300,100,58,29,28,861,393,468,150,101,69,35,1
28347,341,154,187,34,36,11,11,1647,794,853,279,235,128,65,1
28348,482,235,247,58,45,37,26,379,203,176,55,48,45,16,1
28349,500,242,258,53,48,44,18,267,159,108,31,13,22,15,1
28350,355,166,189,54,54,39,17,466,247,219,51,32,49,26,1
28351,209,125,84,20,22,22,6,406,202,204,54,54,41,16,1
28352,462,251,211,74,53,41,18,153,93,60,18,6,26,6,1
28353,245,112,133,32,45,20,10,528,283,245,77,72,63,11,1
28354,733,346,387,98,113,66,26,601,313,288,42,48,25,36,1
28355,245,110,135,42,32,29,9,424,179,245,65,67,29,11,1
28356,541,279,262,79,82,31,32,377,201,176,46,50,41,23,1
28357,380,184,196,58,52,46,8,481,256,225,60,56,48,12,1
28358,502,240,262,78,61,54,32,396,192,204,71,41,51,15,1
28359,802,344,458,156,136,57,24,164,78,86,28,23,12,8,1
28360,482,231,251,76,81,64,26,441,218,223,69,55,50,27,1
28361,473,224,249,82,63,48,24,737,374,363,100,95,103,29,1
28362,354,166,188,53,55,40,19,422,245,177,50,31,42,22,1
28363,651,307,344,74,130,45,18,904,448,456,146,103,86,37,1
28364,202,113,89,16,27,21,11,559,274,285,75,63,52,16,1
28365,360,192,168,55,45,48,16,350,200,150,45,47,23,8,1
28366,666,347,319,92,73,63,25,461,233,228,75,64,36,18,1
28367,227,127,100,32,24,31,5,367,161,206,70,48,41,19,1
28368,256,134,122,27,31,31,10,780,337,443,112,116,77,28,1
28369,694,360,334,90,88,77,32,374,191,183,40,52,40,16,1
28370,936,451,485,111,97,92,41,197,87,110,33,32,15,11,1
28371,331,165,166,52,34,48,22,132,65,67,21,9,8,21,1
28372,360,192,168,55,45,48,16,524,264,260,75,75,40,21,1
28373,2220,1085,1135,312,304,202,91,864,429,435,129,118,68,35,1
28374,350,180,170,64,46,55,12,1332,626,706,182,144,80,41,1
28375,716,354,362,102,87,77,30,781,418,363,92,90,64,41,1
28376,462,233,229,66,49,43,30,551,298,253,63,65,45,19,1
28377,815,418,397,97,62,70,17,1188,632,556,123,99,114,37,1
28378,1411,472,939,252,262,58,31,216,113,103,26,21,19,9,1
28379,1114,581,533,145,132,126,54,982,494,488,150,117,91,45,1
28380,825,363,462,97,105,72,75,2477,1186,1291,256,271,249,90,1
28381,762,363,399,132,107,82,26,1914,892,1022,272,267,143,79,1
28382,1030,566,464,119,107,96,49,1424,650,774,152,124,95,87,1
28383,262,144,118,19,39,22,8,635,333,302,99,75,83,28,1
28384,462,251,211,74,53,41,18,114,71,43,8,18,7,4,1
28385,360,188,172,49,48,47,17,772,417,355,118,92,80,23,1
28386,253,148,105,31,15,39,16,626,345,281,62,76,66,25,1
28387,586,270,316,83,80,59,21,204,103,101,16,32,22,8,1
28388,245,112,133,32,45,20,10,1263,613,650,163,127,128,62,1
28389,756,348,408,101,103,60,40,246,108,138,32,44,21,10,1
28390,625,293,332,74,71,50,40,825,422,403,100,90,62,43,1
28391,326,153,173,63,48,25,8,373,227,146,40,19,58,21,1
28392,622,309,313,75,81,76,29,845,402,443,137,126,105,47,1
28393,517,249,268,65,59,58,26,1117,556,561,188,117,110,48,1
28394,401,166,235,70,42,51,30,1170,510,660,142,182,115,84,1
28395,484,182,302,124,66,20,8,248,118,130,54,31,26,5,1
28396,595,233,362,143,66,94,47,201,42,159,19,3,2,75,1
28397,458,222,236,69,39,35,18,219,133,86,18,12,32,18,1
28398,365,180,185,63,35,48,19,461,217,244,44,41,27,36,1
28399,938,484,454,137,100,104,41,568,243,325,98,73,56,44,1
28400,254,120,134,32,32,24,8,205,114,91,25,24,20,15,1
28401,356,208,148,42,26,57,15,1074,538,536,154,140,111,51,1
28402,676,333,343,111,89,94,39,413,194,219,77,72,28,11,1
28403,425,210,215,56,43,52,25,454,191,263,61,66,38,15,1
28404,113,60,53,11,13,10,3,97,53,44,13,12,7,5,1
28405,416,209,207,76,45,50,17,522,283,239,65,64,76,22,1
28406,374,227,147,44,22,54,20,99,48,51,15,7,7,7,1
28407,390,191,199,66,49,43,12,969,505,464,123,133,92,33,1
28408,1024,549,475,139,125,82,23,281,144,137,42,25,30,16,1
28409,672,334,338,110,93,91,41,201,98,103,26,35,16,5,1
28410,688,249,439,127,126,41,22,1956,1067,889,219,218,245,93,1
28411,407,217,190,50,44,54,19,615,308,307,83,75,58,32,1
28412,330,143,187,63,29,52,20,593,291,302,81,85,56,20,1
28413,246,108,138,32,44,21,10,1657,849,808,204,192,182,61,1
28414,462,228,234,59,47,37,32,1158,481,677,169,129,86,40,1
28415,1608,778,830,243,230,159,74,334,171,163,48,42,32,18,1
28416,391,208,183,65,49,57,17,549,303,246,64,54,59,35,1
28417,539,273,266,74,59,66,24,627,289,338,101,73,62,43,1
28418,776,346,430,103,102,61,40,782,347,435,110,92,74,34,1
28419,436,209,227,66,47,52,22,173,110,63,35,6,9,8,1
28420,264,156,108,27,27,31,14,603,311,292,102,71,66,23,1
28421,110,53,57,14,15,4,6,90,41,49,17,15,5,8,1
28422,498,263,235,59,63,36,10,513,271,242,54,52,44,13,1
28423,555,278,277,60,70,48,18,963,447,516,120,146,87,74,1
28424,1086,603,483,147,121,95,40,1210,592,618,157,138,116,85,1
28425,435,221,214,72,45,47,19,795,375,420,102,92,81,30,1
28426,355,186,169,54,41,35,15,1152,586,566,131,112,117,42,1
28427,676,295,381,94,71,65,24,583,322,261,73,66,45,26,1
28428,341,178,163,48,44,42,20,1858,927,931,252,216,179,80,1
28429,1537,701,836,209,187,129,58,906,474,432,90,125,74,24,1
28430,388,199,189,50,51,33,14,413,227,186,45,34,58,23,1
28431,101,68,33,9,6,23,2,448,275,173,32,53,55,27,1
28432,766,384,382,132,86,71,30,601,290,311,92,89,55,30,1
28433,1130,639,491,87,188,57,41,778,367,411,90,85,64,43,1
28434,864,413,451,105,125,76,16,550,319,231,49,65,35,16,1
28435,474,224,250,50,72,51,43,193,83,110,26,20,16,9,1
28436,456,209,247,72,58,40,9,182,114,68,13,22,25,8,1
28437,776,346,430,103,102,61,40,544,259,285,76,81,40,20,1
28438,547,267,280,80,69,44,27,1115,586,529,124,161,111,69,1
28439,283,172,111,39,31,29,8,524,336,188,45,36,73,23,1
28440,552,285,267,74,51,69,24,128,62,66,13,11,17,12,1
28441,379,184,195,51,61,49,8,509,254,255,67,55,52,35,1
28442,476,233,243,76,61,52,21,473,212,261,72,64,45,28,1
28443,299,128,171,57,40,13,25,260,92,168,37,43,18,13,1
28444,359,219,140,42,19,56,19,689,343,346,105,102,81,35,1
28445,419,212,207,68,55,42,19,769,329,440,116,66,55,22,1
28446,505,273,232,70,57,60,33,552,285,267,74,51,69,24,1
28447,75,36,39,11,10,5,7,340,166,174,39,40,36,26,1
28448,1038,527,511,118,163,120,52,194,81,113,64,9,7,2,1
28449,425,205,220,50,43,39,24,753,318,435,154,95,56,23,1
28450,221,113,108,23,17,11,11,1454,780,674,182,120,135,67,1
28451,524,264,260,75,75,40,21,574,281,293,88,75,79,25,1
28452,527,262,265,62,73,39,49,164,77,87,33,19,6,7,1
28453,482,224,258,71,62,52,39,538,252,286,77,87,53,30,1
28454,567,323,244,71,62,62,23,3433,1476,1957,522,578,264,123,1
28455,609,279,330,103,98,72,42,466,233,233,65,51,50,32,1
28456,892,420,472,135,146,98,37,489,242,247,83,63,62,19,1
28457,3075,1459,1616,390,359,298,207,2944,1827,1117,338,332,122,35,1
28458,218,115,103,32,32,34,11,131,66,65,21,14,23,7,1
28459,277,122,155,33,33,25,24,724,334,390,112,109,79,17,1
28460,246,115,131,15,29,10,32,549,318,231,82,41,47,21,1
28461,3695,1922,1773,449,360,352,261,1609,694,915,204,241,132,122,1
28462,298,180,118,43,23,39,12,417,217,200,70,55,42,16,1
28463,453,216,237,58,60,67,20,866,382,484,116,114,91,28,1
28464,593,303,290,70,70,68,15,1748,791,957,281,247,173,25,1
28465,964,408,556,131,153,76,55,673,313,360,101,101,46,17,1
28466,593,291,302,81,85,56,20,309,106,203,66,49,25,10,1
28467,323,162,161,53,41,40,13,873,366,507,127,125,75,21,1
28468,323,123,200,59,69,30,15,52,24,28,6,4,3,5,1
28469,377,184,193,50,43,33,17,443,198,245,68,72,48,19,1
28470,394,202,192,44,43,38,28,423,222,201,60,51,51,11,1
28471,127,58,69,17,22,3,2,360,192,168,55,45,48,16,1
28472,225,116,109,29,19,25,6,161,73,88,23,22,15,8,1
28473,412,223,189,55,55,41,10,1149,568,581,177,133,101,30,1
28474,219,100,119,32,43,9,10,1191,417,774,319,127,184,89,1
28475,1613,806,807,190,211,180,84,862,409,453,149,125,86,29,1
28476,476,190,286,116,95,33,11,3661,1791,1870,463,425,340,151,1
28477,165,87,78,24,19,22,9,185,107,78,20,29,10,4,1
28478,951,506,445,107,118,79,40,503,263,240,72,55,51,34,1
28479,400,191,209,51,60,30,9,777,387,390,90,87,65,37,1
28480,1706,830,876,265,209,230,63,332,180,152,46,36,28,14,1
28481,640,339,301,70,64,90,41,288,118,170,50,57,18,15,1
28482,240,125,115,34,32,30,8,392,115,277,117,75,28,17,1
28483,1005,422,583,166,179,70,21,2115,838,1277,346,354,90,48,1
28484,245,112,133,32,45,20,10,925,484,441,112,86,84,31,1
28485,1970,978,992,245,206,198,80,684,353,331,95,98,77,38,1
28486,392,156,236,40,91,28,16,764,347,417,97,137,74,28,1
28487,291,141,150,49,43,26,7,213,91,122,42,30,23,12,1
28488,281,166,115,34,17,36,16,586,254,332,114,111,55,17,1
28489,1006,468,538,151,135,82,39,180,93,87,24,22,19,8,1
28490,332,175,157,46,43,41,9,375,202,173,46,49,41,23,1
28491,745,391,354,85,81,52,39,906,474,432,90,125,74,24,1
28492,672,334,338,110,93,91,41,603,291,312,98,87,61,28,1
28493,1278,593,685,198,201,71,43,452,224,228,69,56,50,31,1
28494,441,216,225,57,66,57,19,778,367,411,90,85,64,43,1
28495,423,222,201,51,33,41,28,647,322,325,104,98,54,14,1
28496,452,262,190,55,42,58,19,601,313,288,42,48,25,36,1
28497,1332,637,695,214,178,117,40,149,68,81,15,38,11,10,1
28498,351,184,167,59,45,54,9,433,229,204,60,59,53,24,1
28499,167,80,87,27,14,18,12,333,171,162,41,44,48,23,1
28500,134,66,68,24,11,10,6,1061,586,475,141,127,120,38,1
28501,435,187,248,62,51,51,21,671,326,345,111,77,74,11,1
28502,462,251,211,74,53,41,18,1770,824,946,245,258,179,60,1
28503,920,492,428,100,92,88,49,303,137,166,54,54,31,15,1
28504,603,314,289,100,73,79,29,377,180,197,37,20,24,8,1
28505,525,274,251,82,74,60,25,309,154,155,42,44,45,16,1
28506,98,55,43,14,1,7,4,590,306,284,69,82,68,27,1
28507,339,157,182,39,49,43,19,517,250,267,78,37,64,29,1
28508,230,115,115,29,29,22,14,495,233,262,64,39,49,32,1
28509,1720,856,864,259,224,176,85,700,265,435,134,106,16,3,1
28510,400,195,205,63,67,40,18,437,177,260,69,58,41,15,1
28511,351,184,167,59,45,54,9,557,306,251,66,42,52,15,1
28512,1068,527,541,160,131,112,52,358,212,146,51,36,33,9,1
28513,419,197,222,70,51,36,19,869,488,381,110,77,78,30,1
28514,379,203,176,55,48,45,16,764,277,487,158,162,64,31,1
28515,491,283,208,55,61,40,13,551,352,199,46,43,77,26,1
28516,526,264,262,77,71,61,27,906,455,451,116,105,87,46,1
28517,442,254,188,46,22,40,19,2414,1189,1225,277,178,170,169,1
28518,677,361,316,81,61,42,22,1130,614,516,129,138,98,42,1
28519,443,241,202,57,43,67,18,142,80,62,24,12,21,4,1
28520,1273,592,681,199,164,139,39,135,65,70,21,25,15,9,1
28521,2477,1186,1291,256,271,249,90,837,464,373,104,72,85,49,1
28522,907,530,377,61,82,63,30,939,493,446,113,100,87,31,1
28523,699,295,404,132,126,46,28,847,467,380,117,101,67,24,1
28524,376,183,193,50,50,43,21,327,177,150,40,40,38,18,1
28525,440,218,222,58,66,40,24,465,245,220,71,45,76,25,1
28526,448,236,212,53,64,56,24,870,489,381,97,99,76,14,1
28527,374,187,187,51,52,40,27,372,198,174,66,35,25,8,1
28528,2063,1024,1039,175,117,80,97,2414,1189,1225,277,178,170,169,1
28529,303,137,166,54,54,31,15,503,263,240,72,55,51,34,1
28530,789,319,470,129,139,81,35,790,352,438,132,87,91,60,1
28531,702,298,404,134,111,48,18,205,94,111,48,31,15,6,1
28532,124,69,55,14,7,9,4,239,146,93,30,22,35,9,1
28533,530,259,271,83,50,54,41,794,390,404,103,95,86,23,1
28534,585,277,308,92,73,61,32,526,220,306,95,74,62,41,1
28535,359,182,177,59,31,40,12,1487,996,491,147,141,50,35,1
28536,424,209,215,56,58,45,24,163,71,92,33,26,5,7,1
28537,640,279,361,102,83,69,21,882,432,450,115,111,68,44,1
28538,393,186,207,58,50,36,22,229,105,124,36,33,12,4,1
28539,312,173,139,33,38,12,5,938,415,523,115,101,69,30,1
28540,487,247,240,73,42,42,22,558,302,256,66,62,65,30,1
28541,609,292,317,102,96,64,21,190,94,96,30,21,13,5,1
28542,1606,753,853,215,227,182,48,173,95,78,17,16,21,6,1
28543,323,123,200,59,69,30,15,220,113,107,37,24,16,7,1
28544,561,343,218,53,63,37,15,1009,506,503,146,141,97,55,1
28545,537,273,264,62,60,74,27,529,274,255,61,57,85,32,1
28546,430,198,232,57,46,37,19,255,136,119,39,20,32,10,1
28547,277,124,153,44,40,35,18,1417,598,819,223,188,135,58,1
28548,553,275,278,56,76,60,20,176,84,92,29,18,19,10,1
28549,684,288,396,107,90,54,42,2202,1121,1081,338,274,269,81,1
28550,390,220,170,55,37,44,19,424,219,205,61,40,40,23,1
28551,433,226,207,52,60,58,20,928,442,486,139,118,91,43,1
28552,331,152,179,34,30,35,12,619,332,287,95,77,74,38,1
28553,782,372,410,127,111,89,36,760,405,355,112,95,92,29,1
28554,2881,1254,1627,442,386,273,102,462,233,229,66,49,43,30,1
28555,509,254,255,67,55,52,35,278,137,141,47,32,28,20,1
28556,620,305,315,97,80,87,28,220,126,94,29,12,34,11,1
28557,505,273,232,70,57,60,33,522,239,283,75,88,45,11,1
28558,482,235,247,58,45,37,26,360,188,172,49,48,47,17,1
28559,210,106,104,29,23,20,4,415,209,206,60,67,39,18,1
28560,465,228,237,64,42,63,24,422,213,209,63,60,35,13,1
28561,248,128,120,65,21,27,10,686,270,416,134,77,92,48,1
28562,676,295,381,94,71,65,24,164,88,76,27,20,17,6,1
28563,457,228,229,64,36,52,21,969,505,464,123,133,92,33,1
28564,234,129,105,31,22,19,18,769,329,440,116,66,55,22,1
28565,410,194,216,60,47,47,26,465,228,237,64,42,63,24,1
28566,345,141,204,64,58,13,11,778,367,411,90,85,64,43,1
28567,822,402,420,125,107,82,26,1047,562,485,141,127,114,41,1
28568,574,295,279,78,65,61,22,756,348,408,101,103,60,40,1
28569,176,73,103,22,29,13,9,753,318,435,154,95,56,23,1
28570,2442,1193,1249,278,183,170,145,320,163,157,44,44,26,15,1
28571,480,234,246,79,77,65,23,426,228,198,62,42,47,22,1
28572,592,292,300,56,52,71,17,355,168,187,55,48,40,15,1
28573,191,91,100,28,33,23,12,280,139,141,25,39,26,13,1
28574,400,207,193,30,36,12,10,586,254,332,114,111,55,17,1
28575,325,184,141,43,34,22,18,410,188,222,53,52,31,14,1
28576,291,141,150,50,29,35,7,264,126,138,44,26,25,10,1
28577,677,245,432,129,155,72,11,1107,601,506,155,138,104,49,1
28578,991,483,508,166,120,94,42,711,344,367,87,109,74,24,1
28579,519,246,273,78,82,42,16,557,349,208,52,43,79,29,1
28580,797,406,391,121,86,64,15,901,423,478,106,117,83,38,1
28581,288,118,170,50,57,18,15,292,152,140,46,38,35,12,1
28582,400,208,192,62,44,42,21,528,283,245,77,72,63,11,1
28583,553,261,292,73,79,40,26,503,263,240,72,55,51,34,1
28584,1218,499,719,147,141,119,145,2471,1130,1341,240,281,219,290,1
28585,211,138,73,14,11,22,17,1362,633,729,220,150,93,43,1
28586,1034,451,583,165,146,104,40,505,275,230,63,57,35,12,1
28587,1332,626,706,182,144,80,41,342,208,134,36,31,29,15,1
28588,906,460,446,117,131,108,33,211,88,123,38,28,26,10,1
28589,672,334,338,110,93,91,41,393,186,207,58,50,36,22,1
28590,3144,1617,1527,367,342,278,136,407,217,190,50,44,54,19,1
28591,89,44,45,15,12,15,6,105,50,55,16,17,14,10,1
28592,793,413,380,105,120,57,23,757,373,384,115,93,95,25,1
28593,423,198,225,43,47,36,41,501,240,261,80,62,49,42,1
28594,179,76,103,36,32,9,9,973,497,476,131,108,126,49,1
28595,247,110,137,34,45,23,10,1257,662,595,176,142,106,42,1
28596,919,467,452,125,87,88,37,246,108,138,32,44,21,10,1
28597,544,259,285,76,81,40,20,648,307,341,101,58,76,34,1
28598,280,118,162,35,32,41,37,788,381,407,77,41,46,35,1
28599,307,154,153,39,36,31,12,344,151,193,59,51,30,9,1
28600,502,240,262,78,61,54,32,843,404,439,107,112,93,34,1
28601,465,257,208,51,61,54,23,524,237,287,87,75,54,26,1
28602,652,329,323,65,70,51,50,1669,1162,507,154,128,86,51,1
28603,160,77,83,14,27,11,10,595,316,279,86,60,65,40,1
28604,346,183,163,51,38,23,6,1234,590,644,180,182,95,40,1
28605,480,257,223,74,26,60,27,270,136,134,38,31,31,4,1
28606,211,109,102,33,27,24,11,824,365,459,121,123,88,50,1
28607,744,384,360,104,96,57,31,140,86,54,17,6,20,7,1
28608,403,210,193,63,53,48,20,1102,552,550,174,137,137,45,1
28609,318,176,142,25,32,35,25,350,222,128,33,33,41,20,1
28610,426,228,198,62,42,47,22,2964,1274,1690,563,343,259,115,1
28611,1455,765,690,189,162,166,66,756,348,408,101,103,60,40,1
28612,1093,567,526,122,75,71,46,601,313,288,42,48,25,36,1
28613,316,132,184,48,49,14,14,160,67,93,32,37,15,9,1
28614,613,333,280,71,66,47,26,770,403,367,91,87,68,52,1
28615,552,285,267,74,51,69,24,802,375,427,133,103,81,41,1
28616,168,67,101,37,17,13,13,99,34,65,12,1,2,18,1
28617,509,262,247,64,70,64,20,533,254,279,81,78,52,10,1
28618,580,240,340,108,81,59,22,208,96,112,31,32,13,9,1
28619,500,215,285,120,41,66,35,825,399,426,128,128,77,32,1
28620,2524,1232,1292,398,317,186,61,441,218,223,69,55,50,27,1
28621,871,437,434,112,113,83,49,181,95,86,21,22,18,9,1
28622,930,411,519,138,137,86,24,531,286,245,61,45,46,16,1
28623,549,303,246,64,54,59,35,207,105,102,35,27,15,5,1
28624,1037,575,462,122,150,82,32,1091,602,489,143,101,144,67,1
28625,975,417,558,161,126,96,44,477,301,176,52,35,45,24,1
28626,152,74,78,16,20,16,5,686,375,311,89,80,63,20,1
28627,376,183,193,50,50,43,21,240,125,115,34,32,30,8,1
28628,491,232,259,80,65,54,21,365,180,185,63,35,48,19,1
28629,626,333,293,64,55,61,15,255,130,125,44,18,22,12,1
28630,465,230,235,68,64,48,24,595,316,279,86,60,65,40,1
28631,277,124,153,44,40,35,18,907,455,452,132,117,80,40,1
28632,950,497,453,146,127,115,43,274,158,116,27,27,22,18,1
28633,789,319,470,129,139,81,35,648,341,307,78,89,77,21,1
28634,449,244,205,68,53,49,12,408,197,211,74,44,53,16,1
28635,1368,742,626,179,129,189,73,371,174,197,53,56,43,15,1
28636,198,112,86,20,36,16,5,605,295,310,74,66,70,36,1
28637,254,146,108,28,35,33,8,263,142,121,27,18,34,14,1
28638,246,125,121,33,31,34,18,552,285,267,74,51,69,24,1
28639,318,176,142,25,32,35,25,311,165,146,40,28,37,12,1
28640,116,55,61,14,14,18,8,495,233,262,64,39,49,32,1
28641,434,237,197,52,64,37,14,180,95,85,27,15,14,16,1
28642,292,153,139,39,33,24,21,587,303,284,84,90,63,23,1
28643,561,279,282,85,81,88,24,673,313,360,101,101,46,17,1
28644,288,120,168,54,52,21,12,1591,734,857,229,225,171,75,1
28645,622,309,313,75,81,76,29,1132,553,579,172,143,150,57,1
28646,219,110,109,32,23,24,7,253,133,120,40,22,27,13,1
28647,1822,879,943,236,227,175,97,217,109,108,34,32,35,7,1
28648,504,237,267,62,66,48,17,335,185,150,46,34,36,13,1
28649,1190,638,552,162,95,112,18,1462,652,810,243,199,115,30,1
28650,165,83,82,16,29,11,9,406,187,219,55,64,24,9,1
28651,346,183,163,51,38,23,6,592,291,301,92,93,71,31,1
28652,552,285,267,74,51,69,24,422,213,209,63,60,35,13,1
28653,508,267,241,57,49,40,13,390,191,199,66,49,43,12,1
28654,552,264,288,82,64,48,20,1272,651,621,178,194,79,59,1
28655,1257,662,595,176,142,106,42,724,334,390,112,109,79,17,1
28656,314,108,206,45,75,34,8,272,124,148,51,36,23,27,1
28657,819,411,408,108,86,90,58,1048,564,484,118,122,113,40,1
28658,95,44,51,14,13,7,4,434,237,197,52,64,37,14,1
28659,475,235,240,77,58,43,22,298,140,158,51,33,21,22,1
28660,425,199,226,54,71,56,11,928,442,486,139,118,91,43,1
28661,199,87,112,31,27,8,15,240,134,106,34,35,15,13,1
28662,408,179,229,86,72,32,5,2045,985,1060,359,339,199,74,1
28663,629,338,291,92,57,64,22,360,192,168,55,45,48,16,1
28664,348,187,161,50,35,44,9,609,292,317,102,96,64,21,1
28665,788,360,428,93,106,67,72,478,239,239,65,66,65,21,1
28666,785,374,411,56,42,38,25,3144,1617,1527,367,342,278,136,1
28667,155,89,66,13,15,17,9,684,288,396,107,90,54,42,1
28668,593,266,327,102,84,69,24,271,131,140,55,17,30,16,1
28669,208,96,112,31,32,13,9,2261,1217,1044,271,243,267,101,1
28670,379,203,176,55,48,45,16,1023,561,462,117,125,96,48,1
28671,338,169,169,43,38,41,10,288,104,184,80,30,39,6,1
28672,191,100,91,30,22,23,4,549,268,281,83,63,71,23,1
28673,912,460,452,139,132,89,53,803,358,445,135,117,80,44,1
28674,467,226,241,55,48,54,23,3695,1922,1773,449,360,352,261,1
28675,619,332,287,95,77,74,38,445,225,220,47,62,53,26,1
28676,1338,633,705,199,151,144,65,537,276,261,75,68,68,22,1
28677,262,144,118,19,39,22,8,620,305,315,97,80,87,28,1
28678,488,217,271,71,71,50,32,562,265,297,79,56,72,45,1
28679,1970,978,992,245,206,198,80,1443,776,667,191,175,160,56,1
28680,140,76,64,17,13,13,8,240,125,115,34,32,30,8,1
28681,538,252,286,77,87,53,30,293,142,151,49,40,42,17,1
28682,205,99,106,24,29,20,5,822,417,405,111,127,76,34,1
28683,656,358,298,67,47,64,26,508,268,240,92,58,56,21,1
28684,745,391,354,85,81,52,39,1049,530,519,102,125,89,48,1
28685,377,171,206,59,58,41,22,2871,1148,1723,496,469,204,98,1
28686,954,521,433,135,118,78,26,272,149,123,34,35,21,2,1
28687,958,451,507,165,135,97,41,293,153,140,45,38,22,15,1
28688,503,263,240,72,55,51,34,467,226,241,55,48,54,23,1
28689,119,53,66,33,8,7,6,2477,1186,1291,256,271,249,90,1
28690,1403,715,688,154,147,172,69,2161,1233,928,269,199,178,42,1
28691,593,266,327,102,84,69,24,375,192,183,48,29,44,17,1
28692,969,505,464,123,133,92,33,900,484,416,119,110,77,29,1
28693,3801,1837,1964,510,442,418,170,245,111,134,31,44,20,11,1
28694,900,484,416,119,110,77,29,115,59,56,21,9,9,8,1
28695,590,306,284,69,82,68,27,347,194,153,53,44,40,10,1
28696,154,75,79,17,24,16,13,775,407,368,122,100,97,32,1
28697,2644,1346,1298,391,304,315,148,732,355,377,108,109,79,27,1
28698,454,240,214,57,68,39,11,489,242,247,83,63,62,19,1
28699,719,364,355,104,100,58,34,904,436,468,138,146,82,39,1
28700,979,492,487,120,122,89,51,855,359,496,142,153,53,24,1
28701,450,231,219,77,50,76,16,510,246,264,80,71,15,18,1
28702,512,261,251,79,73,60,21,496,251,245,78,62,61,23,1
28703,686,375,311,89,80,63,20,862,409,453,149,125,86,29,1
28704,313,149,164,48,31,30,13,1290,597,693,182,182,119,63,1
28705,163,70,93,28,21,17,6,350,180,170,64,46,55,12,1
28706,708,303,405,115,115,70,23,2414,1189,1225,277,178,170,169,1
28707,346,180,166,55,49,38,6,313,157,156,39,26,34,29,1
28708,234,129,105,31,22,19,18,1290,597,693,182,182,119,63,1
28709,633,327,306,102,90,72,15,1038,470,568,130,123,86,51,1
28710,741,374,367,103,105,75,32,1800,882,918,202,185,186,49,1
28711,1647,794,853,279,235,128,65,1105,544,561,165,167,98,40,1
28712,775,480,295,82,78,58,19,1129,528,601,154,162,114,52,1
28713,454,229,225,59,60,60,19,817,425,392,120,102,83,26,1
28714,2382,1161,1221,237,220,140,50,419,208,211,68,60,35,22,1
28715,509,262,247,64,70,64,20,742,303,439,88,96,86,23,1
28716,770,374,396,95,91,79,41,1338,633,705,199,151,144,65,1
28717,204,99,105,32,32,22,10,367,199,168,41,41,33,16,1
28718,532,187,345,127,64,89,45,671,318,353,83,124,46,34,1
28719,1113,401,712,196,186,53,44,395,198,197,55,55,36,10,1
28720,175,101,74,20,20,20,9,141,69,72,18,17,13,7,1
28721,1273,592,681,199,164,139,39,882,432,450,115,111,68,44,1
28722,1435,649,786,214,181,135,54,480,234,246,79,77,65,23,1
28723,927,527,400,104,123,119,43,255,122,133,35,51,22,13,1
28724,146,71,75,20,17,8,7,178,88,90,24,21,11,11,1
28725,968,452,516,150,144,79,28,745,391,354,85,81,52,39,1
28726,562,273,289,76,92,45,24,228,106,122,34,27,26,22,1
28727,367,203,164,41,32,39,20,840,385,455,118,137,66,39,1
28728,785,374,411,56,42,38,25,1203,651,552,151,128,123,46,1
28729,556,269,287,86,66,62,22,149,68,81,15,38,11,10,1
28730,626,345,281,62,76,66,25,304,127,177,61,38,31,4,1
28731,824,397,427,113,95,82,33,2440,1061,1379,377,326,172,62,1
28732,505,273,232,70,57,60,33,407,225,182,58,44,44,22,1
28733,2286,1154,1132,338,314,278,103,261,130,131,27,41,19,16,1
28734,484,261,223,59,48,49,24,296,147,149,45,29,30,23,1
28735,2813,1331,1482,320,339,261,290,654,317,337,95,111,44,13,1
28736,446,227,219,58,52,45,26,632,326,306,92,71,56,19,1
28737,251,138,113,40,31,14,8,777,387,390,90,87,65,37,1
28738,1691,1217,474,130,115,73,46,252,124,128,49,22,19,13,1
28739,516,234,282,82,63,58,29,493,226,267,68,67,54,29,1
28740,1016,495,521,138,138,94,50,1129,589,540,134,122,108,46,1
28741,208,115,93,31,27,22,19,212,116,96,22,19,24,17,1
28742,204,99,105,32,32,22,10,606,307,299,92,56,68,30,1
28743,1216,628,588,134,130,172,51,976,496,480,128,111,121,48,1
28744,819,411,408,108,86,90,58,1066,587,479,127,108,118,48,1
28745,307,133,174,48,53,27,10,794,390,404,103,95,86,23,1
28746,424,179,245,65,67,29,11,202,102,100,29,35,6,9,1
28747,508,265,243,81,65,61,16,633,327,306,102,90,72,15,1
28748,454,224,230,71,39,62,22,1038,470,568,130,123,86,51,1
28749,436,209,227,66,47,52,22,904,436,468,138,146,82,39,1
28750,416,210,206,55,54,39,20,1248,584,664,184,164,155,67,1
28751,1304,696,608,195,169,122,53,465,225,240,65,44,65,25,1
28752,736,337,399,97,95,53,32,552,285,267,74,51,69,24,1
28753,262,151,111,30,17,32,25,571,204,367,108,89,38,30,1
28754,143,79,64,16,25,7,5,229,105,124,36,33,12,4,1
28755,635,333,302,99,75,83,28,226,129,97,20,25,26,11,1
28756,333,192,141,50,48,28,10,1091,543,548,146,136,110,34,1
28757,987,515,472,107,110,106,61,380,187,193,38,51,30,18,1
28758,232,108,124,33,27,19,16,150,74,76,21,22,18,7,1
28759,744,385,359,125,89,90,23,477,232,245,67,64,70,30,1
28760,829,396,433,141,82,93,36,393,210,183,55,50,34,19,1
28761,292,108,184,47,64,19,15,355,165,190,53,56,42,19,1
28762,852,472,380,99,79,70,27,298,129,169,51,40,29,8,1
28763,2442,1193,1249,278,183,170,145,770,374,396,95,91,79,41,1
28764,391,208,183,65,49,57,17,317,153,164,34,52,30,14,1
28765,627,289,338,101,73,62,43,347,133,214,64,60,29,9,1
28766,411,224,187,50,43,54,19,631,376,255,74,53,87,27,1
28767,619,332,287,95,77,74,38,1304,585,719,179,169,154,47,1
28768,419,231,188,57,43,56,11,859,395,464,157,119,59,31,1
28769,373,213,160,44,33,27,17,462,228,234,59,47,37,32,1
28770,160,102,58,12,5,28,7,258,146,112,41,23,30,7,1
28771,322,164,158,46,44,29,7,324,154,170,57,40,26,4,1
28772,269,165,104,24,19,27,7,201,42,159,19,3,2,75,1
28773,180,115,65,17,12,9,9,266,140,126,29,24,33,13,1
28774,863,458,405,97,82,63,57,537,276,261,75,68,68,22,1
28775,596,289,307,86,75,71,33,522,235,287,78,67,60,50,1
28776,354,192,162,46,43,30,20,381,191,190,55,61,33,11,1
28777,273,131,142,35,35,25,12,221,116,105,34,22,35,12,1
28778,454,240,214,57,68,39,11,782,347,435,110,92,74,34,1
28779,246,115,131,15,29,10,32,165,76,89,26,24,18,15,1
28780,562,265,297,79,56,72,45,417,182,235,57,109,50,8,1
28781,374,181,193,55,58,48,23,247,132,115,24,22,24,13,1
28782,751,312,439,131,115,78,48,845,402,443,137,126,105,47,1
28783,474,274,200,59,36,86,31,2639,1436,1203,317,307,242,77,1
28784,529,274,255,57,62,38,14,194,81,113,64,9,7,2,1
28785,414,207,207,59,47,54,18,586,254,332,114,111,55,17,1
28786,2371,1178,1193,325,318,258,102,454,242,212,54,42,61,24,1
28787,648,262,386,113,108,78,29,871,312,559,187,101,140,58,1
28788,686,345,341,98,106,75,25,314,108,206,45,75,34,8,1
28789,466,186,280,71,84,30,11,885,437,448,135,130,89,36,1
28790,219,128,91,26,25,27,8,201,98,103,26,35,16,5,1
28791,529,274,255,57,62,38,14,219,105,114,36,29,19,8,1
28792,1290,629,661,191,187,167,55,1114,581,533,145,132,126,54,1
28793,1247,548,699,168,150,140,43,649,326,323,83,66,87,38,1
28794,1278,593,685,198,201,71,43,765,407,358,89,75,90,42,1
28795,1006,551,455,115,97,110,41,333,167,166,45,30,34,14,1
28796,201,108,93,36,21,17,4,1749,880,869,237,228,214,112,1
28797,268,157,111,26,30,28,13,1032,395,637,190,189,71,40,1
28798,794,390,404,103,95,86,23,345,203,142,47,35,31,11,1
28799,758,347,411,146,91,58,22,133,66,67,21,24,9,2,1
28800,509,262,247,64,70,64,20,495,233,262,64,39,49,32,1
28801,555,278,277,60,70,48,18,4655,2074,2581,545,652,562,399,1
28802,481,256,225,60,56,48,12,303,159,144,40,35,35,8,1
28803,862,409,453,149,125,86,29,425,210,215,56,43,52,25,1
28804,3830,2000,1830,532,388,418,203,413,206,207,38,55,19,10,1
28805,31,21,10,2,1,5,2,52,30,22,6,2,3,6,1
28806,430,192,238,62,67,27,10,654,317,337,95,111,44,13,1
28807,640,308,332,91,102,49,21,103,44,59,16,17,9,5,1
28808,622,354,268,89,60,64,18,287,124,163,52,48,24,16,1
28809,331,169,162,40,28,22,14,605,263,342,73,103,54,18,1
28810,332,211,121,27,16,41,22,1447,751,696,161,143,131,46,1
28811,622,331,291,69,74,45,21,536,287,249,64,73,21,27,1
28812,970,486,484,142,120,85,51,611,246,365,116,82,71,27,1
28813,1016,495,521,138,138,94,50,1178,562,616,155,107,127,34,1
28814,609,318,291,80,72,55,36,769,329,440,116,66,55,22,1
28815,189,96,93,24,21,19,17,632,326,306,92,71,56,19,1
28816,688,323,365,121,69,55,22,775,480,295,82,78,58,19,1
28817,383,204,179,59,45,29,15,639,287,352,111,108,44,9,1
28818,1447,814,633,171,141,183,58,462,261,201,69,52,48,12,1
28819,475,235,240,77,58,43,22,559,317,242,58,65,37,23,1
28820,709,310,399,95,103,61,30,668,331,337,108,64,58,29,1
28821,651,323,328,90,65,64,24,769,362,407,99,88,66,67,1
28822,490,198,292,65,81,39,27,2414,1189,1225,277,178,170,169,1
28823,461,208,253,79,76,61,21,1242,613,629,174,113,114,53,1
28824,676,333,343,111,89,94,39,421,210,211,72,55,44,14,1
28825,834,405,429,112,95,84,34,425,210,215,56,43,52,25,1
28826,238,100,138,39,37,16,9,2136,1063,1073,317,308,223,90,1
28827,504,237,267,62,66,48,17,375,202,173,46,49,41,23,1
28828,1156,578,578,130,155,118,39,3114,1105,2009,505,603,150,122,1
28829,501,218,283,86,94,63,15,1098,519,579,182,159,79,42,1
28830,178,88,90,24,21,11,11,200,91,109,23,35,13,7,1
28831,195,100,95,27,20,17,11,1706,830,876,265,209,230,63,1
28832,1066,587,479,127,108,118,48,228,139,89,24,21,32,18,1
28833,976,415,561,154,144,101,44,277,124,153,44,40,35,18,1
28834,946,469,477,133,113,62,39,267,127,140,43,42,24,9,1
28835,872,468,404,129,85,92,34,493,208,285,75,77,70,40,1
28836,504,237,267,62,66,48,17,250,164,86,22,15,30,4,1
28837,377,195,182,49,30,53,14,338,179,159,44,45,42,16,1
28838,1290,629,661,191,187,167,55,389,210,179,51,37,43,9,1
28839,247,110,137,34,45,23,10,641,324,317,88,92,49,14,1
28840,466,186,280,71,84,30,11,413,194,219,77,72,28,11,1
28841,2512,1328,1184,379,280,301,113,422,211,211,73,61,43,17,1
28842,427,191,236,67,60,41,34,750,347,403,105,103,83,29,1
28843,3664,1638,2026,598,519,231,63,425,199,226,54,71,56,11,1
28844,2817,1216,1601,379,436,183,115,359,173,186,55,57,44,16,1
28845,398,263,135,46,13,46,22,138,73,65,18,9,10,3,1
28846,246,115,131,15,29,10,32,123,65,58,29,3,6,9,1
28847,514,283,231,60,60,52,19,1071,549,522,133,127,130,59,1
28848,370,197,173,63,40,40,23,626,333,293,64,55,61,15,1
28849,203,97,106,30,22,18,10,202,102,100,29,35,6,9,1
28850,890,432,458,127,107,99,50,876,457,419,88,124,67,47,1
28851,339,170,169,32,17,24,13,660,267,393,137,105,57,47,1
28852,656,358,298,67,47,64,26,485,187,298,95,71,61,25,1
28853,1210,592,618,157,138,116,85,553,261,292,73,79,40,26,1
28854,430,218,212,58,47,34,20,522,265,257,35,39,38,8,1
28855,553,261,292,73,79,40,26,393,210,183,55,50,34,19,1
28856,320,163,157,44,44,26,15,303,175,128,43,36,34,12,1
28857,543,287,256,71,66,64,23,1132,553,579,172,143,150,57,1
28858,293,142,151,49,40,42,17,928,442,486,139,118,91,43,1
28859,374,202,172,58,40,41,7,558,302,256,66,62,65,30,1
28860,635,333,302,99,75,83,28,839,427,412,91,83,114,37,1
28861,561,275,286,85,62,87,22,1140,586,554,130,146,117,49,1
28862,923,471,452,119,117,119,41,1356,672,684,171,172,134,59,1
28863,796,342,454,129,148,57,28,911,551,360,92,106,107,29,1
28864,465,225,240,65,44,65,25,422,213,209,63,60,35,13,1
28865,246,115,131,15,29,10,32,622,305,317,91,80,65,28,1
28866,656,358,298,67,47,64,26,870,418,452,121,102,109,28,1
28867,335,185,150,46,34,36,13,1816,865,951,246,230,189,76,1
28868,394,202,192,44,43,38,28,115,57,58,32,7,9,7,1
28869,537,315,222,55,46,69,39,870,433,437,133,121,95,25,1
28870,208,99,109,28,30,18,9,2230,752,1478,421,460,118,67,1
28871,537,276,261,75,68,68,22,297,144,153,47,29,34,13,1
28872,289,125,164,51,55,17,10,593,305,288,91,83,54,24,1
28873,532,291,241,83,36,79,25,1586,815,771,196,135,138,67,1
28874,416,198,218,58,65,38,14,304,127,177,61,38,31,4,1
28875,107,58,49,17,4,2,6,360,218,142,39,26,50,18,1
28876,240,125,115,34,32,30,8,403,220,183,50,40,39,27,1
28877,187,104,83,24,18,26,5,601,313,288,42,48,25,36,1
28878,429,187,242,79,72,28,19,467,240,227,65,65,51,23,1
28879,593,266,327,102,84,69,24,1106,579,527,121,152,113,45,1
28880,465,225,240,65,44,65,25,1412,603,809,184,195,112,45,1
28881,636,284,352,108,101,40,23,1162,515,647,191,143,97,35,1
28882,501,265,236,89,52,45,16,509,254,255,67,55,52,35,1
28883,938,484,454,137,100,104,41,189,90,99,26,29,17,11,1
28884,418,199,219,55,44,22,15,512,261,251,79,73,60,21,1
28885,294,148,146,35,33,25,14,327,177,150,40,40,38,18,1
28886,75,36,39,11,10,5,7,648,307,341,101,58,76,34,1
28887,273,154,119,34,26,20,11,168,67,101,37,17,13,13,1
28888,466,242,224,66,53,53,13,341,197,144,50,31,15,6,1
28889,1192,579,613,120,215,79,24,233,121,112,24,31,30,7,1
28890,390,191,199,57,49,45,25,243,114,129,37,30,32,8,1
28891,247,110,137,34,45,23,10,685,315,370,108,99,36,9,1
28892,1647,794,853,279,235,128,65,433,222,211,68,58,42,23,1
28893,731,281,450,112,113,50,18,205,100,105,25,25,20,9,1
28894,277,152,125,31,35,22,19,261,121,140,35,48,28,12,1
28895,331,169,162,40,28,22,14,169,64,105,23,37,11,3,1
28896,1074,538,536,154,140,111,51,187,95,92,27,20,16,8,1
28897,339,183,156,43,45,28,17,376,187,189,55,48,36,17,1
28898,297,123,174,51,49,16,10,295,145,150,41,45,36,18,1
28899,735,375,360,103,91,77,46,536,278,258,72,63,62,20,1
28900,826,362,464,107,118,71,43,393,186,207,58,50,36,22,1
28901,501,240,261,80,62,49,42,910,441,469,117,120,101,61,1
28902,1338,756,582,155,105,104,44,728,385,343,110,102,69,14,1
28903,794,390,404,103,95,86,23,536,278,258,72,63,62,20,1
28904,297,123,174,51,49,16,10,141,64,77,26,24,10,6,1
28905,1290,597,693,182,182,119,63,912,460,452,139,132,89,53,1
28906,494,266,228,64,60,58,28,519,283,236,70,61,61,30,1
28907,245,111,134,31,44,20,11,644,329,315,70,64,50,11,1
28908,443,208,235,43,55,51,50,1978,807,1171,323,310,129,70,1
28909,515,259,256,79,58,46,21,778,367,411,90,85,64,43,1
28910,461,227,234,61,47,54,33,592,264,328,86,85,62,41,1
28911,418,215,203,62,45,64,19,375,192,183,50,39,46,16,1
28912,425,210,215,56,43,52,25,516,193,323,132,42,99,36,1
28913,724,325,399,98,92,64,24,1189,559,630,179,147,118,35,1
28914,619,293,326,98,78,65,22,255,122,133,35,51,22,13,1
28915,670,316,354,84,69,47,24,998,496,502,149,146,89,27,1
28916,355,214,141,43,29,63,13,109,50,59,20,7,10,9,1
28917,1054,530,524,172,119,133,37,247,110,137,34,45,23,10,1
28918,297,158,139,47,37,37,9,380,185,195,68,54,32,16,1
28919,394,202,192,44,43,38,28,427,218,209,107,27,31,15,1
28920,423,247,176,58,55,29,20,3801,1837,1964,510,442,418,170,1
28921,261,144,117,34,22,31,15,418,213,205,54,56,49,13,1
28922,790,343,447,90,191,35,17,136,66,70,33,11,9,5,1
28923,866,417,449,131,126,92,39,858,431,427,94,57,54,30,1
28924,217,98,119,33,32,27,7,882,432,450,115,111,68,44,1
28925,536,278,258,72,63,62,20,802,388,414,101,93,88,35,1
28926,985,551,434,123,93,91,26,359,167,192,49,37,27,19,1
28927,246,124,122,33,31,25,14,234,133,101,29,25,28,7,1
28928,87,48,39,15,9,9,3,617,255,362,105,108,61,23,1
28929,861,393,468,150,101,69,35,577,251,326,92,84,60,11,1
28930,267,147,120,37,28,35,12,911,493,418,89,140,83,34,1
28931,478,239,239,65,66,65,21,1207,593,614,151,148,131,95,1
28932,756,348,408,101,103,60,40,551,237,314,95,79,54,17,1
28933,396,150,246,103,64,38,3,160,53,107,31,29,13,3,1
28934,271,131,140,47,37,41,11,331,169,162,40,28,22,14,1
28935,323,159,164,49,28,38,22,377,202,175,46,50,41,23,1
28936,351,184,167,59,45,54,9,2758,1332,1426,394,384,287,131,1
28937,736,337,399,97,95,53,32,763,361,402,103,144,78,45,1
28938,1242,613,629,174,113,114,53,304,159,145,38,40,32,3,1
28939,864,362,502,142,150,70,19,707,354,353,89,80,37,19,1
28940,477,256,221,69,66,70,12,98,48,50,18,4,9,8,1
28941,1215,572,643,151,105,127,54,208,96,112,31,32,13,9,1
28942,962,430,532,109,142,61,34,205,100,105,25,25,20,9,1
28943,1272,651,621,178,194,79,59,968,498,470,129,133,115,37,1
28944,504,237,267,62,66,48,17,381,186,195,69,55,46,15,1
28945,351,184,167,59,45,54,9,405,180,225,72,57,31,12,1
28946,1755,860,895,244,225,214,117,152,74,78,16,20,16,5,1
28947,288,158,130,59,23,21,10,923,471,452,119,117,119,41,1
28948,577,288,289,85,56,40,20,1129,589,540,134,122,108,46,1
28949,1417,598,819,223,188,135,58,1001,498,503,156,114,106,56,1
28950,3695,1922,1773,449,360,352,261,895,474,421,122,93,69,25,1
28951,379,203,176,55,48,45,16,418,204,214,68,66,38,12,1
28952,410,175,235,73,61,37,27,705,356,349,111,97,84,36,1
28953,140,81,59,16,15,15,12,377,158,219,80,68,26,14,1
28954,227,107,120,38,33,30,10,422,256,166,37,21,47,23,1
28955,776,346,430,103,102,61,40,467,226,241,55,48,54,23,1
28956,686,337,349,96,116,45,19,637,321,316,70,96,30,18,1
28957,501,257,244,65,53,57,28,340,162,178,40,39,35,22,1
28958,892,397,495,146,63,65,37,3830,2000,1830,532,388,418,203,1
28959,870,433,437,133,121,95,25,1009,522,487,121,106,107,46,1
28960,533,254,279,81,78,52,10,1290,629,661,191,187,167,55,1
28961,647,324,323,101,80,76,43,166,81,85,30,27,13,8,1
28962,256,141,115,32,22,32,8,1066,485,581,136,182,99,31,1
28963,1024,549,475,139,125,82,23,493,275,218,64,36,49,30,1
28964,652,272,380,116,113,55,27,136,65,71,33,11,9,6,1
28965,536,237,299,116,87,42,17,2556,1169,1387,248,291,227,275,1
28966,250,123,127,40,28,29,8,219,124,95,22,22,23,5,1
28967,940,464,476,116,135,108,58,718,283,435,126,127,34,29,1
28968,725,419,306,75,67,105,26,235,153,82,15,8,42,17,1
28969,431,235,196,57,53,50,18,522,235,287,78,67,60,50,1
28970,947,482,465,143,107,89,37,419,175,244,71,73,23,23,1
28971,677,323,354,101,109,45,31,928,442,486,139,118,91,43,1
28972,830,402,428,80,67,100,80,3396,1499,1897,325,572,309,90,1
28973,858,398,460,126,138,75,39,1058,557,501,128,128,115,43,1
28974,266,139,127,33,26,34,12,261,159,102,19,29,41,11,1
28975,204,104,100,26,27,21,11,189,102,87,28,17,22,5,1
28976,99,48,51,15,7,7,7,336,221,115,22,17,40,16,1
28977,461,233,228,75,64,36,18,377,202,175,46,50,41,23,1
28978,222,103,119,38,39,4,17,721,363,358,87,104,70,28,1
28979,3056,1457,1599,438,389,329,168,433,222,211,68,58,42,23,1
28980,89,42,47,16,12,15,6,796,445,351,96,80,90,38,1
28981,297,177,120,36,23,29,16,217,109,108,34,32,35,7,1
28982,520,272,248,74,71,44,15,473,254,219,66,67,41,16,1
28983,526,264,262,77,71,61,27,863,470,393,82,72,92,44,1
28984,134,63,71,27,9,6,8,601,313,288,42,48,25,36,1
28985,686,375,311,89,80,63,20,280,121,159,60,45,22,12,1
28986,1616,728,888,280,204,178,54,368,141,227,64,61,24,13,1
28987,352,179,173,54,46,35,22,360,188,172,49,48,47,17,1
28988,469,253,216,49,51,48,18,1107,601,506,155,138,104,49,1
28989,724,334,390,112,109,79,17,1089,544,545,138,160,117,43,1
28990,676,333,343,111,89,94,39,769,362,407,99,88,66,67,1
28991,825,363,462,97,105,72,75,1367,690,677,172,175,154,83,1
28992,349,192,157,46,41,45,15,522,276,246,68,64,31,14,1
28993,505,247,258,72,71,60,27,1441,657,784,140,135,81,73,1
28994,218,110,108,24,31,27,13,352,167,185,49,44,37,16,1
28995,277,100,177,35,88,30,2,309,149,160,55,33,27,15,1
28996,415,134,281,114,65,27,7,597,246,351,95,98,45,25,1
28997,205,91,114,31,36,13,8,264,122,142,33,29,13,13,1
28998,724,334,390,112,109,79,17,781,418,363,92,90,64,41,1
28999,557,278,279,75,70,66,31,975,400,575,160,162,62,31,1
29000,1278,593,685,198,201,71,43,5497,2328,3169,872,896,436,168,1
29001,750,347,403,105,103,83,29,1356,672,684,171,172,134,59,1
29002,876,457,419,88,124,67,47,521,267,254,53,68,39,15,1
29003,3075,1459,1616,390,359,298,207,770,355,415,103,142,75,42,1
29004,130,55,75,21,26,10,3,360,192,168,55,45,48,16,1
29005,834,465,369,82,84,81,21,494,315,179,49,22,42,24,1
29006,501,216,285,79,70,54,30,609,292,317,102,96,64,21,1
29007,323,162,161,44,28,43,14,902,495,407,116,97,111,37,1
29008,392,115,277,117,75,28,17,235,149,86,30,21,17,5,1
29009,427,215,212,69,35,51,21,940,417,523,190,146,85,26,1
29010,652,329,323,65,70,51,50,245,142,103,29,20,21,9,1
29011,291,141,150,49,43,26,7,202,102,100,29,35,6,9,1
29012,1037,461,576,146,163,75,44,416,210,206,55,54,39,20,1
29013,697,373,324,105,83,95,38,522,283,239,65,64,76,22,1
29014,1255,666,589,145,142,120,82,217,109,108,34,32,35,7,1
29015,950,500,450,104,126,75,22,3460,1748,1712,369,360,496,190,1
29016,509,254,255,67,55,52,35,692,383,309,88,64,58,35,1
29017,780,337,443,112,116,77,28,416,182,234,62,67,37,17,1
29018,466,186,280,71,84,30,11,317,149,168,62,44,27,10,1
29019,340,181,159,44,39,35,21,1117,423,694,182,134,88,31,1
29020,168,67,101,37,17,13,13,205,94,111,29,31,16,7,1
29021,280,142,138,35,37,22,13,294,148,146,35,33,25,14,1
29022,1685,807,878,256,231,178,50,33423,16370,17053,4965,4756,2786,883,1
29023,1748,791,957,281,247,173,25,1210,592,618,157,138,116,85,1
29024,895,436,459,124,113,87,44,215,105,110,27,22,20,9,1
29025,583,322,261,73,66,45,26,1210,592,618,157,138,116,85,1
29026,271,131,140,47,37,41,11,146,80,66,17,15,13,7,1
29027,1235,637,598,191,162,99,36,428,248,180,44,39,28,9,1
29028,359,203,156,42,19,45,26,402,270,132,46,9,33,18,1
29029,204,99,105,32,32,22,10,648,307,341,101,58,76,34,1
29030,619,332,287,95,77,74,38,845,402,443,137,126,105,47,1
29031,360,219,141,33,26,65,22,93,54,39,13,9,9,7,1
29032,383,204,179,61,32,54,16,513,176,337,101,90,31,25,1
29033,324,154,170,57,40,26,4,630,393,237,47,45,100,30,1
29034,1074,538,536,190,131,157,35,211,114,97,32,24,19,10,1
29035,920,492,428,100,92,88,49,271,137,134,35,37,31,12,1
29036,208,101,107,38,28,24,7,1068,539,529,161,134,132,71,1
29037,1210,592,618,157,138,116,85,248,119,129,33,48,20,10,1
29038,431,235,196,57,53,50,18,465,225,240,65,44,65,25,1
29039,730,328,402,126,99,48,23,377,202,175,46,50,41,23,1
29040,673,313,360,101,101,46,17,632,280,352,111,96,55,16,1
29041,527,262,265,62,73,39,49,467,224,243,70,43,67,23,1
29042,727,294,433,143,118,69,50,215,80,135,54,56,21,9,1
29043,888,478,410,105,73,58,33,313,157,156,39,26,34,29,1
29044,298,141,157,43,29,28,13,1748,791,957,281,247,173,25,1
29045,1333,646,687,209,179,148,45,822,392,430,125,104,79,24,1
29046,407,217,190,50,44,54,19,390,209,181,59,47,41,26,1
29047,583,322,261,73,66,45,26,897,487,410,92,97,83,31,1
29048,169,85,84,21,14,9,9,338,202,136,39,9,31,15,1
29049,653,326,327,83,96,83,27,505,275,230,63,57,35,12,1
29050,265,183,82,22,17,41,7,101,68,33,9,6,23,2,1
29051,369,212,157,35,24,54,30,150,80,70,26,5,20,7,1
29052,190,94,96,24,33,24,6,696,348,348,97,93,85,33,1
29053,297,158,139,47,37,37,9,415,189,226,69,54,50,21,1
29054,591,279,312,88,91,52,26,102,61,41,15,13,8,2,1
29055,185,98,87,26,16,25,4,2157,1171,986,306,238,131,32,1
29056,523,249,274,92,64,58,21,247,110,137,34,45,23,10,1
29057,285,143,142,45,32,21,17,1076,563,513,129,114,90,37,1
29058,676,295,381,94,71,65,24,1265,580,685,205,188,166,53,1
29059,431,228,203,66,46,59,15,391,206,185,56,36,60,17,1
29060,184,80,104,46,17,17,11,360,168,192,57,49,48,19,1
29061,303,159,144,40,35,35,8,787,386,401,98,95,86,25,1
29062,4391,2256,2135,494,411,423,231,593,257,336,76,56,56,96,1
29063,1861,896,965,265,187,156,70,499,217,282,76,83,29,6,1
29064,368,170,198,59,64,29,13,464,249,215,73,42,65,12,1
29065,588,296,292,85,76,45,30,149,68,81,15,38,11,10,1
29066,652,397,255,79,43,36,13,109,54,55,15,17,7,5,1
29067,576,250,326,93,71,34,15,808,415,393,112,107,81,25,1
29068,172,98,74,20,21,22,8,1270,557,713,130,195,57,30,1
29069,4684,2161,2523,779,782,304,101,1091,543,548,146,136,110,34,1
29070,635,333,302,99,75,83,28,398,174,224,46,58,36,17,1
29071,2063,1024,1039,175,117,80,97,2524,1232,1292,398,317,186,61,1
29072,1332,659,673,174,170,153,55,777,345,432,128,88,65,39,1
29073,714,364,350,98,102,91,27,425,244,181,38,26,60,26,1
29074,525,245,280,59,72,47,21,1132,553,579,172,143,150,57,1
29075,200,89,111,26,25,17,7,4655,2074,2581,545,652,562,399,1
29076,517,250,267,78,37,64,29,431,233,198,54,40,42,12,1
29077,1608,778,830,243,230,159,74,352,179,173,54,46,35,22,1
29078,504,237,267,62,66,48,17,455,218,237,57,51,42,35,1
29079,389,199,190,51,56,41,21,448,236,212,53,64,56,24,1
29080,746,361,385,91,92,101,32,129,66,63,23,17,18,4,1
29081,764,409,355,88,73,102,43,417,182,235,57,109,50,8,1
29082,212,88,124,46,24,22,16,327,177,150,40,40,38,18,1
29083,187,96,91,30,24,24,4,302,138,164,50,36,30,20,1
29084,382,169,213,51,38,36,18,396,150,246,103,64,38,3,1
29085,301,170,131,38,23,35,11,931,491,440,127,116,118,44,1
29086,344,201,143,42,39,41,14,305,162,143,45,34,38,18,1
29087,160,77,83,14,27,11,10,433,237,196,60,52,33,27,1
29088,714,364,350,98,102,91,27,393,186,207,58,50,36,22,1
29089,426,256,170,52,25,53,34,174,89,85,25,16,18,10,1
29090,463,236,227,64,50,44,29,454,230,224,63,56,38,33,1
29091,1132,646,486,99,102,71,41,1332,659,673,174,170,153,55,1
29092,815,418,397,97,62,70,17,478,260,218,75,37,60,24,1
29093,377,184,193,56,53,44,14,993,492,501,116,119,135,57,1
29094,246,124,122,33,31,25,14,248,120,128,43,37,20,6,1
29095,282,152,130,35,27,13,21,195,83,112,40,16,19,16,1
29096,595,316,279,86,60,65,40,423,222,201,51,33,41,28,1
29097,437,241,196,49,48,61,24,204,99,105,32,32,22,10,1
29098,485,183,302,79,81,73,33,342,160,182,69,40,37,16,1
29099,1273,592,681,199,164,139,39,3144,1617,1527,367,342,278,136,1
29100,815,398,417,107,88,84,24,96,50,46,8,15,6,2,1
29101,782,421,361,101,97,82,20,476,227,249,52,59,38,17,1
29102,683,288,395,125,94,77,39,484,254,230,60,66,56,14,1
29103,932,471,461,137,86,84,32,854,399,455,127,118,57,39,1
29104,515,253,262,46,83,57,21,372,174,198,56,42,43,30,1
29105,284,109,175,55,79,9,9,97,46,51,12,17,11,8,1
29106,165,87,78,24,19,22,9,148,93,55,24,3,19,8,1
29107,390,220,170,55,37,44,19,427,218,209,56,57,53,24,1
29108,473,224,249,82,63,48,24,749,374,375,99,108,98,37,1
29109,556,259,297,75,69,63,38,334,172,162,43,39,41,17,1
29110,280,156,124,36,19,20,13,622,331,291,69,74,45,21,1
29111,2073,846,1227,304,300,162,111,589,281,308,69,39,63,20,1
29112,802,388,414,131,105,96,29,130,70,60,30,9,8,1,1
29113,80,42,38,12,7,7,4,95,47,48,13,12,10,4,1
29114,2663,1073,1590,548,499,192,64,536,278,258,72,63,62,20,1
29115,399,181,218,48,56,37,13,1152,586,566,131,112,117,42,1
29116,646,316,330,89,95,48,17,575,293,282,78,64,40,13,1
29117,95,44,51,14,13,7,4,289,140,149,33,42,30,15,1
29118,874,431,443,112,120,79,50,953,481,472,133,130,77,48,1
29119,874,431,443,112,120,79,50,205,114,91,25,24,20,15,1
29120,492,317,175,42,31,63,23,288,156,132,37,32,22,11,1
29121,155,115,40,8,7,12,8,729,321,408,128,84,63,26,1
29122,218,110,108,24,31,27,13,913,393,520,160,165,87,40,1
29123,279,106,173,48,35,41,39,2414,1189,1225,277,178,170,169,1
29124,536,237,299,116,87,42,17,427,191,236,67,60,41,34,1
29125,788,420,368,93,89,98,23,328,158,170,52,68,45,7,1
29126,561,255,306,95,67,44,17,1290,629,661,191,187,167,55,1
29127,537,276,261,75,68,68,22,527,263,264,81,63,72,31,1
29128,885,424,461,143,114,92,32,565,291,274,97,52,54,23,1
29129,268,140,128,33,39,26,9,1358,685,673,191,157,146,53,1
29130,250,130,120,40,32,19,13,303,158,145,47,40,41,12,1
29131,736,388,348,88,85,67,28,512,248,264,66,71,49,30,1
29132,380,184,196,58,52,46,8,641,341,300,101,91,29,22,1
29133,215,96,119,42,26,12,8,209,89,120,41,35,17,3,1
29134,248,118,130,54,31,26,5,240,99,141,53,38,29,15,1
29135,341,167,174,48,47,31,8,181,96,85,25,23,20,7,1
29136,334,172,162,43,39,41,17,397,237,160,47,15,56,21,1
29137,393,186,207,58,50,36,22,432,228,204,59,53,43,15,1
29138,535,286,249,87,80,59,17,534,285,249,87,77,59,16,1
29139,1270,682,588,165,147,136,54,577,288,289,85,56,40,20,1
29140,622,299,323,86,86,69,35,314,108,206,45,75,34,8,1
29141,396,192,204,71,41,51,15,512,269,243,69,70,62,29,1
29142,427,164,263,62,80,14,10,413,227,186,45,34,58,23,1
29143,440,235,205,34,61,36,13,990,410,580,140,175,44,36,1
29144,1204,623,581,144,146,119,83,1475,658,817,149,114,120,43,1
29145,443,207,236,76,68,52,28,725,365,360,104,111,70,31,1
29146,462,232,230,78,54,42,23,427,218,209,61,53,45,26,1
29147,920,289,631,237,141,98,11,911,449,462,134,111,81,34,1
29148,103,49,54,21,21,10,2,1519,823,696,204,195,110,45,1
29149,605,283,322,94,72,64,39,524,237,287,87,75,54,26,1
29150,4640,2231,2409,660,549,437,245,454,191,263,61,66,38,15,1
29151,1464,715,749,200,167,181,70,977,406,571,151,128,84,47,1
29152,1137,569,568,142,138,120,50,181,96,85,25,23,20,7,1
29153,1132,646,486,99,102,71,41,173,97,76,21,18,24,6,1
29154,165,80,85,30,20,12,9,205,99,106,24,29,20,5,1
29155,312,164,148,45,34,35,15,1259,705,554,174,158,123,34,1
29156,745,391,354,85,81,52,39,901,423,478,106,117,83,38,1
29157,103,49,54,21,11,14,6,396,192,204,71,41,51,15,1
29158,130,55,75,21,26,10,3,740,385,355,114,97,91,27,1
29159,1028,576,452,128,139,79,31,194,94,100,35,19,25,16,1
29160,470,256,214,56,39,47,34,1177,666,511,131,99,88,35,1
29161,350,180,170,64,46,55,12,478,220,258,47,69,41,10,1
29162,941,504,437,119,86,103,44,351,166,185,48,61,24,15,1
29163,229,120,109,31,30,22,9,204,103,101,16,32,22,8,1
29164,522,265,257,35,39,38,8,507,248,259,56,49,44,10,1
29165,333,212,121,33,15,44,16,113,68,45,18,11,6,2,1
29166,846,367,479,134,108,72,31,934,472,462,119,122,87,39,1
29167,185,70,115,37,48,15,5,191,72,119,40,41,17,8,1
29168,481,283,198,37,24,42,15,864,413,451,105,125,76,16,1
29169,303,159,144,40,35,35,8,1187,631,556,182,139,152,56,1
29170,136,65,71,33,11,9,6,204,103,101,16,32,22,8,1
29171,552,285,267,74,51,69,24,347,212,135,35,32,17,6,1
29172,309,154,155,42,44,45,16,267,149,118,45,33,31,14,1
29173,595,316,279,86,60,65,40,969,505,464,123,133,92,33,1
29174,639,397,242,64,37,64,30,279,106,173,48,35,41,39,1
29175,699,334,365,108,80,70,20,973,522,451,140,134,124,39,1
29176,3830,2000,1830,532,388,418,203,454,191,263,61,66,38,15,1
29177,246,108,138,32,44,21,10,758,362,396,115,102,35,13,1
29178,301,150,151,41,30,17,11,200,91,109,23,35,13,7,1
29179,1190,638,552,162,95,112,18,540,248,292,77,62,61,33,1
29180,1190,638,552,162,95,112,18,870,418,452,121,102,109,28,1
29181,154,75,79,17,24,16,13,790,352,438,132,87,91,60,1
29182,1078,557,521,116,114,144,44,2639,1436,1203,317,307,242,77,1
29183,553,261,292,73,79,40,26,465,225,240,65,44,65,25,1
29184,1074,538,536,190,131,157,35,181,96,85,25,23,20,7,1
29185,1087,480,607,155,179,99,28,237,112,125,19,57,25,10,1
29186,1187,633,554,164,151,120,41,1584,831,753,197,161,142,83,1
29187,466,186,280,71,84,30,11,1190,638,552,162,95,112,18,1
29188,1210,578,632,172,184,94,66,1505,681,824,201,204,73,32,1
29189,386,247,139,34,19,40,28,1610,844,766,228,180,232,110,1
29190,171,98,73,15,25,15,10,310,166,144,43,35,24,4,1
29191,354,188,166,44,31,48,11,304,138,166,53,32,34,13,1
29192,131,66,65,21,14,23,7,721,346,375,89,73,65,30,1
29193,374,191,183,70,48,61,13,1082,532,550,144,151,79,38,1
29194,3623,1788,1835,325,354,507,198,250,164,86,22,15,30,4,1
29195,1149,568,581,177,133,101,30,247,110,137,34,45,23,10,1
29196,1290,597,693,182,182,119,63,136,65,71,33,11,9,6,1
29197,1258,648,610,172,159,116,28,1149,568,581,177,133,101,30,1
29198,585,312,273,57,64,77,25,1838,1168,670,185,225,103,35,1
29199,543,287,256,71,66,64,23,198,80,118,35,31,14,7,1
29200,377,177,200,63,53,44,16,676,333,343,111,89,94,39,1
29201,998,496,502,149,146,89,27,310,141,169,36,38,20,8,1
29202,1243,633,610,149,160,87,39,230,144,86,16,11,25,14,1
29203,379,184,195,51,61,49,8,196,99,97,28,32,17,12,1
29204,270,133,137,42,37,34,8,552,283,269,89,66,68,30,1
29205,459,206,253,56,66,32,17,1382,689,693,186,176,167,77,1
29206,1441,657,784,140,135,81,73,404,239,165,48,38,38,19,1
29207,595,316,279,86,60,65,40,334,172,162,43,39,41,17,1
29208,210,115,95,31,22,27,10,503,263,240,72,55,51,34,1
29209,292,162,130,43,27,21,12,1477,738,739,176,176,145,72,1
29210,474,208,266,65,69,43,36,1663,835,828,224,213,163,63,1
29211,341,178,163,48,44,42,20,134,60,74,19,13,10,7,1
29212,485,273,212,52,47,51,17,359,219,140,42,19,56,19,1
29213,1980,963,1017,262,243,179,78,87,59,28,6,5,10,8,1
29214,1151,493,658,157,141,108,62,601,313,288,42,48,25,36,1
29215,819,411,408,108,86,90,58,676,333,343,111,89,94,39,1
29216,537,288,249,60,60,61,19,2364,1004,1360,406,426,226,79,1
29217,407,225,182,58,44,44,22,426,200,226,75,56,39,24,1
29218,317,164,153,47,33,47,12,427,218,209,61,53,45,26,1
29219,1801,889,912,206,263,126,42,323,162,161,44,28,43,14,1
29220,349,166,183,49,37,25,52,1153,535,618,204,158,93,50,1
29221,931,475,456,111,105,93,46,604,272,332,112,62,67,51,1
29222,714,364,350,98,102,91,27,467,250,217,64,49,63,39,1
29223,333,127,206,66,68,25,14,1056,506,550,147,129,106,48,1
29224,484,192,292,118,68,83,22,247,110,137,34,45,23,10,1
29225,803,395,408,127,102,79,31,416,230,186,54,53,42,17,1
29226,509,341,168,35,32,52,15,437,240,197,54,77,68,20,1
29227,237,117,120,34,27,24,14,1013,457,556,124,157,81,26,1
29228,221,80,141,48,37,14,10,454,191,263,61,66,38,15,1
29229,556,283,273,77,55,70,27,270,116,154,50,32,34,17,1
29230,333,192,141,50,48,28,10,720,357,363,113,85,62,39,1
29231,906,460,446,117,131,108,33,205,82,123,38,28,20,15,1
29232,434,237,197,52,64,37,14,350,189,161,55,34,63,19,1
29233,1116,413,703,214,213,53,41,208,99,109,28,30,18,9,1
29234,383,204,179,61,32,54,16,824,403,421,80,150,65,35,1
29235,367,195,172,57,54,43,16,1801,889,912,206,263,126,42,1
29236,366,184,182,46,42,23,18,551,237,314,95,79,54,17,1
29237,897,487,410,92,97,83,31,770,374,396,95,91,79,41,1
29238,482,231,251,76,81,64,26,414,216,198,51,32,42,28,1
29239,672,334,338,110,93,91,41,1194,646,548,139,125,127,59,1
29240,442,254,188,46,22,40,19,217,115,102,40,24,26,6,1
29241,128,65,63,18,13,7,6,930,411,519,138,137,86,24,1
29242,352,164,188,53,43,31,16,1086,603,483,147,121,95,40,1
29243,536,278,258,72,63,62,20,724,334,390,112,109,79,17,1
29244,456,228,228,49,70,32,19,435,170,265,77,69,41,22,1
29245,467,269,198,46,51,60,18,968,452,516,150,144,79,28,1
29246,330,143,187,63,29,52,20,1419,759,660,198,135,147,51,1
29247,562,214,348,120,86,69,42,522,235,287,78,67,60,50,1
29248,309,137,172,51,50,28,14,743,366,377,41,37,26,14,1
29249,338,188,150,45,41,31,18,646,316,330,89,95,48,17,1
29250,243,120,123,30,24,26,13,541,260,281,87,65,70,24,1
29251,146,71,75,20,17,8,7,747,469,278,60,41,53,23,1
29252,2524,1232,1292,398,317,186,61,508,267,241,43,35,25,17,1
29253,285,148,137,31,42,42,16,303,175,128,43,36,34,12,1
29254,456,228,228,49,70,32,19,630,345,285,89,60,41,16,1
29255,1210,592,618,157,138,116,85,114,48,66,22,20,15,7,1
29256,625,286,339,92,59,83,42,626,333,293,64,55,61,15,1
29257,247,135,112,25,24,27,13,418,213,205,54,56,49,13,1
29258,220,117,103,26,39,14,13,170,83,87,23,32,17,9,1
29259,508,215,293,72,71,42,15,232,108,124,33,27,19,16,1
29260,2156,893,1263,299,302,186,95,2843,1104,1739,429,357,178,95,1
29261,508,267,241,43,35,25,17,345,203,142,47,35,31,11,1
29262,1336,828,508,166,121,152,48,400,215,185,59,54,33,16,1
29263,507,314,193,49,45,59,25,1038,470,568,130,123,86,51,1
29264,1042,530,512,162,150,103,52,293,153,140,45,38,22,15,1
29265,247,110,137,34,45,23,10,2639,1436,1203,317,307,242,77,1
29266,917,443,474,126,115,125,41,317,153,164,39,30,35,13,1
29267,1450,638,812,220,196,18,18,764,277,487,158,162,64,31,1
29268,612,330,282,71,54,63,37,1687,770,917,282,226,181,79,1
29269,283,112,171,48,39,34,15,188,99,89,22,21,26,12,1
29270,1657,800,857,249,235,154,51,191,99,92,25,24,18,8,1
29271,258,111,147,46,63,17,6,401,167,234,56,71,16,10,1
29272,209,96,113,35,28,22,13,333,192,141,50,48,28,10,1
29273,1187,573,614,188,132,138,52,905,434,471,136,137,52,40,1
29274,707,386,321,85,83,99,28,987,515,472,107,110,106,61,1
29275,236,147,89,20,21,25,13,316,195,121,26,26,46,8,1
29276,525,274,251,82,74,60,25,433,222,211,68,58,42,23,1
29277,475,236,239,80,63,41,15,757,373,384,115,93,95,25,1
29278,815,418,397,97,62,70,17,476,270,206,62,45,46,30,1
29279,386,163,223,51,51,28,14,437,228,209,47,61,26,11,1
29280,467,226,241,55,48,54,23,507,242,265,53,44,31,22,1
29281,235,94,141,45,37,31,7,354,166,188,53,55,40,19,1
29282,310,161,149,34,31,35,12,140,86,54,17,6,20,7,1
29283,769,362,407,99,88,66,67,398,181,217,65,69,42,17,1
29284,498,277,221,51,46,70,22,677,392,285,77,67,102,19,1
29285,1256,595,661,153,143,106,130,412,192,220,71,50,48,23,1
29286,893,469,424,126,135,68,14,403,185,218,67,62,63,19,1
29287,359,179,180,69,35,47,13,858,417,441,93,124,75,26,1
29288,354,137,217,63,43,38,38,1356,672,684,171,172,134,59,1
29289,454,224,230,71,39,62,22,894,469,425,127,93,82,31,1
29290,175,91,84,22,18,11,20,368,141,227,64,61,24,13,1
29291,257,148,109,28,20,21,14,595,316,279,86,60,65,40,1
29292,434,233,201,61,55,37,15,1186,567,619,161,156,122,49,1
29293,2414,1189,1225,277,178,170,169,473,177,296,81,70,49,8,1
29294,732,355,377,108,109,79,27,1432,652,780,217,205,131,81,1
29295,1447,698,749,214,180,116,46,360,218,142,39,26,50,18,1
29296,432,181,251,48,75,27,17,358,170,188,54,55,20,10,1
29297,564,291,273,77,72,95,21,548,236,312,88,88,63,25,1
29298,1068,527,541,160,131,112,52,462,247,215,87,45,49,20,1
29299,394,202,192,44,43,38,28,472,258,214,69,52,32,18,1
29300,615,293,322,70,67,45,29,504,259,245,73,56,45,29,1
29301,168,76,92,26,21,19,4,193,118,75,20,21,24,6,1
29302,350,224,126,34,14,48,18,307,133,174,65,42,14,9,1
29303,926,435,491,133,132,85,17,575,318,257,65,65,70,24,1
29304,502,240,262,78,61,54,32,183,91,92,21,29,16,10,1
29305,467,226,241,55,48,54,23,779,292,487,178,84,124,50,1
29306,532,226,306,102,55,69,29,1863,721,1142,262,283,139,74,1
29307,201,93,108,34,39,21,6,191,99,92,25,24,18,8,1
29308,436,201,235,54,37,34,20,1747,959,788,256,200,123,25,1
29309,451,238,213,53,64,56,22,605,295,310,74,66,70,36,1
29310,862,432,430,121,96,102,37,2135,1170,965,232,246,196,89,1
29311,668,331,337,108,64,58,29,291,133,158,46,51,21,15,1
29312,368,175,193,72,43,39,15,1098,552,546,157,133,110,58,1
29313,745,366,379,110,93,79,45,651,306,345,85,64,61,32,1
29314,1482,762,720,156,144,154,52,442,208,234,68,49,51,25,1
29315,926,435,491,133,132,85,17,423,210,213,54,59,50,18,1
29316,536,278,258,72,63,62,20,1205,632,573,156,149,102,48,1
29317,377,177,200,63,53,44,16,737,363,374,119,101,85,41,1
29318,621,301,320,76,64,46,34,748,360,388,101,89,82,36,1
29319,280,97,183,55,48,20,20,748,355,393,121,91,95,26,1
29320,192,93,99,29,21,17,11,757,373,384,115,93,95,25,1
29321,906,455,451,116,105,87,46,214,108,106,29,32,21,7,1
29322,537,276,261,75,68,68,22,316,156,160,34,28,32,14,1
29323,323,123,200,59,69,30,15,1273,592,681,199,164,139,39,1
29324,160,101,59,21,18,17,2,196,105,91,22,26,21,8,1
29325,709,359,350,107,102,65,20,266,152,114,31,13,37,11,1
29326,576,250,326,93,71,34,15,673,313,360,101,101,46,17,1
29327,920,492,428,100,92,88,49,295,143,152,38,47,22,25,1
29328,247,110,137,34,45,23,10,684,353,331,95,98,77,38,1
29329,1332,637,695,214,178,117,40,916,344,572,168,220,47,10,1
29330,462,248,214,53,49,55,20,493,208,285,75,77,70,40,1
29331,593,291,302,81,85,56,20,780,409,371,125,80,60,34,1
29332,753,345,408,77,85,66,31,423,218,205,64,55,54,15,1
29333,304,159,145,38,40,32,3,794,390,404,103,95,86,23,1
29334,473,248,225,64,50,38,24,184,86,98,26,26,14,11,1
29335,1464,693,771,153,136,91,86,556,259,297,75,69,63,38,1
29336,822,374,448,134,118,76,39,781,418,363,92,90,64,41,1
29337,476,227,249,52,59,38,17,642,271,371,106,111,57,23,1
29338,501,240,261,80,62,49,42,709,310,399,95,103,61,30,1
29339,984,509,475,114,109,106,56,333,167,166,45,30,34,14,1
29340,882,432,450,115,111,68,44,500,234,266,72,63,58,33,1
29341,518,270,248,63,52,57,33,551,298,253,63,65,45,19,1
29342,1390,695,695,180,137,170,71,130,69,61,21,13,16,5,1
29343,488,217,271,71,71,50,32,585,322,263,77,66,74,40,1
29344,822,424,398,107,106,86,46,591,319,272,96,62,43,19,1
29345,374,212,162,48,40,32,23,2045,985,1060,359,339,199,74,1
29346,1048,564,484,118,122,113,40,788,367,421,93,97,71,71,1
29347,272,173,99,32,32,11,8,241,132,109,33,26,27,13,1
29348,674,268,406,118,96,70,21,586,270,316,83,80,59,21,1
29349,690,327,363,115,91,54,31,726,326,400,106,106,57,31,1
29350,1462,711,751,219,222,148,65,423,220,203,51,54,46,17,1
29351,2768,1380,1388,280,294,291,161,654,317,337,95,111,44,13,1
29352,641,324,317,88,92,49,14,318,164,154,52,43,34,10,1
29353,2030,1006,1024,306,249,263,107,304,159,145,38,40,32,3,1
29354,1233,498,735,252,232,88,41,934,472,462,119,122,87,39,1
29355,656,358,298,67,47,64,26,258,157,101,28,27,21,7,1
29356,624,308,316,92,72,68,22,724,334,390,112,109,79,17,1
29357,365,222,143,44,24,35,11,467,226,241,55,48,54,23,1
29358,246,128,118,39,34,22,7,152,98,54,13,10,21,9,1
29359,802,344,458,156,136,57,24,173,110,63,35,6,9,8,1
29360,360,192,168,55,45,48,16,553,261,292,73,79,40,26,1
29361,429,227,202,49,51,46,26,3830,2000,1830,532,388,418,203,1
29362,560,244,316,92,118,47,12,476,233,243,76,61,52,21,1
29363,261,126,135,41,36,24,11,121,69,52,15,18,14,8,1
29364,1336,633,703,182,197,110,52,424,209,215,56,58,45,24,1
29365,418,235,183,48,24,55,30,672,334,338,110,93,91,41,1
29366,1863,721,1142,262,283,139,74,346,191,155,52,38,40,13,1
29367,508,267,241,43,35,25,17,347,181,166,27,20,12,12,1
29368,412,218,194,63,51,49,14,606,307,299,92,56,68,30,1
29369,921,544,377,99,116,105,32,255,122,133,35,51,22,13,1
29370,2353,1314,1039,308,250,253,112,1182,612,570,142,118,140,62,1
29371,356,197,159,50,43,29,17,249,111,138,40,30,22,17,1
29372,277,122,155,33,33,25,24,840,385,455,118,137,66,39,1
29373,632,285,347,102,78,43,29,954,521,433,135,118,78,26,1
29374,217,109,108,34,32,35,7,847,402,445,109,91,100,37,1
29375,484,192,292,118,68,83,22,522,251,271,87,68,60,21,1
29376,1210,485,725,205,139,79,34,313,157,156,39,26,34,29,1
29377,714,364,350,98,102,91,27,906,455,451,116,105,87,46,1
29378,534,266,268,86,62,37,14,328,120,208,76,50,23,9,1
29379,219,116,103,66,7,2,1,185,70,115,37,48,15,5,1
29380,391,208,183,65,49,57,17,241,115,126,35,30,17,14,1
29381,963,532,431,99,110,105,44,174,79,95,36,37,18,6,1
29382,339,183,156,43,45,28,17,466,186,280,71,84,30,11,1
29383,1061,543,518,146,123,109,67,195,109,86,25,24,17,6,1
29384,2442,1193,1249,278,183,170,145,454,214,240,56,71,35,16,1
29385,900,484,416,119,110,77,29,662,322,340,101,89,76,21,1
29386,782,347,435,110,92,74,34,553,261,292,73,79,40,26,1
29387,199,107,92,41,15,14,8,403,188,215,70,42,41,11,1
29388,283,132,151,57,33,12,7,220,101,119,50,22,23,6,1
29389,281,154,127,45,31,24,9,640,279,361,102,83,69,21,1
29390,637,335,302,83,77,85,26,240,167,73,32,12,8,21,1
29391,316,157,159,45,38,22,19,1424,650,774,152,124,95,87,1
29392,418,204,214,68,66,38,12,526,264,262,77,71,61,27,1
29393,255,122,133,35,51,22,13,601,290,311,92,89,55,30,1
29394,517,196,321,103,98,34,12,267,147,120,40,24,25,8,1
29395,612,330,282,71,54,63,37,284,151,133,34,19,22,20,1
29396,2803,1300,1503,392,510,170,57,445,225,220,47,62,53,26,1
29397,585,289,296,102,86,61,18,518,259,259,65,66,65,24,1
29398,520,274,246,55,70,57,16,96,50,46,8,15,6,2,1
29399,204,103,101,16,32,22,8,103,56,47,27,7,8,2,1
29400,213,109,104,26,26,21,6,748,355,393,121,91,95,26,1
29401,2161,1233,928,269,199,178,42,767,392,375,113,112,83,13,1
29402,2442,1193,1249,278,183,170,145,450,241,209,67,58,54,23,1
29403,165,90,75,36,18,20,6,611,246,365,116,82,71,27,1
29404,551,298,253,63,65,45,19,543,265,278,52,37,54,19,1
29405,289,147,142,45,45,38,13,393,186,207,58,50,36,22,1
29406,182,71,111,45,36,11,13,149,68,81,15,38,11,10,1
29407,375,202,173,46,49,41,23,166,79,87,29,27,14,5,1
29408,512,261,251,79,73,60,21,86,52,34,9,8,8,3,1
29409,930,367,563,181,153,83,48,776,356,420,122,103,85,30,1
29410,1324,609,715,149,119,97,56,482,231,251,76,81,64,26,1
29411,553,261,292,73,79,40,26,377,184,193,56,53,44,14,1
29412,116,55,61,16,7,18,14,165,89,76,17,12,8,16,1
29413,863,430,433,131,110,70,28,89,42,47,16,12,15,6,1
29414,712,396,316,78,69,65,25,101,41,60,18,19,10,5,1
29415,349,178,171,28,23,33,10,526,254,272,44,43,49,13,1
29416,410,186,224,72,57,52,22,1427,542,885,246,269,69,46,1
29417,797,394,403,109,89,83,40,745,366,379,110,93,79,45,1
29418,481,256,225,60,56,48,12,1114,581,533,145,132,126,54,1
29419,476,227,249,52,59,38,17,238,134,104,20,22,14,6,1
29420,513,246,267,71,66,60,35,574,277,297,88,77,58,36,1
29421,266,124,142,44,21,28,26,246,115,131,15,29,10,32,1
29422,467,226,241,55,48,54,23,198,113,85,19,20,26,12,1
29423,446,176,270,64,79,45,24,632,326,306,92,71,56,19,1
29424,256,125,131,34,27,24,14,374,217,157,52,23,67,13,1
29425,2541,1299,1242,306,302,121,98,1134,574,560,157,164,47,48,1
29426,503,286,217,76,44,66,22,521,290,231,76,56,76,18,1
29427,724,334,390,112,109,79,17,1047,562,485,141,127,114,41,1
29428,258,141,117,33,29,23,10,378,192,186,49,36,45,23,1
29429,582,293,289,94,80,77,32,422,203,219,75,49,40,22,1
29430,665,297,368,111,107,34,12,526,264,262,77,71,61,27,1
29431,191,72,119,40,41,17,8,585,302,283,91,57,33,16,1
29432,624,308,316,92,72,68,22,215,88,127,36,26,27,16,1
29433,728,385,343,110,102,69,14,217,109,108,34,32,35,7,1
29434,1009,506,503,146,141,97,55,1502,683,819,241,216,172,52,1
29435,164,78,86,28,23,12,8,209,78,131,33,42,11,7,1
29436,323,169,154,47,44,39,20,2035,1087,948,163,129,96,73,1
29437,165,87,78,24,19,22,9,383,204,179,61,32,54,16,1
29438,466,186,280,71,84,30,11,666,344,322,91,73,91,20,1
29439,129,66,63,23,17,18,4,1519,823,696,204,195,110,45,1
29440,632,360,272,75,65,36,19,466,186,280,71,84,30,11,1
29441,727,389,338,77,54,70,32,894,420,474,136,146,93,39,1
29442,160,60,100,23,40,19,11,854,380,474,137,159,81,31,1
29443,863,470,393,82,72,92,44,148,67,81,20,14,18,16,1
29444,1270,682,588,165,147,136,54,306,128,178,49,59,17,9,1
29445,273,154,119,33,25,21,12,665,297,368,111,107,34,12,1
29446,317,161,156,40,49,41,11,358,170,188,54,55,20,10,1
29447,615,312,303,86,54,75,45,770,355,415,103,142,75,42,1
29448,470,256,214,56,39,47,34,443,198,245,68,72,48,19,1
29449,374,219,155,57,42,32,19,163,71,92,22,38,11,7,1
29450,2322,1315,1007,242,257,220,38,1074,538,536,154,140,111,51,1
29451,862,433,429,97,59,24,27,551,298,253,63,65,45,19,1
29452,262,151,111,30,17,32,25,955,465,490,137,138,119,28,1
29453,537,276,261,75,68,68,22,829,366,463,137,130,56,10,1
29454,476,270,206,62,45,46,30,380,184,196,58,52,46,8,1
29455,208,100,108,27,29,18,9,465,225,240,65,44,65,25,1
29456,150,74,76,21,22,18,7,563,299,264,78,79,68,26,1
29457,295,145,150,41,45,36,18,744,384,360,104,96,57,31,1
29458,787,394,393,113,98,52,19,819,411,408,108,86,90,58,1
29459,331,193,138,44,37,18,9,444,212,232,74,25,60,24,1
29460,536,278,258,72,63,62,20,1464,715,749,200,167,181,70,1
29461,381,196,185,55,57,43,16,294,157,137,43,30,29,16,1
29462,706,300,406,94,74,61,22,654,344,310,80,69,57,15,1
29463,228,139,89,24,21,32,18,556,300,256,58,73,55,22,1
29464,493,281,212,57,50,51,20,317,156,161,49,51,18,10,1
29465,903,433,470,122,127,48,30,2758,1332,1426,394,384,287,131,1
29466,304,127,177,61,38,31,4,815,418,397,97,62,70,17,1
29467,76,42,34,12,8,5,7,327,177,150,40,40,38,18,1
29468,390,203,187,58,40,43,19,359,184,175,49,35,32,11,1
29469,465,257,208,51,61,54,23,437,228,209,47,61,26,11,1
29470,586,254,332,114,111,55,17,781,418,363,92,90,64,41,1
29471,303,159,144,40,35,35,8,976,496,480,128,111,121,48,1
29472,2376,1263,1113,304,241,264,115,540,261,279,62,49,59,26,1
29473,505,275,230,63,57,35,12,377,201,176,46,50,41,23,1
29474,720,356,364,90,98,61,22,462,232,230,78,54,42,23,1
29475,111,51,60,20,21,10,11,839,439,400,101,86,102,43,1
29476,267,159,108,31,13,22,15,528,276,252,86,78,49,17,1
29477,500,244,256,66,57,52,27,2440,1061,1379,377,326,172,62,1
29478,862,432,430,121,96,102,37,1304,585,719,179,169,154,47,1
29479,561,292,269,88,68,64,22,1265,580,685,205,188,166,53,1
29480,1066,457,609,176,125,104,42,247,110,137,34,45,23,10,1
29481,229,123,106,28,21,21,14,766,386,380,101,81,78,31,1
29482,284,150,134,34,23,31,13,270,130,140,43,24,36,10,1
29483,2524,1232,1292,398,317,186,61,882,432,450,115,111,68,44,1
29484,412,216,196,24,48,18,16,635,333,302,99,75,83,28,1
29485,247,110,137,34,45,23,10,971,516,455,114,115,116,35,1
29486,154,66,88,26,13,12,10,268,143,125,43,29,22,10,1
29487,136,66,70,33,11,9,3,1054,497,557,190,168,107,45,1
29488,1647,794,853,279,235,128,65,778,367,411,90,85,64,43,1
29489,476,270,206,62,45,46,30,2490,1126,1364,352,325,219,89,1
29490,536,278,258,72,63,62,20,162,88,74,18,20,25,10,1
29491,171,94,77,24,28,30,11,1006,551,455,115,97,110,41,1
29492,357,169,188,61,53,32,15,345,174,171,46,34,45,28,1
29493,1691,1217,474,130,115,73,46,811,361,450,124,107,80,31,1
29494,484,192,292,118,68,83,22,304,127,177,61,38,31,4,1
29495,383,201,182,44,37,32,51,1074,539,535,136,87,87,66,1
29496,408,221,187,55,51,57,14,292,108,184,47,64,19,15,1
29497,425,177,248,60,62,33,16,599,314,285,80,72,58,20,1
29498,461,257,204,63,49,50,29,920,492,428,100,92,88,49,1
29499,539,279,260,72,64,19,24,410,208,202,59,58,43,26,1
29500,205,99,106,24,29,20,5,248,130,118,26,28,16,11,1
29501,415,203,212,77,44,49,18,143,79,64,16,25,7,5,1
29502,791,306,485,142,157,21,18,1194,543,651,190,197,65,43,1
29503,977,492,485,135,122,116,35,854,380,474,137,159,81,31,1
29504,330,143,187,63,29,52,20,637,267,370,94,126,43,27,1
29505,688,323,365,121,69,55,22,346,183,163,51,38,23,6,1
29506,148,64,84,33,19,6,1,149,68,81,15,38,11,10,1
29507,203,98,105,34,29,19,10,395,222,173,48,42,21,8,1
29508,659,325,334,102,85,87,32,1059,508,551,129,112,135,36,1
29509,881,419,462,132,82,81,24,894,417,477,114,123,89,38,1
29510,776,356,420,122,103,85,30,192,101,91,25,22,18,9,1
29511,757,414,343,85,59,112,47,185,89,96,28,19,17,13,1
29512,605,283,322,94,72,64,39,317,153,164,34,52,30,14,1
29513,454,224,230,71,39,62,22,760,391,369,101,109,65,24,1
29514,351,143,208,44,68,23,18,341,167,174,48,47,31,8,1
29515,531,286,245,81,67,42,29,648,307,341,101,58,76,34,1
29516,488,217,271,71,71,50,32,152,98,54,20,6,25,7,1
29517,194,103,91,26,32,13,8,377,202,175,46,50,41,23,1
29518,295,179,116,31,28,28,16,676,333,343,111,89,94,39,1
29519,146,71,75,20,17,8,7,221,113,108,23,17,11,11,1
29520,764,372,392,109,94,85,36,1663,835,828,224,213,163,63,1
29521,411,207,204,51,38,40,15,326,140,186,53,36,41,16,1
29522,737,363,374,119,101,85,41,377,202,175,46,50,41,23,1
29523,1807,933,874,248,203,173,71,744,385,359,125,89,90,23,1
29524,194,90,104,33,17,24,19,242,111,131,35,35,17,13,1
29525,839,427,412,91,83,114,37,625,316,309,77,79,54,34,1
29526,136,65,71,33,11,9,6,183,76,107,34,38,14,8,1
29527,593,266,327,102,84,69,24,1132,553,579,172,143,150,57,1
29528,508,295,213,42,61,53,17,724,325,399,98,92,64,24,1
29529,81,41,40,15,13,3,2,848,394,454,100,90,101,41,1
29530,898,467,431,101,127,90,53,619,290,329,97,79,62,19,1
29531,211,113,98,38,17,25,8,631,309,322,106,83,89,33,1
29532,124,72,52,14,12,13,6,467,250,217,59,52,41,19,1
29533,397,221,176,51,39,29,17,547,300,247,68,60,55,30,1
29534,732,355,377,108,109,79,27,1087,523,564,146,177,103,33,1
29535,530,259,271,83,50,54,41,2817,1216,1601,379,436,183,115,1
29536,1304,585,719,179,169,154,47,217,109,108,34,32,35,7,1
29537,461,227,234,61,47,54,33,1074,538,536,154,140,111,51,1
29538,95,44,51,14,13,7,4,350,181,169,44,52,43,13,1
29539,393,223,170,44,36,32,14,2442,1193,1249,278,183,170,145,1
29540,425,210,215,56,43,52,25,427,218,209,61,53,45,26,1
29541,1099,566,533,120,154,95,46,690,337,353,108,102,74,26,1
29542,164,88,76,27,20,17,6,537,276,261,75,68,68,22,1
29543,2426,1147,1279,307,320,114,128,930,367,563,181,153,83,48,1
29544,272,173,99,32,32,11,8,1217,566,651,215,170,102,23,1
29545,673,317,356,101,85,76,49,550,319,231,49,65,35,16,1
29546,837,464,373,104,72,85,49,418,213,205,54,56,49,13,1
29547,833,467,366,106,84,105,34,817,425,392,120,102,83,26,1
29548,411,205,206,51,31,33,14,781,418,363,92,90,64,41,1
29549,1258,648,610,172,159,116,28,906,455,451,116,105,87,46,1
29550,595,316,279,86,60,65,40,835,420,415,104,105,57,47,1
29551,637,335,302,83,77,85,26,237,112,125,19,57,25,10,1
29552,427,204,223,38,57,26,32,360,192,168,55,45,48,16,1
29553,902,332,570,154,146,75,40,673,313,360,101,101,46,17,1
29554,643,338,305,81,72,78,35,165,95,70,18,23,19,11,1
29555,951,506,445,107,118,79,40,666,344,322,91,73,91,20,1
29556,581,254,327,100,83,54,20,2442,1193,1249,278,183,170,145,1
29557,1118,471,647,204,164,102,34,270,106,164,55,48,27,12,1
29558,95,41,54,15,16,8,5,943,342,601,188,127,74,24,1
29559,1273,592,681,199,164,139,39,718,283,435,126,127,34,29,1
29560,478,223,255,80,81,41,24,472,258,214,69,52,32,18,1
29561,731,383,348,102,84,68,30,632,326,306,92,71,56,19,1
29562,646,316,330,89,95,48,17,193,107,86,13,20,13,6,1
29563,736,388,348,88,85,67,28,423,218,205,64,55,54,15,1
29564,1425,670,755,153,189,122,85,467,226,241,55,48,54,23,1
29565,502,240,262,78,61,54,32,183,95,88,27,22,26,5,1
29566,1562,742,820,219,231,104,46,2135,1170,965,232,246,196,89,1
29567,476,227,249,52,59,38,17,390,207,183,50,48,38,15,1
29568,1168,652,516,155,113,134,68,648,307,341,101,58,76,34,1
29569,325,153,172,62,37,50,39,386,181,205,55,51,57,31,1
29570,538,252,286,77,87,53,30,502,236,266,66,66,58,17,1
29571,1333,646,687,209,179,148,45,1255,708,547,120,68,88,7,1
29572,2477,1186,1291,256,271,249,90,707,386,321,85,83,99,28,1
29573,1395,627,768,172,263,141,59,397,237,160,47,15,56,21,1
29574,832,428,404,131,89,88,38,2414,1189,1225,277,178,170,169,1
29575,1190,638,552,162,95,112,18,2627,1378,1249,361,265,257,96,1
29576,195,109,86,25,24,17,6,781,374,407,123,99,65,26,1
29577,366,183,183,48,47,36,17,654,317,337,95,111,44,13,1
29578,496,218,278,59,62,54,26,498,222,276,71,60,63,27,1
29579,919,444,475,141,148,62,20,450,229,221,49,63,54,27,1
29580,595,316,279,86,60,65,40,158,85,73,24,18,18,8,1
29581,632,350,282,82,58,111,42,422,211,211,73,61,43,17,1
29582,1014,427,587,195,162,105,40,375,202,173,46,49,41,23,1
29583,452,230,222,64,61,31,27,401,167,234,56,71,16,10,1
29584,854,380,474,137,159,81,31,149,68,81,15,38,11,10,1
29585,834,405,429,112,95,84,34,903,437,466,117,112,108,32,1
29586,639,287,352,111,108,44,9,217,109,108,34,32,35,7,1
29587,3418,1378,2040,515,464,318,121,1471,709,762,198,184,154,62,1
29588,481,269,212,54,35,54,25,359,173,186,55,57,44,16,1
29589,546,267,279,90,69,56,19,427,230,197,48,28,60,37,1
29590,191,72,119,40,41,17,8,1647,794,853,279,235,128,65,1
29591,379,203,176,55,48,45,16,393,186,207,58,50,36,22,1
29592,330,208,122,44,20,44,12,247,110,137,34,45,23,10,1
29593,912,461,451,127,109,96,48,1290,629,661,191,187,167,55,1
29594,825,427,398,79,95,81,48,412,223,189,55,55,41,10,1
29595,351,184,167,59,45,54,9,736,318,418,96,108,72,37,1
29596,750,347,403,105,103,83,29,2414,1189,1225,277,178,170,169,1
29597,95,47,48,13,11,6,11,97,39,58,12,14,9,7,1
29598,763,368,395,102,69,65,32,315,118,197,85,57,42,14,1
29599,168,67,101,37,17,13,13,340,181,159,44,39,35,21,1
29600,521,265,256,56,44,35,12,507,242,265,53,44,31,22,1
29601,149,77,72,19,15,18,9,569,293,276,63,52,43,20,1
29602,503,263,240,72,55,51,34,229,105,124,36,33,12,4,1
29603,756,444,312,95,64,60,17,557,306,251,66,42,52,15,1
29604,770,385,385,78,83,60,16,536,278,258,72,63,62,20,1
29605,352,189,163,42,31,33,19,426,200,226,75,56,39,24,1
29606,764,409,355,88,73,102,43,355,165,190,53,56,42,19,1
29607,838,380,458,114,95,68,57,806,419,387,115,130,57,32,1
29608,295,139,156,48,31,30,17,292,152,140,46,38,35,12,1
29609,363,181,182,51,42,57,18,1024,486,538,186,113,94,51,1
29610,670,309,361,120,78,60,24,1801,889,912,206,263,126,42,1
29611,538,268,270,58,72,42,25,165,80,85,21,9,18,19,1
29612,1187,573,614,188,132,138,52,1748,791,957,281,247,173,25,1
29613,471,221,250,87,68,42,25,249,111,138,40,30,22,17,1
29614,1957,777,1180,315,263,149,46,1009,506,503,146,141,97,55,1
29615,1692,713,979,325,210,122,58,2138,1161,977,258,229,249,95,1
29616,282,135,147,36,49,25,10,672,334,338,110,93,91,41,1
29617,443,248,195,67,54,40,15,464,242,222,61,68,36,17,1
29618,900,484,416,119,110,77,29,1203,527,676,199,174,99,107,1
29619,500,244,256,66,57,52,27,1016,501,515,109,71,76,37,1
29620,89,44,45,15,12,15,6,361,172,189,51,54,25,4,1
29621,587,309,278,67,73,56,34,354,168,186,50,53,39,20,1
29622,303,175,128,43,36,34,12,1290,597,693,182,182,119,63,1
29623,760,410,350,89,81,128,25,766,395,371,89,86,127,27,1
29624,785,374,411,56,42,38,25,2440,1061,1379,377,326,172,62,1
29625,337,171,166,46,27,33,16,2440,1061,1379,377,326,172,62,1
29626,240,125,115,34,32,30,8,537,276,261,75,68,68,22,1
29627,1001,422,579,185,180,51,32,928,442,486,139,118,91,43,1
29628,975,400,575,160,162,62,31,406,187,219,55,64,24,9,1
29629,1336,633,703,182,197,110,52,573,247,326,98,95,46,22,1
29630,517,196,321,103,98,34,12,168,67,101,37,17,13,13,1
29631,8797,3688,5109,1359,1437,715,322,869,464,405,107,91,89,56,1
29632,207,105,102,35,27,15,5,837,399,438,112,144,71,32,1
29633,903,437,466,117,112,108,32,651,323,328,90,65,64,24,1
29634,390,199,191,72,42,35,12,633,303,330,95,91,51,13,1
29635,355,165,190,53,56,42,19,443,240,203,66,31,57,27,1
29636,1290,629,661,191,187,167,55,280,133,147,44,38,40,12,1
29637,1086,603,483,147,121,95,40,925,432,493,137,135,106,43,1
29638,430,192,238,62,67,27,10,246,113,133,33,45,22,10,1
29639,459,221,238,72,78,47,16,451,225,226,68,57,65,22,1
29640,672,334,338,110,93,91,41,930,477,453,111,92,92,29,1
29641,1257,647,610,156,146,145,35,729,391,338,80,64,71,34,1
29642,431,228,203,66,46,59,15,1247,548,699,168,150,140,43,1
29643,838,431,407,107,90,107,43,492,238,254,72,56,49,20,1
29644,603,311,292,102,71,66,23,646,304,342,104,93,58,26,1
29645,158,74,84,26,23,18,18,1834,823,1011,297,282,151,63,1
29646,391,208,183,65,49,57,17,529,264,265,59,68,41,17,1
29647,1363,690,673,185,172,152,62,1074,538,536,154,140,111,51,1
29648,1273,592,681,199,164,139,39,425,199,226,54,71,56,11,1
29649,880,355,525,122,139,75,36,467,226,241,55,48,54,23,1
29650,673,313,360,101,101,46,17,621,273,348,104,102,48,19,1
29651,456,228,228,49,70,32,19,670,358,312,95,75,58,26,1
29652,829,366,463,137,130,56,10,418,199,219,55,44,22,15,1
29653,918,427,491,113,111,113,33,526,264,262,77,71,61,27,1
29654,104,54,50,17,18,13,4,204,119,85,25,24,19,12,1
29655,111,55,56,16,15,8,7,198,95,103,29,26,22,8,1
29656,398,203,195,58,43,54,16,269,133,136,30,41,34,17,1
29657,624,308,316,92,72,68,22,393,223,170,44,36,32,14,1
29658,630,303,327,89,62,56,35,217,109,108,34,32,35,7,1
29659,8797,3688,5109,1359,1437,715,322,377,202,175,46,50,41,22,1
29660,862,409,453,149,125,86,29,309,155,154,41,44,45,16,1
29661,428,226,202,52,60,75,20,928,442,486,139,118,91,43,1
29662,423,222,201,60,51,51,11,417,231,186,37,32,43,18,1
29663,410,211,199,55,42,34,27,2440,1061,1379,377,326,172,62,1
29664,919,538,381,111,98,103,41,1466,991,475,136,129,59,39,1
29665,859,411,448,118,100,95,49,295,146,149,33,32,33,7,1
29666,1834,823,1011,297,282,151,63,906,437,469,135,132,49,40,1
29667,3312,1761,1551,403,345,309,127,1051,523,528,164,140,126,50,1
29668,450,227,223,53,36,48,12,2414,1189,1225,277,178,170,169,1
29669,582,293,289,94,80,77,32,111,29,82,10,54,0,1,1
29670,175,91,84,19,21,21,10,218,127,91,27,23,23,10,1
29671,724,320,404,120,147,67,25,859,395,464,157,119,59,31,1
29672,290,127,163,47,58,23,12,769,329,440,116,66,55,22,1
29673,900,484,416,119,110,77,29,745,366,379,110,93,79,45,1
29674,370,177,193,51,61,32,4,355,169,186,49,37,26,11,1
29675,976,496,480,128,111,121,48,1132,553,579,172,143,150,57,1
29676,524,237,287,87,75,54,26,298,167,131,47,33,40,8,1
29677,985,445,540,164,146,68,36,245,112,133,32,45,20,10,1
29678,620,348,272,91,43,59,29,2556,1169,1387,248,291,227,275,1
29679,605,215,390,138,54,75,35,835,420,415,104,105,57,47,1
29680,704,356,348,112,94,71,24,928,442,486,139,118,91,43,1
29681,778,367,411,90,85,64,43,770,374,396,95,91,79,41,1
29682,1801,889,912,206,263,126,42,1464,715,749,200,167,181,70,1
29683,216,102,114,31,29,21,6,448,275,173,32,53,55,27,1
29684,509,341,168,35,32,52,15,181,96,85,26,23,18,7,1
29685,425,210,215,56,43,52,25,536,237,299,116,87,42,17,1
29686,345,155,190,49,56,23,6,4646,2328,2318,674,639,475,170,1
29687,787,386,401,98,95,86,25,1124,578,546,149,127,122,61,1
29688,815,382,433,97,50,88,31,324,190,134,41,27,28,9,1
29689,487,263,224,57,43,62,21,406,209,197,57,50,50,17,1
29690,728,385,343,110,102,69,14,211,113,98,38,17,25,8,1
29691,350,180,170,64,46,55,12,262,150,112,31,33,31,7,1
29692,122,80,42,11,8,12,5,260,138,122,44,30,28,6,1
29693,718,283,435,126,127,34,29,1382,599,783,208,252,90,39,1
29694,628,324,304,83,85,75,23,757,373,384,115,93,95,25,1
29695,392,115,277,117,75,28,17,259,143,116,39,37,23,9,1
29696,396,215,181,53,43,55,17,885,424,461,143,114,92,32,1
29697,445,225,220,47,62,53,26,662,312,350,103,104,59,20,1
29698,299,128,171,57,40,13,25,559,271,288,81,58,59,26,1
29699,267,147,120,37,28,35,12,208,107,101,42,22,18,10,1
29700,522,235,287,78,67,60,50,256,125,131,34,27,24,14,1
29701,66,36,30,11,3,5,5,592,283,309,84,137,60,20,1
29702,400,183,217,53,62,28,28,548,252,296,65,93,42,28,1
29703,1744,920,824,225,190,178,57,2489,1251,1238,288,234,283,178,1
29704,601,313,288,42,48,25,36,815,418,397,97,62,70,17,1
29705,218,114,104,32,31,33,11,218,117,101,35,32,34,12,1
29706,235,104,131,29,35,26,10,460,223,237,61,65,45,22,1
29707,552,285,267,74,51,69,24,462,251,211,74,53,41,18,1
29708,466,186,280,71,84,30,11,435,203,232,57,67,40,12,1
29709,247,127,120,43,20,27,14,586,240,346,94,110,29,19,1
29710,178,100,78,23,22,30,6,1203,651,552,151,128,123,46,1
29711,501,257,244,65,53,57,28,423,210,213,54,59,50,18,1
29712,240,125,115,34,32,30,8,207,107,100,27,25,20,11,1
29713,591,279,312,88,91,52,26,95,47,48,13,12,10,4,1
29714,656,358,298,67,47,64,26,246,115,131,15,29,10,32,1
29715,261,143,118,33,24,32,16,402,222,180,50,39,51,19,1
29716,405,202,203,47,55,50,14,601,313,288,42,48,25,36,1
29717,207,115,92,26,16,11,13,412,195,217,79,48,36,29,1
29718,422,203,219,75,49,40,22,393,186,207,58,50,36,22,1
29719,224,108,116,31,32,22,8,119,67,52,15,15,7,7,1
29720,1270,557,713,130,195,57,30,785,374,411,56,42,38,25,1
29721,770,390,380,104,76,78,32,947,506,441,105,126,75,14,1
29722,360,188,172,49,48,47,17,430,192,238,62,67,27,10,1
29723,213,108,105,26,26,21,8,185,115,70,19,17,26,6,1
29724,592,291,301,92,93,71,31,648,307,341,101,58,76,34,1
29725,158,85,73,24,18,18,8,353,147,206,47,61,30,25,1
29726,391,208,183,65,49,57,17,1531,691,840,270,226,143,52,1
29727,606,307,299,92,56,68,30,393,210,183,55,50,34,19,1
29728,1338,756,582,155,105,104,44,1068,559,509,158,132,122,57,1
29729,1382,599,783,208,252,90,39,393,175,218,66,67,21,10,1
29730,659,325,334,102,85,87,32,656,358,298,67,47,64,26,1
29731,476,233,243,76,61,52,21,552,285,267,74,51,69,24,1
29732,1313,644,669,169,90,111,43,355,168,187,48,57,30,15,1
29733,758,362,396,115,102,35,13,375,202,173,46,49,41,23,1
29734,663,338,325,68,71,41,16,229,105,124,36,33,12,4,1
29735,205,106,99,28,26,23,3,173,82,91,27,25,28,4,1
29736,394,202,192,44,43,38,28,1129,589,540,134,122,108,46,1
29737,149,85,64,20,15,4,2,601,313,288,42,48,25,36,1
29738,316,157,159,45,38,22,19,619,292,327,73,73,61,32,1
29739,509,262,247,64,70,64,20,845,402,443,137,126,105,47,1
29740,169,99,70,26,21,20,7,267,149,118,45,33,31,14,1
29741,462,228,234,59,47,37,32,882,432,450,115,111,68,44,1
29742,428,226,202,52,60,75,20,1071,549,522,133,127,130,59,1
29743,605,298,307,94,66,46,31,297,148,149,64,35,37,15,1
29744,1970,978,992,245,206,198,80,1129,589,540,134,122,108,46,1
29745,589,294,295,37,44,27,33,236,120,116,19,16,23,8,1
29746,540,306,234,74,52,43,22,3433,1476,1957,522,578,264,123,1
29747,328,173,155,43,36,24,17,437,225,212,61,57,66,12,1
29748,819,473,346,75,105,69,16,528,268,260,81,77,36,22,1
29749,327,160,167,56,31,36,15,637,321,316,70,96,30,18,1
29750,822,374,448,134,118,76,39,770,374,396,95,91,79,41,1
29751,1304,585,719,179,169,154,47,359,163,196,47,78,47,9,1
29752,720,357,363,113,85,62,39,1272,520,752,235,242,117,54,1
29753,583,322,261,73,66,45,26,1132,553,579,172,143,150,57,1
29754,393,186,207,58,50,36,22,983,487,496,126,115,104,52,1
29755,245,112,133,32,45,20,10,393,186,207,58,50,36,22,1
29756,617,272,345,83,120,46,17,601,313,288,42,48,25,36,1
29757,94,43,51,11,9,3,7,247,132,115,24,22,24,13,1
29758,651,331,320,93,93,51,28,255,144,111,23,27,32,11,1
29759,1367,690,677,172,175,154,83,1242,613,629,174,113,114,53,1
29760,557,250,307,70,47,51,22,271,110,161,33,27,11,8,1
29761,513,271,242,54,52,44,13,665,297,368,111,107,34,12,1
29762,388,199,189,55,52,52,22,290,153,137,38,29,42,12,1
29763,1134,570,564,152,133,131,69,377,184,193,56,53,44,14,1
29764,296,147,149,45,29,30,23,258,134,124,35,25,29,13,1
29765,388,199,189,50,51,33,14,536,278,258,72,63,62,20,1
29766,1647,794,853,222,218,151,65,455,218,237,57,51,42,35,1
29767,931,491,440,127,116,118,44,537,276,261,75,68,68,22,1
29768,282,152,130,35,27,13,21,426,200,226,75,56,39,24,1
29769,192,106,86,27,21,20,10,631,315,316,64,57,49,15,1
29770,1573,791,782,198,173,148,46,896,407,489,97,152,70,22,1
29771,186,84,102,27,29,21,10,536,278,258,72,63,62,20,1
29772,536,278,258,72,63,62,20,847,452,395,100,94,81,36,1
29773,3969,1703,2266,619,432,259,144,2035,1087,948,163,129,96,73,1
29774,705,421,284,78,58,122,38,748,328,420,126,88,57,32,1
29775,240,98,142,49,42,23,17,393,186,207,58,50,36,22,1
29776,593,266,327,102,84,69,24,1382,689,693,186,176,167,77,1
29777,108,53,55,17,8,10,6,423,247,176,44,35,67,22,1
29778,517,250,267,78,37,64,29,252,114,138,41,35,22,12,1
29779,128,58,70,22,14,4,7,350,213,137,39,21,53,22,1
29780,351,183,168,50,46,37,16,721,363,358,87,104,70,28,1
29781,767,392,375,113,112,83,13,843,449,394,112,86,82,32,1
29782,458,222,236,69,39,35,18,760,401,359,96,89,98,22,1
29783,909,455,454,137,82,85,68,724,334,390,112,109,79,17,1
29784,223,103,120,36,30,15,9,654,344,310,80,69,57,15,1
29785,290,127,163,47,58,23,12,340,172,168,60,50,36,10,1
29786,863,450,413,116,122,106,41,149,77,72,37,10,20,5,1
29787,1304,585,719,179,169,154,47,290,149,141,37,26,41,12,1
29788,224,151,73,19,13,42,16,558,306,252,75,55,74,23,1
29789,541,260,281,87,65,70,24,570,292,278,80,65,72,23,1
29790,352,167,185,49,44,37,16,366,211,155,35,42,24,12,1
29791,168,67,101,37,17,13,13,310,170,140,39,26,32,17,1
29792,1113,401,712,196,186,53,44,652,323,329,99,90,65,20,1
29793,404,197,207,57,69,33,15,1858,805,1053,271,345,116,41,1
29794,736,388,348,88,85,67,28,418,204,214,68,66,38,12,1
29795,140,86,54,17,6,20,7,856,429,427,113,105,96,24,1
29796,171,94,77,24,28,30,11,1117,423,694,182,134,88,31,1
29797,2080,1094,986,284,295,253,78,357,169,188,61,53,32,15,1
29798,433,220,213,67,68,31,19,522,235,287,78,67,60,50,1
29799,337,222,115,33,21,38,20,1663,835,828,224,213,163,63,1
29800,211,88,123,38,28,26,10,186,103,83,28,20,27,6,1
29801,837,399,438,112,144,71,32,288,118,170,50,57,18,15,1
29802,1613,806,807,190,211,180,84,352,169,183,57,36,47,31,1
29803,263,146,117,24,21,23,14,346,181,165,36,27,21,23,1
29804,502,240,262,78,61,54,32,431,219,212,68,46,67,18,1
29805,805,486,319,95,71,97,30,963,455,508,126,110,68,29,1
29806,377,180,197,45,63,19,17,320,163,157,44,44,26,15,1
29807,275,140,135,38,32,18,5,423,212,211,51,44,48,28,1
29808,931,476,455,101,101,44,24,101,41,60,18,19,10,5,1
29809,984,459,525,150,145,89,37,2490,1126,1364,352,325,219,89,1
29810,1484,731,753,206,175,187,71,894,420,474,136,146,93,39,1
29811,803,346,457,126,171,74,24,291,131,160,40,42,36,14,1
29812,928,442,486,139,118,91,43,462,247,215,87,45,49,20,1
29813,659,325,334,102,85,87,32,668,338,330,85,95,68,18,1
29814,360,188,172,49,48,47,17,815,478,337,104,80,103,27,1
29815,578,332,246,63,54,61,32,227,107,120,38,33,30,10,1
29816,631,309,322,106,83,89,33,502,299,203,57,52,32,11,1
29817,434,237,197,52,64,37,14,410,222,188,54,49,43,13,1
29818,870,415,455,112,103,93,51,239,129,110,39,31,33,13,1
29819,583,322,261,73,66,45,26,316,156,160,34,28,32,14,1
29820,490,224,266,80,70,39,32,514,265,249,74,61,62,16,1
29821,2442,1193,1249,278,183,170,145,403,220,183,57,39,45,11,1
29822,8797,3688,5109,1359,1437,715,322,254,117,137,33,35,38,6,1
29823,673,313,360,101,101,46,17,1061,440,621,189,149,153,72,1
29824,161,94,67,23,13,8,10,119,67,52,15,15,7,7,1
29825,294,148,146,35,33,25,14,240,125,115,34,32,30,8,1
29826,605,295,310,74,66,70,36,1134,574,560,157,164,47,48,1
29827,430,192,238,62,67,27,10,648,307,341,101,58,76,34,1
29828,1164,622,542,150,143,78,35,211,114,97,32,24,19,10,1
29829,2414,1189,1225,277,178,170,169,595,316,279,86,60,65,40,1
29830,1424,650,774,152,124,95,87,505,247,258,72,71,60,27,1
29831,234,129,105,31,22,19,18,770,390,380,104,76,78,32,1
29832,301,191,110,34,20,37,17,190,94,96,30,21,13,5,1
29833,651,323,328,90,65,64,24,982,545,437,119,100,92,40,1
29834,365,171,194,48,56,36,11,95,49,46,12,16,9,5,1
29835,556,279,277,83,69,71,19,431,228,203,66,46,59,15,1
29836,769,362,407,99,88,66,67,2541,1299,1242,306,302,121,98,1
29837,1332,659,673,174,170,153,55,756,348,408,101,103,60,40,1
29838,671,318,353,83,124,46,34,479,202,277,94,99,30,5,1
29839,588,331,257,86,71,52,12,601,313,288,42,48,25,36,1
29840,309,154,155,42,44,45,16,348,226,122,23,20,59,25,1
29841,1721,838,883,241,218,144,54,482,231,251,76,81,64,26,1
29842,167,79,88,22,26,16,9,118,51,67,25,13,6,7,1
29843,225,135,90,23,12,27,20,1748,791,957,281,247,173,25,1
29844,1138,615,523,142,120,116,57,1124,578,546,149,127,122,61,1
29845,1446,762,684,193,160,182,67,355,165,190,53,56,42,19,1
29846,292,152,140,46,38,35,12,507,242,265,53,44,31,22,1
29847,186,110,76,26,22,32,14,140,81,59,16,15,15,12,1
29848,646,316,330,89,95,48,17,105,53,52,23,11,12,6,1
29849,549,303,246,64,54,59,35,563,304,259,75,64,68,31,1
29850,900,484,416,119,110,77,29,356,199,157,43,58,29,12,1
29851,777,387,390,90,87,65,37,366,124,242,80,63,25,8,1
29852,391,189,202,55,56,56,12,255,130,125,44,18,22,12,1
29853,168,67,101,37,17,13,13,145,75,70,22,18,10,5,1
29854,1050,482,568,136,154,101,41,824,392,432,106,89,88,32,1
29855,748,355,393,121,91,95,26,235,111,124,38,26,31,22,1
29856,855,420,435,139,134,109,35,1223,593,630,161,135,142,71,1
29857,2089,917,1172,285,306,83,39,1972,846,1126,222,330,114,68,1
29858,3664,1638,2026,598,519,231,63,582,293,289,94,80,77,32,1
29859,459,212,247,63,48,48,28,1441,657,784,140,135,81,73,1
29860,794,402,392,96,84,86,30,2556,1169,1387,248,291,227,275,1
29861,821,394,427,122,117,109,38,2080,1094,986,284,295,253,78,1
29862,288,159,129,27,44,27,15,314,158,156,39,28,30,17,1
29863,584,272,312,76,72,66,42,128,62,66,13,11,17,12,1
29864,419,197,222,70,51,36,19,1720,856,864,259,224,176,85,1
29865,468,243,225,60,50,34,32,440,214,226,59,62,27,28,1
29866,467,226,241,55,48,54,23,482,231,251,76,81,64,26,1
29867,631,315,316,64,57,49,15,781,418,363,92,90,64,41,1
29868,580,308,272,82,79,58,25,331,169,162,40,28,22,14,1
29869,222,97,125,36,23,21,12,206,85,121,31,42,6,17,1
29870,534,256,278,81,70,46,25,822,417,405,112,97,88,40,1
29871,372,189,183,60,44,41,18,755,271,484,113,226,61,20,1
29872,168,82,86,30,23,19,10,399,216,183,60,53,43,18,1
29873,577,342,235,63,57,23,37,1332,659,673,174,170,153,55,1
29874,168,120,48,7,5,20,7,451,267,184,43,39,50,7,1
29875,697,373,324,105,83,95,38,201,98,103,26,35,16,5,1
29876,289,135,154,37,34,34,17,593,266,327,102,84,69,24,1
29877,833,452,381,117,85,71,39,583,322,261,73,66,45,26,1
29878,215,115,100,27,28,34,16,595,316,279,86,60,65,40,1
29879,1475,658,817,149,114,120,43,876,457,419,88,124,67,47,1
29880,292,153,139,39,33,24,21,303,175,128,43,36,34,12,1
29881,501,240,261,80,62,49,42,267,130,137,31,18,19,13,1
29882,326,166,160,49,45,36,12,815,418,397,97,62,70,17,1
29883,673,329,344,111,95,92,41,928,442,486,139,118,91,43,1
29884,652,272,380,116,113,55,27,670,333,337,95,79,62,21,1
29885,98,45,53,16,11,15,3,335,183,152,40,26,54,23,1
29886,600,254,346,95,90,52,42,189,90,99,26,29,17,11,1
29887,841,356,485,173,116,27,14,367,161,206,70,48,41,19,1
29888,863,418,445,127,114,70,31,904,436,468,138,146,82,39,1
29889,442,230,212,50,58,56,23,1425,670,755,153,189,122,85,1
29890,652,272,380,116,113,55,27,412,203,209,65,47,37,18,1
29891,461,207,254,82,66,55,33,476,270,206,62,45,46,30,1
29892,314,151,163,42,61,39,16,703,388,315,82,78,81,37,1
29893,474,258,216,63,48,51,24,903,437,466,117,112,108,32,1
29894,89,42,47,16,12,15,6,375,202,173,46,49,41,23,1
29895,445,198,247,85,67,38,19,341,178,163,48,44,42,20,1
29896,557,269,288,83,56,56,22,206,94,112,37,36,18,9,1
29897,429,219,210,46,66,42,17,623,233,390,145,83,43,20,1
29898,82,43,39,16,8,16,2,368,141,227,64,61,24,13,1
29899,1253,639,614,181,155,164,73,1134,570,564,152,133,131,69,1
29900,1092,562,530,126,91,125,84,673,328,345,107,112,63,27,1
29901,333,167,166,45,30,34,14,1076,517,559,139,136,72,34,1
29902,772,364,408,114,106,98,33,928,442,486,139,118,91,43,1
29903,317,153,164,34,52,30,14,191,85,106,33,28,16,8,1
29904,217,105,112,34,32,25,13,149,68,81,15,38,11,10,1
29905,146,71,75,20,17,8,7,1581,684,897,220,153,118,63,1
29906,163,70,93,28,21,17,6,393,186,207,58,50,36,22,1
29907,178,89,89,36,22,18,7,882,432,450,115,111,68,44,1
29908,671,318,353,83,124,46,34,136,72,64,22,16,7,3,1
29909,467,226,241,55,48,54,23,527,262,265,62,73,39,49,1
29910,261,127,134,42,37,24,11,391,208,183,65,49,57,17,1
29911,427,218,209,56,57,53,24,817,425,392,120,102,83,26,1
29912,480,266,214,64,55,37,18,453,255,198,62,49,29,19,1
29913,322,143,179,41,62,23,11,164,78,86,28,23,12,8,1
29914,528,228,300,60,119,43,28,592,283,309,84,137,60,20,1
29915,294,148,146,35,33,25,14,76,42,34,12,8,5,7,1
29916,249,138,111,32,29,21,8,373,181,192,54,35,44,20,1
29917,360,192,168,55,45,48,16,345,176,169,34,31,36,11,1
29918,2414,1189,1225,277,178,170,169,410,200,210,60,54,46,19,1
29919,210,102,108,33,33,20,9,172,98,74,20,21,22,8,1
29920,2270,1179,1091,320,246,268,115,641,324,317,88,92,49,14,1
29921,845,402,443,137,126,105,47,508,295,213,42,61,53,17,1
29922,1692,713,979,325,210,122,58,223,115,108,30,29,24,10,1
29923,406,202,204,54,54,41,16,202,102,100,29,35,6,9,1
29924,160,60,100,23,40,19,11,789,362,427,90,82,70,35,1
29925,492,238,254,72,56,49,20,232,108,124,33,27,19,16,1
29926,686,375,311,89,80,63,20,3144,1617,1527,367,342,278,136,1
29927,1367,690,677,172,175,154,83,297,145,152,49,30,23,21,1
29928,656,358,298,67,47,64,26,300,144,156,38,33,35,12,1
29929,365,188,177,60,47,48,16,304,127,177,61,38,31,4,1
29930,355,214,141,43,29,63,13,750,347,403,105,103,83,29,1
29931,408,197,211,74,44,53,16,1425,670,755,153,189,122,85,1
29932,374,210,164,41,22,53,27,68,34,34,9,2,9,9,1
29933,832,428,404,131,89,88,38,2442,1193,1249,278,183,170,145,1
29934,583,279,304,99,71,59,31,328,156,172,44,37,44,15,1
29935,246,108,138,32,44,21,10,465,220,245,82,71,60,25,1
29936,439,177,262,78,73,40,21,537,272,265,75,83,41,29,1
29937,255,130,125,44,18,22,12,356,208,148,42,26,57,15,1
29938,474,274,200,59,36,86,31,149,68,81,15,38,11,10,1
29939,1241,697,544,169,156,125,39,721,379,342,89,73,68,25,1
29940,223,113,110,31,33,22,12,410,208,202,35,36,50,15,1
29941,824,414,410,106,107,91,45,501,240,261,80,62,49,42,1
29942,370,197,173,63,40,40,23,355,209,146,41,25,73,14,1
29943,447,179,268,81,49,35,29,493,230,263,73,47,47,13,1
29944,215,91,124,23,39,5,5,873,366,507,127,125,75,21,1
29945,372,189,183,60,44,41,18,1325,588,737,188,133,136,96,1
29946,85,44,41,9,6,10,9,138,69,69,28,7,10,10,1
29947,490,198,292,65,81,39,27,255,122,133,35,51,22,13,1
29948,671,303,368,93,68,61,26,134,60,74,19,13,10,7,1
29949,210,121,89,22,23,23,7,558,302,256,66,62,65,30,1
29950,1970,978,992,245,206,198,80,522,245,277,78,69,52,21,1
29951,316,161,155,46,50,39,16,437,225,212,61,57,66,12,1
29952,251,178,73,21,12,50,12,365,186,179,48,47,42,13,1
29953,380,195,185,37,47,61,19,153,65,88,27,14,18,9,1
29954,537,276,261,75,68,68,22,556,300,256,58,73,55,22,1
29955,312,180,132,36,22,32,21,246,108,138,32,44,21,10,1
29956,250,130,120,40,32,19,13,256,138,118,43,28,26,9,1
29957,425,210,215,56,43,52,25,466,186,280,71,84,30,11,1
29958,443,226,217,67,34,53,10,466,242,224,66,53,53,13,1
29959,973,527,446,110,137,122,34,245,111,134,31,44,20,11,1
29960,396,181,215,52,47,48,19,1140,586,554,130,146,117,49,1
29961,294,148,146,35,33,25,14,240,167,73,32,12,8,21,1
29962,1130,614,516,129,138,98,42,858,447,411,116,76,73,34,1
29963,427,218,209,61,53,45,26,198,102,96,27,20,21,12,1
29964,342,178,164,33,38,35,15,119,59,60,29,10,6,4,1
29965,261,130,131,27,41,19,16,292,152,140,46,38,35,12,1
29966,972,519,453,109,98,120,39,1333,646,687,209,179,148,45,1
29967,498,222,276,71,60,63,27,1124,578,546,149,127,122,61,1
29968,304,159,145,38,40,32,3,389,195,194,68,60,30,17,1
29969,1332,652,680,210,180,155,49,303,159,144,40,35,35,8,1
29970,424,209,215,56,58,45,24,529,264,265,59,68,41,17,1
29971,338,172,166,32,42,22,10,347,212,135,35,32,17,6,1
29972,822,392,430,125,104,79,24,788,360,428,93,106,67,72,1
29973,644,343,301,96,69,59,28,462,251,211,74,53,41,18,1
29974,2639,1436,1203,317,307,242,77,748,313,435,108,100,65,35,1
29975,102,61,41,15,13,8,2,573,316,257,78,80,21,21,1
29976,533,254,279,81,78,52,10,526,264,262,77,71,61,27,1
29977,583,322,261,73,66,45,26,822,416,406,111,105,84,44,1
29978,186,99,87,30,17,18,8,109,50,59,12,12,9,3,1
29979,323,156,167,52,45,39,18,719,364,355,104,100,58,34,1
29980,910,462,448,143,126,90,25,700,305,395,111,99,54,18,1
29981,377,212,165,56,37,34,21,374,227,147,44,22,54,20,1
29982,451,238,213,53,64,56,22,641,318,323,69,61,41,19,1
29983,707,386,321,85,83,99,28,742,303,439,88,96,86,23,1
29984,719,301,418,122,132,42,26,144,57,87,38,26,10,4,1
29985,416,201,215,54,52,39,25,277,122,155,33,33,25,24,1
29986,360,192,168,55,45,48,16,594,274,320,89,63,66,28,1
29987,1937,899,1038,336,332,181,86,2644,1346,1298,391,304,315,148,1
29988,484,254,230,60,66,56,14,605,283,322,94,72,64,39,1
29989,787,386,401,98,95,86,25,272,122,150,33,30,27,26,1
29990,2839,1413,1426,384,301,308,145,770,355,415,103,142,75,42,1
29991,351,184,167,59,45,54,9,283,159,124,41,21,39,17,1
29992,551,237,314,95,79,54,17,393,186,207,58,50,36,22,1
29993,428,248,180,44,39,28,9,143,79,64,16,25,7,5,1
29994,330,77,253,86,52,20,12,221,75,146,68,21,16,5,1
29995,957,346,611,205,175,61,29,1692,713,979,325,210,122,58,1
29996,686,375,311,89,80,63,20,609,318,291,80,72,55,36,1
29997,522,265,257,35,39,38,8,452,256,196,32,44,27,11,1
29998,691,241,450,151,139,24,20,854,399,455,127,118,57,39,1
29999,1009,506,503,146,141,97,55,1124,615,509,157,125,128,52,1
30000,394,202,192,44,43,38,28,449,240,209,59,55,63,20,1
30001,714,364,350,98,102,91,27,637,335,302,83,77,85,26,1
30002,480,257,223,74,26,60,27,331,169,162,40,28,22,14,1
30003,1570,771,799,241,181,137,41,505,275,230,63,57,35,12,1
30004,467,227,240,76,61,60,19,406,200,206,58,65,57,16,1
30005,432,218,214,57,55,42,11,295,179,116,31,28,28,16,1
30006,1308,652,656,166,153,149,87,304,159,145,38,40,32,3,1
30007,432,218,214,57,55,42,11,756,378,378,109,77,94,49,1
30008,674,383,291,80,68,60,20,128,58,70,22,14,4,7,1
30009,700,357,343,99,84,88,34,858,417,441,124,101,85,41,1
30010,616,296,320,69,76,49,48,568,243,325,98,73,56,44,1
30011,611,246,365,116,82,71,27,389,176,213,81,59,24,7,1
30012,96,50,46,8,15,6,2,369,167,202,66,59,39,20,1
30013,350,213,137,39,21,53,22,107,58,49,18,3,2,7,1
30014,864,429,435,129,118,68,35,253,148,105,31,15,39,16,1
30015,183,91,92,31,21,16,11,501,240,261,80,62,49,42,1
30016,246,124,122,33,31,25,14,603,311,292,102,71,66,23,1
30017,1562,742,820,219,231,104,46,1891,1066,825,207,184,181,83,1
30018,519,246,273,78,82,42,16,509,295,214,55,41,69,35,1
30019,371,237,134,31,25,43,17,87,50,37,16,7,10,5,1
30020,848,394,454,100,90,101,41,1464,693,771,153,136,91,86,1
30021,583,322,261,73,66,45,26,631,309,322,106,83,89,33,1
30022,761,346,415,114,113,89,35,487,229,258,68,82,41,24,1
30023,1577,747,830,213,232,147,57,864,429,435,129,118,68,35,1
30024,2063,1024,1039,175,117,80,97,447,222,225,71,54,44,25,1
30025,806,436,370,101,100,76,34,598,300,298,68,77,59,21,1
30026,433,221,212,59,42,47,14,862,409,453,149,125,86,29,1
30027,392,156,236,40,91,28,16,966,459,507,123,145,83,39,1
30028,1064,555,509,111,90,99,32,295,147,148,36,24,36,11,1
30029,622,299,323,86,86,69,35,676,319,357,83,86,62,46,1
30030,1356,672,684,171,172,134,59,211,112,99,30,15,34,18,1
30031,533,297,236,74,57,39,28,505,247,258,72,71,60,27,1
30032,619,332,287,95,77,74,38,1255,708,547,120,68,88,7,1
30033,193,105,88,22,25,22,9,193,102,91,23,25,20,10,1
30034,825,399,426,128,128,77,32,321,180,141,47,37,33,12,1
30035,185,115,70,19,17,26,6,218,108,110,28,28,22,10,1
30036,478,220,258,47,69,41,10,127,49,78,27,20,6,5,1
30037,577,241,336,112,109,47,21,532,276,256,57,50,32,19,1
30038,667,360,307,76,92,46,27,303,175,128,43,36,34,12,1
30039,1102,552,550,174,137,137,45,2556,1169,1387,248,291,227,275,1
30040,290,149,141,37,26,41,12,509,262,247,64,70,64,20,1
30041,469,221,248,49,60,55,21,441,216,225,57,66,57,19,1
30042,432,218,214,57,55,42,11,278,148,130,36,29,25,16,1
30043,427,164,263,62,80,14,10,473,256,217,66,47,64,20,1
30044,239,146,93,30,22,35,9,454,191,263,61,66,38,15,1
30045,487,223,264,81,68,63,15,355,168,187,55,48,40,15,1
30046,1382,599,783,208,252,90,39,560,228,332,113,58,79,38,1
30047,375,201,174,52,56,39,15,107,36,71,27,15,0,1,1
30048,309,157,152,37,36,26,16,500,256,244,70,70,57,26,1
30049,406,211,195,55,37,47,16,262,138,124,25,34,34,16,1
30050,467,226,241,55,48,54,23,670,333,337,95,79,62,21,1
30051,2799,1324,1475,369,371,215,124,479,239,240,54,75,46,18,1
30052,766,395,371,89,86,127,27,356,208,148,42,26,57,15,1
30053,514,226,288,71,66,63,32,482,231,251,76,81,64,26,1
30054,588,255,333,94,82,58,27,1133,491,642,192,170,61,29,1
30055,1822,879,943,236,227,175,97,1091,543,548,146,136,110,34,1
30056,4655,2074,2581,545,652,562,399,402,222,180,50,39,51,19,1
30057,567,279,288,75,77,54,25,205,100,105,25,25,20,9,1
30058,381,189,192,74,49,44,13,906,474,432,90,125,74,24,1
30059,173,106,67,11,10,35,5,1210,592,618,157,138,116,85,1
30060,848,394,454,100,90,101,41,423,222,201,51,33,41,28,1
30061,1047,562,485,141,127,114,41,976,520,456,120,115,109,53,1
30062,720,356,364,90,98,61,22,600,254,346,95,90,52,42,1
30063,113,47,66,14,15,11,17,780,369,411,130,113,79,35,1
30064,482,242,240,60,39,60,17,585,242,343,110,111,55,20,1
30065,843,379,464,107,99,95,65,1676,860,816,208,192,204,56,1
30066,519,244,275,76,90,44,16,1210,592,618,157,138,116,85,1
30067,223,132,91,18,16,27,17,794,390,404,103,95,86,23,1
30068,98,53,45,14,6,7,6,362,225,137,43,22,30,11,1
30069,360,192,168,55,45,48,16,592,291,301,92,93,71,31,1
30070,446,246,200,64,48,54,12,785,374,411,56,42,38,25,1
30071,825,427,398,79,95,81,48,592,291,301,92,93,71,31,1
30072,953,489,464,126,104,111,44,540,257,283,81,63,57,24,1
30073,269,156,113,37,32,17,7,2414,1189,1225,277,178,170,169,1
30074,798,287,511,126,125,77,26,1581,684,897,220,153,118,63,1
30075,235,135,100,30,13,25,11,366,183,183,48,47,36,17,1
30076,602,310,292,87,66,70,36,921,455,466,144,127,108,39,1
30077,189,90,99,26,29,17,11,784,373,411,101,90,91,37,1
30078,522,265,257,35,39,38,8,619,290,329,97,79,62,19,1
30079,439,199,240,66,64,49,30,477,256,221,69,66,70,12,1
30080,1970,978,992,245,206,198,80,915,336,579,185,199,56,29,1
30081,178,100,78,23,22,30,6,2639,1436,1203,317,307,242,77,1
30082,1863,721,1142,262,283,139,74,770,374,396,95,91,79,41,1
30083,1012,563,449,128,120,118,31,335,128,207,59,43,24,23,1
30084,458,222,236,69,39,35,18,272,122,150,33,30,27,26,1
30085,247,135,112,38,18,29,13,238,117,121,32,27,22,14,1
30086,646,298,348,91,110,63,33,615,356,259,90,56,97,19,1
30087,815,418,397,97,62,70,17,795,375,420,102,92,81,30,1
30088,1097,464,633,190,166,80,60,3144,1617,1527,367,342,278,136,1
30089,318,176,142,25,32,35,25,406,188,218,51,80,47,20,1
30090,350,200,150,45,47,23,8,1327,690,637,194,140,130,52,1
30091,681,348,333,100,63,53,27,191,99,92,25,24,18,8,1
30092,594,274,320,89,63,66,28,481,256,225,60,56,48,12,1
30093,595,316,279,86,60,65,40,299,158,141,45,31,21,5,1
30094,894,448,446,123,100,81,30,4563,2219,2344,620,531,527,104,1
30095,178,89,89,36,22,18,7,497,185,312,63,92,38,28,1
30096,1674,699,975,311,277,134,51,1052,492,560,184,163,103,44,1
30097,815,382,433,97,50,88,31,428,214,214,65,67,45,23,1
30098,476,227,249,52,59,38,17,1130,639,491,87,188,57,41,1
30099,2261,1217,1044,271,243,267,101,505,275,230,63,57,35,12,1
30100,593,266,327,102,84,69,24,738,339,399,102,88,68,35,1
30101,97,52,45,17,5,7,6,249,138,111,32,29,21,8,1
30102,1134,539,595,150,146,78,40,454,223,231,38,45,24,19,1
30103,686,345,341,93,81,69,30,430,192,238,62,67,27,10,1
30104,871,312,559,187,101,140,58,360,175,185,73,36,27,7,1
30105,1290,597,693,182,182,119,63,274,145,129,40,17,20,12,1
30106,1320,599,721,177,156,104,47,901,443,458,134,141,88,40,1
30107,795,395,400,94,87,80,42,1215,652,563,129,142,121,62,1
30108,165,85,80,29,25,16,13,402,227,175,48,40,35,11,1
30109,1225,593,632,158,125,102,38,1149,568,581,177,133,101,30,1
30110,1863,721,1142,262,283,139,74,552,285,267,74,51,69,24,1
30111,790,343,447,90,191,35,17,136,66,70,33,11,9,4,1
30112,606,279,327,81,70,49,34,418,201,217,53,39,56,15,1
30113,117,58,59,17,17,12,2,275,125,150,37,48,27,7,1
30114,506,254,252,57,82,41,17,307,150,157,44,23,30,13,1
30115,154,75,79,28,23,16,6,403,185,218,67,62,63,19,1
30116,1024,549,475,139,125,82,23,142,66,76,22,25,16,9,1
30117,462,233,229,66,49,43,30,454,255,199,51,45,54,27,1
30118,348,166,182,65,33,46,20,576,293,283,64,49,62,18,1
30119,883,470,413,112,99,108,34,2472,1055,1417,416,458,235,64,1
30120,837,444,393,128,89,87,37,3830,2000,1830,532,388,418,203,1
30121,367,217,150,51,30,24,12,375,202,173,46,49,41,23,1
30122,707,386,321,85,83,99,28,1464,987,477,137,141,55,31,1
30123,1032,426,606,172,172,80,35,504,256,248,78,70,36,9,1
30124,429,219,210,46,66,42,17,208,94,114,20,11,14,9,1
30125,447,225,222,76,35,75,21,1106,565,541,139,102,103,52,1
30126,1268,612,656,218,195,89,33,1270,682,588,165,147,136,54,1
30127,138,80,58,22,20,8,6,1117,423,694,182,134,88,31,1
30128,298,167,131,47,33,40,8,574,269,305,91,63,54,27,1
30129,591,263,328,95,90,26,13,552,264,288,82,64,48,20,1
30130,272,173,99,32,32,11,8,326,176,150,35,22,29,11,1
30131,399,161,238,90,80,44,14,1608,924,684,163,133,89,29,1
30132,551,237,314,95,79,54,17,606,279,327,81,70,49,34,1
30133,433,226,207,52,60,58,20,933,536,397,96,90,71,41,1
30134,238,91,147,68,19,22,7,780,304,476,160,173,66,23,1
30135,1506,722,784,216,177,116,54,1427,542,885,246,269,69,46,1
30136,593,321,272,64,84,33,20,437,228,209,47,61,26,11,1
30137,266,146,120,34,40,34,14,770,355,415,103,142,75,42,1
30138,446,265,181,51,35,27,17,1215,652,563,129,142,121,62,1
30139,834,465,369,82,84,81,21,400,188,212,80,47,30,17,1
30140,870,433,437,133,121,95,25,4655,2074,2581,545,652,562,399,1
30141,595,316,279,86,60,65,40,1210,592,618,157,138,116,85,1
30142,351,184,167,59,45,54,9,1076,563,513,129,114,90,37,1
30143,241,132,109,33,26,27,13,277,151,126,35,30,24,15,1
30144,1484,731,753,206,175,187,71,666,347,319,92,73,63,25,1
30145,470,256,214,56,39,47,34,536,237,299,116,87,42,17,1
30146,383,204,179,61,32,54,16,632,285,347,102,78,43,29,1
30147,535,249,286,79,64,55,22,112,59,53,12,17,14,8,1
30148,546,267,279,90,69,56,19,243,100,143,38,34,11,13,1
30149,671,318,353,83,124,46,34,389,176,213,81,59,24,7,1
30150,1308,646,662,157,133,173,54,837,399,438,112,144,71,32,1
30151,565,336,229,66,42,88,39,767,392,375,113,112,83,13,1
30152,624,329,295,97,83,75,34,528,268,260,81,77,36,22,1
30153,410,211,199,55,42,34,27,372,189,183,60,44,41,18,1
30154,502,286,216,56,50,66,32,770,355,415,103,142,75,42,1
30155,430,165,265,90,43,63,30,467,224,243,70,43,67,23,1
30156,246,115,131,15,29,10,32,272,131,141,36,26,36,16,1
30157,393,186,207,58,50,36,22,171,94,77,24,28,30,11,1
30158,247,110,137,34,45,23,10,672,334,338,110,93,91,41,1
30159,788,367,421,93,97,71,71,2477,1186,1291,256,271,249,90,1
30160,317,164,153,47,33,47,12,267,147,120,37,28,35,12,1
30161,271,131,140,47,37,41,11,526,268,258,54,37,55,12,1
30162,577,217,360,100,116,32,24,423,186,237,92,40,52,29,1
30163,1261,694,567,159,130,136,70,211,88,123,38,28,26,10,1
30164,309,106,203,66,49,25,10,524,295,229,69,58,36,12,1
30165,248,119,129,33,48,20,10,326,176,150,35,22,29,11,1
30166,400,203,197,30,36,31,10,204,104,100,26,27,21,11,1
30167,2063,1024,1039,175,117,80,97,462,233,229,66,49,43,30,1
30168,1332,637,695,214,178,117,40,2390,1131,1259,395,383,203,74,1
30169,777,345,432,128,88,65,39,168,67,101,37,17,13,13,1
30170,399,189,210,65,70,42,16,720,356,364,90,98,61,22,1
30171,208,96,112,31,32,13,9,859,395,464,157,119,59,31,1
30172,406,238,168,71,35,42,16,646,316,330,89,95,48,17,1
30173,480,256,224,67,55,26,22,501,265,236,89,52,45,16,1
30174,61,17,44,8,4,0,21,912,461,451,127,109,96,48,1
30175,371,123,248,104,70,26,15,235,149,86,30,21,17,5,1
30176,1914,892,1022,272,267,143,79,377,202,175,46,50,41,23,1
30177,1030,566,464,119,107,96,49,595,316,279,86,60,65,40,1
30178,1103,536,567,171,156,81,43,246,108,138,32,44,21,10,1
30179,211,92,119,33,44,11,7,551,298,253,63,65,45,19,1
30180,198,112,86,20,36,16,5,461,227,234,61,47,54,33,1
30181,374,191,183,40,52,40,16,411,209,202,69,43,18,15,1
30182,402,222,180,50,39,51,19,810,367,443,115,92,94,59,1
30183,393,223,170,44,36,32,14,2414,1189,1225,277,178,170,169,1
30184,870,489,381,97,99,76,14,303,159,144,40,35,35,8,1
30185,246,115,131,15,29,10,32,696,268,428,172,81,125,54,1
30186,758,348,410,114,141,79,20,729,266,463,185,136,34,8,1
30187,229,105,124,36,33,12,4,758,362,396,115,102,35,13,1
30188,1116,539,577,149,161,115,43,854,380,474,137,159,81,31,1
30189,385,212,173,57,40,39,21,366,204,162,47,41,31,23,1
30190,845,412,433,146,103,112,18,217,109,108,34,32,35,7,1
30191,313,160,153,51,33,43,23,386,189,197,54,57,39,16,1
30192,1098,519,579,182,159,79,42,654,317,337,95,111,44,13,1
30193,684,288,396,107,90,54,42,824,392,432,106,89,88,32,1
30194,605,295,310,74,66,70,36,403,185,218,67,62,63,19,1
30195,282,165,117,26,34,37,11,375,202,173,46,49,41,23,1
30196,572,353,219,70,42,57,25,517,249,268,65,59,58,26,1
30197,270,137,133,30,28,27,11,904,436,468,138,146,82,39,1
30198,409,268,141,32,26,57,25,91,54,37,8,3,7,4,1
30199,326,167,159,46,31,38,13,895,479,416,96,119,92,56,1
30200,398,216,182,52,33,40,15,622,299,323,86,86,69,35,1
30201,466,186,280,71,84,30,11,462,224,238,77,75,37,13,1
30202,755,390,365,103,84,85,34,748,355,393,121,91,95,26,1
30203,660,332,328,84,73,47,19,1893,764,1129,308,323,126,60,1
30204,898,467,431,101,127,90,53,2090,1085,1005,167,141,168,40,1
30205,467,226,241,55,48,54,23,462,251,211,74,53,41,18,1
30206,1692,713,979,325,210,122,58,288,118,170,50,57,18,15,1
30207,162,73,89,32,19,4,4,131,66,65,21,14,23,7,1
30208,356,142,214,55,47,29,16,281,128,153,47,43,22,14,1
30209,618,290,328,82,74,69,42,277,124,153,44,40,35,18,1
30210,651,331,320,93,93,51,28,171,94,77,24,28,30,11,1
30211,466,242,224,66,53,53,13,245,111,134,36,27,18,6,1
30212,2517,1275,1242,304,324,245,135,165,95,70,18,23,19,11,1
30213,423,206,217,64,60,35,13,1089,544,545,138,160,117,43,1
30214,1337,667,670,137,143,140,35,1106,579,527,121,152,113,45,1
30215,912,461,451,127,109,96,48,991,537,454,134,99,80,34,1
30216,676,333,343,111,89,94,39,445,255,190,57,53,56,28,1
30217,215,86,129,34,37,18,15,448,223,225,50,58,39,34,1
30218,885,424,461,143,114,92,32,276,143,133,34,38,20,15,1
30219,725,365,360,104,111,70,31,703,356,347,96,97,38,22,1
30220,509,341,168,35,32,52,15,381,191,190,55,61,33,11,1
30221,132,69,63,16,14,6,15,325,196,129,35,17,48,33,1
30222,103,49,54,21,21,10,2,537,288,249,60,60,61,19,1
30223,339,177,162,40,36,51,24,252,125,127,33,25,26,19,1
30224,837,399,438,112,144,71,32,2339,1260,1079,336,252,279,106,1
30225,947,482,465,143,107,89,37,606,279,327,81,70,49,34,1
30226,454,223,231,38,45,24,19,245,111,134,31,44,20,11,1
30227,424,198,226,57,46,41,19,79,38,41,19,11,15,4,1
30228,545,289,256,75,72,42,22,1243,633,610,149,160,87,39,1
30229,530,259,271,83,50,54,41,785,374,411,56,42,38,25,1
30230,1064,555,509,111,90,99,32,1368,742,626,179,129,189,73,1
30231,697,373,324,105,83,95,38,217,98,119,33,32,27,7,1
30232,1881,929,952,259,247,158,57,1259,705,554,174,158,123,34,1
30233,673,317,356,101,85,76,49,297,158,139,47,37,37,9,1
30234,594,305,289,86,63,51,21,1210,592,618,157,138,116,85,1
30235,1475,658,817,149,114,120,43,626,272,354,96,80,71,36,1
30236,783,429,354,100,77,54,25,189,90,99,26,29,17,11,1
30237,374,201,173,51,34,53,24,246,108,138,32,44,21,10,1
30238,418,204,214,68,66,38,12,295,158,137,42,34,38,14,1
30239,350,180,170,64,46,55,12,225,113,112,29,45,19,7,1
30240,380,187,193,38,51,30,18,391,208,183,65,49,57,17,1
30241,391,201,190,52,47,35,24,482,231,251,76,81,64,26,1
30242,669,406,263,69,68,64,27,2524,1232,1292,398,317,186,61,1
30243,284,167,117,35,25,28,8,2442,1193,1249,278,183,170,145,1
30244,575,217,358,134,59,90,41,467,224,243,70,43,67,23,1
30245,2031,983,1048,294,257,230,93,214,109,105,31,26,25,17,1
30246,1290,629,661,191,187,167,55,631,309,322,106,83,89,33,1
30247,165,83,82,16,29,11,9,360,188,172,49,48,47,17,1
30248,204,99,105,32,32,22,10,435,208,227,68,64,53,23,1
30249,998,496,502,149,146,89,27,454,191,263,61,66,38,15,1
30250,316,161,155,46,50,39,16,327,177,150,40,40,38,18,1
30251,345,203,142,47,35,31,11,529,264,265,59,68,41,17,1
30252,431,235,196,64,33,48,20,480,252,228,55,37,49,20,1
30253,628,341,287,77,59,55,31,552,285,267,74,51,69,24,1
30254,1906,909,997,280,193,135,72,267,127,140,43,43,25,15,1
30255,451,209,242,73,53,47,36,426,200,226,75,56,39,24,1
30256,407,230,177,53,42,34,20,826,362,464,107,118,71,43,1
30257,484,182,302,124,66,20,8,475,235,240,77,58,43,22,1
30258,341,154,187,34,36,11,11,508,267,241,43,35,25,17,1
30259,668,347,321,89,50,60,41,318,176,142,25,32,35,25,1
30260,340,172,168,60,50,36,10,558,302,256,66,62,65,30,1
30261,719,343,376,108,78,92,29,211,114,97,32,24,19,10,1
30262,539,306,233,69,57,53,23,728,388,340,103,87,64,34,1
30263,848,394,454,100,90,101,41,249,114,135,47,33,25,4,1
30264,107,58,49,17,4,2,6,350,213,137,39,21,53,22,1
30265,343,163,180,50,47,44,15,601,313,288,42,48,25,36,1
30266,246,108,138,32,44,21,10,573,247,326,98,95,46,22,1
30267,508,267,241,43,35,25,17,416,210,206,55,54,39,20,1
30268,303,175,128,43,36,34,12,425,210,215,56,43,52,25,1
30269,183,95,88,27,22,26,5,503,263,240,72,55,51,34,1
30270,770,385,385,78,83,60,16,450,241,209,67,58,54,23,1
30271,209,129,80,18,13,20,12,456,247,209,68,46,42,14,1
30272,553,261,292,73,79,40,26,258,131,127,37,32,20,14,1
30273,126,56,70,31,10,10,3,1017,498,519,136,107,82,52,1
30274,525,299,226,54,54,51,19,467,226,241,55,48,54,23,1
30275,251,122,129,39,39,25,7,377,202,175,46,50,41,23,1
30276,714,364,350,98,102,91,27,307,150,157,44,23,30,13,1
30277,379,203,176,55,48,45,16,467,226,241,55,48,54,23,1
30278,368,154,214,80,52,41,16,411,202,209,60,67,57,24,1
30279,291,129,162,44,30,35,23,329,148,181,44,38,36,21,1
30280,330,190,140,42,21,30,13,309,154,155,42,44,45,16,1
30281,344,190,154,34,31,36,10,744,385,359,125,89,90,23,1
30282,253,133,120,44,31,22,8,393,186,207,58,50,36,22,1
30283,475,235,240,77,58,43,22,240,99,141,53,38,29,15,1
30284,360,192,168,55,45,48,16,815,478,337,104,80,103,27,1
30285,824,403,421,80,150,65,35,4655,2074,2581,545,652,562,399,1
30286,339,177,162,40,36,51,24,97,50,47,17,14,14,10,1
30287,207,107,100,27,25,20,11,1621,750,871,276,243,162,51,1
30288,760,391,369,101,109,65,24,431,235,196,57,53,50,18,1
30289,532,267,265,86,55,64,22,1114,581,533,145,132,126,54,1
30290,379,203,176,55,48,45,16,1216,552,664,194,189,110,49,1
30291,1163,493,670,214,158,106,42,315,150,165,52,36,22,15,1
30292,609,292,317,102,96,64,21,254,136,118,42,36,28,8,1
30293,434,221,213,58,47,54,15,202,102,100,29,35,6,9,1
30294,326,151,175,50,39,36,17,1114,581,533,145,132,126,54,1
30295,181,96,85,26,23,18,7,1190,638,552,162,95,112,18,1
30296,573,247,326,98,95,46,22,250,105,145,39,27,22,40,1
30297,257,148,109,28,20,21,14,461,223,238,66,57,36,23,1
30298,393,186,207,58,50,36,22,785,374,411,56,42,38,25,1
30299,533,254,279,81,78,52,10,456,209,247,72,58,40,9,1
30300,84,61,23,9,2,13,2,484,259,225,69,44,60,21,1
30301,1255,708,547,120,68,88,7,2843,1104,1739,429,357,178,95,1
30302,1012,411,601,177,174,75,32,1117,423,694,182,134,88,31,1
30303,853,401,452,121,118,74,38,377,177,200,63,53,44,16,1
30304,154,75,79,17,24,16,13,868,448,420,108,103,76,25,1
30305,1424,650,774,152,124,95,87,462,233,229,66,49,43,30,1
30306,632,350,282,82,58,111,42,3144,1617,1527,367,342,278,136,1
30307,566,263,303,83,87,74,31,164,78,86,28,23,12,8,1
30308,204,104,100,26,27,21,11,254,107,147,42,37,24,10,1
30309,211,83,128,28,35,5,11,116,67,49,13,12,6,5,1
30310,912,460,452,139,132,89,53,412,193,219,70,56,51,26,1
30311,309,164,145,35,47,30,11,395,198,197,55,55,36,10,1
30312,590,279,311,103,83,69,30,407,240,167,38,29,67,26,1
30313,2644,1346,1298,391,304,315,148,934,472,462,119,122,87,39,1
30314,1116,413,703,214,213,53,41,247,110,137,34,45,23,10,1
30315,98,42,56,6,6,5,20,201,42,159,19,3,2,75,1
30316,620,307,313,92,91,92,33,467,226,241,55,48,54,23,1
30317,327,160,167,56,31,36,15,605,231,374,102,109,27,34,1
30318,1037,534,503,127,148,121,48,587,300,287,67,102,34,20,1
30319,389,210,179,51,37,43,9,527,263,264,81,63,72,31,1
30320,158,85,73,24,18,18,8,815,382,433,97,50,88,31,1
30321,1074,538,536,154,140,111,51,1048,564,484,118,122,113,40,1
30322,4377,1898,2479,663,608,331,126,268,130,138,41,29,31,17,1
30323,616,296,320,69,76,49,48,317,164,153,47,33,47,12,1
30324,278,137,141,47,32,28,20,425,210,215,56,43,52,25,1
30325,503,259,244,73,53,52,28,592,264,328,86,85,62,41,1
30326,184,78,106,21,25,25,12,632,326,306,92,71,56,19,1
30327,425,177,248,60,62,33,16,501,240,261,80,62,49,42,1
30328,619,292,327,73,73,61,32,429,187,242,79,72,28,19,1
30329,391,208,183,65,49,57,17,431,186,245,79,83,37,18,1
30330,1663,835,828,224,213,163,63,2489,1251,1238,288,234,283,178,1
30331,432,188,244,76,81,26,13,246,124,122,31,28,25,5,1
30332,1290,629,661,191,187,167,55,583,322,261,73,66,45,26,1
30333,587,303,284,84,90,63,23,724,325,399,98,92,64,24,1
30334,295,145,150,41,45,36,18,381,189,192,74,49,44,13,1
30335,405,205,200,59,55,39,9,466,247,219,51,32,49,26,1
30336,480,271,209,69,55,64,27,920,492,428,100,92,88,49,1
30337,1363,690,673,185,172,152,62,593,266,327,102,84,69,24,1
30338,333,192,141,50,48,28,10,851,446,405,93,94,92,37,1
30339,672,334,338,110,93,91,41,1243,650,593,158,159,98,55,1
30340,1215,572,643,151,105,127,54,783,266,517,204,79,127,53,1
30341,830,402,428,80,67,100,80,586,254,332,114,111,55,17,1
30342,235,119,116,31,26,15,13,1887,1054,833,205,169,189,50,1
30343,221,110,111,28,32,25,11,140,86,54,17,6,20,7,1
30344,515,259,256,79,58,46,21,331,169,162,40,28,22,14,1
30345,286,130,156,42,43,38,7,375,202,173,46,49,41,23,1
30346,648,307,341,101,58,76,34,537,276,261,75,68,68,22,1
30347,358,204,154,57,41,36,14,520,261,259,82,76,71,24,1
30348,154,75,79,17,24,16,13,789,319,470,129,139,81,35,1
30349,317,153,164,34,52,30,14,734,366,368,121,99,63,39,1
30350,498,174,324,112,108,33,19,202,102,100,29,35,6,9,1
30351,247,110,137,34,45,23,10,246,108,138,32,44,21,10,1
30352,438,216,222,53,49,58,34,640,315,325,77,55,67,33,1
30353,481,269,212,54,35,54,25,359,174,185,54,56,43,16,1
30354,700,348,352,93,115,85,27,268,157,111,26,30,28,13,1
30355,1382,689,693,186,176,167,77,787,386,401,98,95,86,25,1
30356,676,333,343,111,89,94,39,245,112,133,32,45,20,10,1
30357,583,279,304,99,71,59,31,633,303,330,95,91,51,13,1
30358,587,300,287,67,102,34,20,216,119,97,33,27,28,7,1
30359,425,258,167,50,27,56,24,472,263,209,57,39,60,29,1
30360,963,455,508,127,130,115,48,475,223,252,72,66,51,26,1
30361,1278,593,685,198,201,71,43,334,171,163,48,42,32,18,1
30362,1419,759,660,198,135,147,51,799,377,422,98,95,80,70,1
30363,218,115,103,32,32,34,11,769,329,440,116,66,55,22,1
30364,348,226,122,23,20,59,25,689,343,346,119,100,86,38,1
30365,468,215,253,65,60,34,13,198,80,118,35,31,14,7,1
30366,920,492,428,100,92,88,49,471,221,250,87,68,42,25,1
30367,1836,1051,785,185,221,239,110,538,286,252,80,58,48,14,1
30368,560,254,306,78,67,75,47,1669,1162,507,154,128,86,51,1
30369,788,381,407,77,41,46,35,425,210,215,56,43,52,25,1
30370,359,163,196,47,78,47,9,512,261,251,79,73,60,21,1
30371,207,97,110,34,27,22,10,445,225,220,47,62,53,26,1
30372,509,262,247,64,70,64,20,230,115,115,29,29,22,14,1
30373,674,319,355,84,139,50,11,345,141,204,64,58,13,11,1
30374,1183,595,588,182,136,76,24,870,489,381,97,99,76,14,1
30375,433,229,204,60,59,53,24,233,111,122,38,27,17,8,1
30376,371,230,141,42,21,41,21,1037,575,462,122,150,82,32,1
30377,1865,918,947,300,256,217,76,191,98,93,26,18,19,9,1
30378,249,90,159,29,89,12,4,370,177,193,51,61,32,4,1
30379,854,380,474,137,159,81,31,770,374,396,95,91,79,41,1
30380,766,386,380,101,81,78,31,246,113,133,33,45,22,10,1
30381,344,183,161,45,26,33,16,601,313,288,42,48,25,36,1
30382,290,138,152,37,50,24,14,632,326,306,92,71,56,19,1
30383,202,86,116,33,29,26,10,350,169,181,52,54,42,20,1
30384,1071,549,522,133,127,130,59,531,250,281,72,61,68,31,1
30385,320,163,157,44,44,26,15,149,68,81,15,38,11,10,1
30386,395,162,233,63,78,35,15,588,255,333,94,82,58,27,1
30387,202,102,100,29,35,6,9,456,191,265,82,55,45,11,1
30388,2442,1193,1249,278,183,170,145,463,236,227,64,50,44,29,1
30389,796,445,351,96,80,90,38,955,465,490,137,138,119,28,1
30390,502,240,262,78,61,54,32,408,197,211,74,44,53,16,1
30391,205,114,91,25,24,20,15,372,179,193,50,52,33,6,1
30392,246,115,131,15,29,10,32,436,165,271,110,40,67,32,1
30393,158,83,75,22,14,17,9,242,104,138,41,33,37,8,1
30394,739,471,268,55,70,34,9,215,80,135,54,56,21,9,1
30395,334,171,163,48,42,32,18,365,188,177,60,47,48,16,1
30396,2541,1299,1242,306,302,121,98,788,360,428,93,106,67,72,1
30397,672,334,338,110,93,91,41,374,181,193,63,49,46,20,1
30398,501,240,261,80,62,49,42,601,313,288,42,48,25,36,1
30399,602,310,292,87,66,70,36,432,181,251,48,75,27,17,1
30400,593,266,327,102,84,69,24,527,273,254,81,61,81,14,1
30401,499,217,282,76,83,29,6,1336,828,508,166,121,152,48,1
30402,352,189,163,42,31,33,19,509,254,255,67,55,52,35,1
30403,572,307,265,70,55,44,17,341,190,151,50,41,23,15,1
30404,998,514,484,120,122,113,57,238,138,100,31,15,38,11,1
30405,360,192,168,55,45,48,16,676,333,343,111,89,94,39,1
30406,864,429,435,129,118,68,35,456,247,209,68,46,42,14,1
30407,376,199,177,63,46,33,8,592,291,301,92,93,71,31,1
30408,417,182,235,57,109,50,8,4544,2024,2520,579,628,480,403,1
30409,1512,737,775,238,209,156,57,660,333,327,102,95,69,31,1
30410,1328,648,680,220,151,112,40,798,287,511,126,125,77,26,1
30411,591,286,305,80,74,68,17,779,370,409,111,105,73,37,1
30412,135,69,66,21,14,11,5,1395,627,768,172,263,141,59,1
30413,366,190,176,39,62,55,14,136,66,70,33,11,9,4,1
30414,388,199,189,50,51,33,14,391,208,183,65,49,57,17,1
30415,589,281,308,69,39,63,20,331,169,162,40,28,22,14,1
30416,859,438,421,142,80,105,43,1922,923,999,267,275,215,90,1
30417,264,126,138,44,26,25,10,920,492,428,100,92,88,49,1
30418,318,156,162,42,29,26,17,387,217,170,49,47,44,14,1
30419,269,134,135,42,35,27,13,337,177,160,40,43,45,19,1
30420,172,74,98,32,30,11,7,351,143,208,44,68,23,18,1
30421,487,223,264,81,68,63,15,354,166,188,53,55,40,19,1
30422,512,269,243,69,70,62,29,431,219,212,68,46,67,18,1
30423,885,424,461,143,114,92,32,958,451,507,165,135,97,41,1
30424,144,62,82,29,8,19,17,359,184,175,49,35,32,11,1
30425,154,66,88,26,13,12,10,363,181,182,51,42,57,18,1
30426,497,185,312,63,92,38,28,985,551,434,123,93,91,26,1
30427,515,274,241,85,42,77,23,815,382,433,97,50,88,31,1
30428,900,484,416,119,110,77,29,1084,537,547,154,121,92,35,1
30429,2045,985,1060,359,339,199,74,642,325,317,74,78,73,43,1
30430,197,95,102,31,23,18,12,404,190,214,55,55,35,27,1
30431,620,299,321,75,60,68,30,216,119,97,33,27,28,7,1
30432,245,112,133,32,45,20,10,246,108,138,39,46,27,10,1
30433,799,377,422,98,95,80,70,1106,499,607,161,139,95,39,1
30434,145,75,70,19,17,18,10,627,314,313,61,59,71,22,1
30435,926,435,491,133,132,85,17,894,420,474,136,146,93,39,1
30436,794,390,404,103,95,86,23,638,305,333,68,90,70,29,1
30437,656,358,298,67,47,64,26,299,110,189,54,75,17,4,1
30438,797,395,402,107,117,77,22,149,68,81,15,38,11,10,1
30439,841,356,485,173,116,27,14,327,177,150,40,40,38,18,1
30440,1634,828,806,236,195,195,67,864,510,354,89,81,76,42,1
30441,163,70,93,28,21,17,6,433,237,196,60,52,33,27,1
30442,187,107,80,30,16,22,7,432,218,214,57,55,42,11,1
30443,272,122,150,33,30,27,26,770,374,396,95,91,79,41,1
30444,380,222,158,36,29,59,28,77,45,32,14,3,6,5,1
30445,665,304,361,90,72,63,28,360,188,172,49,48,47,17,1
30446,248,119,129,33,48,20,10,694,260,434,122,92,62,36,1
30447,209,125,84,20,22,22,6,780,369,411,130,113,79,35,1
30448,576,250,326,93,71,34,15,267,127,140,43,42,24,9,1
30449,693,297,396,87,52,64,27,522,235,287,78,67,60,50,1
30450,1290,597,693,182,182,119,63,226,90,136,43,43,26,7,1
30451,95,44,51,14,13,7,4,641,324,317,88,92,49,14,1
30452,609,318,291,80,72,55,36,377,202,175,46,50,41,23,1
30453,677,245,432,129,155,72,11,764,277,487,158,162,64,31,1
30454,4289,2228,2061,511,563,380,175,412,195,217,79,48,36,29,1
30455,428,226,202,52,60,75,20,1257,464,793,221,264,75,37,1
30456,162,73,89,32,19,4,4,605,263,342,73,103,54,18,1
30457,415,189,226,69,54,50,21,1154,540,614,195,160,138,66,1
30458,999,504,495,95,119,78,42,797,406,391,121,86,64,15,1
30459,229,105,124,36,33,12,4,524,237,287,87,75,54,26,1
30460,3661,1791,1870,463,425,340,151,596,286,310,90,89,78,37,1
30461,411,171,240,61,81,30,15,536,278,258,72,63,62,20,1
30462,651,306,345,85,64,61,32,684,288,396,107,90,54,42,1
30463,1354,537,817,245,247,117,57,432,188,244,76,81,26,13,1
30464,346,191,155,52,38,40,13,350,178,172,49,62,29,16,1
30465,537,276,261,75,68,68,22,158,71,87,23,21,17,12,1
30466,1573,791,782,198,173,148,46,292,152,140,46,38,35,12,1
30467,2109,999,1110,332,294,187,89,1087,523,564,146,177,103,33,1
30468,845,402,443,137,126,105,47,191,98,93,26,18,19,9,1
30469,347,212,135,35,32,17,6,379,203,176,55,48,45,16,1
30470,335,185,150,46,34,36,13,666,347,319,92,73,63,25,1
30471,350,224,126,34,14,48,18,340,163,177,39,38,37,23,1
30472,321,187,134,59,29,32,8,947,482,465,143,107,89,37,1
30473,688,330,358,122,97,92,39,391,223,168,35,26,47,31,1
30474,681,348,333,100,63,53,27,595,316,279,86,60,65,40,1
30475,784,393,391,117,102,65,35,467,224,243,70,43,67,23,1
30476,1374,679,695,191,193,154,48,557,240,317,97,74,68,37,1
30477,191,72,119,40,41,17,8,609,292,317,102,96,64,21,1
30478,228,114,114,37,34,29,3,674,319,355,84,139,50,11,1
30479,437,225,212,61,57,66,12,446,227,219,58,52,45,26,1
30480,475,268,207,61,27,56,30,2725,1490,1235,339,333,254,78,1
30481,911,551,360,92,106,107,29,173,110,63,35,6,9,8,1
30482,1042,570,472,113,125,91,61,1242,613,629,174,113,114,53,1
30483,396,150,246,103,64,38,3,467,226,241,55,48,54,23,1
30484,225,129,96,32,33,20,8,191,98,93,26,18,19,9,1
30485,509,254,255,67,55,52,35,1430,614,816,229,197,128,71,1
30486,246,108,138,39,46,27,10,299,164,135,30,21,29,10,1
30487,1037,461,576,146,163,75,44,248,129,119,26,46,21,6,1
30488,854,380,474,137,159,81,31,537,276,261,75,68,68,22,1
30489,244,116,128,47,19,26,9,802,449,353,102,87,82,29,1
30490,382,190,192,59,48,40,21,725,339,386,112,122,93,32,1
30491,906,460,446,117,131,108,33,587,310,277,80,64,84,26,1
30492,205,106,99,28,26,23,3,205,96,109,32,25,31,5,1
30493,2696,1169,1527,432,347,193,146,462,228,234,59,47,37,32,1
30494,288,104,184,80,30,39,6,496,209,287,113,55,72,14,1
30495,4303,2489,1814,436,369,444,134,906,437,469,135,132,49,40,1
30496,465,230,235,73,64,56,15,454,191,263,61,66,38,15,1
30497,651,306,345,85,64,61,32,783,348,435,150,109,62,21,1
30498,957,346,611,205,175,61,29,1257,525,732,216,210,79,52,1
30499,246,115,131,15,29,10,32,224,108,116,31,32,22,8,1
30500,418,199,219,55,44,22,15,303,159,144,40,35,35,8,1
30501,326,154,172,45,39,20,10,347,212,135,35,32,17,6,1
30502,476,263,213,56,44,50,16,1179,579,600,140,133,122,53,1
30503,1441,657,784,140,135,81,73,461,257,204,63,49,50,29,1
30504,391,203,188,49,48,41,14,859,395,464,157,119,59,31,1
30505,1367,690,677,172,175,154,83,1132,553,579,172,143,150,57,1
30506,471,255,216,66,68,81,16,109,50,59,20,7,10,9,1
30507,392,205,187,43,33,52,18,294,148,146,35,33,25,14,1
30508,360,192,168,55,45,48,16,461,257,204,63,49,50,29,1
30509,399,208,191,48,57,53,17,374,174,200,54,52,42,21,1
30510,859,398,461,96,109,89,57,498,224,274,69,49,45,16,1
30511,1251,591,660,183,137,106,50,715,324,391,107,92,71,31,1
30512,1068,494,574,176,155,81,27,248,129,119,26,46,21,6,1
30513,461,207,254,82,66,55,33,1581,684,897,220,153,118,63,1
30514,858,431,427,94,57,54,30,330,143,187,63,29,52,20,1
30515,470,289,181,58,47,45,25,512,261,251,79,73,60,21,1
30516,76,31,45,8,14,3,1,398,203,195,69,51,65,11,1
30517,689,484,205,73,55,18,15,671,318,353,83,124,46,34,1
30518,982,494,488,150,117,91,45,583,322,261,73,66,45,26,1
30519,789,389,400,121,80,92,40,451,225,226,68,57,65,22,1
30520,351,184,167,59,45,54,9,780,337,443,112,116,77,28,1
30521,101,41,60,18,19,10,5,393,186,207,58,50,36,22,1
30522,743,366,377,41,37,26,14,631,315,316,64,57,49,15,1
30523,248,119,129,33,48,20,10,778,367,411,90,85,64,43,1
30524,968,452,516,150,144,79,28,1497,881,616,151,117,94,40,1
30525,327,177,150,40,40,38,18,393,186,207,58,50,36,22,1
30526,141,68,73,25,20,12,6,2440,1061,1379,377,326,172,62,1
30527,194,94,100,35,19,25,16,4391,2256,2135,494,411,423,231,1
30528,440,246,194,62,49,41,16,832,428,404,131,89,88,38,1
30529,947,482,465,143,107,89,37,671,321,350,95,87,75,34,1
30530,331,144,187,61,76,44,5,815,418,397,97,62,70,17,1
30531,261,143,118,33,24,32,16,423,220,203,51,54,46,17,1
30532,211,88,123,38,28,26,10,284,146,138,48,31,43,11,1
30533,3685,1574,2111,579,580,303,116,483,215,268,66,70,30,16,1
30534,147,81,66,18,18,18,4,1332,659,673,174,170,153,55,1
30535,241,106,135,48,29,17,15,1170,510,660,142,182,115,84,1
30536,346,186,160,50,33,27,12,622,331,291,69,74,45,21,1
30537,248,119,129,33,48,20,10,297,158,139,47,37,37,9,1
30538,781,418,363,92,90,64,41,814,450,364,91,114,69,12,1
30539,446,246,200,64,48,54,12,706,300,406,94,74,61,22,1
30540,625,286,339,92,59,83,42,406,211,195,55,37,47,16,1
30541,368,158,210,64,61,39,14,140,86,54,17,6,20,7,1
30542,142,80,62,24,12,21,4,403,185,218,67,62,63,19,1
30543,456,232,224,69,65,30,19,781,418,363,92,90,64,41,1
30544,1074,538,536,154,140,111,51,1461,741,720,176,155,140,45,1
30545,418,248,170,41,31,54,9,424,255,169,38,26,27,14,1
30546,386,181,205,55,51,57,31,184,88,96,39,27,22,5,1
30547,298,140,158,51,33,21,22,1442,606,836,212,158,111,47,1
30548,504,259,245,73,56,45,29,139,62,77,23,6,14,4,1
30549,378,154,224,74,84,35,22,419,175,244,71,73,23,23,1
30550,411,171,240,61,81,30,15,579,321,258,74,70,47,22,1
30551,181,75,106,35,26,11,9,393,186,207,58,50,36,22,1
30552,847,402,445,137,119,102,41,217,109,108,34,32,35,7,1
30553,138,80,58,22,20,8,6,1332,659,673,174,170,153,55,1
30554,109,57,52,19,7,8,8,362,225,137,43,22,30,11,1
30555,201,102,99,25,26,19,7,1516,764,752,179,155,126,55,1
30556,139,75,64,17,17,23,9,375,202,173,46,49,41,23,1
30557,1093,407,686,158,205,49,31,920,492,428,100,92,88,49,1
30558,627,302,325,101,91,43,13,557,278,279,75,70,66,31,1
30559,295,140,155,44,37,26,27,351,159,192,58,35,35,31,1
30560,476,190,286,116,95,33,11,1129,589,540,134,122,108,46,1
30561,171,85,86,23,16,20,10,361,184,177,50,53,51,22,1
30562,918,427,491,113,111,113,33,845,402,443,137,126,105,47,1
30563,732,355,377,108,109,79,27,577,251,326,92,84,60,11,1
30564,128,67,61,19,13,15,4,537,276,261,75,68,68,22,1
30565,355,214,141,43,29,63,13,152,98,54,13,10,21,9,1
30566,871,482,389,113,95,109,35,536,278,258,72,63,62,20,1
30567,374,187,187,51,52,40,27,1013,457,556,124,157,81,26,1
30568,436,235,201,62,45,56,17,525,274,251,82,74,60,25,1
30569,624,308,316,92,72,68,22,1304,585,719,179,169,154,47,1
30570,330,143,187,63,29,52,20,1154,405,749,164,255,63,65,1
30571,394,202,192,44,43,38,28,1023,561,462,117,125,96,48,1
30572,361,174,187,63,56,38,16,288,118,170,50,57,18,15,1
30573,350,213,137,39,21,53,22,355,165,190,53,56,42,19,1
30574,938,484,454,137,100,104,41,781,367,414,60,67,43,17,1
30575,3418,1378,2040,515,464,318,121,536,287,249,64,73,21,27,1
30576,3685,1574,2111,579,580,303,116,895,474,421,122,93,69,25,1
30577,101,38,63,23,8,9,10,926,435,491,133,132,85,17,1
30578,150,74,76,21,22,18,7,183,96,87,20,28,17,10,1
30579,1117,423,694,182,134,88,31,838,385,453,110,137,78,28,1
30580,473,230,243,80,56,52,35,462,233,229,66,49,43,30,1
30581,427,218,209,61,53,45,26,525,274,251,82,74,60,25,1
30582,673,329,344,111,95,92,41,586,240,346,94,110,29,19,1
30583,143,65,78,32,11,11,11,4544,2024,2520,579,628,480,403,1
30584,200,106,94,24,26,18,6,969,505,464,123,133,92,33,1
30585,557,306,251,66,42,52,15,341,190,151,50,41,23,15,1
30586,338,188,150,45,41,31,18,757,359,398,109,127,80,26,1
30587,360,192,168,55,45,48,16,770,374,396,95,91,79,41,1
30588,497,185,312,63,92,38,28,882,432,450,115,111,68,44,1
30589,225,116,109,29,19,25,6,1132,553,579,172,143,150,57,1
30590,1132,438,694,209,149,89,40,785,374,411,56,42,38,25,1
30591,412,195,217,79,48,36,29,480,234,246,79,77,65,23,1
30592,330,77,253,86,52,20,12,240,99,141,53,38,29,15,1
30593,520,261,259,82,76,71,24,256,134,122,29,42,14,7,1
30594,324,154,170,57,40,26,4,425,210,215,56,43,52,25,1
30595,466,186,280,71,84,30,11,408,179,229,86,72,32,5,1
30596,1455,760,695,205,191,124,40,1007,523,484,116,113,117,43,1
30597,628,341,287,77,59,55,31,422,207,215,79,38,53,23,1
30598,299,153,146,32,28,29,12,1356,576,780,229,198,107,38,1
30599,288,159,129,27,44,27,15,176,85,91,24,23,24,7,1
30600,540,257,283,81,63,57,24,522,235,287,78,67,60,50,1
30601,309,154,155,42,44,45,16,758,362,396,115,102,35,13,1
30602,393,186,207,58,50,36,22,541,279,262,79,82,31,32,1
30603,771,321,450,151,135,43,15,1336,724,612,209,141,133,60,1
30604,509,254,255,67,55,52,35,843,404,439,107,112,93,34,1
30605,430,192,238,62,67,27,10,451,222,229,58,55,51,17,1
30606,763,343,420,127,70,105,34,255,122,133,35,51,22,13,1
30607,420,224,196,66,48,46,16,480,234,246,79,77,65,23,1
30608,503,263,240,72,55,51,34,496,272,224,70,58,42,18,1
30609,284,104,180,54,81,8,10,97,46,51,12,17,11,8,1
30610,770,374,396,95,91,79,41,356,208,148,42,26,57,15,1
30611,248,119,129,33,48,20,10,168,76,92,26,21,19,4,1
30612,398,217,181,38,44,49,14,259,124,135,43,33,17,13,1
30613,986,465,521,152,132,138,51,2944,1827,1117,338,332,122,35,1
30614,472,230,242,82,46,49,19,1669,1162,507,154,128,86,51,1
30615,772,417,355,118,92,80,23,271,110,161,33,27,11,8,1
30616,642,271,371,106,111,57,23,928,442,486,139,118,91,43,1
30617,422,213,209,63,60,35,13,900,484,416,119,110,77,29,1
30618,591,319,272,96,62,43,19,633,305,328,90,56,22,23,1
30619,431,227,204,53,60,58,12,404,190,214,55,55,35,27,1
30620,340,162,178,40,39,35,22,301,133,168,41,60,26,18,1
30621,465,225,240,65,44,65,25,489,253,236,73,36,62,17,1
30622,728,385,343,110,102,69,14,906,455,451,116,105,87,46,1
30623,298,167,131,47,33,40,8,861,393,468,150,101,69,35,1
30624,164,78,86,28,23,12,8,347,194,153,53,44,40,10,1
30625,833,467,366,106,84,105,34,333,192,141,50,48,28,10,1
30626,1375,695,680,156,173,181,57,4391,2256,2135,494,411,423,231,1
30627,297,158,139,47,37,37,9,1621,752,869,171,356,65,23,1
30628,723,335,388,90,84,77,74,388,221,167,56,36,61,20,1
30629,1247,548,699,168,150,140,43,373,194,179,42,54,26,13,1
30630,216,102,114,31,29,21,6,382,179,203,58,54,29,19,1
30631,464,297,167,72,30,52,14,793,413,380,105,120,57,23,1
30632,835,419,416,119,94,106,40,133,61,72,21,19,13,4,1
30633,592,291,301,92,93,71,31,187,96,91,30,24,24,4,1
30634,370,190,180,60,52,37,13,854,380,474,137,159,81,31,1
30635,136,58,78,35,14,8,3,145,76,69,31,13,14,4,1
30636,976,496,480,128,111,121,48,509,262,247,64,70,64,20,1
30637,158,85,73,24,18,18,8,455,229,226,66,62,63,29,1
30638,400,208,192,62,44,42,21,477,232,245,67,64,70,30,1
30639,427,218,209,56,57,53,24,445,255,190,57,53,56,28,1
30640,822,417,405,112,97,88,40,911,489,422,121,98,97,36,1
30641,840,411,429,122,101,79,34,821,387,434,121,131,76,29,1
30642,500,242,258,53,48,44,18,728,369,359,79,93,97,40,1
30643,211,88,123,38,28,26,10,673,329,344,111,95,92,41,1
30644,304,135,169,52,43,30,16,4544,2024,2520,579,628,480,403,1
30645,729,391,338,80,64,71,34,769,362,407,99,88,66,67,1
30646,235,111,124,38,26,31,22,810,367,443,115,92,94,59,1
30647,410,194,216,60,47,47,26,167,70,97,32,20,15,7,1
30648,144,69,75,11,21,8,5,490,224,266,80,70,39,32,1
30649,2701,1334,1367,380,349,299,139,785,359,426,118,128,84,33,1
30650,1800,882,918,202,185,186,49,2442,1193,1249,278,183,170,145,1
30651,686,345,341,98,106,75,25,155,66,89,36,28,11,7,1
30652,316,161,155,46,50,39,16,131,66,65,21,14,23,7,1
30653,415,209,206,60,67,39,18,601,313,288,42,48,25,36,1
30654,437,230,207,41,55,27,13,785,374,411,56,42,38,25,1
30655,465,225,240,65,44,65,25,833,389,444,126,111,85,31,1
30656,461,227,234,61,47,54,33,601,313,288,42,48,25,36,1
30657,1123,554,569,142,130,85,36,429,223,206,50,32,46,17,1
30658,201,98,103,28,25,19,13,398,181,217,65,69,42,17,1
30659,341,170,171,41,66,27,10,142,76,66,21,21,22,11,1
30660,650,304,346,80,106,62,28,215,115,100,27,28,34,16,1
30661,581,323,258,74,58,48,20,217,109,108,34,32,35,7,1
30662,815,418,397,97,62,70,17,799,365,434,86,92,74,39,1
30663,557,240,317,97,74,68,37,574,295,279,78,65,61,22,1
30664,864,404,460,150,127,103,42,757,373,384,115,93,95,25,1
30665,425,210,215,56,43,52,25,229,134,95,25,13,28,10,1
30666,870,418,452,121,102,109,28,369,181,188,41,36,54,16,1
30667,662,312,350,103,104,59,20,931,491,440,127,116,118,44,1
30668,646,355,291,99,62,72,21,360,192,168,55,45,48,16,1
30669,317,153,164,39,30,35,13,557,268,289,66,67,70,17,1
30670,265,117,148,39,36,47,17,601,313,288,42,48,25,36,1
30671,1186,512,674,170,156,94,48,3418,1378,2040,515,464,318,121,1
30672,392,180,212,78,49,43,18,553,261,292,73,79,40,26,1
30673,196,107,89,19,18,15,7,509,262,247,64,70,64,20,1
30674,1826,876,950,263,264,139,62,926,435,491,133,132,85,17,1
30675,985,551,434,123,93,91,26,271,159,112,34,34,33,7,1
30676,248,130,118,26,28,16,11,686,360,326,79,81,96,36,1
30677,326,182,144,42,37,39,15,724,650,74,44,3,32,3,1
30678,561,280,281,88,58,89,27,512,261,251,79,73,60,21,1
30679,369,237,132,33,16,38,18,267,149,118,45,33,31,14,1
30680,819,269,550,140,213,44,23,301,119,182,53,47,14,20,1
30681,671,303,368,93,68,61,26,2414,1189,1225,277,178,170,169,1
30682,307,150,157,44,23,30,13,781,418,363,92,90,64,41,1
30683,1863,721,1142,262,283,139,74,1149,568,581,177,133,101,30,1
30684,278,137,141,47,32,28,20,465,225,240,65,44,65,25,1
30685,796,390,406,110,117,86,33,522,239,283,75,88,45,11,1
30686,1116,539,577,149,161,115,43,756,348,408,101,103,60,40,1
30687,1669,1162,507,154,128,86,51,223,127,96,25,23,33,4,1
30688,412,218,194,63,51,49,14,757,359,398,109,127,80,26,1
30689,335,181,154,37,26,42,9,930,367,563,181,153,83,48,1
30690,496,251,245,78,62,61,23,537,276,261,75,68,68,22,1
30691,195,83,112,40,16,19,16,328,182,146,47,35,21,29,1
30692,168,90,78,22,19,13,4,326,166,160,49,45,36,12,1
30693,464,167,297,90,81,33,9,603,311,292,102,71,66,23,1
30694,351,184,167,59,45,54,9,1275,579,696,200,172,125,51,1
30695,1608,778,830,243,230,159,74,191,99,92,25,24,18,8,1
30696,317,153,164,39,30,35,13,799,377,422,98,95,80,70,1
30697,1748,791,957,281,247,173,25,977,500,477,139,115,121,31,1
30698,214,132,82,26,20,15,8,254,107,147,42,37,24,10,1
30699,1106,579,527,121,152,113,45,532,267,265,86,55,64,22,1
30700,261,114,147,23,20,8,6,335,188,147,40,37,30,22,1
30701,391,208,183,65,49,57,17,297,160,137,27,33,26,19,1
30702,1290,597,693,182,182,119,63,255,142,113,40,32,27,6,1
30703,1865,943,922,270,209,228,91,136,65,71,33,11,9,6,1
30704,358,170,188,54,55,20,10,553,333,220,61,43,72,36,1
30705,920,492,428,100,92,88,49,335,185,150,46,34,36,13,1
30706,744,384,360,104,96,57,31,1117,423,694,182,134,88,31,1
30707,489,250,239,66,57,47,26,525,283,242,73,62,54,28,1
30708,574,269,305,91,63,54,27,719,364,355,104,100,58,34,1
30709,509,262,247,64,70,64,20,217,109,108,34,30,34,5,1
30710,1304,585,719,179,169,154,47,1187,631,556,182,139,152,56,1
30711,281,154,127,45,31,24,9,158,85,73,24,18,18,8,1
30712,397,194,203,45,47,38,14,390,207,183,50,48,38,15,1
30713,552,285,267,74,51,69,24,503,263,240,72,55,51,34,1
30714,623,320,303,103,85,75,15,419,208,211,68,60,35,22,1
30715,328,173,155,39,16,45,6,267,147,120,40,24,25,8,1
30716,822,416,406,111,105,84,44,304,159,145,38,40,32,3,1
30717,228,105,123,38,29,25,9,187,91,96,23,28,23,7,1
30718,907,455,452,132,117,80,40,406,205,201,54,58,34,21,1
30719,454,230,224,63,56,38,33,813,440,373,117,93,34,19,1
30720,429,219,210,46,66,42,17,268,104,164,58,37,30,14,1
30721,815,418,397,97,62,70,17,1011,499,512,157,133,116,48,1
30722,558,286,272,76,67,45,30,1516,963,553,148,152,111,26,1
30723,267,130,137,31,18,19,13,369,181,188,41,36,54,16,1
30724,148,64,84,33,19,6,1,447,222,225,71,54,44,25,1
30725,206,85,121,31,42,6,17,422,211,211,73,61,43,17,1
30726,427,205,222,53,52,51,22,691,241,450,151,139,24,20,1
30727,482,231,251,76,81,64,26,499,252,247,74,42,55,14,1
30728,576,250,326,93,71,34,15,597,246,351,95,98,45,25,1
30729,490,224,266,80,70,39,32,776,356,420,122,103,85,30,1
30730,317,164,153,47,33,47,12,360,192,168,55,45,48,16,1
30731,1400,800,600,158,134,150,65,536,278,258,72,63,62,20,1
30732,226,109,117,38,36,13,11,522,235,287,78,67,60,50,1
30733,504,237,267,62,66,48,17,1137,641,496,132,130,114,42,1
30734,3695,1922,1773,449,360,352,261,2944,1827,1117,338,332,122,35,1
30735,240,125,115,34,32,30,8,876,473,403,110,106,73,24,1
30736,624,204,420,166,101,32,13,955,314,641,241,135,97,11,1
30737,2556,1169,1387,248,291,227,275,388,221,167,56,36,61,20,1
30738,603,314,289,100,73,79,29,1255,708,547,120,68,88,7,1
30739,621,246,375,133,112,56,21,509,261,248,62,65,35,20,1
30740,723,309,414,106,106,41,40,483,274,209,54,39,45,13,1
30741,600,281,319,98,68,38,13,2177,1034,1143,274,228,201,95,1
30742,136,66,70,33,11,9,4,652,272,380,116,113,55,27,1
30743,2923,1529,1394,308,341,287,114,751,390,361,116,98,80,34,1
30744,247,110,137,34,45,23,10,960,409,551,166,134,77,44,1
30745,1182,599,583,162,130,106,41,526,264,262,77,71,61,27,1
30746,499,249,250,79,63,61,22,750,347,403,105,103,83,29,1
30747,536,278,258,72,63,62,20,583,322,261,73,66,45,26,1
30748,226,129,97,20,25,26,11,478,269,209,75,47,47,19,1
30749,1253,634,619,182,155,162,70,377,202,175,46,50,41,23,1
30750,344,138,206,46,48,24,43,454,220,234,73,46,61,19,1
30751,422,203,219,75,49,40,22,246,108,138,32,44,21,10,1
30752,1042,530,512,162,150,103,52,785,374,411,56,42,38,25,1
30753,498,224,274,69,49,45,16,892,420,472,135,146,98,37,1
30754,728,385,343,110,102,69,14,303,159,144,40,35,35,8,1
30755,396,150,246,103,64,38,3,2442,1193,1249,278,183,170,145,1
30756,303,187,116,41,23,23,9,743,366,377,41,37,26,14,1
30757,617,255,362,105,108,61,23,227,105,122,37,29,19,12,1
30758,233,121,112,24,31,30,7,173,82,91,27,25,28,4,1
30759,451,235,216,64,49,38,21,544,291,253,62,53,35,26,1
30760,162,88,74,18,20,25,10,377,184,193,56,53,44,14,1
30761,676,333,343,111,89,94,39,385,174,211,38,32,23,12,1
30762,1013,457,556,124,157,81,26,394,240,154,46,36,59,28,1
30763,892,397,495,146,63,65,37,1134,539,595,150,146,78,40,1
30764,212,93,119,30,27,21,14,358,212,146,51,36,33,9,1
30765,1123,554,569,142,130,85,36,1130,614,516,129,138,98,42,1
30766,245,122,123,21,32,18,13,942,423,519,130,126,104,50,1
30767,124,69,55,15,13,12,2,400,215,185,59,54,33,16,1
30768,562,282,280,76,80,43,12,1477,738,739,176,176,145,72,1
30769,443,208,235,43,55,51,50,144,57,87,38,26,10,4,1
30770,837,399,438,112,144,71,32,458,265,193,55,35,49,27,1
30771,522,265,257,35,39,38,8,1125,581,544,135,124,137,47,1
30772,582,293,289,94,80,77,32,785,374,411,56,42,38,25,1
30773,466,186,280,71,84,30,11,2365,944,1421,371,293,137,69,1
30774,501,240,261,80,62,49,42,745,366,379,110,93,79,45,1
30775,297,160,137,27,33,26,19,277,122,155,33,33,25,24,1
30776,677,245,432,129,155,72,11,93,45,48,19,15,14,3,1
30777,2063,1024,1039,175,117,80,97,928,442,486,139,118,91,43,1
30778,227,127,100,32,24,31,5,1117,423,694,182,134,88,31,1
30779,250,137,113,33,19,24,9,201,98,103,26,35,16,5,1
30780,344,168,176,65,44,33,15,273,126,147,54,49,25,18,1
30781,440,218,222,58,66,40,24,906,485,421,112,98,112,39,1
30782,1311,690,621,158,161,128,51,962,430,532,109,142,61,34,1
30783,556,274,282,74,68,62,37,1516,963,553,148,152,111,26,1
30784,219,105,114,36,29,19,8,1893,764,1129,308,323,126,60,1
30785,246,108,138,32,44,21,10,198,102,96,27,20,21,12,1
30786,1390,695,695,180,137,170,71,472,263,209,57,39,60,29,1
30787,919,538,381,111,98,103,41,421,195,226,73,71,34,15,1
30788,964,408,556,131,153,76,55,526,169,357,109,86,69,30,1
30789,461,207,254,82,66,55,33,582,293,289,94,80,77,32,1
30790,277,124,153,44,40,35,18,315,150,165,49,59,23,15,1
30791,845,373,472,160,151,60,23,245,122,123,21,32,18,13,1
30792,255,122,133,35,51,22,13,247,110,137,34,45,23,10,1
30793,834,405,429,112,95,84,34,1067,555,512,141,129,100,36,1
30794,184,131,53,15,15,16,5,460,228,232,70,46,46,17,1
30795,502,240,262,78,61,54,32,210,115,95,31,22,27,10,1
30796,168,67,101,37,17,13,13,152,67,85,26,23,14,6,1
30797,469,242,227,66,48,48,26,522,235,287,78,67,60,50,1
30798,1863,721,1142,262,283,139,74,330,143,187,63,29,52,20,1
30799,787,386,401,98,95,86,25,469,221,248,49,60,55,21,1
30800,150,81,69,24,23,16,4,528,252,276,97,68,58,22,1
30801,595,316,279,86,60,65,40,419,247,172,64,30,43,17,1
30802,676,333,343,111,89,94,39,600,261,339,103,114,34,16,1
30803,593,295,298,70,85,48,13,982,545,437,119,100,92,40,1
30804,933,536,397,96,90,71,41,1424,650,774,152,124,95,87,1
30805,744,385,359,125,89,90,23,508,267,241,43,35,25,17,1
30806,1395,627,768,172,263,141,59,1194,646,548,139,125,127,59,1
30807,333,167,166,45,30,34,14,767,392,375,113,112,83,13,1
30808,639,397,242,64,37,64,30,326,153,173,63,48,25,8,1
30809,767,392,375,113,112,83,13,536,278,258,72,63,62,20,1
30810,336,154,182,51,48,39,22,111,29,82,10,54,0,1,1
30811,875,376,499,155,125,53,39,863,418,445,127,114,70,31,1
30812,870,489,381,97,99,76,14,526,264,262,77,71,61,27,1
30813,3957,1683,2274,560,659,267,109,340,172,168,60,50,36,10,1
30814,284,109,175,55,79,9,9,375,202,173,46,49,41,23,1
30815,724,325,399,98,92,64,24,657,293,364,109,75,66,28,1
30816,454,224,230,71,39,62,22,513,274,239,67,66,62,35,1
30817,346,165,181,69,43,22,9,202,102,100,29,35,6,9,1
30818,125,51,74,31,7,5,5,415,250,165,43,28,50,21,1
30819,676,295,381,94,71,65,24,262,144,118,19,39,22,8,1
30820,220,126,94,29,12,34,11,744,384,360,104,96,57,31,1
30821,556,279,277,83,69,71,19,788,360,428,93,106,67,72,1
30822,194,90,104,33,17,24,19,892,420,472,135,146,98,37,1
30823,297,158,139,47,37,37,9,149,52,97,36,36,7,4,1
30824,951,506,445,107,118,79,40,418,204,214,68,66,38,12,1
30825,785,391,394,83,116,74,20,794,407,387,86,120,76,16,1
30826,1332,637,695,214,178,117,40,792,407,385,110,132,82,43,1
30827,1320,566,754,235,198,122,36,1047,562,485,141,127,114,41,1
30828,443,208,235,43,55,51,50,910,524,386,106,97,73,26,1
30829,487,229,258,68,82,41,24,277,124,153,44,40,35,18,1
30830,732,355,377,108,109,79,27,277,122,155,33,33,25,24,1
30831,1292,592,700,186,169,108,22,377,202,175,46,50,41,23,1
30832,351,184,167,59,45,54,9,778,367,411,90,85,64,43,1
30833,1181,612,569,107,121,123,43,1464,987,477,137,141,55,31,1
30834,216,102,114,31,29,21,6,445,230,215,64,62,50,20,1
30835,559,296,263,77,69,42,13,375,202,173,46,49,41,23,1
30836,736,388,348,88,85,67,28,396,195,201,52,53,25,23,1
30837,536,278,258,72,63,62,20,317,153,164,34,52,30,14,1
30838,963,553,410,126,103,79,26,184,86,98,26,26,14,11,1
30839,666,349,317,87,91,58,20,140,76,64,17,13,13,8,1
30840,331,170,161,47,39,41,8,574,273,301,101,74,68,26,1
30841,3664,1638,2026,598,519,231,63,291,133,158,46,51,21,15,1
30842,2414,1189,1225,277,178,170,169,331,169,162,40,28,22,14,1
30843,615,293,322,70,67,45,29,504,255,249,56,59,45,13,1
30844,546,267,279,90,69,56,19,191,99,92,25,24,18,8,1
30845,770,374,396,95,91,79,41,863,470,393,82,72,92,44,1
30846,419,235,184,50,49,53,20,974,509,465,136,121,122,40,1
30847,336,169,167,38,30,44,16,417,231,186,37,32,43,18,1
30848,385,181,204,48,41,52,36,558,239,319,53,56,27,19,1
30849,258,113,145,43,44,16,7,302,147,155,47,42,17,11,1
30850,2524,1232,1292,398,317,186,61,423,222,201,51,33,41,28,1
30851,314,169,145,32,47,35,7,794,390,404,103,95,86,23,1
30852,301,149,152,40,39,34,10,572,309,263,64,55,47,29,1
30853,2442,1193,1249,278,183,170,145,368,170,198,59,64,29,13,1
30854,334,171,163,48,42,32,18,360,188,172,49,48,47,17,1
30855,910,431,479,138,103,98,41,158,85,73,24,18,18,8,1
30856,767,392,375,113,112,83,13,2016,1107,909,214,229,238,111,1
30857,277,122,155,33,33,25,24,604,282,322,76,74,69,35,1
30858,671,295,376,126,93,61,28,207,99,108,34,27,22,9,1
30859,177,67,110,34,24,13,10,969,505,464,123,133,92,33,1
30860,362,233,129,37,17,51,18,592,283,309,84,137,60,20,1
30861,126,66,60,24,10,7,9,294,148,146,35,33,25,14,1
30862,770,374,396,95,91,79,41,882,432,450,115,111,68,44,1
30863,1123,554,569,142,130,85,36,507,242,265,53,44,31,22,1
30864,333,167,166,45,30,34,14,987,535,452,124,110,101,45,1
30865,2548,1117,1431,444,335,260,93,368,141,227,64,61,24,13,1
30866,95,47,48,13,12,10,4,118,51,67,25,13,6,7,1
30867,714,364,350,98,102,91,27,271,126,145,33,38,31,10,1
30868,213,127,86,26,20,33,9,748,341,407,121,87,96,52,1
30869,2442,1193,1249,278,183,170,145,651,306,345,85,64,61,32,1
30870,1417,598,819,223,188,135,58,328,178,150,36,34,16,14,1
30871,672,334,338,110,93,91,41,386,247,139,34,19,40,28,1
30872,1785,857,928,246,225,187,93,1849,882,967,239,239,191,84,1
30873,441,218,223,69,55,50,27,536,278,258,72,63,62,20,1
30874,2490,1126,1364,352,325,219,89,208,96,112,31,32,13,9,1
30875,297,158,139,47,37,37,9,335,128,207,51,60,16,8,1
30876,585,312,273,57,64,77,25,2477,1186,1291,256,271,249,90,1
30877,191,99,92,25,24,18,8,424,209,215,56,58,45,24,1
30878,509,262,247,64,70,64,20,631,261,370,110,109,50,26,1
30879,270,137,133,30,28,27,11,401,167,234,56,71,16,10,1
30880,1363,690,673,185,172,152,62,1356,672,684,171,172,134,59,1
30881,173,88,85,20,21,9,12,769,329,440,116,66,55,22,1
30882,1132,646,486,99,102,71,41,646,316,330,89,95,48,17,1
30883,329,155,174,46,38,29,14,892,420,472,135,146,98,37,1
30884,1037,534,503,127,148,121,48,876,457,419,88,124,67,47,1
30885,870,489,381,97,99,76,14,1095,530,565,157,151,98,34,1
30886,587,309,278,67,73,56,34,354,169,185,54,54,41,19,1
30887,677,245,432,129,155,72,11,463,236,227,64,50,44,29,1
30888,2524,1232,1292,398,317,186,61,255,122,133,35,51,22,13,1
30889,840,385,455,118,137,66,39,984,461,523,109,89,91,52,1
30890,190,94,96,25,24,18,5,745,354,391,116,100,95,46,1
30891,825,399,426,128,128,77,32,635,333,302,99,75,83,28,1
30892,3097,1431,1666,473,433,300,121,1907,1008,899,235,224,195,73,1
30893,292,152,140,46,38,35,12,393,186,207,58,50,36,22,1
30894,694,360,334,90,88,77,32,671,326,345,111,77,74,11,1
30895,173,110,63,35,6,9,8,194,92,102,42,23,16,2,1
30896,184,95,89,17,21,18,8,239,146,93,30,22,35,9,1
30897,428,237,191,45,25,46,30,115,62,53,17,12,8,7,1
30898,504,255,249,56,59,45,13,693,297,396,87,52,64,27,1
30899,623,329,294,84,86,74,27,792,399,393,96,103,85,37,1
30900,512,261,251,79,73,60,21,303,159,144,40,35,35,8,1
30901,189,102,87,23,24,20,11,461,245,216,55,62,54,25,1
30902,707,391,316,111,80,54,30,279,106,173,48,35,41,39,1
30903,825,427,398,79,95,81,48,153,65,88,27,14,18,9,1
30904,519,244,275,76,90,44,16,512,269,243,69,70,62,29,1
30905,269,134,135,42,35,27,13,323,156,167,52,45,39,18,1
30906,981,465,516,126,164,112,38,1980,963,1017,262,243,179,78,1
30907,611,246,365,116,82,71,27,777,345,432,128,88,65,39,1
30908,483,236,247,82,60,43,18,410,208,202,59,58,43,26,1
30909,712,380,332,69,74,57,30,374,217,157,52,23,67,13,1
30910,225,111,114,32,34,32,16,218,114,104,32,31,33,11,1
30911,577,217,360,100,116,32,24,1269,624,645,183,180,136,52,1
30912,698,345,353,104,87,81,50,259,133,126,26,30,22,22,1
30913,210,124,86,27,21,14,8,262,123,139,44,32,25,18,1
30914,1298,591,707,196,168,124,58,1531,649,882,108,122,93,72,1
30915,1089,544,545,138,160,117,43,211,90,121,49,27,14,11,1
30916,396,215,181,53,43,55,17,1706,830,876,265,209,230,63,1
30917,863,458,405,97,82,63,57,574,281,293,88,75,79,25,1
30918,1621,750,871,276,243,162,51,215,115,100,27,28,34,16,1
30919,466,230,236,63,74,42,35,110,67,43,9,10,11,8,1
30920,834,405,429,112,95,84,34,572,309,263,64,55,47,29,1
30921,1140,586,554,130,146,117,49,1247,613,634,172,176,136,47,1
30922,624,204,420,166,101,32,13,391,189,202,73,47,37,8,1
30923,593,295,298,70,85,48,13,1006,468,538,151,135,82,39,1
30924,669,356,313,90,86,64,31,454,240,214,57,68,39,11,1
30925,579,330,249,52,27,90,11,295,147,148,36,24,36,11,1
30926,870,436,434,131,114,72,25,536,278,258,72,63,62,20,1
30927,188,119,69,24,15,26,12,178,116,62,22,11,15,8,1
30928,324,149,175,49,49,34,6,156,64,92,39,19,15,8,1
30929,303,137,166,54,54,31,15,854,380,474,137,159,81,31,1
30930,1098,519,579,182,159,79,42,223,93,130,38,27,39,10,1
30931,626,333,293,64,55,61,15,427,186,241,55,52,42,23,1
30932,326,161,165,55,43,21,12,522,245,277,78,69,52,21,1
30933,662,312,350,103,104,59,20,759,391,368,103,82,101,45,1
30934,646,355,291,99,62,72,21,473,212,261,72,64,45,28,1
30935,1358,659,699,129,178,134,63,2416,1280,1136,140,374,175,47,1
30936,910,431,479,138,103,98,41,172,91,81,35,13,18,8,1
30937,400,208,192,62,44,42,21,583,322,261,73,66,45,26,1
30938,786,378,408,101,79,104,35,811,400,411,107,87,116,43,1
30939,736,388,348,88,85,67,28,382,183,199,55,60,38,22,1
30940,478,239,239,65,66,65,21,390,203,187,58,40,43,19,1
30941,410,211,199,55,42,34,27,614,292,322,74,48,57,33,1
30942,44,14,30,9,10,1,2,359,171,188,50,60,21,12,1
30943,1132,646,486,99,102,71,41,235,149,86,30,21,17,5,1
30944,282,163,119,40,23,25,17,176,89,87,31,24,9,4,1
30945,527,257,270,72,68,50,28,393,186,207,58,50,36,22,1
30946,414,185,229,53,54,49,11,1233,635,598,187,149,146,51,1
30947,391,208,183,65,49,57,17,933,536,397,96,90,71,41,1
30948,815,418,397,97,62,70,17,288,159,129,27,44,27,15,1
30949,351,184,167,59,45,54,9,627,323,304,81,90,53,27,1
30950,274,142,132,33,34,18,14,837,399,438,112,144,71,32,1
30951,561,210,351,108,77,41,22,309,155,154,41,44,45,16,1
30952,924,441,483,131,115,90,38,458,243,215,51,44,49,26,1
30953,902,332,570,154,146,75,40,519,219,300,86,72,50,39,1
30954,1304,585,719,179,169,154,47,1154,540,614,195,160,138,66,1
30955,659,325,334,102,85,87,32,845,402,443,137,126,105,47,1
30956,502,240,262,78,61,54,32,204,99,105,32,32,22,10,1
30957,1270,557,713,130,195,57,30,1712,1175,537,179,142,113,46,1
30958,360,192,168,55,45,48,16,310,161,149,34,31,35,12,1
30959,340,169,171,40,39,36,22,68,34,34,11,8,3,4,1
30960,252,124,128,49,22,19,13,1690,1173,517,186,130,110,56,1
30961,512,261,251,79,73,60,21,287,154,133,33,27,36,15,1
30962,697,275,422,121,111,66,54,652,397,255,79,43,36,13,1
30963,794,402,392,96,84,86,30,967,463,504,133,114,99,62,1
30964,476,227,249,52,59,38,17,724,334,390,112,109,79,17,1
30965,256,125,131,36,39,32,13,467,269,198,46,51,60,18,1
30966,552,264,288,82,64,48,20,233,111,122,38,27,17,8,1
30967,1382,599,783,208,252,90,39,1989,869,1120,320,274,179,65,1
30968,624,204,420,166,101,32,13,326,167,159,46,31,38,13,1
30969,727,294,433,143,118,69,50,461,207,254,82,66,55,33,1
30970,762,361,401,97,111,92,36,975,505,470,110,124,117,48,1
30971,656,358,298,67,47,64,26,429,227,202,49,51,46,26,1
30972,95,44,51,14,13,7,4,449,240,209,59,55,63,20,1
30973,276,143,133,34,38,20,15,326,176,150,35,22,29,11,1
30974,1006,551,455,115,97,110,41,984,509,475,114,109,106,56,1
30975,201,92,109,27,24,16,8,838,380,458,114,95,68,57,1
30976,467,237,230,73,58,62,15,336,140,196,51,44,27,18,1
30977,1606,743,863,262,212,176,90,503,263,240,72,55,51,34,1
30978,654,317,337,95,111,44,13,564,305,259,82,64,57,27,1
30979,621,273,348,104,102,48,19,140,86,54,17,6,20,7,1
30980,229,105,124,36,33,12,4,363,182,181,33,55,23,11,1
30981,921,455,466,144,127,108,39,822,392,430,125,104,79,24,1
30982,1070,558,512,154,134,126,54,676,333,343,111,89,94,39,1
30983,505,254,251,80,77,60,15,166,74,92,31,19,21,8,1
30984,476,227,249,52,59,38,17,538,269,269,78,67,65,18,1
30985,952,464,488,143,135,72,21,1748,791,957,281,247,173,25,1
30986,533,254,279,81,78,52,10,583,322,261,73,66,45,26,1
30987,1992,927,1065,292,228,166,77,467,224,243,70,43,67,23,1
30988,576,250,326,93,71,34,15,693,289,404,95,158,61,15,1
30989,859,429,430,126,115,64,33,315,118,197,85,57,42,14,1
30990,95,44,51,14,13,7,4,256,141,115,32,22,32,8,1
30991,549,273,276,74,68,72,24,308,170,138,38,35,45,14,1
30992,437,228,209,47,61,26,11,272,149,123,34,35,21,2,1
30993,1791,870,921,217,230,203,112,297,145,152,49,30,23,21,1
30994,756,348,408,101,103,60,40,847,467,380,117,101,67,24,1
30995,1190,638,552,162,95,112,18,324,174,150,37,24,35,27,1
30996,325,153,172,62,37,50,39,902,332,570,154,146,75,40,1
30997,335,183,152,36,27,45,11,592,283,309,84,137,60,20,1
30998,732,355,377,108,109,79,27,1970,978,992,245,206,198,80,1
30999,2944,1827,1117,338,332,122,35,707,388,319,85,61,68,23,1
31000,118,51,67,25,13,6,7,119,59,60,29,10,6,4,1
31001,1374,679,695,191,193,154,48,245,111,134,31,44,20,11,1
31002,708,303,405,115,115,70,23,609,292,317,102,96,64,21,1
31003,424,197,227,67,62,43,17,240,134,106,34,35,15,13,1
31004,246,108,138,32,44,21,10,262,78,184,78,28,32,4,1
31005,601,313,288,42,48,25,36,418,220,198,69,51,44,16,1
31006,984,466,518,159,139,97,42,191,98,93,26,18,19,9,1
31007,24,14,10,4,2,1,2,346,186,160,44,37,29,14,1
31008,527,257,270,72,68,50,28,423,212,211,51,44,48,28,1
31009,331,169,162,40,28,22,14,505,226,279,68,51,30,15,1
31010,930,367,563,181,153,83,48,505,268,237,68,59,34,15,1
31011,486,229,257,75,104,49,10,377,202,175,46,50,41,23,1
31012,1132,646,486,99,102,71,41,1130,639,491,87,188,57,41,1
31013,356,208,148,42,26,57,15,198,112,86,20,36,16,5,1
31014,481,256,225,60,56,48,12,1115,552,563,104,116,115,35,1
31015,410,208,202,59,58,43,26,1068,527,541,160,131,112,52,1
31016,365,215,150,39,35,43,10,308,156,152,43,29,52,9,1
31017,462,251,211,74,53,41,18,947,506,441,105,126,75,14,1
31018,708,290,418,71,143,67,27,834,465,369,82,84,81,21,1
31019,583,322,261,73,66,45,26,1363,690,673,185,172,152,62,1
31020,470,226,244,81,53,59,39,748,355,393,121,91,95,26,1
31021,522,235,287,78,67,60,50,540,282,258,50,53,33,16,1
31022,272,122,150,33,30,27,26,551,299,252,51,62,63,17,1
31023,151,83,68,18,19,17,7,427,214,213,65,58,26,18,1
31024,688,323,365,121,69,55,22,445,225,220,47,62,53,26,1
31025,1241,670,571,135,139,110,32,377,184,193,56,53,44,14,1
31026,52,30,22,6,2,3,6,1001,557,444,113,132,81,53,1
31027,1375,695,680,156,173,181,57,717,469,248,92,67,22,21,1
31028,238,95,143,37,55,4,4,149,68,81,15,38,11,10,1
31029,1476,699,777,228,270,60,23,430,218,212,58,47,34,20,1
31030,204,114,90,21,19,28,7,885,424,461,143,114,92,32,1
31031,357,187,170,51,34,40,23,1441,657,784,140,135,81,73,1
31032,381,189,192,74,49,44,13,499,252,247,75,71,65,25,1
31033,509,341,168,35,32,52,15,917,470,447,139,135,88,63,1
31034,247,110,137,34,45,23,10,606,307,299,92,56,68,30,1
31035,211,92,119,33,44,11,7,1443,776,667,191,175,160,56,1
31036,462,251,211,74,53,41,18,294,146,148,50,45,51,15,1
31037,126,57,69,31,10,10,3,111,29,82,10,54,0,1,1
31038,324,151,173,61,54,32,6,522,235,287,78,67,60,50,1
31039,1434,727,707,210,173,161,54,782,404,378,101,97,75,33,1
31040,419,210,209,54,44,31,23,1469,742,727,213,173,93,29,1
31041,653,311,342,106,74,52,28,404,197,207,57,69,33,15,1
31042,1163,493,670,214,158,106,42,1873,1066,807,217,201,237,105,1
31043,722,384,338,94,83,63,35,217,109,108,34,32,35,7,1
31044,999,541,458,110,110,104,42,678,344,334,85,87,67,46,1
31045,1189,559,630,179,147,118,35,303,159,144,40,35,35,8,1
31046,425,183,242,57,77,39,33,601,313,288,42,48,25,36,1
31047,692,326,366,103,121,67,27,292,153,139,39,33,24,21,1
31048,973,522,451,140,134,124,39,570,281,289,86,70,58,22,1
31049,440,246,194,62,49,41,16,1124,441,683,148,189,72,43,1
31050,372,189,183,60,44,41,18,393,186,207,58,50,36,22,1
31051,975,505,470,110,124,117,48,207,89,118,28,26,16,6,1
31052,405,180,225,72,57,31,12,377,202,175,46,50,41,22,1
31053,310,156,154,27,43,20,6,255,130,125,44,18,22,12,1
31054,350,180,170,64,46,55,12,229,103,126,28,44,17,5,1
31055,1007,523,484,116,113,117,43,908,488,420,115,97,111,43,1
31056,467,226,241,55,48,54,23,777,387,390,90,87,65,37,1
31057,834,465,369,82,84,81,21,427,204,223,38,57,26,32,1
31058,579,250,329,90,61,62,45,614,292,322,74,48,57,33,1
31059,1140,586,554,130,146,117,49,427,215,212,69,35,51,21,1
31060,618,290,328,82,74,69,42,435,233,202,43,42,39,32,1
31061,211,114,97,32,24,19,10,377,184,193,56,53,44,14,1
31062,596,270,326,109,78,53,17,1462,652,810,243,199,115,30,1
31063,713,335,378,94,70,56,35,89,42,47,16,12,15,6,1
31064,191,72,119,40,41,17,8,695,373,322,80,59,89,39,1
31065,2627,1378,1249,361,265,257,96,672,334,338,110,93,91,41,1
31066,505,273,232,70,57,60,33,426,200,226,75,56,39,24,1
31067,345,172,173,57,29,38,22,985,551,434,123,93,91,26,1
31068,963,553,410,126,103,79,26,189,90,99,26,29,17,11,1
31069,299,153,146,32,28,29,12,1748,791,957,281,247,173,25,1
31070,1154,540,614,195,160,138,66,770,374,396,95,91,79,41,1
31071,892,420,472,135,146,98,37,576,250,326,93,71,34,15,1
31072,1238,596,642,148,147,126,136,2321,1177,1144,236,255,174,254,1
31073,703,414,289,75,61,68,26,808,484,324,80,63,76,24,1
31074,419,210,209,54,44,31,23,1139,536,603,162,139,109,50,1
31075,589,294,295,37,44,27,33,115,62,53,18,3,19,5,1
31076,592,283,309,84,137,60,20,4544,2024,2520,579,628,480,403,1
31077,707,295,412,105,105,66,30,2003,1022,981,195,194,164,229,1
31078,191,72,119,40,41,17,8,835,420,415,104,105,57,47,1
31079,330,157,173,56,42,51,8,533,254,279,81,78,52,10,1
31080,639,322,317,73,82,39,23,277,144,133,36,36,34,15,1
31081,501,285,216,52,55,62,25,228,110,118,37,33,18,12,1
31082,297,158,139,47,37,37,9,524,237,287,87,75,54,26,1
31083,982,494,488,150,117,91,45,671,326,345,111,77,74,11,1
31084,1785,857,928,246,225,187,93,930,367,563,181,153,83,48,1
31085,1106,565,541,139,102,103,52,763,343,420,127,70,105,34,1
31086,413,206,207,38,55,19,10,1139,536,603,162,139,109,50,1
31087,116,58,58,13,14,7,8,388,253,135,37,21,39,23,1
31088,1063,530,533,181,121,121,25,651,340,311,81,84,80,29,1
31089,770,356,414,123,102,66,25,1336,724,612,209,141,133,60,1
31090,587,300,287,67,102,34,20,3224,1440,1784,455,440,333,126,1
31091,586,309,277,81,64,76,25,1255,586,669,167,149,113,59,1
31092,671,295,376,126,93,61,28,202,102,100,29,35,6,9,1
31093,316,156,160,43,42,28,17,387,177,210,53,50,44,20,1
31094,684,311,373,109,99,66,16,703,356,347,96,97,38,22,1
31095,712,313,399,125,119,51,24,497,185,312,63,92,38,28,1
31096,671,318,353,83,124,46,34,485,273,212,92,63,37,8,1
31097,631,261,370,110,109,50,26,192,101,91,25,22,18,9,1
31098,1336,724,612,209,141,133,60,367,161,206,70,48,41,19,1
31099,541,260,281,87,65,70,24,193,85,108,24,37,20,13,1
31100,424,197,227,67,62,43,17,467,261,206,54,49,48,24,1
31101,883,403,480,140,119,85,38,374,235,139,33,16,72,21,1
31102,104,52,52,18,14,17,4,673,313,360,101,101,46,17,1
31103,686,358,328,83,61,71,24,593,266,327,102,84,69,24,1
31104,1258,531,727,218,216,108,35,708,303,405,115,115,70,23,1
31105,145,76,69,31,13,14,4,288,158,130,59,23,21,10,1
31106,270,130,140,48,44,37,12,1210,592,618,157,138,116,85,1
31107,247,110,137,34,45,23,10,759,326,433,115,95,61,29,1
31108,840,385,455,118,137,66,39,428,226,202,52,60,75,20,1
31109,592,264,328,86,85,62,41,390,203,187,58,40,43,19,1
31110,538,252,286,77,87,53,30,101,41,60,18,19,10,5,1
31111,248,120,128,43,37,20,6,826,362,464,107,118,71,43,1
31112,465,220,245,82,71,60,25,92,40,52,14,23,13,7,1
31113,693,359,334,75,54,59,20,245,112,133,32,45,20,10,1
31114,546,267,279,90,69,56,19,779,392,387,124,79,52,13,1
31115,372,201,171,52,50,42,13,239,146,93,30,22,35,9,1
31116,247,127,120,43,20,27,14,1073,541,532,126,143,123,54,1
31117,391,208,183,65,49,57,17,1242,613,629,174,113,114,53,1
31118,111,29,82,10,54,0,1,303,175,128,43,36,34,12,1
31119,1048,564,484,118,122,113,40,799,377,422,98,95,80,70,1
31120,824,386,438,94,77,81,34,2442,1193,1249,278,183,170,145,1
31121,158,71,87,23,21,17,12,781,418,363,92,90,64,41,1
31122,665,297,368,111,107,34,12,229,105,124,36,33,12,4,1
31123,401,204,197,49,33,29,17,769,329,440,116,66,55,22,1
31124,504,237,267,62,66,48,17,434,233,201,61,55,37,15,1
31125,837,444,393,128,89,87,37,2948,1454,1494,327,456,140,81,1
31126,1978,807,1171,323,310,129,70,279,106,173,48,35,41,39,1
31127,817,425,392,120,102,83,26,149,68,81,15,38,11,10,1
31128,393,186,207,58,50,36,22,425,210,215,56,43,52,25,1
31129,359,182,177,54,37,41,12,1066,587,479,127,108,118,48,1
31130,977,406,571,151,128,84,47,89,44,45,15,12,15,6,1
31131,313,159,154,30,40,23,14,1132,646,486,99,102,71,41,1
31132,524,270,254,84,72,70,23,676,333,343,111,89,94,39,1
31133,780,414,366,112,89,73,38,827,446,381,111,88,81,45,1
31134,117,53,64,17,17,7,5,301,150,151,41,30,17,11,1
31135,764,277,487,158,162,64,31,399,201,198,65,45,48,17,1
31136,624,204,420,166,101,32,13,930,411,519,138,137,86,24,1
31137,4829,2417,2412,551,526,409,214,239,110,129,32,32,24,10,1
31138,293,142,151,49,40,42,17,758,362,396,115,102,35,13,1
31139,917,470,447,139,135,88,63,737,363,374,119,101,85,41,1
31140,277,100,177,35,88,30,2,318,164,154,52,43,34,10,1
31141,632,339,293,83,77,59,20,1124,615,509,157,125,128,52,1
31142,514,226,288,71,66,63,32,220,113,107,37,24,16,7,1
31143,290,127,163,47,58,23,12,940,425,515,145,122,42,29,1
31144,467,231,236,71,65,58,18,309,154,155,42,44,45,16,1
31145,536,278,258,72,63,62,20,836,416,420,106,80,85,40,1
31146,245,112,133,32,45,20,10,475,223,252,72,66,51,26,1
31147,2570,1286,1284,337,338,294,120,781,418,363,92,90,64,41,1
31148,92,47,45,15,9,9,5,639,373,266,77,89,68,25,1
31149,671,364,307,75,71,58,22,806,436,370,101,100,76,34,1
31150,532,267,265,86,55,64,22,947,482,465,143,107,89,37,1
31151,926,474,452,106,103,84,42,1242,613,629,174,113,114,53,1
31152,271,131,140,47,37,41,11,480,257,223,74,26,60,27,1
31153,351,184,167,59,45,54,9,478,239,239,65,66,65,21,1
31154,1290,597,693,182,182,119,63,104,48,56,15,15,13,7,1
31155,460,228,232,70,46,46,17,425,204,221,71,56,45,13,1
31156,756,362,394,102,104,73,25,951,506,445,107,118,79,40,1
31157,129,78,51,17,9,10,10,211,114,97,32,24,19,10,1
31158,252,124,128,49,22,19,13,1670,1140,530,173,120,89,53,1
31159,503,263,240,72,55,51,34,418,189,229,76,72,45,14,1
31160,261,146,115,37,35,27,7,601,313,288,42,48,25,36,1
31161,662,306,356,90,82,73,28,519,246,273,78,82,42,16,1
31162,1217,566,651,215,170,102,23,367,161,206,70,48,41,19,1
31163,822,392,430,125,104,79,24,377,202,175,46,50,41,23,1
31164,2817,1216,1601,379,436,183,115,468,233,235,65,61,49,34,1
31165,327,172,155,45,44,39,21,998,379,619,167,176,57,23,1
31166,574,298,276,79,75,79,40,563,304,259,75,64,68,31,1
31167,603,311,292,102,71,66,23,433,237,196,60,52,33,27,1
31168,1691,1159,532,160,109,95,46,398,216,182,52,33,40,15,1
31169,412,192,220,71,50,48,23,503,263,240,72,55,51,34,1
31170,708,344,364,106,98,66,33,398,186,212,76,70,18,13,1
31171,173,110,63,35,6,9,8,249,138,111,32,29,21,8,1
31172,330,143,187,63,29,52,20,538,292,246,69,57,52,39,1
31173,1615,835,780,189,208,172,86,1170,510,660,142,182,115,84,1
31174,475,235,240,77,58,43,22,864,362,502,142,150,70,19,1
31175,275,125,150,37,48,27,7,142,60,82,20,28,13,5,1
31176,1484,731,753,206,175,187,71,556,269,287,86,66,62,22,1
31177,1071,549,522,133,127,130,59,216,119,97,33,27,28,7,1
31178,217,109,108,34,30,34,5,1333,646,687,209,179,148,45,1
31179,767,392,375,113,112,83,13,1464,715,749,200,167,181,70,1
31180,458,222,236,69,39,35,18,290,149,141,37,26,41,12,1
31181,280,118,162,35,32,41,37,480,320,160,64,49,22,18,1
31182,2440,1061,1379,377,326,172,62,3144,1617,1527,367,342,278,136,1
31183,513,274,239,67,66,62,35,503,259,244,73,53,52,28,1
31184,413,227,186,45,34,58,23,418,204,214,68,66,38,12,1
31185,579,293,286,68,72,31,47,1356,576,780,229,198,107,38,1
31186,1188,476,712,179,163,93,57,1425,670,755,153,189,122,85,1
31187,183,76,107,34,38,14,8,722,344,378,126,71,46,42,1
31188,1430,718,712,205,172,151,64,842,452,390,101,85,91,33,1
31189,433,221,212,59,42,47,14,605,295,310,74,66,70,36,1
31190,649,330,319,82,67,81,31,1132,553,579,172,143,150,57,1
31191,359,181,178,41,30,31,14,367,203,164,42,29,34,12,1
31192,303,175,128,43,36,34,12,358,212,146,51,36,33,9,1
31193,461,207,254,82,66,55,33,581,254,327,100,83,54,20,1
31194,1464,715,749,200,167,181,70,1290,629,661,191,187,167,55,1
31195,477,301,176,52,35,45,24,926,435,491,133,132,85,17,1
31196,419,207,212,78,40,46,23,454,191,263,61,66,38,15,1
31197,918,427,491,113,111,113,33,468,242,226,58,42,49,19,1
31198,245,112,133,32,45,20,10,1087,480,607,155,179,99,28,1
31199,335,143,192,45,36,32,37,1152,586,566,131,112,117,42,1
31200,109,53,56,17,8,13,7,355,220,135,43,26,65,20,1
31201,465,225,240,65,44,65,25,569,283,286,40,16,60,7,1
31202,303,170,133,37,25,31,9,349,167,182,54,38,30,28,1
31203,745,391,354,85,81,52,39,1118,551,567,128,145,95,36,1
31204,2871,1148,1723,496,469,204,98,894,417,477,114,123,89,38,1
31205,2033,877,1156,359,333,106,44,644,329,315,70,64,50,11,1
31206,476,270,206,62,45,46,30,391,193,198,51,52,49,16,1
31207,149,68,81,15,38,11,10,768,378,390,105,104,63,26,1
31208,119,53,66,33,8,7,6,660,359,301,81,87,102,31,1
31209,463,267,196,51,36,73,27,180,77,103,30,29,23,5,1
31210,218,115,103,32,32,34,11,393,186,207,58,50,36,22,1
31211,199,87,112,31,27,8,15,216,102,114,31,29,21,6,1
31212,1047,562,485,141,127,114,41,217,109,108,34,32,35,7,1
31213,364,241,123,33,16,38,19,391,243,148,32,24,40,29,1
31214,465,240,225,50,54,24,14,432,228,204,59,53,43,15,1
31215,1009,506,503,146,141,97,55,583,322,261,73,66,45,26,1
31216,141,64,77,26,24,10,6,325,149,176,51,49,24,11,1
31217,673,329,344,111,95,92,41,756,348,408,101,103,60,40,1
31218,512,261,251,79,73,60,21,244,136,108,21,25,25,13,1
31219,432,188,244,76,81,26,13,615,339,276,82,76,63,16,1
31220,365,173,192,47,47,29,14,870,436,434,131,114,72,25,1
31221,1290,629,661,191,187,167,55,456,209,247,72,58,40,9,1
31222,372,206,166,43,32,49,12,585,299,286,92,73,89,23,1
31223,451,238,213,53,64,56,22,724,334,390,112,109,79,17,1
31224,123,62,61,17,18,13,8,771,321,450,151,135,43,15,1
31225,1691,1217,474,130,115,73,46,707,386,321,85,83,99,28,1
31226,1182,599,583,162,130,106,41,1271,599,672,194,175,118,47,1
31227,1193,492,701,152,190,66,53,250,105,145,39,27,22,40,1
31228,2161,1233,928,269,199,178,42,2472,1055,1417,416,458,235,64,1
31229,898,361,537,182,146,91,40,501,240,261,80,62,49,42,1
31230,205,91,114,31,32,23,12,183,76,107,34,38,14,8,1
31231,360,192,168,55,45,48,16,785,374,411,56,42,38,25,1
31232,754,318,436,114,106,58,28,439,177,262,78,73,40,21,1
31233,309,137,172,51,50,28,14,782,372,410,127,111,89,36,1
31234,304,171,133,42,35,42,9,1425,670,755,153,189,122,85,1
31235,441,218,223,69,55,50,27,467,224,243,70,43,67,23,1
31236,377,202,175,46,50,41,22,911,551,360,92,106,107,29,1
31237,673,317,356,101,85,76,49,1084,537,547,154,121,92,35,1
31238,340,181,159,44,39,35,21,1003,626,377,94,57,46,21,1
31239,480,234,246,79,77,65,23,673,318,355,61,71,40,31,1
31240,321,173,148,47,27,39,17,1218,499,719,147,141,119,145,1
31241,756,348,408,101,103,60,40,729,358,371,116,99,89,33,1
31242,313,196,117,20,28,46,13,116,67,49,13,12,6,5,1
31243,896,407,489,97,152,70,22,641,318,323,69,61,41,19,1
31244,1738,821,917,242,196,181,58,906,474,432,90,125,74,24,1
31245,1231,603,628,121,162,109,120,1516,963,553,148,152,111,26,1
31246,430,192,238,62,67,27,10,590,303,287,69,65,46,17,1
31247,897,487,410,92,97,83,31,822,402,420,125,107,82,26,1
31248,467,226,241,55,48,54,23,256,134,122,27,31,31,10,1
31249,509,341,168,35,32,52,15,207,99,108,27,27,21,9,1
31250,169,123,46,15,6,33,6,1857,929,928,232,275,95,59,1
31251,117,53,64,17,17,7,5,200,91,109,23,35,13,7,1
31252,439,227,212,60,55,58,8,483,236,247,82,60,43,18,1
31253,435,187,248,62,51,51,21,176,73,103,22,29,13,9,1
31254,482,223,259,74,67,39,12,1097,464,633,190,166,80,60,1
31255,833,452,381,117,85,71,39,533,254,279,81,78,52,10,1
31256,826,362,464,107,118,71,43,625,298,327,90,78,57,33,1
31257,517,249,268,65,59,58,26,3685,1574,2111,579,580,303,116,1
31258,368,195,173,52,41,42,15,233,130,103,26,23,23,6,1
31259,579,321,258,74,70,47,22,900,484,416,119,110,77,29,1
31260,336,221,115,22,17,40,16,109,50,59,20,7,10,9,1
31261,423,218,205,64,55,54,15,764,380,384,89,92,67,25,1
31262,1441,657,784,140,135,81,73,380,187,193,38,51,30,18,1
31263,270,137,133,30,28,27,11,131,66,65,21,14,23,7,1
31264,763,364,399,106,96,54,30,808,357,451,116,98,56,36,1
31265,215,91,124,23,39,5,5,254,107,147,42,37,24,10,1
31266,354,166,188,53,55,40,19,363,221,142,36,16,56,25,1
31267,408,179,229,86,72,32,5,1045,374,671,217,143,103,29,1
31268,641,324,317,88,92,49,14,4563,2219,2344,620,531,527,104,1
31269,1132,553,579,172,143,150,57,537,276,261,75,68,68,22,1
31270,201,42,159,19,3,2,75,560,228,332,113,58,79,38,1
31271,719,301,418,122,132,42,26,875,376,499,155,125,53,39,1
31272,700,305,395,111,99,54,18,236,121,115,26,45,28,6,1
31273,382,194,188,55,36,36,11,297,141,156,32,18,31,15,1
31274,394,220,174,50,28,53,21,246,113,133,33,45,22,10,1
31275,373,190,183,56,45,82,24,384,183,201,66,46,77,26,1
31276,320,171,149,40,29,30,14,1512,737,775,238,209,156,57,1
31277,260,144,116,30,34,38,9,258,134,124,35,25,29,13,1
31278,1424,650,774,152,124,95,87,419,175,244,71,73,23,23,1
31279,740,313,427,101,135,40,22,509,341,168,35,32,52,15,1
31280,316,157,159,45,38,22,19,490,224,266,80,70,39,32,1
31281,465,228,237,64,42,63,24,922,418,504,120,120,106,31,1
31282,424,197,227,67,62,43,17,217,109,108,34,32,35,7,1
31283,1461,741,720,176,155,140,45,580,316,264,87,45,49,43,1
31284,1016,501,515,109,71,76,37,2556,1169,1387,248,291,227,275,1
31285,1058,558,500,132,127,121,53,1508,733,775,216,186,172,60,1
31286,806,436,370,101,100,76,34,559,239,320,57,73,48,28,1
31287,316,161,155,46,50,39,16,1117,423,694,182,134,88,31,1
31288,526,254,272,44,43,49,13,1382,689,693,186,176,167,77,1
31289,334,172,162,43,39,41,17,826,362,464,107,118,71,43,1
31290,160,91,69,13,28,11,13,175,91,84,19,21,21,10,1
31291,540,265,275,87,59,74,25,1382,689,693,186,176,167,77,1
31292,413,227,186,45,34,58,23,217,109,108,34,32,35,7,1
31293,393,223,170,44,36,32,14,655,328,327,65,54,55,35,1
31294,462,224,238,77,75,37,13,866,503,363,97,94,116,39,1
31295,546,267,279,90,69,56,19,770,374,396,95,91,79,41,1
31296,840,468,372,96,85,121,29,381,184,197,40,33,33,21,1
31297,307,150,157,44,23,30,13,695,340,355,79,124,53,13,1
31298,303,137,166,54,54,31,15,371,188,183,43,67,35,14,1
31299,475,238,237,73,53,63,17,246,125,121,33,31,34,18,1
31300,477,228,249,72,63,47,33,518,235,283,94,77,55,22,1
31301,370,173,197,65,57,42,10,489,242,247,83,63,62,19,1
31302,607,311,296,73,81,33,33,792,407,385,110,132,82,43,1
31303,346,183,163,51,38,23,6,372,179,193,50,52,33,6,1
31304,476,233,243,76,61,52,21,393,186,207,58,50,36,22,1
31305,465,218,247,64,51,50,42,926,435,491,133,132,85,17,1
31306,1190,638,552,162,95,112,18,552,264,288,82,64,48,20,1
31307,743,341,402,104,89,68,38,3685,1574,2111,579,580,303,116,1
31308,539,279,260,72,64,19,24,377,201,176,46,50,41,23,1
31309,745,355,390,99,85,62,19,684,353,331,95,98,77,38,1
31310,360,192,168,55,45,48,16,182,114,68,13,22,25,8,1
31311,1807,933,874,248,203,173,71,246,113,133,33,45,22,10,1
31312,208,96,112,31,32,13,9,398,200,198,68,43,51,14,1
31313,1290,629,661,191,187,167,55,217,109,108,34,32,35,7,1
31314,357,169,188,61,53,32,15,526,254,272,44,43,49,13,1
31315,706,354,352,82,61,32,30,284,128,156,48,29,34,8,1
31316,1307,594,713,179,208,102,41,160,53,107,31,29,13,3,1
31317,160,67,93,32,37,15,9,639,292,347,95,92,83,20,1
31318,249,90,159,29,89,12,4,784,393,391,117,102,65,35,1
31319,277,173,104,26,12,48,19,592,283,309,84,137,60,20,1
31320,428,248,180,44,39,28,9,2442,1193,1249,278,183,170,145,1
31321,1363,690,673,185,172,152,62,825,363,462,97,105,72,75,1
31322,465,225,240,65,44,65,25,570,261,309,78,72,60,23,1
31323,283,142,141,35,29,32,5,782,421,361,101,97,82,20,1
31324,1007,523,484,116,113,117,43,926,437,489,135,107,113,42,1
31325,298,138,160,50,37,22,6,245,112,133,32,45,20,10,1
31326,608,336,272,61,49,78,31,2442,1193,1249,278,183,170,145,1
31327,1450,638,812,220,196,18,18,261,130,131,27,41,19,16,1
31328,544,295,249,84,56,49,14,461,227,234,61,47,54,33,1
31329,782,421,361,101,97,82,20,375,202,173,46,49,41,23,1
31330,455,191,264,68,86,21,19,464,236,228,64,56,53,28,1
31331,360,218,142,39,26,50,18,906,485,421,112,98,112,39,1
31332,806,436,370,101,100,76,34,124,62,62,22,14,14,8,1
31333,647,282,365,104,90,53,27,520,231,289,89,59,58,26,1
31334,345,141,204,64,58,13,11,920,492,428,100,92,88,49,1
31335,1094,508,586,152,151,77,36,388,199,189,50,51,33,14,1
31336,962,430,532,109,142,61,34,1859,935,924,240,243,170,88,1
31337,360,192,168,55,45,48,16,565,291,274,61,80,59,31,1
31338,178,91,87,20,21,12,5,537,276,261,75,68,68,22,1
31339,1367,690,677,172,175,154,83,912,461,451,127,109,96,48,1
31340,360,181,179,40,54,25,18,330,157,173,56,42,51,8,1
31341,1597,710,887,241,219,146,69,208,101,107,38,28,24,7,1
31342,425,210,215,56,43,52,25,840,385,455,118,137,66,39,1
31343,339,170,169,32,17,24,13,1523,758,765,188,183,157,58,1
31344,653,304,349,102,84,93,28,149,68,81,15,38,11,10,1
31345,294,146,148,50,45,51,15,467,250,217,59,52,41,19,1
31346,316,157,159,45,38,22,19,1970,978,992,245,206,198,80,1
31347,442,228,214,44,53,39,18,1087,480,607,155,179,99,28,1
31348,558,306,252,83,67,64,20,89,42,47,16,12,15,6,1
31349,505,254,251,80,77,60,15,1030,604,426,115,88,130,45,1
31350,606,307,299,92,56,68,30,724,334,390,112,109,79,17,1
31351,393,186,207,58,50,36,22,525,299,226,54,54,51,19,1
31352,447,276,171,51,21,38,25,115,62,53,17,12,8,7,1
31353,407,225,182,58,44,44,22,509,254,255,67,55,52,35,1
31354,195,100,95,27,20,17,11,245,137,108,34,30,19,10,1
31355,323,162,161,44,28,43,14,817,425,392,120,102,83,26,1
31356,913,412,501,131,100,117,83,406,219,187,44,39,52,20,1
31357,522,265,257,35,39,38,8,626,272,354,96,80,71,36,1
31358,1406,676,730,210,164,160,73,354,140,214,55,50,31,18,1
31359,97,55,42,15,13,11,2,381,220,161,43,34,47,16,1
31360,211,94,117,35,35,29,8,531,260,271,97,68,47,11,1
31361,209,75,134,53,48,20,9,318,164,154,52,43,34,10,1
31362,534,266,268,86,62,37,14,390,175,215,53,61,26,22,1
31363,334,171,163,48,42,32,18,367,195,172,57,54,43,16,1
31364,832,428,404,131,89,88,38,497,185,312,63,92,38,28,1
31365,763,343,420,127,70,105,34,655,328,327,65,54,55,35,1
31366,677,245,432,129,155,72,11,806,436,370,101,100,76,34,1
31367,345,155,190,49,56,23,6,255,122,133,35,51,22,13,1
31368,1395,627,768,172,263,141,59,173,88,85,20,21,9,12,1
31369,260,133,127,43,32,39,3,1259,705,554,174,158,123,34,1
31370,1465,716,749,213,205,172,55,381,186,195,69,55,46,15,1
31371,236,110,126,31,39,10,8,395,197,198,44,57,27,18,1
31372,245,137,108,34,30,19,10,959,496,463,144,132,75,35,1
31373,624,204,420,166,101,32,13,391,208,183,65,49,57,17,1
31374,393,186,207,58,50,36,22,778,367,411,90,85,64,43,1
31375,428,248,180,44,39,28,9,155,85,70,17,16,4,8,1
31376,277,128,149,40,47,15,6,779,370,409,111,105,73,37,1
31377,1401,670,731,174,122,153,57,467,224,243,70,43,67,23,1
31378,376,176,200,31,53,27,8,339,170,169,32,17,24,13,1
31379,160,86,74,21,11,16,16,1150,585,565,162,148,102,36,1
31380,1551,789,762,222,210,127,47,211,114,97,32,24,19,10,1
31381,458,269,189,56,40,29,7,130,55,75,21,26,10,3,1
31382,802,449,353,102,87,82,29,206,129,77,27,15,21,6,1
31383,1005,540,465,133,101,106,55,205,101,104,34,25,34,8,1
31384,918,427,491,113,111,113,33,1097,526,571,131,134,120,43,1
31385,1070,602,468,124,131,76,21,601,313,288,42,48,25,36,1
31386,186,110,76,26,22,32,14,452,230,222,64,61,31,27,1
31387,394,202,192,44,43,38,28,1675,875,800,213,219,196,72,1
31388,360,192,168,55,45,48,16,357,153,204,84,62,39,2,1
31389,385,255,130,37,20,42,16,622,299,323,86,86,69,35,1
31390,595,272,323,111,107,54,28,914,453,461,112,115,79,29,1
31391,495,218,277,94,62,58,19,632,280,352,111,96,55,16,1
31392,379,203,176,55,48,45,16,382,200,182,53,36,51,16,1
31393,209,78,131,33,42,11,7,260,133,127,43,29,34,11,1
31394,437,225,212,61,57,66,12,1009,478,531,166,126,96,42,1
31395,368,175,193,72,43,39,15,1149,568,581,177,133,101,30,1
31396,673,313,360,101,101,46,17,534,266,268,86,62,37,14,1
31397,451,239,212,53,64,56,22,635,333,302,99,75,83,28,1
31398,496,269,227,67,55,37,19,537,276,261,75,68,68,22,1
31399,131,74,57,17,14,12,4,167,79,88,22,26,16,9,1
31400,902,526,376,94,103,78,23,245,112,133,32,45,20,10,1
31401,220,113,107,37,24,16,7,126,57,69,31,10,10,3,1
31402,308,146,162,42,39,24,12,4655,2074,2581,545,652,562,399,1
31403,508,267,241,43,35,25,17,538,252,286,77,87,53,30,1
31404,851,446,405,93,94,92,37,366,213,153,48,27,42,17,1
31405,396,150,246,103,64,38,3,885,339,546,159,135,81,49,1
31406,185,115,70,19,17,26,6,205,104,101,28,28,35,13,1
31407,825,399,426,128,128,77,32,361,167,194,55,35,41,11,1
31408,706,346,360,118,92,98,56,480,234,246,79,77,65,23,1
31409,160,60,100,23,40,19,11,984,461,523,109,89,91,52,1
31410,150,74,76,21,22,18,7,354,169,185,54,54,41,19,1
31411,125,58,67,34,14,6,2,1051,523,528,164,140,126,50,1
31412,754,301,453,139,95,99,45,485,190,295,94,55,57,29,1
31413,745,391,354,85,81,52,39,205,104,101,28,28,35,13,1
31414,1382,689,693,186,176,167,77,149,68,81,15,38,11,10,1
31415,851,417,434,109,116,83,28,750,347,403,105,103,83,29,1
31416,686,345,341,98,106,75,25,639,368,271,72,51,38,38,1
31417,267,124,143,45,46,26,4,145,75,70,22,18,10,5,1
31418,181,96,85,25,23,20,7,698,365,333,108,83,65,21,1
31419,400,203,197,30,36,31,10,318,176,142,25,32,35,25,1
31420,229,120,109,31,30,22,9,456,247,209,68,46,42,14,1
31421,559,266,293,85,78,74,17,985,535,450,98,87,135,54,1
31422,909,455,454,137,82,85,68,297,145,152,49,30,23,21,1
31423,932,471,461,137,86,84,32,149,68,81,15,38,11,10,1
31424,1914,892,1022,272,267,143,79,377,202,175,46,50,41,22,1
31425,777,387,390,90,87,65,37,1390,695,695,180,137,170,71,1
31426,359,184,175,49,35,32,11,1366,943,423,137,109,58,19,1
31427,386,180,206,47,45,21,23,281,132,149,38,32,38,14,1
31428,350,215,135,36,21,48,14,409,200,209,69,56,44,13,1
31429,1118,471,647,204,164,102,34,245,111,134,31,44,20,11,1
31430,1257,525,732,216,210,79,52,876,407,469,137,130,73,29,1
31431,676,333,343,111,89,94,39,391,223,168,35,26,47,31,1
31432,736,388,348,88,85,67,28,352,178,174,52,56,36,20,1
31433,1170,510,660,142,182,115,84,1838,1168,670,185,225,103,35,1
31434,595,316,279,86,60,65,40,490,224,266,80,70,39,32,1
31435,461,217,244,44,41,27,36,430,192,238,62,67,27,10,1
31436,607,335,272,90,65,97,23,4544,2024,2520,579,628,480,403,1
31437,286,130,156,42,43,38,7,665,297,368,111,107,34,12,1
31438,1336,828,508,166,121,152,48,1675,875,800,213,219,196,72,1
31439,639,298,341,77,61,70,20,152,74,78,16,20,16,5,1
31440,193,96,97,32,31,16,11,439,227,212,60,55,58,8,1
31441,767,392,375,113,112,83,13,4544,2024,2520,579,628,480,403,1
31442,601,290,311,92,89,55,30,360,188,172,49,48,47,17,1
31443,248,119,129,33,48,20,10,218,127,91,27,23,23,10,1
31444,984,459,525,150,145,89,37,1290,629,661,191,187,167,55,1
31445,270,128,142,36,43,15,11,146,71,75,20,17,8,7,1
31446,726,312,414,121,73,82,23,848,394,454,100,90,101,41,1
31447,516,227,289,75,36,54,28,592,295,297,79,70,76,11,1
31448,205,101,104,34,25,34,8,983,487,496,126,115,104,52,1
31449,452,213,239,79,69,39,18,171,107,64,14,12,16,9,1
31450,450,215,235,73,72,53,18,519,244,275,76,90,44,16,1
31451,1441,657,784,140,135,81,73,331,169,162,40,28,22,14,1
31452,462,251,211,74,53,41,18,265,103,162,61,58,25,3,1
31453,402,205,197,62,48,38,19,349,167,182,54,38,30,28,1
31454,1441,657,784,140,135,81,73,533,297,236,74,57,39,28,1
31455,947,482,465,143,107,89,37,745,366,379,110,93,79,45,1
31456,529,283,246,66,69,66,25,418,204,214,68,66,38,12,1
31457,876,457,419,88,124,67,47,297,145,152,49,30,23,21,1
31458,380,187,193,38,51,30,18,631,315,316,64,57,49,15,1
31459,579,285,294,81,79,70,26,186,91,95,30,22,18,7,1
31460,445,230,215,64,62,50,20,207,99,108,34,27,22,9,1
31461,759,365,394,134,108,85,35,198,80,118,35,31,14,7,1
31462,1374,679,695,191,193,154,48,246,113,133,33,45,22,10,1
31463,477,301,176,52,35,45,24,355,168,187,48,57,30,15,1
31464,350,180,170,64,46,55,12,323,200,123,33,25,38,18,1
31465,354,166,188,53,55,40,19,472,263,209,57,39,60,29,1
31466,189,88,101,31,29,18,10,379,184,195,51,61,49,8,1
31467,340,176,164,50,50,33,13,910,431,479,138,103,98,41,1
31468,393,186,207,58,50,36,22,437,212,225,66,44,44,11,1
31469,648,307,341,101,58,76,34,246,113,133,33,45,22,10,1
31470,1114,581,533,145,132,126,54,427,164,263,62,80,14,10,1
31471,615,312,303,86,54,75,45,644,329,315,70,64,50,11,1
31472,205,91,114,31,36,13,8,168,90,78,22,19,13,4,1
31473,344,151,193,59,51,30,9,859,429,430,126,115,64,33,1
31474,1048,564,484,118,122,113,40,425,244,181,38,26,60,26,1
31475,540,257,283,81,63,57,24,158,85,73,24,18,18,8,1
31476,440,214,226,59,62,27,28,480,232,248,83,64,51,25,1
31477,1475,658,817,149,114,120,43,1071,549,522,133,127,130,59,1
31478,323,123,200,59,69,30,15,290,127,163,47,58,23,12,1
31479,557,282,275,77,61,68,23,285,148,137,31,42,42,16,1
31480,382,183,199,55,60,38,22,480,234,246,79,77,65,23,1
31481,707,391,316,111,80,54,30,181,80,101,27,18,17,11,1
31482,537,276,261,75,68,68,22,561,292,269,88,68,64,22,1
31483,207,108,99,25,15,27,16,469,247,222,70,58,82,13,1
31484,220,102,118,26,32,27,10,656,292,364,79,102,69,35,1
31485,179,102,77,23,20,6,3,1043,445,598,169,153,117,52,1
31486,870,433,437,133,121,95,25,2016,1107,909,214,229,238,111,1
31487,859,429,430,126,115,64,33,687,353,334,84,96,74,31,1
31488,754,318,436,114,106,58,28,791,391,400,103,94,59,38,1
31489,724,334,390,112,109,79,17,635,333,302,99,75,83,28,1
31490,421,192,229,72,54,51,48,435,229,206,58,48,49,24,1
31491,1225,593,632,158,125,102,38,537,276,261,75,68,68,22,1
31492,341,178,163,48,44,42,20,551,237,314,95,79,54,17,1
31493,316,157,159,45,38,22,19,331,169,162,40,28,22,14,1
31494,1113,480,633,170,173,81,34,168,70,98,19,30,8,12,1
31495,355,179,176,51,45,45,11,366,191,175,37,33,19,19,1
31496,327,160,167,56,31,36,15,428,226,202,52,60,75,20,1
31497,1242,613,629,174,113,114,53,540,265,275,87,59,74,25,1
31498,474,214,260,73,58,53,17,342,160,182,69,40,37,16,1
31499,969,505,464,123,133,92,33,325,152,173,43,47,28,17,1
31500,1009,506,503,146,141,97,55,1074,538,536,154,140,111,51,1
31501,205,101,104,34,25,34,8,976,520,456,120,115,109,53,1
31502,881,419,462,132,82,81,24,1049,530,519,102,125,89,48,1
31503,118,56,62,13,14,6,6,524,361,163,41,8,28,16,1
31504,149,68,81,15,38,11,10,550,309,241,65,50,87,31,1
31505,504,272,232,72,41,57,23,2442,1193,1249,278,183,170,145,1
31506,797,394,403,109,89,83,40,455,218,237,57,51,42,35,1
31507,211,114,97,32,24,19,10,502,299,203,57,52,32,11,1
31508,169,64,105,23,37,11,3,150,60,90,27,16,6,3,1
31509,2542,1245,1297,285,287,170,84,368,141,227,64,61,24,13,1
31510,171,94,77,24,28,30,11,152,67,85,26,23,14,6,1
31511,838,431,407,107,90,107,43,427,204,223,38,57,26,32,1
31512,1132,553,579,172,143,150,57,217,109,108,34,32,35,7,1
31513,604,275,329,95,69,52,25,246,115,131,15,29,10,32,1
31514,196,107,89,19,18,15,7,619,332,287,95,77,74,38,1
31515,508,266,242,81,62,49,22,326,153,173,63,48,25,8,1
31516,374,184,190,52,38,48,11,525,237,288,121,59,105,20,1
31517,476,227,249,52,59,38,17,217,109,108,34,32,35,7,1
31518,190,94,96,25,24,18,5,195,90,105,28,27,22,8,1
31519,394,202,192,44,43,38,28,2511,1400,1111,295,265,244,89,1
31520,536,278,258,72,63,62,20,756,348,408,101,103,60,40,1
31521,2602,1424,1178,314,320,249,75,467,269,198,46,51,60,18,1
31522,1210,592,618,157,138,116,85,536,226,310,93,63,62,26,1
31523,426,224,202,48,38,53,13,467,226,241,55,48,54,23,1
31524,3224,1440,1784,455,440,333,126,364,222,142,33,18,57,22,1
31525,920,492,428,100,92,88,49,2414,1189,1225,277,178,170,169,1
31526,404,231,173,44,43,24,10,94,45,49,11,20,10,4,1
31527,142,76,66,21,21,22,11,265,103,162,61,58,25,3,1
31528,456,228,228,49,70,32,19,666,344,322,91,73,91,20,1
31529,369,196,173,52,44,27,22,282,154,128,43,32,22,15,1
31530,1210,592,618,157,138,116,85,303,158,145,47,40,41,12,1
31531,281,133,148,41,32,16,12,462,228,234,59,47,37,32,1
31532,295,139,156,48,31,30,17,497,185,312,63,92,38,28,1
31533,504,272,232,75,57,53,19,215,115,100,27,28,34,16,1
31534,278,137,141,47,32,28,20,1068,539,529,161,134,132,71,1
31535,165,90,75,36,18,20,6,671,318,353,83,124,46,34,1
31536,140,71,69,15,13,11,10,328,178,150,36,34,16,14,1
31537,212,107,105,29,26,25,8,241,128,113,31,27,27,21,1
31538,593,295,298,70,85,48,13,338,188,150,45,41,31,18,1
31539,1091,543,548,146,136,110,34,825,363,462,97,105,72,75,1
31540,473,212,261,72,64,45,28,245,111,134,31,44,20,11,1
31541,1172,545,627,156,135,85,96,1193,532,661,160,154,90,90,1
31542,868,448,420,108,103,76,25,352,166,186,55,59,31,16,1
31543,1441,657,784,140,135,81,73,446,265,181,51,35,27,17,1
31544,391,208,183,65,49,57,17,314,108,206,45,75,34,8,1
31545,392,160,232,68,70,19,8,247,110,137,34,45,23,10,1
31546,478,229,249,85,72,58,21,490,216,274,67,77,52,21,1
31547,230,123,107,29,25,28,8,113,66,47,11,9,6,5,1
31548,362,174,188,46,55,35,23,461,217,244,44,41,27,36,1
31549,777,387,390,90,87,65,37,724,334,390,112,109,79,17,1
31550,425,210,215,56,43,52,25,605,283,322,94,72,64,39,1
31551,315,150,165,49,59,23,15,452,230,222,64,61,31,27,1
31552,224,108,116,31,32,22,8,149,68,81,15,38,11,10,1
31553,387,200,187,61,54,51,16,149,68,81,15,38,11,10,1
31554,3056,1457,1599,438,389,329,168,754,318,436,114,106,58,28,1
31555,471,255,216,66,68,81,16,615,312,303,86,54,75,45,1
31556,1462,652,810,243,199,115,30,4655,2074,2581,545,652,562,399,1
31557,642,271,371,106,111,57,23,568,292,276,69,74,59,34,1
31558,199,113,86,27,17,10,7,140,70,70,22,17,9,4,1
31559,391,222,169,46,36,30,9,318,176,142,25,32,35,25,1
31560,2414,1189,1225,277,178,170,169,436,201,235,54,37,34,20,1
31561,351,184,167,59,45,54,9,1159,641,518,148,115,114,48,1
31562,201,108,93,36,21,17,4,305,166,139,42,38,28,12,1
31563,541,269,272,75,57,59,36,327,177,150,56,20,25,6,1
31564,1086,603,483,147,121,95,40,1675,875,800,213,219,196,72,1
31565,564,313,251,74,62,61,22,1863,721,1142,262,283,139,74,1
31566,784,373,411,101,90,91,37,375,214,161,38,36,24,17,1
31567,478,223,255,80,81,41,24,379,203,176,55,48,45,16,1
31568,217,109,108,34,32,35,7,553,261,292,73,79,40,26,1
31569,298,181,117,43,23,40,12,625,313,312,103,90,74,29,1
31570,822,392,430,125,104,79,24,799,377,422,98,95,80,70,1
31571,280,118,162,35,32,41,37,632,326,306,92,71,56,19,1
31572,646,298,348,91,110,63,33,560,260,300,100,58,29,28,1
31573,33423,16370,17053,4965,4756,2786,883,175,86,89,33,25,27,2,1
31574,353,156,197,35,57,28,43,627,351,276,78,62,71,32,1
31575,1724,845,879,217,223,179,73,893,469,424,126,135,68,14,1
31576,283,144,139,35,25,36,10,859,395,464,157,119,59,31,1
31577,249,138,111,32,29,21,8,859,395,464,157,119,59,31,1
31578,152,74,78,16,20,16,5,131,66,65,21,14,23,7,1
31579,418,189,229,76,72,45,14,502,240,262,78,61,54,32,1
31580,1786,793,993,213,271,163,159,1028,576,452,128,139,79,31,1
31581,167,86,81,21,21,11,11,450,242,208,53,63,56,22,1
31582,497,270,227,64,43,62,22,397,210,187,46,41,48,20,1
31583,580,339,241,72,47,66,21,703,356,347,96,97,38,22,1
31584,687,353,334,84,96,74,31,2477,1186,1291,256,271,249,90,1
31585,579,330,249,52,27,90,11,407,244,163,42,32,50,12,1
31586,638,300,338,83,53,81,49,297,145,152,49,30,23,21,1
31587,582,328,254,78,48,35,9,215,80,135,54,56,21,9,1
31588,277,124,153,44,40,35,18,984,459,525,150,145,89,37,1
31589,872,473,399,124,100,93,27,149,68,81,15,38,11,10,1
31590,1290,597,693,182,182,119,63,274,158,116,27,27,22,18,1
31591,1162,548,614,191,166,142,38,718,283,435,126,127,34,29,1
31592,570,318,252,77,48,93,26,1657,800,857,249,235,154,51,1
31593,1721,809,912,268,234,144,50,424,209,215,56,58,45,24,1
31594,498,278,220,55,42,63,26,468,257,211,57,50,61,18,1
31595,108,51,57,16,12,16,11,163,71,92,22,38,11,7,1
31596,472,263,209,61,56,56,18,368,185,183,61,41,56,8,1
31597,361,184,177,50,53,51,22,304,127,177,61,38,31,4,1
31598,551,237,314,95,79,54,17,854,380,474,137,159,81,31,1
31599,68,34,34,11,8,3,4,395,186,209,53,48,46,30,1
31600,501,247,254,53,63,57,17,737,374,363,100,95,103,29,1
31601,346,208,138,46,39,51,18,771,321,450,151,135,43,15,1
31602,781,418,363,92,90,64,41,906,437,469,135,132,49,40,1
31603,429,198,231,62,78,42,15,1037,461,576,146,163,75,44,1
31604,686,375,311,89,80,63,20,400,203,197,30,36,31,10,1
31605,756,366,390,83,146,47,23,175,90,85,28,21,19,7,1
31606,447,222,225,71,54,44,25,468,233,235,65,61,49,34,1
31607,261,130,131,27,41,19,16,363,178,185,54,48,21,13,1
31608,246,108,138,32,44,21,10,863,417,446,130,112,53,29,1
31609,160,60,100,23,40,19,11,340,172,168,60,50,36,10,1
31610,412,202,210,64,46,43,34,217,109,108,34,32,35,7,1
31611,536,278,258,72,63,62,20,648,307,341,101,58,76,34,1
31612,625,293,332,74,71,50,40,1675,875,800,213,219,196,72,1
31613,1085,471,614,181,156,110,46,193,99,94,31,31,16,12,1
31614,246,108,138,32,44,21,10,568,235,333,109,106,50,29,1
31615,73,29,44,15,16,3,4,757,373,384,115,93,95,25,1
31616,683,341,342,107,77,93,43,769,362,407,99,88,66,67,1
31617,247,110,137,34,45,23,10,2225,1244,981,271,243,217,93,1
31618,309,137,172,51,50,28,14,437,228,209,47,61,26,11,1
31619,429,219,210,46,66,42,17,299,164,135,37,29,28,11,1
31620,178,100,78,23,22,30,6,1333,646,687,209,179,148,45,1
31621,211,83,128,28,35,5,11,366,211,155,35,42,24,12,1
31622,1265,580,685,205,188,166,53,631,309,322,106,83,89,33,1
31623,211,113,98,38,17,25,8,1124,615,509,157,125,128,52,1
31624,426,228,198,62,42,47,22,505,273,232,70,57,60,33,1
31625,501,240,261,80,62,49,42,522,235,287,78,67,60,50,1
31626,431,220,211,71,49,42,16,465,218,247,64,51,50,42,1
31627,1068,494,574,176,155,81,27,1037,461,576,146,163,75,44,1
31628,535,249,286,79,64,55,22,503,263,240,72,55,51,34,1
31629,246,108,138,32,44,21,10,372,179,193,50,52,33,6,1
31630,316,161,155,46,50,39,16,769,329,440,116,66,55,22,1
31631,457,261,196,55,27,57,34,770,390,380,104,76,78,32,1
31632,593,305,288,86,67,76,23,744,384,360,104,96,57,31,1
31633,277,124,153,44,40,35,18,1863,721,1142,262,283,139,74,1
31634,178,100,78,23,22,30,6,864,429,435,129,118,68,35,1
31635,370,205,165,50,41,54,18,152,87,65,20,19,14,5,1
31636,636,288,348,94,77,65,30,846,356,490,102,79,88,34,1
31637,603,311,292,102,71,66,23,445,225,220,47,62,53,26,1
31638,220,113,107,31,21,25,12,562,283,279,48,32,63,13,1
31639,415,189,226,69,54,50,21,876,457,419,88,124,67,47,1
31640,349,183,166,56,55,38,5,727,259,468,163,157,68,15,1
31641,500,242,258,53,48,44,18,562,265,297,79,56,72,45,1
31642,134,72,62,14,28,8,4,561,281,280,80,71,36,14,1
31643,168,76,92,26,21,19,4,246,113,133,33,45,22,10,1
31644,1182,599,583,162,130,106,41,203,119,83,22,21,19,9,1
31645,365,180,185,63,35,48,19,590,298,292,73,45,71,25,1
31646,241,127,114,34,33,29,12,437,225,212,61,57,66,12,1
31647,949,512,437,102,124,70,41,3056,1457,1599,438,389,329,168,1
31648,360,192,168,55,45,48,16,648,307,341,101,58,76,34,1
31649,457,220,237,78,79,45,23,716,364,352,107,80,75,26,1
31650,920,492,428,100,92,88,49,129,72,57,19,12,8,8,1
31651,355,165,190,53,56,42,19,350,220,130,32,18,45,17,1
31652,372,199,173,56,45,40,15,393,210,183,55,50,34,19,1
31653,881,383,498,142,148,77,24,245,111,134,31,44,20,11,1
31654,349,186,163,43,45,51,12,428,226,202,52,60,75,20,1
31655,345,203,142,47,35,31,11,505,226,279,68,51,30,15,1
31656,933,536,397,96,90,71,41,595,316,279,86,60,65,40,1
31657,245,110,135,42,32,29,9,100,48,52,8,15,5,7,1
31658,579,330,249,52,27,90,11,1208,565,643,182,162,120,57,1
31659,859,395,464,157,119,59,31,770,356,414,123,102,66,25,1
31660,831,334,497,163,167,49,22,961,507,454,130,102,115,37,1
31661,472,259,213,51,44,56,21,537,276,261,75,68,68,22,1
31662,825,363,462,97,105,72,75,272,149,123,46,14,27,16,1
31663,4303,2489,1814,436,369,444,134,2541,1299,1242,306,302,121,98,1
31664,554,251,303,88,59,47,25,103,56,47,27,7,8,2,1
31665,258,88,170,68,67,14,4,671,318,353,83,124,46,34,1
31666,701,368,333,90,81,39,27,1573,791,782,198,173,148,46,1
31667,501,240,261,80,62,49,42,574,295,279,78,65,61,22,1
31668,589,281,308,69,39,63,20,433,237,196,60,52,33,27,1
31669,244,136,108,21,25,25,13,480,234,246,79,77,65,23,1
31670,397,196,201,64,59,42,15,776,346,430,103,102,61,40,1
31671,298,167,131,47,33,40,8,1863,721,1142,262,283,139,74,1
31672,317,153,164,34,52,30,14,356,199,157,43,58,29,12,1
31673,1086,603,483,147,121,95,40,447,228,219,53,60,46,22,1
31674,262,151,111,30,17,32,25,641,318,323,69,61,41,19,1
31675,504,237,267,62,66,48,17,236,145,91,17,19,30,18,1
31676,1069,512,557,148,126,84,36,101,41,60,18,19,10,5,1
31677,971,516,455,114,115,116,35,128,57,71,26,20,12,3,1
31678,399,222,177,48,44,52,23,1663,835,828,224,213,163,63,1
31679,817,425,392,120,102,83,26,1205,632,573,156,149,102,48,1
31680,217,115,102,40,24,26,6,215,117,98,43,22,27,5,1
31681,461,207,254,82,66,55,33,2540,1065,1475,426,322,239,78,1
31682,416,201,215,54,52,39,25,501,240,261,80,62,49,42,1
31683,1074,538,536,154,140,111,51,1242,613,629,174,113,114,53,1
31684,427,164,263,62,80,14,10,427,218,209,56,57,53,24,1
31685,636,380,256,59,60,65,24,427,218,209,61,53,45,26,1
31686,313,160,153,51,33,43,23,346,191,155,52,38,40,13,1
31687,138,80,58,22,20,8,6,303,175,128,43,36,34,12,1
31688,330,190,140,42,21,30,13,436,205,231,39,51,26,20,1
31689,331,183,148,36,44,40,21,656,292,364,79,102,69,35,1
31690,821,394,427,122,117,109,38,386,189,197,54,57,39,16,1
31691,560,244,316,92,118,47,12,551,298,253,63,65,45,19,1
31692,640,339,301,70,64,90,41,1342,675,667,162,154,123,39,1
31693,862,427,435,139,98,100,59,593,257,336,76,56,56,96,1
31694,548,250,298,85,64,56,21,433,220,213,67,68,31,19,1
31695,420,205,215,60,44,52,21,460,223,237,61,65,45,22,1
31696,347,212,135,35,32,17,6,615,339,276,82,76,63,16,1
31697,1534,735,799,174,152,134,126,1651,798,853,203,199,137,50,1
31698,1103,651,452,144,118,96,44,92,40,52,14,23,13,7,1
31699,2442,1193,1249,278,183,170,145,557,250,307,70,47,51,22,1
31700,297,158,139,47,37,37,9,1058,557,501,128,128,115,43,1
31701,186,101,85,18,23,17,5,201,78,123,42,47,19,8,1
31702,502,299,203,57,52,32,11,782,347,435,110,92,74,34,1
31703,651,331,320,93,93,51,28,410,175,235,73,61,37,27,1
31704,184,131,53,15,15,16,5,450,233,217,68,45,45,17,1
31705,1117,556,561,188,117,110,48,1068,527,541,160,131,112,52,1
31706,687,353,334,84,96,74,31,491,270,221,51,47,53,18,1
31707,509,243,266,80,57,45,19,1356,672,684,171,172,134,59,1
31708,299,158,141,45,31,21,5,320,163,157,44,44,26,15,1
31709,352,183,169,41,40,38,26,1474,756,718,175,158,169,51,1
31710,307,133,174,48,53,27,10,748,360,388,101,89,82,36,1
31711,712,396,316,78,69,65,25,427,218,209,61,53,45,26,1
31712,2472,1055,1417,416,458,235,64,238,95,143,37,55,4,4,1
31713,810,367,443,115,92,94,59,525,237,288,121,59,105,20,1
31714,680,308,372,81,72,70,40,486,236,250,73,67,59,16,1
31715,1432,652,780,217,205,131,81,469,253,216,49,51,48,18,1
31716,89,42,47,16,12,15,6,466,260,206,62,44,56,19,1
31717,427,191,236,67,60,41,34,341,178,163,48,44,42,20,1
31718,462,233,229,66,49,43,30,446,265,181,51,35,27,17,1
31719,2440,1061,1379,377,326,172,62,595,316,279,86,60,65,40,1
31720,522,283,239,65,64,76,22,377,202,175,46,50,41,23,1
31721,265,183,82,22,17,41,7,467,269,198,46,51,60,18,1
31722,548,236,312,88,88,63,25,320,143,177,51,51,24,10,1
31723,119,67,52,15,15,7,7,604,255,349,100,72,55,26,1
31724,536,278,258,72,63,62,20,860,427,433,132,100,81,30,1
31725,272,173,99,32,32,11,8,282,135,147,36,49,25,10,1
31726,1048,564,484,118,122,113,40,788,360,428,93,106,67,72,1
31727,1132,553,579,172,143,150,57,1400,800,600,158,134,150,65,1
31728,301,150,151,41,30,17,11,600,281,319,98,68,38,13,1
31729,301,150,151,41,30,17,11,464,225,239,85,57,65,19,1
31730,146,75,71,13,32,15,11,419,184,235,66,43,50,28,1
31731,142,69,73,20,27,9,6,187,75,112,41,32,17,11,1
31732,168,67,101,37,17,13,13,375,202,173,46,49,41,23,1
31733,312,163,149,45,47,24,12,666,370,296,84,61,99,51,1
31734,344,168,176,50,39,30,20,336,140,196,51,44,27,18,1
31735,624,204,420,166,101,32,13,395,198,197,55,55,36,10,1
31736,347,212,135,35,32,17,6,169,64,105,23,37,11,3,1
31737,656,358,298,67,47,64,26,192,104,88,24,14,24,14,1
31738,672,334,338,110,93,91,41,883,470,413,112,99,108,34,1
31739,1170,510,660,142,182,115,84,417,182,235,57,109,50,8,1
31740,459,212,247,63,48,48,28,177,99,78,22,23,20,10,1
31741,72,35,37,10,9,7,6,1117,423,694,182,134,88,31,1
31742,1331,657,674,159,137,182,58,921,455,466,144,127,108,39,1
31743,92,43,49,14,13,7,4,328,191,137,36,13,55,21,1
31744,1150,585,565,162,148,102,36,2113,1079,1034,268,209,196,65,1
31745,298,160,138,37,30,22,12,201,98,103,26,35,16,5,1
31746,168,82,86,30,23,19,10,590,306,284,69,82,68,27,1
31747,394,183,211,65,60,35,18,928,442,486,139,118,91,43,1
31748,143,79,64,16,25,7,5,620,396,224,53,44,97,26,1
31749,576,293,283,64,49,62,18,246,128,118,39,34,22,7,1
31750,716,364,352,107,80,75,26,392,155,237,68,61,34,16,1
31751,1477,738,739,176,176,145,72,491,232,259,80,65,54,21,1
31752,245,110,135,42,32,29,9,557,245,312,81,96,72,48,1
31753,186,101,85,18,23,17,5,216,119,97,33,27,28,7,1
31754,224,103,121,34,47,11,9,199,87,112,31,27,8,15,1
31755,407,221,186,58,42,44,22,512,269,243,69,70,62,29,1
31756,527,260,267,76,69,46,16,448,236,212,53,64,56,24,1
31757,511,202,309,70,84,37,21,911,445,466,154,121,108,48,1
31758,391,208,183,65,49,57,17,919,444,475,141,148,62,20,1
31759,256,125,131,34,27,24,14,296,154,142,38,38,24,16,1
31760,432,188,244,76,81,26,13,467,269,198,46,51,60,18,1
31761,512,216,296,92,68,51,19,213,109,104,26,26,21,6,1
31762,467,240,227,65,65,51,23,969,505,464,123,133,92,33,1
31763,388,245,143,45,25,41,16,421,220,201,52,57,42,18,1
31764,246,108,138,32,44,21,10,1430,718,712,205,172,151,64,1
31765,914,401,513,110,125,64,37,427,218,209,56,57,53,24,1
31766,1798,844,954,277,212,142,53,1315,720,595,138,136,115,62,1
31767,94,58,36,10,9,7,8,122,52,70,24,22,7,6,1
31768,509,254,255,67,55,52,35,756,348,408,101,103,60,40,1
31769,467,226,241,55,48,54,23,259,123,136,36,40,33,12,1
31770,24,14,10,4,2,1,2,289,147,142,45,45,38,13,1
31771,903,437,466,117,112,108,32,839,444,395,107,95,104,39,1
31772,429,219,210,46,66,42,17,336,191,145,49,42,43,21,1
31773,262,144,118,19,39,22,8,533,254,279,81,78,52,10,1
31774,812,456,356,105,74,101,29,536,278,258,72,63,62,20,1
31775,352,179,173,54,46,35,22,379,203,176,55,48,45,16,1
31776,659,325,334,102,85,87,32,906,455,451,116,105,87,46,1
31777,782,421,361,101,97,82,20,377,202,175,46,50,41,23,1
31778,182,93,89,24,19,18,8,171,88,83,20,21,16,7,1
31779,1094,508,586,152,151,77,36,1050,482,568,136,154,101,41,1
31780,159,105,54,22,9,14,25,437,167,270,126,95,34,10,1
31781,920,492,428,100,92,88,49,628,341,287,77,59,55,31,1
31782,320,163,157,44,44,26,15,161,94,67,23,13,8,10,1
31783,215,115,100,27,28,34,16,393,186,207,58,50,36,22,1
31784,2414,1189,1225,277,178,170,169,403,220,183,57,39,45,11,1
31785,390,223,167,42,25,48,25,154,88,66,23,8,10,8,1
31786,140,71,69,33,11,14,2,1101,521,580,177,168,86,45,1
31787,187,75,112,41,32,17,11,125,58,67,20,16,10,5,1
31788,366,183,183,48,47,36,17,417,182,235,57,109,50,8,1
31789,102,61,41,15,13,8,2,240,125,115,34,32,30,8,1
31790,1024,510,514,152,122,131,52,410,208,202,59,58,43,26,1
31791,750,347,403,105,103,83,29,360,188,172,49,48,47,17,1
31792,95,41,54,15,16,8,5,404,197,207,60,48,47,20,1
31793,724,334,390,112,109,79,17,569,288,281,86,69,74,24,1
31794,435,208,227,68,64,53,23,536,278,258,72,63,62,20,1
31795,896,503,393,114,90,101,28,418,204,214,68,66,38,12,1
31796,556,259,297,75,69,63,38,145,70,75,24,16,16,20,1
31797,75,36,39,11,10,5,7,395,186,209,53,48,46,30,1
31798,422,213,209,63,60,35,13,467,250,217,59,52,41,19,1
31799,2231,1188,1043,225,189,188,118,1590,726,864,270,237,126,59,1
31800,500,319,181,49,33,65,26,385,194,191,49,50,40,12,1
31801,296,154,142,38,38,24,16,858,448,410,98,83,122,29,1
31802,544,259,285,76,81,40,20,1285,578,707,239,191,136,57,1
31803,922,491,431,112,92,97,52,149,68,81,15,38,11,10,1
31804,784,337,447,127,135,59,29,215,105,110,26,22,19,9,1
31805,350,212,138,32,26,40,13,215,80,135,54,56,21,9,1
31806,767,392,375,113,112,83,13,101,38,63,23,8,9,10,1
31807,459,221,238,52,56,51,19,177,85,92,30,21,18,12,1
31808,400,228,172,43,20,47,24,437,225,212,61,57,66,12,1
31809,395,222,173,48,42,21,8,172,91,81,35,13,18,8,1
31810,936,451,485,111,97,92,41,616,304,312,75,71,55,25,1
31811,447,225,222,76,35,75,21,1580,742,838,208,146,144,71,1
31812,2556,1169,1387,248,291,227,275,2414,1189,1225,277,178,170,169,1
31813,950,497,453,146,127,115,43,102,49,53,14,21,7,4,1
31814,126,57,69,31,10,10,3,142,72,70,16,20,17,11,1
31815,743,341,402,104,89,68,38,540,306,234,74,52,43,22,1
31816,632,285,347,102,78,43,29,448,236,212,53,64,56,24,1
31817,448,223,225,50,58,39,34,391,220,171,49,37,32,14,1
31818,156,74,82,24,18,16,22,444,212,232,74,25,60,24,1
31819,673,317,356,101,85,76,49,326,141,185,57,39,33,20,1
31820,458,210,248,39,38,25,16,467,226,241,55,48,54,23,1
31821,462,228,234,59,47,37,32,347,168,179,44,51,35,23,1
31822,261,130,131,27,41,19,16,297,158,139,47,37,37,9,1
31823,970,514,456,97,91,117,49,632,285,347,102,78,43,29,1
31824,439,220,219,63,72,25,20,287,124,163,52,48,24,16,1
31825,303,175,128,43,36,34,12,467,226,241,55,48,54,23,1
31826,545,230,315,91,101,50,16,512,261,251,79,73,60,21,1
31827,653,304,349,102,84,93,28,149,68,81,15,38,11,10,1
31828,642,271,371,106,111,57,23,703,356,347,96,97,38,22,1
31829,1190,638,552,162,95,112,18,459,238,221,49,37,67,28,1
31830,613,334,279,90,71,51,17,641,324,317,88,92,49,14,1
31831,262,151,111,30,17,32,25,863,450,413,116,122,106,41,1
31832,314,158,156,39,28,30,17,543,265,278,52,37,54,19,1
31833,424,197,227,67,62,43,17,525,245,280,59,72,47,21,1
31834,1210,592,618,157,138,116,85,920,492,428,100,92,88,49,1
31835,470,226,244,81,53,59,39,782,330,452,119,123,25,16,1
31836,257,157,100,30,12,40,16,661,361,300,65,82,57,15,1
31837,339,170,169,32,17,24,13,433,220,213,67,68,31,19,1
31838,619,293,326,98,78,65,22,245,112,133,32,45,20,10,1
31839,119,56,63,15,12,13,11,723,309,414,106,106,41,40,1
31840,870,489,381,97,99,76,14,1009,506,503,146,141,97,55,1
31841,555,264,291,83,62,48,19,723,335,388,90,84,77,74,1
31842,95,44,51,14,13,7,4,543,246,297,99,93,50,29,1
31843,168,67,101,37,17,13,13,919,376,543,129,122,55,30,1
31844,706,354,352,82,61,32,30,573,271,302,56,64,55,18,1
31845,171,94,77,24,28,30,11,771,321,450,151,135,43,15,1
31846,510,262,248,60,64,44,17,517,274,243,64,62,59,15,1
31847,1271,599,672,194,175,118,47,255,122,133,35,51,22,13,1
31848,2414,1189,1225,277,178,170,169,507,242,265,53,44,31,22,1
31849,313,159,154,30,40,23,14,236,120,116,19,16,23,8,1
31850,674,319,355,84,139,50,11,3969,1703,2266,619,432,259,144,1
31851,2492,894,1598,466,444,164,102,392,115,277,117,75,28,17,1
31852,480,234,246,79,77,65,23,598,322,276,67,57,63,26,1
31853,454,209,245,85,78,45,9,164,78,86,28,23,12,8,1
31854,818,417,401,100,92,55,37,181,80,101,27,18,17,11,1
31855,5038,2652,2386,655,729,544,245,1873,1066,807,217,201,237,105,1
31856,1674,699,975,311,277,134,51,467,224,243,70,43,67,23,1
31857,390,203,187,58,40,43,19,303,141,162,42,57,37,20,1
31858,843,422,421,127,113,79,31,685,315,370,108,99,36,9,1
31859,616,304,312,75,71,55,25,472,263,209,61,56,56,18,1
31860,210,121,89,22,23,23,7,252,128,124,46,31,18,8,1
31861,449,244,205,68,53,49,12,770,374,396,95,91,79,41,1
31862,641,341,300,101,91,29,22,390,191,199,66,49,43,12,1
31863,386,163,223,51,51,28,14,465,240,225,50,54,24,14,1
31864,808,366,442,130,133,66,31,904,436,468,138,146,82,39,1
31865,447,276,171,51,21,38,25,593,266,327,102,84,69,24,1
31866,297,158,139,47,37,37,9,107,36,71,27,15,0,1,1
31867,480,234,246,79,77,65,23,3144,1617,1527,367,342,278,136,1
31868,154,75,79,17,24,16,13,601,313,288,42,48,25,36,1
31869,469,225,244,61,40,43,50,764,372,392,109,94,85,36,1
31870,216,119,97,33,27,28,7,452,239,213,62,46,38,22,1
31871,1412,603,809,184,195,112,45,1192,545,647,161,116,105,34,1
31872,307,133,174,48,53,27,10,750,347,403,105,103,83,29,1
31873,1307,594,713,179,208,102,41,427,218,209,61,53,45,26,1
31874,330,166,164,57,51,36,16,160,60,100,23,40,19,11,1
31875,342,160,182,69,40,37,16,691,307,384,93,128,45,19,1
31876,468,243,225,60,50,34,32,671,321,350,95,87,75,34,1
31877,391,208,183,65,49,57,17,297,145,152,49,30,23,21,1
31878,147,78,69,19,15,19,7,622,328,294,75,42,67,31,1
31879,551,298,253,63,65,45,19,163,70,93,28,21,17,6,1
31880,595,272,323,111,107,54,28,1071,549,522,133,127,130,59,1
31881,255,143,112,22,29,34,12,110,67,43,9,10,11,8,1
31882,624,323,301,76,67,74,48,2175,1078,1097,364,275,271,81,1
31883,350,224,126,34,14,48,18,440,237,203,55,66,44,12,1
31884,1190,638,552,162,95,112,18,736,388,348,88,85,67,28,1
31885,416,201,215,54,52,39,25,455,218,237,57,51,42,35,1
31886,1270,557,713,130,195,57,30,548,250,298,85,64,56,21,1
31887,425,177,248,60,62,33,16,756,348,408,101,103,60,40,1
31888,350,200,150,45,47,23,8,184,95,89,17,21,18,8,1
31889,202,113,89,16,27,21,11,136,66,70,33,11,9,3,1
31890,568,243,325,98,73,56,44,461,217,244,44,41,27,36,1
31891,285,109,176,54,80,9,9,377,202,175,46,50,41,23,1
31892,806,436,370,101,100,76,34,257,139,118,64,17,24,7,1
31893,242,112,130,39,41,21,13,377,171,206,59,58,41,22,1
31894,1165,567,598,134,119,158,63,189,105,84,17,20,21,10,1
31895,229,98,131,32,37,22,13,866,405,461,155,136,101,43,1
31896,237,112,125,19,57,25,10,1039,597,442,101,110,106,33,1
31897,1102,552,550,174,137,137,45,689,343,346,119,100,86,38,1
31898,672,334,338,110,93,91,41,769,362,407,99,88,66,67,1
31899,778,367,411,90,85,64,43,341,154,187,34,36,11,11,1
31900,326,148,178,55,42,31,12,189,90,99,26,29,17,11,1
31901,651,306,345,85,64,61,32,862,409,453,149,125,86,29,1
31902,428,214,214,65,67,45,23,450,229,221,49,63,54,27,1
31903,268,157,111,26,30,28,13,367,199,168,62,44,34,8,1
31904,145,70,75,24,16,16,20,176,73,103,22,29,13,9,1
31905,424,209,215,56,58,45,24,331,169,162,40,28,22,14,1
31906,303,159,144,40,35,35,8,724,334,390,112,109,79,17,1
31907,93,45,48,19,15,14,3,467,250,217,59,52,41,19,1
31908,313,159,154,30,40,23,14,187,104,83,24,18,26,5,1
31909,486,236,250,73,67,59,16,583,322,261,73,66,45,26,1
31910,341,167,174,48,47,31,8,192,101,91,25,22,18,9,1
31911,292,153,139,39,33,24,21,427,191,236,67,60,41,34,1
31912,538,252,286,77,87,53,30,780,304,476,160,173,66,23,1
31913,239,146,93,30,22,35,9,379,203,176,55,48,45,16,1
31914,391,208,183,65,49,57,17,1332,626,706,182,144,80,41,1
31915,454,224,230,71,39,62,22,358,204,154,57,41,36,14,1
31916,1412,603,809,184,195,112,45,426,228,198,62,42,47,22,1
31917,1075,594,481,132,108,101,42,194,112,82,26,13,17,8,1
31918,288,159,129,27,44,27,15,800,387,413,122,77,90,34,1
31919,264,134,130,40,26,35,11,1477,738,739,176,176,145,72,1
31920,453,216,237,58,60,67,20,732,373,359,97,96,90,29,1
31921,588,331,257,86,71,52,12,405,195,210,57,74,24,17,1
31922,330,143,187,63,29,52,20,421,195,226,73,71,34,15,1
31923,326,160,166,34,33,37,19,2549,1331,1218,366,296,271,130,1
31924,427,186,241,55,52,42,23,267,159,108,31,13,22,15,1
31925,876,457,419,88,124,67,47,3224,1440,1784,455,440,333,126,1
31926,508,267,241,43,35,25,17,452,217,235,59,47,60,20,1
31927,1087,536,551,123,115,122,55,962,502,460,112,122,109,50,1
31928,839,408,431,138,122,105,46,622,309,313,75,81,76,29,1
31929,297,158,139,47,37,37,9,758,362,396,115,102,35,13,1
31930,654,399,255,73,58,56,21,537,276,261,75,68,68,22,1
31931,556,259,297,75,69,63,38,406,210,196,68,60,25,20,1
31932,409,200,209,69,56,44,13,896,503,393,114,90,101,28,1
31933,240,134,106,21,17,16,11,135,73,62,15,16,15,8,1
31934,350,214,136,33,23,49,27,97,52,45,17,5,7,6,1
31935,722,388,334,105,85,68,36,673,317,356,101,85,76,49,1
31936,1098,519,579,182,159,79,42,730,442,288,104,88,42,68,1
31937,347,169,178,41,37,44,13,921,462,459,140,126,83,55,1
31938,863,418,445,127,114,70,31,252,121,131,42,34,12,16,1
31939,265,165,100,32,19,27,5,358,212,146,51,36,33,9,1
31940,448,199,249,65,54,38,33,327,177,150,56,20,25,6,1
31941,352,189,163,42,31,33,19,407,225,182,58,44,44,22,1
31942,870,418,452,121,102,109,28,1047,562,485,141,127,114,41,1
31943,171,94,77,24,28,30,11,90,52,38,17,6,12,5,1
31944,98,32,66,15,25,5,4,1469,742,727,213,173,93,29,1
31945,201,93,108,34,39,21,6,191,95,96,26,17,17,12,1
31946,326,176,150,35,22,29,11,202,102,100,29,35,6,9,1
31947,309,161,148,38,34,40,15,278,131,147,29,30,33,12,1
31948,646,316,330,89,95,48,17,432,190,242,85,82,28,11,1
31949,502,252,250,68,63,40,14,418,226,192,57,57,53,17,1
31950,404,190,214,55,55,35,27,791,306,485,142,157,21,18,1
31951,509,341,168,35,32,52,15,440,237,203,55,66,44,12,1
31952,163,70,93,28,21,17,6,609,318,291,80,72,55,36,1
31953,594,274,320,89,63,66,28,1382,689,693,186,176,167,77,1
31954,1505,681,824,201,204,73,32,991,483,508,166,120,94,42,1
31955,1609,694,915,204,241,132,122,194,91,103,17,32,9,6,1
31956,450,242,208,53,63,56,22,313,157,156,39,26,34,29,1
31957,595,272,323,111,107,54,28,358,170,188,54,55,20,10,1
31958,593,266,327,102,84,69,24,217,109,108,34,32,35,7,1
31959,510,306,204,82,46,45,20,585,289,296,102,86,61,18,1
31960,167,77,90,22,25,11,11,375,183,192,52,48,39,23,1
31961,260,113,147,42,30,20,8,712,396,316,78,69,65,25,1
31962,673,328,345,107,112,63,27,531,260,271,97,68,47,11,1
31963,471,246,225,46,38,52,30,359,174,185,54,56,43,16,1
31964,277,124,153,44,40,35,18,1047,562,485,141,127,114,41,1
31965,566,263,303,83,87,74,31,808,366,442,130,133,66,31,1
31966,456,228,228,49,70,32,19,406,210,196,68,60,25,20,1
31967,360,192,168,55,45,48,16,1424,650,774,152,124,95,87,1
31968,1049,493,556,146,138,87,41,375,202,173,46,49,41,23,1
31969,602,310,292,87,66,70,36,870,433,437,133,121,95,25,1
31970,224,108,116,33,26,32,10,456,228,228,49,70,32,19,1
31971,1149,568,581,177,133,101,30,1132,624,508,199,79,127,41,1
31972,123,62,61,17,18,13,8,220,102,118,26,32,27,10,1
31973,411,175,236,60,73,47,17,963,498,465,136,123,92,42,1
31974,197,87,110,33,32,15,11,213,107,106,28,41,19,5,1
31975,509,254,255,67,55,52,35,243,140,103,33,27,31,12,1
31976,415,203,212,77,44,49,18,716,354,362,102,87,77,30,1
31977,600,254,346,95,90,52,42,1863,721,1142,262,283,139,74,1
31978,1562,742,820,219,231,104,46,381,189,192,74,49,44,13,1
31979,1272,520,752,235,242,117,54,1599,806,793,213,237,100,45,1
31980,462,251,211,74,53,41,18,340,169,171,49,42,31,14,1
31981,427,191,236,67,60,41,34,1158,481,677,169,129,86,40,1
31982,1428,702,726,182,187,155,72,467,224,243,70,43,67,23,1
31983,1390,695,695,180,137,170,71,550,243,307,91,99,70,10,1
31984,592,295,297,79,70,76,11,639,368,271,72,51,38,38,1
31985,453,255,198,62,49,29,19,873,366,507,127,125,75,21,1
31986,1174,579,595,174,135,132,42,675,311,364,111,80,96,30,1
31987,163,67,96,45,21,17,12,96,50,46,8,15,6,2,1
31988,1822,879,943,236,227,175,97,815,418,397,97,62,70,17,1
31989,881,383,498,142,148,77,24,246,108,138,32,44,21,10,1
31990,471,221,250,87,68,42,25,523,270,253,85,80,39,31,1
31991,298,160,138,37,30,22,12,333,167,166,45,30,34,14,1
31992,245,112,133,32,45,20,10,553,309,244,75,60,39,14,1
31993,1042,530,512,162,150,103,52,276,143,133,34,38,20,15,1
31994,393,186,207,58,50,36,22,543,265,278,52,37,54,19,1
31995,406,209,197,57,50,50,17,847,402,445,109,91,100,37,1
31996,163,64,99,37,12,25,9,480,234,246,79,77,65,23,1
31997,256,153,103,19,23,23,8,743,366,377,41,37,26,14,1
31998,1290,597,693,182,182,119,63,396,150,246,103,64,38,3,1
31999,254,117,137,33,35,38,6,352,166,186,55,59,31,16,1
32000,299,128,171,57,40,13,25,561,281,280,80,71,36,14,1
32001,95,44,51,14,13,7,4,198,110,88,27,27,24,4,1
32002,433,221,212,59,42,47,14,919,376,543,129,122,55,30,1
32003,4684,2161,2523,779,782,304,101,467,224,243,70,43,67,23,1
32004,154,75,79,17,24,16,13,715,324,391,107,92,71,31,1
32005,146,75,71,13,32,15,11,720,357,363,113,85,62,39,1
32006,497,185,312,63,92,38,28,2442,1193,1249,278,183,170,145,1
32007,297,158,139,47,37,37,9,1887,1054,833,205,169,189,50,1
32008,1502,683,819,241,216,172,52,1049,585,464,107,108,120,28,1
32009,233,94,139,36,37,15,8,420,205,215,60,44,52,21,1
32010,928,442,486,139,118,91,43,505,226,279,68,51,30,15,1
32011,1356,672,684,171,172,134,59,1047,562,485,141,127,114,41,1
32012,979,493,486,161,112,95,31,977,406,571,151,128,84,47,1
32013,136,81,55,14,23,11,2,2033,877,1156,359,333,106,44,1
32014,330,166,164,57,51,36,16,848,394,454,100,90,101,41,1
32015,967,463,504,133,114,99,62,2416,1280,1136,140,374,175,47,1
32016,283,112,171,48,39,34,15,598,300,298,68,77,59,21,1
32017,406,210,196,68,60,25,20,418,215,203,60,69,35,14,1
32018,595,316,279,86,60,65,40,406,210,196,68,60,25,20,1
32019,197,100,97,24,22,29,8,691,307,384,93,128,45,19,1
32020,491,272,219,55,66,36,6,221,75,146,68,21,16,5,1
32021,646,298,348,91,110,63,33,254,117,137,33,35,38,6,1
32022,582,313,269,69,53,55,21,705,396,309,87,48,53,17,1
32023,461,231,230,52,61,26,14,670,316,354,84,69,47,24,1
32024,205,114,91,25,24,20,15,596,286,310,90,89,78,37,1
32025,1871,919,952,318,233,164,56,551,298,253,63,65,45,19,1
32026,498,263,235,59,63,36,10,659,325,334,102,85,87,32,1
32027,360,179,181,63,60,26,12,324,154,170,57,40,26,4,1
32028,428,248,180,44,30,57,31,413,227,186,45,34,58,23,1
32029,782,421,361,101,97,82,20,375,202,173,46,49,41,23,1
32030,109,50,59,12,12,9,3,339,170,169,32,17,24,13,1
32031,284,105,179,55,81,8,10,1098,519,579,182,159,79,42,1
32032,89,44,45,15,12,15,6,458,245,213,52,43,27,24,1
32033,125,51,74,31,7,5,5,355,220,135,43,26,65,20,1
32034,582,330,252,82,69,87,21,471,255,216,66,68,81,16,1
32035,404,197,207,60,48,47,20,298,167,131,47,33,40,8,1
32036,604,255,349,100,72,55,26,641,341,300,101,91,29,22,1
32037,267,161,106,22,25,35,20,1091,543,548,146,136,110,34,1
32038,247,110,137,34,45,23,10,4128,2104,2024,581,505,453,205,1
32039,490,224,266,80,70,39,32,410,200,210,60,54,46,19,1
32040,474,208,266,65,69,43,36,377,202,175,46,50,41,22,1
32041,1084,537,547,154,121,92,35,1059,580,479,138,117,67,27,1
32042,1215,572,643,151,105,127,54,572,309,263,64,55,47,29,1
32043,163,70,93,28,21,17,6,1531,691,840,270,226,143,52,1
32044,247,110,137,34,45,23,10,282,135,147,36,49,25,10,1
32045,854,399,455,127,118,57,39,2803,1300,1503,392,510,170,57,1
32046,482,269,213,43,37,65,25,1744,920,824,223,192,177,58,1
32047,508,248,260,71,56,50,19,326,176,150,35,22,29,11,1
32048,358,212,146,51,36,33,9,781,418,363,92,90,64,41,1
32049,979,493,486,161,112,95,31,1009,506,503,146,141,97,55,1
32050,358,212,146,51,36,33,9,2442,1193,1249,278,183,170,145,1
32051,160,67,93,32,37,15,9,96,45,51,13,12,6,4,1
32052,234,110,124,39,29,23,2,508,267,241,43,35,25,17,1
32053,1367,690,677,172,175,154,83,304,159,145,38,40,32,3,1
32054,95,44,51,14,13,7,4,318,165,153,45,38,25,18,1
32055,298,181,117,43,23,40,12,383,204,179,61,32,54,16,1
32056,745,391,354,85,81,52,39,906,437,469,135,132,49,40,1
32057,310,142,168,42,39,24,9,211,92,119,33,44,11,7,1
32058,651,306,345,85,64,61,32,510,264,246,67,66,38,29,1
32059,267,127,140,43,42,24,9,544,266,278,85,48,69,25,1
32060,1391,729,662,159,151,135,64,1425,670,755,153,189,122,85,1
32061,448,236,212,53,64,56,24,872,421,451,109,95,66,40,1
32062,154,77,77,35,17,20,9,186,99,87,30,17,18,8,1
32063,851,417,434,109,116,83,28,482,231,251,76,81,64,26,1
32064,1024,549,475,139,125,82,23,395,186,209,53,48,46,30,1
32065,656,358,298,67,47,64,26,796,398,398,107,87,56,36,1
32066,529,283,246,66,69,66,25,486,229,257,75,104,49,10,1
32067,583,322,261,73,66,45,26,360,192,168,55,45,48,16,1
32068,254,117,137,33,35,38,6,702,298,404,134,111,48,18,1
32069,967,496,471,101,109,124,26,202,123,79,12,15,26,21,1
32070,258,111,147,46,63,17,6,834,465,369,82,84,81,21,1
32071,431,227,204,53,60,58,12,1036,496,540,151,134,114,72,1
32072,502,240,262,78,61,54,32,192,91,101,29,28,17,7,1
32073,1696,771,925,257,225,149,63,1030,495,535,154,106,116,49,1
32074,487,223,264,81,68,63,15,354,168,186,50,53,39,20,1
32075,1071,549,522,133,127,130,59,562,283,279,48,32,63,13,1
32076,434,237,197,52,64,37,14,529,264,265,59,68,41,17,1
32077,574,295,279,78,65,61,22,277,122,155,33,33,25,24,1
32078,393,186,207,58,50,36,22,274,145,129,40,17,20,12,1
32079,351,183,168,55,44,33,9,341,178,163,48,44,42,20,1
32080,76,31,45,13,14,9,7,1248,584,664,184,164,155,67,1
32081,485,187,298,95,71,61,25,753,318,435,154,95,56,23,1
32082,298,160,138,37,30,22,12,894,479,415,117,93,119,38,1
32083,1651,714,937,244,233,158,67,711,344,367,87,109,74,24,1
32084,219,104,115,25,31,25,11,149,68,81,15,38,11,10,1
32085,751,312,439,131,115,78,48,2492,894,1598,466,444,164,102,1
32086,536,278,258,72,63,62,20,449,244,205,68,53,49,12,1
32087,3056,1457,1599,438,389,329,168,586,270,316,83,80,59,21,1
32088,352,212,140,37,17,61,20,354,169,185,54,54,41,19,1
32089,330,148,182,42,35,42,25,1231,566,665,164,147,154,103,1
32090,360,188,172,49,48,47,17,1980,1084,896,242,235,254,106,1
32091,154,75,79,17,24,16,13,147,78,69,20,15,20,7,1
32092,350,214,136,33,23,49,27,109,50,59,20,7,10,9,1
32093,432,218,214,57,55,42,11,652,323,329,99,90,65,20,1
32094,1771,864,907,239,217,158,63,796,445,351,96,80,90,38,1
32095,606,307,299,92,56,68,30,215,115,100,27,28,34,16,1
32096,326,153,173,63,48,25,8,1243,650,593,158,159,98,55,1
32097,283,142,141,35,29,32,5,350,200,150,45,47,23,8,1
32098,351,184,167,59,45,54,9,355,179,176,51,45,45,11,1
32099,656,358,298,67,47,64,26,365,184,181,47,41,29,18,1
32100,1132,646,486,99,102,71,41,178,89,89,26,21,21,10,1
32101,317,153,164,34,52,30,14,714,364,350,98,102,91,27,1
32102,412,193,219,70,56,51,26,1616,735,881,285,248,153,72,1
32103,605,281,324,111,67,40,44,1290,597,693,182,182,119,63,1
32104,380,187,193,38,51,30,18,425,210,215,56,43,52,25,1
32105,103,44,59,16,17,9,5,587,300,287,67,102,34,20,1
32106,415,209,206,60,67,39,18,574,298,276,79,75,79,40,1
32107,85,44,41,9,6,10,9,61,17,44,8,4,0,21,1
32108,1770,824,946,245,258,179,60,926,435,491,133,132,85,17,1
32109,413,236,177,41,25,35,19,308,164,144,47,29,33,7,1
32110,211,114,97,32,24,19,10,526,266,260,76,75,53,22,1
32111,2817,1216,1601,379,436,183,115,246,108,138,32,44,21,10,1
32112,173,88,85,20,21,9,12,256,114,142,27,46,30,13,1
32113,770,430,340,97,81,77,30,931,464,467,109,126,119,42,1
32114,150,80,70,26,5,20,7,362,225,137,43,22,30,11,1
32115,326,151,175,50,39,36,17,1047,562,485,141,127,114,41,1
32116,158,85,73,24,18,18,8,441,216,225,57,66,57,19,1
32117,1336,633,703,182,197,110,52,1074,538,536,154,140,111,51,1
32118,374,213,161,46,43,31,26,2639,1436,1203,317,307,242,77,1
32119,593,342,251,73,55,82,29,418,204,214,68,66,38,12,1
32120,252,114,138,41,35,22,12,601,313,288,42,48,25,36,1
32121,419,247,172,64,30,43,17,656,358,298,67,47,64,26,1
32122,299,128,171,57,40,13,25,316,157,159,45,38,22,19,1
32123,360,192,168,55,45,48,16,598,322,276,67,57,63,26,1
32124,117,62,55,24,18,21,2,393,210,183,44,53,53,23,1
32125,307,133,174,48,53,27,10,847,452,395,100,94,81,36,1
32126,439,202,237,80,53,35,15,1117,423,694,182,134,88,31,1
32127,593,303,290,70,70,68,15,1241,670,571,135,139,110,32,1
32128,712,396,316,78,69,65,25,189,90,99,26,29,17,11,1
32129,387,200,187,61,54,51,16,406,212,194,64,58,49,18,1
32130,1647,794,853,279,235,128,65,393,186,207,58,50,36,22,1
32131,473,224,249,82,63,48,24,587,303,284,84,90,63,23,1
32132,628,345,283,73,75,80,17,1333,646,687,209,179,148,45,1
32133,673,313,360,101,101,46,17,395,222,173,48,42,21,8,1
32134,1217,496,721,230,214,94,42,295,122,173,52,42,22,10,1
32135,394,202,192,44,43,38,28,654,317,337,95,111,44,13,1
32136,63,29,34,13,10,4,8,490,248,242,82,79,38,24,1
32137,215,80,135,54,56,21,9,1505,681,824,201,204,73,32,1
32138,527,263,264,81,63,72,31,223,132,91,18,16,27,17,1
32139,290,127,163,47,58,23,12,482,231,251,76,81,64,26,1
32140,1382,599,783,208,252,90,39,309,106,203,66,49,25,10,1
32141,1115,599,516,125,105,95,51,906,474,432,90,125,74,24,1
32142,336,154,182,51,48,39,22,480,232,248,83,64,51,25,1
32143,1189,559,630,179,147,118,35,593,266,327,102,84,69,24,1
32144,781,418,363,92,90,64,41,1390,695,695,180,137,170,71,1
32145,1830,904,926,276,245,222,100,211,114,97,32,24,19,10,1
32146,1336,736,600,137,136,163,69,513,274,239,67,66,62,35,1
32147,518,262,256,70,52,49,27,719,301,418,122,132,42,26,1
32148,432,193,239,55,68,26,15,469,225,244,64,69,26,11,1
32149,110,67,43,9,10,11,8,1382,689,693,186,176,167,77,1
32150,447,214,233,67,65,62,20,163,71,92,22,38,11,7,1
32151,631,309,322,106,83,89,33,976,496,480,128,111,121,48,1
32152,455,218,237,57,51,42,35,1471,709,762,198,184,154,62,1
32153,242,114,128,44,47,21,3,409,200,209,69,56,44,13,1
32154,529,274,255,57,62,38,14,365,180,185,63,35,48,19,1
32155,730,298,432,128,69,86,26,359,150,209,57,75,29,12,1
32156,194,99,95,29,24,20,8,1411,472,939,252,262,58,31,1
32157,671,332,339,103,75,75,31,189,93,96,24,28,17,12,1
32158,304,159,145,38,40,32,3,1074,538,536,154,140,111,51,1
32159,292,152,140,46,38,35,12,205,77,128,31,45,12,11,1
32160,1786,793,993,213,271,163,159,617,387,230,65,57,77,16,1
32161,1692,713,979,325,210,122,58,1591,734,857,229,225,171,75,1
32162,1253,634,619,182,155,162,70,211,114,97,32,24,19,10,1
32163,860,457,403,118,103,103,36,467,226,241,55,48,54,23,1
32164,573,271,302,56,64,55,18,284,128,156,48,29,34,8,1
32165,101,68,33,9,6,23,2,709,373,336,73,72,78,24,1
32166,211,113,98,38,17,25,8,112,59,53,12,17,14,8,1
32167,722,310,412,134,81,46,24,843,391,452,139,104,91,34,1
32168,580,248,332,106,94,43,25,341,178,163,48,44,42,20,1
32169,211,114,97,32,24,19,10,782,347,435,110,92,74,34,1
32170,906,413,493,134,111,94,61,246,108,138,32,44,21,10,1
32171,487,229,258,68,82,41,24,393,186,207,58,50,36,22,1
32172,2303,1190,1113,331,253,115,66,281,137,144,39,41,34,11,1
32173,270,137,133,30,28,27,11,770,390,380,104,76,78,32,1
32174,775,407,368,122,100,97,32,467,224,243,70,43,67,23,1
32175,3333,1606,1727,446,357,333,206,986,465,521,152,132,138,51,1
32176,246,108,138,32,44,21,10,825,363,462,97,105,72,75,1
32177,288,158,130,59,23,21,10,201,98,103,26,35,16,5,1
32178,600,254,346,104,100,44,17,218,108,110,27,29,23,10,1
32179,871,312,559,187,101,140,58,270,106,164,55,48,27,12,1
32180,505,273,232,70,57,60,33,352,189,163,42,31,33,19,1
32181,168,120,48,7,5,20,7,1247,548,699,168,150,140,43,1
32182,581,254,327,100,83,54,20,920,492,428,100,92,88,49,1
32183,521,265,256,69,69,61,26,252,133,119,35,40,29,9,1
32184,423,222,201,60,51,51,11,825,422,403,100,90,62,43,1
32185,1214,498,716,197,180,121,65,467,224,243,70,43,67,23,1
32186,480,234,246,79,77,65,23,467,240,227,65,65,51,23,1
32187,434,237,197,52,64,37,14,448,236,212,53,64,56,24,1
32188,417,182,235,57,109,50,8,448,281,167,47,37,45,13,1
32189,716,354,362,102,87,77,30,309,154,155,42,44,45,16,1
32190,95,44,51,14,13,7,4,529,314,215,59,64,39,14,1
32191,288,159,129,27,44,27,15,736,388,348,88,85,67,28,1
32192,168,120,48,7,5,20,7,652,323,329,99,90,65,20,1
32193,498,263,235,59,63,36,10,1149,568,581,177,133,101,30,1
32194,918,427,491,113,111,113,33,770,390,380,104,76,78,32,1
32195,91,56,35,17,2,7,7,233,121,112,24,31,30,7,1
32196,487,229,258,68,82,41,24,304,127,177,61,38,31,4,1
32197,392,221,171,53,30,25,8,436,201,235,54,37,34,20,1
32198,352,212,140,37,17,61,20,97,52,45,17,5,7,6,1
32199,246,108,138,32,44,21,10,445,225,220,47,62,53,26,1
32200,906,455,451,116,105,87,46,1106,579,527,121,152,113,45,1
32201,288,155,133,38,33,34,10,350,181,169,44,52,43,13,1
32202,67,40,27,10,8,7,6,356,199,157,43,58,29,12,1
32203,148,77,71,26,24,23,4,347,133,214,64,60,29,9,1
32204,601,313,288,42,48,25,36,731,338,393,114,126,53,17,1
32205,291,146,145,39,45,22,16,958,451,507,165,135,97,41,1
32206,246,115,131,15,29,10,32,309,149,160,55,33,27,15,1
32207,450,241,209,67,58,54,23,605,295,310,74,66,70,36,1
32208,427,186,241,55,52,42,23,770,355,415,103,142,75,42,1
32209,443,208,235,43,55,51,50,601,313,288,42,48,25,36,1
32210,553,261,292,73,79,40,26,1464,987,477,137,141,55,31,1
32211,1082,532,550,144,151,79,38,365,180,185,63,35,48,19,1
32212,567,296,271,88,53,55,30,213,91,122,42,30,23,12,1
32213,694,441,253,69,47,82,42,370,176,194,61,30,40,28,1
32214,838,385,453,110,137,78,28,466,247,219,51,32,49,26,1
32215,344,181,163,61,37,40,14,464,197,267,87,73,43,20,1
32216,898,396,502,102,98,54,37,164,78,86,28,23,12,8,1
32217,356,185,171,37,31,17,21,341,190,151,50,41,23,15,1
32218,375,202,173,46,49,41,23,245,122,123,21,32,18,13,1
32219,253,123,130,40,46,15,4,621,284,337,108,68,50,17,1
32220,355,220,135,43,26,65,20,97,52,45,17,5,7,6,1
32221,595,276,319,120,55,77,39,750,347,403,105,103,83,29,1
32222,244,105,139,38,28,20,15,1502,683,819,241,216,172,52,1
32223,1064,576,488,130,119,109,36,399,222,177,48,44,52,23,1
32224,448,236,212,53,64,56,24,359,160,199,62,33,27,17,1
32225,278,111,167,66,66,19,8,406,210,196,68,60,25,20,1
32226,189,101,88,23,24,16,11,416,210,206,55,54,39,20,1
32227,519,244,275,76,90,44,16,1382,689,693,186,176,167,77,1
32228,509,241,268,67,53,56,13,501,240,261,80,62,49,42,1
32229,427,218,209,61,53,45,26,454,191,263,61,66,38,15,1
32230,431,216,215,46,40,33,9,380,187,193,38,51,30,18,1
32231,506,243,263,75,70,39,17,582,313,269,69,53,55,21,1
32232,906,485,421,112,98,112,39,1007,523,484,116,113,117,43,1
32233,527,273,254,81,61,81,14,811,400,411,107,87,116,43,1
32234,1332,659,673,174,170,153,55,247,133,114,41,25,41,8,1
32235,149,68,81,15,38,11,10,149,77,72,37,10,20,5,1
32236,313,159,154,30,40,23,14,443,208,235,43,55,51,50,1
32237,264,122,142,33,29,13,13,371,174,197,53,56,43,15,1
32238,1158,481,677,169,129,86,40,246,113,133,33,45,22,10,1
32239,201,98,103,26,35,16,5,390,203,187,58,40,43,19,1
32240,1194,609,585,195,142,105,37,425,198,227,57,69,59,13,1
32241,390,207,183,50,48,38,15,526,264,262,77,71,61,27,1
32242,624,204,420,166,101,32,13,306,128,178,49,59,17,9,1
32243,762,363,399,132,107,82,26,145,75,70,21,18,18,8,1
32244,979,535,444,123,99,79,34,1460,758,702,180,154,174,59,1
32245,503,298,205,62,28,20,4,526,264,262,77,71,61,27,1
32246,246,108,138,32,44,21,10,654,317,337,95,111,44,13,1
32247,124,62,62,17,14,7,5,563,285,278,79,66,48,27,1
32248,391,208,183,65,49,57,17,308,157,151,44,48,33,14,1
32249,847,402,445,137,119,102,41,724,334,390,112,109,79,17,1
32250,587,309,278,67,73,56,34,623,320,303,103,85,75,15,1
32251,380,175,205,57,64,28,11,757,373,384,115,93,95,25,1
32252,410,211,199,55,42,34,27,425,198,227,57,69,59,13,1
32253,393,186,207,58,50,36,22,104,48,56,15,15,13,7,1
32254,158,72,86,27,14,15,11,383,185,198,54,41,49,18,1
32255,609,292,317,102,96,64,21,680,351,329,93,97,87,27,1
32256,539,273,266,74,59,66,24,2016,1107,909,214,229,238,111,1
32257,221,110,111,28,32,25,11,1989,775,1214,307,250,189,59,1
32258,863,418,445,127,114,70,31,808,366,442,130,133,66,31,1
32259,688,364,324,74,94,89,40,705,357,348,90,84,100,41,1
32260,670,333,337,95,79,62,21,416,209,207,76,45,50,17,1
32261,2871,1218,1653,290,374,238,414,3396,1499,1897,325,572,309,90,1
32262,175,90,85,28,21,19,7,590,298,292,73,45,71,25,1
32263,426,228,198,62,42,47,22,905,371,534,192,135,81,28,1
32264,225,102,123,32,32,31,15,407,230,177,53,42,34,20,1
32265,900,484,416,119,110,77,29,778,367,411,90,85,64,43,1
32266,393,186,207,58,50,36,22,1092,562,530,126,91,125,84,1
32267,339,170,169,32,17,24,13,291,120,171,63,39,26,6,1
32268,536,278,258,72,63,62,20,462,233,229,66,49,43,30,1
32269,188,101,87,20,18,20,14,484,259,225,69,44,60,21,1
32270,1613,806,807,190,211,180,84,694,441,253,69,47,82,42,1
32271,442,254,188,46,22,40,19,508,267,241,43,35,25,17,1
32272,350,167,183,36,56,26,31,601,313,288,42,48,25,36,1
32273,677,245,432,129,155,72,11,349,177,172,58,49,43,10,1
32274,815,418,397,97,62,70,17,1037,534,503,127,148,121,48,1
32275,424,197,227,67,62,43,17,540,269,271,51,70,43,26,1
32276,208,80,128,26,22,13,16,948,484,464,134,131,75,27,1
32277,554,350,204,47,42,66,35,256,153,103,19,23,23,8,1
32278,910,462,448,143,126,90,25,847,452,395,100,94,81,36,1
32279,920,492,428,100,92,88,49,743,366,377,41,37,26,14,1
32280,576,250,326,93,71,34,15,620,319,301,87,74,75,37,1
32281,225,102,123,32,32,31,15,131,66,65,21,14,23,7,1
32282,1271,599,672,194,175,118,47,393,186,207,58,50,36,22,1
32283,342,179,163,51,59,34,3,339,189,150,34,27,55,13,1
32284,303,159,144,40,35,35,8,1149,568,581,177,133,101,30,1
32285,1341,481,860,275,264,57,21,615,338,277,77,69,74,35,1
32286,1058,558,500,132,127,121,53,250,164,86,22,15,30,4,1
32287,465,322,143,39,31,58,24,385,194,191,49,50,40,12,1
32288,639,397,242,64,37,64,30,1798,844,954,277,212,142,53,1
32289,151,60,91,23,29,4,6,470,205,265,71,80,33,11,1
32290,706,354,352,82,61,32,30,2440,1061,1379,377,326,172,62,1
32291,734,366,368,121,99,63,39,270,137,133,30,28,27,11,1
32292,824,414,410,106,107,91,45,440,218,222,58,66,40,24,1
32293,509,254,255,67,55,52,35,305,156,149,37,39,42,5,1
32294,270,137,133,30,28,27,11,327,177,150,40,40,38,18,1
32295,798,287,511,126,125,77,26,710,307,403,117,176,37,9,1
32296,146,75,71,13,32,15,11,582,272,310,103,79,48,29,1
32297,398,200,198,68,43,51,14,468,233,235,65,61,49,34,1
32298,702,298,404,134,111,48,18,1090,543,547,157,132,116,35,1
32299,469,204,265,81,67,30,22,416,201,215,54,52,39,25,1
32300,381,189,192,74,49,44,13,854,380,474,137,159,81,31,1
32301,767,392,375,113,112,83,13,1009,506,503,146,141,97,55,1
32302,660,326,334,106,61,71,32,368,141,227,64,61,24,13,1
32303,418,199,219,55,44,22,15,1030,495,535,154,106,116,49,1
32304,427,186,241,55,52,42,23,485,273,212,52,47,51,17,1
32305,301,133,168,41,60,26,18,556,290,266,75,74,29,24,1
32306,986,418,568,159,99,110,42,425,210,215,56,43,52,25,1
32307,236,92,144,25,25,28,36,267,159,108,31,13,22,15,1
32308,604,282,322,76,74,69,35,499,250,249,78,81,46,25,1
32309,172,74,98,32,30,11,7,217,121,96,27,34,18,10,1
32310,673,313,360,101,101,46,17,272,135,137,34,30,31,8,1
32311,328,184,144,47,24,23,9,684,288,396,107,90,54,42,1
32312,425,210,215,56,43,52,25,1980,963,1017,262,243,179,78,1
32313,432,218,214,57,55,42,11,276,150,126,43,32,33,9,1
32314,5537,2898,2639,598,623,347,214,467,224,243,70,43,67,23,1
32315,672,336,336,103,80,47,32,213,91,122,42,30,23,12,1
32316,618,290,328,82,74,69,42,499,250,249,78,81,46,25,1
32317,1826,876,950,263,264,139,62,767,392,375,113,112,83,13,1
32318,1149,568,581,177,133,101,30,318,176,142,25,32,35,25,1
32319,929,462,467,106,88,78,44,1675,875,800,213,219,196,72,1
32320,2414,1189,1225,277,178,170,169,100,37,63,26,19,0,1,1
32321,811,400,411,107,87,116,43,432,115,317,127,90,24,15,1
32322,1009,506,503,146,141,97,55,556,279,277,83,69,71,19,1
32323,415,203,212,77,44,49,18,393,186,207,58,50,36,22,1
32324,1452,733,719,182,161,179,64,913,412,501,131,100,117,83,1
32325,624,204,420,166,101,32,13,494,123,371,160,58,29,5,1
32326,2725,1490,1235,339,333,254,78,661,333,328,94,70,93,29,1
32327,455,218,237,57,51,42,35,624,308,316,92,72,68,22,1
32328,428,226,202,52,60,75,20,998,496,502,149,146,89,27,1
32329,255,106,149,46,40,21,10,172,74,98,32,30,11,7,1
32330,405,195,210,57,74,24,17,262,151,111,30,17,32,25,1
32331,1132,646,486,99,102,71,41,577,342,235,63,57,23,37,1
32332,328,178,150,36,34,16,14,384,196,188,42,43,32,20,1
32333,685,315,370,108,99,36,9,152,83,69,24,21,12,5,1
32334,150,81,69,24,23,16,4,131,66,65,21,14,23,7,1
32335,277,100,177,35,88,30,2,177,99,78,22,23,20,10,1
32336,245,112,133,32,45,20,10,331,145,186,40,56,16,9,1
32337,230,115,115,29,29,22,14,619,332,287,95,77,74,38,1
32338,469,247,222,70,58,82,13,99,48,51,15,7,7,7,1
32339,323,198,125,28,25,34,15,1170,510,660,142,182,115,84,1
32340,1292,633,659,171,202,109,47,402,227,175,48,40,35,11,1
32341,450,241,209,67,58,54,23,202,86,116,33,29,26,10,1
32342,1074,538,536,190,131,157,35,206,94,112,37,36,18,9,1
32343,863,458,405,97,82,63,57,776,346,430,103,102,61,40,1
32344,592,264,328,86,85,62,41,704,356,348,112,94,71,24,1
32345,330,157,173,56,42,51,8,1118,471,647,204,164,102,34,1
32346,316,161,155,46,50,39,16,671,318,353,83,124,46,34,1
32347,561,210,351,108,77,41,22,589,314,275,70,83,44,28,1
32348,334,172,162,43,39,41,17,331,169,162,40,28,22,14,1
32349,486,302,184,46,27,61,24,558,306,252,75,55,74,23,1
32350,490,224,266,80,70,39,32,295,143,152,38,47,22,25,1
32351,920,492,428,100,92,88,49,928,442,486,139,118,91,43,1
32352,462,258,204,59,41,56,15,439,205,234,64,88,41,21,1
32353,553,261,292,73,79,40,26,675,311,364,111,80,96,30,1
32354,556,279,277,83,69,71,19,482,262,220,72,60,52,15,1
32355,277,124,153,44,40,35,18,841,329,512,137,163,35,26,1
32356,480,232,248,83,64,51,25,277,124,153,44,40,35,18,1
32357,221,110,111,28,32,25,11,1090,543,547,157,132,116,35,1
32358,682,260,422,98,83,42,31,785,374,411,56,42,38,25,1
32359,357,169,188,61,53,32,15,217,109,108,34,32,35,7,1
32360,624,308,316,92,72,68,22,976,496,480,128,111,121,48,1
32361,710,361,349,81,98,63,26,253,148,105,31,15,39,16,1
32362,391,203,188,49,48,41,14,367,161,206,70,48,41,19,1
32363,749,384,365,108,105,86,31,595,272,323,111,107,54,28,1
32364,1085,529,556,149,133,126,54,368,177,191,49,35,50,20,1
32365,977,500,477,139,115,121,31,2758,1332,1426,394,384,287,131,1
32366,390,203,187,58,40,43,19,92,44,48,6,8,9,8,1
32367,585,299,286,92,73,89,23,365,170,195,85,43,18,8,1
32368,186,99,87,30,17,18,8,434,205,229,51,55,24,13,1
32369,1029,403,626,222,126,141,67,835,420,415,104,105,57,47,1
32370,574,273,301,101,74,68,26,648,307,341,101,58,76,34,1
32371,656,358,298,67,47,64,26,524,317,207,47,49,43,28,1
32372,589,294,295,37,44,27,33,467,224,243,70,43,67,23,1
32373,882,432,450,115,111,68,44,103,44,59,16,17,9,5,1
32374,467,224,243,70,43,67,23,437,167,270,126,95,34,10,1
32375,503,263,240,72,55,51,34,108,59,49,17,13,12,5,1
32376,1270,682,588,165,147,136,54,1863,721,1142,262,283,139,74,1
32377,190,91,99,26,22,36,12,402,227,175,48,40,35,11,1
32378,1012,575,437,137,102,172,30,1367,690,677,172,175,154,83,1
32379,425,210,215,56,43,52,25,1475,658,817,149,114,120,43,1
32380,363,181,182,51,42,57,18,140,70,70,22,17,9,4,1
32381,635,333,302,99,75,83,28,982,494,488,150,117,91,45,1
32382,204,96,108,31,37,20,5,198,80,118,35,31,14,7,1
32383,187,92,95,13,51,14,11,1257,464,793,221,264,75,37,1
32384,355,220,135,43,26,65,20,92,44,48,6,8,9,8,1
32385,217,109,108,34,30,34,5,976,496,480,128,111,121,48,1
32386,405,180,225,72,57,31,12,375,202,173,46,49,41,23,1
32387,535,251,284,65,78,47,20,268,104,164,58,37,30,14,1
32388,247,110,137,34,45,23,10,1834,823,1011,297,282,151,63,1
32389,480,266,214,64,55,37,18,254,120,134,32,32,24,8,1
32390,335,148,187,52,26,51,12,173,104,69,18,20,18,9,1
32391,560,260,300,100,58,29,28,156,64,92,39,19,15,8,1
32392,503,232,271,44,57,21,10,1390,695,695,180,137,170,71,1
32393,672,334,338,110,93,91,41,1212,645,567,145,117,122,72,1
32394,556,269,287,86,66,62,22,1537,701,836,209,187,129,58,1
32395,177,67,110,34,24,13,10,715,355,360,118,79,71,29,1
32396,415,209,206,60,67,39,18,269,165,104,24,19,27,7,1
32397,1037,461,576,146,163,75,44,3144,1617,1527,367,342,278,136,1
32398,1034,451,583,165,146,104,40,1748,791,957,281,247,173,25,1
32399,1527,633,894,314,260,134,67,1054,497,557,190,168,107,45,1
32400,383,204,179,61,32,54,16,220,122,98,24,20,23,12,1
32401,353,217,136,39,17,44,17,359,173,186,55,57,44,16,1
32402,660,332,328,84,73,47,19,217,109,108,34,32,35,7,1
32403,1084,537,547,154,121,92,35,521,265,256,56,44,35,12,1
32404,3230,1723,1507,361,358,157,75,839,466,373,104,84,120,31,1
32405,161,73,88,23,22,15,8,213,107,106,28,41,19,5,1
32406,95,41,54,15,16,8,5,768,354,414,133,106,79,42,1
32407,202,103,99,28,20,12,8,654,344,310,80,69,57,15,1
32408,659,325,334,102,85,87,32,335,128,207,59,43,24,23,1
32409,928,442,486,139,118,91,43,380,187,193,38,51,30,18,1
32410,864,362,502,142,150,70,19,325,177,148,56,32,30,12,1
32411,500,268,232,65,56,28,17,900,484,416,119,110,77,29,1
32412,1134,539,595,150,146,78,40,1462,652,810,243,199,115,30,1
32413,1475,658,817,149,114,120,43,216,119,97,33,27,28,7,1
32414,841,329,512,137,163,35,26,421,192,229,72,54,51,48,1
32415,338,169,169,43,38,41,10,1366,943,423,137,109,58,19,1
32416,3911,1465,2446,610,767,240,133,149,68,81,15,38,11,10,1
32417,921,455,466,144,127,108,39,864,362,502,142,150,70,19,1
32418,410,208,202,59,58,43,26,305,168,137,48,35,40,9,1
32419,102,61,41,15,13,8,2,686,375,311,89,80,63,20,1
32420,271,131,140,47,37,41,11,930,477,453,111,92,92,29,1
32421,454,223,231,38,45,24,19,247,110,137,34,45,23,10,1
32422,2045,985,1060,359,339,199,74,519,219,300,86,72,50,39,1
32423,1210,592,618,157,138,116,85,335,128,207,59,43,24,23,1
32424,577,288,289,85,56,40,20,1047,562,485,141,127,114,41,1
32425,465,225,240,65,44,65,25,437,167,270,126,95,34,10,1
32426,248,120,128,43,37,20,6,440,215,225,76,74,29,16,1
32427,595,316,279,86,60,65,40,781,367,414,60,67,43,17,1
32428,870,489,381,97,99,76,14,512,261,251,79,73,60,21,1
32429,815,418,397,97,62,70,17,620,319,301,87,74,75,37,1
32430,406,212,194,50,52,24,18,928,442,486,139,118,91,43,1
32431,1441,504,937,264,329,69,46,1052,492,560,184,163,103,44,1
32432,1822,879,943,236,227,175,97,1074,538,536,154,140,111,51,1
32433,589,314,275,70,83,44,28,198,110,88,27,27,24,4,1
32434,1051,523,528,164,140,126,50,390,208,182,47,53,32,12,1
32435,1158,481,677,169,129,86,40,461,223,238,66,57,36,23,1
32436,414,193,221,54,49,45,28,681,322,359,100,87,71,26,1
32437,656,358,298,67,47,64,26,514,226,288,71,66,63,32,1
32438,272,173,99,32,32,11,8,245,137,108,34,30,19,10,1
32439,422,211,211,73,61,43,17,317,153,164,39,30,35,13,1
32440,881,419,462,132,82,81,24,781,418,363,92,90,64,41,1
32441,688,323,365,121,69,55,22,353,195,158,40,55,30,13,1
32442,848,461,387,111,102,108,42,2758,1332,1426,394,384,287,131,1
32443,230,115,115,29,29,22,14,1074,538,536,154,140,111,51,1
32444,189,90,99,26,29,17,11,135,73,62,15,16,15,8,1
32445,982,494,488,150,117,91,45,993,492,501,116,119,135,57,1
32446,551,299,252,51,62,63,17,225,116,109,29,19,25,6,1
32447,338,192,146,41,29,22,14,430,239,191,63,42,51,19,1
32448,1124,615,509,157,125,128,52,1154,540,614,195,160,138,66,1
32449,218,115,103,32,32,34,11,770,390,380,104,76,78,32,1
32450,505,273,232,70,57,60,33,467,226,241,55,48,54,23,1
32451,247,110,137,34,45,23,10,2214,993,1221,361,324,190,74,1
32452,509,341,168,35,32,52,15,324,151,173,61,54,32,6,1
32453,790,343,447,90,191,35,17,1036,511,525,136,89,94,56,1
32454,1037,461,576,146,163,75,44,229,103,126,28,44,17,5,1
32455,328,184,144,47,24,23,9,341,178,163,48,44,42,20,1
32456,440,246,194,62,49,41,16,1863,721,1142,262,283,139,74,1
32457,582,293,289,94,80,77,32,718,283,435,126,127,34,29,1
32458,277,124,153,44,40,35,18,568,243,325,98,73,56,44,1
32459,1074,538,536,190,131,157,35,377,202,175,46,50,41,23,1
32460,437,225,212,61,57,66,12,109,57,52,19,7,8,8,1
32461,648,307,341,101,58,76,34,778,367,411,90,85,64,43,1
32462,470,255,215,68,49,83,15,615,312,303,86,54,75,45,1
32463,780,337,443,112,116,77,28,993,492,501,116,119,135,57,1
32464,537,276,261,75,68,68,22,226,129,97,20,25,26,11,1
32465,825,399,426,128,128,77,32,577,288,289,85,56,40,20,1
32466,467,226,241,55,48,54,23,745,355,390,99,85,62,19,1
32467,395,226,169,57,44,32,8,399,189,210,65,70,42,16,1
32468,795,395,400,94,87,80,42,148,67,81,20,14,18,16,1
32469,933,493,440,140,108,124,32,603,291,312,98,87,61,28,1
32470,466,242,224,66,53,53,13,307,133,174,48,53,27,10,1
32471,352,212,140,37,17,61,20,509,262,247,64,70,64,20,1
32472,1549,848,701,182,150,179,69,437,225,212,61,57,66,12,1
32473,311,182,129,29,28,19,12,624,308,316,92,72,68,22,1
32474,1290,597,693,182,182,119,63,681,286,395,109,61,69,42,1
32475,72,35,37,10,9,7,6,186,92,94,28,23,17,11,1
32476,663,338,325,68,71,41,16,387,193,194,51,48,50,17,1
32477,248,119,129,33,48,20,10,1374,679,695,191,193,154,48,1
32478,113,47,66,14,15,11,17,745,354,391,116,100,95,46,1
32479,250,114,136,45,42,18,8,244,135,109,36,24,20,10,1
32480,609,292,317,102,96,64,21,426,228,198,62,42,47,22,1
32481,375,202,173,46,49,41,23,1216,628,588,134,130,172,51,1
32482,568,243,325,98,73,56,44,277,141,136,35,21,16,22,1
32483,5038,2652,2386,655,729,544,245,149,68,81,15,38,11,10,1
32484,229,105,124,36,33,12,4,419,175,244,71,73,23,23,1
32485,333,198,135,33,15,63,17,114,53,61,16,7,4,6,1
32486,622,299,323,86,86,69,35,732,373,359,97,96,90,29,1
32487,525,303,222,57,47,84,36,149,68,81,15,38,11,10,1
32488,362,174,188,46,55,35,23,158,85,73,24,18,18,8,1
32489,351,166,185,48,61,24,15,280,121,159,60,45,22,12,1
32490,536,278,258,72,63,62,20,788,360,428,93,106,67,72,1
32491,446,176,270,64,79,45,24,720,357,363,113,85,62,39,1
32492,204,86,118,38,21,23,15,326,153,173,63,48,25,8,1
32493,475,235,240,77,58,43,22,471,231,240,76,58,44,8,1
32494,602,299,303,98,81,72,21,667,360,307,76,92,46,27,1
32495,510,264,246,67,66,38,29,168,67,101,37,17,13,13,1
32496,551,237,314,95,79,54,17,191,99,92,25,24,18,8,1
32497,660,359,301,81,87,102,31,822,416,406,111,105,84,44,1
32498,552,283,269,89,66,68,30,2383,1253,1130,323,292,273,107,1
32499,393,186,207,58,50,36,22,765,295,470,200,142,84,27,1
32500,273,151,122,31,27,34,13,263,142,121,27,18,34,14,1
32501,288,157,131,40,35,27,13,391,212,179,40,45,47,10,1
32502,54,26,28,11,4,3,3,233,121,112,24,31,30,7,1
32503,736,388,348,88,85,67,28,258,141,117,39,35,27,8,1
32504,504,259,245,73,56,45,29,334,172,162,43,39,41,17,1
32505,362,233,129,37,17,51,18,1233,635,598,187,149,146,51,1
32506,3336,1358,1978,571,599,203,101,2024,765,1259,283,343,137,76,1
32507,1657,800,857,249,235,154,51,1427,542,885,246,269,69,46,1
32508,848,461,387,111,102,108,42,295,145,150,41,45,36,18,1
32509,368,158,210,64,61,39,14,485,190,295,94,55,57,29,1
32510,519,244,275,76,90,44,16,1106,579,527,121,152,113,45,1
32511,309,154,155,42,44,45,16,196,99,97,28,32,17,12,1
32512,384,211,173,43,30,60,26,97,53,44,13,12,7,5,1
32513,241,127,114,34,33,29,12,367,161,206,70,48,41,19,1
32514,574,277,297,88,77,58,36,632,326,306,92,71,56,19,1
32515,985,551,434,123,93,91,26,401,204,197,49,33,29,17,1
32516,839,427,412,91,83,114,37,540,257,283,81,63,57,24,1
32517,101,45,56,17,17,12,9,240,125,115,34,32,30,8,1
32518,549,318,231,82,41,47,21,219,124,95,22,22,23,5,1
32519,517,250,267,78,37,64,29,680,308,372,81,72,70,40,1
32520,654,317,337,95,111,44,13,643,373,270,91,43,113,21,1
32521,419,189,230,64,49,36,15,339,183,156,43,45,28,17,1
32522,635,333,302,99,75,83,28,769,362,407,99,88,66,67,1
32523,272,149,123,34,35,21,2,357,169,188,61,53,32,15,1
32524,247,110,137,34,45,23,10,700,265,435,134,106,16,3,1
32525,2524,1232,1292,398,317,186,61,969,505,464,123,133,92,33,1
32526,984,509,475,114,109,106,56,217,109,108,34,32,35,7,1
32527,204,93,111,35,35,16,11,422,203,219,75,49,40,22,1
32528,146,76,70,16,15,14,14,904,448,456,146,103,86,37,1
32529,483,209,274,83,78,52,22,478,219,259,82,80,51,18,1
32530,450,229,221,49,63,54,27,493,275,218,64,36,49,30,1
32531,430,192,238,62,67,27,10,666,344,322,91,73,91,20,1
32532,1390,695,695,180,137,170,71,728,343,385,116,82,96,57,1
32533,330,143,187,63,29,52,20,563,271,292,72,91,34,27,1
32534,963,447,516,120,146,87,74,357,153,204,84,62,39,2,1
32535,209,129,80,18,13,20,12,452,213,239,79,69,39,18,1
32536,585,242,343,110,111,55,20,3312,1761,1551,403,345,309,127,1
32537,217,108,109,30,23,28,10,2414,1189,1225,277,178,170,169,1
32538,395,186,209,53,48,46,30,454,242,212,54,42,61,24,1
32539,220,115,105,31,26,22,18,467,251,216,56,49,79,11,1
32540,689,343,346,119,100,86,38,536,278,258,72,63,62,20,1
32541,277,124,153,44,40,35,18,756,362,394,102,104,73,25,1
32542,690,310,380,114,85,66,27,969,505,464,123,133,92,33,1
32543,202,123,79,12,15,26,21,448,236,212,53,64,56,24,1
32544,703,308,395,81,91,66,80,825,363,462,97,105,72,75,1
32545,292,153,139,39,33,24,21,256,114,142,27,46,30,13,1
32546,782,404,378,101,97,75,33,1040,562,478,125,101,103,32,1
32547,503,298,205,62,28,20,4,377,202,175,46,50,41,22,1
32548,725,365,360,104,111,70,31,202,102,100,29,35,6,9,1
32549,144,57,87,38,26,10,4,703,356,347,96,97,38,22,1
32550,260,123,137,41,25,29,25,753,395,358,93,72,71,16,1
32551,476,251,225,57,67,57,18,115,62,53,17,12,8,7,1
32552,509,341,168,35,32,52,15,128,54,74,30,13,8,7,1
32553,426,234,192,46,41,39,37,312,172,140,41,40,21,8,1
32554,1210,592,618,157,138,116,85,976,520,456,120,115,109,53,1
32555,170,80,90,31,22,12,8,351,226,125,29,22,48,19,1
32556,458,210,248,39,38,25,16,425,210,215,56,43,52,25,1
32557,493,271,222,77,56,74,20,680,351,329,93,97,87,27,1
32558,561,292,269,88,68,64,22,619,332,287,95,77,74,38,1
32559,1338,756,582,155,105,104,44,1001,557,444,113,132,81,53,1
32560,164,88,76,27,20,17,6,365,170,195,49,30,41,10,1
32561,393,186,207,58,50,36,22,235,149,86,30,21,17,5,1
32562,2440,1061,1379,377,326,172,62,882,432,450,115,111,68,44,1
32563,1153,588,565,174,128,149,56,375,202,173,46,49,41,23,1
32564,639,397,242,64,37,64,30,724,320,404,120,147,67,25,1
32565,306,128,178,49,59,17,9,158,85,73,24,18,18,8,1
32566,231,126,105,37,26,29,6,327,177,150,40,40,38,18,1
32567,505,231,274,64,68,30,40,176,73,103,22,29,13,9,1
32568,426,228,198,62,42,47,22,503,263,240,72,55,51,34,1
32569,622,294,328,104,93,42,17,1336,633,703,182,197,110,52,1
32570,223,132,91,18,16,27,17,486,236,250,73,67,59,16,1
32571,496,272,224,70,58,42,18,748,355,393,121,91,95,26,1
32572,1356,576,780,229,198,107,38,246,113,133,33,45,22,10,1
32573,732,402,330,81,86,87,33,360,208,152,47,38,31,20,1
32574,158,74,84,26,23,18,18,444,212,232,74,25,60,24,1
32575,781,418,363,92,90,64,41,467,269,198,46,51,60,18,1
32576,1738,821,917,242,196,181,58,536,278,258,72,63,62,20,1
32577,984,461,523,109,89,91,52,1050,473,577,142,119,87,54,1
32578,470,226,244,81,53,59,39,158,85,73,24,18,18,8,1
32579,476,259,217,64,64,81,15,707,386,321,85,83,99,28,1
32580,505,247,258,72,71,60,27,655,328,327,65,54,55,35,1
32581,365,173,192,47,47,29,14,593,295,298,70,85,48,13,1
32582,379,203,176,55,48,45,16,689,343,346,119,100,86,38,1
32583,601,313,288,42,48,25,36,518,256,262,65,71,50,15,1
32584,309,164,145,35,47,30,11,463,256,207,60,53,39,18,1
32585,770,390,380,104,76,78,32,89,47,42,11,5,6,9,1
32586,536,278,258,72,63,62,20,480,234,246,79,77,65,23,1
32587,1064,381,683,220,182,77,92,247,132,115,24,22,24,13,1
32588,990,410,580,140,175,44,36,807,268,539,203,102,121,56,1
32589,486,236,250,73,67,59,16,365,180,185,63,35,48,19,1
32590,719,343,376,108,78,92,29,666,344,322,91,73,91,20,1
32591,699,376,323,79,53,86,41,355,165,190,53,56,42,19,1
32592,453,255,198,62,49,29,19,642,326,316,86,83,63,26,1
32593,326,140,186,59,42,19,9,372,179,193,50,52,33,6,1
32594,549,244,305,105,79,39,19,486,236,250,73,67,59,16,1
32595,1192,579,613,120,215,79,24,683,367,316,87,73,40,17,1
32596,382,207,175,55,32,40,13,1487,996,491,147,141,50,35,1
32597,103,44,59,16,17,9,5,404,197,207,60,48,47,20,1
32598,92,49,43,7,8,10,9,355,220,135,43,26,65,20,1
32599,393,186,207,58,50,36,22,355,169,186,49,37,26,11,1
32600,287,154,133,33,27,36,15,303,147,156,43,20,32,6,1
32601,351,184,167,59,45,54,9,517,250,267,78,37,64,29,1
32602,536,222,314,101,100,34,22,233,94,139,36,37,15,8,1
32603,1424,650,774,152,124,95,87,530,259,271,83,50,54,41,1
32604,2004,839,1165,291,300,148,108,480,252,228,55,37,49,20,1
32605,836,407,429,122,89,61,21,724,334,390,112,109,79,17,1
32606,1269,550,719,188,162,102,50,356,199,157,43,58,29,12,1
32607,323,181,142,40,37,26,16,242,125,117,38,31,28,22,1
32608,309,205,104,28,23,39,16,419,212,207,61,44,35,21,1
32609,798,287,511,126,125,77,26,458,225,233,67,61,43,33,1
32610,1332,659,673,174,170,153,55,745,366,379,110,93,79,45,1
32611,339,170,169,32,17,24,13,904,436,468,138,146,82,39,1
32612,1019,512,507,94,114,125,49,79,38,41,8,7,5,7,1
32613,207,124,83,22,19,24,11,1005,540,465,133,101,106,55,1
32614,298,160,138,37,30,22,12,288,118,170,50,57,18,15,1
32615,921,455,466,144,127,108,39,908,488,420,115,97,111,43,1
32616,1581,684,897,220,153,118,63,920,492,428,100,92,88,49,1
32617,323,181,142,40,37,26,16,201,42,159,19,3,2,75,1
32618,894,469,425,127,93,82,31,361,184,177,50,53,51,22,1
32619,756,362,394,102,104,73,25,541,273,268,67,48,48,30,1
32620,478,254,224,67,74,56,28,467,224,243,70,43,67,23,1
32621,561,343,218,53,63,37,15,780,337,443,112,116,77,28,1
32622,303,159,144,40,35,35,8,825,363,462,97,105,72,75,1
32623,1027,444,583,127,80,80,36,227,109,118,42,35,29,8,1
32624,719,301,418,122,132,42,26,271,159,112,34,34,33,7,1
32625,223,113,110,31,33,22,12,854,380,474,137,159,81,31,1
32626,538,252,286,77,87,53,30,671,321,350,95,87,75,34,1
32627,360,218,142,39,26,50,18,107,57,50,16,3,3,6,1
32628,396,226,170,26,35,47,18,110,67,43,9,10,11,8,1
32629,525,245,280,59,72,47,21,1187,631,556,182,139,152,56,1
32630,123,61,62,17,18,17,7,164,87,77,16,18,12,20,1
32631,406,202,204,54,54,41,16,443,198,245,68,72,48,19,1
32632,707,391,316,111,80,54,30,557,306,251,66,42,52,15,1
32633,920,492,428,100,92,88,49,671,303,368,93,68,61,26,1
32634,556,279,277,83,69,71,19,596,286,310,90,89,78,37,1
32635,666,329,337,90,90,54,19,896,407,489,97,152,70,22,1
32636,99,49,50,16,8,7,8,355,220,135,43,26,65,20,1
32637,724,334,390,112,109,79,17,535,249,286,79,64,55,22,1
32638,192,91,101,29,28,17,7,356,199,157,43,58,29,12,1
32639,299,164,135,30,21,29,10,246,115,131,15,29,10,32,1
32640,686,334,352,107,93,73,43,782,421,361,101,97,82,20,1
32641,1948,1039,909,242,227,200,67,771,321,450,151,135,43,15,1
32642,1015,457,558,110,160,49,26,930,367,563,181,153,83,48,1
32643,267,159,108,31,13,22,15,170,80,90,31,22,12,8,1
32644,593,321,272,64,84,33,20,885,339,546,159,135,81,49,1
32645,493,230,263,73,47,47,13,684,288,396,107,90,54,42,1
32646,132,57,75,25,9,6,13,317,201,116,31,14,38,20,1
32647,2627,1378,1249,361,265,257,96,393,186,207,58,50,36,22,1
32648,408,215,193,47,31,42,17,245,181,64,6,6,25,8,1
32649,1721,838,883,241,218,144,54,557,278,279,75,70,66,31,1
32650,1193,492,701,152,190,66,53,136,72,64,22,16,7,3,1
32651,505,296,209,55,50,45,23,198,113,85,19,20,26,12,1
32652,427,236,191,49,54,46,13,748,355,393,121,91,95,26,1
32653,929,462,467,106,88,78,44,423,186,237,92,40,52,29,1
32654,288,159,129,27,44,27,15,674,248,426,169,95,56,16,1
32655,706,320,386,111,76,75,51,890,432,458,127,107,99,50,1
32656,527,257,270,72,68,50,28,334,172,162,43,39,41,17,1
32657,327,177,150,40,40,38,18,435,212,223,71,56,40,18,1
32658,377,184,193,56,53,44,14,508,215,293,72,71,42,15,1
32659,672,334,338,110,93,91,41,154,73,81,24,27,18,9,1
32660,415,209,206,60,67,39,18,908,488,420,115,97,111,43,1
32661,649,330,319,82,67,81,31,906,455,451,116,105,87,46,1
32662,261,137,124,38,37,29,9,304,127,177,61,38,31,4,1
32663,317,153,164,34,52,30,14,147,79,68,20,15,19,8,1
32664,806,436,370,101,100,76,34,142,76,66,22,14,19,3,1
32665,1071,549,522,133,127,130,59,2090,1085,1005,167,141,168,40,1
32666,236,141,95,36,32,14,6,2414,1189,1225,277,178,170,169,1
32667,740,331,409,125,97,79,35,147,79,68,20,15,19,8,1
32668,246,113,133,33,45,22,10,657,293,364,109,75,66,28,1
32669,306,128,178,49,59,17,9,673,313,360,101,101,46,17,1
32670,631,332,299,61,104,60,19,399,238,161,55,41,42,12,1
32671,1242,613,629,174,113,114,53,1354,537,817,245,247,117,57,1
32672,803,358,445,135,117,80,44,799,377,422,98,95,80,70,1
32673,770,356,414,123,102,66,25,229,112,117,42,23,13,10,1
32674,2442,1193,1249,278,183,170,145,1360,644,716,213,194,136,62,1
32675,128,54,74,30,13,8,7,390,207,183,50,48,38,15,1
32676,620,305,315,97,80,87,28,1290,629,661,191,187,167,55,1
32677,622,299,323,86,86,69,35,431,201,230,69,39,55,33,1
32678,393,186,207,58,50,36,22,603,311,292,102,71,66,23,1
32679,444,189,255,72,82,45,17,1333,646,687,209,179,148,45,1
32680,344,181,163,61,37,40,14,1047,562,485,141,127,114,41,1
32681,1214,498,716,197,180,121,65,465,225,240,65,44,65,25,1
32682,359,157,202,47,52,24,17,503,263,240,72,55,51,34,1
32683,784,391,393,105,113,86,21,968,452,516,150,144,79,28,1
32684,771,331,440,136,104,72,27,245,112,133,32,45,20,10,1
32685,467,224,243,70,43,67,23,158,83,75,22,14,17,9,1
32686,1655,891,764,205,245,81,30,612,330,282,71,54,63,37,1
32687,839,439,400,101,86,102,43,257,118,139,44,28,23,11,1
32688,938,484,454,137,100,104,41,781,418,363,92,90,64,41,1
32689,129,66,63,23,17,18,4,407,240,167,38,29,67,26,1
32690,351,184,167,59,45,54,9,184,86,98,26,26,14,11,1
32691,517,287,230,60,43,78,23,485,273,212,52,47,51,17,1
32692,933,493,440,140,108,124,32,364,200,164,48,43,32,11,1
32693,467,226,241,55,48,54,23,151,75,76,30,16,8,7,1
32694,191,99,92,25,24,18,8,254,120,134,32,32,24,8,1
32695,390,191,199,57,49,45,25,338,208,130,39,30,35,12,1
32696,833,452,381,117,85,71,39,262,144,118,19,39,22,8,1
32697,525,254,271,60,76,46,13,242,104,138,41,33,37,8,1
32698,154,66,88,26,13,12,10,283,132,151,57,33,12,7,1
32699,207,107,100,27,25,20,11,230,115,115,29,29,22,14,1
32700,159,84,75,13,28,10,8,462,233,229,66,49,43,30,1
32701,1270,682,588,165,147,136,54,655,281,374,108,103,61,24,1
32702,3911,1465,2446,610,767,240,133,418,213,205,54,70,38,18,1
32703,31,21,10,2,1,5,2,1001,557,444,113,132,81,53,1
32704,435,221,214,72,45,47,19,655,311,344,69,73,60,28,1
32705,345,141,204,64,58,13,11,1390,695,695,180,137,170,71,1
32706,629,301,328,65,69,77,27,770,374,396,95,91,79,41,1
32707,851,417,434,109,116,83,28,557,268,289,66,67,70,17,1
32708,466,242,224,66,53,53,13,358,212,146,51,36,33,9,1
32709,93,54,39,13,9,9,7,739,359,380,83,95,53,38,1
32710,400,174,226,67,50,28,14,212,107,105,29,26,25,8,1
32711,951,506,445,107,118,79,40,757,373,384,115,93,95,25,1
32712,132,57,75,25,9,6,13,360,224,136,26,20,50,35,1
32713,254,139,115,29,35,27,11,331,191,140,44,37,45,20,1
32714,277,124,153,44,40,35,18,706,346,360,118,92,98,56,1
32715,335,128,207,59,43,24,23,624,308,316,92,72,68,22,1
32716,229,134,95,25,13,28,10,253,127,126,31,25,21,21,1
32717,346,208,138,46,39,51,18,437,225,212,61,57,66,12,1
32718,928,442,486,139,118,91,43,513,246,267,71,66,60,35,1
32719,261,127,134,33,24,30,13,239,116,123,24,22,21,9,1
32720,423,219,204,57,43,50,17,418,248,170,41,31,54,9,1
32721,860,457,403,118,103,103,36,503,259,244,73,53,52,28,1
32722,247,110,137,34,45,23,10,790,352,438,132,87,91,60,1
32723,1194,609,585,195,142,105,37,482,231,251,76,81,64,26,1
32724,379,203,176,55,48,45,16,592,291,301,92,93,71,31,1
32725,297,158,139,47,37,37,9,435,208,227,68,64,53,23,1
32726,671,321,350,95,87,75,34,557,240,317,97,74,68,37,1
32727,716,354,362,102,87,77,30,580,339,241,72,47,66,21,1
32728,700,335,365,83,84,95,33,115,62,53,17,12,8,7,1
32729,131,74,57,17,14,12,4,126,66,60,24,10,7,9,1
32730,635,333,302,99,75,83,28,672,334,338,110,93,91,41,1
32731,737,374,363,100,95,103,29,350,182,168,39,41,49,14,1
32732,127,62,65,13,33,7,6,210,102,108,33,33,20,9,1
32733,561,278,283,75,60,63,25,1770,824,946,245,258,179,60,1
32734,864,362,502,142,150,70,19,911,551,360,92,106,107,29,1
32735,391,208,183,65,49,57,17,262,150,112,31,33,31,7,1
32736,168,82,86,30,23,19,10,178,89,89,26,21,21,10,1
32737,437,221,216,62,64,47,13,628,315,313,88,95,54,28,1
32738,1171,586,585,177,177,111,39,33423,16370,17053,4965,4756,2786,883,1
32739,103,51,52,15,17,6,5,126,66,60,24,10,7,9,1
32740,206,86,120,40,13,23,14,408,197,211,74,44,53,16,1
32741,572,353,219,70,42,57,25,540,306,234,74,52,43,22,1
32742,290,127,163,47,58,23,12,220,113,107,37,24,16,7,1
32743,482,152,330,126,83,51,19,240,99,141,53,38,29,15,1
32744,384,196,188,42,43,32,20,194,81,113,64,9,7,2,1
32745,641,324,317,88,92,49,14,778,367,411,90,85,64,43,1
32746,1134,570,564,152,133,131,69,211,114,97,32,24,19,10,1
32747,241,115,126,35,30,17,14,175,91,84,19,21,21,10,1
32748,593,266,327,102,84,69,24,1367,690,677,172,175,154,83,1
32749,1130,538,592,158,118,113,44,487,229,258,68,82,41,24,1
32750,207,107,100,27,25,20,11,510,246,264,80,71,15,18,1
32751,764,430,334,82,82,94,32,221,141,80,18,11,34,11,1
32752,1690,795,895,271,257,150,101,595,316,279,86,60,65,40,1
32753,1231,566,665,164,147,154,103,185,94,91,36,13,17,7,1
32754,1149,568,581,177,133,101,30,912,461,451,127,109,96,48,1
32755,194,90,104,33,17,24,19,133,69,64,25,18,10,5,1
32756,822,392,430,125,104,79,24,1210,592,618,157,138,116,85,1
32757,347,220,127,20,6,40,25,536,278,258,72,63,62,20,1
32758,189,93,96,24,28,17,12,239,146,93,30,22,35,9,1
32759,494,123,371,160,58,29,5,757,373,384,115,93,95,25,1
32760,582,330,252,82,69,87,21,220,115,105,31,26,22,18,1
32761,677,245,432,129,155,72,11,403,185,218,67,62,63,19,1
32762,201,98,103,26,35,16,5,586,254,332,114,111,55,17,1
32763,205,135,70,21,16,24,4,201,114,87,21,16,21,5,1
32764,136,65,71,33,11,9,6,472,264,208,46,26,50,29,1
32765,394,202,192,44,43,38,28,906,460,446,117,131,108,33,1
32766,396,192,204,71,41,51,15,509,254,255,67,55,52,35,1
32767,526,228,298,79,74,45,21,193,99,94,31,31,16,12,1
32768,667,360,307,76,92,46,27,277,100,177,35,88,30,2,1
32769,480,234,246,79,77,65,23,920,492,428,100,92,88,49,1
32770,672,334,338,110,93,91,41,489,253,236,68,68,46,23,1
32771,93,46,47,6,8,8,8,352,212,140,37,17,61,20,1
32772,413,194,219,77,72,28,11,282,135,147,36,49,25,10,1
32773,339,170,169,32,17,24,13,671,318,353,83,124,46,34,1
32774,577,217,360,100,116,32,24,648,341,307,78,89,77,21,1
32775,866,466,400,100,114,92,45,155,73,82,24,13,15,9,1
32776,309,154,155,42,44,45,16,344,159,185,47,50,35,23,1
32777,532,267,265,86,55,64,22,1124,578,546,149,127,122,61,1
32778,101,41,60,18,19,10,5,520,224,296,69,64,31,29,1
32779,204,103,101,16,32,22,8,103,56,47,27,7,8,2,1
32780,467,226,241,55,48,54,23,569,283,286,40,16,60,7,1
32781,437,225,212,61,57,66,12,1176,602,574,184,161,140,61,1
32782,447,225,222,76,35,75,21,1586,815,771,196,135,138,67,1
32783,1161,514,647,159,138,122,37,304,127,177,61,38,31,4,1
32784,337,202,135,39,26,46,22,253,148,105,31,15,39,16,1
32785,564,291,273,77,72,95,21,445,219,226,61,60,60,21,1
32786,277,124,153,44,40,35,18,795,305,490,169,178,66,22,1
32787,467,226,241,55,48,54,23,2090,1085,1005,167,141,168,40,1
32788,1235,454,781,212,249,74,37,277,124,153,44,40,35,18,1
32789,280,118,162,35,32,41,37,1074,539,535,136,87,87,66,1
32790,351,184,167,59,45,54,9,689,343,346,105,102,81,35,1
32791,399,202,197,46,52,36,16,919,444,475,141,148,62,20,1
32792,721,379,342,89,73,68,25,1881,929,952,259,247,158,57,1
32793,543,277,266,62,54,70,19,342,208,134,36,31,29,15,1
32794,644,290,354,125,72,85,42,835,420,415,104,105,57,47,1
32795,770,385,385,78,83,60,16,799,377,422,98,95,80,70,1
32796,481,189,292,119,69,84,26,182,99,83,26,30,22,2,1
32797,441,201,240,70,58,55,24,751,312,439,131,115,78,48,1
32798,415,242,173,53,21,70,21,359,173,186,55,57,44,16,1
32799,377,177,200,63,53,44,16,673,329,344,111,95,92,41,1
32800,963,385,578,171,162,62,35,206,85,121,31,42,6,17,1
32801,451,239,212,53,64,56,22,143,79,64,16,25,7,5,1
32802,3144,1617,1527,367,342,278,136,1047,562,485,141,127,114,41,1
32803,600,319,281,94,67,72,37,658,349,309,77,70,73,35,1
32804,2261,1217,1044,271,243,267,101,2161,1233,928,269,199,178,42,1
32805,632,339,293,83,77,59,20,635,333,302,99,75,83,28,1
32806,391,208,183,65,49,57,17,1486,738,748,192,206,85,34,1
32807,2033,877,1156,359,333,106,44,98,49,49,14,15,9,2,1
32808,305,168,137,48,35,40,9,164,78,86,28,23,12,8,1
32809,290,138,152,37,50,24,14,188,81,107,26,29,18,5,1
32810,624,204,420,166,101,32,13,330,77,253,86,52,20,12,1
32811,347,160,187,46,49,33,29,261,127,134,33,24,30,13,1
32812,706,307,399,121,102,65,36,526,169,357,109,86,69,30,1
32813,352,212,140,37,17,61,20,770,374,396,95,91,79,41,1
32814,442,254,188,46,22,40,19,1581,684,897,220,153,118,63,1
32815,1537,701,836,209,187,129,58,489,242,247,83,63,62,19,1
32816,517,274,243,64,62,59,15,1834,823,1011,297,282,151,63,1
32817,227,124,103,33,21,16,19,425,210,215,56,43,52,25,1
32818,384,237,147,50,43,31,11,215,80,135,54,56,21,9,1
32819,626,345,281,62,76,66,25,2477,1186,1291,256,271,249,90,1
32820,454,224,230,71,39,62,22,76,42,34,12,8,5,7,1
32821,871,482,389,113,95,109,35,526,264,262,77,71,61,27,1
32822,352,166,186,55,59,31,16,665,297,368,111,107,34,12,1
32823,204,119,85,28,18,27,8,211,126,85,21,20,28,7,1
32824,404,197,207,60,48,47,20,198,80,118,35,31,14,7,1
32825,504,237,267,62,66,48,17,225,124,101,19,22,25,9,1
32826,540,271,269,80,77,51,16,293,153,140,45,38,22,15,1
32827,1190,638,552,162,95,112,18,1534,735,799,174,152,134,126,1
32828,560,281,279,68,62,36,14,928,442,486,139,118,91,43,1
32829,771,321,450,151,135,43,15,334,96,238,104,49,19,2,1
32830,1566,743,823,261,188,151,48,1188,476,712,179,163,93,57,1
32831,615,293,322,70,67,45,29,378,154,224,74,84,35,22,1
32832,986,499,487,123,116,98,54,822,416,406,111,105,84,44,1
32833,262,150,112,31,33,31,7,928,442,486,139,118,91,43,1
32834,493,230,263,73,47,47,13,623,298,325,94,59,79,21,1
32835,428,207,221,65,52,53,24,163,71,92,22,38,11,7,1
32836,195,86,109,31,37,19,5,372,171,201,47,53,39,18,1
32837,671,303,368,93,68,61,26,149,68,81,15,38,11,10,1
32838,930,367,563,181,153,83,48,646,298,348,91,110,63,33,1
32839,578,318,260,70,50,80,17,395,204,191,51,48,54,20,1
32840,391,203,188,49,34,36,9,480,252,228,55,37,49,20,1
32841,402,227,175,48,40,35,11,875,421,454,124,142,98,43,1
32842,207,93,114,20,33,19,10,205,91,114,31,36,13,8,1
32843,475,268,207,61,27,56,30,572,353,219,70,42,57,25,1
32844,202,86,116,33,29,26,10,354,168,186,50,53,39,20,1
32845,822,416,406,111,105,84,44,1290,629,661,191,187,167,55,1
32846,2069,1004,1065,319,254,267,92,191,99,92,25,24,18,8,1
32847,620,305,315,97,80,87,28,165,87,78,24,19,22,9,1
32848,697,373,324,105,83,95,38,255,122,133,35,51,22,13,1
32849,418,213,205,54,56,49,13,247,132,115,24,22,24,13,1
32850,393,186,207,58,50,36,22,729,325,404,129,88,64,32,1
32851,745,366,379,110,93,79,45,449,244,205,68,53,49,12,1
32852,160,67,93,32,37,15,9,1042,530,512,162,150,103,52,1
32853,740,385,355,114,97,91,27,341,154,187,34,36,11,11,1
32854,948,484,464,134,131,75,27,367,195,172,57,54,43,16,1
32855,1170,510,660,142,182,115,84,4544,2024,2520,579,628,480,403,1
32856,382,214,168,49,20,47,23,422,245,177,50,31,42,22,1
32857,695,373,322,80,59,89,39,156,64,92,39,19,15,8,1
32858,149,77,72,19,15,18,9,875,421,454,124,142,98,43,1
32859,509,262,247,64,70,64,20,1074,538,536,154,140,111,51,1
32860,670,333,337,95,79,62,21,552,285,267,74,51,69,24,1
32861,375,167,208,55,83,44,9,136,65,71,33,11,9,6,1
32862,337,152,185,58,43,38,17,215,80,135,54,56,21,9,1
32863,424,191,233,76,73,49,13,444,189,255,72,82,45,17,1
32864,393,186,207,58,50,36,22,410,188,222,53,52,31,14,1
32865,267,147,120,37,28,35,12,707,386,321,85,83,99,28,1
32866,198,113,85,19,20,26,12,1873,1066,807,217,201,237,105,1
32867,327,175,152,48,45,36,16,376,199,177,54,49,48,22,1
32868,950,497,453,146,127,115,43,462,251,211,74,53,41,18,1
32869,432,219,213,58,51,39,20,659,334,325,90,79,72,36,1
32870,829,366,463,137,130,56,10,128,67,61,19,13,15,4,1
32871,347,154,193,48,51,25,11,575,290,285,67,70,28,9,1
32872,943,496,447,112,98,101,59,380,184,196,56,35,44,36,1
32873,504,237,267,62,66,48,17,1147,471,676,229,164,86,37,1
32874,377,202,175,46,50,41,23,2472,1055,1417,416,458,235,64,1
32875,272,124,148,51,36,23,27,622,299,323,86,86,69,35,1
32876,558,286,272,76,67,45,30,412,195,217,79,48,36,29,1
32877,1527,633,894,314,260,134,67,411,171,240,61,81,30,15,1
32878,450,229,221,49,63,54,27,287,151,136,51,42,36,7,1
32879,440,246,194,62,49,41,16,1038,470,568,130,123,86,51,1
32880,2220,1085,1135,312,304,202,91,149,68,81,15,38,11,10,1
32881,1960,875,1085,287,189,162,66,331,169,162,40,28,22,14,1
32882,782,421,361,101,97,82,20,770,355,415,103,142,75,42,1
32883,455,218,237,57,51,42,35,1132,553,579,172,143,150,57,1
32884,709,310,399,95,103,61,30,1068,539,529,161,134,132,71,1
32885,95,44,51,14,13,7,4,358,180,178,57,55,39,11,1
32886,370,194,176,51,57,43,17,1123,554,569,142,130,85,36,1
32887,298,154,144,44,34,25,11,643,282,361,94,109,59,24,1
32888,579,250,329,90,61,62,45,299,155,144,39,38,34,16,1
32889,605,295,310,74,66,70,36,556,279,277,83,69,71,19,1
32890,784,391,393,105,113,86,21,346,183,163,51,38,23,6,1
32891,171,94,77,24,28,30,11,735,426,309,93,60,71,33,1
32892,603,311,292,102,71,66,23,620,258,362,106,100,47,28,1
32893,261,143,118,33,24,32,16,582,189,393,117,66,66,6,1
32894,467,221,246,98,68,43,11,740,313,427,101,135,40,22,1
32895,503,263,240,72,55,51,34,742,303,439,88,96,86,23,1
32896,194,103,91,26,32,13,8,377,201,176,46,50,41,23,1
32897,334,172,162,43,39,41,17,101,43,58,18,16,12,7,1
32898,860,457,403,118,103,103,36,503,263,240,72,55,51,34,1
32899,219,97,122,30,29,23,9,306,144,162,52,35,40,16,1
32900,158,76,82,18,23,14,8,247,127,120,43,20,27,14,1
32901,275,140,135,38,32,18,5,780,369,411,130,113,79,35,1
32902,560,244,316,92,118,47,12,785,374,411,56,42,38,25,1
32903,920,289,631,237,141,98,11,247,110,137,34,45,23,10,1
32904,339,170,169,32,17,24,13,215,80,135,54,56,21,9,1
32905,967,463,504,133,114,99,62,3396,1499,1897,325,572,309,90,1
32906,183,97,86,30,18,20,12,259,133,126,26,30,22,22,1
32907,430,198,232,57,46,37,19,340,145,195,46,38,26,23,1
32908,355,214,141,43,29,63,13,770,374,396,95,91,79,41,1
32909,551,233,318,103,99,64,23,1051,523,528,164,140,126,50,1
32910,168,90,78,22,19,13,4,303,175,128,43,36,34,12,1
32911,598,316,282,81,83,71,21,1698,875,823,222,219,173,64,1
32912,456,228,228,49,70,32,19,647,255,392,99,55,52,17,1
32913,728,385,343,110,102,69,14,1255,666,589,145,142,120,82,1
32914,230,113,117,31,40,28,10,354,140,214,55,50,31,18,1
32915,222,106,116,31,27,27,15,485,273,212,52,47,51,17,1
32916,331,169,162,40,28,22,14,372,201,171,52,50,42,13,1
32917,292,108,184,47,64,19,15,641,324,317,88,92,49,14,1
32918,1270,682,588,165,147,136,54,916,474,442,106,139,98,50,1
32919,1564,799,765,223,181,170,67,467,224,243,70,43,67,23,1
32920,480,234,246,79,77,65,23,390,191,199,66,49,43,12,1
32921,216,119,97,33,27,28,7,467,226,241,55,48,54,23,1
32922,229,105,124,36,33,12,4,838,431,407,107,90,107,43,1
32923,1332,637,695,214,178,117,40,377,201,176,46,50,41,23,1
32924,2442,1193,1249,278,183,170,145,882,432,450,115,111,68,44,1
32925,766,395,371,89,86,127,27,1304,585,719,179,169,154,47,1
32926,952,464,488,143,135,72,21,396,202,194,60,48,55,18,1
32927,414,185,229,53,54,49,11,212,135,77,22,13,44,7,1
32928,193,83,110,26,20,16,9,875,421,454,124,142,98,43,1
32929,964,408,556,131,153,76,55,416,201,215,54,52,39,25,1
32930,913,393,520,160,165,87,40,144,63,81,28,32,11,5,1
32931,194,82,112,28,24,19,6,219,97,122,30,29,23,9,1
32932,737,320,417,112,94,73,34,2442,1193,1249,278,183,170,145,1
32933,325,181,144,46,31,48,9,476,254,222,58,33,46,23,1
32934,827,505,322,100,93,68,40,1992,927,1065,292,228,166,77,1
32935,427,191,236,67,60,41,34,462,233,229,66,49,43,30,1
32936,707,295,412,105,105,66,30,2556,1169,1387,248,291,227,275,1
32937,267,161,106,22,25,35,20,769,362,407,99,88,66,67,1
32938,906,455,451,116,105,87,46,245,111,134,31,44,20,11,1
32939,730,298,432,128,69,86,26,948,484,464,134,131,75,27,1
32940,386,189,197,54,57,39,16,632,326,306,92,71,56,19,1
32941,876,457,419,88,124,67,47,822,416,406,111,105,84,44,1
32942,918,427,491,113,111,113,33,212,102,110,25,24,17,10,1
32943,3075,1459,1616,390,359,298,207,1663,835,828,224,213,163,63,1
32944,483,274,209,54,39,45,13,431,228,203,66,46,59,15,1
32945,446,233,213,74,21,59,71,553,261,292,73,79,40,26,1
32946,593,291,302,81,85,56,20,631,261,370,110,109,50,26,1
32947,675,338,337,91,85,28,23,810,367,443,115,92,94,59,1
32948,504,272,232,72,41,57,23,1123,554,569,142,130,85,36,1
32949,1092,562,530,126,91,125,84,825,399,426,128,128,77,32,1
32950,1738,821,917,242,196,181,58,1290,629,661,191,187,167,55,1
32951,705,396,309,87,48,53,17,2472,1055,1417,416,458,235,64,1
32952,839,446,393,125,110,94,35,261,108,153,35,37,16,6,1
32953,509,262,247,64,70,64,20,619,332,287,95,77,74,38,1
32954,135,69,66,21,14,11,5,1749,880,869,237,228,214,112,1
32955,218,102,116,32,31,21,4,653,309,344,107,75,49,14,1
32956,291,131,160,49,35,32,15,331,169,162,40,28,22,14,1
32957,833,452,381,117,85,71,39,304,159,145,38,40,32,3,1
32958,278,131,147,29,30,33,12,292,141,151,45,23,35,13,1
32959,780,337,443,112,116,77,28,1074,538,536,154,140,111,51,1
32960,548,236,312,88,88,63,25,258,111,147,46,63,17,6,1
32961,3477,1607,1870,792,235,429,146,603,311,292,102,71,66,23,1
32962,362,211,151,46,35,42,12,350,180,170,64,46,55,12,1
32963,280,118,162,35,32,41,37,985,551,434,123,93,91,26,1
32964,459,221,238,52,76,33,24,1893,764,1129,308,323,126,60,1
32965,313,155,158,33,39,28,16,4655,2074,2581,545,652,562,399,1
32966,1015,497,518,141,148,72,39,853,400,453,137,109,88,42,1
32967,2315,1086,1229,231,306,248,64,1513,702,811,233,205,160,57,1
32968,461,229,232,62,52,56,28,217,109,108,34,32,35,7,1
32969,342,160,182,69,40,37,16,1014,490,524,177,137,94,38,1
32970,189,105,84,17,20,21,10,100,51,49,12,12,8,4,1
32971,326,141,185,57,39,33,20,168,67,101,37,17,13,13,1
32972,340,158,182,51,56,9,7,454,209,245,85,78,45,9,1
32973,1124,615,509,157,125,128,52,825,427,398,79,95,81,48,1
32974,504,255,249,56,59,45,13,606,279,327,81,70,49,34,1
32975,707,391,316,111,80,54,30,765,295,470,200,142,84,27,1
32976,1367,690,677,172,175,154,83,534,285,249,87,77,59,16,1
32977,109,42,67,25,13,1,1,350,180,170,64,46,55,12,1
32978,250,130,120,40,32,19,13,646,316,330,89,95,48,17,1
32979,528,283,245,77,72,63,11,795,305,490,169,178,66,22,1
32980,400,215,185,59,54,33,16,606,307,299,92,56,68,30,1
32981,953,421,532,131,131,70,37,1970,978,992,245,206,198,80,1
32982,1058,558,500,132,127,121,53,135,73,62,15,16,15,8,1
32983,1690,795,895,271,257,150,101,462,228,234,59,47,37,32,1
32984,466,186,280,71,84,30,11,642,325,317,74,78,73,43,1
32985,385,179,206,58,56,38,19,323,169,154,47,44,39,20,1
32986,548,292,256,67,65,68,26,1292,633,659,171,202,109,47,1
32987,515,274,241,85,42,77,23,399,201,198,65,45,48,17,1
32988,267,124,143,45,46,26,4,481,268,213,54,48,53,14,1
32989,346,168,178,36,43,20,9,1068,527,541,160,131,112,52,1
32990,202,115,87,28,10,22,8,918,427,491,113,111,113,33,1
32991,546,279,267,94,60,32,22,298,167,131,47,33,40,8,1
32992,103,56,47,27,7,8,2,960,376,584,168,128,70,45,1
32993,365,215,150,39,35,43,10,609,279,330,103,98,72,42,1
32994,671,318,353,83,124,46,34,377,158,219,80,68,26,14,1
32995,603,311,292,102,71,66,23,3418,1378,2040,515,464,318,121,1
32996,576,250,326,93,71,34,15,659,334,325,90,79,72,36,1
32997,1164,531,633,179,157,107,46,543,221,322,78,122,37,12,1
32998,704,373,331,74,153,34,10,400,228,172,43,20,47,24,1
32999,674,268,406,118,96,70,21,719,364,355,104,100,58,34,1
33000,309,154,155,42,44,45,16,524,270,254,84,72,70,23,1
33001,1134,574,560,157,164,47,48,513,271,242,54,52,44,13,1
33002,303,158,145,47,40,41,12,80,41,39,9,7,5,5,1
33003,465,228,237,64,42,63,24,513,260,253,71,50,58,23,1
33004,672,334,338,110,93,91,41,320,163,157,44,44,26,15,1
33005,703,308,395,81,91,66,80,724,650,74,44,3,32,3,1
33006,502,299,203,57,52,32,11,724,334,390,112,109,79,17,1
33007,305,168,137,48,35,40,9,368,175,193,72,43,39,15,1
33008,52,24,28,6,4,3,5,290,127,163,47,58,23,12,1
33009,411,208,203,63,44,52,19,473,217,256,59,44,34,21,1
33010,355,165,190,53,56,42,19,427,230,197,48,28,60,37,1
33011,605,285,320,89,61,68,26,202,102,100,29,35,6,9,1
33012,686,345,341,98,106,75,25,2758,1332,1426,394,384,287,131,1
33013,749,360,389,91,122,59,37,551,298,253,63,65,45,19,1
33014,646,355,291,99,62,72,21,191,85,106,24,34,19,5,1
33015,480,234,246,79,77,65,23,751,312,439,131,115,78,48,1
33016,901,439,462,133,123,102,45,215,105,110,26,22,19,9,1
33017,815,418,397,97,62,70,17,158,85,73,24,18,18,8,1
33018,1212,645,567,145,117,122,72,333,167,166,45,30,34,14,1
33019,324,219,105,25,24,27,14,592,291,301,92,93,71,31,1
33020,1691,1159,532,160,109,95,46,1231,603,628,121,162,109,120,1
33021,317,153,164,39,30,35,13,1290,629,661,191,187,167,55,1
33022,699,376,323,79,53,86,41,165,89,76,17,12,8,16,1
33023,920,492,428,100,92,88,49,732,355,377,108,109,79,27,1
33024,863,458,405,97,82,63,57,1100,474,626,197,143,126,41,1
33025,462,251,211,74,53,41,18,402,227,175,48,40,35,11,1
33026,350,181,169,44,52,43,13,167,79,88,22,26,16,9,1
33027,762,363,399,132,107,82,26,1234,590,644,180,182,95,40,1
33028,369,216,153,36,22,46,23,624,308,316,92,72,68,22,1
33029,501,240,261,80,62,49,42,377,184,193,50,43,33,17,1
33030,327,177,150,40,40,38,18,445,219,226,61,60,60,21,1
33031,1363,690,673,185,172,152,62,1270,557,713,130,195,57,30,1
33032,314,158,156,41,57,30,12,439,227,212,60,55,58,8,1
33033,541,279,262,79,82,31,32,301,133,168,41,60,26,18,1
33034,593,295,298,70,85,48,13,695,340,355,79,124,53,13,1
33035,218,127,91,27,23,23,10,245,111,134,31,44,20,11,1
33036,744,371,373,103,82,79,39,112,59,53,12,17,14,8,1
33037,484,182,302,124,66,20,8,221,75,146,68,21,16,5,1
33038,1149,568,581,177,133,101,30,1154,540,614,195,160,138,66,1
33039,611,229,382,121,126,46,5,1382,508,874,334,320,98,36,1
33040,349,186,163,43,45,51,12,482,231,251,76,81,64,26,1
33041,1435,649,786,214,181,135,54,1621,750,871,276,243,162,51,1
33042,393,186,207,58,50,36,22,294,146,148,50,45,51,15,1
33043,686,334,352,107,93,73,43,166,81,85,30,27,13,8,1
33044,326,151,175,50,39,36,17,536,278,258,72,63,62,20,1
33045,1085,646,439,108,65,36,19,3144,1617,1527,367,342,278,136,1
33046,425,210,215,56,43,52,25,505,269,236,52,59,32,18,1
33047,448,223,225,50,58,39,34,501,240,261,80,62,49,42,1
33048,1068,559,509,158,132,122,57,757,359,398,109,127,80,26,1
33049,201,111,90,25,29,26,13,1233,635,598,187,149,146,51,1
33050,1071,549,522,133,127,130,59,3224,1440,1784,455,440,333,126,1
33051,623,332,291,58,66,53,15,245,111,134,31,44,20,11,1
33052,175,88,87,29,29,23,6,859,429,430,126,115,64,33,1
33053,487,223,264,81,68,63,15,359,173,186,55,57,44,16,1
33054,656,358,298,67,47,64,26,2511,1400,1111,295,265,244,89,1
33055,249,111,138,40,30,22,17,474,197,277,80,67,52,13,1
33056,527,257,270,72,68,50,28,648,341,307,78,89,77,21,1
33057,327,160,167,56,31,36,15,322,160,162,44,52,33,16,1
33058,1133,491,642,192,170,61,29,202,102,100,29,35,6,9,1
33059,404,190,214,55,55,35,27,749,374,375,99,108,98,37,1
33060,219,104,115,25,31,25,11,764,380,384,89,92,67,25,1
33061,710,375,335,95,94,110,28,170,82,88,28,23,20,12,1
33062,212,117,95,23,27,21,11,853,401,452,121,118,74,38,1
33063,620,305,315,97,80,87,28,503,263,240,72,55,51,34,1
33064,635,333,302,99,75,83,28,536,278,258,72,63,62,20,1
33065,870,489,381,97,99,76,14,724,334,390,112,109,79,17,1
33066,357,161,196,55,59,24,9,1247,548,699,168,150,140,43,1
33067,311,173,138,43,21,45,19,583,322,261,73,66,45,26,1
33068,248,119,129,33,48,20,10,462,251,211,74,53,41,18,1
33069,1805,814,991,257,268,155,59,949,512,437,102,124,70,41,1
33070,322,180,142,45,38,28,7,1434,727,707,210,173,161,54,1
33071,368,141,227,64,61,24,13,213,91,122,42,30,23,12,1
33072,673,317,356,101,85,76,49,1162,548,614,191,166,142,38,1
33073,264,130,134,38,33,26,10,525,281,244,69,68,65,25,1
33074,365,180,185,63,35,48,19,306,128,178,49,59,17,9,1
33075,167,77,90,22,25,11,11,497,185,312,63,92,38,28,1
33076,801,395,406,106,91,61,25,770,374,396,95,91,79,41,1
33077,425,210,215,56,43,52,25,3418,1378,2040,515,464,318,121,1
33078,377,223,154,35,31,36,20,172,88,84,24,31,20,12,1
33079,938,484,454,137,100,104,41,825,399,426,128,128,77,32,1
33080,154,75,79,17,24,16,13,259,123,136,36,40,33,12,1
33081,476,190,286,116,95,33,11,132,78,54,12,8,15,9,1
33082,512,248,264,66,71,49,30,560,228,332,113,58,79,38,1
33083,680,312,368,98,56,38,27,482,231,251,76,81,64,26,1
33084,272,173,99,32,32,11,8,226,119,107,39,20,30,6,1
33085,299,164,135,37,29,28,11,894,420,474,136,146,93,39,1
33086,368,158,210,64,61,39,14,671,318,353,83,124,46,34,1
33087,606,316,290,82,68,82,20,1246,677,569,159,154,108,52,1
33088,466,186,280,71,84,30,11,103,44,59,16,17,9,5,1
33089,707,422,285,84,82,59,13,219,124,95,22,22,23,5,1
33090,217,109,108,34,32,35,7,594,305,289,86,63,51,21,1
33091,715,355,360,118,79,71,29,217,109,108,34,32,35,7,1
33092,351,183,168,50,46,37,16,315,150,165,49,59,23,15,1
33093,1066,485,581,136,182,99,31,430,218,212,58,47,34,20,1
33094,1843,908,935,238,225,119,49,377,202,175,46,50,41,23,1
33095,424,209,215,56,58,45,24,725,339,386,112,122,93,32,1
33096,552,283,269,89,66,68,30,2458,1305,1153,333,302,275,106,1
33097,432,190,242,85,82,28,11,496,286,210,60,53,61,16,1
33098,359,203,156,42,19,45,26,358,205,153,40,22,39,24,1
33099,622,331,291,69,74,45,21,558,302,256,66,62,65,30,1
33100,102,49,53,14,21,7,4,92,46,46,14,9,8,6,1
33101,376,199,177,63,46,33,8,191,99,92,25,24,18,8,1
33102,647,387,260,69,51,86,38,767,392,375,113,112,83,13,1
33103,889,419,470,124,112,69,31,968,498,470,129,133,115,37,1
33104,566,295,271,75,68,74,21,201,42,159,19,3,2,75,1
33105,2871,1148,1723,496,469,204,98,590,303,287,69,65,46,17,1
33106,1441,657,784,140,135,81,73,598,322,276,67,57,63,26,1
33107,235,119,116,31,26,15,13,885,424,461,143,114,92,32,1
33108,622,328,294,75,42,67,31,191,92,99,25,33,22,12,1
33109,712,331,381,111,86,86,34,734,366,368,121,99,63,39,1
33110,1052,492,560,184,163,103,44,103,56,47,27,7,8,2,1
33111,649,326,323,83,66,87,38,640,339,301,70,64,90,41,1
33112,1905,879,1026,242,272,193,128,907,475,432,124,92,65,14,1
33113,95,44,51,14,13,7,4,380,187,193,38,51,30,18,1
33114,201,111,90,25,29,26,13,414,185,229,53,54,49,11,1
33115,419,212,207,61,44,35,21,926,435,491,133,132,85,17,1
33116,635,333,302,99,75,83,28,1154,540,614,195,160,138,66,1
33117,101,41,60,18,19,10,5,1531,691,840,270,226,143,52,1
33118,247,110,137,34,45,23,10,245,111,134,31,44,20,11,1
33119,284,111,173,47,34,47,43,300,140,160,39,35,14,12,1
33120,509,241,268,67,53,56,13,341,154,187,34,36,11,11,1
33121,465,225,240,65,44,65,25,388,245,143,45,25,41,16,1
33122,273,126,147,54,49,25,18,323,168,155,47,35,26,9,1
33123,457,237,220,69,44,53,26,1114,581,533,145,132,126,54,1
33124,573,278,295,58,79,37,23,465,225,240,65,44,65,25,1
33125,245,122,123,21,32,18,13,598,300,298,68,77,59,21,1
33126,292,153,139,39,33,24,21,252,114,138,41,35,22,12,1
33127,502,240,262,78,61,54,32,214,109,105,31,26,25,17,1
33128,127,58,69,17,22,3,2,1050,482,568,136,154,101,41,1
33129,194,99,95,29,24,20,8,664,316,348,75,96,53,31,1
33130,446,246,200,64,48,54,12,476,254,222,58,33,46,23,1
33131,334,165,169,46,49,23,16,536,230,306,64,88,40,12,1
33132,727,362,365,123,107,63,23,356,199,157,43,58,29,12,1
33133,248,120,128,42,41,23,5,251,145,106,30,31,28,7,1
33134,605,283,322,94,72,64,39,710,342,368,99,82,76,46,1
33135,501,240,261,80,62,49,42,467,201,266,71,70,63,27,1
33136,369,166,203,59,55,41,14,377,202,175,46,50,41,23,1
33137,460,251,209,61,48,43,21,1502,683,819,241,216,172,52,1
33138,648,307,341,101,58,76,34,168,76,92,26,21,19,4,1
33139,1314,693,621,174,155,140,58,405,195,210,57,74,24,17,1
33140,224,108,116,33,26,32,10,2414,1189,1225,277,178,170,169,1
33141,603,311,292,102,71,66,23,451,222,229,58,55,51,17,1
33142,359,173,186,55,57,44,16,369,237,132,33,16,38,18,1
33143,1139,536,603,162,139,109,50,295,143,152,38,47,22,25,1
33144,235,119,116,31,26,15,13,394,183,211,65,60,35,18,1
33145,144,57,87,38,26,10,4,920,435,485,115,113,94,49,1
33146,139,62,77,23,6,14,4,920,492,428,100,92,88,49,1
33147,812,456,356,105,74,101,29,724,334,390,112,109,79,17,1
33148,546,267,279,90,69,56,19,280,121,159,60,45,22,12,1
33149,95,44,51,14,13,7,4,806,419,387,115,130,57,32,1
33150,595,316,279,86,60,65,40,1177,666,511,131,99,88,35,1
33151,192,106,86,25,19,26,9,660,326,334,106,61,71,32,1
33152,1893,850,1043,280,340,169,80,303,187,116,41,23,23,9,1
33153,1278,593,685,198,201,71,43,217,109,108,34,32,35,7,1
33154,625,298,327,90,78,57,33,854,380,474,137,159,81,31,1
33155,536,278,258,72,63,62,20,864,429,435,129,118,68,35,1
33156,702,298,404,134,111,48,18,375,202,173,46,49,41,23,1
33157,562,265,297,79,56,72,45,938,484,454,137,100,104,41,1
33158,671,318,353,83,124,46,34,247,133,114,41,25,41,8,1
33159,205,135,70,21,16,24,4,224,129,95,25,17,20,14,1
33160,296,127,169,55,40,29,17,246,108,138,32,44,21,10,1
33161,637,267,370,94,126,43,27,512,216,296,92,68,51,19,1
33162,781,418,363,92,90,64,41,666,204,462,110,194,42,14,1
33163,275,126,149,30,40,24,10,333,134,199,59,46,37,16,1
33164,433,222,211,68,58,42,23,431,218,213,57,49,55,18,1
33165,393,186,207,58,50,36,22,482,231,251,76,81,64,26,1
33166,1030,566,464,119,107,96,49,548,250,298,85,64,56,21,1
33167,211,126,85,21,20,28,7,218,127,91,27,23,23,10,1
33168,1102,511,591,171,179,148,52,470,226,244,81,53,59,39,1
33169,292,152,140,46,38,35,12,553,261,292,73,79,40,26,1
33170,269,140,129,27,26,30,19,870,418,452,121,102,109,28,1
33171,1069,512,557,148,126,84,36,191,72,119,40,41,17,8,1
33172,1473,758,715,205,171,161,65,233,121,112,24,31,30,7,1
33173,327,177,150,40,40,38,18,454,237,217,53,49,44,24,1
33174,221,80,141,48,37,14,10,364,172,192,55,57,32,15,1
33175,412,238,174,41,38,43,19,2491,1175,1316,303,302,273,147,1
33176,508,295,213,42,61,53,17,1290,629,661,191,187,167,55,1
33177,432,188,244,76,81,26,13,659,334,325,90,79,72,36,1
33178,351,184,167,59,45,54,9,505,244,261,77,65,56,22,1
33179,199,101,98,22,25,9,12,545,269,276,80,76,27,32,1
33180,1163,493,670,214,158,106,42,219,104,115,25,31,25,11,1
33181,536,278,258,72,63,62,20,1290,629,661,191,187,167,55,1
33182,234,129,105,31,22,19,18,140,86,54,17,6,20,7,1
33183,424,179,245,65,67,29,11,83,39,44,7,18,6,4,1
33184,154,72,82,25,24,5,5,197,87,110,33,32,15,11,1
33185,217,109,108,34,32,35,7,1102,552,550,174,137,137,45,1
33186,353,195,158,40,55,30,13,697,373,324,105,83,95,38,1
33187,798,385,413,120,115,79,30,636,336,300,94,65,58,32,1
33188,449,232,217,53,64,57,22,556,290,266,75,74,29,24,1
33189,572,298,274,72,67,52,20,933,493,440,140,108,124,32,1
33190,326,166,160,49,45,36,12,503,263,240,72,55,51,34,1
33191,1907,1008,899,235,224,195,73,930,367,563,181,153,83,48,1
33192,371,233,138,39,32,28,11,811,400,411,107,87,116,43,1
33193,482,231,251,76,81,64,26,1050,482,568,136,154,101,41,1
33194,351,184,167,59,45,54,9,536,278,258,72,63,62,20,1
33195,721,363,358,87,104,70,28,333,127,206,66,68,25,14,1
33196,311,175,136,40,30,25,13,377,184,193,50,43,33,17,1
33197,369,180,189,62,70,24,21,641,324,317,88,92,49,14,1
33198,606,340,266,67,62,76,22,130,55,75,21,26,10,3,1
33199,697,373,324,105,83,95,38,456,243,213,64,44,59,18,1
33200,1076,517,559,139,136,72,34,427,236,191,49,54,46,13,1
33201,644,343,301,96,69,59,28,2472,1057,1415,331,352,159,96,1
33202,185,115,70,19,17,26,6,184,86,98,26,26,14,11,1
33203,291,146,145,39,45,22,16,235,119,116,31,26,15,13,1
33204,1255,666,589,145,142,120,82,423,220,203,51,54,46,17,1
33205,435,222,213,67,49,67,12,719,364,355,104,100,58,34,1
33206,261,130,131,27,41,19,16,609,292,317,102,96,64,21,1
33207,1158,481,677,169,129,86,40,468,233,235,65,61,49,34,1
33208,132,57,75,25,9,6,13,332,198,134,29,17,46,28,1
33209,1562,742,820,219,231,104,46,193,99,94,31,31,16,12,1
33210,741,387,354,118,104,90,27,168,76,92,26,21,19,4,1
33211,89,42,47,16,12,15,6,317,153,164,34,52,30,14,1
33212,85,44,41,9,6,10,9,61,17,44,8,3,0,21,1
33213,211,138,73,14,11,22,17,660,359,301,81,87,102,31,1
33214,1154,540,614,195,160,138,66,489,235,254,53,69,49,20,1
33215,1174,579,595,174,135,132,42,631,309,322,106,83,89,33,1
33216,98,55,43,14,1,7,4,219,124,95,22,22,23,5,1
33217,406,210,196,68,60,25,20,473,230,243,80,56,52,35,1
33218,1149,568,581,177,133,101,30,246,108,138,32,44,21,10,1
33219,298,141,157,43,29,28,13,374,235,139,33,16,72,21,1
33220,360,192,168,55,45,48,16,860,427,433,132,100,81,30,1
33221,780,359,421,160,78,169,16,1074,539,535,136,87,87,66,1
33222,651,306,345,85,64,61,32,331,169,162,40,28,22,14,1
33223,125,67,58,11,11,6,19,530,259,271,83,50,54,41,1
33224,668,338,330,85,95,68,18,4655,2074,2581,545,652,562,399,1
33225,923,480,443,110,114,98,55,288,104,184,80,30,39,6,1
33226,655,327,328,91,76,53,28,503,263,240,72,55,51,34,1
33227,273,131,142,35,35,25,12,508,295,213,42,61,53,17,1
33228,206,89,117,43,31,14,6,160,53,107,31,29,13,3,1
33229,504,237,267,62,66,48,17,574,330,244,74,63,40,19,1
33230,860,456,404,104,95,77,27,781,374,407,123,99,65,26,1
33231,407,218,189,34,41,23,17,589,294,295,37,44,27,33,1
33232,323,169,154,47,44,39,20,245,112,133,32,45,20,10,1
33233,346,208,138,46,39,51,18,147,81,66,18,18,18,4,1
33234,638,300,338,83,53,81,49,711,340,371,106,77,87,55,1
33235,1455,765,690,189,162,166,66,297,158,139,47,37,37,9,1
33236,594,274,320,89,63,66,28,976,496,480,128,111,121,48,1
33237,368,183,185,40,42,40,15,360,188,172,49,48,47,17,1
33238,512,216,296,92,68,51,19,216,102,114,31,29,21,6,1
33239,340,169,171,40,39,36,22,356,185,171,37,31,17,21,1
33240,785,374,411,56,42,38,25,331,169,162,40,28,22,14,1
33241,864,362,502,142,150,70,19,742,303,439,88,96,86,23,1
33242,277,124,153,44,40,35,18,1302,637,665,162,150,125,61,1
33243,351,184,167,59,45,54,9,651,357,294,81,67,103,18,1
33244,2201,1053,1148,238,312,200,122,2477,1186,1291,256,271,249,90,1
33245,277,100,177,35,88,30,2,292,152,140,46,38,35,12,1
33246,638,295,343,90,103,69,20,743,233,510,148,142,28,17,1
33247,1150,585,565,162,148,102,36,1891,1066,825,207,184,181,83,1
33248,476,233,243,76,61,52,21,601,290,311,92,89,55,30,1
33249,370,196,174,63,52,21,18,2758,1332,1426,394,384,287,131,1
33250,930,477,453,111,92,92,29,2414,1189,1225,277,178,170,169,1
33251,595,316,279,86,60,65,40,546,267,279,90,69,56,19,1
33252,127,62,65,13,33,7,6,275,125,150,37,48,27,7,1
33253,390,203,187,58,40,43,19,1487,996,491,147,141,50,35,1
33254,603,311,292,102,71,66,23,172,88,84,24,31,20,12,1
33255,1039,597,442,101,110,106,33,788,360,428,93,106,67,72,1
33256,254,134,120,34,27,26,14,467,250,217,59,52,41,19,1
33257,170,82,88,28,23,20,12,418,245,173,49,22,59,20,1
33258,323,152,171,45,35,40,12,292,141,151,45,23,35,13,1
33259,848,394,454,100,90,101,41,854,380,474,137,159,81,31,1
33260,372,189,183,60,44,41,18,730,298,432,128,69,86,26,1
33261,482,231,251,76,81,64,26,1147,471,676,229,164,86,37,1
33262,755,348,407,109,98,49,23,386,189,197,54,57,39,16,1
33263,380,187,193,38,51,30,18,551,298,253,63,65,45,19,1
33264,2005,1074,931,235,243,249,109,1279,669,610,164,162,104,55,1
33265,948,484,464,134,131,75,27,758,362,396,115,102,35,13,1
33266,501,285,216,52,55,62,25,527,262,265,62,73,39,49,1
33267,389,195,194,68,60,30,17,229,115,114,27,30,16,9,1
33268,298,181,117,43,23,40,12,677,245,432,129,155,72,11,1
33269,204,104,100,26,27,21,11,257,139,118,64,17,24,7,1
33270,546,267,279,90,69,56,19,306,155,151,43,34,36,17,1
33271,113,66,47,11,9,6,5,257,118,139,37,26,27,15,1
33272,439,227,212,60,55,58,8,191,99,92,25,24,18,8,1
33273,561,343,218,53,63,37,15,173,104,69,18,20,18,9,1
33274,350,180,170,64,46,55,12,464,237,227,64,66,33,12,1
33275,251,132,119,29,25,32,13,426,234,192,46,41,39,37,1
33276,561,210,351,108,77,41,22,309,154,155,42,44,45,16,1
33277,4684,2161,2523,779,782,304,101,1210,592,618,157,138,116,85,1
33278,386,189,197,54,57,39,16,516,296,220,79,59,69,16,1
33279,519,283,236,70,61,61,30,858,417,441,124,101,85,41,1
33280,1275,579,696,200,172,125,51,1086,603,483,147,121,95,40,1
33281,415,209,206,60,67,39,18,879,466,413,103,85,111,54,1
33282,538,292,246,69,57,52,39,217,109,108,34,32,35,7,1
33283,440,246,194,62,49,41,16,1051,432,619,179,147,126,54,1
33284,323,159,164,49,28,38,22,432,218,214,57,55,42,11,1
33285,268,104,164,58,37,30,14,245,112,133,32,45,20,10,1
33286,158,85,73,24,18,18,8,403,185,218,67,62,63,19,1
33287,2472,1055,1417,416,458,235,64,470,205,265,71,80,33,11,1
33288,1989,775,1214,307,250,189,59,467,224,243,70,43,67,23,1
33289,559,296,263,77,69,42,13,508,267,241,57,49,40,13,1
33290,527,260,267,76,69,46,16,1192,649,543,153,145,116,57,1
33291,292,108,184,47,64,19,15,189,90,99,26,29,17,11,1
33292,1124,578,546,149,127,122,61,1997,972,1025,262,209,239,52,1
33293,184,88,96,39,27,22,5,681,249,432,125,168,46,13,1
33294,465,225,240,65,44,65,25,1188,632,556,123,99,114,37,1
33295,546,267,279,90,69,56,19,87,50,37,16,7,10,5,1
33296,593,266,327,102,84,69,24,770,374,396,95,91,79,41,1
33297,211,114,97,32,24,19,10,676,333,343,111,89,94,39,1
33298,901,439,462,133,123,102,45,1675,875,800,213,219,196,72,1
33299,95,44,51,14,13,7,4,364,195,169,50,38,33,12,1
33300,354,168,186,50,53,39,20,462,291,171,57,25,53,17,1
33301,102,49,53,14,21,7,4,940,417,523,190,146,85,26,1
33302,592,291,301,92,93,71,31,479,228,251,79,78,64,24,1
33303,751,312,439,131,115,78,48,482,231,251,76,81,64,26,1
33304,326,151,175,50,39,36,17,304,159,145,38,40,32,3,1
33305,460,274,186,50,34,69,27,354,169,185,54,54,41,19,1
33306,802,344,458,156,136,57,24,861,393,468,150,101,69,35,1
33307,1290,597,693,182,182,119,63,777,345,432,128,88,65,39,1
33308,249,114,135,47,33,25,4,789,362,427,90,82,70,35,1
33309,2414,1189,1225,277,178,170,169,631,315,316,64,57,49,15,1
33310,223,93,130,38,27,39,10,157,78,79,18,29,16,10,1
33311,271,150,121,39,36,37,5,1162,515,647,191,143,97,35,1
33312,750,347,403,105,103,83,29,185,94,91,23,19,17,9,1
33313,462,228,234,59,47,37,32,461,223,238,66,57,36,23,1
33314,513,246,267,71,66,60,35,482,231,251,76,81,64,26,1
33315,964,408,556,131,153,76,55,322,160,162,44,52,33,16,1
33316,981,465,516,126,164,112,38,744,331,413,118,114,58,28,1
33317,198,80,118,35,31,14,7,521,267,254,53,68,39,15,1
33318,1089,544,545,138,160,117,43,787,386,401,98,95,86,25,1
33319,205,106,99,28,26,23,3,289,147,142,45,45,38,13,1
33320,755,349,406,131,80,68,28,657,293,364,109,75,66,28,1
33321,284,128,156,48,29,34,8,543,277,266,62,54,70,19,1
33322,962,430,532,109,142,61,34,1290,629,661,191,187,167,55,1
33323,625,316,309,77,79,54,34,569,288,281,86,69,74,24,1
33324,667,312,355,100,134,47,20,700,335,365,83,84,95,33,1
33325,258,146,112,41,23,30,7,328,120,208,76,50,23,9,1
33326,211,113,98,38,17,25,8,839,408,431,138,122,105,46,1
33327,84,36,48,19,6,9,8,261,136,125,29,41,28,9,1
33328,1164,622,542,150,143,78,35,375,202,173,46,49,41,23,1
33329,132,69,63,16,14,6,15,332,198,134,29,17,46,28,1
33330,350,214,136,33,23,49,27,99,49,50,16,8,7,8,1
33331,418,255,163,42,31,42,22,354,169,185,54,54,41,19,1
33332,454,214,240,56,71,35,16,271,110,161,33,27,11,8,1
33333,635,333,302,99,75,83,28,316,156,160,34,28,32,14,1
33334,207,107,100,27,25,20,11,724,334,390,112,109,79,17,1
33335,380,184,196,58,52,46,8,508,267,241,57,49,40,13,1
33336,101,38,63,23,8,9,10,817,425,392,120,102,83,26,1
33337,400,191,209,51,60,30,9,2024,765,1259,283,343,137,76,1
33338,1143,576,567,170,139,113,31,598,300,298,68,77,59,21,1
33339,771,321,450,151,135,43,15,280,121,159,60,45,22,12,1
33340,1164,531,633,179,157,107,46,586,254,332,114,111,55,17,1
33341,471,255,216,66,68,81,16,1487,996,491,147,141,50,35,1
33342,683,341,342,107,77,93,43,593,266,327,102,84,69,24,1
33343,645,297,348,89,105,74,24,89,44,45,15,12,15,6,1
33344,176,106,70,30,15,18,5,440,250,190,51,35,64,27,1
33345,922,418,504,120,120,106,31,1047,562,485,141,127,114,41,1
33346,294,157,137,43,30,29,16,349,186,163,43,45,51,12,1
33347,425,210,215,56,43,52,25,1068,527,541,160,131,112,52,1
33348,162,73,89,32,19,4,4,2045,985,1060,359,339,199,74,1
33349,1004,464,540,143,104,78,55,1273,592,681,199,164,139,39,1
33350,1290,597,693,182,182,119,63,412,203,209,65,47,37,18,1
33351,349,167,182,54,38,30,28,158,74,84,26,23,18,18,1
33352,443,208,235,43,55,51,50,670,358,312,95,75,58,26,1
33353,1016,501,515,109,71,76,37,2471,1130,1341,240,281,219,290,1
33354,284,173,111,28,19,49,12,193,99,94,31,31,16,12,1
33355,134,63,71,27,9,6,8,3396,1499,1897,325,572,309,90,1
33356,1333,646,687,209,179,148,45,619,332,287,95,77,74,38,1
33357,919,538,381,111,98,103,41,1290,629,661,191,187,167,55,1
33358,546,267,279,90,69,56,19,214,119,95,25,27,18,7,1
33359,372,189,183,60,44,41,18,1315,720,595,138,136,115,62,1
33360,162,76,86,18,20,17,11,369,181,188,41,36,54,16,1
33361,158,71,87,23,21,17,12,976,520,456,120,115,109,53,1
33362,479,238,241,71,45,36,17,1117,423,694,182,134,88,31,1
33363,297,145,152,49,30,23,21,2477,1186,1291,256,271,249,90,1
33364,452,234,218,65,46,63,22,1024,549,475,139,125,82,23,1
33365,421,246,175,51,27,44,19,406,211,195,55,37,47,16,1
33366,189,104,85,20,16,20,8,662,340,322,67,72,71,35,1
33367,529,274,255,57,62,38,14,399,201,198,65,45,48,17,1
33368,466,186,280,71,84,30,11,242,125,117,38,31,28,22,1
33369,1214,642,572,175,153,138,47,1480,789,691,195,151,173,55,1
33370,298,160,138,37,30,22,12,474,250,224,58,47,37,12,1
33371,233,121,112,24,31,30,7,241,115,126,35,30,17,14,1
33372,101,41,60,18,19,10,5,885,339,546,159,135,81,49,1
33373,1273,592,681,199,164,139,39,393,186,207,58,50,36,22,1
33374,346,191,155,52,38,40,13,782,372,410,127,111,89,36,1
33375,3418,1378,2040,515,464,318,121,393,186,207,58,50,36,22,1
33376,427,191,236,67,60,41,34,345,141,204,64,58,13,11,1
33377,348,172,176,46,34,46,16,366,183,183,48,47,36,17,1
33378,298,154,144,44,34,25,11,292,153,139,39,33,24,21,1
33379,724,334,390,112,109,79,17,557,268,289,66,67,70,17,1
33380,1863,721,1142,262,283,139,74,1147,471,676,229,164,86,37,1
33381,536,278,258,72,63,62,20,1134,574,560,157,164,47,48,1
33382,1194,543,651,190,197,65,43,1948,1039,909,242,227,200,67,1
33383,780,409,371,125,80,60,34,201,42,159,19,3,2,75,1
33384,545,230,315,91,101,50,16,641,341,300,101,91,29,22,1
33385,466,242,224,66,53,53,13,101,41,60,18,19,10,5,1
33386,527,257,270,72,68,50,28,108,51,57,16,12,16,11,1
33387,155,74,81,23,19,20,5,391,208,183,65,49,57,17,1
33388,101,38,63,23,8,9,10,601,313,288,42,48,25,36,1
33389,469,221,248,49,60,55,21,2440,1061,1379,377,326,172,62,1
33390,289,125,164,51,55,17,10,100,50,50,15,13,10,4,1
33391,640,279,361,102,83,69,21,710,307,403,117,176,37,9,1
33392,1154,540,614,195,160,138,66,356,208,148,42,26,57,15,1
33393,730,313,417,119,92,65,23,221,110,111,28,32,25,11,1
33394,335,128,207,59,43,24,23,1248,584,664,184,164,155,67,1
33395,1363,690,673,185,172,152,62,594,305,289,86,63,51,21,1
33396,2414,1189,1225,277,178,170,169,2089,917,1172,285,306,83,39,1
33397,525,274,251,82,74,60,25,211,114,97,32,24,19,10,1
33398,349,166,183,49,37,25,52,4544,2024,2520,579,628,480,403,1
33399,577,342,235,63,57,23,37,601,313,288,42,48,25,36,1
33400,894,420,474,136,146,93,39,576,250,326,93,71,34,15,1
33401,744,384,360,104,96,57,31,297,123,174,51,49,16,10,1
33402,1948,1039,909,242,227,200,67,1452,733,719,182,161,179,64,1
33403,504,237,267,62,66,48,17,175,88,87,29,29,23,6,1
33404,1084,537,547,154,121,92,35,429,223,206,50,32,46,17,1
33405,1807,933,874,248,203,173,71,295,143,152,38,47,22,25,1
33406,380,200,180,35,42,31,10,1132,646,486,99,102,71,41,1
33407,822,416,406,111,105,84,44,206,129,77,27,15,21,6,1
33408,351,184,167,59,45,54,9,323,162,161,44,28,43,14,1
33409,1905,901,1004,269,248,149,78,482,231,251,76,81,64,26,1
33410,247,110,137,34,45,23,10,504,255,249,56,59,45,13,1
33411,346,167,179,56,52,28,13,1210,592,618,157,138,116,85,1
33412,281,125,156,44,47,17,7,326,141,185,57,39,33,20,1
33413,1009,506,503,146,141,97,55,512,261,251,79,73,60,21,1
33414,1085,646,439,108,65,36,19,376,176,200,31,53,27,8,1
33415,783,429,354,100,77,54,25,215,105,110,27,22,20,9,1
33416,910,462,448,143,126,90,25,313,166,147,47,44,41,10,1
33417,152,82,70,15,19,17,9,569,288,281,86,69,74,24,1
33418,1311,690,621,158,161,128,51,295,139,156,48,31,30,17,1
33419,907,455,452,132,117,80,40,790,385,405,121,108,106,39,1
33420,427,205,222,53,52,51,22,146,85,61,15,9,12,10,1
33421,178,100,78,23,22,30,6,796,445,351,96,80,90,38,1
33422,140,76,64,15,10,13,15,528,268,260,81,77,36,22,1
33423,573,316,257,78,80,21,21,517,295,222,60,55,55,19,1
33424,131,66,65,21,14,23,7,511,286,225,69,52,50,19,1
33425,442,230,212,50,58,56,23,474,224,250,50,72,51,43,1
33426,594,274,320,89,63,66,28,947,482,465,143,107,89,37,1
33427,298,154,144,44,34,25,11,252,128,124,46,31,18,8,1
33428,1464,693,771,153,136,91,86,500,270,230,77,56,53,28,1
33429,365,222,143,44,24,35,11,469,226,243,79,30,58,23,1
33430,529,290,239,54,63,85,15,193,110,83,18,20,15,12,1
33431,424,191,233,76,73,49,13,505,268,237,68,59,34,15,1
33432,729,321,408,128,84,63,26,719,359,360,89,86,74,30,1
33433,219,112,107,24,31,25,9,653,298,355,70,101,64,39,1
33434,351,183,168,55,44,33,9,1290,597,693,182,182,119,63,1
33435,195,109,86,21,17,25,9,79,38,41,8,7,5,7,1
33436,491,234,257,55,56,36,21,296,149,147,54,34,39,16,1
33437,435,221,214,72,45,47,19,794,402,392,96,84,86,30,1
33438,351,184,167,59,45,54,9,2225,1244,981,271,243,217,93,1
33439,525,245,280,59,72,47,21,601,313,288,42,48,25,36,1
33440,101,45,56,17,17,12,9,437,190,247,82,66,39,20,1
33441,380,212,168,47,38,19,11,502,299,203,57,52,32,11,1
33442,740,313,427,101,135,40,22,636,320,316,79,61,67,31,1
33443,432,188,244,76,81,26,13,329,155,174,46,38,29,14,1
33444,601,313,288,42,48,25,36,167,94,73,22,11,23,4,1
33445,3830,2000,1830,532,388,418,203,437,228,209,47,61,26,11,1
33446,192,101,91,25,22,18,9,563,285,278,79,66,48,27,1
33447,720,357,363,113,85,62,39,115,67,48,10,7,12,7,1
33448,453,255,198,62,49,29,19,140,81,59,16,15,15,12,1
33449,1304,696,608,195,169,122,53,351,183,168,55,44,33,9,1
33450,365,186,179,48,47,42,13,309,161,148,38,34,40,15,1
33451,1272,651,621,178,194,79,59,436,201,235,54,37,34,20,1
33452,1214,642,572,175,153,138,47,1079,582,497,151,133,133,47,1
33453,256,148,108,31,16,29,12,379,192,187,50,48,47,14,1
33454,233,149,84,18,17,38,20,450,229,221,49,63,54,27,1
33455,141,83,58,15,10,10,17,1037,575,462,122,150,82,32,1
33456,631,315,316,64,57,49,15,358,212,146,51,36,33,9,1
33457,796,445,351,96,80,90,38,1290,629,661,191,187,167,55,1
33458,719,364,355,104,100,58,34,309,137,172,51,50,28,14,1
33459,1706,830,876,265,209,230,63,1272,520,752,235,242,117,54,1
33460,1194,609,585,195,142,105,37,1328,648,680,220,151,112,40,1
33461,684,288,396,107,90,54,42,1210,601,609,126,80,120,39,1
33462,175,91,84,19,21,21,10,217,109,108,34,32,35,7,1
33463,524,264,260,75,75,40,21,1292,592,700,186,169,108,22,1
33464,393,186,207,58,50,36,22,338,193,145,34,27,53,17,1
33465,997,441,556,152,165,92,41,208,99,109,28,30,18,9,1
33466,437,225,212,61,57,66,12,247,110,137,34,45,23,10,1
33467,305,162,143,45,34,38,18,304,127,177,61,38,31,4,1
33468,624,308,316,92,72,68,22,676,295,381,94,71,65,24,1
33469,1271,599,672,194,175,118,47,536,278,258,72,63,62,20,1
33470,296,151,145,39,25,40,20,367,161,206,70,48,41,19,1
33471,254,111,143,33,62,12,6,1069,494,575,133,111,110,39,1
33472,205,106,99,28,26,23,3,817,427,390,100,97,87,32,1
33473,503,263,240,72,55,51,34,485,246,239,74,48,47,22,1
33474,956,403,553,147,135,99,87,2912,1266,1646,268,360,243,422,1
33475,1294,547,747,203,153,136,54,190,74,116,34,29,11,11,1
33476,247,110,137,34,45,23,10,164,61,103,47,19,14,5,1
33477,309,154,155,42,44,45,16,558,311,247,59,60,50,23,1
33478,147,78,69,20,15,20,7,518,235,283,94,77,55,22,1
33479,689,343,346,119,100,86,38,391,223,168,35,26,47,31,1
33480,720,357,363,113,85,62,39,320,113,207,58,55,37,35,1
33481,714,364,350,98,102,91,27,2472,1055,1417,416,458,235,64,1
33482,524,264,260,75,75,40,21,508,267,241,57,49,40,13,1
33483,537,276,261,75,68,68,22,428,223,205,59,67,23,16,1
33484,256,125,131,34,27,24,14,712,380,332,69,74,57,30,1
33485,276,143,133,34,38,20,15,1164,622,542,150,143,78,35,1
33486,1696,771,925,257,225,149,63,391,204,187,47,48,38,18,1
33487,208,96,112,31,32,13,9,712,396,316,78,69,65,25,1
33488,1477,738,739,176,176,145,72,422,211,211,73,61,43,17,1
33489,333,171,162,41,44,48,23,146,83,63,19,12,13,8,1
33490,2696,1169,1527,432,347,193,146,490,224,266,80,70,39,32,1
33491,215,80,135,54,56,21,9,1616,735,881,285,248,153,72,1
33492,341,178,163,48,44,42,20,840,385,455,118,137,66,39,1
33493,359,171,188,49,74,45,11,537,276,261,75,68,68,22,1
33494,288,112,176,55,55,18,15,118,67,51,13,13,7,7,1
33495,756,348,408,101,103,60,40,1242,613,629,174,113,114,53,1
33496,981,465,516,126,164,112,38,1435,649,786,214,181,135,54,1
33497,837,444,393,128,89,87,37,454,191,263,61,66,38,15,1
33498,870,489,381,97,99,76,14,780,337,443,112,116,77,28,1
33499,729,391,338,80,64,71,34,223,113,110,31,33,22,12,1
33500,1257,525,732,216,210,79,52,1005,439,566,159,165,70,43,1
33501,2440,1061,1379,377,326,172,62,111,29,82,10,54,0,1,1
33502,425,224,201,58,56,40,16,796,445,351,96,80,90,38,1
33503,509,262,247,64,70,64,20,551,299,252,51,62,63,17,1
33504,511,290,221,67,59,77,22,545,284,261,72,67,72,25,1
33505,1115,599,516,125,105,95,51,781,418,363,92,90,64,41,1
33506,394,202,192,44,43,38,28,92,40,52,14,23,13,7,1
33507,372,179,193,50,52,33,6,592,291,301,92,93,71,31,1
33508,986,465,521,152,132,138,51,1838,1168,670,185,225,103,35,1
33509,942,423,519,130,126,104,50,213,107,106,28,41,19,5,1
33510,452,256,196,32,44,27,11,205,100,105,25,25,20,9,1
33511,380,212,168,47,38,19,11,377,202,175,46,50,41,23,1
33512,255,122,133,35,51,22,13,111,51,60,20,21,10,11,1
33513,243,120,123,30,24,26,13,353,166,187,82,42,41,16,1
33514,5183,2553,2630,621,604,471,244,930,367,563,181,153,83,48,1
33515,559,217,342,105,86,42,16,2285,1219,1066,207,180,178,106,1
33516,1132,553,579,172,143,150,57,317,153,164,34,52,30,14,1
33517,442,230,212,50,58,56,23,1712,1175,537,179,142,113,46,1
33518,202,113,89,16,27,21,11,787,351,436,135,98,82,23,1
33519,247,110,137,34,45,23,10,553,309,244,75,60,39,14,1
33520,345,155,190,49,56,23,6,410,186,224,72,57,52,22,1
33521,4391,2256,2135,494,411,423,231,1270,557,713,130,195,57,30,1
33522,427,164,263,62,80,14,10,926,435,491,133,132,85,17,1
33523,437,225,212,61,57,66,12,161,99,62,15,22,9,7,1
33524,1338,633,705,199,151,144,65,377,184,193,56,53,44,14,1
33525,501,265,236,89,52,45,16,513,274,239,67,66,62,35,1
33526,686,375,311,89,80,63,20,1980,963,1017,262,243,179,78,1
33527,411,171,240,61,81,30,15,595,316,279,86,60,65,40,1
33528,219,124,95,22,22,23,5,346,165,181,69,43,22,9,1
33529,218,118,100,33,30,25,11,205,104,101,28,28,35,13,1
33530,349,178,171,28,23,33,10,344,184,160,24,24,32,9,1
33531,719,364,355,104,100,58,34,344,151,193,59,51,30,9,1
33532,660,362,298,81,47,48,12,153,73,80,19,15,14,10,1
33533,427,218,209,61,53,45,26,393,186,207,58,50,36,22,1
33534,191,85,106,24,34,19,5,448,275,173,32,53,55,27,1
33535,211,88,123,38,28,26,10,89,42,47,16,12,15,6,1
33536,718,283,435,126,127,34,29,588,255,333,94,82,58,27,1
33537,140,67,73,13,16,18,8,531,250,281,72,61,68,31,1
33538,335,185,150,46,34,36,13,473,254,219,66,67,41,16,1
33539,763,354,409,101,90,63,26,1505,681,824,201,204,73,32,1
33540,280,127,153,53,36,12,6,165,77,88,28,27,19,10,1
33541,480,234,246,79,77,65,23,118,56,62,13,14,6,6,1
33542,1970,978,992,245,206,198,80,142,60,82,20,28,13,5,1
33543,432,218,214,57,55,42,11,270,166,104,30,26,28,14,1
33544,385,200,185,65,41,41,12,434,240,194,61,53,37,15,1
33545,505,296,209,55,50,45,23,191,101,90,21,23,28,5,1
33546,218,127,91,27,23,23,10,239,146,93,30,22,35,9,1
33547,323,123,200,59,69,30,15,482,231,251,76,81,64,26,1
33548,436,201,235,54,37,34,20,89,42,47,16,12,15,6,1
33549,165,80,85,21,9,18,19,467,224,243,70,43,67,23,1
33550,501,240,261,80,62,49,42,627,289,338,101,73,62,43,1
33551,426,228,198,62,42,47,22,592,264,328,86,85,62,41,1
33552,419,189,230,64,49,36,15,782,372,410,127,111,89,36,1
33553,991,537,454,134,99,80,34,441,218,223,69,55,50,27,1
33554,368,170,198,59,64,29,13,454,200,254,86,74,43,13,1
33555,297,123,174,51,49,16,10,375,202,173,46,49,41,23,1
33556,1102,511,591,171,179,148,52,617,386,231,60,48,76,38,1
33557,1354,537,817,245,247,117,57,647,324,323,101,80,76,43,1
33558,885,424,461,143,114,92,32,272,173,99,32,32,11,8,1
33559,497,257,240,71,63,62,16,309,154,155,42,44,45,16,1
33560,428,226,202,52,60,75,20,283,141,142,32,26,23,26,1
33561,509,341,168,35,32,52,15,390,205,185,60,39,36,16,1
33562,668,343,325,61,79,65,35,298,160,138,37,30,22,12,1
33563,407,207,200,53,36,38,8,134,60,74,19,13,10,7,1
33564,1591,704,887,253,227,156,50,454,191,263,61,66,38,15,1
33565,609,292,317,102,96,64,21,1192,649,543,153,145,116,57,1
33566,483,236,247,82,60,43,18,541,269,272,75,57,59,36,1
33567,540,271,269,80,77,51,16,276,143,133,34,38,20,15,1
33568,360,192,168,55,45,48,16,676,295,381,94,71,65,24,1
33569,249,111,138,40,30,22,17,1013,457,556,124,157,81,26,1
33570,536,278,258,72,63,62,20,827,422,405,111,104,94,28,1
33571,566,287,279,77,66,34,14,354,169,185,54,54,41,19,1
33572,391,208,183,65,49,57,17,650,304,346,80,106,62,28,1
33573,419,175,244,71,73,23,23,706,346,360,118,92,98,56,1
33574,386,189,197,54,57,39,16,387,202,185,64,43,37,16,1
33575,521,279,242,47,50,58,30,1154,540,614,195,160,138,66,1
33576,416,201,215,54,52,39,25,574,295,279,78,65,61,22,1
33577,825,363,462,97,105,72,75,399,222,177,48,44,52,23,1
33578,171,94,77,24,28,30,11,102,61,41,15,13,8,2,1
33579,686,375,311,89,80,63,20,653,389,264,69,59,51,19,1
33580,582,293,289,94,80,77,32,598,278,320,95,66,48,24,1
33581,206,86,120,40,13,23,14,513,260,253,71,50,58,23,1
33582,235,94,141,45,37,31,7,354,169,185,54,54,41,19,1
33583,374,217,157,52,23,67,13,522,235,287,78,67,60,50,1
33584,625,313,312,103,90,74,29,492,238,254,72,56,49,20,1
33585,1321,679,642,154,167,133,58,215,80,135,54,56,21,9,1
33586,374,235,139,33,16,72,21,622,299,323,86,86,69,35,1
33587,1192,579,613,120,215,79,24,304,127,177,61,38,31,4,1
33588,964,408,556,131,153,76,55,309,106,203,66,49,25,10,1
33589,963,455,508,126,110,68,29,2491,1175,1316,303,302,273,147,1
33590,520,236,284,115,52,45,16,221,75,146,68,21,16,5,1
33591,902,495,407,116,97,111,37,415,209,206,60,67,39,18,1
33592,548,250,298,85,64,56,21,1186,493,693,184,208,88,32,1
33593,950,497,453,146,127,115,43,276,143,133,34,38,20,15,1
33594,999,541,458,110,110,104,42,1086,603,483,147,121,95,40,1
33595,673,317,356,101,85,76,49,785,374,411,56,42,38,25,1
33596,261,144,117,34,22,31,15,508,295,213,42,61,53,17,1
33597,217,115,102,40,24,26,6,351,184,167,59,45,54,9,1
33598,172,71,101,31,39,11,10,940,417,523,190,146,85,26,1
33599,802,429,373,68,101,88,23,789,362,427,90,82,70,35,1
33600,207,99,108,34,27,22,9,265,103,162,61,58,25,3,1
33601,3056,1457,1599,438,389,329,168,497,185,312,63,92,38,28,1
33602,1149,568,581,177,133,101,30,292,152,140,46,38,35,12,1
33603,780,337,443,112,116,77,28,312,123,189,59,43,30,18,1
33604,332,172,160,50,33,35,9,592,292,300,56,52,71,17,1
33605,1970,978,992,245,206,198,80,67,40,27,10,8,7,6,1
33606,211,114,97,32,24,19,10,750,347,403,105,103,83,29,1
33607,835,420,415,104,105,57,47,573,213,360,119,65,91,35,1
33608,1142,515,627,56,128,113,16,128,67,61,29,9,9,1,1
33609,277,124,153,44,40,35,18,537,276,261,75,68,68,22,1
33610,305,174,131,38,35,31,10,980,580,400,109,103,59,32,1
33611,255,134,121,36,40,29,13,287,124,163,52,48,24,16,1
33612,491,283,208,55,61,40,13,729,430,299,78,57,101,33,1
33613,2442,1193,1249,278,183,170,145,529,274,255,57,62,38,14,1
33614,381,189,192,74,49,44,13,814,450,364,91,114,69,12,1
33615,216,119,97,33,27,28,7,465,225,240,65,44,65,25,1
33616,1388,535,853,241,239,96,52,3256,1307,1949,625,448,159,88,1
33617,498,174,324,112,108,33,19,564,284,280,71,64,41,13,1
33618,551,237,314,95,79,54,17,486,236,250,73,67,59,16,1
33619,870,436,434,131,114,72,25,216,121,95,38,27,25,6,1
33620,824,403,421,80,150,65,35,427,218,209,61,53,45,26,1
33621,686,345,341,98,106,75,25,380,212,168,47,38,19,11,1
33622,467,226,241,55,48,54,23,504,259,245,73,56,45,29,1
33623,739,359,380,83,95,53,38,586,254,332,114,111,55,17,1
33624,556,269,287,86,66,62,22,5038,2652,2386,655,729,544,245,1
33625,574,273,301,101,74,68,26,725,339,386,112,122,93,32,1
33626,400,187,213,56,59,42,20,2202,1121,1081,338,274,269,81,1
33627,2414,1189,1225,277,178,170,169,859,395,464,157,119,59,31,1
33628,1435,649,786,214,181,135,54,803,358,445,135,117,80,44,1
33629,1298,591,707,196,168,124,58,1435,649,786,214,181,135,54,1
33630,329,190,139,24,23,50,13,493,208,285,75,77,70,40,1
33631,525,274,251,82,74,60,25,758,362,396,115,102,35,13,1
33632,356,185,171,37,31,17,21,457,237,220,69,44,53,26,1
33633,771,321,450,151,135,43,15,597,246,351,95,98,45,25,1
33634,360,192,168,55,45,48,16,401,204,197,49,33,29,17,1
33635,154,75,79,17,24,16,13,1247,548,699,168,150,140,43,1
33636,520,279,241,62,72,35,25,1425,670,755,153,189,122,85,1
33637,105,51,54,13,17,12,8,969,505,464,123,133,92,33,1
33638,177,99,78,22,23,20,10,346,180,166,52,55,36,13,1
33639,150,74,76,21,22,18,7,553,285,268,82,78,60,30,1
33640,509,341,168,35,32,52,15,152,87,65,20,19,14,5,1
33641,198,98,100,30,21,21,8,1367,690,677,172,175,154,83,1
33642,154,75,79,17,24,16,13,147,78,69,19,15,19,7,1
33643,428,226,202,52,60,75,20,412,193,219,70,56,51,26,1
33644,560,244,316,92,118,47,12,3056,1457,1599,438,389,329,168,1
33645,161,75,86,24,20,10,7,592,295,297,79,70,76,11,1
33646,113,66,47,11,8,12,7,408,179,229,86,72,32,5,1
33647,747,316,431,143,127,53,21,218,108,110,28,28,22,10,1
33648,594,274,320,89,63,66,28,648,307,341,101,58,76,34,1
33649,201,111,90,25,29,26,13,990,410,580,140,175,44,36,1
33650,466,242,224,66,53,53,13,360,201,159,38,38,34,13,1
33651,330,157,173,56,42,51,8,583,322,261,73,66,45,26,1
33652,933,493,440,140,108,124,32,364,195,169,50,38,33,12,1
33653,577,288,289,85,56,40,20,191,99,92,25,24,18,8,1
33654,1292,592,700,186,169,108,22,1074,538,536,154,140,111,51,1
33655,246,115,131,15,29,10,32,91,41,50,23,4,8,6,1
33656,672,334,338,110,93,91,41,90,41,49,26,14,0,1,1
33657,537,276,261,75,68,68,22,551,299,252,51,62,63,17,1
33658,451,222,229,72,46,57,17,757,373,384,115,93,95,25,1
33659,267,159,108,31,13,22,15,207,125,82,16,15,19,11,1
33660,714,364,350,98,102,91,27,8797,3688,5109,1359,1437,715,322,1
33661,360,192,168,55,45,48,16,556,300,256,58,73,55,22,1
33662,170,82,88,28,23,20,12,410,250,160,50,24,53,17,1
33663,853,400,453,137,109,88,42,912,460,452,139,132,89,53,1
33664,296,147,149,44,27,33,18,425,210,215,56,43,52,25,1
33665,659,325,334,102,85,87,32,256,125,131,34,27,24,14,1
33666,458,222,236,69,39,35,18,724,334,390,112,109,79,17,1
33667,376,195,181,41,39,52,13,390,203,187,58,40,43,19,1
33668,683,341,342,107,77,93,43,536,278,258,72,63,62,20,1
33669,451,239,212,53,64,56,22,581,323,258,74,58,48,20,1
33670,331,158,173,31,35,47,26,1663,835,828,224,213,163,63,1
33671,589,294,295,37,44,27,33,324,149,175,49,49,34,6,1
33672,127,49,78,27,20,6,5,529,264,265,59,68,41,17,1
33673,554,215,339,102,65,85,42,597,246,351,95,98,45,25,1
33674,425,204,221,71,56,45,13,422,211,211,73,61,43,17,1
33675,247,110,137,34,45,23,10,731,383,348,102,84,68,30,1
33676,169,64,105,23,37,11,3,270,162,108,26,26,16,11,1
33677,151,75,76,30,16,8,7,264,122,142,33,29,13,13,1
33678,493,208,285,75,77,70,40,747,366,381,99,90,80,31,1
33679,1233,498,735,252,232,88,41,1462,711,751,219,222,148,65,1
33680,275,155,120,37,31,16,14,711,435,276,72,62,51,20,1
33681,583,322,261,73,66,45,26,780,337,443,112,116,77,28,1
33682,419,189,230,64,49,36,15,158,85,73,24,18,18,8,1
33683,873,366,507,127,125,75,21,412,203,209,65,47,37,18,1
33684,956,475,481,122,128,100,50,419,175,244,71,73,23,23,1
33685,3418,1378,2040,515,464,318,121,298,167,131,47,33,40,8,1
33686,391,208,183,65,49,57,17,2624,999,1625,416,495,109,81,1
33687,651,340,311,81,84,80,29,869,488,381,110,77,78,30,1
33688,425,210,215,56,43,52,25,1356,576,780,229,198,107,38,1
33689,457,261,196,55,27,57,34,270,130,140,43,24,36,10,1
33690,593,295,298,70,85,48,13,989,439,550,142,121,75,29,1
33691,776,381,395,72,71,65,22,1270,557,713,130,195,57,30,1
33692,208,96,112,31,32,13,9,480,232,248,83,64,51,25,1
33693,116,58,58,13,14,7,8,391,243,148,32,24,40,29,1
33694,248,119,129,33,48,20,10,450,232,218,60,52,33,27,1
33695,642,271,371,106,111,57,23,464,197,267,87,73,43,20,1
33696,2045,985,1060,359,339,199,74,98,55,43,14,1,7,4,1
33697,328,173,155,43,36,24,17,811,400,411,107,87,116,43,1
33698,940,417,523,190,146,85,26,548,250,298,85,64,56,21,1
33699,982,494,488,150,117,91,45,845,402,443,137,126,105,47,1
33700,781,418,363,92,90,64,41,326,166,160,49,45,36,12,1
33701,341,178,163,48,44,42,20,202,71,131,33,39,13,8,1
33702,490,224,266,80,70,39,32,507,242,265,53,44,31,22,1
33703,433,237,196,60,52,33,27,164,78,86,28,23,12,8,1
33704,600,254,346,95,90,52,42,3114,1105,2009,505,603,150,122,1
33705,101,41,60,18,19,10,5,452,202,250,83,60,56,19,1
33706,452,202,250,83,60,56,19,757,373,384,115,93,95,25,1
33707,290,147,143,31,32,26,14,624,308,316,92,72,68,22,1
33708,984,459,525,150,145,89,37,193,99,94,31,31,16,12,1
33709,191,72,119,40,41,17,8,956,405,551,170,171,64,35,1
33710,247,110,137,34,45,23,10,1005,439,566,159,165,70,43,1
33711,687,353,334,84,96,74,31,193,99,94,31,31,16,12,1
33712,445,209,236,63,50,42,28,334,172,162,43,39,41,17,1
33713,360,188,172,49,48,47,17,390,191,199,66,49,43,12,1
33714,440,218,222,58,66,40,24,596,286,310,90,89,78,37,1
33715,556,279,277,83,69,71,19,246,113,133,33,45,22,10,1
33716,1246,677,569,159,154,108,52,240,167,73,32,12,8,21,1
33717,856,429,427,113,105,96,24,433,226,207,52,60,58,20,1
33718,663,360,303,88,82,80,35,1822,879,943,236,227,175,97,1
33719,673,328,345,107,112,63,27,224,99,125,27,37,14,3,1
33720,926,435,491,133,132,85,17,921,455,466,144,127,108,39,1
33721,625,286,339,92,59,83,42,728,343,385,116,82,96,57,1
33722,583,322,261,73,66,45,26,1822,879,943,236,227,175,97,1
33723,158,85,73,24,18,18,8,920,492,428,100,92,88,49,1
33724,146,71,75,20,17,8,7,877,458,419,115,88,81,52,1
33725,504,282,222,70,42,60,22,522,269,253,67,43,60,29,1
33726,526,264,262,77,71,61,27,412,223,189,55,55,41,10,1
33727,361,174,187,63,56,38,16,168,120,48,7,5,20,7,1
33728,666,349,317,87,91,58,20,380,212,168,47,38,19,11,1
33729,2320,948,1372,415,323,214,95,1647,794,853,279,235,128,65,1
33730,2442,1193,1249,278,183,170,145,614,305,309,96,73,65,24,1
33731,493,240,253,72,62,59,15,427,204,223,38,57,26,32,1
33732,930,367,563,181,153,83,48,552,285,267,74,51,69,24,1
33733,104,72,32,8,4,3,4,520,305,215,64,47,32,16,1
33734,651,306,345,85,64,61,32,781,367,414,60,67,43,17,1
33735,671,303,368,93,68,61,26,781,418,363,92,90,64,41,1
33736,1441,657,784,140,135,81,73,462,233,229,66,49,43,30,1
33737,620,299,321,75,60,68,30,1223,593,630,161,135,142,71,1
33738,851,446,405,93,94,92,37,390,203,187,58,40,43,19,1
33739,2261,1217,1044,271,243,267,101,233,111,122,38,27,17,8,1
33740,528,200,328,104,91,30,22,297,123,174,51,49,16,10,1
33741,1071,549,522,133,127,130,59,304,159,145,38,40,32,3,1
33742,784,393,391,117,102,65,35,344,168,176,65,44,33,15,1
33743,342,178,164,33,38,35,15,92,46,46,14,9,8,6,1
33744,1312,477,835,230,273,80,35,1273,592,681,199,164,139,39,1
33745,247,110,137,34,45,23,10,559,317,242,58,65,37,23,1
33746,683,288,395,125,94,77,39,450,232,218,58,54,42,20,1
33747,1689,821,868,277,250,177,78,1647,794,853,279,235,128,65,1
33748,1336,828,508,166,121,152,48,2472,1055,1417,416,458,235,64,1
33749,247,110,137,34,45,23,10,906,455,451,116,105,87,46,1
33750,562,273,289,76,92,45,24,759,390,369,107,83,68,42,1
33751,425,210,215,56,43,52,25,467,226,241,55,48,54,23,1
33752,450,241,209,67,58,54,23,782,421,361,101,97,82,20,1
33753,465,228,237,64,42,63,24,465,225,240,65,44,65,25,1
33754,327,172,155,45,44,39,21,928,442,486,139,118,91,43,1
33755,258,113,145,43,44,16,7,982,545,437,119,100,92,40,1
33756,1192,649,543,153,145,116,57,95,73,22,2,13,14,4,1
33757,2644,1346,1298,391,304,315,148,273,126,147,54,49,25,18,1
33758,786,367,419,126,108,87,29,524,264,260,75,75,40,21,1
33759,798,287,511,126,125,77,26,505,247,258,72,71,60,27,1
33760,462,228,234,59,47,37,32,257,148,109,28,20,21,14,1
33761,177,68,109,44,21,17,2,593,342,251,73,55,82,29,1
33762,258,113,145,43,44,16,7,255,113,142,31,40,18,9,1
33763,1006,468,538,151,135,82,39,1009,506,503,146,141,97,55,1
33764,556,269,287,86,66,62,22,308,159,149,52,41,22,10,1
33765,537,276,261,75,68,68,22,381,184,197,40,33,33,21,1
33766,1092,562,530,126,91,125,84,556,300,256,58,73,55,22,1
33767,525,274,251,82,74,60,25,249,105,144,71,26,13,7,1
33768,556,279,277,83,69,71,19,496,256,240,78,67,75,13,1
33769,767,392,375,113,112,83,13,602,310,292,87,66,70,36,1
33770,501,240,261,80,62,49,42,595,284,311,69,71,35,49,1
33771,221,110,111,28,32,25,11,1855,852,1003,329,264,184,83,1
33772,605,295,310,74,66,70,36,508,268,240,92,58,56,21,1
33773,89,42,47,16,12,15,6,332,180,152,46,36,28,14,1
33774,424,198,226,57,46,41,19,236,121,115,26,45,28,6,1
33775,522,265,257,35,39,38,8,291,120,171,63,39,26,6,1
33776,589,294,295,37,44,27,33,418,205,213,69,50,29,15,1
33777,803,358,445,135,117,80,44,923,509,414,95,102,65,52,1
33778,111,51,60,20,21,10,11,416,201,215,54,52,39,25,1
33779,1048,564,484,118,122,113,40,660,359,301,81,87,102,31,1
33780,609,292,317,102,96,64,21,1450,754,696,207,197,145,54,1
33781,770,385,385,78,83,60,16,862,409,453,149,125,86,29,1
33782,748,355,393,121,91,95,26,467,226,241,55,48,54,23,1
33783,4544,2024,2520,579,628,480,403,684,288,396,107,90,54,42,1
33784,327,175,152,48,45,36,16,854,380,474,137,159,81,31,1
33785,252,151,101,35,25,33,10,253,148,105,31,15,39,16,1
33786,806,436,370,101,100,76,34,207,94,113,44,20,25,10,1
33787,1190,638,552,162,95,112,18,418,248,170,41,31,54,9,1
33788,355,222,133,54,32,40,14,2414,1189,1225,277,178,170,169,1
33789,570,281,289,86,70,58,22,325,149,176,51,49,24,11,1
33790,214,110,104,26,22,16,10,253,133,120,44,31,22,8,1
33791,583,322,261,73,66,45,26,895,474,421,122,93,69,25,1
33792,159,77,82,23,9,18,11,794,390,404,103,95,86,23,1
33793,352,212,140,37,17,61,20,374,227,147,44,22,54,20,1
33794,396,150,246,103,64,38,3,454,191,263,61,66,38,15,1
33795,341,178,163,48,44,42,20,205,77,128,31,45,12,11,1
33796,1706,830,876,265,209,230,63,139,73,66,26,13,9,9,1
33797,695,373,322,80,59,89,39,229,105,124,36,33,12,4,1
33798,501,265,236,69,64,66,23,1133,491,642,192,170,61,29,1
33799,473,300,173,50,21,106,24,1159,641,518,148,115,114,48,1
33800,430,218,212,58,47,34,20,187,84,103,31,27,14,8,1
33801,508,254,254,74,99,61,12,253,148,105,31,15,39,16,1
33802,459,221,238,72,78,47,16,748,355,393,121,91,95,26,1
33803,357,187,170,51,34,40,23,1581,684,897,220,153,118,63,1
33804,465,257,208,51,61,54,23,700,305,395,111,99,54,18,1
33805,1253,639,614,181,155,164,73,377,184,193,56,53,44,14,1
33806,163,71,92,33,26,5,7,2414,1189,1225,277,178,170,169,1
33807,147,81,66,18,18,18,4,4391,2256,2135,494,411,423,231,1
33808,448,229,219,60,50,46,16,593,266,327,102,84,69,24,1
33809,501,240,261,80,62,49,42,753,395,358,93,72,71,16,1
33810,540,265,275,87,59,74,25,822,416,406,111,105,84,44,1
33811,101,68,33,9,6,23,2,467,269,198,46,51,60,18,1
33812,743,366,377,41,37,26,14,551,298,253,63,65,45,19,1
33813,269,156,113,37,32,17,7,2442,1193,1249,278,183,170,145,1
33814,280,127,153,53,36,12,6,918,357,561,191,150,42,24,1
33815,375,173,202,50,46,43,25,145,70,75,24,16,16,20,1
33816,306,128,178,49,59,17,9,217,109,108,34,32,35,7,1
33817,585,299,286,92,73,89,23,352,168,184,53,39,34,20,1
33818,431,201,230,69,39,55,33,1247,620,627,134,149,142,58,1
33819,546,267,279,90,69,56,19,3056,1457,1599,438,389,329,168,1
33820,499,252,247,75,71,65,25,1374,679,695,191,193,154,48,1
33821,1264,655,609,141,119,131,50,814,450,364,91,114,69,12,1
33822,512,261,251,79,73,60,21,897,487,410,92,97,83,31,1
33823,391,165,226,56,104,38,12,2442,1193,1249,278,183,170,145,1
33824,527,264,263,60,61,45,30,1084,537,547,154,121,92,35,1
33825,1273,592,681,199,164,139,39,422,203,219,75,49,40,22,1
33826,2839,1413,1426,384,301,308,145,186,99,87,30,17,18,8,1
33827,269,134,135,42,35,27,13,255,134,121,36,40,29,13,1
33828,543,274,269,85,56,34,19,315,150,165,49,59,23,15,1
33829,716,364,352,107,80,75,26,317,153,164,34,52,30,14,1
33830,433,237,196,60,52,33,27,297,158,139,47,37,37,9,1
33831,424,209,215,56,58,45,24,393,186,207,58,50,36,22,1
33832,147,81,66,18,18,18,4,466,186,280,71,84,30,11,1
33833,815,418,397,97,62,70,17,662,297,365,92,88,44,29,1
33834,448,281,167,47,37,45,13,703,414,289,75,61,68,26,1
33835,1566,743,823,261,188,151,48,201,42,159,19,3,2,75,1
33836,868,448,420,108,103,76,25,390,207,183,50,48,38,15,1
33837,789,362,427,90,82,70,35,2414,1189,1225,277,178,170,169,1
33838,303,187,116,41,23,23,9,651,306,345,85,64,61,32,1
33839,197,95,102,30,26,29,9,418,213,205,54,70,38,18,1
33840,264,122,142,33,29,13,13,2035,1087,948,163,129,96,73,1
33841,538,268,270,58,72,42,25,750,347,403,105,103,83,29,1
33842,1189,559,630,179,147,118,35,529,283,246,66,69,66,25,1
33843,95,41,54,15,16,8,5,1134,539,595,150,146,78,40,1
33844,656,358,298,67,47,64,26,219,97,122,30,29,23,9,1
33845,326,153,173,63,48,25,8,583,248,335,115,111,52,16,1
33846,539,279,260,72,64,19,24,375,202,173,46,49,41,23,1
33847,178,88,90,24,21,11,11,301,150,151,41,30,17,11,1
33848,462,251,211,74,53,41,18,63,29,34,13,10,4,8,1
33849,1374,679,695,191,193,154,48,501,240,261,80,62,49,42,1
33850,987,515,472,107,110,106,61,269,165,104,24,19,27,7,1
33851,545,289,256,75,72,42,22,304,127,177,61,38,31,4,1
33852,1692,713,979,325,210,122,58,206,85,121,31,42,6,17,1
33853,215,115,100,27,28,34,16,288,158,130,59,23,21,10,1
33854,443,208,235,43,55,51,50,318,176,142,25,32,35,25,1
33855,328,120,208,76,50,23,9,1132,624,508,199,79,127,41,1
33856,708,334,374,105,96,61,37,218,108,110,28,28,22,10,1
33857,580,339,241,72,47,66,21,298,167,131,47,33,40,8,1
33858,307,150,157,44,23,30,13,496,247,249,82,69,47,14,1
33859,947,506,441,105,126,75,14,367,161,206,70,48,41,19,1
33860,685,315,370,108,99,36,9,168,120,48,7,5,20,7,1
33861,1019,547,472,141,136,82,34,659,361,298,106,66,86,29,1
33862,672,334,338,110,93,91,41,332,185,147,31,59,7,4,1
33863,1893,764,1129,308,323,126,60,1315,720,595,138,136,115,62,1
33864,379,140,239,99,60,30,11,673,317,356,101,85,76,49,1
33865,805,438,367,89,95,116,25,182,71,111,45,36,11,13,1
33866,559,296,263,77,69,42,13,304,159,145,38,40,32,3,1
33867,940,464,476,116,135,108,58,246,104,142,47,38,17,14,1
33868,292,152,140,46,38,35,12,555,278,277,60,70,48,18,1
33869,235,104,131,29,35,26,10,625,316,309,77,79,54,34,1
33870,1278,593,685,198,201,71,43,410,186,224,72,57,52,22,1
33871,377,184,193,56,53,44,14,838,431,407,107,90,107,43,1
33872,198,98,100,30,21,21,8,638,305,333,68,90,70,29,1
33873,1190,638,552,162,95,112,18,703,308,395,81,91,66,80,1
33874,1231,603,628,121,162,109,120,1670,1140,530,173,120,89,53,1
33875,217,94,123,29,30,23,17,354,168,186,50,53,39,20,1
33876,1016,557,459,107,124,57,30,549,273,276,74,68,72,24,1
33877,163,70,93,28,21,17,6,297,158,139,47,37,37,9,1
33878,616,304,312,75,71,55,25,292,154,138,46,29,41,7,1
33879,517,249,268,65,59,58,26,627,289,338,101,73,62,43,1
33880,278,111,167,66,66,19,8,227,107,120,38,33,30,10,1
33881,529,264,265,63,59,60,35,442,230,212,50,58,56,23,1
33882,509,262,247,64,70,64,20,398,174,224,46,58,36,17,1
33883,143,79,64,16,25,7,5,758,362,396,115,102,35,13,1
33884,871,395,476,155,141,75,30,254,146,108,28,35,33,8,1
33885,231,126,105,37,26,29,6,254,107,147,42,37,24,10,1
33886,480,234,246,79,77,65,23,595,316,279,86,60,65,40,1
33887,703,388,315,82,78,81,37,117,62,55,24,18,21,2,1
33888,706,300,406,94,74,61,22,2442,1193,1249,278,183,170,145,1
33889,493,281,212,57,50,51,20,100,51,49,12,12,8,4,1
33890,246,108,138,32,44,21,10,391,208,183,65,49,57,17,1
33891,187,95,92,27,20,16,8,201,42,159,19,3,2,75,1
33892,3574,1733,1841,371,392,414,304,467,224,243,70,43,67,23,1
33893,519,244,275,76,90,44,16,1165,567,598,134,119,158,63,1
33894,456,209,247,72,58,40,9,659,325,334,102,85,87,32,1
33895,393,186,207,58,50,36,22,467,226,241,55,48,54,23,1
33896,228,72,156,42,27,8,7,414,194,220,76,66,49,16,1
33897,1250,640,610,155,117,82,37,1577,747,830,213,232,147,57,1
33898,224,103,121,34,47,11,9,437,210,227,73,62,38,19,1
33899,211,113,98,38,17,25,8,620,305,315,97,80,87,28,1
33900,427,215,212,69,35,51,21,273,126,147,54,49,25,18,1
33901,536,266,270,58,73,40,25,971,516,455,114,115,116,35,1
33902,938,484,454,137,100,104,41,864,429,435,129,118,68,35,1
33903,269,133,136,30,41,34,17,1474,756,718,175,158,169,51,1
33904,669,351,318,122,84,49,9,359,171,188,49,74,45,11,1
33905,309,154,155,42,44,45,16,277,100,177,35,88,30,2,1
33906,4303,2489,1814,436,369,444,134,470,205,265,71,80,33,11,1
33907,247,127,120,43,20,27,14,416,210,206,55,54,39,20,1
33908,810,345,465,104,99,83,103,330,143,187,63,29,52,20,1
33909,315,129,186,51,29,24,29,217,109,108,34,32,35,7,1
33910,575,293,282,78,64,40,13,1290,629,661,191,187,167,55,1
33911,579,306,273,82,45,59,29,149,68,81,15,38,11,10,1
33912,673,317,356,101,85,76,49,95,47,48,13,12,10,4,1
33913,716,364,352,107,80,75,26,712,380,332,69,74,57,30,1
33914,858,406,452,135,78,69,36,1308,652,656,166,153,149,87,1
33915,365,180,185,63,35,48,19,245,111,134,31,44,20,11,1
33916,467,224,243,70,43,67,23,4374,2058,2316,531,605,321,183,1
33917,240,98,142,49,42,23,17,466,186,280,71,84,30,11,1
33918,323,181,142,40,37,26,16,189,96,93,24,21,19,17,1
33919,676,333,343,111,89,94,39,700,335,365,83,84,95,33,1
33920,755,349,406,131,80,68,28,716,354,362,102,87,77,30,1
33921,484,254,230,60,66,56,14,408,205,203,80,40,55,23,1
33922,538,252,286,77,87,53,30,4684,2161,2523,779,782,304,101,1
33923,369,180,189,62,70,24,21,454,242,212,54,42,61,24,1
33924,951,506,445,107,118,79,40,552,285,267,74,51,69,24,1
33925,161,75,86,21,11,17,7,537,276,261,75,68,68,22,1
33926,257,132,125,39,27,26,10,457,261,196,55,27,57,34,1
33927,830,402,428,80,67,100,80,423,218,205,64,55,54,15,1
33928,355,220,135,43,26,65,20,109,50,59,20,7,10,9,1
33929,766,384,382,132,86,71,30,646,304,342,104,93,58,26,1
33930,385,194,191,49,50,40,12,457,237,220,69,44,53,26,1
33931,968,506,462,132,140,88,37,225,113,112,29,45,19,7,1
33932,430,198,232,57,46,37,19,393,223,170,44,36,32,14,1
33933,327,172,155,45,44,39,21,1425,670,755,153,189,122,85,1
33934,154,72,82,31,17,10,10,854,380,474,137,159,81,31,1
33935,323,168,155,47,35,26,9,380,200,180,35,42,31,10,1
33936,2946,1499,1447,365,342,315,119,760,391,369,101,109,65,24,1
33937,247,110,137,34,45,23,10,683,263,420,127,85,40,25,1
33938,536,237,299,116,87,42,17,306,167,139,42,51,23,8,1
33939,2442,1193,1249,278,183,170,145,640,279,361,102,83,69,21,1
33940,326,166,160,49,45,36,12,292,153,139,39,33,24,21,1
33941,332,185,147,31,59,7,4,149,68,81,15,38,11,10,1
33942,616,324,292,96,63,45,20,119,44,75,19,21,4,4,1
33943,477,239,238,63,58,45,16,375,202,173,46,49,41,23,1
33944,155,66,89,24,25,9,14,504,259,245,73,56,45,29,1
33945,430,239,191,63,42,51,19,204,84,120,39,39,18,10,1
33946,380,187,193,38,51,30,18,969,505,464,123,133,92,33,1
33947,1670,1140,530,173,120,89,53,770,355,415,103,142,75,42,1
33948,508,267,241,57,49,40,13,6669,2978,3691,1310,930,829,237,1
33949,666,390,276,97,62,60,28,1290,629,661,191,187,167,55,1
33950,482,224,258,71,62,52,39,1441,657,784,140,135,81,73,1
33951,217,109,108,34,32,35,7,770,355,415,103,142,75,42,1
33952,211,114,97,32,24,19,10,372,179,193,50,52,33,6,1
33953,920,492,428,100,92,88,49,215,80,135,54,56,21,9,1
33954,264,122,142,33,29,13,13,393,186,207,58,50,36,22,1
33955,242,125,117,38,31,28,22,1248,584,664,184,164,155,67,1
33956,247,110,137,34,45,23,10,582,285,297,62,57,44,16,1
33957,168,120,48,7,5,20,7,318,176,142,25,32,35,25,1
33958,802,344,458,156,136,57,24,435,222,213,67,49,67,12,1
33959,309,179,130,37,19,31,16,246,108,138,32,44,21,10,1
33960,403,185,218,67,62,63,19,178,100,78,23,22,30,6,1
33961,172,83,89,26,25,18,7,278,148,130,36,29,25,16,1
33962,466,186,280,71,84,30,11,304,144,160,54,31,22,10,1
33963,261,171,90,21,21,35,17,345,169,176,57,50,32,15,1
33964,420,197,223,72,57,54,19,241,132,109,33,26,27,13,1
33965,863,458,405,97,82,63,57,733,346,387,98,113,66,26,1
33966,303,137,166,54,54,31,15,255,134,121,36,40,29,13,1
33967,532,267,265,86,55,64,22,1255,666,589,145,142,120,82,1
33968,352,212,140,37,17,61,20,241,124,117,25,35,21,12,1
33969,527,257,270,72,68,50,28,776,356,420,122,103,85,30,1
33970,238,151,87,15,14,35,18,207,137,70,16,9,23,17,1
33971,1782,715,1067,211,414,58,30,672,334,338,110,93,91,41,1
33972,381,187,194,37,49,36,17,246,115,131,15,29,10,32,1
33973,272,141,131,45,29,36,9,219,124,95,22,22,23,5,1
33974,349,131,218,66,76,22,9,1050,473,577,142,119,87,54,1
33975,303,175,128,43,36,34,12,213,76,137,63,36,13,2,1
33976,451,225,226,68,57,65,22,847,452,395,100,94,81,36,1
33977,330,159,171,48,38,50,19,394,202,192,44,43,38,28,1
33978,103,56,47,27,7,8,2,277,100,177,35,88,30,2,1
33979,807,359,448,114,99,93,33,217,109,108,34,32,35,7,1
33980,1863,721,1142,262,283,139,74,279,106,173,48,35,41,39,1
33981,462,251,211,74,53,41,18,161,76,85,18,21,13,5,1
33982,835,420,415,88,75,92,61,381,184,197,40,33,33,21,1
33983,672,334,338,110,93,91,41,1078,557,521,116,114,144,44,1
33984,297,148,149,64,35,37,15,876,457,419,88,124,67,47,1
33985,669,351,318,122,84,49,9,533,254,279,81,78,52,10,1
33986,163,71,92,22,38,11,7,356,199,157,43,58,29,12,1
33987,977,500,477,139,115,121,31,973,497,476,131,108,126,49,1
33988,381,189,192,74,49,44,13,901,458,443,91,129,86,21,1
33989,1132,553,579,172,143,150,57,508,295,213,42,61,53,17,1
33990,466,186,280,71,84,30,11,324,151,173,61,54,32,6,1
33991,183,107,76,20,17,22,3,638,320,318,97,77,46,26,1
33992,1202,506,696,209,198,74,44,770,356,414,123,102,66,25,1
33993,3144,1617,1527,367,342,278,136,1210,592,618,157,138,116,85,1
33994,246,115,131,15,29,10,32,720,357,363,113,85,62,39,1
33995,433,237,196,60,52,33,27,524,237,287,87,75,54,26,1
33996,673,313,360,101,101,46,17,357,182,175,53,45,41,26,1
33997,271,131,140,47,37,41,11,2442,1193,1249,278,183,170,145,1
33998,162,73,89,32,19,4,4,279,161,118,37,21,22,9,1
33999,1243,633,610,149,160,87,39,1030,604,426,115,88,130,45,1
34000,802,375,427,133,103,81,41,298,167,131,47,33,40,8,1
34001,828,405,423,114,106,78,33,246,108,138,32,44,21,10,1
34002,554,254,300,104,58,66,28,446,176,270,64,79,45,24,1
34003,1202,639,563,161,131,113,47,324,190,134,41,27,28,9,1
34004,756,348,408,101,103,60,40,356,199,157,43,58,29,12,1
34005,353,147,206,47,61,30,25,863,450,413,116,122,106,41,1
34006,324,154,170,57,40,26,4,360,192,168,55,45,48,16,1
34007,748,355,393,121,91,95,26,453,191,262,58,55,39,22,1
34008,574,273,301,101,74,68,26,505,244,261,77,65,56,22,1
34009,347,198,149,45,29,29,8,338,172,166,32,42,22,10,1
34010,400,207,193,30,36,12,10,1709,942,767,179,148,157,60,1
34011,515,253,262,46,83,57,21,188,91,97,24,22,21,12,1
34012,354,137,217,63,43,38,38,1363,690,673,185,172,152,62,1
34013,419,175,244,71,73,23,23,854,380,474,137,159,81,31,1
34014,605,263,342,73,103,54,18,347,212,135,35,32,17,6,1
34015,172,74,98,32,30,11,7,136,72,64,22,16,7,3,1
34016,947,482,465,143,107,89,37,379,203,176,55,48,45,16,1
34017,672,334,338,110,93,91,41,100,37,63,26,19,0,1,1
34018,260,133,127,43,32,39,3,911,551,360,92,106,107,29,1
34019,1016,501,515,109,71,76,37,2442,1193,1249,278,183,170,145,1
34020,483,258,225,70,53,54,20,383,204,179,61,32,54,16,1
34021,220,126,94,29,12,34,11,217,109,108,34,32,35,7,1
34022,437,225,212,61,57,66,12,290,163,127,34,43,30,13,1
34023,482,231,251,76,81,64,26,463,231,232,66,69,29,18,1
34024,805,419,386,94,99,111,35,117,65,52,15,16,10,4,1
34025,1086,603,483,147,121,95,40,232,101,131,44,34,19,8,1
34026,247,135,112,25,24,27,13,770,355,415,103,142,75,42,1
34027,613,379,234,55,55,72,33,490,224,266,80,70,39,32,1
34028,317,149,168,62,44,27,10,202,102,100,29,35,6,9,1
34029,97,46,51,12,17,11,8,393,186,207,58,50,36,22,1
34030,601,313,288,42,48,25,36,793,318,475,110,104,45,30,1
34031,474,258,216,63,48,51,24,1210,592,618,157,138,116,85,1
34032,138,69,69,28,7,10,10,240,125,115,34,32,30,8,1
34033,482,235,247,58,45,37,26,427,218,209,61,53,45,26,1
34034,185,107,78,20,29,10,4,183,78,105,30,31,26,8,1
34035,594,305,289,86,63,51,21,838,431,407,107,90,107,43,1
34036,476,227,249,52,59,38,17,777,387,390,90,87,65,37,1
34037,178,100,78,23,22,30,6,226,128,98,32,18,37,16,1
34038,476,270,206,62,45,46,30,119,61,58,18,8,9,6,1
34039,1024,507,517,141,122,119,46,233,94,139,36,37,15,8,1
34040,411,175,236,60,73,47,17,279,135,144,40,52,40,5,1
34041,433,222,211,68,58,42,23,225,102,123,32,32,31,15,1
34042,911,489,422,121,98,97,36,423,186,237,92,40,52,29,1
34043,247,110,137,34,45,23,10,729,321,408,128,84,63,26,1
34044,233,121,112,24,31,30,7,334,194,140,49,36,25,12,1
34045,220,126,94,29,12,34,11,1102,552,550,174,137,137,45,1
34046,1469,742,727,213,173,93,29,743,366,377,41,37,26,14,1
34047,245,118,127,27,20,33,21,495,272,223,60,59,54,14,1
34048,745,391,354,85,81,52,39,309,106,203,66,49,25,10,1
34049,194,82,112,28,24,19,6,790,385,405,121,108,106,39,1
34050,759,326,433,115,95,61,29,605,295,310,74,66,70,36,1
34051,873,366,507,127,125,75,21,466,186,280,71,84,30,11,1
34052,442,252,190,35,52,20,4,168,67,101,37,17,13,13,1
34053,245,112,133,32,45,20,10,870,489,381,97,99,76,14,1
34054,722,384,338,94,83,63,35,505,268,237,68,59,34,15,1
34055,2414,1189,1225,277,178,170,169,397,224,173,47,26,39,19,1
34056,1221,595,626,201,152,83,31,301,119,182,53,47,14,20,1
34057,454,237,217,53,49,44,24,760,391,369,101,109,65,24,1
34058,1512,737,775,238,209,156,57,590,306,284,69,82,68,27,1
34059,465,257,208,51,61,54,23,364,183,181,53,44,46,14,1
34060,624,307,317,99,74,67,33,1038,470,568,130,123,86,51,1
34061,2839,1321,1518,400,328,170,90,146,83,63,19,12,13,8,1
34062,101,41,60,18,19,10,5,1464,693,771,153,136,91,86,1
34063,295,143,152,38,47,22,25,781,418,363,92,90,64,41,1
34064,200,90,110,22,29,10,13,900,484,416,119,110,77,29,1
34065,428,226,202,52,60,75,20,490,239,251,78,63,66,38,1
34066,1214,573,641,184,152,101,66,467,250,217,59,52,41,19,1
34067,150,74,76,21,22,18,7,167,72,95,31,45,14,5,1
34068,689,343,346,119,100,86,38,350,220,130,32,18,45,17,1
34069,592,292,300,56,52,71,17,291,141,150,50,29,35,7,1
34070,1907,1008,899,235,224,195,73,1338,756,582,155,105,104,44,1
34071,95,44,51,14,13,7,4,437,212,225,66,44,44,11,1
34072,455,242,213,69,50,45,18,1038,470,568,130,123,86,51,1
34073,962,430,532,109,142,61,34,744,384,360,104,96,57,31,1
34074,393,186,207,58,50,36,22,376,183,193,50,50,43,21,1
34075,4128,2104,2024,581,505,453,205,676,333,343,111,89,94,39,1
34076,469,204,265,81,67,30,22,461,217,244,44,41,27,36,1
34077,581,302,279,73,72,53,37,956,403,553,147,135,99,87,1
34078,393,186,207,58,50,36,22,1531,691,840,270,226,143,52,1
34079,576,250,326,93,71,34,15,727,352,375,115,106,97,32,1
34080,400,207,193,30,36,12,10,781,418,363,92,90,64,41,1
34081,456,228,228,49,70,32,19,2024,765,1259,283,343,137,76,1
34082,390,183,207,56,50,52,12,331,165,166,52,34,48,22,1
34083,293,142,151,49,40,42,17,1247,548,699,168,150,140,43,1
34084,1873,948,925,245,214,194,85,210,115,95,31,22,27,10,1
34085,785,391,394,83,116,74,20,814,450,364,91,114,69,12,1
34086,947,506,441,105,126,75,14,769,329,440,116,66,55,22,1
34087,1718,735,983,266,225,130,68,136,65,71,33,11,9,6,1
34088,970,440,530,142,102,111,39,1379,599,780,214,189,91,33,1
34089,426,228,198,62,42,47,22,1162,515,647,191,143,97,35,1
34090,335,128,207,59,43,24,23,149,68,81,15,38,11,10,1
34091,691,309,382,93,98,88,42,163,71,92,22,38,11,7,1
34092,323,123,200,59,69,30,15,135,65,70,21,25,15,9,1
34093,1105,544,561,165,167,98,40,579,321,258,74,70,47,22,1
34094,259,118,141,21,29,15,23,873,366,507,127,125,75,21,1
34095,673,329,344,111,95,92,41,864,362,502,142,150,70,19,1
34096,724,325,399,98,92,64,24,1290,629,661,191,187,167,55,1
34097,826,362,464,107,118,71,43,920,492,428,100,92,88,49,1
34098,585,289,296,102,86,61,18,361,185,176,55,40,49,14,1
34099,734,366,368,121,99,63,39,719,364,355,104,100,58,34,1
34100,480,256,224,67,55,26,22,1466,991,475,136,129,59,39,1
34101,308,160,148,39,46,30,12,1233,635,598,187,149,146,51,1
34102,204,100,104,61,11,32,5,327,177,150,40,40,38,18,1
34103,293,115,178,63,37,28,7,3256,1307,1949,625,448,159,88,1
34104,727,388,339,102,87,71,29,364,195,169,50,38,33,12,1
34105,1038,470,568,130,123,86,51,568,327,241,67,60,66,21,1
34106,314,108,206,45,75,34,8,742,303,439,88,96,86,23,1
34107,922,491,431,112,92,97,52,451,238,213,53,64,56,22,1
34108,1503,794,709,220,174,189,60,931,491,440,127,116,118,44,1
34109,671,326,345,111,77,74,11,342,208,134,36,31,29,15,1
34110,1273,592,681,199,164,139,39,585,277,308,92,73,61,32,1
34111,339,170,169,32,17,24,13,651,306,345,85,64,61,32,1
34112,480,234,246,79,77,65,23,1374,679,695,191,193,154,48,1
34113,380,225,155,52,37,72,11,155,115,40,8,7,12,8,1
34114,433,221,212,59,42,47,14,1278,593,685,198,201,71,43,1
34115,375,202,173,46,49,41,23,166,79,87,29,27,14,5,1
34116,622,331,291,69,74,45,21,520,246,274,87,77,63,29,1
34117,956,403,553,147,135,99,87,1670,1140,530,173,120,89,53,1
34118,898,467,431,101,127,90,53,355,179,176,51,45,45,11,1
34119,238,151,87,15,14,35,18,399,222,177,48,44,52,23,1
34120,432,218,214,57,55,42,11,436,199,237,70,55,47,22,1
34121,639,322,317,73,82,39,23,1675,875,800,213,219,196,72,1
34122,198,80,118,35,31,14,7,149,52,97,36,36,7,4,1
34123,318,176,142,25,32,35,25,118,52,66,20,15,23,2,1
34124,738,339,399,102,88,68,35,526,264,262,77,71,61,27,1
34125,633,303,330,95,91,51,13,342,160,182,69,40,37,16,1
34126,351,185,166,45,57,51,14,393,186,207,58,50,36,22,1
34127,814,403,411,112,140,94,23,325,159,166,42,43,48,15,1
34128,391,193,198,51,49,39,24,467,224,243,70,43,67,23,1
34129,552,285,267,74,51,69,24,365,188,177,60,47,48,16,1
34130,4655,2074,2581,545,652,562,399,474,208,266,65,69,43,36,1
34131,260,120,140,34,39,36,12,479,233,246,68,66,36,21,1
34132,1374,657,717,243,178,185,70,773,361,412,126,126,65,30,1
34133,431,228,203,66,46,59,15,673,318,355,61,71,40,31,1
34134,129,56,73,17,14,19,18,116,55,61,16,7,18,14,1
34135,391,208,183,65,49,57,17,418,218,200,53,50,39,9,1
34136,252,121,131,42,34,12,16,577,251,326,92,84,60,11,1
34137,161,99,62,15,22,9,7,482,231,251,76,81,64,26,1
34138,258,126,132,38,22,29,8,435,225,210,58,46,50,14,1
34139,743,233,510,148,142,28,17,483,215,268,66,70,30,16,1
34140,224,101,123,45,32,21,3,215,115,100,27,28,34,16,1
34141,224,96,128,40,37,23,6,96,55,41,13,2,8,5,1
34142,162,73,89,32,19,4,4,466,186,280,71,84,30,11,1
34143,625,313,312,103,90,74,29,1058,558,500,132,127,121,53,1
34144,1566,743,823,261,188,151,48,2004,839,1165,291,300,148,108,1
34145,816,463,353,99,99,61,26,454,191,263,61,66,38,15,1
34146,137,66,71,22,11,10,14,355,214,141,43,29,63,13,1
34147,427,236,191,49,54,46,13,729,358,371,116,99,89,33,1
34148,932,471,461,137,86,84,32,149,68,81,15,38,11,10,1
34149,218,108,110,28,28,22,10,222,123,99,32,20,32,6,1
34150,235,104,131,29,35,26,10,904,443,461,118,89,124,30,1
34151,744,569,175,71,37,51,25,568,292,276,69,74,59,34,1
34152,354,166,188,53,55,40,19,443,240,203,66,31,57,27,1
34153,303,137,166,54,54,31,15,758,362,396,115,102,35,13,1
34154,815,418,397,97,62,70,17,227,127,100,32,24,31,5,1
34155,635,326,309,70,61,77,30,593,266,327,102,84,69,24,1
34156,217,109,108,34,32,35,7,327,177,150,56,20,25,6,1
34157,847,402,445,109,91,100,37,533,254,279,81,78,52,10,1
34158,596,286,310,90,89,78,37,212,107,105,29,26,25,8,1
34159,358,170,188,54,55,20,10,583,248,335,115,111,52,16,1
34160,919,538,381,111,98,103,41,1818,1119,699,211,211,108,36,1
34161,245,112,133,32,45,20,10,496,247,249,82,69,47,14,1
34162,391,208,183,65,49,57,17,873,366,507,127,125,75,21,1
34163,2492,894,1598,466,444,164,102,168,67,101,37,17,13,13,1
34164,423,252,171,53,39,42,21,402,227,175,48,40,35,11,1
34165,536,278,258,72,63,62,20,770,374,396,95,91,79,41,1
34166,1671,719,952,198,228,109,84,470,289,181,58,47,45,25,1
34167,207,108,99,25,15,27,16,477,256,221,69,66,70,12,1
34168,1140,495,645,129,95,128,159,1263,616,647,185,180,140,56,1
34169,477,256,221,69,66,70,12,314,108,206,45,75,34,8,1
34170,647,387,260,69,51,86,38,380,184,196,56,35,44,36,1
34171,446,221,225,50,44,45,22,530,259,271,83,50,54,41,1
34172,224,125,99,33,32,22,6,526,266,260,76,75,53,22,1
34173,532,267,265,86,55,64,22,1342,673,669,178,154,137,94,1
34174,235,129,106,24,19,20,10,273,131,142,35,35,25,12,1
34175,1499,678,821,224,201,126,55,1455,760,695,205,191,124,40,1
34176,1258,531,727,218,216,108,35,2492,894,1598,466,444,164,102,1
34177,425,210,215,56,43,52,25,824,392,432,106,89,88,32,1
34178,267,124,143,45,46,26,4,545,263,282,80,80,68,22,1
34179,235,104,131,29,35,26,10,569,288,281,86,69,74,24,1
34180,233,121,112,24,31,30,7,105,53,52,23,11,12,6,1
34181,815,478,337,104,80,103,27,196,92,104,35,33,19,6,1
34182,647,324,323,101,80,76,43,166,79,87,29,27,14,5,1
34183,815,418,397,97,62,70,17,1313,644,669,169,90,111,43,1
34184,220,113,107,37,24,16,7,136,65,71,33,11,9,6,1
34185,117,66,51,15,8,4,11,258,133,125,24,13,30,11,1
34186,643,282,361,94,109,59,24,497,185,312,63,92,38,28,1
34187,360,167,193,61,34,43,35,352,169,183,57,36,47,31,1
34188,822,416,406,111,105,84,44,858,417,441,93,124,75,26,1
34189,546,267,279,90,69,56,19,422,198,224,52,52,42,43,1
34190,1134,574,560,157,164,47,48,930,367,563,181,153,83,48,1
34191,412,223,189,55,55,41,10,377,184,193,56,53,44,14,1
34192,200,90,110,22,29,10,13,648,307,341,101,58,76,34,1
34193,396,150,246,103,64,38,3,543,200,343,112,93,60,28,1
34194,630,294,336,92,90,57,21,315,150,165,49,59,23,15,1
34195,215,115,100,27,28,34,16,961,463,498,139,156,62,34,1
34196,1237,617,620,138,167,92,24,1270,557,713,130,195,57,30,1
34197,429,223,206,50,32,46,17,770,390,380,104,76,78,32,1
34198,411,208,203,63,44,52,19,160,53,107,31,29,13,3,1
34199,1893,764,1129,308,323,126,60,878,365,513,128,125,56,28,1
34200,579,330,249,52,27,90,11,89,42,47,16,12,15,6,1
34201,297,158,139,47,37,37,9,793,240,553,196,206,28,13,1
34202,724,334,390,112,109,79,17,556,300,256,58,73,55,22,1
34203,323,181,142,40,37,26,16,184,78,106,21,25,25,12,1
34204,1006,569,437,133,96,76,36,480,257,223,74,26,60,27,1
34205,393,186,207,58,50,36,22,389,207,182,53,58,52,18,1
34206,168,67,101,37,17,13,13,296,151,145,39,25,40,20,1
34207,448,275,173,32,53,55,27,714,364,350,98,102,91,27,1
34208,335,185,150,46,34,36,13,199,106,93,29,23,26,7,1
34209,158,85,73,24,18,18,8,2414,1189,1225,277,178,170,169,1
34210,740,385,355,114,97,91,27,433,222,211,68,58,42,23,1
34211,899,453,446,149,128,78,24,3354,1783,1571,308,474,315,62,1
34212,2639,1436,1203,317,307,242,77,626,333,293,64,55,61,15,1
34213,378,154,224,74,84,35,22,298,167,131,47,33,40,8,1
34214,755,348,407,109,98,49,23,703,356,347,96,97,38,22,1
34215,434,237,197,52,64,37,14,213,129,84,32,14,21,15,1
34216,251,178,73,21,12,50,12,738,399,339,88,86,83,39,1
34217,355,166,189,54,54,39,17,413,227,186,45,34,58,23,1
34218,845,412,433,146,103,112,18,377,202,175,46,50,41,23,1
34219,955,465,490,137,138,119,28,649,326,323,83,66,87,38,1
34220,52,24,28,6,4,3,5,422,203,219,75,49,40,22,1
34221,2442,1193,1249,278,183,170,145,299,164,135,30,21,29,10,1
34222,1071,549,522,133,127,130,59,346,168,178,36,43,20,9,1
34223,120,56,64,15,12,10,5,217,98,119,33,32,27,7,1
34224,648,307,341,101,58,76,34,409,200,209,69,56,44,13,1
34225,810,367,443,115,92,94,59,345,174,171,46,34,45,28,1
34226,799,377,422,98,95,80,70,2058,933,1125,317,304,250,74,1
34227,433,221,212,59,42,47,14,770,355,415,103,142,75,42,1
34228,323,147,176,61,35,45,10,331,169,162,40,28,22,14,1
34229,331,152,179,34,30,35,12,128,67,61,19,13,15,4,1
34230,822,392,430,125,104,79,24,280,122,158,47,39,13,12,1
34231,350,214,136,33,23,49,27,91,50,41,12,5,10,7,1
34232,461,207,254,82,66,55,33,1158,481,677,169,129,86,40,1
34233,665,341,324,92,88,59,27,1107,601,506,155,138,104,49,1
34234,2261,1217,1044,271,243,267,101,540,306,234,74,52,43,22,1
34235,412,192,220,71,50,48,23,442,208,234,68,49,51,25,1
34236,1379,663,716,153,117,178,106,332,198,134,29,17,46,28,1
34237,713,335,378,94,70,56,35,261,130,131,27,41,19,16,1
34238,540,257,283,81,63,57,24,427,204,223,38,57,26,32,1
34239,1562,742,820,219,231,104,46,2803,1300,1503,392,510,170,57,1
34240,521,267,254,53,68,39,15,687,353,334,84,96,74,31,1
34241,229,111,118,33,26,13,13,467,226,241,55,48,54,23,1
34242,147,81,66,18,18,18,4,404,231,173,44,43,24,10,1
34243,620,324,296,81,68,66,31,539,279,260,72,64,19,24,1
34244,175,91,84,18,14,22,12,201,98,103,26,35,16,5,1
34245,690,327,363,115,91,54,31,921,455,466,144,127,108,39,1
34246,759,391,368,103,82,101,45,973,497,476,131,108,126,49,1
34247,707,391,316,111,80,54,30,1273,592,681,199,164,139,39,1
34248,349,194,155,54,31,44,17,465,257,208,51,61,54,23,1
34249,134,60,74,19,13,10,7,320,163,157,44,44,26,15,1
34250,170,85,85,15,24,12,11,672,334,338,110,93,91,41,1
34251,158,71,87,23,21,17,12,619,332,287,95,77,74,38,1
34252,1124,615,509,157,125,128,52,1304,585,719,179,169,154,47,1
34253,619,293,326,98,78,65,22,247,110,137,34,45,23,10,1
34254,1706,830,876,265,209,230,63,785,419,366,105,90,64,31,1
34255,145,75,70,18,17,10,9,467,250,217,59,52,41,19,1
34256,307,162,145,38,46,41,15,474,199,275,76,66,29,19,1
34257,509,341,168,35,32,52,15,660,347,313,94,72,82,29,1
34258,178,100,78,23,22,30,6,428,223,205,59,67,23,16,1
34259,1721,809,912,268,234,144,50,987,515,472,107,110,106,61,1
34260,682,353,329,80,60,86,22,921,455,466,144,127,108,39,1
34261,560,254,306,78,67,75,47,1691,1217,474,130,115,73,46,1
34262,489,253,236,73,36,62,17,655,328,327,65,54,55,35,1
34263,1655,891,764,205,245,81,30,476,270,206,62,45,46,30,1
34264,427,218,209,61,53,45,26,724,334,390,112,109,79,17,1
34265,403,195,208,68,48,37,16,1477,738,739,176,176,145,72,1
34266,394,202,192,44,43,38,28,531,286,245,81,67,42,29,1
34267,194,82,112,28,24,19,6,239,146,93,30,22,35,9,1
34268,505,272,233,76,66,57,23,226,129,97,20,25,26,11,1
34269,1865,943,922,270,209,228,91,1290,629,661,191,187,167,55,1
34270,1893,850,1043,280,340,169,80,432,228,204,59,53,43,15,1
34271,184,80,104,43,29,10,8,551,237,314,95,79,54,17,1
34272,1084,537,547,154,121,92,35,589,281,308,69,39,63,20,1
34273,617,255,362,105,108,61,23,864,429,435,129,118,68,35,1
34274,1150,585,565,162,148,102,36,1304,679,625,153,158,131,35,1
34275,1210,592,618,157,138,116,85,728,385,343,110,102,69,14,1
34276,824,403,421,80,150,65,35,847,467,380,117,101,67,24,1
34277,2549,1331,1218,366,296,271,130,770,374,396,95,91,79,41,1
34278,2416,1280,1136,140,374,175,47,469,247,222,70,58,82,13,1
34279,168,67,101,37,17,13,13,286,148,138,29,51,25,6,1
34280,198,112,86,20,36,16,5,921,455,466,144,127,108,39,1
34281,1336,736,600,137,136,163,69,509,254,255,67,55,52,35,1
34282,480,243,237,75,59,51,25,1134,574,560,157,164,47,48,1
34283,510,269,241,66,67,71,26,920,492,428,100,92,88,49,1
34284,1270,502,768,199,168,92,50,363,221,142,36,16,56,25,1
34285,1312,484,828,258,239,86,51,792,399,393,96,103,85,37,1
34286,1154,540,614,195,160,138,66,225,116,109,29,19,25,6,1
34287,475,268,207,61,27,56,30,211,88,123,38,28,26,10,1
34288,800,416,384,102,105,83,22,249,114,135,47,33,25,4,1
34289,480,232,248,83,64,51,25,756,348,408,101,103,60,40,1
34290,1084,537,547,154,121,92,35,473,217,256,59,44,34,21,1
34291,885,424,461,143,114,92,32,1222,648,574,138,139,132,38,1
34292,894,479,415,117,93,119,38,1141,582,559,162,151,76,34,1
34293,430,192,238,62,67,27,10,538,252,286,77,87,53,30,1
34294,787,386,401,98,95,86,25,778,367,411,90,85,64,43,1
34295,561,292,269,88,68,64,22,245,111,134,31,44,20,11,1
34296,453,255,198,62,49,29,19,391,165,226,56,104,38,12,1
34297,900,484,416,119,110,77,29,151,78,73,37,12,15,2,1
34298,737,320,417,112,94,73,34,541,269,272,75,57,59,36,1
34299,345,203,142,47,35,31,11,969,505,464,123,133,92,33,1
34300,2406,1132,1274,362,272,192,66,501,240,261,80,62,49,42,1
34301,73,29,44,15,16,3,4,873,366,507,127,125,75,21,1
34302,480,234,246,79,77,65,23,847,467,380,117,101,67,24,1
34303,1483,613,870,257,150,132,71,1270,557,713,130,195,57,30,1
34304,760,391,369,101,109,65,24,149,68,81,15,38,11,10,1
34305,366,183,183,48,47,36,17,348,173,175,46,34,45,15,1
34306,651,331,320,93,93,51,28,215,91,124,23,39,5,5,1
34307,211,114,97,32,24,19,10,770,374,396,95,91,79,41,1
34308,769,405,364,97,101,49,35,516,245,271,82,84,70,26,1
34309,424,198,226,57,46,41,19,298,167,131,47,33,40,8,1
34310,308,159,149,52,41,22,10,149,68,81,15,38,11,10,1
34311,656,358,298,67,47,64,26,361,155,206,43,61,29,18,1
34312,2639,1436,1203,317,307,242,77,919,502,417,121,100,116,48,1
34313,247,110,137,34,45,23,10,2382,1161,1221,237,220,140,50,1
34314,362,174,188,46,55,35,23,441,216,225,57,66,57,19,1
34315,350,181,169,44,52,43,13,496,272,224,70,58,42,18,1
34316,894,492,402,95,103,88,42,380,184,196,58,52,46,8,1
34317,344,201,143,42,39,41,14,706,354,352,82,61,32,30,1
34318,350,180,170,64,46,55,12,390,191,199,66,49,43,12,1
34319,2490,1126,1364,352,325,219,89,245,112,133,32,45,20,10,1
34320,710,361,349,81,98,63,26,770,355,415,103,142,75,42,1
34321,771,321,450,151,135,43,15,72,35,37,10,9,7,6,1
34322,714,282,432,119,128,69,15,202,102,100,29,35,6,9,1
34323,336,154,182,51,48,39,22,1302,637,665,162,150,125,61,1
34324,374,201,173,51,34,53,24,248,119,129,33,48,20,10,1
34325,280,142,138,35,37,22,13,221,75,146,68,21,16,5,1
34326,144,67,77,28,14,9,8,504,265,239,71,57,40,38,1
34327,815,418,397,97,62,70,17,340,205,135,34,21,35,25,1
34328,1190,638,552,162,95,112,18,304,127,177,61,38,31,4,1
34329,702,358,344,113,87,81,30,359,219,140,42,19,56,19,1
34330,673,313,360,101,101,46,17,203,120,83,27,17,24,12,1
34331,834,405,429,112,95,84,34,1009,506,503,146,141,97,55,1
34332,415,217,198,49,51,50,23,2335,1200,1135,374,268,340,83,1
34333,2663,1073,1590,548,499,192,64,1084,537,547,154,121,92,35,1
34334,445,230,215,64,62,50,20,212,107,105,29,26,25,8,1
34335,338,188,150,45,41,31,18,192,104,88,24,14,24,14,1
34336,418,180,238,76,64,54,34,976,496,480,128,111,121,48,1
34337,823,438,385,97,88,108,32,767,392,375,113,112,83,13,1
34338,419,175,244,71,73,23,23,2442,1193,1249,278,183,170,145,1
34339,1464,693,771,153,136,91,86,411,171,240,61,81,30,15,1
34340,1216,552,664,194,189,110,49,1447,698,749,214,180,116,46,1
34341,707,391,316,111,80,54,30,471,221,250,87,68,42,25,1
34342,961,485,476,147,130,83,37,191,99,92,25,24,18,8,1
34343,465,228,237,64,42,63,24,222,105,117,37,44,6,18,1
34344,427,218,209,61,53,45,26,778,367,411,90,85,64,43,1
34345,748,355,393,121,91,95,26,425,210,215,56,43,52,25,1
34346,1455,765,690,189,162,166,66,374,202,172,58,40,41,7,1
34347,364,185,179,58,53,48,15,155,74,81,23,19,20,5,1
34348,770,355,415,103,142,75,42,427,214,213,65,58,26,18,1
34349,1132,553,579,172,143,150,57,337,189,148,30,32,45,11,1
34350,495,233,262,64,39,49,32,359,157,202,44,34,31,17,1
34351,391,203,188,49,34,36,9,2442,1193,1249,278,183,170,145,1
34352,1043,633,410,140,92,102,31,767,392,375,113,112,83,13,1
34353,504,255,249,56,59,45,13,522,235,287,78,67,60,50,1
34354,521,267,254,53,68,39,15,452,239,213,62,46,38,22,1
34355,245,137,108,34,30,19,10,1272,520,752,235,242,117,54,1
34356,546,267,279,90,69,56,19,577,342,235,63,57,23,37,1
34357,461,257,204,48,37,78,28,175,101,74,20,20,20,9,1
34358,648,307,341,101,58,76,34,509,262,247,64,70,64,20,1
34359,440,218,222,58,66,40,24,712,396,316,78,69,65,25,1
34360,307,162,145,38,46,41,15,1227,545,682,218,202,121,49,1
34361,105,53,52,23,11,12,6,184,91,93,25,25,11,9,1
34362,335,177,158,45,49,34,13,201,42,159,19,3,2,75,1
34363,502,299,203,57,52,32,11,191,85,106,24,34,19,5,1
34364,356,185,171,37,31,17,21,395,222,173,48,42,21,8,1
34365,297,158,139,47,37,37,9,647,322,325,104,98,54,14,1
34366,382,183,199,55,60,38,22,879,466,413,103,85,111,54,1
34367,391,220,171,49,37,32,14,318,145,173,29,38,34,22,1
34368,370,197,173,63,40,40,23,374,227,147,44,22,54,20,1
34369,1698,875,823,222,219,173,64,163,71,92,22,38,11,7,1
34370,275,140,135,34,24,32,15,586,254,332,114,111,55,17,1
34371,1150,506,644,154,176,124,52,722,344,378,126,71,46,42,1
34372,985,551,434,123,93,91,26,647,322,325,104,98,54,14,1
34373,271,110,161,33,27,11,8,1863,721,1142,262,283,139,74,1
34374,914,453,461,112,115,79,29,183,91,92,21,29,16,10,1
34375,954,521,433,135,118,78,26,526,254,272,44,43,49,13,1
34376,882,432,450,115,111,68,44,428,226,202,52,60,75,20,1
34377,911,423,488,140,150,102,32,1153,588,565,174,128,149,56,1
34378,505,286,219,54,51,64,27,498,278,220,55,42,63,26,1
34379,2768,1380,1388,280,294,291,161,223,127,96,25,23,33,4,1
34380,759,391,368,103,82,101,45,968,498,470,129,133,115,37,1
34381,457,228,229,64,36,52,21,2442,1193,1249,278,183,170,145,1
34382,560,254,306,78,67,75,47,1712,1175,537,179,142,113,46,1
34383,532,276,256,57,50,32,19,1152,586,566,131,112,117,42,1
34384,1124,615,509,157,125,128,52,1132,553,579,172,143,150,57,1
34385,1210,592,618,157,138,116,85,435,208,227,68,64,53,23,1
34386,411,224,187,50,43,54,19,1290,597,693,182,182,119,63,1
34387,418,199,219,55,44,22,15,140,81,59,16,15,15,12,1
34388,537,276,261,75,68,68,22,143,79,64,16,25,7,5,1
34389,540,257,283,81,63,57,24,557,240,317,97,74,68,37,1
34390,668,338,330,85,95,68,18,949,512,437,102,124,70,41,1
34391,462,261,201,69,52,48,12,176,106,70,30,15,18,5,1
34392,555,278,277,60,70,48,18,788,360,428,93,106,67,72,1
34393,267,147,120,37,28,35,12,304,127,177,61,38,31,4,1
34394,175,91,84,18,14,22,12,2477,1186,1291,256,271,249,90,1
34395,673,329,344,111,95,92,41,357,169,188,61,53,32,15,1
34396,672,334,338,110,93,91,41,763,361,402,103,144,78,45,1
34397,1722,774,948,199,192,158,167,2871,1218,1653,290,374,238,414,1
34398,482,284,198,63,49,40,13,320,163,157,44,44,26,15,1
34399,341,162,179,54,49,41,12,418,201,217,53,39,56,15,1
34400,2063,1024,1039,175,117,80,97,1368,742,626,179,129,189,73,1
34401,480,234,246,79,77,65,23,164,78,86,28,23,12,8,1
34402,818,357,461,122,136,54,25,536,278,258,72,63,62,20,1
34403,815,418,397,97,62,70,17,501,267,234,83,62,38,20,1
34404,619,289,330,67,77,36,19,928,442,486,139,118,91,43,1
34405,284,128,156,48,29,34,8,264,126,138,44,26,25,10,1
34406,358,170,188,54,55,20,10,973,497,476,131,108,126,49,1
34407,424,198,226,57,46,41,19,229,105,124,36,33,12,4,1
34408,246,108,138,32,44,21,10,1075,594,481,132,108,101,42,1
34409,1106,579,527,121,152,113,45,537,276,261,75,68,68,22,1
34410,656,358,298,67,47,64,26,107,58,49,14,16,14,4,1
34411,208,110,98,32,25,28,4,806,436,370,101,100,76,34,1
34412,190,96,94,21,17,23,10,402,270,132,46,9,33,18,1
34413,598,278,320,95,66,48,24,482,231,251,76,81,64,26,1
34414,425,244,181,38,26,60,26,355,165,190,53,56,42,19,1
34415,1455,760,695,205,191,124,40,1190,638,552,162,95,112,18,1
34416,1154,540,614,195,160,138,66,1089,544,545,138,160,117,43,1
34417,435,254,181,52,46,48,14,697,373,324,105,83,95,38,1
34418,417,182,235,57,109,50,8,4563,2219,2344,620,531,527,104,1
34419,890,512,378,92,95,75,41,543,287,256,71,66,64,23,1
34420,1907,1008,899,235,224,195,73,802,388,414,101,93,88,35,1
34421,173,90,83,30,19,19,11,451,238,213,53,64,56,22,1
34422,536,278,258,72,63,62,20,675,311,364,111,80,96,30,1
34423,146,75,71,13,32,15,11,423,218,205,64,55,54,15,1
34424,560,260,300,100,58,29,28,261,130,131,27,41,19,16,1
34425,441,189,252,73,50,47,23,423,218,205,64,55,54,15,1
34426,211,114,97,32,24,19,10,1591,704,887,253,227,156,50,1
34427,360,188,172,49,48,47,17,504,259,245,73,56,45,29,1
34428,979,492,487,120,122,89,51,709,294,415,132,123,76,23,1
34429,1328,648,680,220,151,112,40,640,279,361,102,83,69,21,1
34430,720,356,364,90,98,61,22,193,99,94,31,31,16,12,1
34431,951,506,445,107,118,79,40,984,516,468,78,45,73,12,1
34432,832,428,404,131,89,88,38,179,90,89,26,9,16,6,1
34433,1721,838,883,241,218,144,54,1215,652,563,129,142,121,62,1
34434,1058,558,500,132,127,121,53,824,397,427,113,95,82,33,1
34435,619,332,287,95,77,74,38,631,261,370,110,109,50,26,1
34436,1150,506,644,154,176,124,52,499,252,247,75,71,65,25,1
34437,217,109,108,34,32,35,7,591,319,272,96,62,43,19,1
34438,659,325,334,102,85,87,32,805,382,423,109,118,77,33,1
34439,755,348,407,109,98,49,23,395,222,173,48,42,21,8,1
34440,1007,353,654,277,147,70,26,247,110,137,34,45,23,10,1
34441,919,538,381,111,98,103,41,211,88,123,38,28,26,10,1
34442,364,168,196,64,61,27,6,202,102,100,29,35,6,9,1
34443,1094,508,586,152,151,77,36,1675,875,800,213,219,196,72,1
34444,969,505,464,123,133,92,33,280,164,116,46,21,19,9,1
34445,835,420,415,104,105,57,47,778,367,411,90,85,64,43,1
34446,355,179,176,51,45,45,11,324,154,170,57,40,26,4,1
34447,613,354,259,72,72,61,19,767,392,375,113,112,83,13,1
34448,391,208,183,65,49,57,17,149,52,97,36,36,7,4,1
34449,168,67,101,37,17,13,13,392,115,277,117,75,28,17,1
34450,206,86,120,40,13,23,14,396,192,204,71,41,51,15,1
34451,425,198,227,57,69,59,13,928,442,486,139,118,91,43,1
34452,966,416,550,152,134,98,42,711,344,367,87,109,74,24,1
34453,297,158,139,47,37,37,9,1130,538,592,158,118,113,44,1
34454,76,42,34,12,8,5,7,193,89,104,25,22,19,12,1
34455,714,260,454,140,97,120,54,928,442,486,139,118,91,43,1
34456,464,242,222,61,68,36,17,707,422,285,84,82,59,13,1
34457,1238,596,642,148,147,126,136,330,143,187,63,29,52,20,1
34458,267,159,108,31,13,22,15,304,135,169,48,36,38,26,1
34459,1863,721,1142,262,283,139,74,316,141,175,48,46,34,16,1
34460,782,347,435,110,92,74,34,450,229,221,49,63,54,27,1
34461,1271,599,672,194,175,118,47,240,125,115,34,32,30,8,1
34462,751,312,439,131,115,78,48,598,300,298,68,77,59,21,1
34463,257,148,109,28,20,21,14,505,247,258,72,71,60,27,1
34464,683,365,318,89,69,56,25,1464,987,477,137,141,55,31,1
34465,561,255,306,95,67,44,17,1242,613,629,174,113,114,53,1
34466,538,252,286,77,87,53,30,906,485,421,112,98,112,39,1
34467,331,169,162,40,28,22,14,671,303,368,93,68,61,26,1
34468,108,55,53,19,7,11,2,654,344,310,80,69,57,15,1
34469,540,269,271,51,70,43,26,1132,553,579,172,143,150,57,1
34470,292,153,139,39,33,24,21,351,143,208,44,68,23,18,1
34471,592,291,301,92,93,71,31,215,115,100,27,28,34,16,1
34472,209,96,113,35,28,22,13,859,429,430,126,115,64,33,1
34473,450,229,221,49,63,54,27,117,62,55,24,18,21,2,1
34474,953,377,576,203,197,65,29,595,316,279,86,60,65,40,1
34475,624,308,316,92,72,68,22,271,131,140,55,17,30,16,1
34476,744,385,359,125,89,90,23,598,301,297,76,53,71,36,1
34477,101,41,60,18,19,10,5,1621,750,871,276,243,162,51,1
34478,1162,528,634,193,161,107,74,136,66,70,33,11,9,4,1
34479,919,538,381,111,98,103,41,1487,996,491,147,141,50,35,1
34480,1332,626,706,182,144,80,41,1233,721,512,148,98,144,52,1
34481,132,62,70,21,20,11,7,466,186,280,71,84,30,11,1
34482,552,264,288,82,64,48,20,722,384,338,94,83,63,35,1
34483,657,287,370,86,108,66,28,928,442,486,139,118,91,43,1
34484,832,428,404,131,89,88,38,325,152,173,43,47,28,17,1
34485,105,51,54,13,17,12,8,778,367,411,90,85,64,43,1
34486,1362,633,729,220,150,93,43,664,297,367,88,86,55,47,1
34487,347,181,166,27,20,12,12,743,366,377,41,37,26,14,1
34488,770,390,380,104,76,78,32,653,389,264,69,59,51,19,1
34489,24,14,10,4,2,1,2,241,124,117,25,35,21,12,1
34490,498,263,235,59,63,36,10,552,264,288,82,64,48,20,1
34491,966,459,507,123,145,83,39,307,154,153,39,36,31,12,1
34492,114,48,66,22,20,15,7,93,45,48,19,15,14,3,1
34493,459,229,230,78,65,59,26,264,121,143,57,32,22,15,1
34494,536,278,258,72,63,62,20,556,279,277,83,69,71,19,1
34495,199,101,98,22,25,9,12,173,104,69,18,20,18,9,1
34496,360,181,179,40,54,25,18,680,239,441,162,73,105,49,1
34497,350,168,182,59,50,42,15,503,263,240,72,55,51,34,1
34498,360,161,199,72,36,35,13,164,88,76,27,20,17,6,1
34499,537,276,261,75,68,68,22,297,158,139,47,37,37,9,1
34500,3969,1703,2266,619,432,259,144,334,155,179,47,34,38,11,1
34501,501,240,261,80,62,49,42,1073,432,641,179,133,121,54,1
34502,479,227,252,65,79,42,26,577,241,336,112,109,47,21,1
34503,928,442,486,139,118,91,43,215,80,135,54,56,21,9,1
34504,200,90,110,22,29,10,13,191,92,99,25,33,22,12,1
34505,309,137,172,51,50,28,14,595,316,279,86,60,65,40,1
34506,160,91,69,13,28,11,13,233,121,112,24,31,30,7,1
34507,1356,672,684,171,172,134,59,537,276,261,75,68,68,22,1
34508,280,142,138,35,37,22,13,437,167,270,126,95,34,10,1
34509,582,328,254,78,48,35,9,298,129,169,51,40,29,8,1
34510,250,137,113,33,19,24,9,335,128,207,59,43,24,23,1
34511,303,141,162,42,57,37,20,201,98,103,26,35,16,5,1
34512,684,311,373,109,99,66,16,396,223,173,57,37,44,19,1
34513,377,211,166,45,46,51,20,604,255,349,100,72,55,26,1
34514,379,203,176,55,48,45,16,724,261,463,135,139,39,20,1
34515,1100,474,626,197,143,126,41,975,417,558,161,126,96,44,1
34516,1210,601,609,126,80,120,39,324,190,134,41,27,28,9,1
34517,355,214,141,43,29,63,13,92,49,43,7,8,10,9,1
34518,767,392,375,113,112,83,13,918,490,428,114,100,115,41,1
34519,462,251,211,74,53,41,18,1134,539,595,150,146,78,40,1
34520,391,208,183,65,49,57,17,399,194,205,49,102,52,8,1
34521,603,311,292,102,71,66,23,586,270,316,83,80,59,21,1
34522,805,338,467,109,145,49,25,227,109,118,42,35,29,8,1
34523,527,245,282,87,62,65,16,385,194,191,49,50,40,12,1
34524,178,100,78,23,22,30,6,435,254,181,52,46,48,14,1
34525,557,245,312,81,96,72,48,153,81,72,22,18,16,8,1
34526,415,209,206,60,67,39,18,1255,666,589,145,142,120,82,1
34527,215,115,100,27,28,34,16,236,121,115,26,45,28,6,1
34528,2045,985,1060,359,339,199,74,559,317,242,58,65,37,23,1
34529,489,242,247,83,63,62,19,926,435,491,133,132,85,17,1
34530,351,184,167,59,45,54,9,557,268,289,66,67,70,17,1
34531,1441,657,784,140,135,81,73,468,233,235,65,61,49,34,1
34532,557,278,279,75,70,66,31,537,288,249,60,60,61,19,1
34533,1270,682,588,165,147,136,54,443,248,195,67,54,40,15,1
34534,751,312,439,131,115,78,48,406,207,199,56,46,68,19,1
34535,1123,554,569,142,130,85,36,246,108,138,32,44,21,10,1
34536,1074,538,536,154,140,111,51,1106,579,527,121,152,113,45,1
34537,260,136,124,24,41,19,4,1130,614,516,129,138,98,42,1
34538,220,143,77,15,10,20,16,1748,791,957,281,247,173,25,1
34539,700,305,395,111,99,54,18,1068,527,541,160,131,112,52,1
34540,1102,511,591,171,179,148,52,461,231,230,52,61,26,14,1
34541,588,255,333,94,82,58,27,715,322,393,105,82,77,51,1
34542,298,140,158,51,33,21,22,374,187,187,51,52,40,27,1
34543,148,78,70,21,11,14,11,1474,756,718,175,158,169,51,1
34544,425,210,215,56,43,52,25,614,305,309,96,73,65,24,1
34545,201,108,93,36,21,17,4,397,186,211,73,63,36,25,1
34546,368,201,167,61,38,38,12,2286,1154,1132,338,314,278,103,1
34547,1102,511,591,171,179,148,52,1606,753,853,215,227,182,48,1
34548,651,311,340,94,75,59,22,200,91,109,23,35,13,7,1
34549,437,221,216,62,64,47,13,624,323,301,76,67,74,48,1
34550,3664,1638,2026,598,519,231,63,500,244,256,66,57,52,27,1
34551,350,181,169,44,52,43,13,426,228,198,62,42,47,22,1
34552,459,212,247,63,48,48,28,2063,1024,1039,175,117,80,97,1
34553,577,241,336,112,109,47,21,1257,647,610,156,146,145,35,1
34554,624,308,316,92,72,68,22,1009,506,503,146,141,97,55,1
34555,158,85,73,24,18,18,8,318,164,154,52,43,34,10,1
34556,975,417,558,161,126,96,44,590,279,311,103,83,69,30,1
34557,279,161,118,37,32,7,7,670,333,337,95,79,62,21,1
34558,588,266,322,99,79,87,28,339,170,169,32,17,24,13,1
34559,535,217,318,87,106,41,14,295,135,160,48,43,29,11,1
34560,1084,537,547,154,121,92,35,507,242,265,53,44,31,22,1
34561,822,417,405,111,127,76,34,85,34,51,17,17,4,2,1
34562,671,321,350,95,87,75,34,416,201,215,54,52,39,25,1
34563,191,91,100,28,33,23,12,622,328,294,75,42,67,31,1
34564,362,233,129,37,17,51,18,245,111,134,31,44,20,11,1
34565,2442,1193,1249,278,183,170,145,506,254,252,57,82,41,17,1
34566,406,211,195,55,37,47,16,582,189,393,117,66,66,6,1
34567,1465,716,749,213,205,172,55,33423,16370,17053,4965,4756,2786,883,1
34568,815,478,337,104,80,103,27,246,115,131,15,29,10,32,1
34569,406,202,204,54,54,41,16,344,151,193,59,51,30,9,1
34570,137,60,77,37,4,10,6,577,288,289,85,56,40,20,1
34571,473,224,249,82,63,48,24,725,339,386,112,122,93,32,1
34572,347,181,166,27,20,12,12,585,299,286,92,73,89,23,1
34573,856,429,427,113,105,96,24,626,272,354,96,80,71,36,1
34574,583,322,261,73,66,45,26,481,256,225,60,56,48,12,1
34575,95,44,51,14,13,7,4,360,180,180,57,48,39,12,1
34576,796,445,351,96,80,90,38,1047,562,485,141,127,114,41,1
34577,1024,587,437,122,126,84,27,433,221,212,59,42,47,14,1
34578,462,228,234,59,47,37,32,787,386,401,98,95,86,25,1
34579,1384,769,615,178,141,219,56,1997,972,1025,262,209,239,52,1
34580,429,219,210,46,66,42,17,534,266,268,86,62,37,14,1
34581,835,420,415,104,105,57,47,2045,985,1060,359,339,199,74,1
34582,854,380,474,137,159,81,31,672,334,338,110,93,91,41,1
34583,631,315,316,64,57,49,15,609,279,330,103,98,72,42,1
34584,1273,592,681,199,164,139,39,604,255,349,100,72,55,26,1
34585,853,400,453,137,109,88,42,1616,735,881,285,248,153,72,1
34586,305,161,144,39,40,44,17,503,263,240,72,55,51,34,1
34587,257,176,81,21,11,44,12,709,373,336,73,72,78,24,1
34588,543,274,269,85,56,34,19,351,183,168,50,46,37,16,1
34589,501,240,261,80,62,49,42,452,256,196,32,44,27,11,1
34590,832,428,404,131,89,88,38,288,140,148,59,33,27,12,1
34591,379,203,176,55,48,45,16,416,210,206,55,54,39,20,1
34592,207,93,114,20,33,19,10,2414,1189,1225,277,178,170,169,1
34593,394,202,192,44,43,38,28,908,489,419,114,131,79,46,1
34594,117,62,55,24,18,21,2,233,120,113,38,32,20,15,1
34595,509,262,247,64,70,64,20,223,132,91,18,16,27,17,1
34596,595,316,279,86,60,65,40,785,374,411,56,42,38,25,1
34597,467,226,241,55,48,54,23,824,392,432,106,89,88,32,1
34598,359,184,175,49,35,32,11,1464,987,477,137,141,55,31,1
34599,708,306,402,116,118,44,41,983,487,496,126,115,104,52,1
34600,1395,627,768,172,263,141,59,593,265,328,107,71,65,32,1
34601,219,116,103,36,31,27,9,101,68,33,9,6,23,2,1
34602,440,214,226,59,62,27,28,386,180,206,47,45,21,23,1
34603,589,340,249,75,53,85,35,321,180,141,47,37,33,12,1
34604,4655,2074,2581,545,652,562,399,2040,956,1084,202,190,258,147,1
34605,874,431,443,112,120,79,50,446,246,200,46,32,53,25,1
34606,352,212,140,37,17,61,20,356,208,148,42,26,57,15,1
34607,855,422,433,109,97,109,50,728,343,385,116,82,96,57,1
34608,673,329,344,111,95,92,41,394,183,211,65,60,35,18,1
34609,91,50,41,12,5,10,7,310,156,154,27,43,20,6,1
34610,580,308,272,82,79,58,25,380,148,232,81,69,24,8,1
34611,375,173,202,50,46,43,25,624,222,402,92,81,39,15,1
34612,581,323,258,74,58,48,20,377,184,193,56,53,44,14,1
34613,183,95,88,27,22,26,5,480,234,246,79,77,65,23,1
34614,318,176,142,25,32,35,25,408,205,203,80,40,55,23,1
34615,508,215,293,72,71,42,15,596,286,310,90,89,78,37,1
34616,1050,482,568,136,154,101,41,2701,957,1744,504,525,160,95,1
34617,1290,629,661,191,187,167,55,509,262,247,64,70,64,20,1
34618,1039,597,442,101,110,106,33,1487,996,491,147,141,50,35,1
34619,220,126,94,29,12,34,11,728,385,343,110,102,69,14,1
34620,380,148,232,81,69,24,8,100,51,49,13,11,7,4,1
34621,185,70,115,37,48,15,5,179,87,92,25,21,22,11,1
34622,475,203,272,90,58,50,16,652,329,323,65,70,51,50,1
34623,339,183,156,43,45,28,17,1863,721,1142,262,283,139,74,1
34624,565,294,271,61,67,39,25,757,359,398,109,127,80,26,1
34625,720,356,364,90,98,61,22,388,205,183,50,47,37,10,1
34626,1132,553,579,172,143,150,57,1242,613,629,174,113,114,53,1
34627,543,246,297,99,93,50,29,854,380,474,137,159,81,31,1
34628,782,347,435,110,92,74,34,592,264,328,86,85,62,41,1
34629,459,221,238,72,78,47,16,594,296,298,73,81,57,27,1
34630,223,103,120,25,20,47,20,834,405,429,112,95,84,34,1
34631,707,295,412,105,105,66,30,467,269,198,46,51,60,18,1
34632,1130,639,491,87,188,57,41,777,387,390,90,87,65,37,1
34633,864,362,502,142,150,70,19,770,355,415,103,142,75,42,1
34634,810,367,443,115,92,94,59,97,50,47,17,14,14,10,1
34635,550,243,307,91,99,70,10,726,340,386,125,100,60,17,1
34636,314,158,156,41,57,30,12,822,416,406,111,105,84,44,1
34637,1566,743,823,261,188,151,48,459,238,221,49,37,67,28,1
34638,490,198,292,65,81,39,27,246,108,138,32,44,21,10,1
34639,512,216,296,92,68,51,19,247,110,137,34,45,23,10,1
34640,335,143,192,45,36,32,37,825,363,462,97,105,72,75,1
34641,327,177,150,40,40,38,18,406,202,204,54,54,41,16,1
34642,986,465,521,152,132,138,51,1464,987,477,137,141,55,31,1
34643,754,288,466,153,88,110,41,643,373,270,91,43,113,21,1
34644,766,370,396,100,104,80,45,745,354,391,116,100,95,46,1
34645,2944,1827,1117,338,332,122,35,423,193,230,60,45,32,35,1
34646,160,67,93,32,37,15,9,1647,794,853,279,235,128,65,1
34647,359,198,161,51,28,54,13,299,140,159,27,59,20,18,1
34648,635,333,302,99,75,83,28,431,204,227,59,72,41,12,1
34649,1132,553,579,172,143,150,57,504,245,259,64,54,42,14,1
34650,432,188,244,76,81,26,13,519,246,273,78,82,42,16,1
34651,80,44,36,4,1,4,2,529,283,246,66,69,66,25,1
34652,92,40,52,14,23,13,7,432,188,244,76,81,26,13,1
34653,379,203,176,55,48,45,16,1447,751,696,161,143,131,46,1
34654,462,251,211,74,53,41,18,306,155,151,43,34,36,17,1
34655,445,219,226,61,60,60,21,405,189,216,53,60,39,14,1
34656,605,285,320,89,61,68,26,719,301,418,122,132,42,26,1
34657,1271,599,672,194,175,118,47,467,250,217,59,52,41,19,1
34658,1691,1159,532,160,109,95,46,770,355,415,103,142,75,42,1
34659,553,261,292,73,79,40,26,648,307,341,101,58,76,34,1
34660,277,124,153,44,40,35,18,765,295,470,200,142,84,27,1
34661,432,228,204,59,53,43,15,164,78,86,28,23,12,8,1
34662,124,62,62,17,14,7,5,669,363,306,93,72,74,36,1
34663,672,334,338,110,93,91,41,475,247,228,62,45,75,24,1
34664,317,153,164,39,30,35,13,1367,690,677,172,175,154,83,1
34665,194,94,100,35,19,25,16,1464,987,477,137,141,55,31,1
34666,536,278,258,72,63,62,20,269,148,121,33,22,30,6,1
34667,513,176,337,101,90,31,25,1117,423,694,182,134,88,31,1
34668,1313,644,669,169,90,111,43,627,323,304,81,90,53,27,1
34669,380,187,193,38,51,30,18,480,252,228,55,37,49,20,1
34670,632,339,293,83,77,59,20,976,496,480,128,111,121,48,1
34671,301,124,177,45,62,23,8,1208,575,633,187,204,117,41,1
34672,663,338,325,68,71,41,16,424,198,226,57,46,41,19,1
34673,477,256,221,69,66,70,12,99,48,51,15,7,7,7,1
34674,418,199,219,55,44,22,15,508,267,241,57,49,40,13,1
34675,304,127,177,61,38,31,4,592,291,301,92,93,71,31,1
34676,639,368,271,72,51,38,38,574,277,297,88,77,58,36,1
34677,207,99,108,22,33,20,12,465,225,240,65,44,65,25,1
34678,653,298,355,70,101,64,39,220,102,118,26,32,27,10,1
34679,751,312,439,131,115,78,48,631,336,295,64,65,70,12,1
34680,292,154,138,46,29,41,7,598,300,298,68,77,59,21,1
34681,1597,731,866,212,223,131,46,1290,629,661,191,187,167,55,1
34682,278,111,167,66,66,19,8,673,313,360,101,101,46,17,1
34683,745,355,390,99,85,62,19,282,163,119,40,23,25,17,1
34684,198,89,109,32,36,14,9,181,101,80,30,18,22,11,1
34685,231,126,105,37,26,29,6,140,86,54,17,6,20,7,1
34686,281,132,149,38,32,38,14,367,161,206,70,48,41,19,1
34687,361,172,189,51,54,25,4,1433,675,758,171,176,149,47,1
34688,938,484,454,137,100,104,41,987,535,452,124,110,101,45,1
34689,196,107,89,20,31,17,4,703,356,347,96,97,38,22,1
34690,499,298,201,55,52,37,15,432,217,215,52,49,34,16,1
34691,2414,1189,1225,277,178,170,169,516,298,218,62,57,49,19,1
34692,372,201,171,52,50,42,13,725,339,386,112,122,93,32,1
34693,656,358,298,67,47,64,26,130,69,61,26,12,14,7,1
34694,464,225,239,85,57,65,19,138,80,58,22,20,8,6,1
34695,738,400,338,102,98,109,25,1210,578,632,172,184,94,66,1
34696,298,167,131,47,33,40,8,313,178,135,43,18,35,6,1
34697,221,75,146,68,21,16,5,601,313,288,42,48,25,36,1
34698,168,67,101,37,17,13,13,525,299,226,54,54,51,19,1
34699,386,163,223,51,51,28,14,255,122,133,35,51,22,13,1
34700,446,221,225,50,44,45,22,920,492,428,100,92,88,49,1
34701,268,129,139,50,15,33,7,822,416,406,111,105,84,44,1
34702,2201,1053,1148,238,312,200,122,1210,592,618,157,138,116,85,1
34703,1271,599,672,194,175,118,47,782,372,410,127,111,89,36,1
34704,317,149,168,62,44,27,10,3418,1378,2040,515,464,318,121,1
34705,624,204,420,166,101,32,13,126,66,60,24,10,7,9,1
34706,1123,554,569,142,130,85,36,191,72,119,40,41,17,8,1
34707,2376,1263,1113,304,241,264,115,505,247,258,72,71,60,27,1
34708,326,181,145,50,31,28,24,503,263,240,72,55,51,34,1
34709,349,131,218,66,76,22,9,848,394,454,100,90,101,41,1
34710,741,387,354,118,104,90,27,393,210,183,55,50,34,19,1
34711,2985,1374,1611,450,433,312,111,974,509,465,136,121,122,40,1
34712,1190,638,552,162,95,112,18,827,446,381,111,88,81,45,1
34713,672,334,338,110,93,91,41,239,146,93,30,22,35,9,1
34714,243,140,103,31,27,25,5,636,380,256,59,60,65,24,1
34715,467,226,241,55,48,54,23,687,353,334,84,96,74,31,1
34716,580,339,241,72,47,66,21,347,133,214,64,60,29,9,1
34717,2639,1436,1203,317,307,242,77,798,378,420,99,94,71,63,1
34718,131,74,57,17,14,12,4,118,51,67,25,13,6,7,1
34719,372,187,185,55,36,45,21,151,75,76,21,22,9,5,1
34720,473,254,219,66,67,41,16,1084,537,547,154,121,92,35,1
34721,2321,1177,1144,236,255,174,254,1156,519,637,104,62,66,45,1
34722,767,392,375,113,112,83,13,367,195,172,57,54,43,16,1
34723,135,69,66,21,14,11,5,465,279,186,48,24,70,25,1
34724,275,125,150,37,48,27,7,224,108,116,31,32,22,8,1
34725,538,293,245,48,66,45,16,1834,823,1011,297,282,151,63,1
34726,456,228,228,49,70,32,19,146,75,71,13,32,15,11,1
34727,561,343,218,53,63,37,15,671,326,345,111,77,74,11,1
34728,1321,653,668,186,195,70,35,1858,805,1053,271,345,116,41,1
34729,201,92,109,27,29,27,8,446,265,181,51,35,27,17,1
34730,721,379,342,89,73,68,25,864,362,502,142,150,70,19,1
34731,160,67,93,32,37,15,9,119,54,65,26,14,6,5,1
34732,424,284,140,51,28,47,20,368,201,167,61,38,38,12,1
34733,1360,600,760,233,199,123,40,501,240,261,80,62,49,42,1
34734,789,376,413,101,116,66,40,738,358,380,106,99,62,25,1
34735,1462,652,810,243,199,115,30,468,242,226,58,42,49,19,1
34736,755,348,407,109,98,49,23,346,180,166,55,49,38,6,1
34737,624,204,420,166,101,32,13,164,61,103,47,19,14,5,1
34738,168,67,101,37,17,13,13,570,284,286,68,52,46,34,1
34739,621,284,337,108,68,50,17,393,186,207,58,50,36,22,1
34740,409,200,209,69,56,44,13,301,150,151,41,30,17,11,1
34741,275,125,150,37,48,27,7,769,329,440,116,66,55,22,1
34742,1074,538,536,154,140,111,51,583,322,261,73,66,45,26,1
34743,639,397,242,64,37,64,30,301,149,152,40,39,34,10,1
34744,427,214,213,65,58,26,18,322,180,142,45,38,28,7,1
34745,227,124,103,33,21,16,19,426,228,198,62,42,47,22,1
34746,1120,436,684,208,120,101,115,380,191,189,45,29,34,17,1
34747,727,294,433,143,118,69,50,324,154,170,57,40,26,4,1
34748,737,363,374,119,101,85,41,360,192,168,55,45,48,16,1
34749,512,269,243,69,70,62,29,375,183,192,52,48,39,23,1
34750,580,385,195,36,42,82,23,340,158,182,51,56,9,7,1
34751,484,223,261,76,70,47,12,2138,1161,977,258,229,249,95,1
34752,2549,1331,1218,366,296,271,130,525,274,251,82,74,60,25,1
34753,639,287,352,111,108,44,9,218,108,110,28,28,22,10,1
34754,472,259,213,51,44,56,21,1464,987,477,137,141,55,31,1
34755,427,164,263,62,80,14,10,418,213,205,54,70,38,18,1
34756,1185,585,600,180,174,113,58,334,171,163,48,42,32,18,1
34757,594,305,289,86,63,51,21,796,445,351,96,80,90,38,1
34758,620,324,296,81,68,66,31,3418,1378,2040,515,464,318,121,1
34759,433,245,188,54,37,38,11,796,445,351,96,80,90,38,1
34760,1163,493,670,214,158,106,42,246,113,133,33,45,22,10,1
34761,548,250,298,85,64,56,21,904,436,468,138,146,82,39,1
34762,226,100,126,32,33,21,11,1117,423,694,182,134,88,31,1
34763,462,233,229,66,49,43,30,423,222,201,51,33,41,28,1
34764,290,127,163,47,58,23,12,854,380,474,137,159,81,31,1
34765,686,375,311,89,80,63,20,95,47,48,13,12,10,4,1
34766,538,252,286,77,87,53,30,781,418,363,92,90,64,41,1
34767,211,99,112,34,43,10,6,493,275,218,64,36,49,30,1
34768,515,250,265,67,60,58,29,390,207,183,50,48,38,15,1
34769,402,169,233,70,36,34,18,1210,578,632,172,184,94,66,1
34770,360,188,172,49,48,47,17,595,316,279,86,60,65,40,1
34771,450,229,221,49,63,54,27,1821,809,1012,317,235,180,69,1
34772,351,166,185,48,61,24,15,854,399,455,127,118,57,39,1
34773,951,506,445,107,118,79,40,308,146,162,42,39,24,12,1
34774,359,200,159,49,37,47,17,331,180,151,46,35,47,17,1
34775,750,347,403,105,103,83,29,317,153,164,39,30,35,13,1
34776,247,110,137,34,45,23,10,1591,704,887,253,227,156,50,1
34777,198,80,118,35,31,14,7,292,152,140,46,38,35,12,1
34778,599,310,289,45,32,43,10,522,265,257,35,39,38,8,1
34779,446,246,200,64,48,54,12,505,239,266,71,55,50,18,1
34780,426,231,195,51,52,45,24,440,246,194,62,49,41,16,1
34781,1117,556,561,188,117,110,48,189,90,99,26,29,17,11,1
34782,205,94,111,29,31,16,7,327,177,150,40,40,38,18,1
34783,991,537,454,134,99,80,34,428,226,202,52,60,75,20,1
34784,458,248,210,69,52,52,19,3144,1617,1527,367,342,278,136,1
34785,422,213,209,63,60,35,13,367,161,206,70,48,41,19,1
34786,590,306,284,69,82,68,27,282,154,128,43,32,22,15,1
34787,1047,562,485,141,127,114,41,583,322,261,73,66,45,26,1
34788,694,360,334,90,88,77,32,158,85,73,24,18,18,8,1
34789,406,211,195,55,37,47,16,261,144,117,34,22,31,15,1
34790,537,276,261,75,68,68,22,335,172,163,40,29,31,15,1
34791,1353,661,692,192,197,139,63,392,115,277,117,75,28,17,1
34792,174,79,95,36,37,18,6,483,155,328,138,109,32,9,1
34793,183,76,107,38,24,19,6,392,156,236,40,91,28,16,1
34794,770,385,385,78,83,60,16,592,264,328,86,85,62,41,1
34795,293,142,151,49,40,42,17,315,150,165,49,59,23,15,1
34796,473,224,249,82,63,48,24,205,106,99,28,26,23,3,1
34797,832,428,404,131,89,88,38,500,244,256,66,57,52,27,1
34798,111,29,82,10,54,0,1,298,167,131,47,33,40,8,1
34799,770,390,380,104,76,78,32,99,34,65,12,1,2,18,1
34800,422,211,211,73,61,43,17,155,74,81,23,19,20,5,1
34801,306,128,178,49,59,17,9,413,183,230,69,55,37,18,1
34802,684,288,396,107,90,54,42,373,189,184,54,46,50,23,1
34803,112,59,53,17,8,12,8,362,225,137,43,22,30,11,1
34804,171,94,77,24,28,30,11,1290,597,693,182,182,119,63,1
34805,909,455,454,137,82,85,68,543,287,256,71,66,64,23,1
34806,873,366,507,127,125,75,21,274,158,116,27,27,22,18,1
34807,2644,1346,1298,391,304,315,148,754,318,436,114,106,58,28,1
34808,437,235,202,72,61,39,17,964,408,556,131,153,76,55,1
34809,489,253,236,73,36,62,17,365,222,143,44,24,35,11,1
34810,740,404,336,113,77,87,34,745,432,313,104,75,79,26,1
34811,673,391,282,70,57,40,25,442,208,234,68,49,51,25,1
34812,511,257,254,79,67,43,23,470,205,265,71,80,33,11,1
34813,398,216,182,52,33,40,15,1669,1162,507,154,128,86,51,1
34814,1770,759,1011,237,271,163,74,2414,1189,1225,277,178,170,169,1
34815,437,225,212,36,34,32,39,402,227,175,48,40,35,11,1
34816,625,316,309,77,79,54,34,189,90,99,26,29,17,11,1
34817,297,158,139,47,37,37,9,589,281,308,69,39,63,20,1
34818,467,269,198,46,51,60,18,2471,1130,1341,240,281,219,290,1
34819,785,419,366,105,90,64,31,157,79,78,24,26,19,7,1
34820,298,167,131,47,33,40,8,620,258,362,106,100,47,28,1
34821,211,137,74,16,9,22,21,1748,791,957,281,247,173,25,1
34822,1115,589,526,142,108,136,50,1464,715,749,200,167,181,70,1
34823,490,198,292,65,81,39,27,247,110,137,34,45,23,10,1
34824,1395,627,768,172,263,141,59,413,227,186,45,34,58,23,1
34825,499,249,250,79,63,61,22,466,186,280,71,84,30,11,1
34826,826,362,464,107,118,71,43,331,169,162,40,28,22,14,1
34827,91,56,35,17,2,7,7,282,135,147,36,49,25,10,1
34828,333,171,162,41,44,48,23,1505,681,824,201,204,73,32,1
34829,871,437,434,112,113,83,49,446,246,200,46,32,53,25,1
34830,666,344,322,91,73,91,20,368,176,192,54,52,41,14,1
34831,800,416,384,102,105,83,22,677,361,316,81,61,42,22,1
34832,465,228,237,64,42,63,24,475,235,240,77,58,43,22,1
34833,293,142,151,49,40,42,17,2045,985,1060,359,339,199,74,1
34834,217,134,83,40,16,26,5,294,148,146,35,33,25,14,1
34835,961,463,498,139,156,62,34,104,48,56,15,15,13,7,1
34836,1849,931,918,245,220,158,90,400,221,179,51,42,38,16,1
34837,1113,520,593,168,139,109,49,448,236,212,53,64,56,24,1
34838,706,354,352,82,61,32,30,158,85,73,24,18,18,8,1
34839,616,304,312,75,71,55,25,904,436,468,138,146,82,39,1
34840,1591,704,887,253,227,156,50,536,278,258,72,63,62,20,1
34841,332,140,192,60,49,31,21,724,320,404,120,147,67,25,1
34842,864,429,435,129,118,68,35,368,170,198,59,64,29,13,1
34843,450,194,256,57,75,45,22,239,146,93,30,22,35,9,1
34844,467,226,241,55,48,54,23,589,314,275,70,83,44,28,1
34845,789,386,403,95,124,83,25,790,379,411,99,116,81,23,1
34846,1141,583,558,141,98,91,45,504,259,245,73,56,45,29,1
34847,1475,658,817,149,114,120,43,467,226,241,55,48,54,23,1
34848,351,184,167,59,45,54,9,700,335,365,83,84,95,33,1
34849,1100,474,626,197,143,126,41,1834,823,1011,297,282,151,63,1
34850,442,252,190,35,52,20,4,550,243,307,91,99,70,10,1
34851,160,67,93,32,37,15,9,140,86,54,17,6,20,7,1
34852,904,436,468,138,146,82,39,225,102,123,32,32,31,15,1
34853,416,198,218,58,65,38,14,990,410,580,140,175,44,36,1
34854,1203,462,741,215,230,40,22,299,153,146,32,28,29,12,1
34855,860,427,433,132,100,81,30,987,515,472,107,110,106,61,1
34856,368,158,210,64,61,39,14,769,329,440,116,66,55,22,1
34857,1893,764,1129,308,323,126,60,589,256,333,112,67,63,28,1
34858,1706,830,876,265,209,230,63,187,84,103,31,27,14,8,1
34859,466,242,224,66,53,53,13,436,201,235,54,37,34,20,1
34860,370,176,194,61,30,40,28,352,169,183,57,36,47,31,1
34861,522,265,257,35,39,38,8,1071,549,522,133,127,130,59,1
34862,582,330,252,82,69,87,21,310,156,154,27,43,20,6,1
34863,529,274,255,57,62,38,14,236,121,115,39,20,44,15,1
34864,115,55,60,25,14,7,7,392,156,236,40,91,28,16,1
34865,186,99,87,30,17,18,8,460,223,237,61,65,45,22,1
34866,350,180,170,64,46,55,12,454,191,263,61,66,38,15,1
34867,551,237,314,95,79,54,17,693,297,396,87,52,64,27,1
34868,458,245,213,52,43,27,24,201,42,159,19,3,2,75,1
34869,310,156,154,27,43,20,6,143,65,78,32,11,11,11,1
34870,158,85,73,24,18,18,8,640,279,361,102,83,69,21,1
34871,392,160,232,68,70,19,8,614,275,339,108,83,80,31,1
34872,245,112,133,32,45,20,10,1096,513,583,195,156,113,24,1
34873,351,163,188,54,61,21,7,284,109,175,55,79,9,9,1
34874,172,98,74,20,21,22,8,592,295,297,79,70,76,11,1
34875,648,307,341,101,58,76,34,854,380,474,137,159,81,31,1
34876,2040,956,1084,202,190,258,147,592,283,309,84,137,60,20,1
34877,247,127,120,43,20,27,14,590,298,292,73,45,71,25,1
34878,1719,754,965,277,258,158,80,166,83,83,24,30,18,7,1
34879,1464,693,771,153,136,91,86,401,226,175,53,18,38,20,1
34880,240,134,106,34,35,15,13,444,218,226,71,64,37,11,1
34881,465,225,240,65,44,65,25,440,218,222,58,66,40,24,1
34882,613,352,261,77,47,83,31,350,224,126,34,14,48,18,1
34883,706,370,336,86,79,78,43,1129,589,540,134,122,108,46,1
34884,826,362,464,107,118,71,43,482,231,251,76,81,64,26,1
34885,1140,495,645,129,95,128,159,985,546,439,120,113,80,39,1
34886,574,277,297,88,77,58,36,296,127,169,55,40,29,17,1
34887,350,181,169,44,52,43,13,92,46,46,14,9,8,6,1
34888,168,90,78,22,19,13,4,240,125,115,34,32,30,8,1
34889,868,448,420,108,103,76,25,1162,515,647,191,143,97,35,1
34890,822,424,398,107,106,86,46,1290,629,661,191,187,167,55,1
34891,501,273,228,70,59,30,10,359,213,146,44,40,35,20,1
34892,1278,593,685,198,201,71,43,671,318,353,83,124,46,34,1
34893,524,264,260,75,75,40,21,665,297,368,111,107,34,12,1
34894,728,288,440,117,137,46,34,560,228,332,113,58,79,38,1
34895,104,52,52,18,14,17,4,323,181,142,40,37,26,16,1
34896,998,532,466,113,109,97,53,537,276,261,75,68,68,22,1
34897,393,186,207,58,50,36,22,437,228,209,47,61,26,11,1
34898,378,154,224,74,84,35,22,305,168,137,48,35,40,9,1
34899,468,242,226,58,42,49,19,200,99,101,31,24,26,6,1
34900,423,247,176,58,55,29,20,798,287,511,126,125,77,26,1
34901,622,299,323,86,86,69,35,369,180,189,62,70,24,21,1
34902,770,356,414,123,102,66,25,173,88,85,20,21,9,12,1
34903,207,125,82,16,15,19,11,863,470,393,82,72,92,44,1
34904,427,236,191,49,54,46,13,510,264,246,67,66,38,29,1
34905,2468,1038,1430,333,465,167,62,240,99,141,53,38,29,15,1
34906,428,226,202,52,60,75,20,2440,1061,1379,377,326,172,62,1
34907,609,292,317,102,96,64,21,1217,566,651,215,170,102,23,1
34908,425,210,215,56,43,52,25,2639,1436,1203,317,307,242,77,1
34909,605,281,324,111,67,40,44,467,224,243,70,43,67,23,1
34910,467,226,241,55,48,54,23,467,224,243,70,43,67,23,1
34911,477,215,262,85,82,51,29,651,311,340,110,77,73,33,1
34912,917,443,474,126,115,125,41,455,218,237,57,51,42,35,1
34913,338,162,176,43,39,25,11,253,148,105,31,15,39,16,1
34914,648,307,341,101,58,76,34,239,146,93,30,22,35,9,1
34915,1361,709,652,207,147,202,55,1894,962,932,232,209,205,90,1
34916,403,185,218,67,62,63,19,1570,771,799,241,181,137,41,1
34917,591,263,328,95,90,26,13,769,405,364,97,101,49,35,1
34918,665,292,373,107,126,37,10,466,186,280,71,84,30,11,1
34919,536,278,258,72,63,62,20,976,496,480,128,111,121,48,1
34920,3623,1788,1835,325,354,507,198,91,45,46,9,11,3,9,1
34921,205,100,105,25,25,20,9,493,240,253,72,62,59,15,1
34922,379,203,176,55,48,45,16,565,291,274,61,80,59,31,1
34923,155,74,81,23,19,20,5,293,169,124,52,22,25,12,1
34924,384,238,146,38,26,66,19,91,50,41,12,5,10,7,1
34925,1657,800,857,249,235,154,51,149,68,81,15,38,11,10,1
34926,1214,573,641,184,152,101,66,279,135,144,40,52,40,5,1
34927,507,287,220,43,36,24,7,356,185,171,37,31,17,21,1
34928,335,148,187,52,26,51,12,201,42,159,19,3,2,75,1
34929,227,108,119,31,35,35,14,647,344,303,84,62,73,28,1
34930,557,282,275,77,61,68,23,292,150,142,31,43,39,16,1
34931,749,374,375,99,108,98,37,138,75,63,19,9,23,15,1
34932,639,287,352,111,108,44,9,906,455,451,116,105,87,46,1
34933,163,84,79,20,23,10,5,339,157,182,39,49,43,19,1
34934,317,153,164,39,30,35,13,479,233,246,68,66,36,21,1
34935,428,226,202,52,60,75,20,317,153,164,34,52,30,14,1
34936,595,316,279,86,60,65,40,1367,690,677,172,175,154,83,1
34937,109,50,59,20,7,10,9,392,156,236,40,91,28,16,1
34938,298,167,131,47,33,40,8,991,423,568,157,126,70,52,1
34939,293,134,159,40,27,23,30,522,235,287,78,67,60,50,1
34940,802,344,458,156,136,57,24,875,376,499,155,125,53,39,1
34941,423,212,211,51,44,48,28,393,186,207,58,50,36,22,1
34942,162,88,74,18,20,25,10,428,223,205,59,67,23,16,1
34943,360,188,172,49,48,47,17,492,280,212,56,61,30,13,1
34944,261,144,117,34,22,31,15,2477,1186,1291,256,271,249,90,1
34945,198,112,86,20,36,16,5,91,50,41,12,5,10,7,1
34946,142,76,66,22,14,19,3,147,86,61,23,15,22,4,1
34947,743,377,366,87,74,68,30,480,252,228,55,37,49,20,1
34948,501,240,261,80,62,49,42,455,218,237,57,51,42,35,1
34949,229,105,124,36,33,12,4,367,203,164,41,32,39,20,1
34950,491,283,208,55,61,40,13,557,349,208,52,43,79,29,1
34951,2045,985,1060,359,339,199,74,171,94,77,24,28,30,11,1
34952,457,220,237,78,79,45,23,854,380,474,137,159,81,31,1
34953,963,385,578,171,162,62,35,247,110,137,34,45,23,10,1
34954,960,409,551,166,134,77,44,603,311,292,102,71,66,23,1
34955,619,289,330,67,77,36,19,207,93,114,20,33,19,10,1
34956,629,301,328,65,69,77,27,1132,553,579,172,143,150,57,1
34957,683,365,318,89,69,56,25,2477,1186,1291,256,271,249,90,1
34958,294,126,168,56,30,29,19,894,469,425,127,93,82,31,1
34959,89,42,47,16,12,15,6,445,225,220,47,62,53,26,1
34960,716,354,362,102,87,77,30,314,158,156,39,28,30,17,1
34961,1948,1039,909,242,227,200,67,392,156,236,40,91,28,16,1
34962,562,265,297,79,56,72,45,357,169,188,61,53,32,15,1
34963,351,184,167,59,45,54,9,528,283,245,77,72,63,11,1
34964,697,373,324,105,83,95,38,382,200,182,53,36,51,16,1
34965,380,212,168,47,38,19,11,870,418,452,121,102,109,28,1
34966,504,237,267,62,66,48,17,406,216,190,59,56,45,15,1
34967,519,244,275,76,90,44,16,522,239,283,75,88,45,11,1
34968,418,220,198,69,51,44,16,228,139,89,24,21,32,18,1
34969,794,402,392,96,84,86,30,267,145,122,38,30,32,13,1
34970,322,150,172,43,27,25,33,626,357,269,81,61,51,26,1
34971,351,184,167,59,45,54,9,2871,1148,1723,496,469,204,98,1
34972,496,272,224,70,58,42,18,606,279,327,81,70,49,34,1
34973,589,294,295,37,44,27,33,405,202,203,47,55,50,14,1
34974,259,160,99,21,14,38,11,116,67,49,13,12,6,5,1
34975,476,199,277,82,80,49,24,597,293,304,99,81,68,34,1
34976,346,191,155,52,38,40,13,298,167,131,47,33,40,8,1
34977,391,189,202,55,56,56,12,810,367,443,115,92,94,59,1
34978,814,403,411,112,140,94,23,258,111,147,46,63,17,6,1
34979,1382,689,693,186,176,167,77,1338,756,582,155,105,104,44,1
34980,464,225,239,85,57,65,19,1016,501,515,109,71,76,37,1
34981,521,289,232,71,58,49,16,633,303,330,95,91,51,13,1
34982,609,292,317,102,96,64,21,1675,875,800,213,219,196,72,1
34983,548,292,256,67,65,68,26,684,288,396,107,90,54,42,1
34984,739,369,370,97,83,65,44,2639,1436,1203,317,307,242,77,1
34985,562,281,281,80,61,67,23,1353,661,692,192,197,139,63,1
34986,492,317,175,42,31,63,23,592,283,309,84,137,60,20,1
34987,292,152,140,46,38,35,12,536,278,258,72,63,62,20,1
34988,207,89,118,28,26,16,6,317,153,164,34,52,30,14,1
34989,928,442,486,139,118,91,43,882,432,450,115,111,68,44,1
34990,101,45,56,17,17,12,9,357,169,188,61,53,32,15,1
34991,400,208,192,61,51,36,16,603,291,312,98,87,61,28,1
34992,672,334,338,110,93,91,41,946,469,477,133,113,62,39,1
34993,512,248,264,66,71,49,30,632,326,306,92,71,56,19,1
34994,647,376,271,73,64,41,23,411,214,197,52,45,50,19,1
34995,498,263,235,59,63,36,10,1865,918,947,300,256,217,76,1
34996,529,274,255,57,62,38,14,579,321,258,74,70,47,22,1
34997,555,277,278,84,56,66,23,417,182,235,57,109,50,8,1
34998,178,89,89,26,21,21,10,498,263,235,59,63,36,10,1
34999,486,229,257,75,104,49,10,454,200,254,86,74,43,13,1
35000,853,401,452,121,118,74,38,404,197,207,57,69,33,15,1
35001,342,177,165,42,44,45,20,629,338,291,92,57,64,22,1
35002,77,36,41,18,7,13,9,671,318,353,83,124,46,34,1
35003,358,212,146,51,36,33,9,651,306,345,85,64,61,32,1
35004,1114,581,533,145,132,126,54,770,374,396,95,91,79,41,1
35005,1242,613,629,174,113,114,53,1620,884,736,194,161,162,80,1
35006,267,161,106,22,25,35,20,1066,587,479,127,108,118,48,1
35007,1925,1022,903,237,196,185,99,761,418,343,87,73,89,32,1
35008,1068,527,541,160,131,112,52,134,60,74,19,13,10,7,1
35009,168,67,101,37,17,13,13,1893,764,1129,308,323,126,60,1
35010,488,217,271,71,71,50,32,376,190,186,48,52,44,25,1
35011,560,279,281,113,64,58,15,406,212,194,50,52,24,18,1
35012,318,176,142,25,32,35,25,1023,527,496,148,122,132,46,1
35013,747,333,414,102,64,63,46,2871,1148,1723,496,469,204,98,1
35014,879,439,440,120,108,101,30,238,151,87,21,16,24,24,1
35015,794,434,360,122,87,61,23,1267,578,689,185,182,102,72,1
35016,203,109,94,56,14,22,6,401,167,234,56,71,16,10,1
35017,2442,1193,1249,278,183,170,145,251,139,112,41,18,27,11,1
35018,1190,537,653,207,186,101,26,1748,791,957,281,247,173,25,1
35019,467,226,241,55,48,54,23,4377,1898,2479,663,608,331,126,1
35020,272,173,99,32,32,11,8,235,119,116,31,26,15,13,1
35021,780,370,410,107,120,75,22,595,316,279,86,60,65,40,1
35022,376,203,173,57,52,48,11,2115,838,1277,346,354,90,48,1
35023,341,195,146,42,21,36,9,1544,738,806,239,217,145,91,1
35024,641,324,317,88,92,49,14,815,418,397,97,62,70,17,1
35025,673,329,344,111,95,92,41,770,385,385,78,83,60,16,1
35026,459,221,238,72,78,47,16,68,33,35,11,9,5,6,1
35027,258,111,147,46,63,17,6,313,157,156,39,26,34,29,1
35028,456,228,228,49,70,32,19,396,193,203,61,63,46,10,1
35029,440,255,185,67,28,24,6,1577,747,830,213,232,147,57,1
35030,299,158,141,45,31,21,5,1123,554,569,142,130,85,36,1
35031,1202,639,563,161,131,113,47,1123,554,569,142,130,85,36,1
35032,589,314,275,70,83,44,28,780,370,410,107,120,75,22,1
35033,272,173,99,32,32,11,8,227,127,100,32,24,31,5,1
35034,660,267,393,137,105,57,47,757,373,384,115,93,95,25,1
35035,419,175,244,71,73,23,23,356,199,157,43,58,29,12,1
35036,603,282,321,74,68,60,38,615,293,322,70,67,45,29,1
35037,280,142,138,35,37,22,13,475,235,240,77,58,43,22,1
35038,257,176,81,21,11,44,12,448,275,173,32,53,55,27,1
35039,1597,710,887,241,219,146,69,184,86,98,26,26,14,11,1
35040,656,358,298,67,47,64,26,258,129,129,45,24,31,10,1
35041,135,65,70,21,25,15,9,425,198,227,57,69,59,13,1
35042,645,297,348,89,105,74,24,96,45,51,13,12,6,4,1
35043,930,367,563,181,153,83,48,3144,1617,1527,367,342,278,136,1
35044,462,251,211,74,53,41,18,454,255,199,51,45,54,27,1
35045,136,65,71,33,11,9,6,294,122,172,46,65,18,11,1
35046,294,148,146,35,33,25,14,576,250,326,93,71,34,15,1
35047,147,68,79,31,23,8,4,415,203,212,77,44,49,18,1
35048,766,395,371,89,86,127,27,125,51,74,31,7,5,5,1
35049,217,94,123,29,30,23,17,354,166,188,53,55,40,19,1
35050,184,86,98,26,26,14,11,1047,562,485,141,127,114,41,1
35051,346,183,163,51,38,23,6,326,140,186,59,42,19,9,1
35052,3224,1440,1784,455,440,333,126,364,224,140,33,18,58,22,1
35053,990,410,580,140,175,44,36,212,107,105,29,26,25,8,1
35054,379,203,176,55,48,45,16,309,154,155,42,44,45,16,1
35055,379,203,176,55,48,45,16,149,52,97,36,36,7,4,1
35056,1217,647,570,142,160,129,45,247,110,137,34,45,23,10,1
35057,672,334,338,110,93,91,41,473,245,228,67,52,70,24,1
35058,99,55,44,9,10,7,9,139,73,66,26,13,9,9,1
35059,767,392,375,113,112,83,13,1233,721,512,148,98,144,52,1
35060,479,256,223,69,56,58,11,238,151,87,21,16,24,24,1
35061,164,78,86,28,23,12,8,230,119,111,30,29,26,12,1
35062,537,276,261,75,68,68,22,1484,731,753,206,175,187,71,1
35063,422,198,224,52,52,42,43,1290,597,693,182,182,119,63,1
35064,540,257,283,81,63,57,24,233,94,139,36,37,15,8,1
35065,1214,498,716,197,180,121,65,425,210,215,56,43,52,25,1
35066,272,173,99,32,32,11,8,293,153,140,45,38,22,15,1
35067,99,49,50,16,8,7,8,352,212,140,37,17,61,20,1
35068,977,406,571,151,128,84,47,975,417,558,161,126,96,44,1
35069,566,263,303,83,87,74,31,435,222,213,67,49,67,12,1
35070,686,375,311,89,80,63,20,432,218,214,57,55,42,11,1
35071,467,226,241,55,48,54,23,462,233,229,66,49,43,30,1
35072,462,251,211,74,53,41,18,72,35,37,10,9,7,6,1
35073,640,339,301,70,64,90,41,4377,1898,2479,663,608,331,126,1
35074,502,240,262,78,61,54,32,512,256,256,77,64,66,24,1
35075,461,223,238,66,57,36,23,418,163,255,57,54,38,24,1
35076,290,127,163,47,58,23,12,326,156,170,60,47,43,5,1
35077,465,228,237,64,42,63,24,552,285,267,74,51,69,24,1
35078,1190,638,552,162,95,112,18,4391,2256,2135,494,411,423,231,1
35079,743,346,397,91,90,62,10,304,159,145,38,40,32,3,1
35080,215,104,111,61,7,2,1,165,83,82,16,29,11,9,1
35081,288,159,129,27,44,27,15,496,295,201,57,42,52,19,1
35082,331,193,138,44,37,18,9,654,344,310,80,69,57,15,1
35083,605,295,310,74,66,70,36,593,266,327,102,84,69,24,1
35084,672,334,338,110,93,91,41,295,95,200,70,89,17,6,1
35085,2414,1189,1225,277,178,170,169,90,41,49,26,14,0,1,1
35086,92,40,52,14,23,13,7,90,46,44,14,15,8,3,1
35087,546,267,279,90,69,56,19,497,185,312,63,92,38,28,1
35088,480,257,223,74,26,60,27,882,432,450,115,111,68,44,1
35089,248,118,130,54,31,26,5,482,152,330,126,83,51,19,1
35090,178,100,78,23,22,30,6,563,299,264,78,79,68,26,1
35091,415,209,206,60,67,39,18,346,186,160,48,32,35,14,1
35092,196,105,91,22,26,21,8,391,208,183,65,49,57,17,1
35093,318,165,153,53,37,36,13,202,102,100,29,35,6,9,1
35094,264,122,142,33,29,13,13,316,157,159,45,38,22,19,1
35095,352,229,123,40,12,35,12,374,181,193,63,49,46,20,1
35096,351,228,123,32,30,33,13,346,187,159,42,34,43,21,1
35097,163,80,83,25,21,20,10,220,101,119,50,22,23,6,1
35098,376,183,193,50,50,43,21,254,107,147,42,37,24,10,1
35099,338,165,173,48,51,38,11,854,380,474,137,159,81,31,1
35100,758,421,337,95,73,116,28,488,217,271,71,71,50,32,1
35101,595,272,323,111,107,54,28,1164,531,633,179,157,107,46,1
35102,4655,2074,2581,545,652,562,399,345,174,171,46,34,45,28,1
35103,431,216,215,46,40,33,9,372,201,171,52,50,42,13,1
35104,92,40,52,14,23,13,7,470,205,265,71,80,33,11,1
35105,365,188,177,60,47,48,16,505,226,279,68,51,30,15,1
35106,832,428,404,131,89,88,38,516,298,218,62,57,49,19,1
35107,509,262,247,64,70,64,20,1047,562,485,141,127,114,41,1
35108,89,42,47,16,12,15,6,466,186,280,71,84,30,11,1
35109,493,222,271,44,53,45,51,211,112,99,30,15,34,18,1
35110,168,90,78,22,19,13,4,327,177,150,40,40,38,18,1
35111,538,252,286,77,87,53,30,1037,461,576,146,163,75,44,1
35112,552,283,269,89,66,68,30,167,89,78,16,14,18,7,1
35113,416,210,206,55,54,39,20,233,121,112,24,31,30,7,1
35114,254,136,118,42,36,28,8,1192,545,647,161,116,105,34,1
35115,656,358,298,67,47,64,26,439,232,207,50,35,47,15,1
35116,440,218,222,58,66,40,24,838,431,407,107,90,107,43,1
35117,755,390,365,103,84,85,34,636,336,300,94,65,58,32,1
35118,215,115,100,27,28,34,16,750,371,379,95,98,86,29,1
35119,2442,1193,1249,278,183,170,145,543,265,278,52,37,54,19,1
35120,969,505,464,123,133,92,33,215,80,135,54,56,21,9,1
35121,736,388,348,88,85,67,28,346,165,181,69,43,22,9,1
35122,147,86,61,23,15,22,4,194,115,79,23,15,25,15,1
35123,546,267,279,90,69,56,19,521,279,242,47,50,58,30,1
35124,1166,597,569,181,132,123,45,540,265,275,87,59,74,25,1
35125,395,226,169,57,44,32,8,941,504,437,119,86,103,44,1
35126,267,161,106,22,25,35,20,1255,666,589,145,142,120,82,1
35127,589,296,293,99,76,64,29,143,79,64,16,25,7,5,1
35128,242,112,130,39,41,21,13,452,224,228,69,56,50,31,1
35129,653,298,355,70,101,64,39,215,110,105,27,26,24,8,1
35130,346,174,172,36,43,21,9,310,141,169,36,38,20,8,1
35131,984,459,525,150,145,89,37,377,184,193,56,53,44,14,1
35132,229,105,124,36,33,12,4,964,408,556,131,153,76,55,1
35133,180,91,89,22,28,16,10,173,104,69,18,20,18,9,1
35134,370,194,176,51,57,43,17,705,396,309,87,48,53,17,1
35135,583,322,261,73,66,45,26,863,470,393,82,72,92,44,1
35136,288,120,168,54,52,21,12,593,305,288,91,83,54,24,1
35137,1124,615,509,157,125,128,52,356,208,148,42,26,57,15,1
35138,700,335,365,83,84,95,33,101,55,46,13,15,12,3,1
35139,509,262,247,64,70,64,20,561,292,269,88,68,64,22,1
35140,314,108,206,45,75,34,8,825,363,462,97,105,72,75,1
35141,2871,1148,1723,496,469,204,98,1192,545,647,161,116,105,34,1
35142,635,333,302,99,75,83,28,1265,580,685,205,188,166,53,1
35143,562,282,280,76,80,43,12,526,266,260,76,75,53,22,1
35144,171,94,77,24,28,30,11,327,177,150,40,40,38,18,1
35145,171,88,83,20,21,16,7,164,88,76,27,20,17,6,1
35146,527,245,282,87,62,65,16,848,391,457,158,135,115,23,1
35147,350,213,137,39,21,53,22,374,181,193,63,49,46,20,1
35148,567,261,306,63,89,29,15,216,119,97,33,27,28,7,1
35149,556,300,256,58,73,55,22,217,109,108,34,32,35,7,1
35150,846,367,479,134,108,72,31,862,384,478,127,110,75,42,1
35151,124,72,52,14,12,13,6,276,143,133,34,38,20,15,1
35152,582,293,289,94,80,77,32,224,101,123,45,32,21,3,1
35153,1218,499,719,147,141,119,145,2321,1177,1144,236,255,174,254,1
35154,588,255,333,94,82,58,27,810,310,500,164,162,42,26,1
35155,834,465,369,82,84,81,21,109,63,46,17,7,16,9,1
35156,724,334,390,112,109,79,17,847,402,445,109,91,100,37,1
35157,1382,599,783,208,252,90,39,414,212,202,65,52,32,17,1
35158,778,367,411,90,85,64,43,414,216,198,51,32,42,28,1
35159,1198,571,627,177,168,97,54,359,174,185,54,56,43,16,1
35160,181,75,106,35,26,11,9,769,329,440,116,66,55,22,1
35161,1215,572,643,151,105,127,54,1198,571,627,177,168,97,54,1
35162,1040,582,458,126,106,140,40,2157,1171,986,306,238,131,32,1
35163,784,337,447,127,135,59,29,215,110,105,27,26,24,8,1
35164,875,379,496,140,145,88,30,854,399,455,127,118,57,39,1
35165,2813,1331,1482,320,339,261,290,417,182,235,57,109,50,8,1
35166,875,421,454,124,142,98,43,285,107,178,49,58,27,17,1
35167,216,119,97,33,27,28,7,111,29,82,10,54,0,1,1
35168,298,159,139,39,40,33,15,277,124,153,44,40,35,18,1
35169,985,551,434,123,93,91,26,1124,441,683,148,189,72,43,1
35170,584,319,265,72,83,53,22,785,374,411,56,42,38,25,1
35171,165,89,76,19,16,12,5,1012,563,449,128,120,118,31,1
35172,785,374,411,56,42,38,25,320,163,157,44,44,26,15,1
35173,159,102,57,14,13,23,7,317,153,164,39,30,35,13,1
35174,540,297,243,75,69,67,21,151,82,69,16,17,11,7,1
35175,372,237,135,38,22,39,26,355,168,187,55,48,40,15,1
35176,903,437,466,117,112,108,32,1970,978,992,245,206,198,80,1
35177,466,233,233,65,51,50,32,295,146,149,33,32,33,7,1
35178,785,374,411,56,42,38,25,423,222,201,51,33,41,28,1
35179,197,99,98,35,27,14,6,552,264,288,82,64,48,20,1
35180,2328,1054,1274,377,410,232,62,768,378,390,105,104,63,26,1
35181,786,378,408,101,79,104,35,858,448,410,98,83,122,29,1
35182,920,492,428,100,92,88,49,417,182,235,57,109,50,8,1
35183,483,236,247,82,60,43,18,482,224,258,71,62,52,39,1
35184,652,272,380,116,113,55,27,2490,1126,1364,352,325,219,89,1
35185,1208,632,576,181,134,107,51,383,204,179,61,32,54,16,1
35186,452,202,250,83,60,56,19,158,85,73,24,18,18,8,1
35187,1197,521,676,216,187,82,38,1288,556,732,235,217,98,40,1
35188,1233,498,735,252,232,88,41,2115,838,1277,346,354,90,48,1
35189,532,269,263,72,59,59,39,242,104,138,41,33,37,8,1
35190,2524,1232,1292,398,317,186,61,454,230,224,63,56,38,33,1
35191,897,471,426,116,113,88,37,1706,830,876,265,209,230,63,1
35192,1162,548,614,191,166,142,38,585,277,308,92,73,61,32,1
35193,330,159,171,48,38,50,19,741,387,354,103,94,68,22,1
35194,958,492,466,119,104,119,35,933,491,442,118,103,99,46,1
35195,207,86,121,34,39,12,13,729,358,371,116,99,89,33,1
35196,390,175,215,53,61,26,22,560,228,332,113,58,79,38,1
35197,304,125,179,61,31,44,10,227,105,122,37,29,19,12,1
35198,427,186,241,55,52,42,23,255,130,125,44,18,22,12,1
35199,449,232,217,53,64,57,22,605,295,310,74,66,70,36,1
35200,821,387,434,121,131,76,29,904,436,468,138,146,82,39,1
35201,504,237,267,62,66,48,17,357,169,188,61,53,32,15,1
35202,1706,830,876,265,209,230,63,1132,646,486,99,102,71,41,1
35203,247,110,137,34,45,23,10,650,334,316,56,54,48,19,1
35204,890,432,458,127,107,99,50,529,274,255,57,62,38,14,1
35205,355,205,150,35,19,62,24,96,46,50,17,8,9,11,1
35206,1038,527,511,118,163,120,52,194,92,102,42,23,16,2,1
35207,795,444,351,120,97,73,32,318,176,142,25,32,35,25,1
35208,224,103,121,34,47,11,9,201,86,115,33,37,8,7,1
35209,895,436,459,124,113,87,44,593,295,298,70,85,48,13,1
35210,96,49,47,16,6,10,10,3396,1499,1897,325,572,309,90,1
35211,306,144,162,52,35,40,16,1114,581,533,145,132,126,54,1
35212,1333,646,687,209,179,148,45,728,385,343,110,102,69,14,1
35213,199,87,112,31,27,8,15,346,196,150,43,26,27,14,1
35214,1647,794,853,279,235,128,65,529,264,265,59,68,41,17,1
35215,400,195,205,63,67,40,18,856,483,373,101,90,123,47,1
35216,583,322,261,73,66,45,26,1114,581,533,145,132,126,54,1
35217,582,293,289,94,80,77,32,770,374,396,95,91,79,41,1
35218,1215,572,643,151,105,127,54,409,200,209,69,56,44,13,1
35219,167,89,78,16,14,18,7,224,123,101,23,24,33,6,1
35220,482,231,251,76,81,64,26,1621,750,871,276,243,162,51,1
35221,580,293,287,74,47,52,24,705,396,309,87,48,53,17,1
35222,2045,985,1060,359,339,199,74,619,343,276,88,65,84,25,1
35223,822,402,420,125,107,82,26,1271,599,672,194,175,118,47,1
35224,790,343,447,90,191,35,17,215,104,111,61,7,2,1,1
35225,472,259,213,51,44,56,21,1366,943,423,137,109,58,19,1
35226,552,285,267,74,51,69,24,504,259,245,73,56,45,29,1
35227,428,248,180,44,39,28,9,225,102,123,32,32,31,15,1
35228,824,403,421,80,150,65,35,1591,704,887,253,227,156,50,1
35229,1047,562,485,141,127,114,41,512,261,251,79,73,60,21,1
35230,498,263,235,59,63,36,10,191,99,92,25,24,18,8,1
35231,1261,694,567,159,130,136,70,351,184,167,59,45,54,9,1
35232,318,176,142,25,32,35,25,586,309,277,81,64,76,25,1
35233,431,245,186,50,23,46,17,2442,1193,1249,278,183,170,145,1
35234,824,397,427,113,95,82,33,126,66,60,24,10,7,9,1
35235,681,322,359,100,87,71,26,128,65,63,18,13,7,6,1
35236,337,203,134,29,18,44,26,503,263,240,72,55,51,34,1
35237,393,223,170,60,35,50,14,204,104,100,26,27,21,11,1
35238,631,261,370,110,109,50,26,191,99,92,25,24,18,8,1
35239,277,124,153,44,40,35,18,267,127,140,43,42,24,9,1
35240,699,295,404,132,126,46,28,954,521,433,135,118,78,26,1
35241,271,161,110,32,34,27,14,1306,707,599,165,147,199,44,1
35242,639,368,271,72,51,38,38,219,124,95,22,22,23,5,1
35243,536,278,258,72,63,62,20,281,166,115,34,17,36,16,1
35244,375,167,208,55,83,44,9,103,56,47,27,7,8,2,1
35245,474,208,266,65,69,43,36,531,260,271,97,68,47,11,1
35246,1497,881,616,151,117,94,40,981,465,516,126,164,112,38,1
35247,246,108,138,32,44,21,10,470,226,244,67,80,40,15,1
35248,1149,568,581,177,133,101,30,391,204,187,47,48,38,18,1
35249,493,250,243,72,65,36,27,1512,737,775,238,209,156,57,1
35250,477,301,176,52,35,45,24,352,166,186,55,59,31,16,1
35251,440,215,225,76,74,29,16,324,151,173,61,54,32,6,1
35252,592,283,309,84,137,60,20,489,235,254,53,69,49,20,1
35253,724,334,390,112,109,79,17,906,474,432,90,125,74,24,1
35254,1047,562,485,141,127,114,41,162,88,74,18,20,25,10,1
35255,1215,572,643,151,105,127,54,245,142,103,29,20,21,9,1
35256,3969,1703,2266,619,432,259,144,336,140,196,51,44,27,18,1
35257,461,231,230,61,67,41,15,654,317,337,95,111,44,13,1
35258,775,324,451,130,140,45,15,1382,599,783,208,252,90,39,1
35259,775,324,451,130,140,45,15,471,231,240,76,58,44,8,1
35260,1474,808,666,160,146,166,60,2161,1233,928,269,199,178,42,1
35261,745,391,354,85,81,52,39,814,450,364,91,114,69,12,1
35262,606,340,266,67,62,76,22,72,35,37,10,9,7,6,1
35263,536,278,258,72,63,62,20,413,227,186,45,34,58,23,1
35264,628,341,287,77,59,55,31,364,222,142,33,18,57,22,1
35265,815,418,397,97,62,70,17,487,247,240,73,42,42,22,1
35266,313,157,156,39,26,34,29,313,196,117,20,28,46,13,1
35267,462,228,234,59,47,37,32,159,84,75,13,28,10,8,1
35268,216,104,112,27,18,35,20,383,185,198,54,41,49,18,1
35269,459,229,230,78,65,59,26,292,152,140,46,38,35,12,1
35270,140,86,54,17,6,20,7,346,178,168,57,50,56,9,1
35271,484,254,230,60,66,56,14,1106,565,541,139,102,103,52,1
35272,671,318,353,83,124,46,34,196,120,76,29,15,39,10,1
35273,672,334,338,110,93,91,41,487,223,264,81,68,63,15,1
35274,903,437,466,117,112,108,32,522,283,239,65,64,76,22,1
35275,595,316,279,86,60,65,40,142,60,82,20,28,13,5,1
35276,763,361,402,103,144,78,45,365,186,179,48,47,42,13,1
35277,413,194,219,77,72,28,11,601,250,351,126,83,44,15,1
35278,270,133,137,42,37,34,8,574,273,301,101,74,68,26,1
35279,2231,1188,1043,225,189,188,118,1647,794,853,279,235,128,65,1
35280,794,390,404,103,95,86,23,1124,578,546,149,127,122,61,1
35281,635,333,302,99,75,83,28,847,402,445,109,91,100,37,1
35282,1152,459,693,138,343,75,33,406,187,219,55,64,24,9,1
35283,208,97,111,39,19,22,11,123,62,61,17,18,13,8,1
35284,1210,592,618,157,138,116,85,304,159,145,38,40,32,3,1
35285,864,429,435,129,118,68,35,156,88,68,29,14,12,11,1
35286,346,183,163,51,38,23,6,1216,552,664,194,189,110,49,1
35287,2419,1042,1377,389,474,238,59,380,212,168,47,38,19,11,1
35288,426,228,198,62,42,47,22,763,364,399,106,96,54,30,1
35289,2549,1331,1218,366,296,271,130,1708,792,916,256,198,171,65,1
35290,496,218,278,59,62,54,26,1124,578,546,149,127,122,61,1
35291,574,269,305,91,63,54,27,303,175,128,43,36,34,12,1
35292,2490,1126,1364,352,325,219,89,781,418,363,92,90,64,41,1
35293,1074,538,536,190,131,157,35,191,99,92,25,24,18,8,1
35294,593,321,272,64,84,33,20,2871,1148,1723,496,469,204,98,1
35295,1190,638,552,162,95,112,18,1072,538,534,145,128,106,68,1
35296,876,472,404,130,93,70,45,318,176,142,25,32,35,25,1
35297,757,414,343,85,59,112,47,185,92,93,29,21,17,10,1
35298,500,244,256,66,57,52,27,2003,1022,981,195,194,164,229,1
35299,189,90,99,26,29,17,11,473,212,261,72,64,45,28,1
35300,185,94,91,24,25,20,6,276,118,158,38,40,16,10,1
35301,334,162,172,34,33,32,21,805,486,319,95,71,97,30,1
35302,246,128,118,39,34,22,7,118,67,51,13,13,7,7,1
35303,195,83,112,40,16,19,16,240,119,121,31,24,10,19,1
35304,731,383,348,102,84,68,30,641,341,300,101,91,29,22,1
35305,461,257,204,48,37,78,28,141,69,72,18,17,13,7,1
35306,815,418,397,97,62,70,17,340,172,168,52,32,28,13,1
35307,712,313,399,115,106,40,16,375,202,173,46,49,41,23,1
35308,1443,776,667,191,175,160,56,904,436,468,138,146,82,39,1
35309,336,140,196,51,44,27,18,1280,712,568,167,131,135,39,1
35310,506,233,273,81,69,52,22,845,402,443,137,126,105,47,1
35311,730,442,288,104,88,42,68,359,179,180,52,45,48,16,1
35312,358,205,153,40,22,39,24,152,98,54,21,8,23,10,1
35313,529,274,255,57,62,38,14,111,29,82,10,54,0,1,1
35314,2045,985,1060,359,339,199,74,758,360,398,114,107,51,19,1
35315,593,295,298,70,85,48,13,336,134,202,51,64,27,12,1
35316,427,214,213,65,58,26,18,537,276,261,75,68,68,22,1
35317,906,455,451,116,105,87,46,495,233,262,64,39,49,32,1
35318,743,366,377,41,37,26,14,317,167,150,45,21,30,26,1
35319,1190,638,552,162,95,112,18,922,418,504,120,120,106,31,1
35320,1538,704,834,239,176,120,42,247,110,137,34,45,23,10,1
35321,470,226,244,81,53,59,39,390,191,199,66,49,43,12,1
35322,694,360,334,90,88,77,32,236,120,116,40,28,17,7,1
35323,1210,592,618,157,138,116,85,335,185,150,46,34,36,13,1
35324,370,232,138,36,23,42,21,176,81,95,28,20,17,15,1
35325,677,245,432,129,155,72,11,729,321,408,128,84,63,26,1
35326,1566,743,823,261,188,151,48,540,248,292,77,62,61,33,1
35327,1599,806,793,213,237,100,45,406,205,201,54,58,34,21,1
35328,299,164,135,37,29,28,11,892,420,472,135,146,98,37,1
35329,667,312,355,100,134,47,20,467,226,241,55,48,54,23,1
35330,803,346,457,126,171,74,24,4544,2024,2520,579,628,480,403,1
35331,848,461,387,111,102,108,42,973,527,446,110,137,122,34,1
35332,178,100,78,23,22,30,6,675,311,364,111,80,96,30,1
35333,486,236,250,73,67,59,16,1203,651,552,151,128,123,46,1
35334,703,356,347,96,97,38,22,899,453,446,149,128,78,24,1
35335,757,373,384,115,93,95,25,429,223,206,50,32,46,17,1
35336,435,208,227,68,64,53,23,864,510,354,89,81,76,42,1
35337,316,161,155,46,50,39,16,1290,597,693,182,182,119,63,1
35338,537,276,261,75,68,68,22,726,326,400,106,106,57,31,1
35339,278,111,167,66,66,19,8,1382,599,783,208,252,90,39,1
35340,546,267,279,90,69,56,19,452,202,250,83,60,56,19,1
35341,425,220,205,60,55,45,18,227,127,100,32,24,31,5,1
35342,760,358,402,112,125,78,26,96,55,41,13,2,8,5,1
35343,1338,756,582,155,105,104,44,461,208,253,79,76,61,21,1
35344,391,223,168,35,26,47,31,359,219,140,42,19,56,19,1
35345,2045,985,1060,359,339,199,74,1948,1039,909,242,227,200,67,1
35346,446,176,270,64,79,45,24,253,133,120,44,31,22,8,1
35347,697,373,324,105,83,95,38,902,495,407,116,97,111,37,1
35348,362,233,129,37,17,51,18,968,452,516,150,144,79,28,1
35349,2003,1022,981,195,194,164,229,1156,519,637,104,62,66,45,1
35350,513,246,267,71,66,60,35,882,432,450,115,111,68,44,1
35351,202,99,103,24,25,19,12,562,265,297,79,56,72,45,1
35352,275,155,120,37,31,16,14,587,279,308,88,71,49,31,1
35353,611,246,365,116,82,71,27,329,171,158,49,41,31,10,1
35354,526,220,306,95,74,62,41,519,219,300,86,72,50,39,1
35355,536,278,258,72,63,62,20,189,90,99,26,29,17,11,1
35356,3333,1606,1727,446,357,333,206,810,367,443,115,92,94,59,1
35357,1203,651,552,151,128,123,46,359,219,140,42,19,56,19,1
35358,913,453,460,118,129,114,46,757,373,384,115,93,95,25,1
35359,608,336,272,61,49,78,31,1269,624,645,183,180,136,52,1
35360,538,252,286,77,87,53,30,501,240,261,80,62,49,42,1
35361,636,336,300,94,65,58,32,366,191,175,37,33,19,19,1
35362,1032,526,506,129,117,119,47,272,149,123,46,14,27,16,1
35363,911,423,488,140,150,102,32,1497,881,616,151,117,94,40,1
35364,178,86,92,30,21,12,17,1210,592,618,157,138,116,85,1
35365,299,158,141,45,31,21,5,482,231,251,76,81,64,26,1
35366,199,101,98,29,25,18,6,769,329,440,116,66,55,22,1
35367,113,47,66,14,15,11,17,267,145,122,38,30,32,13,1
35368,425,204,221,71,56,45,13,313,159,154,30,40,23,14,1
35369,514,278,236,70,62,46,22,601,313,288,42,48,25,36,1
35370,862,409,453,149,125,86,29,986,418,568,159,99,110,42,1
35371,677,245,432,129,155,72,11,313,178,135,40,33,35,14,1
35372,632,339,293,83,77,59,20,1132,553,579,172,143,150,57,1
35373,164,78,86,28,23,12,8,327,172,155,38,41,41,15,1
35374,467,226,241,55,48,54,23,478,254,224,67,74,56,28,1
35375,1663,835,828,224,213,163,63,469,225,244,61,40,43,50,1
35376,492,280,212,56,61,30,13,690,433,257,74,59,70,36,1
35377,131,66,65,21,14,23,7,159,84,75,13,28,10,8,1
35378,360,192,168,55,45,48,16,393,210,183,55,50,34,19,1
35379,760,322,438,81,130,57,19,292,153,139,39,33,24,21,1
35380,821,329,492,167,130,79,27,102,49,53,14,21,7,4,1
35381,2045,985,1060,359,339,199,74,476,251,225,57,67,57,18,1
35382,1311,690,621,158,161,128,51,920,492,428,100,92,88,49,1
35383,198,80,118,35,31,14,7,305,168,137,48,35,40,9,1
35384,1299,517,782,209,222,93,37,594,274,320,89,63,66,28,1
35385,933,536,397,96,90,71,41,209,75,134,53,48,20,9,1
35386,832,428,404,131,89,88,38,614,263,351,85,84,54,35,1
35387,282,151,131,26,29,27,11,289,135,154,37,34,34,17,1
35388,476,233,243,76,61,52,21,524,237,287,87,75,54,26,1
35389,161,96,65,8,7,16,16,1247,548,699,168,150,140,43,1
35390,972,519,453,109,98,120,39,1258,648,610,172,159,116,28,1
35391,95,41,54,15,16,8,5,303,187,116,41,23,23,9,1
35392,614,226,388,103,97,51,30,223,97,126,41,33,21,12,1
35393,1242,613,629,174,113,114,53,178,100,78,23,22,30,6,1
35394,213,109,104,26,26,21,6,552,285,267,74,51,69,24,1
35395,349,167,182,54,38,30,28,595,316,279,86,60,65,40,1
35396,432,218,214,57,55,42,11,377,184,193,50,43,33,17,1
35397,553,261,292,73,79,40,26,595,316,279,86,60,65,40,1
35398,154,75,79,17,24,16,13,405,195,210,57,74,24,17,1
35399,403,185,218,67,62,63,19,433,222,211,68,58,42,23,1
35400,430,218,212,58,47,34,20,243,114,129,37,30,32,8,1
35401,794,402,392,96,84,86,30,501,285,216,52,55,62,25,1
35402,1545,828,717,186,149,176,58,592,283,309,84,137,60,20,1
35403,258,141,117,33,29,23,10,551,299,252,51,62,63,17,1
35404,1374,679,695,191,193,154,48,191,101,90,21,23,28,5,1
35405,706,346,360,118,92,98,56,537,276,261,75,68,68,22,1
35406,427,191,236,67,60,41,34,346,191,155,52,38,40,13,1
35407,968,452,516,150,144,79,28,550,243,307,91,99,70,10,1
35408,450,242,208,53,63,56,22,451,222,229,58,55,51,17,1
35409,623,320,303,103,85,75,15,355,179,176,51,45,45,11,1
35410,89,42,47,16,12,15,6,377,202,175,46,50,41,22,1
35411,498,231,267,72,61,54,29,1608,924,684,163,133,89,29,1
35412,777,387,390,90,87,65,37,553,261,292,73,79,40,26,1
35413,399,216,183,60,53,43,18,377,202,175,46,50,41,22,1
35414,720,361,359,98,98,70,37,1865,918,947,300,256,217,76,1
35415,432,218,214,57,55,42,11,379,200,179,55,42,53,16,1
35416,211,113,98,38,17,25,8,972,519,453,109,98,120,39,1
35417,217,121,96,27,34,18,10,136,72,64,22,16,7,3,1
35418,2442,1193,1249,278,183,170,145,482,231,251,76,81,64,26,1
35419,317,164,153,47,33,47,12,969,505,464,123,133,92,33,1
35420,1037,470,567,145,136,102,47,953,489,464,126,104,111,44,1
35421,715,322,393,105,82,77,51,177,82,95,24,37,9,12,1
35422,1270,557,713,130,195,57,30,517,196,321,103,98,34,12,1
35423,507,229,278,70,68,34,34,663,360,303,88,82,80,35,1
35424,476,240,236,71,70,27,15,1382,599,783,208,252,90,39,1
35425,198,114,84,30,13,27,11,220,126,94,29,12,34,11,1
35426,255,109,146,35,32,23,17,654,344,310,80,69,57,15,1
35427,235,104,131,29,35,26,10,256,125,131,34,27,24,14,1
35428,270,128,142,36,43,15,11,198,86,112,36,27,23,9,1
35429,127,66,61,13,14,19,8,522,265,257,35,39,38,8,1
35430,781,367,414,60,67,43,17,785,374,411,56,42,38,25,1
35431,1186,493,693,184,208,88,32,1970,978,992,245,206,198,80,1
35432,1149,568,581,177,133,101,30,203,119,83,22,21,19,9,1
35433,540,257,283,81,63,57,24,552,285,267,74,51,69,24,1
35434,377,224,153,52,23,51,20,1048,564,484,118,122,113,40,1
35435,183,96,87,25,25,29,10,202,113,89,16,27,21,11,1
35436,931,476,455,101,101,44,24,938,415,523,115,101,69,30,1
35437,442,208,234,68,49,51,25,625,342,283,62,53,56,28,1
35438,660,359,301,81,87,102,31,250,164,86,22,15,30,4,1
35439,2220,1085,1135,312,304,202,91,365,210,155,46,30,24,12,1
35440,1497,881,616,151,117,94,40,2871,1148,1723,496,469,204,98,1
35441,1320,566,754,235,198,122,36,825,363,462,97,105,72,75,1
35442,2315,1086,1229,231,306,248,64,168,67,101,37,17,13,13,1
35443,426,228,198,62,42,47,22,890,467,423,115,87,90,54,1
35444,1412,603,809,184,195,112,45,1822,879,943,236,227,175,97,1
35445,586,270,316,83,80,59,21,524,270,254,84,72,70,23,1
35446,546,241,305,61,128,31,26,894,479,415,117,93,119,38,1
35447,659,325,334,102,85,87,32,416,194,222,70,58,52,20,1
35448,907,530,377,61,82,63,30,1046,562,484,139,116,124,51,1
35449,1166,597,569,181,132,123,45,1729,863,866,188,254,101,37,1
35450,767,392,375,113,112,83,13,379,203,176,48,38,44,11,1
35451,536,278,258,72,63,62,20,365,186,179,48,47,42,13,1
35452,922,491,431,112,92,97,52,448,236,212,53,64,56,24,1
35453,103,49,54,21,21,10,2,557,278,279,75,70,66,31,1
35454,525,245,280,59,72,47,21,1118,471,647,204,164,102,34,1
35455,164,78,86,28,23,12,8,314,190,124,40,20,35,14,1
35456,499,188,311,123,53,84,39,201,42,159,19,3,2,75,1
35457,421,221,200,62,58,50,15,632,339,293,83,77,59,20,1
35458,410,200,210,60,54,46,19,396,150,246,103,64,38,3,1
35459,588,296,292,85,76,45,30,370,194,176,51,57,43,17,1
35460,1261,548,713,194,177,102,54,2490,1126,1364,352,325,219,89,1
35461,592,264,328,86,85,62,41,503,263,240,72,55,51,34,1
35462,216,120,96,21,24,31,13,418,248,170,41,31,54,9,1
35463,664,316,348,75,96,53,31,668,331,337,108,64,58,29,1
35464,366,193,173,53,32,46,19,178,100,78,23,22,30,6,1
35465,1068,559,509,158,132,122,57,189,90,99,26,29,17,11,1
35466,1464,715,749,200,167,181,70,1198,571,627,177,168,97,54,1
35467,468,233,235,65,61,49,34,551,298,253,63,65,45,19,1
35468,336,154,182,51,48,39,22,530,183,347,121,98,29,13,1
35469,2414,1189,1225,277,178,170,169,468,233,235,65,61,49,34,1
35470,439,177,262,78,73,40,21,387,193,194,51,48,50,17,1
35471,280,118,162,35,32,41,37,928,455,473,108,90,107,43,1
35472,183,95,88,27,19,20,7,233,94,139,36,37,15,8,1
35473,706,300,406,94,74,61,22,2414,1189,1225,277,178,170,169,1
35474,556,269,287,86,66,62,22,1591,704,887,253,227,156,50,1
35475,1247,620,627,134,149,142,58,1464,987,477,137,141,55,31,1
35476,156,64,92,31,19,5,4,772,363,409,76,120,57,20,1
35477,1198,571,627,177,168,97,54,1034,451,583,165,146,104,40,1
35478,1050,482,568,136,154,101,41,3418,1378,2040,515,464,318,121,1
35479,1124,615,509,157,125,128,52,369,181,188,41,36,54,16,1
35480,576,250,326,93,71,34,15,775,324,451,130,140,45,15,1
35481,5065,2741,2324,643,675,347,116,1210,592,618,157,138,116,85,1
35482,422,213,209,63,60,35,13,873,366,507,127,125,75,21,1
35483,233,111,122,38,27,17,8,767,392,375,113,112,83,13,1
35484,391,208,183,65,49,57,17,378,154,224,74,84,35,22,1
35485,509,262,247,64,70,64,20,295,167,128,43,23,17,11,1
35486,247,110,137,34,45,23,10,448,236,212,53,64,56,24,1
35487,467,226,241,55,48,54,23,530,259,271,83,50,54,41,1
35488,466,186,280,71,84,30,11,2871,1148,1723,496,469,204,98,1
35489,4388,2170,2218,590,532,460,156,1647,794,853,222,218,151,65,1
35490,749,361,388,107,115,73,27,769,329,440,116,66,55,22,1
35491,499,252,247,74,42,55,14,556,290,266,75,74,29,24,1
35492,245,122,123,21,32,18,13,673,329,344,111,95,92,41,1
35493,901,458,443,91,129,86,21,1210,592,618,157,138,116,85,1
35494,515,259,256,79,58,46,21,202,102,100,29,35,6,9,1
35495,1210,601,609,126,80,120,39,393,186,207,58,50,36,22,1
35496,366,191,175,37,33,19,19,238,91,147,68,19,22,7,1
35497,601,272,329,100,100,51,22,377,180,197,45,63,19,17,1
35498,4303,2489,1814,436,369,444,134,430,192,238,62,67,27,10,1
35499,442,254,188,46,22,40,19,379,203,176,55,48,45,16,1
35500,395,226,169,57,44,32,8,767,392,375,113,112,83,13,1
35501,183,92,91,26,28,17,7,87,50,37,16,7,10,5,1
35502,264,144,120,19,10,25,13,423,220,203,51,54,46,17,1
35503,881,428,453,174,110,64,21,778,367,411,90,85,64,43,1
35504,1284,511,773,227,166,169,107,591,300,291,70,45,59,30,1
35505,456,220,236,67,75,30,21,958,451,507,165,135,97,41,1
35506,798,393,405,112,80,83,33,391,203,188,49,34,36,9,1
35507,492,242,250,52,78,28,19,1675,875,800,213,219,196,72,1
35508,924,521,403,99,98,62,35,467,269,198,46,51,60,18,1
35509,582,330,252,82,69,87,21,179,95,84,32,33,29,8,1
35510,215,104,111,61,7,2,1,224,123,101,23,24,33,6,1
35511,520,224,296,69,64,31,29,399,201,198,65,45,48,17,1
35512,377,184,193,50,43,33,17,170,90,80,22,27,15,4,1
35513,111,29,82,10,54,0,1,641,324,317,88,92,49,14,1
35514,484,254,230,60,66,56,14,500,244,256,66,57,52,27,1
35515,1712,1175,537,179,142,113,46,122,69,53,18,16,20,4,1
35516,676,333,343,111,89,94,39,493,240,253,72,62,59,15,1
35517,225,116,109,29,19,25,6,1367,690,677,172,175,154,83,1
35518,467,226,241,55,48,54,23,2063,1024,1039,175,117,80,97,1
35519,1627,782,845,204,187,202,108,1663,835,828,224,213,163,63,1
35520,522,235,287,78,67,60,50,956,475,481,122,128,100,50,1
35521,1356,672,684,171,172,134,59,593,266,327,102,84,69,24,1
35522,318,176,142,25,32,35,25,197,92,105,38,16,26,15,1
35523,862,409,453,149,125,86,29,467,226,241,55,48,54,23,1
35524,508,268,240,92,58,56,21,536,278,258,72,63,62,20,1
35525,582,293,289,94,80,77,32,536,237,299,116,87,42,17,1
35526,205,99,106,24,29,20,5,824,392,432,106,89,88,32,1
35527,806,436,370,101,100,76,34,206,129,77,27,15,21,6,1
35528,105,51,54,13,17,12,8,334,172,162,43,39,41,17,1
35529,379,203,176,55,48,45,16,331,169,162,40,28,22,14,1
35530,723,380,343,80,84,47,18,390,207,183,50,48,38,15,1
35531,832,428,404,131,89,88,38,892,420,472,135,146,98,37,1
35532,247,110,137,34,45,23,10,529,314,215,59,64,39,14,1
35533,236,141,95,36,32,14,6,482,231,251,76,81,64,26,1
35534,556,279,277,83,69,71,19,948,484,464,134,131,75,27,1
35535,159,84,75,13,28,10,8,216,119,97,33,27,28,7,1
35536,482,231,251,76,81,64,26,288,142,146,52,32,26,8,1
35537,1342,675,667,162,154,123,39,1384,769,615,178,141,219,56,1
35538,628,341,287,77,59,55,31,467,226,241,55,48,54,23,1
35539,391,208,183,65,49,57,17,781,418,363,92,90,64,41,1
35540,210,89,121,51,34,11,6,295,95,200,70,89,17,6,1
35541,581,323,258,74,58,48,20,1290,629,661,191,187,167,55,1
35542,285,142,143,37,37,39,16,341,178,163,48,44,42,20,1
35543,328,156,172,44,37,44,15,582,293,289,94,80,77,32,1
35544,233,130,103,26,23,23,6,461,217,244,44,41,27,36,1
35545,294,148,146,35,33,25,14,280,142,138,35,37,22,13,1
35546,1278,593,685,198,201,71,43,268,140,128,33,39,26,9,1
35547,429,219,210,46,66,42,17,114,68,46,13,7,15,5,1
35548,906,437,469,135,132,49,40,829,424,405,91,131,76,22,1
35549,2302,1039,1263,395,353,222,90,862,427,435,139,98,100,59,1
35550,2045,985,1060,359,339,199,74,99,34,65,12,1,2,18,1
35551,326,153,173,63,48,25,8,551,352,199,46,43,77,26,1
35552,205,94,111,29,31,16,7,1117,423,694,182,134,88,31,1
35553,133,66,67,21,24,9,2,276,151,125,35,28,33,20,1
35554,123,62,61,17,18,13,8,454,237,217,61,51,56,17,1
35555,1382,689,693,186,176,167,77,481,256,225,60,56,48,12,1
35556,815,418,397,97,62,70,17,1214,612,602,169,173,98,35,1
35557,963,385,578,171,162,62,35,504,256,248,78,70,36,9,1
35558,524,281,243,71,58,63,21,947,482,465,143,107,89,37,1
35559,181,64,117,46,41,5,4,241,106,135,48,29,17,15,1
35560,556,269,287,86,66,62,22,2639,1436,1203,317,307,242,77,1
35561,1163,493,670,214,158,106,42,207,99,108,34,27,22,9,1
35562,203,120,83,27,17,24,12,707,295,412,105,105,66,30,1
35563,543,265,278,52,37,54,19,173,110,63,35,6,9,8,1
35564,406,210,196,68,60,25,20,380,187,193,38,51,30,18,1
35565,961,507,454,130,102,115,37,744,384,360,104,96,57,31,1
35566,896,407,489,97,152,70,22,651,323,328,90,65,64,24,1
35567,428,226,202,52,60,75,20,1189,653,536,152,118,109,56,1
35568,625,298,327,90,78,57,33,848,394,454,100,90,101,41,1
35569,391,208,183,65,49,57,17,409,200,209,69,56,44,13,1
35570,676,333,343,111,89,94,39,1212,645,567,145,117,122,72,1
35571,313,149,164,48,31,30,13,393,186,207,58,50,36,22,1
35572,509,262,247,64,70,64,20,706,346,360,118,92,98,56,1
35573,509,241,268,67,53,56,13,461,257,204,63,49,50,29,1
35574,127,66,61,13,14,19,8,111,29,82,10,54,0,1,1
35575,1170,510,660,142,182,115,84,1487,996,491,147,141,50,35,1
35576,393,186,207,58,50,36,22,1863,721,1142,262,283,139,74,1
35577,482,231,251,76,81,64,26,920,492,428,100,92,88,49,1
35578,280,118,162,35,32,41,37,375,202,173,46,49,41,23,1
35579,703,388,315,82,78,81,37,187,95,92,27,20,16,8,1
35580,1719,754,965,277,258,158,80,782,382,400,124,131,35,16,1
35581,1215,652,563,129,142,121,62,445,225,220,47,62,53,26,1
35582,745,354,391,116,100,95,46,213,107,106,28,41,19,5,1
35583,190,94,96,25,24,18,5,202,97,105,29,26,19,5,1
35584,131,66,65,21,14,23,7,390,237,153,41,57,22,16,1
35585,89,44,45,15,12,15,6,257,112,145,44,29,23,12,1
35586,829,396,433,141,82,93,36,360,192,168,55,45,48,16,1
35587,394,202,192,44,43,38,28,723,353,370,120,109,96,33,1
35588,125,78,47,17,6,9,6,333,212,121,33,15,44,16,1
35589,1087,481,606,102,80,92,18,2157,1171,986,306,238,131,32,1
35590,671,326,345,111,77,74,11,471,231,240,76,58,44,8,1
35591,640,308,332,91,102,49,21,81,41,40,15,13,3,2,1
35592,553,261,292,73,79,40,26,605,295,310,74,66,70,36,1
35593,826,362,464,107,118,71,43,318,164,154,52,43,34,10,1
35594,959,496,463,144,132,75,35,425,210,215,56,43,52,25,1
35595,411,209,202,69,43,18,15,2442,1193,1249,278,183,170,145,1
35596,558,302,256,66,62,65,30,297,158,139,47,37,37,9,1
35597,1149,568,581,177,133,101,30,217,109,108,34,32,35,7,1
35598,815,418,397,97,62,70,17,335,185,150,46,34,36,13,1
35599,1298,591,707,196,168,124,58,932,575,357,94,69,76,40,1
35600,1192,545,647,161,116,105,34,117,62,55,24,18,21,2,1
35601,336,169,167,38,30,44,16,769,362,407,99,88,66,67,1
35602,326,167,159,46,31,38,13,898,467,431,101,127,90,53,1
35603,3396,1499,1897,325,572,309,90,742,303,439,88,96,86,23,1
35604,450,229,221,49,63,54,27,1276,682,594,182,148,89,37,1
35605,787,386,401,98,95,86,25,223,132,91,18,16,27,17,1
35606,3664,1638,2026,598,519,231,63,2524,1232,1292,398,317,186,61,1
35607,1395,627,768,172,263,141,59,400,203,197,30,36,31,10,1
35608,910,524,386,106,97,73,26,1647,794,853,222,218,151,65,1
35609,522,235,287,78,67,60,50,497,227,270,70,63,66,30,1
35610,465,240,225,50,54,24,14,414,194,220,76,66,49,16,1
35611,815,418,397,97,62,70,17,434,231,203,58,45,33,22,1
35612,2012,1000,1012,240,204,189,64,553,261,292,73,79,40,26,1
35613,327,160,167,56,31,36,15,2440,1061,1379,377,326,172,62,1
35614,361,184,177,50,53,51,22,557,268,289,66,67,70,17,1
35615,497,270,227,64,43,62,22,473,245,228,67,52,70,24,1
35616,520,236,284,115,52,45,16,795,305,490,169,178,66,22,1
35617,651,306,345,85,64,61,32,984,461,523,109,89,91,52,1
35618,284,173,111,19,18,37,15,416,229,187,61,52,53,19,1
35619,590,279,311,103,83,69,30,127,58,69,17,22,3,2,1
35620,609,292,317,102,96,64,21,2556,1169,1387,248,291,227,275,1
35621,595,316,279,86,60,65,40,409,208,201,72,30,48,21,1
35622,548,250,298,85,64,56,21,439,205,234,64,88,41,21,1
35623,533,297,236,74,57,39,28,462,228,234,59,47,37,32,1
35624,597,282,315,81,64,75,43,223,127,96,25,23,33,4,1
35625,555,278,277,60,70,48,18,763,361,402,103,144,78,45,1
35626,145,75,70,22,18,10,5,458,177,281,90,69,48,9,1
35627,512,261,251,79,73,60,21,635,333,302,99,75,83,28,1
35628,998,532,466,113,109,97,53,1834,823,1011,297,282,151,63,1
35629,1288,700,588,164,138,121,51,1374,679,695,191,193,154,48,1
35630,838,386,452,108,132,45,29,1162,515,647,191,143,97,35,1
35631,510,264,246,67,66,38,29,543,221,322,78,122,37,12,1
35632,448,223,225,50,58,39,34,416,201,215,54,52,39,25,1
35633,1014,490,524,177,137,94,38,239,146,93,30,22,35,9,1
35634,323,181,142,40,37,26,16,273,148,125,38,31,16,19,1
35635,802,388,414,131,105,96,29,750,347,403,105,103,83,29,1
35636,716,354,362,102,87,77,30,478,215,263,103,72,47,3,1
35637,461,207,254,82,66,55,33,462,233,229,66,49,43,30,1
35638,266,133,133,43,28,30,8,467,226,241,55,48,54,23,1
35639,506,204,302,89,66,44,20,1203,651,552,151,128,123,46,1
35640,638,305,333,68,90,70,29,624,308,316,92,72,68,22,1
35641,429,156,273,94,65,29,7,509,341,168,35,32,52,15,1
35642,649,349,299,90,77,62,26,528,268,260,81,77,36,22,1
35643,1424,650,774,152,124,95,87,731,383,348,102,84,68,30,1
35644,427,218,209,61,53,45,26,347,212,135,35,32,17,6,1
35645,310,161,149,34,31,35,12,224,123,101,23,24,33,6,1
35646,748,355,393,121,91,95,26,550,283,267,67,74,73,31,1
35647,716,354,362,102,87,77,30,632,326,306,92,71,56,19,1
35648,579,330,249,52,27,90,11,1064,555,509,111,90,99,32,1
35649,325,186,139,37,21,53,19,485,273,212,52,47,51,17,1
35650,1215,572,643,151,105,127,54,2725,1490,1235,339,333,254,78,1
35651,280,122,158,47,39,13,12,709,359,350,107,102,65,20,1
35652,424,198,226,57,46,41,19,437,228,209,47,61,26,11,1
35653,1258,648,610,172,159,116,28,583,322,261,73,66,45,26,1
35654,963,455,508,126,110,68,29,141,64,77,26,24,10,6,1
35655,1893,764,1129,308,323,126,60,2466,1374,1092,284,247,280,102,1
35656,140,67,73,13,16,18,8,626,272,354,96,80,71,36,1
35657,1074,538,536,154,140,111,51,605,295,310,74,66,70,36,1
35658,593,303,290,70,70,68,15,383,204,179,59,45,29,15,1
35659,430,218,212,58,47,34,20,1332,659,673,174,170,153,55,1
35660,552,285,267,74,51,69,24,345,203,142,47,35,31,11,1
35661,305,95,210,88,27,15,9,601,313,288,42,48,25,36,1
35662,421,206,215,63,57,35,11,493,275,218,64,36,49,30,1
35663,2440,1061,1379,377,326,172,62,461,223,238,66,57,36,23,1
35664,509,243,266,80,57,45,19,822,392,430,125,104,79,24,1
35665,737,363,374,119,101,85,41,430,192,238,62,67,27,10,1
35666,1073,547,526,60,60,47,19,254,107,147,42,37,24,10,1
35667,410,211,199,55,42,34,27,482,231,251,76,81,64,26,1
35668,209,129,80,18,13,20,12,171,107,64,14,12,16,9,1
35669,482,231,251,76,81,64,26,1068,527,541,160,131,112,52,1
35670,536,278,258,72,63,62,20,1367,690,677,172,175,154,83,1
35671,486,229,257,75,104,49,10,277,124,153,44,40,35,18,1
35672,185,107,78,20,29,10,4,601,313,288,42,48,25,36,1
35673,204,93,111,35,35,16,11,3830,2000,1830,532,388,418,203,1
35674,593,280,313,92,89,60,42,376,177,199,55,49,50,18,1
35675,684,288,396,107,90,54,42,362,174,188,46,55,35,23,1
35676,365,180,185,63,35,48,19,448,275,173,32,53,55,27,1
35677,247,110,137,34,45,23,10,792,398,394,109,96,90,39,1
35678,1210,592,618,157,138,116,85,1207,593,614,151,148,131,95,1
35679,344,201,143,42,39,41,14,96,50,46,8,15,6,2,1
35680,795,305,490,169,178,66,22,246,108,138,32,44,21,10,1
35681,808,366,442,130,133,66,31,298,167,131,47,33,40,8,1
35682,627,289,338,101,73,62,43,225,125,100,33,32,29,12,1
35683,156,77,79,45,14,12,2,898,467,431,101,127,90,53,1
35684,323,198,125,28,25,34,15,1074,538,536,154,140,111,51,1
35685,310,142,168,42,39,24,9,800,416,384,102,105,83,22,1
35686,672,334,338,110,93,91,41,382,200,182,53,36,51,16,1
35687,501,240,261,80,62,49,42,566,287,279,77,66,34,14,1
35688,101,41,60,18,19,10,5,303,187,116,41,23,23,9,1
35689,665,304,361,90,72,63,28,464,236,228,64,56,53,28,1
35690,546,279,267,94,60,32,22,577,251,326,92,84,60,11,1
35691,583,273,310,84,67,73,53,1231,566,665,164,147,154,103,1
35692,685,315,370,108,99,36,9,198,89,109,32,36,14,9,1
35693,637,335,302,83,77,85,26,1187,631,556,182,139,152,56,1
35694,536,278,258,72,63,62,20,781,418,363,92,90,64,41,1
35695,8797,3688,5109,1359,1437,715,322,702,298,404,134,111,48,18,1
35696,109,50,59,12,12,9,3,529,264,265,59,68,41,17,1
35697,1129,500,629,171,148,85,30,660,332,328,84,73,47,19,1
35698,535,249,286,79,64,55,22,510,243,267,65,67,44,44,1
35699,577,241,336,112,109,47,21,246,128,118,39,34,22,7,1
35700,712,396,316,78,69,65,25,1061,543,518,146,123,109,67,1
35701,656,358,298,67,47,64,26,964,408,556,131,153,76,55,1
35702,510,264,246,67,66,38,29,95,41,54,15,16,8,5,1
35703,826,410,416,98,94,107,39,770,374,396,95,91,79,41,1
35704,1367,690,677,172,175,154,83,1382,689,693,186,176,167,77,1
35705,591,274,317,89,66,75,41,1676,860,816,208,192,204,56,1
35706,351,189,162,39,28,21,16,531,286,245,61,45,46,16,1
35707,143,81,62,28,9,8,1,708,303,405,115,115,70,23,1
35708,841,427,414,112,88,56,25,986,499,487,123,116,98,54,1
35709,692,305,387,100,97,78,30,754,318,436,114,106,58,28,1
35710,1115,589,526,142,108,136,50,1484,731,753,206,175,187,71,1
35711,1430,718,712,205,172,151,64,360,192,168,55,45,48,16,1
35712,277,129,148,41,32,32,15,154,75,79,28,23,16,6,1
35713,401,167,234,56,71,16,10,243,100,143,38,34,11,13,1
35714,295,143,152,38,47,22,25,770,374,396,95,91,79,41,1
35715,731,340,391,95,83,81,32,331,169,162,40,28,22,14,1
35716,377,201,176,46,50,41,23,2442,1193,1249,278,183,170,145,1
35717,545,230,315,91,101,50,16,881,443,438,123,92,71,27,1
35718,561,255,306,95,67,44,17,359,173,186,55,57,44,16,1
35719,583,322,261,73,66,45,26,526,254,272,44,43,49,13,1
35720,609,318,291,80,72,55,36,883,403,480,140,119,85,38,1
35721,1336,828,508,166,121,152,48,183,91,92,21,29,16,10,1
35722,350,200,150,45,47,23,8,113,72,41,7,6,17,5,1
35723,748,355,393,121,91,95,26,386,193,193,55,57,31,13,1
35724,1634,828,806,236,195,195,67,1210,592,618,157,138,116,85,1
35725,247,110,137,34,45,23,10,622,294,328,104,93,42,17,1
35726,351,184,167,59,45,54,9,1220,640,580,160,161,101,43,1
35727,839,439,400,101,86,102,43,435,208,227,68,64,53,23,1
35728,1190,638,552,162,95,112,18,261,102,159,45,36,31,37,1
35729,758,360,398,114,107,51,19,247,133,114,41,25,41,8,1
35730,536,237,299,116,87,42,17,500,244,256,66,57,52,27,1
35731,211,90,121,49,27,14,11,1474,756,718,175,158,169,51,1
35732,134,61,73,26,33,4,8,116,67,49,13,12,6,5,1
35733,736,388,348,88,85,67,28,575,293,282,78,64,40,13,1
35734,1649,796,853,250,234,175,53,552,285,267,74,51,69,24,1
35735,520,261,259,82,76,71,24,745,366,379,110,93,79,45,1
35736,1867,973,894,256,222,194,65,412,193,219,70,56,51,26,1
35737,1059,580,479,138,117,67,27,106,52,54,18,4,9,8,1
35738,1123,554,569,142,130,85,36,412,193,219,70,56,51,26,1
35739,770,385,385,78,83,60,16,4655,2074,2581,545,652,562,399,1
35740,418,248,170,41,31,54,9,191,135,56,13,7,23,7,1
35741,303,175,128,43,36,34,12,1068,527,541,160,131,112,52,1
35742,451,225,226,68,57,65,22,296,154,142,38,38,24,16,1
35743,326,148,178,55,42,31,12,189,88,101,31,29,18,10,1
35744,270,137,133,30,28,27,11,616,304,312,75,71,55,25,1
35745,165,87,78,24,19,22,9,928,442,486,139,118,91,43,1
35746,94,55,39,18,6,18,5,422,198,224,52,52,42,43,1
35747,379,203,176,55,48,45,16,509,262,247,64,70,64,20,1
35748,527,257,270,72,68,50,28,780,369,411,130,113,79,35,1
35749,201,42,159,19,3,2,75,1074,539,535,136,87,87,66,1
35750,969,505,464,123,133,92,33,770,374,396,95,91,79,41,1
35751,489,250,239,66,57,47,26,210,106,104,29,23,20,4,1
35752,1255,666,589,145,142,120,82,593,266,327,102,84,69,24,1
35753,931,476,455,101,101,44,24,508,267,241,43,35,25,17,1
35754,359,163,196,47,78,47,9,509,262,247,64,70,64,20,1
35755,194,92,102,42,23,16,2,1115,586,529,124,161,111,69,1
35756,638,305,333,68,90,70,29,1132,553,579,172,143,150,57,1
35757,1332,659,673,174,170,153,55,142,61,81,28,21,22,9,1
35758,358,170,188,54,55,20,10,662,306,356,90,82,73,28,1
35759,448,281,167,47,37,45,13,365,186,179,48,47,42,13,1
35760,128,68,60,18,15,17,4,480,234,246,79,77,65,23,1
35761,380,184,196,58,52,46,8,864,429,435,129,118,68,35,1
35762,117,60,57,20,17,16,5,744,384,360,104,96,57,31,1
35763,208,104,104,39,20,26,15,1190,638,552,162,95,112,18,1
35764,233,96,137,40,40,13,9,797,394,403,109,89,83,40,1
35765,432,218,214,57,55,42,11,523,318,205,59,49,35,17,1
35766,1230,623,607,154,156,94,61,776,356,420,122,103,85,30,1
35767,278,137,141,47,32,28,20,757,373,384,115,93,95,25,1
35768,453,242,211,59,47,49,11,410,208,202,35,36,50,15,1
35769,860,378,482,101,123,82,74,357,153,204,84,62,39,2,1
35770,889,476,413,135,104,78,32,1074,538,536,190,131,157,35,1
35771,113,54,59,20,16,13,3,454,242,212,54,42,61,24,1
35772,676,333,343,111,89,94,39,802,388,414,101,93,88,35,1
35773,297,158,139,47,37,37,9,294,122,172,46,65,18,11,1
35774,448,236,212,53,64,56,24,439,202,237,80,53,35,15,1
35775,810,367,443,115,92,94,59,746,361,385,91,92,101,32,1
35776,779,354,425,96,69,57,36,360,188,172,49,48,47,17,1
35777,577,251,326,92,84,60,11,904,436,468,138,146,82,39,1
35778,1706,830,876,265,209,230,63,531,296,235,82,54,45,23,1
35779,781,418,363,92,90,64,41,906,474,432,90,125,74,24,1
35780,1463,521,942,252,204,105,52,248,118,130,54,31,26,5,1
35781,341,178,163,48,44,42,20,2225,1244,981,271,243,217,93,1
35782,672,334,338,110,93,91,41,217,98,119,33,32,27,7,1
35783,2696,1169,1527,432,347,193,146,462,233,229,66,49,43,30,1
35784,1893,850,1043,280,340,169,80,1068,527,541,160,131,112,52,1
35785,359,184,175,49,35,32,11,1670,1140,530,173,120,89,53,1
35786,279,106,173,48,35,41,39,1137,641,496,132,130,114,42,1
35787,272,122,150,33,30,27,26,153,73,80,19,15,14,10,1
35788,1382,689,693,186,176,167,77,814,370,444,121,108,85,36,1
35789,454,191,263,61,66,38,15,517,196,321,103,98,34,12,1
35790,585,299,286,92,73,89,23,790,388,402,120,101,100,51,1
35791,546,267,279,90,69,56,19,777,345,432,128,88,65,39,1
35792,736,388,348,88,85,67,28,396,150,246,103,64,38,3,1
35793,536,278,258,72,63,62,20,280,133,147,44,38,40,12,1
35794,1192,545,647,161,116,105,34,467,269,198,46,51,60,18,1
35795,908,481,427,118,88,109,49,651,306,345,85,64,61,32,1
35796,507,242,265,53,44,31,22,224,108,116,31,32,22,8,1
35797,764,277,487,158,162,64,31,510,246,264,80,71,15,18,1
35798,288,159,129,27,44,27,15,424,234,190,60,42,46,12,1
35799,1290,597,693,182,182,119,63,582,293,289,94,80,77,32,1
35800,837,444,393,128,89,87,37,2442,1193,1249,278,183,170,145,1
35801,643,294,349,92,97,53,35,673,317,356,101,85,76,49,1
35802,330,143,187,63,29,52,20,1338,506,832,241,229,101,40,1
35803,1782,715,1067,211,414,58,30,404,197,207,57,69,33,15,1
35804,68,34,34,11,8,3,4,340,162,178,40,39,35,22,1
35805,440,214,226,59,62,27,28,281,132,149,38,32,38,14,1
35806,162,88,74,18,20,25,10,3259,1163,2096,526,657,162,86,1
35807,253,141,112,28,21,33,20,1066,587,479,127,108,118,48,1
35808,303,137,166,54,54,31,15,1255,666,589,145,142,120,82,1
35809,327,151,176,48,43,36,10,239,146,93,30,22,35,9,1
35810,953,489,464,126,104,111,44,538,252,286,77,87,53,30,1
35811,750,371,379,95,98,86,29,101,55,46,13,15,12,3,1
35812,313,178,135,43,18,35,6,397,234,163,44,38,23,21,1
35813,638,305,333,68,90,70,29,770,374,396,95,91,79,41,1
35814,244,123,121,36,24,27,16,491,270,221,51,47,53,18,1
35815,301,150,151,41,30,17,11,112,59,53,12,17,14,8,1
35816,458,269,189,56,40,29,7,497,227,270,70,63,66,30,1
35817,315,150,165,52,36,22,15,219,112,107,24,31,25,9,1
35818,615,356,259,90,56,97,19,51,10,41,25,0,5,8,1
35819,651,331,320,93,93,51,28,510,252,258,75,60,57,24,1
35820,218,108,110,27,29,23,10,671,295,376,126,93,61,28,1
35821,714,364,350,98,102,91,27,466,186,280,71,84,30,11,1
35822,480,234,246,79,77,65,23,198,102,96,27,20,21,12,1
35823,236,140,96,20,39,12,6,354,140,214,55,50,31,18,1
35824,271,142,129,34,27,20,7,506,254,252,57,82,41,17,1
35825,342,160,182,69,40,37,16,336,134,202,51,64,27,12,1
35826,901,458,443,91,129,86,21,1907,1008,899,235,224,195,73,1
35827,178,100,78,23,22,30,6,522,235,287,78,67,60,50,1
35828,168,67,101,37,17,13,13,315,169,146,51,49,27,9,1
35829,330,190,140,42,21,30,13,390,191,199,57,49,45,25,1
35830,410,211,199,55,42,34,27,428,226,202,52,60,75,20,1
35831,2161,1233,928,269,199,178,42,741,387,354,118,104,90,27,1
35832,108,59,49,17,13,12,5,2758,1332,1426,394,384,287,131,1
35833,219,104,115,43,32,24,11,914,453,461,112,115,79,29,1
35834,675,338,337,91,85,28,23,1462,652,810,243,199,115,30,1
35835,609,292,317,102,96,64,21,544,291,253,62,53,35,26,1
35836,589,281,308,69,39,63,20,267,147,120,40,24,25,8,1
35837,382,214,168,49,20,47,23,1106,579,527,121,152,113,45,1
35838,328,140,188,61,64,22,12,482,231,251,76,81,64,26,1
35839,410,186,224,72,57,52,22,1858,805,1053,271,345,116,41,1
35840,549,290,259,64,61,62,15,1356,576,780,229,198,107,38,1
35841,740,374,366,117,95,84,33,577,342,235,63,57,23,37,1
35842,355,168,187,55,48,40,15,443,240,203,66,31,57,27,1
35843,1149,568,581,177,133,101,30,1140,586,554,130,146,117,49,1
35844,100,50,50,15,13,10,4,211,83,128,28,35,5,11,1
35845,217,94,123,29,30,23,17,355,168,187,55,48,40,15,1
35846,208,96,112,31,32,13,9,1430,718,712,205,172,151,64,1
35847,323,181,142,40,37,26,16,243,98,145,25,65,20,5,1
35848,373,152,221,49,61,30,34,480,244,236,74,47,50,21,1
35849,1187,631,556,182,139,152,56,724,334,390,112,109,79,17,1
35850,4128,2104,2024,581,505,453,205,1014,490,524,177,137,94,38,1
35851,1118,551,567,128,145,95,36,894,417,477,114,123,89,38,1
35852,344,181,163,61,37,40,14,808,419,389,109,87,86,32,1
35853,414,216,198,51,32,42,28,1215,572,643,151,105,127,54,1
35854,191,99,92,25,24,18,8,240,125,115,34,32,30,8,1
35855,259,123,136,32,42,21,8,328,158,170,52,68,45,7,1
35856,425,224,201,58,56,40,16,838,431,407,107,90,107,43,1
35857,903,472,431,111,76,51,23,1462,652,810,243,199,115,30,1
35858,182,84,98,27,35,18,9,919,467,452,125,87,88,37,1
35859,323,200,123,45,30,70,16,1210,592,618,157,138,116,85,1
35860,468,225,243,80,61,62,22,211,114,97,32,24,19,10,1
35861,163,70,93,28,21,17,6,525,274,251,82,74,60,25,1
35862,509,341,168,35,32,52,15,911,423,488,140,150,102,32,1
35863,255,144,111,23,27,32,11,769,329,440,116,66,55,22,1
35864,1257,647,610,156,146,145,35,3957,1683,2274,560,659,267,109,1
35865,1076,563,513,129,114,90,37,370,177,193,51,61,32,4,1
35866,722,388,334,105,85,68,36,2472,1057,1415,331,352,159,96,1
35867,1235,584,651,140,226,82,52,462,233,229,66,49,43,30,1
35868,1721,838,883,241,218,144,54,706,320,386,111,76,75,51,1
35869,676,333,343,111,89,94,39,456,243,213,64,44,59,18,1
35870,393,209,184,65,44,57,11,2570,1307,1263,294,248,267,235,1
35871,163,70,93,28,21,17,6,416,228,188,63,25,40,20,1
35872,1124,615,509,157,125,128,52,225,116,109,29,19,25,6,1
35873,580,302,278,71,66,65,41,352,169,183,57,36,47,31,1
35874,683,365,318,89,69,56,25,1690,1173,517,186,130,110,56,1
35875,1395,627,768,172,263,141,59,532,274,258,75,42,60,28,1
35876,94,45,49,11,20,10,4,382,200,182,53,36,51,16,1
35877,722,384,338,94,83,63,35,379,203,176,55,48,45,16,1
35878,920,492,428,100,92,88,49,740,313,427,101,135,40,22,1
35879,2414,1189,1225,277,178,170,169,1424,650,774,152,124,95,87,1
35880,225,102,123,32,32,31,15,202,102,100,29,35,6,9,1
35881,3969,1703,2266,619,432,259,144,277,100,177,35,88,30,2,1
35882,1336,828,508,166,121,152,48,1748,791,957,281,247,173,25,1
35883,233,119,114,32,26,24,12,724,334,390,112,109,79,17,1
35884,247,135,112,38,18,29,13,423,220,203,51,54,46,17,1
35885,298,167,131,47,33,40,8,381,191,190,55,61,33,11,1
35886,839,446,393,125,110,94,35,973,522,451,140,134,124,39,1
35887,379,203,176,55,48,45,16,525,274,251,82,74,60,25,1
35888,639,287,352,111,108,44,9,526,264,262,77,71,61,27,1
35889,1581,684,897,220,153,118,63,595,316,279,86,60,65,40,1
35890,846,367,479,134,108,72,31,756,362,394,102,104,73,25,1
35891,356,185,171,37,31,17,21,164,61,103,47,19,14,5,1
35892,1322,598,724,141,94,53,37,562,214,348,120,86,69,42,1
35893,574,277,297,88,77,58,36,984,516,468,78,45,73,12,1
35894,1549,848,701,182,150,179,69,390,220,170,55,37,44,19,1
35895,485,187,298,95,71,61,25,396,169,227,74,59,35,17,1
35896,425,210,215,56,43,52,25,311,165,146,40,28,37,12,1
35897,543,277,266,62,54,70,19,355,165,190,53,56,42,19,1
35898,217,109,108,34,32,35,7,619,332,287,95,77,74,38,1
35899,507,242,265,53,44,31,22,411,208,203,63,44,52,19,1
35900,1315,720,595,138,136,115,62,1106,565,541,139,102,103,52,1
35901,815,418,397,97,62,70,17,1502,593,909,297,212,137,29,1
35902,425,204,221,71,56,45,13,288,118,170,50,57,18,15,1
35903,1425,670,755,153,189,122,85,425,210,215,56,43,52,25,1
35904,92,47,45,15,9,9,5,1023,561,462,117,125,96,48,1
35905,75,36,39,11,10,5,7,340,162,178,40,39,35,22,1
35906,592,264,328,86,85,62,41,882,432,450,115,111,68,44,1
35907,609,279,330,103,98,72,42,4967,2501,2466,718,692,594,248,1
35908,670,306,364,95,74,73,45,657,293,364,109,75,66,28,1
35909,803,345,458,109,110,68,40,189,90,99,26,29,17,11,1
35910,404,177,227,75,68,45,13,1455,765,690,189,162,166,66,1
35911,597,282,315,81,64,75,43,4544,2024,2520,579,628,480,403,1
35912,669,382,287,67,35,70,16,1014,490,524,177,137,94,38,1
35913,560,244,316,92,118,47,12,540,271,269,80,77,51,16,1
35914,522,235,287,78,67,60,50,279,106,173,48,35,41,39,1
35915,416,201,215,54,52,39,25,790,352,438,132,87,91,60,1
35916,433,221,212,59,42,47,14,493,236,257,44,75,25,15,1
35917,727,259,468,163,157,68,15,1149,568,581,177,133,101,30,1
35918,317,153,164,39,30,35,13,672,334,338,110,93,91,41,1
35919,360,188,172,49,48,47,17,1475,658,817,149,114,120,43,1
35920,4967,2501,2466,718,692,594,248,404,197,207,57,69,33,15,1
35921,537,270,267,53,60,56,41,511,274,237,62,53,80,22,1
35922,1009,506,503,146,141,97,55,1210,592,618,157,138,116,85,1
35923,744,385,359,125,89,90,23,2549,1331,1218,366,296,271,130,1
35924,103,44,59,16,17,9,5,2985,1374,1611,450,433,312,111,1
35925,574,277,297,88,77,58,36,309,106,203,66,49,25,10,1
35926,211,113,98,38,17,25,8,551,299,252,51,62,63,17,1
35927,815,418,397,97,62,70,17,186,97,89,26,28,13,5,1
35928,480,196,284,72,74,25,2,1098,432,666,166,199,76,28,1
35929,209,125,84,20,22,22,6,443,198,245,68,72,48,19,1
35930,427,204,223,38,57,26,32,626,345,281,62,76,66,25,1
35931,595,272,323,111,107,54,28,586,254,332,114,111,55,17,1
35932,462,251,211,74,53,41,18,391,203,188,49,48,41,14,1
35933,552,285,267,74,51,69,24,704,356,348,112,94,71,24,1
35934,364,241,123,33,16,38,19,443,240,203,66,31,57,27,1
35935,328,178,150,36,34,16,14,280,128,152,39,37,38,18,1
35936,480,256,224,67,55,26,22,684,300,384,101,106,67,20,1
35937,238,100,138,39,37,16,9,876,457,419,88,124,67,47,1
35938,162,73,89,32,19,4,4,403,220,183,57,39,45,11,1
35939,154,75,79,17,24,16,13,229,105,124,36,33,12,4,1
35940,603,311,292,102,71,66,23,719,364,355,104,100,58,34,1
35941,784,373,411,101,90,91,37,712,396,316,78,69,65,25,1
35942,277,151,126,35,30,24,15,205,118,87,24,23,20,20,1
35943,553,261,292,73,79,40,26,592,264,328,86,85,62,41,1
35944,920,492,428,100,92,88,49,770,374,396,95,91,79,41,1
35945,127,54,73,11,33,15,6,2799,1324,1475,369,371,215,124,1
35946,864,362,502,142,150,70,19,443,240,203,66,31,57,27,1
35947,429,219,210,46,66,42,17,384,207,177,52,39,43,18,1
35948,281,138,143,50,36,27,16,355,165,190,53,56,42,19,1
35949,80,42,38,12,7,7,4,118,51,67,25,13,6,7,1
35950,822,416,406,111,105,84,44,239,126,113,49,18,27,5,1
35951,478,234,244,62,50,61,24,504,237,267,62,66,48,17,1
35952,692,365,327,89,74,63,35,860,378,482,101,123,82,74,1
35953,145,84,61,16,15,14,4,512,269,243,69,70,62,29,1
35954,1147,483,664,200,195,95,53,556,279,277,83,69,71,19,1
35955,350,182,168,39,41,49,14,501,247,254,53,63,57,17,1
35956,860,378,482,101,123,82,74,308,146,162,42,39,24,12,1
35957,361,184,177,50,53,51,22,393,186,207,58,50,36,22,1
35958,461,213,248,58,62,54,30,466,233,233,65,51,50,32,1
35959,802,449,353,102,87,82,29,194,94,100,35,19,25,16,1
35960,117,62,55,24,18,21,2,760,401,359,96,89,98,22,1
35961,370,158,212,62,49,45,18,1106,579,527,121,152,113,45,1
35962,327,177,150,40,40,38,18,885,437,448,135,130,89,36,1
35963,431,201,230,69,39,55,33,402,222,180,50,39,51,19,1
35964,908,489,419,114,131,79,46,673,317,356,101,85,76,49,1
35965,390,203,187,58,40,43,19,379,184,195,51,61,49,8,1
35966,147,72,75,26,10,17,9,377,202,175,46,50,41,22,1
35967,607,311,296,73,81,33,33,344,151,193,59,51,30,9,1
35968,938,484,454,137,100,104,41,2027,896,1131,340,313,172,86,1
35969,872,473,399,124,100,93,27,872,468,404,129,85,92,34,1
35970,304,159,145,38,40,32,3,1356,672,684,171,172,134,59,1
35971,1599,806,793,213,237,100,45,465,229,236,68,62,40,22,1
35972,764,409,355,88,73,102,43,354,166,188,53,55,40,19,1
35973,250,130,120,40,32,19,13,338,165,173,48,51,38,11,1
35974,379,203,176,55,48,45,16,524,264,260,75,75,40,21,1
35975,769,362,407,99,88,66,67,583,248,335,115,111,52,16,1
35976,657,335,322,92,65,64,29,816,463,353,99,99,61,26,1
35977,433,221,212,59,42,47,14,300,140,160,39,35,14,12,1
35978,540,271,269,80,77,51,16,235,119,116,31,26,15,13,1
35979,123,58,65,22,14,13,3,1038,470,568,130,123,86,51,1
35980,505,226,279,68,51,30,15,920,492,428,100,92,88,49,1
35981,1490,655,835,261,174,109,35,304,127,177,61,38,31,4,1
35982,927,527,400,104,123,119,43,246,108,138,32,44,21,10,1
35983,429,219,210,46,66,42,17,659,334,325,90,79,72,36,1
35984,425,210,215,56,43,52,25,728,358,370,118,100,55,29,1
35985,168,67,101,37,17,13,13,1134,539,595,150,146,78,40,1
35986,327,177,150,40,40,38,18,780,369,411,130,113,79,35,1
35987,512,248,264,66,71,49,30,875,376,499,155,125,53,39,1
35988,539,317,222,66,42,72,31,315,118,197,85,57,42,14,1
35989,847,452,395,100,94,81,36,2442,1193,1249,278,183,170,145,1
35990,1508,738,770,194,169,119,53,424,209,215,56,58,45,24,1
35991,200,106,94,24,26,18,6,393,186,207,58,50,36,22,1
35992,745,366,379,110,93,79,45,425,177,248,60,62,33,16,1
35993,512,281,231,69,48,70,23,521,265,256,69,69,61,26,1
35994,1690,795,895,271,257,150,101,778,367,411,90,85,64,43,1
35995,911,423,488,140,150,102,32,1748,791,957,281,247,173,25,1
35996,715,355,360,118,79,71,29,595,316,279,86,60,65,40,1
35997,807,359,448,114,99,93,33,509,262,247,64,70,64,20,1
35998,261,146,115,37,35,27,7,654,317,337,95,111,44,13,1
35999,423,212,211,51,44,48,28,419,175,244,71,73,23,23,1
36000,560,334,226,69,37,52,18,622,299,323,86,86,69,35,1
36001,834,405,429,112,95,84,34,1149,568,581,177,133,101,30,1
36002,672,334,338,110,93,91,41,1214,573,641,184,152,101,66,1
36003,245,112,133,32,45,20,10,755,349,406,131,80,68,28,1
36004,848,461,387,111,102,108,42,759,391,368,103,82,101,45,1
36005,215,102,113,35,20,27,16,553,275,278,56,76,60,20,1
36006,785,391,394,83,116,74,20,781,418,363,92,90,64,41,1
36007,470,199,271,78,84,33,8,586,240,346,94,110,29,19,1
36008,322,143,179,41,62,23,11,339,183,156,43,45,28,17,1
36009,509,262,247,64,70,64,20,300,136,164,44,35,33,21,1
36010,400,215,185,59,54,33,16,416,210,206,55,54,39,20,1
36011,698,345,353,104,87,81,50,258,126,132,42,32,19,26,1
36012,672,334,338,110,93,91,41,780,337,443,112,116,77,28,1
36013,426,228,198,62,42,47,22,496,272,224,70,58,42,18,1
36014,716,364,352,107,80,75,26,425,177,248,60,62,33,16,1
36015,651,323,328,90,65,64,24,788,360,428,93,106,67,72,1
36016,1338,756,582,155,105,104,44,211,113,98,38,17,25,8,1
36017,920,492,428,100,92,88,49,1690,810,880,248,238,168,67,1
36018,576,250,326,93,71,34,15,921,534,387,104,95,101,38,1
36019,317,164,153,47,33,47,12,477,256,221,69,66,70,12,1
36020,405,190,215,53,56,53,16,491,270,221,51,47,53,18,1
36021,1356,672,684,171,172,134,59,788,360,428,93,106,67,72,1
36022,615,338,277,77,69,74,35,601,313,288,42,48,25,36,1
36023,328,156,172,44,37,44,15,1014,490,524,177,137,94,38,1
36024,582,273,309,85,67,34,19,189,90,99,26,29,17,11,1
36025,131,77,54,19,12,16,9,2477,1186,1291,256,271,249,90,1
36026,190,96,94,21,17,23,10,815,418,397,97,62,70,17,1
36027,872,498,374,101,75,106,43,359,173,186,55,57,44,16,1
36028,313,166,147,47,44,41,10,483,258,225,70,53,54,20,1
36029,126,57,69,31,10,10,3,573,316,257,78,80,21,21,1
36030,400,208,192,61,51,36,16,113,54,59,10,12,13,7,1
36031,556,306,250,69,60,80,18,584,293,291,82,67,47,24,1
36032,484,254,230,60,66,56,14,372,196,176,51,36,51,8,1
36033,264,126,138,44,26,25,10,1190,638,552,162,95,112,18,1
36034,1040,460,580,156,117,116,43,1972,846,1126,222,330,114,68,1
36035,426,224,202,48,38,53,13,780,337,443,112,116,77,28,1
36036,1807,933,874,248,203,173,71,198,80,118,35,31,14,7,1
36037,1356,576,780,229,198,107,38,596,286,310,90,89,78,37,1
36038,368,195,173,52,41,42,15,724,650,74,44,3,32,3,1
36039,817,397,420,120,152,48,17,341,178,163,48,44,42,20,1
36040,331,183,148,36,44,40,21,215,105,110,26,22,19,9,1
36041,1071,549,522,133,127,130,59,505,269,236,52,59,32,18,1
36042,288,159,129,27,44,27,15,669,323,346,94,89,34,18,1
36043,776,346,430,103,102,61,40,503,263,240,72,55,51,34,1
36044,732,402,330,81,86,87,33,404,206,198,45,61,31,24,1
36045,2442,1193,1249,278,183,170,145,1427,587,840,165,165,76,49,1
36046,272,125,147,41,41,22,13,322,143,179,41,62,23,11,1
36047,307,133,174,48,53,27,10,98,32,66,15,25,5,4,1
36048,862,432,430,121,96,102,37,359,157,202,44,34,31,17,1
36049,923,420,503,128,159,100,49,1032,565,467,133,81,135,49,1
36050,501,240,261,80,62,49,42,435,233,202,43,42,39,32,1
36051,1332,637,695,214,178,117,40,1431,798,633,201,144,78,29,1
36052,391,189,202,73,47,37,8,755,348,407,109,98,49,23,1
36053,821,387,434,121,131,76,29,155,89,66,13,15,17,9,1
36054,180,96,84,21,22,17,15,327,177,150,40,40,38,18,1
36055,582,293,289,94,80,77,32,781,367,414,60,67,43,17,1
36056,309,163,146,46,22,28,14,1270,557,713,130,195,57,30,1
36057,303,137,166,54,54,31,15,840,385,455,118,137,66,39,1
36058,1893,850,1043,280,340,169,80,376,176,200,31,53,27,8,1
36059,522,273,249,62,57,51,18,163,71,92,22,38,11,7,1
36060,323,181,142,40,37,26,16,270,162,108,26,26,16,11,1
36061,590,303,287,69,65,46,17,644,329,315,70,64,50,11,1
36062,448,199,249,65,54,38,33,1441,657,784,140,135,81,73,1
36063,456,220,236,67,75,30,21,275,155,120,37,31,16,14,1
36064,733,346,387,98,113,66,26,2639,1436,1203,317,307,242,77,1
36065,247,110,137,34,45,23,10,1298,591,707,196,168,124,58,1
36066,1957,777,1180,315,263,149,46,193,99,94,31,31,16,12,1
36067,514,248,266,105,68,38,20,231,141,90,28,20,22,16,1
36068,413,194,219,77,72,28,11,740,313,427,101,135,40,22,1
36069,271,131,140,47,37,41,11,479,238,241,64,47,62,22,1
36070,1417,598,819,223,188,135,58,616,304,312,75,71,55,25,1
36071,829,472,357,82,104,78,25,781,418,363,92,90,64,41,1
36072,314,158,156,39,28,30,17,461,257,204,63,49,50,29,1
36073,759,391,368,103,82,101,45,178,100,78,23,22,30,6,1
36074,254,166,88,25,21,22,5,255,111,144,31,25,21,28,1
36075,391,189,202,73,47,37,8,118,52,66,20,15,23,2,1
36076,564,305,259,82,64,57,27,519,285,234,78,62,57,24,1
36077,368,183,185,40,42,40,15,360,192,168,55,45,48,16,1
36078,806,419,387,115,130,57,32,307,157,150,44,41,33,15,1
36079,306,132,174,73,39,22,9,239,126,113,49,18,27,5,1
36080,618,307,311,73,54,46,18,1706,830,876,265,209,230,63,1
36081,758,360,398,114,107,51,19,757,359,398,109,127,80,26,1
36082,189,90,99,26,29,17,11,1047,562,485,141,127,114,41,1
36083,1270,682,588,165,147,136,54,316,157,159,45,38,22,19,1
36084,671,318,353,83,124,46,34,2024,765,1259,283,343,137,76,1
36085,953,481,472,133,130,77,48,1106,579,527,121,152,113,45,1
36086,833,383,450,132,111,54,26,357,161,196,55,59,24,9,1
36087,284,104,180,54,81,8,10,457,237,220,69,44,53,26,1
36088,300,157,143,41,25,25,23,281,166,115,34,17,36,16,1
36089,336,154,182,51,48,39,22,654,317,337,95,111,44,13,1
36090,972,463,509,138,117,91,53,724,334,390,112,109,79,17,1
36091,685,315,370,108,99,36,9,707,391,316,111,80,54,30,1
36092,441,216,225,57,66,57,19,847,452,395,100,94,81,36,1
36093,465,220,245,88,34,61,23,457,261,196,55,27,57,34,1
36094,940,464,476,116,135,108,58,1158,481,677,169,129,86,40,1
36095,655,281,374,108,103,61,24,494,123,371,160,58,29,5,1
36096,541,269,272,75,57,59,36,142,60,82,20,28,13,5,1
36097,473,245,228,67,52,70,24,706,458,248,56,38,112,39,1
36098,461,217,244,81,69,41,20,899,453,446,149,128,78,24,1
36099,885,424,461,143,114,92,32,621,320,301,51,62,33,27,1
36100,268,144,124,33,25,29,14,387,200,187,61,54,51,16,1
36101,442,208,234,68,49,51,25,390,203,187,58,40,43,19,1
36102,175,90,85,28,21,19,7,641,215,426,164,72,115,64,1
36103,217,98,119,38,35,18,9,461,207,254,82,66,55,33,1
36104,115,60,55,16,9,9,5,126,73,53,14,9,8,6,1
36105,462,229,233,63,49,42,18,1210,592,618,157,138,116,85,1
36106,443,208,235,43,55,51,50,580,339,241,72,47,66,21,1
36107,257,140,117,46,24,15,7,428,214,214,65,67,45,23,1
36108,1203,741,462,114,97,141,46,411,235,176,65,41,53,11,1
36109,477,241,236,59,54,35,18,1141,578,563,184,171,104,34,1
36110,653,379,274,89,56,86,13,585,289,296,102,86,61,18,1
36111,1106,499,607,161,139,95,39,892,420,472,135,146,98,37,1
36112,478,239,239,65,66,65,21,183,97,86,30,18,20,12,1
36113,245,111,134,31,44,20,11,601,290,311,92,89,55,30,1
36114,288,159,129,27,44,27,15,219,124,95,22,22,23,5,1
36115,723,309,414,106,106,41,40,390,207,183,50,48,38,15,1
36116,547,267,280,80,69,44,27,467,231,236,71,65,58,18,1
36117,285,165,120,44,32,30,9,781,418,363,92,90,64,41,1
36118,537,272,265,75,83,41,29,1037,575,462,122,150,82,32,1
36119,464,242,222,61,68,36,17,512,261,251,79,73,60,21,1
36120,624,334,290,35,40,26,31,601,313,288,42,48,25,36,1
36121,1050,473,577,142,119,87,54,504,259,245,73,56,45,29,1
36122,552,285,267,74,51,69,24,592,264,328,86,85,62,41,1
36123,784,391,393,105,113,86,21,450,241,209,67,58,54,23,1
36124,834,483,351,102,83,103,22,1254,631,623,152,160,66,44,1
36125,317,164,153,47,33,47,12,379,203,176,55,48,45,16,1
36126,310,142,168,42,39,24,9,1893,850,1043,280,340,169,80,1
36127,621,310,311,100,106,77,27,279,131,148,48,34,27,15,1
36128,816,463,353,99,99,61,26,521,265,256,56,44,35,12,1
36129,391,208,183,65,49,57,17,217,94,123,29,30,23,17,1
36130,543,287,256,71,66,64,23,481,256,225,60,56,48,12,1
36131,423,222,201,60,51,51,11,1311,690,621,158,161,128,51,1
36132,595,339,256,64,36,54,24,401,226,175,53,18,38,20,1
36133,245,112,133,32,45,20,10,524,237,287,87,75,54,26,1
36134,480,256,224,67,55,26,22,713,399,314,72,76,58,39,1
36135,928,455,473,108,90,107,43,622,328,294,75,42,67,31,1
36136,525,283,242,73,62,54,28,1038,470,568,130,123,86,51,1
36137,394,202,192,44,43,38,28,453,255,198,62,49,29,19,1
36138,249,114,135,47,33,25,4,341,154,187,34,36,11,11,1
36139,1041,563,478,100,139,103,48,589,314,275,70,83,44,28,1
36140,173,110,63,35,6,9,8,497,185,312,63,92,38,28,1
36141,1039,597,442,101,110,106,33,622,299,323,86,86,69,35,1
36142,780,370,410,107,120,75,22,309,154,155,42,44,45,16,1
36143,420,197,223,72,57,54,19,859,438,421,142,80,105,43,1
36144,335,183,152,36,27,45,11,417,182,235,57,109,50,8,1
36145,1261,694,567,159,130,136,70,1037,575,462,122,150,82,32,1
36146,1098,432,666,166,199,76,28,341,178,163,48,44,42,20,1
36147,239,110,129,32,32,24,10,435,233,202,43,42,39,32,1
36148,475,238,237,73,53,63,17,926,437,489,135,107,113,42,1
36149,1042,530,512,162,150,103,52,1272,520,752,235,242,117,54,1
36150,351,184,167,59,45,54,9,351,183,168,55,44,33,9,1
36151,255,122,133,35,51,22,13,496,247,249,82,69,47,14,1
36152,88,35,53,20,14,15,3,631,288,343,102,92,70,32,1
36153,822,416,406,111,105,84,44,724,334,390,112,109,79,17,1
36154,505,296,209,55,50,45,23,434,237,197,52,64,37,14,1
36155,1835,904,931,192,144,135,63,411,171,240,61,81,30,15,1
36156,458,269,189,56,40,29,7,604,282,322,76,74,69,35,1
36157,401,227,174,65,31,42,16,623,320,303,103,85,75,15,1
36158,335,185,150,46,34,36,13,270,137,133,30,28,27,11,1
36159,641,341,300,101,91,29,22,323,169,154,47,44,39,20,1
36160,508,309,199,56,55,47,16,247,110,137,34,45,23,10,1
36161,556,279,277,83,69,71,19,351,184,167,59,45,54,9,1
36162,1830,904,926,276,245,222,100,192,101,91,25,22,18,9,1
36163,355,186,169,54,41,35,15,1748,791,957,281,247,173,25,1
36164,2024,765,1259,283,343,137,76,725,365,360,104,111,70,31,1
36165,436,201,235,54,37,34,20,361,172,189,51,54,25,4,1
36166,360,192,168,55,45,48,16,552,285,267,74,51,69,24,1
36167,140,67,73,13,16,18,8,216,119,97,33,27,28,7,1
36168,95,44,51,14,13,7,4,654,317,337,95,111,44,13,1
36169,359,163,196,47,78,47,9,536,278,258,72,63,62,20,1
36170,467,226,241,55,48,54,23,448,199,249,65,54,38,33,1
36171,976,496,480,128,111,121,48,535,249,286,79,64,55,22,1
36172,79,40,39,12,13,5,4,666,347,319,92,73,63,25,1
36173,377,224,153,52,23,51,20,1356,672,684,171,172,134,59,1
36174,582,293,289,94,80,77,32,425,199,226,54,71,56,11,1
36175,297,123,174,51,49,16,10,116,67,49,13,12,6,5,1
36176,580,302,278,71,66,65,41,349,166,183,56,30,42,31,1
36177,298,161,137,47,29,25,15,462,233,229,66,49,43,30,1
36178,788,390,398,94,118,80,18,168,67,101,37,17,13,13,1
36179,443,207,236,76,68,52,28,777,387,390,90,87,65,37,1
36180,533,254,279,81,78,52,10,845,402,443,137,126,105,47,1
36181,740,313,427,101,135,40,22,943,342,601,188,127,74,24,1
36182,940,464,476,116,135,108,58,498,174,324,112,108,33,19,1
36183,503,263,240,72,55,51,34,278,111,167,66,66,19,8,1
36184,499,252,247,74,42,55,14,205,99,106,24,29,20,5,1
36185,407,182,225,48,38,30,30,1462,652,810,243,199,115,30,1
36186,381,196,185,55,57,43,16,65,37,28,11,3,6,5,1
36187,425,243,182,54,20,51,28,402,270,132,46,9,33,18,1
36188,247,110,137,34,45,23,10,637,335,302,83,77,85,26,1
36189,800,365,435,129,102,97,31,503,263,240,72,55,51,34,1
36190,903,457,446,99,127,62,29,178,100,78,23,22,30,6,1
36191,318,176,142,25,32,35,25,583,322,261,73,66,45,26,1
36192,1129,589,540,134,122,108,46,483,155,328,138,109,32,9,1
36193,201,108,93,36,21,17,4,1336,633,703,182,197,110,52,1
36194,464,297,167,72,30,52,14,755,271,484,113,226,61,20,1
36195,183,91,92,25,20,23,7,277,141,136,35,21,16,22,1
36196,949,512,437,102,124,70,41,409,200,209,69,56,44,13,1
36197,161,75,86,21,11,17,7,1048,564,484,118,122,113,40,1
36198,1338,756,582,155,105,104,44,1290,629,661,191,187,167,55,1
36199,787,456,331,93,66,89,41,1447,814,633,171,141,183,58,1
36200,185,115,70,19,17,26,6,673,313,360,101,101,46,17,1
36201,2477,1186,1291,256,271,249,90,223,127,96,25,23,33,4,1
36202,199,101,98,22,25,9,12,623,269,354,100,86,62,24,1
36203,207,128,79,26,17,19,9,391,208,183,65,49,57,17,1
36204,179,78,101,29,22,10,8,165,80,85,21,9,18,19,1
36205,824,403,421,80,150,65,35,665,304,361,90,72,63,28,1
36206,350,178,172,49,62,29,16,281,125,156,44,47,17,7,1
36207,1333,646,687,209,179,148,45,729,391,338,80,64,71,34,1
36208,503,263,240,72,55,51,34,781,418,363,92,90,64,41,1
36209,689,484,205,73,55,18,15,698,365,333,108,83,65,21,1
36210,582,189,393,117,66,66,6,404,197,207,57,69,33,15,1
36211,657,293,364,109,75,66,28,756,348,408,101,103,60,40,1
36212,304,159,145,38,40,32,3,787,386,401,98,95,86,25,1
36213,2414,1189,1225,277,178,170,169,443,226,217,67,34,53,10,1
36214,193,83,110,26,20,16,9,1247,548,699,168,150,140,43,1
36215,788,360,428,93,106,67,72,2477,1186,1291,256,271,249,90,1
36216,2602,1424,1178,314,320,249,75,764,409,355,88,73,102,43,1
36217,742,364,378,89,107,75,25,586,254,332,114,111,55,17,1
36218,386,247,139,34,19,40,28,359,173,186,55,57,44,16,1
36219,656,358,298,67,47,64,26,248,125,123,36,20,22,11,1
36220,673,329,344,111,95,92,41,603,291,312,98,87,61,28,1
36221,168,67,101,37,17,13,13,493,208,285,75,77,70,40,1
36222,181,75,106,35,26,11,9,969,505,464,123,133,92,33,1
36223,254,117,137,33,35,38,6,81,38,43,11,12,5,5,1
36224,686,345,341,98,106,75,25,1234,590,644,180,182,95,40,1
36225,476,270,206,62,45,46,30,536,278,258,72,63,62,20,1
36226,148,75,73,25,13,9,4,766,395,371,89,86,127,27,1
36227,329,194,135,45,32,33,9,173,82,91,27,25,28,4,1
36228,593,266,327,102,84,69,24,610,281,329,54,62,65,58,1
36229,61,17,44,8,3,0,21,402,227,175,48,40,35,11,1
36230,291,131,160,49,35,32,15,480,257,223,74,26,60,27,1
36231,1356,672,684,171,172,134,59,217,109,108,34,32,35,7,1
36232,802,388,414,131,105,96,29,226,120,106,68,8,2,1,1
36233,515,253,262,46,83,57,21,1187,631,556,182,139,152,56,1
36234,465,257,208,51,61,54,23,1068,527,541,160,131,112,52,1
36235,353,195,158,40,55,30,13,601,313,288,42,48,25,36,1
36236,240,128,112,32,26,25,20,480,234,246,79,77,65,23,1
36237,918,427,491,113,111,113,33,335,143,192,45,36,32,37,1
36238,524,264,260,75,75,40,21,611,229,382,121,126,46,5,1
36239,127,62,65,13,33,7,6,172,98,74,20,21,22,8,1
36240,700,348,352,93,115,85,27,397,237,160,47,15,56,21,1
36241,390,224,166,41,27,47,19,422,245,177,50,31,42,22,1
36242,385,179,206,58,56,38,19,2948,1454,1494,327,456,140,81,1
36243,591,274,317,89,66,75,41,584,272,312,76,72,66,42,1
36244,467,240,227,65,65,51,23,671,321,350,95,87,75,34,1
36245,554,249,305,100,87,44,13,423,220,203,51,54,46,17,1
36246,470,226,244,81,53,59,39,427,204,223,38,57,26,32,1
36247,1341,481,860,275,264,57,21,475,208,267,84,67,50,20,1
36248,434,218,216,76,53,62,20,304,127,177,61,38,31,4,1
36249,225,114,111,32,29,26,6,404,197,207,57,69,33,15,1
36250,117,68,49,13,17,5,3,147,54,93,26,38,6,5,1
36251,760,391,369,101,109,65,24,178,100,78,23,22,30,6,1
36252,247,110,137,34,45,23,10,522,226,296,84,69,54,17,1
36253,489,242,247,83,63,62,19,200,89,111,26,25,17,7,1
36254,1189,559,630,179,147,118,35,583,322,261,73,66,45,26,1
36255,211,113,98,38,17,25,8,1242,613,629,174,113,114,53,1
36256,191,85,106,24,34,19,5,467,269,198,46,51,60,18,1
36257,387,193,194,51,48,50,17,163,71,92,22,38,11,7,1
36258,354,166,188,53,55,40,19,128,62,66,13,11,17,12,1
36259,323,159,164,49,28,38,22,572,309,263,64,55,47,29,1
36260,654,344,310,80,69,57,15,181,93,88,29,20,26,9,1
36261,284,173,111,28,19,49,12,189,90,99,26,29,17,11,1
36262,1464,693,771,153,136,91,86,731,383,348,102,84,68,30,1
36263,435,182,253,71,79,38,16,974,509,465,136,121,122,40,1
36264,290,127,163,47,58,23,12,422,203,219,75,49,40,22,1
36265,479,227,252,65,79,42,26,756,348,408,101,103,60,40,1
36266,211,92,119,33,44,11,7,124,58,66,20,28,11,7,1
36267,391,208,183,65,49,57,17,640,279,361,102,83,69,21,1
36268,1490,655,835,261,174,109,35,248,118,130,54,31,26,5,1
36269,689,484,205,73,55,18,15,1487,996,491,147,141,50,35,1
36270,335,155,180,64,48,36,10,633,303,330,95,91,51,13,1
36271,963,447,516,120,146,87,74,317,156,161,49,51,18,10,1
36272,474,224,250,50,72,51,43,595,316,279,86,60,65,40,1
36273,440,255,185,67,28,24,6,140,76,64,17,13,13,8,1
36274,482,231,251,76,81,64,26,2524,1232,1292,398,317,186,61,1
36275,2442,1193,1249,278,183,170,145,595,316,279,86,60,65,40,1
36276,510,264,246,67,66,38,29,3144,1617,1527,367,342,278,136,1
36277,246,115,131,15,29,10,32,654,344,310,80,69,57,15,1
36278,814,454,360,93,73,60,22,175,88,87,29,29,23,6,1
36279,922,491,431,112,92,97,52,415,209,206,60,67,39,18,1
36280,948,484,464,134,131,75,27,892,420,472,135,146,98,37,1
36281,256,134,122,29,42,14,7,2549,1331,1218,366,296,271,130,1
36282,422,203,219,75,49,40,22,247,110,137,34,45,23,10,1
36283,606,279,327,81,70,49,34,233,94,139,36,37,15,8,1
36284,745,360,385,115,111,63,33,206,94,112,37,36,18,9,1
36285,168,90,78,22,19,13,4,769,329,440,116,66,55,22,1
36286,271,131,140,47,37,41,11,339,170,169,32,17,24,13,1
36287,504,256,248,78,70,36,9,245,111,134,31,44,20,11,1
36288,624,308,316,92,72,68,22,364,182,182,49,30,41,14,1
36289,1523,709,814,204,150,128,122,1378,680,698,160,154,111,38,1
36290,465,228,237,64,42,63,24,492,194,298,99,99,56,16,1
36291,135,65,70,21,25,15,9,425,199,226,54,71,56,11,1
36292,95,44,51,14,13,7,4,331,169,162,40,28,22,14,1
36293,778,367,411,90,85,64,43,509,262,247,64,70,64,20,1
36294,1061,440,621,189,149,153,72,930,367,563,181,153,83,48,1
36295,459,206,253,56,66,32,17,469,225,244,64,69,26,11,1
36296,604,275,329,95,69,52,25,187,80,107,34,36,19,8,1
36297,395,197,198,44,57,27,18,2035,1087,948,163,129,96,73,1
36298,516,298,218,62,57,49,19,540,282,258,50,53,33,16,1
36299,2035,1087,948,163,129,96,73,1273,592,681,199,164,139,39,1
36300,1477,738,739,176,176,145,72,2839,1321,1518,400,328,170,90,1
36301,191,99,92,25,24,18,8,502,299,203,57,52,32,11,1
36302,127,58,69,20,30,6,7,362,181,181,67,46,43,8,1
36303,501,216,285,79,70,54,30,770,355,415,103,142,75,42,1
36304,618,381,237,73,44,117,27,143,81,62,28,9,8,1,1
36305,589,256,333,112,67,63,28,882,432,450,115,111,68,44,1
36306,132,69,63,16,14,6,15,117,65,52,15,16,10,4,1
36307,651,306,345,85,64,61,32,435,208,227,68,64,53,23,1
36308,184,115,69,21,17,6,5,568,243,325,98,73,56,44,1
36309,900,484,416,119,110,77,29,467,240,227,65,65,51,23,1
36310,392,115,277,117,75,28,17,689,336,353,99,92,79,31,1
36311,210,115,95,22,26,15,7,205,114,91,25,24,20,15,1
36312,729,358,371,116,99,89,33,425,177,248,60,62,33,16,1
36313,340,158,182,51,56,9,7,882,432,450,115,111,68,44,1
36314,400,191,209,51,60,30,9,456,228,228,49,70,32,19,1
36315,2524,1232,1292,398,317,186,61,789,362,427,90,82,70,35,1
36316,511,294,217,59,54,48,18,991,483,508,166,120,94,42,1
36317,731,340,391,95,83,81,32,347,212,135,35,32,17,6,1
36318,197,82,115,27,22,29,7,626,272,354,96,80,71,36,1
36319,146,75,71,13,32,15,11,515,259,256,79,58,46,21,1
36320,462,251,211,74,53,41,18,170,35,135,33,25,8,5,1
36321,1907,1008,899,235,224,195,73,1382,689,693,186,176,167,77,1
36322,338,179,159,44,45,42,16,119,57,62,18,16,17,4,1
36323,579,330,249,52,27,90,11,339,181,158,31,26,40,15,1
36324,476,233,243,76,61,52,21,854,380,474,137,159,81,31,1
36325,902,526,376,94,103,78,23,2442,1193,1249,278,183,170,145,1
36326,275,125,150,37,48,27,7,58,23,35,14,8,5,7,1
36327,673,329,344,111,95,92,41,593,266,327,102,84,69,24,1
36328,1094,508,586,152,151,77,36,388,234,154,43,35,47,20,1
36329,919,376,543,129,122,55,30,313,157,156,39,26,34,29,1
36330,467,269,198,46,51,60,18,2556,1169,1387,248,291,227,275,1
36331,350,200,150,45,47,23,8,4374,2058,2316,531,605,321,183,1
36332,734,366,368,121,99,63,39,861,393,468,150,101,69,35,1
36333,97,55,42,15,13,11,2,445,235,210,60,31,63,28,1
36334,311,145,166,43,37,45,14,291,131,160,40,42,36,14,1
36335,1382,689,693,186,176,167,77,149,68,81,15,38,11,10,1
36336,921,455,466,144,127,108,39,220,102,118,26,32,27,10,1
36337,161,74,87,17,46,12,13,182,71,111,45,36,11,13,1
36338,426,213,213,60,56,46,24,271,131,140,47,37,41,11,1
36339,555,277,278,84,56,66,23,247,127,120,43,20,27,14,1
36340,976,520,456,120,115,109,53,784,391,393,105,113,86,21,1
36341,432,181,251,48,75,27,17,619,332,287,95,77,74,38,1
36342,994,474,520,129,130,108,69,1024,507,517,141,122,119,46,1
36343,425,210,215,56,43,52,25,505,226,279,68,51,30,15,1
36344,401,198,203,70,29,38,15,839,387,452,128,129,75,41,1
36345,517,250,267,78,37,64,29,2442,1193,1249,278,183,170,145,1
36346,3056,1457,1599,438,389,329,168,708,303,405,115,115,70,23,1
36347,95,44,51,14,13,7,4,283,142,141,35,29,32,5,1
36348,1190,638,552,162,95,112,18,334,155,179,47,34,38,11,1
36349,236,141,95,36,32,14,6,467,226,241,55,48,54,23,1
36350,203,93,110,36,26,18,9,552,285,267,74,51,69,24,1
36351,1729,863,866,188,254,101,37,1327,690,637,194,140,130,52,1
36352,726,338,388,129,92,46,22,652,272,380,116,113,55,27,1
36353,1284,511,773,227,166,169,107,552,285,267,74,51,69,24,1
36354,930,367,563,181,153,83,48,601,313,288,42,48,25,36,1
36355,676,333,343,111,89,94,39,536,278,258,72,63,62,20,1
36356,851,417,434,109,116,83,28,1132,553,579,172,143,150,57,1
36357,1675,875,800,213,219,196,72,652,332,320,72,59,57,24,1
36358,589,294,295,37,44,27,33,505,286,219,54,51,64,27,1
36359,261,139,122,30,33,23,6,906,455,451,116,105,87,46,1
36360,347,183,164,55,45,51,16,364,183,181,53,44,46,14,1
36361,330,159,171,48,38,50,19,637,335,302,83,77,85,26,1
36362,413,194,219,77,72,28,11,315,118,197,85,57,42,14,1
36363,380,184,196,58,52,46,8,588,331,257,86,71,52,12,1
36364,815,382,433,97,50,88,31,107,36,71,27,15,0,1,1
36365,723,380,343,80,84,47,18,2491,1175,1316,303,302,273,147,1
36366,815,418,397,97,62,70,17,539,241,298,100,64,54,34,1
36367,292,152,140,46,38,35,12,393,210,183,55,50,34,19,1
36368,360,192,168,55,45,48,16,380,187,193,38,51,30,18,1
36369,321,180,141,47,37,33,12,643,282,361,94,109,59,24,1
36370,759,391,368,103,82,101,45,193,99,94,31,31,16,12,1
36371,582,293,289,94,80,77,32,1616,735,881,285,248,153,72,1
36372,154,75,79,17,24,16,13,128,54,74,30,13,8,7,1
36373,539,269,270,60,71,41,23,249,90,159,29,89,12,4,1
36374,976,496,480,128,111,121,48,982,494,488,150,117,91,45,1
36375,840,385,455,118,137,66,39,529,274,255,57,62,38,14,1
36376,832,428,404,131,89,88,38,202,103,99,28,20,12,8,1
36377,254,134,120,34,27,26,14,551,298,253,63,65,45,19,1
36378,768,378,390,105,104,63,26,119,67,52,15,15,7,7,1
36379,434,201,233,58,46,38,19,243,114,129,37,30,32,8,1
36380,164,78,86,28,23,12,8,160,76,84,20,25,16,10,1
36381,639,373,266,77,89,68,25,1030,368,662,172,188,56,20,1
36382,608,336,272,61,49,78,31,136,66,70,33,11,9,3,1
36383,448,281,167,47,37,45,13,808,484,324,80,63,76,24,1
36384,288,159,129,27,44,27,15,487,247,240,73,42,42,22,1
36385,251,144,107,33,23,23,8,894,420,474,136,146,93,39,1
36386,405,180,225,72,57,31,12,416,228,188,63,25,40,20,1
36387,168,76,92,26,21,19,4,239,146,93,30,22,35,9,1
36388,335,128,207,59,43,24,23,140,86,54,17,6,20,7,1
36389,210,105,105,35,26,20,9,351,184,167,59,45,54,9,1
36390,639,322,317,73,82,39,23,181,96,85,25,23,20,7,1
36391,494,266,228,64,60,58,28,989,508,481,139,117,114,41,1
36392,198,96,102,32,13,14,18,670,333,337,95,79,62,21,1
36393,458,224,234,51,65,31,19,469,225,244,64,69,26,11,1
36394,936,396,540,96,166,77,29,825,422,403,100,90,62,43,1
36395,476,227,249,52,59,38,17,206,100,106,28,32,18,8,1
36396,381,191,190,55,61,33,11,930,367,563,181,153,83,48,1
36397,335,143,192,45,36,32,37,537,276,261,75,68,68,22,1
36398,758,360,398,114,107,51,19,332,173,159,48,40,31,11,1
36399,168,120,48,7,5,20,7,601,313,288,42,48,25,36,1
36400,425,210,215,56,43,52,25,920,492,428,100,92,88,49,1
36401,427,204,223,38,57,26,32,831,426,405,101,102,105,32,1
36402,625,286,339,92,59,83,42,622,299,323,86,86,69,35,1
36403,1649,796,853,250,234,175,53,465,225,240,65,44,65,25,1
36404,1235,584,651,140,226,82,52,505,247,258,72,71,60,27,1
36405,428,226,202,52,60,75,20,441,218,223,69,55,50,27,1
36406,406,202,204,54,54,41,16,334,172,162,43,39,41,17,1
36407,756,265,491,129,127,51,17,462,233,229,66,49,43,30,1
36408,267,161,106,22,25,35,20,1342,673,669,178,154,137,94,1
36409,770,390,380,104,76,78,32,631,315,316,64,57,49,15,1
36410,267,161,106,22,25,35,20,208,107,101,42,22,18,10,1
36411,1432,652,780,217,205,131,81,1014,490,524,177,137,94,38,1
36412,173,110,63,35,6,9,8,299,140,159,27,59,20,18,1
36413,530,259,271,83,50,54,41,139,62,77,23,6,14,4,1
36414,346,183,163,51,38,23,6,211,114,97,32,24,19,10,1
36415,985,466,519,153,122,73,26,425,210,215,56,43,52,25,1
36416,716,354,362,102,87,77,30,720,357,363,113,85,62,39,1
36417,501,240,261,80,62,49,42,346,165,181,69,43,22,9,1
36418,592,275,317,100,86,57,31,672,334,338,110,93,91,41,1
36419,1447,698,749,214,180,116,46,606,307,299,92,56,68,30,1
36420,512,261,251,79,73,60,21,412,223,189,55,55,41,10,1
36421,963,468,495,155,164,92,40,683,304,379,140,101,48,19,1
36422,281,125,156,44,47,17,7,751,312,439,131,115,78,48,1
36423,675,311,364,111,80,96,30,708,306,402,116,118,44,41,1
36424,467,221,246,98,68,43,11,390,207,183,50,48,38,15,1
36425,395,222,173,48,42,21,8,1073,547,526,60,60,47,19,1
36426,224,108,116,31,32,22,8,149,68,81,15,38,11,10,1
36427,556,300,256,58,73,55,22,1265,580,685,205,188,166,53,1
36428,314,158,156,39,28,30,17,356,161,195,52,57,40,17,1
36429,333,167,166,45,30,34,14,536,278,258,72,63,62,20,1
36430,2799,1324,1475,369,371,215,124,876,457,419,88,124,67,47,1
36431,604,255,349,100,72,55,26,637,321,316,70,96,30,18,1
36432,204,103,101,16,32,22,8,233,120,113,38,32,20,15,1
36433,489,253,236,73,36,62,17,505,269,236,52,59,32,18,1
36434,526,264,262,77,71,61,27,1271,599,672,194,175,118,47,1
36435,1032,526,506,129,117,119,47,461,227,234,61,47,54,33,1
36436,391,189,202,73,47,37,8,266,110,156,50,28,43,7,1
36437,875,421,454,124,142,98,43,393,186,207,58,50,36,22,1
36438,360,192,168,55,45,48,16,443,248,195,67,54,40,15,1
36439,476,199,277,82,80,49,24,529,274,255,57,62,38,14,1
36440,273,148,125,26,41,30,11,505,254,251,80,77,60,15,1
36441,473,303,170,50,20,107,25,1159,641,518,148,115,114,48,1
36442,894,492,402,95,103,88,42,267,130,137,31,18,19,13,1
36443,240,134,106,34,35,15,13,437,210,227,73,62,38,19,1
36444,653,389,264,69,59,51,19,294,148,146,35,33,25,14,1
36445,840,411,429,122,101,79,34,863,418,445,127,114,70,31,1
36446,681,322,359,100,87,71,26,2286,1154,1132,338,314,278,103,1
36447,1134,539,595,150,146,78,40,870,418,452,121,102,109,28,1
36448,806,436,370,101,100,76,34,770,374,396,95,91,79,41,1
36449,402,169,233,70,36,34,18,440,246,194,62,49,41,16,1
36450,183,89,94,19,24,22,15,2871,1218,1653,290,374,238,414,1
36451,424,209,215,56,58,45,24,425,210,215,56,43,52,25,1
36452,498,244,254,81,67,58,19,393,186,207,58,50,36,22,1
36453,295,143,152,38,47,22,25,164,78,86,28,23,12,8,1
36454,214,109,105,31,26,25,17,552,285,267,74,51,69,24,1
36455,1416,545,871,279,247,84,54,3312,1761,1551,403,345,309,127,1
36456,340,176,164,50,50,33,13,616,304,312,75,71,55,25,1
36457,756,368,388,114,99,89,30,206,92,114,37,36,19,7,1
36458,777,387,390,90,87,65,37,589,294,295,37,44,27,33,1
36459,940,452,488,170,105,97,31,718,390,328,93,86,94,30,1
36460,349,166,183,58,32,38,33,585,354,231,66,39,80,42,1
36461,200,100,100,28,36,24,12,1103,651,452,144,118,96,44,1
36462,772,417,355,118,92,80,23,341,154,187,34,36,11,11,1
36463,427,205,222,53,52,51,22,825,427,398,79,95,81,48,1
36464,1480,789,691,195,151,173,55,491,283,208,55,61,40,13,1
36465,926,435,491,133,132,85,17,1243,650,593,158,159,98,55,1
36466,1102,511,591,171,179,148,52,1721,838,883,241,218,144,54,1
36467,444,189,255,72,82,45,17,505,268,237,68,59,34,15,1
36468,385,181,204,48,41,52,36,610,281,329,54,62,65,58,1
36469,439,205,234,64,88,41,21,782,372,410,127,111,89,36,1
36470,467,269,198,46,51,60,18,2003,1022,981,195,194,164,229,1
36471,537,276,261,75,68,68,22,583,322,261,73,66,45,26,1
36472,451,239,212,53,64,56,22,313,157,156,39,26,34,29,1
36473,1015,497,518,141,148,72,39,536,230,306,64,88,40,12,1
36474,130,55,75,21,26,10,3,1074,538,536,190,131,157,35,1
36475,317,153,164,39,30,35,13,930,477,453,111,92,92,29,1
36476,468,215,253,65,60,34,13,1071,549,522,133,127,130,59,1
36477,508,268,240,92,58,56,21,512,261,251,79,73,60,21,1
36478,471,246,225,46,38,52,30,740,385,355,114,97,91,27,1
36479,1140,586,554,130,146,117,49,597,243,354,97,105,63,20,1
36480,517,250,267,78,37,64,29,475,235,240,77,58,43,22,1
36481,218,133,85,20,19,13,6,124,58,66,20,28,11,7,1
36482,794,407,387,86,120,76,16,790,379,411,99,116,81,23,1
36483,483,236,247,82,60,43,18,462,233,229,66,49,43,30,1
36484,980,537,443,125,99,98,50,908,488,420,115,97,111,43,1
36485,538,252,286,77,87,53,30,583,279,304,99,71,59,31,1
36486,337,146,191,55,21,34,22,2224,1037,1187,288,276,273,74,1
36487,768,378,390,105,104,63,26,979,534,445,83,77,80,24,1
36488,360,192,168,55,45,48,16,473,245,228,67,52,70,24,1
36489,416,210,206,55,54,39,20,105,53,52,23,11,12,6,1
36490,770,356,414,123,102,66,25,1074,538,536,154,140,111,51,1
36491,1271,599,672,194,175,118,47,245,111,134,31,44,20,11,1
36492,486,199,287,79,91,52,18,281,166,115,34,17,36,16,1
36493,1181,612,569,107,121,123,43,744,569,175,71,37,51,25,1
36494,229,105,124,36,33,12,4,365,186,179,48,47,42,13,1
36495,452,236,216,73,54,50,29,825,363,462,97,105,72,75,1
36496,135,65,70,21,25,15,9,600,281,319,98,68,38,13,1
36497,281,154,127,45,31,24,9,1093,567,526,122,75,71,46,1
36498,538,252,286,77,87,53,30,360,192,168,55,45,48,16,1
36499,178,100,78,23,22,30,6,1356,672,684,171,172,134,59,1
36500,390,191,199,57,49,45,25,230,115,115,30,33,29,8,1
36501,427,218,209,61,53,45,26,344,168,176,65,44,33,15,1
36502,752,313,439,121,106,68,27,710,307,403,117,176,37,9,1
36503,1215,572,643,151,105,127,54,440,235,205,34,61,36,13,1
36504,756,348,408,101,103,60,40,724,320,404,120,147,67,25,1
36505,1210,592,618,157,138,116,85,202,86,116,33,29,26,10,1
36506,852,316,536,183,102,131,58,467,224,243,70,43,67,23,1
36507,379,203,176,55,48,45,16,686,270,416,134,77,92,48,1
36508,487,223,264,81,68,63,15,245,111,134,31,44,20,11,1
36509,697,373,324,105,83,95,38,483,283,200,56,51,45,18,1
36510,242,125,117,38,31,28,22,632,326,306,92,71,56,19,1
36511,522,239,283,75,88,45,11,425,244,181,38,26,60,26,1
36512,1100,474,626,197,143,126,41,1009,506,503,146,141,97,55,1
36513,367,167,200,63,42,60,17,163,71,92,22,38,11,7,1
36514,282,135,147,36,49,25,10,360,192,168,55,45,48,16,1
36515,624,308,316,92,72,68,22,164,88,76,27,20,17,6,1
36516,1706,830,876,265,209,230,63,525,245,280,59,72,47,21,1
36517,1258,531,727,218,216,108,35,486,236,250,73,67,59,16,1
36518,660,332,328,84,73,47,19,551,298,253,63,65,45,19,1
36519,737,363,374,119,101,85,41,1941,818,1123,351,358,141,64,1
36520,629,338,291,92,57,64,22,729,391,338,80,64,71,34,1
36521,1071,549,522,133,127,130,59,465,225,240,65,44,65,25,1
36522,183,91,92,21,29,16,10,503,263,240,72,55,51,34,1
36523,651,307,344,74,130,45,18,2804,1163,1641,470,400,203,116,1
36524,677,245,432,129,155,72,11,836,502,334,112,76,110,11,1
36525,303,137,166,54,54,31,15,641,324,317,88,92,49,14,1
36526,636,336,300,94,65,58,32,317,153,164,39,30,35,13,1
36527,469,253,216,49,51,48,18,80,42,38,12,7,7,4,1
36528,520,279,241,62,72,35,25,622,305,317,91,80,65,28,1
36529,848,461,387,111,102,108,42,1290,629,661,191,187,167,55,1
36530,457,228,229,64,36,52,21,291,120,171,63,39,26,6,1
36531,524,295,229,69,58,36,12,221,89,132,44,21,25,14,1
36532,885,424,461,143,114,92,32,775,443,332,109,86,86,20,1
36533,1756,697,1059,328,345,110,27,1497,881,616,151,117,94,40,1
36534,1094,508,586,152,151,77,36,1085,529,556,149,133,126,54,1
36535,292,152,140,46,38,35,12,758,362,396,115,102,35,13,1
36536,864,429,435,129,118,68,35,278,148,130,36,29,25,16,1
36537,653,309,344,107,75,49,14,538,274,264,84,67,52,35,1
36538,379,203,176,55,48,45,16,794,390,404,103,95,86,23,1
36539,136,66,70,26,11,7,5,86,40,46,16,13,9,7,1
36540,702,298,404,134,111,48,18,425,210,215,56,43,52,25,1
36541,822,416,406,111,105,84,44,744,385,359,125,89,90,23,1
36542,2025,914,1111,330,281,206,85,1270,557,713,130,195,57,30,1
36543,1134,539,595,150,146,78,40,543,287,256,71,66,64,23,1
36544,180,96,84,21,22,17,15,467,250,217,59,52,41,19,1
36545,905,421,484,110,119,105,34,864,413,451,105,125,76,16,1
36546,821,394,427,122,117,109,38,2725,1490,1235,339,333,254,78,1
36547,386,247,139,34,19,40,28,359,174,185,54,56,43,16,1
36548,522,285,237,68,38,73,29,97,53,44,13,12,7,5,1
36549,614,305,309,96,73,65,24,1424,650,774,152,124,95,87,1
36550,756,362,394,102,104,73,25,810,331,479,142,119,34,28,1
36551,1298,591,707,196,168,124,58,1067,566,501,108,72,106,59,1
36552,1771,864,907,239,217,158,63,303,159,144,40,35,35,8,1
36553,394,202,192,44,43,38,28,636,336,300,94,65,58,32,1
36554,2339,1260,1079,336,252,279,106,354,168,186,50,53,39,20,1
36555,3664,1638,2026,598,519,231,63,668,331,337,108,64,58,29,1
36556,217,109,108,34,32,35,7,665,297,368,111,107,34,12,1
36557,480,234,246,79,77,65,23,407,217,190,50,44,54,19,1
36558,1194,646,548,139,125,127,59,335,185,150,46,34,36,13,1
36559,125,67,58,11,11,6,19,389,239,150,45,20,46,22,1
36560,391,208,183,65,49,57,17,390,191,199,66,49,43,12,1
36561,95,44,51,14,13,7,4,325,159,166,42,43,48,15,1
36562,577,342,235,63,57,23,37,589,294,295,37,44,27,33,1
36563,619,332,287,95,77,74,38,503,298,205,62,28,20,4,1
36564,463,236,227,64,50,44,29,598,322,276,67,57,63,26,1
36565,264,122,142,33,29,13,13,529,264,265,59,68,41,17,1
36566,656,358,298,67,47,64,26,191,103,88,23,14,23,10,1
36567,495,233,262,64,39,49,32,1047,562,485,141,127,114,41,1
36568,720,357,363,113,85,62,39,956,405,551,170,171,64,35,1
36569,1411,472,939,252,262,58,31,215,105,110,27,22,20,9,1
36570,384,212,172,44,43,34,14,379,203,176,55,48,45,16,1
36571,482,269,213,43,37,65,25,1663,835,828,224,213,163,63,1
36572,407,207,200,53,36,38,8,654,344,310,80,69,57,15,1
36573,297,141,156,32,18,31,15,457,261,196,55,27,57,34,1
36574,245,112,133,32,45,20,10,434,233,201,61,55,37,15,1
36575,583,322,261,73,66,45,26,430,192,238,62,67,27,10,1
36576,467,226,241,55,48,54,23,136,72,64,22,16,7,3,1
36577,2871,1218,1653,290,374,238,414,2912,1266,1646,268,360,243,422,1
36578,785,374,411,56,42,38,25,213,107,106,28,41,19,5,1
36579,1395,627,768,172,263,141,59,407,240,167,38,29,67,26,1
36580,870,433,437,133,121,95,25,574,356,218,61,44,87,39,1
36581,707,359,348,122,89,63,20,1162,515,647,191,143,97,35,1
36582,1462,652,810,243,199,115,30,895,474,421,122,93,69,25,1
36583,125,68,57,19,18,18,6,528,268,260,81,77,36,22,1
36584,624,308,316,92,72,68,22,359,157,202,44,34,31,17,1
36585,855,420,435,139,134,109,35,1493,672,821,258,211,146,47,1
36586,2175,1078,1097,364,275,271,81,381,191,190,55,61,33,11,1
36587,834,405,429,112,95,84,34,860,427,433,132,100,81,30,1
36588,309,154,155,42,44,45,16,118,56,62,13,14,6,6,1
36589,340,169,171,49,42,31,14,367,161,206,70,48,41,19,1
36590,554,254,300,104,58,66,28,246,115,131,15,29,10,32,1
36591,560,254,306,78,67,75,47,1691,1159,532,160,109,95,46,1
36592,607,303,304,86,78,66,26,625,285,340,90,89,67,26,1
36593,366,213,153,48,27,42,17,344,138,206,46,48,24,43,1
36594,298,154,144,44,34,25,11,168,67,101,37,17,13,13,1
36595,379,203,176,55,48,45,16,310,161,149,34,31,35,12,1
36596,163,71,92,33,26,5,7,331,169,162,40,28,22,14,1
36597,1194,646,548,139,125,127,59,326,217,109,32,20,43,18,1
36598,662,306,356,90,82,73,28,418,213,205,54,70,38,18,1
36599,1320,566,754,235,198,122,36,595,268,327,92,87,54,27,1
36600,278,110,168,58,49,29,5,764,277,487,158,162,64,31,1
36601,360,192,168,55,45,48,16,335,128,207,51,60,16,8,1
36602,284,109,175,55,79,9,9,968,498,470,129,133,115,37,1
36603,360,192,168,55,45,48,16,724,325,399,98,92,64,24,1
36604,2261,1217,1044,271,243,267,101,870,433,437,133,121,95,25,1
36605,427,191,236,67,60,41,34,117,60,57,24,19,21,2,1
36606,1071,549,522,133,127,130,59,861,393,468,150,101,69,35,1
36607,658,342,316,94,78,76,26,680,368,312,86,81,81,34,1
36608,420,214,206,58,44,32,24,3969,1703,2266,619,432,259,144,1
36609,452,224,228,69,56,50,31,1498,615,883,226,244,60,46,1
36610,546,267,279,90,69,56,19,433,237,196,60,52,33,27,1
36611,440,246,194,62,49,41,16,3144,1617,1527,367,342,278,136,1
36612,1363,690,673,185,172,152,62,217,109,108,34,32,35,7,1
36613,312,158,154,45,49,29,14,744,384,360,104,96,57,31,1
36614,706,300,406,94,74,61,22,383,204,179,61,32,54,16,1
36615,1791,870,921,217,230,203,112,552,285,267,74,51,69,24,1
36616,401,198,203,70,29,38,15,201,42,159,19,3,2,75,1
36617,402,205,197,62,48,38,19,624,222,402,92,81,39,15,1
36618,627,314,313,61,59,71,22,1074,538,536,154,140,111,51,1
36619,341,190,151,50,41,23,15,213,91,122,42,30,23,12,1
36620,669,342,327,96,75,48,32,4544,2024,2520,579,628,480,403,1
36621,920,492,428,100,92,88,49,249,114,135,47,33,25,4,1
36622,805,338,467,109,145,49,25,403,188,215,70,42,41,11,1
36623,451,222,229,72,46,57,17,245,111,134,31,44,20,11,1
36624,697,356,341,82,58,70,25,624,308,316,92,72,68,22,1
36625,429,219,210,46,66,42,17,1075,594,481,132,108,101,42,1
36626,1248,584,664,184,164,155,67,233,121,112,24,31,30,7,1
36627,1591,734,857,229,225,171,75,315,150,165,52,36,22,15,1
36628,432,188,244,76,81,26,13,694,260,434,122,92,62,36,1
36629,290,134,156,47,31,21,13,411,208,203,63,44,52,19,1
36630,504,222,282,71,64,53,29,390,190,200,66,50,43,12,0
36631,325,152,173,43,47,28,17,483,258,225,70,53,54,20,0
36632,1505,680,825,202,204,73,32,647,324,323,101,80,76,43,0
36633,2109,999,1110,332,294,187,89,405,181,224,71,57,31,12,0
36634,640,308,332,91,102,49,21,317,161,156,50,36,47,12,0
36635,331,165,166,52,34,48,22,732,366,366,108,86,74,41,0
36636,368,154,214,80,52,41,16,367,218,149,45,43,42,16,0
36637,319,153,166,61,52,26,12,169,74,95,33,26,22,3,0
36638,239,146,93,30,22,35,9,577,217,360,100,116,32,24,0
36639,340,181,159,44,39,35,21,403,233,170,38,29,21,14,0
36640,380,185,195,68,54,32,16,106,46,60,29,13,14,5,0
36641,2279,996,1283,375,328,158,60,198,86,112,36,27,23,9,0
36642,413,206,207,38,55,19,10,710,375,335,95,94,110,28,0
36643,371,143,228,77,48,29,26,213,129,84,32,14,21,15,0
36644,193,107,86,13,20,13,6,317,161,156,40,49,41,11,0
36645,384,198,186,58,48,37,12,260,133,127,43,32,39,3,0
36646,269,127,142,43,24,34,26,858,398,460,126,138,75,39,0
36647,359,167,192,49,37,27,19,242,124,118,39,32,28,22,0
36648,469,221,248,49,60,55,21,301,168,133,49,37,34,11,0
36649,380,185,195,68,54,32,16,501,274,227,63,58,53,20,0
36650,793,355,438,134,117,77,43,497,257,240,71,63,62,16,0
36651,674,268,406,118,96,70,21,180,108,72,22,22,15,5,0
36652,1047,443,604,162,156,78,52,188,88,100,53,12,15,6,0
36653,532,291,241,83,36,79,25,528,276,252,86,78,49,17,0
36654,374,187,187,51,52,40,27,138,69,69,28,7,10,10,0
36655,325,177,148,40,24,23,13,425,177,248,60,62,33,16,0
36656,166,59,107,36,41,10,4,647,350,297,95,79,77,29,0
36657,280,156,124,36,19,20,13,508,262,246,66,67,51,20,0
36658,381,146,235,74,48,47,34,783,406,377,102,91,57,29,0
36659,143,81,62,28,9,8,1,337,152,185,49,54,42,21,0
36660,1130,614,516,129,138,98,42,729,358,371,116,99,89,33,0
36661,1912,880,1032,331,334,180,84,295,158,137,42,34,38,14,0
36662,530,259,271,83,50,54,41,317,161,156,50,36,47,12,0
36663,1235,584,651,140,226,82,52,549,273,276,74,68,72,24,0
36664,391,203,188,49,34,36,9,384,204,180,53,47,49,17,0
36665,524,361,163,41,8,28,16,296,140,156,49,40,42,19,0
36666,411,211,200,61,46,35,18,783,406,377,102,91,57,29,0
36667,559,217,342,105,86,42,16,265,134,131,48,34,33,15,0
36668,128,67,61,29,9,9,1,378,154,224,74,84,35,22,0
36669,193,95,98,33,17,25,17,334,181,153,56,31,28,18,0
36670,362,181,181,67,46,43,8,1755,905,850,214,196,183,79,0
36671,1226,513,713,184,147,87,43,1034,495,539,150,134,114,71,0
36672,158,85,73,24,18,18,8,133,61,72,21,19,13,4,0
36673,1208,575,633,187,204,117,41,363,180,183,60,34,10,6,0
36674,2286,1154,1132,338,314,278,103,508,253,255,73,60,50,13,0
36675,502,236,266,66,66,58,17,344,190,154,34,31,36,10,0
36676,3969,1703,2266,619,432,259,144,903,436,467,128,116,83,33,0
36677,125,57,68,31,10,10,3,329,196,133,41,36,31,15,0
36678,1220,575,645,208,179,99,56,903,436,467,128,116,83,33,0
36679,340,181,159,44,39,35,21,926,425,501,159,147,77,35,0
36680,507,242,265,53,44,31,22,169,74,95,33,26,22,3,0
36681,437,230,207,41,55,27,13,1262,653,609,169,165,152,50,0
36682,372,171,201,47,53,39,18,230,113,117,31,40,28,10,0
36683,209,75,134,53,48,20,9,322,180,142,45,38,28,7,0
36684,270,166,104,30,26,28,14,334,181,153,56,31,28,18,0
36685,482,245,237,69,64,66,24,1025,549,476,118,109,88,61,0
36686,347,212,135,35,32,17,6,1101,626,475,145,122,120,50,0
36687,802,375,427,133,103,81,41,231,126,105,37,26,29,6,0
36688,338,139,199,54,54,18,11,715,345,370,110,97,64,25,0
36689,439,183,256,60,64,36,14,277,163,114,33,24,21,16,0
36690,179,78,101,29,22,10,8,978,536,442,132,107,67,32,0
36691,516,224,292,79,29,45,33,192,110,82,33,21,10,3,0
36692,618,289,329,97,86,70,17,1338,720,618,179,145,141,85,0
36693,304,149,155,46,32,39,14,127,58,69,18,17,10,5,0
36694,548,310,238,72,62,54,13,364,189,175,58,41,35,17,0
36695,134,60,74,19,13,10,7,536,222,314,101,100,34,22,0
36696,688,310,378,130,82,78,47,166,102,64,19,14,17,2,0
36697,269,127,142,43,24,34,26,758,319,439,101,123,78,25,0
36698,130,70,60,30,9,8,1,418,223,195,51,45,49,14,0
36699,502,250,252,70,47,57,15,134,72,62,14,28,8,4,0
36700,178,74,104,31,28,9,4,295,160,135,44,36,46,16,0
36701,235,100,135,36,25,30,8,257,139,118,64,17,24,7,0
36702,747,360,387,125,92,69,32,545,269,276,80,76,27,32,0
36703,380,148,232,81,69,24,8,396,197,199,75,49,49,16,0
36704,496,210,286,111,55,74,13,178,69,109,29,25,21,13,0
36705,529,290,239,54,63,85,15,758,319,439,101,123,78,25,0
36706,282,160,122,36,28,27,7,715,348,367,109,84,68,30,0
36707,469,221,248,49,60,55,21,144,67,77,28,14,9,8,0
36708,524,270,254,84,72,70,23,138,69,69,28,7,10,10,0
36709,437,230,207,41,55,27,13,127,66,61,13,14,19,8,0
36710,170,82,88,32,23,22,8,858,461,397,125,114,79,45,0
36711,1616,735,881,285,248,153,72,425,177,248,60,62,33,16,0
36712,631,316,315,64,57,49,15,384,212,172,44,43,34,14,0
36713,854,435,419,118,91,95,42,292,143,149,38,42,36,16,0
36714,2286,1154,1132,338,314,278,103,601,278,323,124,87,65,21,0
36715,404,197,207,60,48,47,20,218,117,101,35,32,34,12,0
36716,349,167,182,54,38,30,28,228,130,98,35,29,30,10,0
36717,1462,711,751,219,222,148,65,144,67,77,28,14,9,8,0
36718,1051,429,622,179,148,125,54,338,169,169,53,44,39,21,0
36719,722,390,332,125,69,67,25,128,63,65,30,11,13,8,0
36720,359,167,192,49,37,27,19,386,181,205,55,51,57,31,0
36721,219,116,103,66,7,2,1,600,254,346,104,100,44,17,0
36722,193,95,98,33,17,25,17,417,232,185,58,50,29,21,0
36723,249,114,135,47,33,25,4,204,80,124,29,51,10,5,0
36724,316,157,159,45,38,22,19,374,174,200,54,52,42,21,0
36725,1711,865,846,204,176,105,60,1338,720,618,179,145,141,85,0
36726,452,217,235,59,47,60,20,629,317,312,80,87,51,22,0
36727,313,148,165,45,33,36,11,445,202,243,70,73,51,15,0
36728,260,133,127,43,29,34,11,251,143,108,47,25,29,11,0
36729,598,322,276,67,57,63,26,125,66,59,24,16,11,5,0
36730,264,122,142,46,24,35,10,375,176,199,48,61,40,12,0
36731,484,261,223,59,48,49,24,165,87,78,24,19,22,9,0
36732,261,130,131,27,41,19,16,410,197,213,67,43,56,18,0
36733,464,237,227,64,66,33,12,154,78,76,23,21,13,5,0
36734,1556,718,838,280,182,161,49,4646,2328,2318,674,639,475,170,0
36735,281,125,156,44,47,17,7,374,202,172,50,39,31,24,0
36736,1087,523,564,146,177,103,33,481,223,258,71,70,49,26,0
36737,416,207,209,63,47,56,15,549,273,276,74,68,72,24,0
36738,313,148,165,45,33,36,11,457,242,215,39,46,53,10,0
36739,257,132,125,39,27,26,10,661,325,336,81,75,65,28,0
36740,625,283,342,93,89,67,25,403,233,170,38,29,21,14,0
36741,1098,519,579,182,159,79,42,437,225,212,61,57,66,12,0
36742,297,161,136,36,35,24,9,251,143,108,47,25,29,11,0
36743,411,171,240,61,81,30,15,247,128,119,34,14,16,14,0
36744,416,207,209,63,47,56,15,496,285,211,62,54,46,22,0
36745,238,158,80,28,15,31,7,756,348,408,101,103,60,40,0
36746,243,100,143,58,50,24,5,520,244,276,91,60,68,20,0
36747,341,175,166,48,43,35,18,483,287,196,71,50,54,17,0
36748,1041,497,544,180,167,98,34,127,58,69,18,17,10,5,0
36749,887,439,448,137,99,91,38,222,119,103,37,32,24,8,0
36750,71,39,32,7,11,6,4,2225,1244,981,271,243,217,93,0
36751,496,272,224,70,58,42,18,262,129,133,40,41,31,10,0
36752,2488,1085,1403,346,253,162,76,399,190,209,61,41,39,18,0
36753,595,208,387,157,60,91,48,132,61,71,19,20,14,6,0
36754,513,276,237,73,43,57,24,403,221,182,62,50,42,12,0
36755,412,203,209,65,47,37,18,536,222,314,101,100,34,22,0
36756,335,155,180,64,48,36,10,289,140,149,33,42,30,15,0
36757,580,308,272,82,79,58,25,1352,602,750,166,185,81,70,0
36758,204,109,95,21,35,27,7,621,273,348,104,102,48,19,0
36759,315,111,204,82,66,46,11,1696,771,925,257,225,149,63,0
36760,584,297,287,89,80,65,17,106,46,60,27,18,12,3,0
36761,424,170,254,69,56,47,28,138,69,69,28,7,10,10,0
36762,394,207,187,52,42,37,24,72,32,40,8,2,1,14,0
36763,178,87,91,20,32,13,10,336,200,136,34,29,25,24,0
36764,1064,495,569,157,159,124,58,132,67,65,24,21,8,10,0
36765,527,254,273,67,66,70,31,598,333,265,79,66,54,33,0
36766,1960,875,1085,287,189,162,66,622,344,278,80,77,68,36,0
36767,278,110,168,58,49,29,5,239,113,126,36,49,20,8,0
36768,126,56,70,31,10,10,3,758,319,439,101,123,78,25,0
36769,159,105,54,22,9,14,25,295,156,139,41,40,42,15,0
36770,447,236,211,56,52,49,14,766,386,380,101,81,78,31,0
36771,616,304,312,75,71,55,25,457,245,212,62,58,57,21,0
36772,502,274,228,64,49,75,17,169,84,85,29,19,21,7,0
36773,824,391,433,106,90,88,32,704,355,349,113,94,71,24,0
36774,667,366,301,96,55,84,25,308,146,162,42,39,24,12,0
36775,272,94,178,76,33,19,4,373,181,192,54,35,44,20,0
36776,484,261,223,59,48,49,24,387,193,194,60,53,57,15,0
36777,505,247,258,72,71,60,27,376,183,193,50,50,43,21,0
36778,126,66,60,24,10,7,9,597,300,297,96,89,68,29,0
36779,571,298,273,81,72,57,25,307,132,175,48,53,26,10,0
36780,1096,563,533,158,136,120,53,572,305,267,74,72,58,21,0
36781,480,267,213,49,44,70,21,557,281,276,80,59,43,21,0
36782,431,245,186,50,23,46,17,135,57,78,21,20,9,11,0
36783,1130,614,516,129,138,98,42,390,190,200,66,50,43,12,0
36784,220,113,107,37,24,16,7,213,129,84,32,14,21,15,0
36785,462,233,229,66,49,43,30,373,189,184,54,46,50,23,0
36786,369,166,203,59,55,41,14,285,143,142,45,32,21,17,0
36787,579,281,298,91,78,74,27,359,171,188,49,74,45,11,0
36788,282,105,177,77,28,39,6,384,212,172,44,43,34,14,0
36789,915,336,579,185,199,56,29,173,94,79,18,24,12,7,0
36790,345,203,142,47,35,31,11,242,124,118,39,32,28,22,0
36791,359,198,161,51,28,54,13,373,183,190,49,37,33,18,0
36792,315,174,141,46,38,47,16,348,194,154,57,31,43,12,0
36793,358,212,146,51,36,33,9,732,366,366,108,86,74,41,0
36794,512,254,258,70,48,37,32,201,98,103,28,25,19,13,0
36795,881,492,389,87,97,59,51,572,305,267,74,72,58,21,0
36796,347,181,166,27,20,12,12,1425,670,755,153,189,122,85,0
36797,801,331,470,151,139,99,55,858,398,460,126,138,75,39,0
36798,745,402,343,95,71,69,40,1040,564,476,134,110,114,51,0
36799,319,153,166,61,52,26,12,149,77,72,37,10,20,5,0
36800,540,252,288,73,67,57,20,264,138,126,33,34,29,12,0
36801,773,383,390,108,76,79,30,620,324,296,81,68,66,31,0
36802,317,153,164,39,30,35,13,712,333,379,95,109,63,26,0
36803,805,338,467,153,138,99,55,295,158,137,42,34,38,14,0
36804,1390,585,805,241,230,118,46,758,319,439,101,123,78,25,0
36805,650,330,320,97,77,65,28,148,69,79,26,18,16,3,0
36806,1004,498,506,94,59,46,33,866,478,388,121,101,101,26,0
36807,406,208,198,41,26,43,21,732,402,330,81,86,87,33,0
36808,269,124,145,36,24,32,11,274,157,117,40,29,40,8,0
36809,593,282,311,75,70,29,25,926,425,501,159,147,77,35,0
36810,729,351,378,111,98,58,18,866,397,469,117,153,95,48,0
36811,82,36,46,17,10,5,1,906,455,451,116,105,87,46,0
36812,474,250,224,58,47,37,12,858,398,460,126,138,75,39,0
36813,443,226,217,67,34,53,10,222,125,97,34,27,27,7,0
36814,585,277,308,92,73,61,32,549,273,276,74,68,72,24,0
36815,587,318,269,76,50,38,21,257,139,118,64,17,24,7,0
36816,92,46,46,14,9,8,6,530,287,243,79,70,33,26,0
36817,346,174,172,36,43,21,9,203,98,105,34,29,19,10,0
36818,215,80,135,54,56,21,9,1262,653,609,169,165,152,50,0
36819,607,305,302,92,89,74,23,723,353,370,120,109,96,33,0
36820,280,128,152,39,37,38,18,519,287,232,68,58,45,21,0
36821,211,92,119,33,44,11,7,727,388,339,102,87,70,29,0
36822,347,154,193,48,51,25,11,375,176,199,48,61,40,12,0
36823,700,305,395,111,99,54,18,390,190,200,66,50,43,12,0
36824,465,220,245,88,34,61,23,497,257,240,71,63,62,16,0
36825,579,246,333,102,79,41,19,432,244,188,51,51,27,14,0
36826,785,374,411,56,42,38,25,295,158,137,42,34,38,14,0
36827,269,124,145,36,24,32,11,72,32,40,8,2,1,14,0
36828,243,100,143,58,50,24,5,368,200,168,54,49,43,9,0
36829,134,60,74,19,13,10,7,483,287,196,71,50,54,17,0
36830,67,40,27,10,8,7,6,127,64,63,26,8,12,8,0
36831,164,77,87,33,19,6,7,373,181,192,54,35,44,20,0
36832,480,232,248,73,40,44,30,402,186,216,64,47,38,20,0
36833,364,168,196,64,61,27,6,307,132,175,48,53,26,10,0
36834,639,368,271,72,51,38,38,602,310,292,87,66,70,36,0
36835,444,250,194,58,21,60,23,262,129,133,40,41,31,10,0
36836,446,283,163,51,26,33,19,663,354,309,91,84,79,31,0
36837,111,29,82,10,54,0,1,218,111,107,45,29,24,6,0
36838,127,55,72,25,18,5,7,266,150,116,28,28,24,12,0
36839,753,395,358,93,72,71,16,1248,584,664,184,164,155,67,0
36840,301,157,144,31,28,34,9,153,80,73,26,18,19,4,0
36841,654,344,310,80,69,57,15,299,140,159,49,44,26,11,0
36842,417,222,195,53,39,43,10,663,360,303,87,82,80,35,0
36843,458,226,232,77,59,61,14,188,101,87,20,18,20,14,0
36844,432,233,199,52,28,47,18,101,59,42,11,17,10,1,0
36845,447,232,215,55,65,50,25,421,219,202,68,57,56,13,0
36846,130,72,58,28,9,7,1,662,312,350,103,104,59,20,0
36847,2286,1154,1132,338,314,278,103,1265,689,576,169,177,128,60,0
36848,885,424,461,143,114,92,32,439,211,228,65,73,26,21,0
36849,333,171,162,50,34,19,8,198,110,88,27,27,24,4,0
36850,184,93,91,26,25,14,11,2225,1244,981,271,243,217,93,0
36851,773,383,390,108,76,79,30,265,134,131,48,34,33,15,0
36852,335,183,152,40,26,54,22,501,257,244,75,57,48,29,0
36853,977,462,515,185,119,76,12,415,189,226,68,54,50,21,0
36854,318,161,157,53,51,32,13,780,337,443,112,116,77,28,0
36855,345,208,137,44,27,33,8,381,186,195,69,55,46,15,0
36856,193,107,86,13,20,13,6,376,189,187,47,53,44,26,0
36857,426,228,198,62,42,47,22,272,141,131,45,29,36,9,0
36858,286,111,175,51,47,21,12,406,234,172,63,35,43,10,0
36859,953,421,532,131,131,70,37,1114,539,575,145,131,94,56,0
36860,726,312,414,121,73,82,23,295,160,135,44,36,46,16,0
36861,317,140,177,43,26,31,16,671,321,350,95,87,75,34,0
36862,392,221,171,53,30,25,8,1040,564,476,134,110,114,51,0
36863,176,74,102,20,29,7,7,132,61,71,22,21,15,3,0
36864,206,96,110,33,25,8,6,375,176,199,48,61,40,12,0
36865,257,148,109,28,20,21,14,526,266,260,76,75,53,22,0
36866,733,382,351,126,92,93,27,811,361,450,124,107,80,31,0
36867,710,352,358,104,86,84,41,306,157,149,52,35,39,16,0
36868,325,177,148,40,24,23,13,225,114,111,32,29,26,6,0
36869,385,179,206,58,56,38,19,1698,875,823,222,219,173,64,0
36870,346,186,160,40,37,34,21,690,345,345,96,83,73,42,0
36871,736,353,383,117,83,71,18,348,194,154,57,31,43,12,0
36872,733,382,351,126,92,93,27,720,361,359,98,98,70,37,0
36873,327,174,153,42,35,16,12,250,116,134,41,30,33,19,0
36874,290,156,134,44,29,39,9,1323,690,633,132,178,112,61,0
36875,306,172,134,35,31,37,18,396,197,199,75,49,49,16,0
36876,246,123,123,40,31,27,7,963,525,438,119,102,102,34,0
36877,610,249,361,107,69,72,33,418,223,195,53,43,49,15,0
36878,1542,682,860,290,158,120,47,452,231,221,74,53,56,20,0
36879,2799,1324,1475,369,371,215,124,627,323,304,81,90,53,27,0
36880,764,277,487,158,162,64,31,708,328,380,113,100,82,34,0
36881,1214,498,716,197,180,121,65,386,181,205,55,51,57,31,0
36882,150,64,86,22,12,29,12,748,359,389,125,113,86,31,0
36883,563,255,308,91,111,42,30,384,204,180,53,47,49,17,0
36884,461,207,254,82,66,55,33,535,301,234,63,48,47,27,0
36885,131,69,62,29,9,9,1,204,80,124,29,51,10,5,0
36886,567,266,301,139,46,76,37,187,89,98,36,24,20,6,0
36887,282,84,198,60,102,1,6,396,213,183,68,44,47,18,0
36888,413,169,244,66,94,28,19,330,166,164,55,51,36,16,0
36889,1189,653,536,152,118,109,56,354,188,166,46,40,34,10,0
36890,470,163,307,99,68,73,30,422,202,220,80,52,57,18,0
36891,178,74,104,31,28,9,4,265,134,131,48,34,33,15,0
36892,1208,575,633,187,204,117,41,715,348,367,109,84,68,30,0
36893,733,438,295,95,79,67,32,212,127,85,28,21,26,6,0
36894,1284,511,773,227,166,169,107,818,357,461,122,136,54,25,0
36895,213,113,100,26,21,26,12,381,186,195,69,55,46,15,0
36896,385,179,206,58,56,38,19,196,105,91,40,13,19,10,0
36897,1085,646,439,108,65,36,19,169,74,95,33,26,22,3,0
36898,525,254,271,60,76,46,13,231,126,105,28,26,34,9,0
36899,465,220,245,88,34,61,23,766,386,380,101,81,78,31,0
36900,763,371,392,104,88,52,23,507,270,237,89,59,57,22,0
36901,609,292,317,102,96,64,21,368,204,164,43,35,30,24,0
36902,532,291,241,83,36,79,25,127,64,63,26,8,12,8,0
36903,414,216,198,51,32,42,28,370,173,197,65,57,42,10,0
36904,1560,778,782,224,235,132,78,520,244,276,91,60,68,20,0
36905,556,306,250,69,60,80,18,87,51,35,15,9,9,4,0
36906,388,209,179,46,24,31,28,427,251,176,51,39,25,22,0
36907,371,143,228,77,48,29,26,322,180,142,45,38,28,7,0
36908,278,104,174,46,34,23,14,222,122,100,39,32,24,9,0
36909,439,241,198,67,40,40,13,171,94,77,24,28,30,11,0
36910,915,336,579,185,199,56,29,1696,771,925,257,225,149,63,0
36911,456,223,233,77,54,47,20,756,348,408,101,103,60,40,0
36912,517,245,272,92,77,46,24,689,343,346,105,102,81,35,0
36913,130,70,60,30,9,8,1,127,54,73,11,33,15,6,0
36914,338,172,166,59,30,39,18,633,311,322,94,82,45,20,0
36915,550,304,246,60,64,77,16,294,146,148,50,45,51,15,0
36916,169,64,105,23,37,11,3,384,212,172,44,43,34,14,0
36917,170,82,88,32,23,22,8,928,440,488,111,157,82,35,0
36918,221,80,141,48,37,14,10,535,301,234,63,48,47,27,0
36919,1043,479,564,200,131,123,62,378,154,224,74,84,35,22,0
36920,618,289,329,97,86,70,17,205,94,111,48,31,15,6,0
36921,233,107,126,40,40,20,16,396,197,199,75,49,49,16,0
36922,271,110,161,33,27,11,8,169,84,85,29,19,21,7,0
36923,440,267,173,52,29,42,12,397,234,163,44,38,23,21,0
36924,335,155,180,64,48,36,10,519,287,232,68,58,45,21,0
36925,380,148,232,81,69,24,8,129,60,69,21,15,8,5,0
36926,161,75,86,24,20,10,7,297,164,133,45,39,40,9,0
36927,755,271,484,113,226,61,20,293,142,151,49,40,42,17,0
36928,545,221,324,101,72,55,30,452,252,200,55,49,61,16,0
36929,587,318,269,76,50,38,21,332,180,152,44,36,27,13,0
36930,312,173,139,43,47,28,6,557,281,276,80,59,43,21,0
36931,331,144,187,57,46,33,19,425,177,248,60,62,33,16,0
36932,280,156,124,36,19,20,13,341,170,171,41,66,27,10,0
36933,317,167,150,45,21,30,26,199,105,94,27,27,28,9,0
36934,1217,647,570,142,160,129,45,301,168,133,49,37,34,11,0
36935,220,113,107,37,24,16,7,127,54,73,11,33,15,6,0
36936,729,351,378,111,98,58,18,227,130,97,32,25,22,12,0
36937,490,198,292,65,81,39,27,332,180,152,46,36,28,14,0
36938,126,57,69,31,10,10,3,403,221,182,62,50,42,12,0
36939,1132,624,508,199,79,127,41,119,57,62,18,16,17,4,0
36940,221,80,141,48,37,14,10,457,242,215,39,46,53,10,0
36941,369,166,203,59,55,41,14,107,77,30,7,2,9,5,0
36942,320,163,157,44,44,26,15,339,180,159,36,29,16,16,0
36943,421,237,184,47,54,45,10,862,426,436,113,115,84,37,0
36944,443,250,193,52,23,49,13,858,398,460,126,138,75,39,0
36945,144,57,87,38,26,10,4,332,155,177,55,51,44,13,0
36946,756,362,394,102,104,73,25,778,391,387,94,77,41,33,0
36947,429,238,191,47,49,56,29,858,398,460,126,138,75,39,0
36948,595,208,387,157,60,91,48,509,267,242,79,81,38,20,0
36949,2414,1189,1225,277,178,170,169,303,137,166,54,54,31,15,0
36950,444,250,194,58,21,60,23,749,384,365,108,105,86,31,0
36951,364,192,172,49,36,39,14,463,170,293,115,54,75,32,0
36952,1647,794,853,279,235,128,65,135,65,70,21,25,15,9,0
36953,580,281,299,95,60,74,29,410,197,213,67,43,56,18,0
36954,822,416,406,111,97,88,42,1065,581,484,134,97,76,46,0
36955,376,249,127,47,23,43,16,368,200,168,54,49,43,9,0
36956,763,371,392,104,88,52,23,87,51,35,15,9,9,4,0
36957,314,178,136,42,32,30,17,326,149,177,51,51,28,10,0
36958,1542,682,860,290,158,120,47,452,254,198,72,57,38,18,0
36959,753,361,392,99,94,66,16,340,169,171,40,39,36,22,0
36960,119,67,52,15,15,7,7,766,386,380,101,81,78,31,0
36961,279,129,150,43,34,17,13,325,172,153,44,34,27,14,0
36962,900,434,466,134,97,86,36,225,129,96,32,33,20,8,0
36963,1560,778,782,224,235,132,78,866,478,388,121,101,101,26,0
36964,595,208,387,157,60,91,48,565,237,328,75,88,32,11,0
36965,282,105,177,77,28,39,6,328,199,129,39,29,27,14,0
36966,622,354,268,89,60,64,18,198,110,88,27,27,24,4,0
36967,345,203,142,47,35,31,11,154,78,76,23,21,13,5,0
36968,651,357,294,81,67,103,18,679,338,341,96,95,40,23,0
36969,344,168,176,50,39,30,20,178,69,109,29,25,21,13,0
36970,476,199,277,82,80,49,24,339,175,164,51,49,37,9,0
36971,339,118,221,77,68,33,13,763,418,345,113,84,59,32,0
36972,813,412,401,114,93,112,26,292,143,149,38,42,36,16,0
36973,463,250,213,56,45,73,25,198,86,112,36,27,23,9,0
36974,461,207,254,82,66,55,33,402,186,216,64,47,38,20,0
36975,411,202,209,60,67,57,24,392,186,206,62,56,29,15,0
36976,213,113,100,26,21,26,12,234,116,118,34,35,23,9,0
36977,115,62,53,13,10,9,7,260,133,127,43,32,39,3,0
36978,233,107,126,40,40,20,16,260,133,127,43,32,39,3,0
36979,434,216,218,72,58,40,20,660,332,328,84,73,47,19,0
36980,474,250,224,58,47,37,12,367,218,149,45,43,42,16,0
36981,1052,492,560,184,163,103,44,811,361,450,124,107,80,31,0
36982,540,252,288,73,67,57,20,225,129,96,32,33,20,8,0
36983,507,242,265,53,44,31,22,380,178,202,69,53,37,10,0
36984,230,114,116,30,33,29,8,178,99,79,31,19,26,8,0
36985,260,136,124,24,41,19,4,137,85,52,15,11,11,2,0
36986,412,146,266,106,38,67,35,1061,543,518,146,123,109,67,0
36987,180,92,88,29,20,26,8,392,214,178,48,40,53,22,0
36988,595,208,387,157,60,91,48,629,317,312,80,87,51,22,0
36989,302,160,142,35,35,37,10,91,42,49,21,9,8,3,0
36990,445,231,214,45,64,53,23,295,158,137,42,34,38,14,0
36991,928,442,486,139,118,91,43,1500,804,696,190,172,144,60,0
36992,126,57,69,31,10,10,3,660,333,327,102,95,69,31,0
36993,107,53,54,15,15,13,4,434,213,221,77,62,53,12,0
36994,394,207,187,52,42,37,24,265,134,131,48,34,33,15,0
36995,1849,931,918,245,220,158,90,218,114,104,32,31,33,11,0
36996,626,300,326,91,82,68,26,548,296,252,71,74,43,28,0
36997,452,217,235,59,47,60,20,145,77,68,26,7,15,8,0
36998,789,362,427,90,82,70,35,231,126,105,28,26,34,9,0
36999,303,147,156,49,49,20,8,465,252,213,73,58,60,18,0
37000,447,236,211,56,52,49,14,699,334,365,108,80,70,20,0
37001,106,43,63,28,13,8,1,213,129,84,32,14,21,15,0
37002,379,217,162,47,20,50,23,457,242,215,39,46,53,10,0
37003,328,156,172,44,37,44,15,758,319,439,101,123,78,25,0
37004,193,95,98,33,17,25,17,1425,670,755,153,189,122,85,0
37005,432,190,242,85,82,28,11,279,142,137,43,39,28,7,0
37006,756,362,394,102,104,73,25,555,282,273,82,69,65,21,0
37007,485,246,239,74,48,47,22,461,223,238,45,62,18,35,0
37008,1186,495,691,182,208,88,32,201,117,83,22,21,19,9,0
37009,509,251,258,69,49,55,17,335,186,149,40,28,29,13,0
37010,417,176,241,75,61,51,20,332,173,159,48,40,31,11,0
37011,450,227,223,53,36,48,12,203,98,105,34,29,19,10,0
37012,431,245,186,50,23,46,17,72,32,40,8,2,1,14,0
37013,1087,523,564,146,177,103,33,334,182,152,45,41,27,13,0
37014,1594,660,934,251,272,117,77,145,77,68,26,7,15,8,0
37015,813,412,401,114,93,112,26,518,292,226,60,60,52,21,0
37016,146,75,71,13,32,15,11,270,162,108,26,26,16,11,0
37017,1276,607,669,192,178,136,63,91,42,49,21,9,8,3,0
37018,219,100,119,40,29,21,3,415,205,210,77,52,55,17,0
37019,2286,1154,1132,338,314,278,103,403,192,211,102,39,49,15,0
37020,267,146,121,40,24,25,7,391,189,202,55,56,56,12,0
37021,280,128,152,39,37,38,18,222,125,97,34,27,27,7,0
37022,261,126,135,41,36,24,11,773,389,384,119,91,79,26,0
37023,595,316,279,86,60,65,40,720,361,359,98,98,70,37,0
37024,252,121,131,42,34,12,16,732,366,366,108,86,74,41,0
37025,577,342,235,63,57,23,37,138,69,69,28,7,10,10,0
37026,221,75,146,68,21,16,5,133,61,72,21,19,13,4,0
37027,200,94,106,33,22,18,8,629,317,312,80,87,51,22,0
37028,438,185,253,71,64,52,28,212,127,85,28,21,26,6,0
37029,362,181,181,67,46,43,8,381,186,195,69,55,46,15,0
37030,571,298,273,81,72,57,25,396,197,199,75,49,49,16,0
37031,640,271,369,111,79,57,17,430,212,218,88,43,40,20,0
37032,282,105,177,77,28,39,6,1101,626,475,145,122,120,50,0
37033,202,103,99,28,20,12,8,330,166,164,55,51,36,16,0
37034,162,73,89,32,19,4,4,1265,689,576,169,177,128,60,0
37035,577,251,326,92,84,60,11,147,74,73,28,20,24,4,0
37036,461,257,204,63,49,50,29,1262,653,609,169,165,152,50,0
37037,739,323,416,127,89,76,33,175,82,93,33,26,17,5,0
37038,329,168,161,48,34,41,16,386,181,205,55,51,57,31,0
37039,270,158,112,35,20,23,7,761,351,410,117,73,103,45,0
37040,420,248,172,64,30,43,17,264,138,126,33,34,29,12,0
37041,532,291,241,83,36,79,25,792,398,394,109,96,90,39,0
37042,428,226,202,52,60,75,20,96,46,50,16,12,7,5,0
37043,126,56,70,31,10,10,3,354,188,166,46,40,34,10,0
37044,318,161,157,53,51,32,13,1166,514,652,150,159,107,70,0
37045,349,131,218,66,76,22,9,866,397,469,117,153,95,48,0
37046,261,148,113,23,29,26,21,131,55,76,28,9,14,12,0
37047,368,154,214,80,52,41,16,582,264,318,84,60,58,23,0
37048,420,189,231,79,67,33,17,332,155,177,55,51,44,13,0
37049,297,161,136,36,35,24,9,292,143,149,38,42,36,16,0
37050,687,351,336,106,67,70,41,549,273,276,74,68,72,24,0
37051,580,308,272,82,79,58,25,178,69,109,29,25,21,13,0
37052,125,46,79,24,16,12,2,332,180,152,46,36,28,14,0
37053,243,114,129,37,30,32,8,297,175,122,46,30,31,6,0
37054,278,104,174,46,34,23,14,453,255,198,62,49,29,19,0
37055,1501,679,822,251,196,174,67,452,252,200,55,49,61,16,0
37056,128,70,58,29,9,8,1,296,151,145,45,42,32,11,0
37057,640,279,361,102,83,69,21,138,69,69,28,7,10,10,0
37058,423,247,176,58,55,29,20,530,287,243,79,70,33,26,0
37059,447,236,211,56,52,49,14,337,152,185,49,54,42,21,0
37060,622,354,268,89,60,64,18,415,205,210,77,52,55,17,0
37061,336,134,202,51,64,27,12,299,140,159,49,44,26,11,0
37062,567,266,301,139,46,76,37,452,231,221,74,53,56,20,0
37063,582,328,254,78,48,35,9,336,200,136,34,29,25,24,0
37064,283,112,171,48,39,34,15,302,150,152,56,40,52,15,0
37065,385,179,206,58,56,38,19,892,475,417,130,108,68,38,0
37066,444,250,194,58,21,60,23,535,288,247,79,72,35,21,0
37067,376,176,200,31,53,27,8,166,78,88,27,25,19,7,0
37068,376,171,205,45,45,34,12,396,197,199,75,49,49,16,0
37069,2220,1085,1135,312,304,202,91,165,87,78,24,19,22,9,0
37070,217,98,119,38,35,18,9,1698,875,823,222,219,173,64,0
37071,301,156,145,32,25,15,5,389,210,179,51,37,43,9,0
37072,315,111,204,82,66,46,11,107,77,30,7,2,9,5,0
37073,429,227,202,49,51,46,26,423,234,189,66,44,57,12,0
37074,758,378,380,89,64,37,31,373,181,192,54,35,44,20,0
37075,393,223,170,44,36,32,14,396,213,183,68,44,47,18,0
37076,163,70,93,28,21,17,6,483,287,196,71,50,54,17,0
37077,206,96,110,33,25,8,6,278,154,124,42,32,38,7,0
37078,478,177,301,109,66,59,25,339,180,159,36,29,16,16,0
37079,979,534,445,83,77,80,24,943,463,480,91,144,70,30,0
37080,435,225,210,58,46,50,14,339,180,159,36,29,16,16,0
37081,932,575,357,94,69,76,40,218,117,101,35,32,34,12,0
37082,269,127,142,43,24,34,26,866,478,388,121,101,101,26,0
37083,126,57,69,31,10,10,3,285,143,142,45,32,21,17,0
37084,1463,521,942,252,204,105,52,359,171,188,49,74,45,11,0
37085,756,362,394,102,104,73,25,375,209,166,50,37,29,23,0
37086,682,260,422,153,78,109,46,352,207,145,40,33,25,21,0
37087,772,417,355,118,92,80,23,307,132,175,48,53,26,10,0
37088,298,141,157,51,33,21,22,464,236,228,64,56,53,28,0
37089,1001,422,579,185,180,51,32,247,128,119,34,14,16,14,0
37090,375,201,174,52,56,39,15,326,169,157,51,41,41,12,0
37091,685,393,292,75,66,113,16,437,221,216,62,64,47,13,0
37092,462,228,234,59,47,37,32,445,192,253,86,58,53,18,0
37093,313,158,155,43,35,43,16,188,90,98,44,7,21,7,0
37094,432,190,242,85,82,28,11,621,273,348,104,102,48,19,0
37095,279,127,152,50,36,28,8,148,69,79,26,18,16,3,0
37096,514,226,288,71,66,63,32,929,459,470,140,120,94,45,0
37097,413,206,207,38,55,19,10,520,272,248,60,65,58,22,0
37098,178,87,91,20,32,13,10,374,181,193,55,58,48,23,0
37099,800,416,384,102,105,83,22,492,278,214,65,58,32,11,0
37100,426,214,212,63,47,53,20,192,91,101,29,28,17,7,0
37101,2285,1219,1066,207,180,178,106,374,202,172,50,39,31,24,0
37102,517,245,272,92,77,46,24,403,233,170,38,29,21,14,0
37103,452,217,235,59,47,60,20,763,418,345,113,84,59,32,0
37104,479,227,252,69,48,46,18,289,140,149,33,42,30,15,0
37105,533,297,236,74,57,39,28,346,196,150,43,26,27,14,0
37106,154,74,80,18,19,7,2,274,157,117,40,29,40,8,0
37107,640,279,361,102,83,69,21,925,439,486,141,134,105,46,0
37108,136,66,70,33,11,9,3,1755,905,850,214,196,183,79,0
37109,433,188,245,63,45,26,14,169,85,84,21,14,9,9,0
37110,173,90,83,30,19,19,11,308,129,179,44,60,19,8,0
37111,202,113,89,16,27,21,11,481,223,258,71,70,49,26,0
37112,107,36,71,27,15,0,1,201,99,102,34,26,23,6,0
37113,452,202,250,83,60,56,19,1166,514,652,150,159,107,70,0
37114,128,67,61,29,9,9,1,153,80,73,26,18,19,4,0
37115,118,51,67,25,13,6,7,400,187,213,56,59,42,20,0
37116,756,362,394,102,104,73,25,464,236,228,64,56,53,28,0
37117,467,233,234,83,37,77,22,423,234,189,66,44,57,12,0
37118,450,231,219,77,50,76,16,137,63,74,20,22,14,6,0
37119,646,304,342,104,93,58,26,89,51,38,15,15,5,4,0
37120,282,163,119,40,23,25,17,2517,1275,1242,304,324,245,135,0
37121,795,384,411,133,109,85,38,660,333,327,102,95,69,31,0
37122,206,100,106,34,26,11,7,1378,692,686,194,174,105,56,0
37123,159,105,54,22,9,14,25,307,132,175,48,53,26,10,0
37124,335,183,152,40,26,54,22,509,267,242,79,81,38,20,0
37125,959,496,463,144,132,75,35,415,205,210,77,52,55,17,0
37126,339,170,169,32,17,24,13,665,361,304,87,91,84,31,0
37127,164,61,103,47,19,14,5,492,278,214,65,58,32,11,0
37128,500,297,203,66,33,53,15,125,66,59,24,16,11,5,0
37129,102,22,80,48,8,18,6,766,386,380,101,81,78,31,0
37130,401,236,165,53,38,34,9,187,89,98,36,24,20,6,0
37131,346,205,141,47,34,30,7,601,279,322,81,65,27,12,0
37132,376,249,127,47,23,43,16,1249,638,611,166,153,141,45,0
37133,343,189,154,44,24,39,12,72,32,40,8,2,2,13,0
37134,376,176,200,31,53,27,8,679,338,341,96,95,40,23,0
37135,552,295,257,67,49,70,30,222,124,98,37,29,22,9,0
37136,475,208,267,84,67,50,20,662,373,289,89,80,77,29,0
37137,908,324,584,181,162,81,29,663,360,303,87,82,80,35,0
37138,117,58,59,17,17,12,2,749,384,365,108,105,86,31,0
37139,1043,479,564,200,131,123,62,316,166,150,45,38,37,13,0
37140,313,134,179,58,37,43,19,297,164,133,45,39,40,9,0
37141,2174,1057,1117,241,241,214,117,158,71,87,23,21,17,12,0
37142,1001,422,579,185,180,51,32,180,108,72,22,22,15,5,0
37143,852,461,391,109,102,72,24,541,279,262,79,82,31,32,0
37144,508,136,372,157,91,22,9,107,77,30,7,2,9,5,0
37145,257,132,125,39,27,26,10,241,127,114,34,33,29,12,0
37146,532,254,278,91,48,23,17,105,51,54,13,17,12,8,0
37147,130,70,60,30,9,8,1,582,264,318,84,60,58,23,0
37148,894,448,446,123,100,82,30,228,130,98,35,29,30,10,0
37149,243,70,173,54,65,8,6,549,273,276,74,68,72,24,0
37150,927,457,470,130,99,118,42,374,202,172,50,39,31,24,0
37151,435,225,210,58,46,50,14,334,181,153,41,40,25,15,0
37152,439,183,256,60,64,36,14,366,204,162,47,41,31,23,0
37153,330,77,253,86,52,20,12,320,168,152,38,42,24,18,0
37154,502,274,228,64,49,75,17,555,292,263,75,63,67,27,0
37155,492,253,239,73,67,77,29,188,93,95,33,18,16,10,0
37156,1014,488,526,178,137,94,39,1378,692,686,194,174,105,56,0
37157,213,113,100,26,21,26,12,213,129,84,32,14,21,15,0
37158,347,198,149,45,29,29,8,514,248,266,86,82,52,22,0
37159,528,273,255,67,53,29,20,405,214,191,53,42,49,20,0
37160,517,196,321,103,98,33,12,128,63,65,30,11,13,8,0
37161,801,331,470,151,139,99,55,679,338,341,96,95,40,23,0
37162,425,198,227,57,69,59,13,640,364,276,84,68,69,33,0
37163,299,128,171,57,40,13,25,274,157,117,40,29,40,8,0
37164,262,133,129,44,38,31,12,252,130,122,45,23,32,11,0
37165,1395,595,800,223,206,113,61,91,42,49,21,9,8,3,0
37166,240,167,73,32,12,8,21,660,303,357,97,89,85,33,0
37167,433,188,245,63,45,26,14,250,119,131,58,26,29,7,0
37168,1001,422,579,185,180,51,32,65,32,33,16,4,8,3,0
37169,609,292,317,102,96,64,21,483,287,196,71,50,54,17,0
37170,622,354,268,89,60,64,18,239,113,126,36,49,20,8,0
37171,414,195,219,51,60,40,17,251,143,108,47,25,29,11,0
37172,1360,644,716,213,194,136,62,424,179,245,65,67,29,11,0
37173,406,207,199,56,46,68,19,316,159,157,38,48,30,11,0
37174,949,466,483,125,126,101,50,629,317,312,80,87,51,22,0
37175,193,107,86,13,20,13,6,292,143,149,38,42,36,16,0
37176,520,240,280,87,63,67,16,374,212,162,48,40,32,23,0
37177,204,93,111,35,35,16,11,73,35,38,14,10,9,4,0
37178,373,164,209,51,45,44,21,189,95,94,25,33,16,8,0
37179,219,116,103,66,7,2,1,492,278,214,65,58,32,11,0
37180,437,167,270,126,95,34,10,395,169,226,73,55,38,9,0
37181,1872,837,1035,280,338,169,80,297,164,133,45,39,40,9,0
37182,361,183,178,50,54,51,22,482,232,250,77,81,44,13,0
37183,1249,543,706,187,164,125,52,323,171,152,48,41,40,16,0
37184,271,110,161,33,27,11,8,336,200,136,34,29,25,24,0
37185,557,250,307,70,47,51,22,862,409,453,149,125,86,29,0
37186,317,140,177,43,26,31,16,621,310,311,100,106,77,27,0
37187,516,210,306,113,53,81,33,331,180,151,46,35,47,17,0
37188,264,122,142,46,24,35,10,1507,737,770,188,228,147,71,0
37189,338,164,174,45,32,37,13,974,457,517,133,117,69,26,0
37190,346,168,178,36,43,20,9,448,217,231,56,63,29,10,0
37191,2048,855,1193,297,287,191,93,405,214,191,53,42,49,20,0
37192,301,156,145,32,25,15,5,179,101,78,25,15,13,13,0
37193,616,304,312,75,71,55,25,602,310,292,87,66,70,36,0
37194,346,205,141,47,34,30,7,445,264,181,35,35,34,14,0
37195,538,263,275,71,85,44,18,701,380,321,94,84,96,34,0
37196,157,62,95,41,18,10,11,398,200,198,68,43,51,14,0
37197,760,405,355,112,95,92,29,474,268,206,66,42,45,24,0
37198,512,254,258,70,48,37,32,89,37,52,13,6,2,9,0
37199,837,381,456,123,109,65,25,103,50,53,19,10,7,5,0
37200,125,57,68,31,10,10,3,339,180,159,36,29,16,16,0
37201,117,57,60,17,14,11,10,1214,475,739,177,250,89,49,0
37202,403,176,227,71,56,51,11,1034,495,539,150,134,114,71,0
37203,2000,965,1035,357,313,198,75,548,273,275,84,81,64,30,0
37204,589,282,307,68,67,70,23,106,41,65,36,6,11,7,0
37205,505,226,279,68,51,30,15,376,189,187,47,53,44,26,0
37206,319,153,166,61,52,26,12,277,144,133,42,30,41,8,0
37207,346,186,160,40,37,34,21,153,65,88,28,21,20,8,0
37208,949,466,483,125,126,101,50,385,212,173,57,40,39,21,0
37209,102,22,80,48,8,18,6,218,114,104,32,31,33,11,0
37210,115,62,53,13,10,9,7,384,204,180,53,47,49,17,0
37211,526,268,258,54,37,55,12,173,94,79,18,24,12,7,0
37212,493,281,212,56,61,30,13,334,181,153,41,40,25,15,0
37213,773,383,390,108,76,79,30,229,120,109,31,30,22,9,0
37214,150,60,90,27,16,6,3,551,226,325,96,103,43,11,0
37215,310,141,169,36,38,20,8,376,189,187,47,53,44,26,0
37216,378,202,176,34,32,44,13,715,345,370,110,97,64,25,0
37217,512,254,258,70,48,37,32,98,49,49,14,15,9,2,0
37218,224,108,116,33,26,32,10,744,385,359,105,96,57,31,0
37219,1041,497,544,180,167,98,34,496,285,211,62,54,46,22,0
37220,435,225,210,58,46,50,14,199,92,107,34,30,18,9,0
37221,711,330,381,111,86,86,34,1241,619,622,183,169,155,59,0
37222,536,237,299,116,87,42,17,336,200,136,34,29,25,24,0
37223,260,133,127,43,29,34,11,1265,689,576,169,177,128,60,0
37224,432,190,242,85,82,28,11,457,253,204,67,51,48,13,0
37225,282,96,186,80,21,28,7,119,61,58,17,12,10,6,0
37226,446,283,163,51,26,33,19,119,61,58,17,12,10,6,0
37227,444,250,194,58,21,60,23,761,351,410,117,73,103,45,0
37228,391,165,226,67,64,36,27,585,277,308,92,73,61,32,0
37229,206,100,106,34,26,11,7,230,125,105,29,40,20,6,0
37230,556,306,250,69,60,80,18,582,264,318,84,60,58,23,0
37231,654,344,310,80,69,57,15,381,196,185,55,57,43,16,0
37232,221,114,107,65,7,2,1,180,108,72,22,22,15,5,0
37233,388,244,144,46,25,42,16,142,73,69,27,9,15,11,0
37234,380,187,193,38,51,30,18,91,42,49,21,9,8,3,0
37235,139,81,58,17,14,24,9,485,244,241,80,55,59,20,0
37236,479,228,251,71,57,60,14,201,99,102,34,26,23,6,0
37237,604,239,365,124,63,84,37,889,505,384,107,97,99,30,0
37238,462,233,229,66,49,43,30,530,287,243,79,70,33,26,0
37239,243,114,129,37,30,32,8,149,77,72,37,10,20,5,0
37240,626,308,318,105,89,77,25,307,132,175,48,53,26,10,0
37241,745,402,343,95,71,69,40,374,181,193,55,58,48,23,0
37242,227,120,107,31,28,28,13,381,186,195,69,55,46,15,0
37243,584,297,287,89,80,65,17,926,340,586,133,119,60,40,0
37244,525,254,271,60,76,46,13,328,199,129,39,29,27,14,0
37245,1544,738,806,239,217,145,91,2547,1280,1267,331,335,293,118,0
37246,2062,706,1356,414,368,158,63,452,254,198,72,57,38,18,0
37247,336,199,137,46,22,51,13,105,51,54,13,17,12,8,0
37248,1226,513,713,184,147,87,43,453,255,198,62,49,29,19,0
37249,478,220,258,47,70,41,10,2225,1244,981,271,243,217,93,0
37250,395,189,206,63,50,49,28,234,129,105,31,22,19,17,0
37251,1360,644,716,213,194,136,62,153,80,73,26,18,19,4,0
37252,452,202,250,83,60,56,19,972,471,501,152,138,112,40,0
37253,908,324,584,181,162,81,29,94,45,49,11,20,10,4,0
37254,956,450,506,122,117,82,36,349,200,149,41,39,30,20,0
37255,505,247,258,72,71,60,27,169,85,84,21,14,9,9,0
37256,270,131,139,47,37,41,11,462,229,233,63,49,42,18,0
37257,301,150,151,45,47,33,13,91,44,47,9,12,4,7,0
37258,2286,1154,1132,338,314,278,103,158,71,87,23,21,17,12,0
37259,359,167,192,49,37,27,19,496,251,245,78,62,61,23,0
37260,426,231,195,51,52,45,24,134,55,79,22,24,16,6,0
37261,181,75,106,35,26,11,9,317,153,164,34,52,30,14,0
37262,245,111,134,36,27,18,6,178,99,79,31,19,26,8,0
37263,509,251,258,69,49,55,17,374,174,200,54,52,42,21,0
37264,1087,523,564,146,177,103,33,413,223,190,52,45,53,10,0
37265,979,534,445,83,77,80,24,519,287,232,68,58,45,21,0
37266,334,155,179,47,34,38,11,464,236,228,64,56,53,28,0
37267,413,206,207,38,55,19,10,397,234,163,44,38,23,21,0
37268,539,283,256,75,73,53,26,101,59,42,11,17,10,1,0
37269,465,220,245,88,34,61,23,374,202,172,50,39,31,24,0
37270,165,66,99,28,32,16,3,262,129,133,40,41,31,10,0
37271,319,222,97,36,23,28,8,629,317,312,80,87,51,22,0
37272,281,154,127,45,31,24,9,261,162,99,24,21,14,10,0
37273,3859,2011,1848,535,391,422,207,166,102,64,19,14,17,2,0
37274,350,172,178,61,45,32,13,902,499,403,118,117,92,35,0
37275,579,321,258,74,70,47,22,147,74,73,28,20,24,4,0
37276,221,75,146,68,21,16,5,320,168,152,38,42,24,18,0
37277,610,249,361,107,69,72,33,501,257,244,75,57,48,29,0
37278,282,96,186,80,21,28,7,299,140,159,49,44,26,11,0
37279,164,81,83,37,8,14,10,194,94,100,33,28,14,7,0
37280,546,265,281,101,64,38,16,531,277,254,82,75,33,22,0
37281,493,208,285,75,77,70,40,1114,539,575,145,131,94,56,0
37282,760,405,355,112,95,92,29,480,255,225,67,64,50,22,0
37283,979,534,445,83,77,80,24,307,132,175,48,53,26,10,0
37284,193,95,98,33,17,25,17,662,312,350,103,104,59,20,0
37285,320,163,157,44,44,26,15,483,258,225,70,53,54,20,0
37286,421,237,184,47,54,45,10,96,45,51,13,12,6,4,0
37287,424,170,254,69,56,47,28,292,155,137,50,34,29,13,0
37288,560,279,281,113,64,58,15,1062,522,540,151,147,105,66,0
37289,520,231,289,89,59,58,26,132,61,71,19,20,14,6,0
37290,941,459,482,167,140,82,38,192,110,82,33,21,10,3,0
37291,583,279,304,99,71,59,31,501,257,244,75,57,48,29,0
37292,752,313,439,121,106,68,27,367,218,149,45,43,42,16,0
37293,343,189,154,44,24,39,12,528,276,252,86,78,49,17,0
37294,760,405,355,112,95,92,29,756,348,408,101,103,60,40,0
37295,331,144,187,57,46,33,19,339,180,159,36,29,16,16,0
37296,206,96,110,33,25,8,6,663,354,309,91,84,79,31,0
37297,92,46,46,14,9,8,6,276,149,127,34,31,32,10,0
37298,2440,1061,1379,377,326,172,62,257,148,109,28,20,21,14,0
37299,445,231,214,45,64,53,23,858,398,460,126,138,75,39,0
37300,589,282,307,68,67,70,23,671,321,350,95,87,75,34,0
37301,439,183,256,60,64,36,14,1065,581,484,134,97,76,46,0
37302,169,64,105,23,37,11,3,242,124,118,39,32,28,22,0
37303,403,176,227,71,56,51,11,445,192,253,86,58,53,18,0
37304,76,42,34,12,8,5,7,497,257,240,71,63,62,16,0
37305,233,110,123,34,22,34,9,663,354,309,91,84,79,31,0
37306,484,192,292,118,68,83,22,2517,1275,1242,304,324,245,135,0
37307,482,245,237,69,64,66,24,301,168,133,49,37,34,11,0
37308,290,156,134,44,29,39,9,218,111,107,45,29,24,6,0
37309,524,270,254,84,72,70,23,384,204,180,53,47,49,17,0
37310,276,149,127,45,34,39,9,319,185,134,42,31,22,13,0
37311,278,110,168,58,49,29,5,649,307,342,71,134,45,17,0
37312,127,48,79,27,20,6,5,514,248,266,86,82,52,22,0
37313,681,367,314,83,74,78,31,732,402,330,81,86,87,33,0
37314,361,171,190,44,40,18,13,756,348,408,101,103,60,40,0
37315,593,325,268,84,66,73,24,1336,599,737,246,184,122,74,0
37316,255,136,119,39,20,32,10,387,193,194,60,53,57,15,0
37317,452,217,235,59,47,60,20,144,67,77,28,14,9,8,0
37318,800,416,384,102,105,83,22,405,214,191,53,42,49,20,0
37319,802,430,372,65,102,87,23,332,155,177,55,51,44,13,0
37320,391,204,187,47,48,38,18,457,242,215,39,46,53,10,0
37321,808,366,442,130,133,66,31,88,50,38,13,8,16,4,0
37322,658,349,309,77,70,73,35,68,23,45,12,9,3,9,0
37323,308,163,145,38,33,30,20,218,115,103,37,33,33,9,0
37324,1342,640,702,187,163,123,57,222,119,103,37,32,24,8,0
37325,1339,494,845,216,298,92,37,818,357,461,122,136,54,25,0
37326,482,245,237,69,64,66,24,482,232,250,77,81,44,13,0
37327,179,96,83,24,8,26,4,352,207,145,40,33,25,21,0
37328,346,174,172,36,43,21,9,374,212,162,48,40,32,23,0
37329,435,230,205,51,37,55,18,519,287,232,68,58,45,21,0
37330,221,114,107,65,7,2,1,316,166,150,45,38,37,13,0
37331,282,96,186,80,21,28,7,403,225,178,56,38,33,25,0
37332,207,89,118,56,8,4,3,749,384,365,108,105,86,31,0
37333,326,154,172,45,39,20,10,403,184,219,75,51,47,20,0
37334,278,110,168,58,49,29,5,337,152,185,49,54,42,21,0
37335,502,229,273,63,66,40,31,387,193,194,60,53,57,15,0
37336,308,163,145,38,33,30,20,165,87,78,24,19,22,9,0
37337,1759,838,921,269,212,191,92,756,348,408,101,103,60,40,0
37338,167,70,97,32,20,15,7,406,234,172,63,35,43,10,0
37339,640,271,369,111,79,57,17,246,107,139,55,33,27,11,0
37340,406,207,199,56,46,68,19,283,160,123,25,20,37,9,0
37341,255,110,145,34,32,23,17,413,223,190,52,45,53,10,0
37342,728,358,370,118,100,55,29,207,114,93,33,20,31,13,0
37343,207,128,79,26,17,19,9,2038,1059,979,262,237,208,100,0
37344,595,316,279,86,60,65,40,531,277,254,82,75,33,22,0
37345,673,317,356,101,85,76,49,332,155,177,55,51,44,13,0
37346,338,208,130,39,30,35,12,198,113,85,19,20,26,12,0
37347,1341,481,860,275,264,57,21,201,93,108,34,39,21,6,0
37348,1531,649,882,108,122,93,72,1113,480,633,170,173,81,34,0
37349,166,59,107,36,41,10,4,375,210,165,49,37,29,27,0
37350,154,74,80,18,19,7,2,189,105,84,25,26,21,9,0
37351,654,344,310,80,69,57,15,469,225,244,64,68,25,11,0
37352,328,195,133,36,23,35,9,501,274,227,63,58,53,20,0
37353,465,220,245,88,34,61,23,404,190,214,55,55,35,27,0
37354,580,240,340,108,81,59,22,274,142,132,33,34,18,14,0
37355,426,213,213,60,56,46,24,374,202,172,50,39,31,24,0
37356,213,114,99,62,7,2,1,332,180,152,46,36,28,14,0
37357,879,457,422,93,98,143,32,536,251,285,75,79,60,23,0
37358,454,214,240,56,71,35,16,395,198,197,55,55,36,10,0
37359,561,282,279,68,62,36,14,422,237,185,53,47,62,20,0
37360,465,220,245,88,34,61,23,260,131,129,42,31,40,9,0
37361,302,160,142,35,35,37,10,368,204,164,43,35,30,24,0
37362,1064,495,569,157,159,124,58,106,41,65,36,6,11,7,0
37363,552,295,257,67,49,70,30,290,147,143,34,34,39,13,0
37364,67,40,27,10,8,7,6,230,125,105,29,40,20,6,0
37365,411,211,200,61,46,35,18,397,234,163,44,38,23,21,0
37366,785,351,434,136,93,71,37,106,46,60,29,13,14,5,0
37367,552,295,257,67,49,70,30,247,128,119,34,14,16,14,0
37368,270,130,140,43,24,36,10,975,400,575,160,162,62,31,0
37369,309,137,172,51,50,28,14,501,249,252,77,70,55,22,0
37370,2136,1063,1073,317,308,223,90,396,213,183,68,44,47,18,0
37371,346,208,138,46,39,51,18,644,343,301,96,69,59,28,0
37372,260,138,122,44,30,28,6,501,249,252,77,70,55,22,0
37373,575,295,280,89,68,54,18,405,195,210,57,74,24,17,0
37374,439,183,256,60,64,36,14,647,324,323,101,80,76,43,0
37375,786,378,408,106,98,77,39,277,144,133,42,30,41,8,0
37376,562,214,348,120,86,69,42,65,32,33,16,4,8,3,0
37377,375,201,174,52,56,39,15,286,160,126,37,27,23,10,0
37378,589,282,307,68,67,70,23,271,150,121,39,36,37,5,0
37379,766,336,430,133,97,79,21,386,207,179,43,48,44,19,0
37380,360,205,155,35,24,52,14,395,198,197,55,55,36,10,0
37381,548,250,298,85,64,56,21,974,457,517,133,117,69,26,0
37382,270,128,142,36,43,15,11,455,191,264,68,86,21,19,0
37383,526,268,258,54,37,55,12,207,86,121,34,39,11,13,0
37384,319,222,97,36,23,28,8,455,229,226,66,62,63,29,0
37385,414,206,208,56,68,35,19,323,171,152,48,41,40,16,0
37386,340,145,195,46,38,26,23,292,143,149,38,42,36,16,0
37387,2696,1169,1527,432,347,193,146,178,69,109,29,25,21,13,0
37388,392,221,171,53,30,25,8,380,211,169,47,37,33,21,0
37389,2000,965,1035,357,313,198,75,465,252,213,73,58,60,18,0
37390,284,128,156,48,29,34,8,419,233,186,54,53,55,17,0
37391,364,192,172,49,36,39,14,232,108,124,33,27,19,16,0
37392,1556,718,838,280,182,161,49,974,457,517,133,117,69,26,0
37393,904,436,468,138,146,82,39,1543,794,749,182,152,132,55,0
37394,510,288,222,44,36,24,7,278,154,124,42,32,38,7,0
37395,726,312,414,121,73,82,23,415,189,226,68,54,50,21,0
37396,466,259,207,59,50,83,12,362,156,206,74,42,36,22,0
37397,953,421,532,131,131,70,37,415,205,210,77,52,55,17,0
37398,474,243,231,66,54,41,29,171,94,77,24,28,30,11,0
37399,397,180,217,61,59,39,13,457,253,204,67,51,48,13,0
37400,2063,1024,1039,175,117,80,97,203,98,105,34,29,19,10,0
37401,435,222,213,67,49,67,12,1065,581,484,134,97,76,46,0
37402,420,248,172,64,30,43,17,530,287,243,79,70,33,26,0
37403,525,302,223,56,48,67,19,266,150,116,28,28,24,12,0
37404,388,244,144,46,25,42,16,222,122,100,39,32,24,9,0
37405,453,240,213,53,33,44,16,966,478,488,108,144,74,43,0
37406,449,179,270,80,77,49,29,198,115,83,30,22,8,8,0
37407,758,378,380,89,64,37,31,145,77,68,26,7,15,8,0
37408,345,203,142,47,35,31,11,1047,562,485,141,127,114,41,0
37409,949,467,482,126,127,102,51,947,482,465,143,107,89,37,0
37410,71,39,32,7,11,6,4,96,45,51,13,12,6,4,0
37411,496,209,287,112,55,71,14,741,383,358,92,63,79,36,0
37412,1336,724,612,209,141,133,60,751,394,357,107,96,73,35,0
37413,873,366,507,127,125,75,21,1208,565,643,182,162,120,57,0
37414,900,434,466,134,97,86,36,729,358,371,116,99,89,33,0
37415,1594,660,934,251,272,117,77,127,58,69,18,17,10,5,0
37416,496,274,222,57,43,75,22,449,252,197,61,52,36,18,0
37417,630,231,399,150,83,84,50,620,324,296,81,68,66,31,0
37418,331,177,154,54,38,27,11,132,77,55,20,9,13,10,0
37419,322,164,158,46,44,29,7,251,143,108,47,25,29,11,0
37420,535,217,318,87,106,41,14,374,181,193,55,58,48,23,0
37421,199,107,92,41,15,14,8,974,457,517,133,117,69,26,0
37422,419,210,209,54,44,31,23,541,279,262,79,82,31,32,0
37423,493,208,285,75,77,70,40,245,131,114,30,27,18,13,0
37424,1139,537,602,162,139,109,50,335,186,149,40,28,29,13,0
37425,186,56,130,46,50,16,7,332,173,159,48,40,31,11,0
37426,664,269,395,117,107,36,15,579,285,294,78,72,64,32,0
37427,531,260,271,97,68,47,11,139,68,71,14,26,14,9,0
37428,302,160,142,35,35,37,10,479,215,264,67,80,46,28,0
37429,431,216,215,46,40,33,9,106,54,52,12,9,7,6,0
37430,308,163,145,38,33,30,20,862,409,453,149,125,86,29,0
37431,188,84,104,35,36,18,9,457,253,204,67,51,48,13,0
37432,305,124,181,27,25,31,21,665,361,304,87,91,84,31,0
37433,380,185,195,68,54,32,16,374,212,162,48,40,32,23,0
37434,259,119,140,48,28,29,19,134,55,79,22,24,16,6,0
37435,341,195,146,42,21,36,9,710,375,335,95,94,110,28,0
37436,340,145,195,46,38,26,23,627,289,338,101,73,62,43,0
37437,374,187,187,51,52,40,27,309,159,150,47,43,43,13,0
37438,440,267,173,52,29,42,12,818,357,461,122,136,54,25,0
37439,451,225,226,69,57,64,22,166,102,64,19,14,17,2,0
37440,501,230,271,63,90,50,18,903,436,467,128,116,83,33,0
37441,514,226,288,71,66,63,32,758,319,439,101,123,78,25,0
37442,1759,838,921,269,212,191,92,142,65,77,30,17,22,9,0
37443,121,69,52,15,18,14,8,453,247,206,58,53,45,20,0
37444,130,70,60,30,9,8,1,201,93,108,34,39,21,6,0
37445,265,165,100,32,19,27,5,244,143,101,31,29,26,8,0
37446,1208,575,633,187,204,117,41,348,212,136,53,31,25,18,0
37447,577,251,326,92,84,60,11,508,262,246,66,67,51,20,0
37448,753,361,392,99,94,66,16,463,170,293,115,54,75,32,0
37449,773,383,390,108,76,79,30,302,150,152,56,40,52,15,0
37450,528,273,255,67,53,29,20,392,155,237,68,61,34,16,0
37451,332,170,162,44,38,39,10,415,189,226,68,54,50,21,0
37452,220,113,107,37,24,16,7,158,71,87,23,21,17,12,0
37453,222,110,112,43,30,14,6,1249,638,611,166,153,141,45,0
37454,886,440,446,116,140,95,45,331,180,151,46,35,47,17,0
37455,2174,1057,1117,241,241,214,117,274,157,117,40,29,40,8,0
37456,407,230,177,44,39,34,19,621,273,348,104,102,48,19,0
37457,479,228,251,71,57,60,14,900,441,459,125,127,110,32,0
37458,717,381,336,118,103,85,29,536,222,314,101,100,34,22,0
37459,1647,794,853,279,235,128,65,583,280,303,95,66,76,25,0
37460,335,155,180,64,48,36,10,387,193,194,60,53,57,15,0
37461,4128,2104,2024,581,505,453,205,257,126,131,61,24,22,8,0
37462,447,236,211,56,52,49,14,1395,627,768,172,263,141,59,0
37463,329,171,158,49,41,31,10,334,181,153,41,40,25,15,0
37464,330,151,179,68,36,56,9,312,165,147,41,39,29,16,0
37465,323,156,167,52,45,39,18,749,384,365,108,105,86,31,0
37466,184,88,96,15,40,17,8,198,113,85,19,20,26,12,0
37467,361,177,184,59,51,24,15,341,170,171,41,66,27,10,0
37468,336,199,137,46,22,51,13,501,249,252,77,70,55,22,0
37469,227,109,118,42,35,29,8,1323,690,633,132,178,112,61,0
37470,540,252,288,73,67,57,20,108,59,49,17,13,12,5,0
37471,746,312,434,129,115,77,47,132,77,55,20,9,13,10,0
37472,911,489,422,121,98,97,36,498,244,254,81,67,58,19,0
37473,772,332,440,136,104,72,28,163,79,84,22,24,13,5,0
37474,340,145,195,46,38,26,23,858,398,460,126,138,75,39,0
37475,335,183,152,40,26,54,22,231,126,105,37,26,29,6,0
37476,784,351,433,118,87,73,41,464,236,228,64,56,53,28,0
37477,92,46,46,14,9,8,6,326,169,157,51,41,41,12,0
37478,2279,996,1283,375,328,158,60,509,267,242,79,81,38,20,0
37479,406,208,198,41,26,43,21,309,159,150,47,43,43,13,0
37480,674,268,406,118,96,70,21,496,251,245,78,62,61,23,0
37481,136,66,70,33,11,9,3,1113,480,633,170,173,81,34,0
37482,410,188,222,53,52,31,14,671,306,365,114,76,49,19,0
37483,395,219,176,47,41,50,18,256,141,115,32,22,32,8,0
37484,496,209,287,112,55,71,14,561,279,282,85,81,88,24,0
37485,143,81,62,28,9,8,1,963,525,438,119,102,102,34,0
37486,234,110,124,39,29,23,2,293,142,151,49,40,42,17,0
37487,243,100,143,58,50,24,5,1061,543,518,146,123,109,67,0
37488,1647,794,853,279,235,128,65,147,74,73,28,20,24,4,0
37489,524,262,262,62,72,39,49,338,169,169,53,44,39,21,0
37490,651,357,294,81,67,103,18,323,168,155,51,41,38,12,0
37491,505,201,304,116,58,75,31,397,234,163,44,38,23,21,0
37492,733,382,351,126,92,93,27,330,166,164,55,51,36,16,0
37493,1139,537,602,162,139,109,50,292,155,137,50,34,29,13,0
37494,508,251,257,74,53,51,18,679,338,341,96,95,40,23,0
37495,496,210,286,112,55,71,14,588,286,302,78,99,53,25,0
37496,83,45,38,11,8,8,3,947,482,465,143,107,89,37,0
37497,1051,429,622,179,148,125,54,474,268,206,66,42,45,24,0
37498,1030,567,463,118,106,94,49,1873,935,938,233,225,203,79,0
37499,482,231,251,76,81,64,26,222,125,97,34,27,27,7,0
37500,1096,563,533,158,136,120,53,194,94,100,33,28,14,7,0
37501,417,176,241,75,61,51,20,266,150,116,28,28,24,12,0
37502,1174,594,580,175,155,126,66,1004,457,547,150,150,74,52,0
37503,609,292,317,102,96,64,21,203,98,105,34,29,19,10,0
37504,228,82,146,45,37,18,8,690,345,345,96,83,73,42,0
37505,399,196,203,62,45,38,19,662,312,350,103,104,59,20,0
37506,435,222,213,67,49,67,12,266,150,116,28,28,24,12,0
37507,439,211,228,65,73,26,21,195,100,95,27,20,17,11,0
37508,643,284,359,129,71,84,43,349,200,149,41,39,30,20,0
37509,548,250,298,85,64,56,21,609,335,274,79,57,45,22,0
37510,227,120,107,31,28,28,13,729,358,371,116,99,89,33,0
37511,480,267,213,49,44,70,21,452,254,198,72,57,38,18,0
37512,526,228,298,69,64,32,30,198,110,88,27,27,24,4,0
37513,291,142,149,50,29,35,7,322,180,142,45,38,28,7,0
37514,315,111,204,82,66,46,11,346,178,168,58,41,33,12,0
37515,180,92,88,29,20,26,8,858,461,397,125,114,79,45,0
37516,279,129,150,43,34,17,13,165,90,75,36,18,20,6,0
37517,356,199,157,36,43,28,12,399,190,209,61,41,39,18,0
37518,820,333,487,202,152,59,23,374,174,200,54,52,42,21,0
37519,452,202,250,83,60,56,19,277,163,114,33,24,21,16,0
37520,1186,495,691,182,208,88,32,314,151,163,42,61,39,16,0
37521,338,172,166,59,30,39,18,156,90,66,17,22,11,10,0
37522,546,265,281,101,64,38,16,464,236,228,64,56,53,28,0
37523,528,273,255,67,53,29,20,2225,1244,981,271,243,217,93,0
37524,466,199,267,86,59,32,17,405,195,210,57,74,24,17,0
37525,730,298,432,128,69,86,26,593,257,336,76,56,56,96,0
37526,360,205,155,35,24,52,14,247,128,119,34,14,16,14,0
37527,345,208,137,44,27,33,8,223,113,110,31,33,22,12,0
37528,86,50,36,9,14,8,7,292,143,149,38,42,36,16,0
37529,328,195,133,36,23,35,9,415,205,210,77,52,55,17,0
37530,1912,880,1032,331,334,180,84,251,143,108,47,25,29,11,0
37531,343,162,181,65,38,29,12,138,69,69,28,7,10,10,0
37532,111,29,82,10,54,0,1,153,80,73,26,18,19,4,0
37533,227,109,118,42,35,29,8,180,95,85,22,21,17,8,0
37534,1007,353,654,277,147,70,26,381,187,194,37,49,36,17,0
37535,747,360,387,125,92,69,32,106,54,52,12,9,7,6,0
37536,209,75,134,53,48,20,9,483,258,225,70,53,54,20,0
37537,304,149,155,46,32,39,14,419,233,186,54,53,55,17,0
37538,215,104,111,61,7,2,1,1025,549,476,118,109,88,61,0
37539,550,304,246,60,64,77,16,775,407,368,122,100,97,32,0
37540,586,298,288,80,75,64,37,188,90,98,44,7,21,7,0
37541,299,151,148,35,34,26,16,455,191,264,68,86,21,19,0
37542,443,206,237,76,68,52,28,270,162,108,26,26,16,11,0
37543,458,210,248,39,38,25,16,207,113,94,33,18,30,9,0
37544,342,185,157,42,27,31,14,773,389,384,119,91,79,26,0
37545,439,211,228,65,73,26,21,160,67,93,32,37,15,9,0
37546,126,66,60,24,10,7,9,308,146,162,42,39,24,12,0
37547,319,222,97,36,23,28,8,393,210,183,58,37,34,20,0
37548,246,111,135,64,47,27,3,260,131,129,42,31,40,9,0
37549,546,265,281,101,64,38,16,336,200,136,34,29,25,24,0
37550,315,170,145,48,56,22,11,701,380,321,94,84,96,34,0
37551,2799,1324,1475,369,371,215,124,375,209,166,50,37,29,23,0
37552,682,292,390,89,69,58,20,258,129,129,45,24,31,10,0
37553,956,450,506,122,117,82,36,367,218,149,45,43,42,16,0
37554,209,75,134,53,48,20,9,592,249,343,91,90,50,42,0
37555,193,90,103,44,9,19,13,173,94,79,18,24,12,7,0
37556,55,16,39,24,2,5,2,710,375,335,95,94,110,28,0
37557,262,133,129,44,38,31,12,256,141,115,32,22,32,8,0
37558,1556,718,838,280,182,161,49,701,380,321,94,84,96,34,0
37559,315,174,141,46,38,47,16,350,196,154,52,37,21,14,0
37560,315,174,141,46,38,47,16,163,79,84,22,24,13,5,0
37561,530,259,271,83,50,54,41,818,357,461,122,136,54,25,0
37562,450,231,219,77,50,76,16,396,223,173,57,37,44,19,0
37563,331,177,154,54,38,27,11,329,194,135,45,32,33,9,0
37564,476,199,277,82,80,49,24,376,189,187,47,53,44,26,0
37565,164,77,87,33,19,6,7,903,436,467,128,116,83,33,0
37566,802,430,372,65,102,87,23,142,65,77,30,17,22,9,0
37567,870,436,434,131,114,72,25,878,430,448,141,122,113,49,0
37568,291,131,160,49,35,32,15,463,268,195,59,46,46,21,0
37569,241,122,119,27,34,17,16,149,77,72,37,10,20,5,0
37570,404,197,207,60,48,47,20,422,202,220,80,52,57,18,0
37571,734,366,368,121,99,63,39,277,124,153,44,40,35,18,0
37572,344,109,235,100,39,26,5,462,251,211,74,53,41,18,0
37573,1499,864,635,141,99,76,110,316,166,150,45,38,37,13,0
37574,333,171,162,50,34,19,8,127,66,61,13,14,19,8,0
37575,317,167,150,45,21,30,26,439,227,212,60,55,58,8,0
37576,2220,1085,1135,312,304,202,91,600,254,346,104,100,44,17,0
37577,795,384,411,133,109,85,38,305,161,144,39,40,44,17,0
37578,517,245,272,92,77,46,24,267,141,126,53,27,23,7,0
37579,243,114,129,37,30,32,8,203,98,105,34,29,19,10,0
37580,1064,495,569,157,159,124,58,362,156,206,74,42,36,22,0
37581,828,355,473,126,134,77,37,1040,564,476,134,110,114,51,0
37582,1011,559,452,121,97,132,33,73,35,38,14,10,9,4,0
37583,431,199,232,59,54,40,17,287,151,136,51,42,36,7,0
37584,124,58,66,20,28,11,7,293,142,151,49,40,42,17,0
37585,639,368,271,72,51,38,38,396,197,199,75,49,49,16,0
37586,465,225,240,65,44,65,25,1127,527,600,147,128,83,58,0
37587,983,449,534,95,77,55,36,406,202,204,54,51,63,21,0
37588,1171,542,629,170,146,114,64,256,141,115,32,22,32,8,0
37589,130,70,60,30,9,8,1,242,124,118,39,32,28,22,0
37590,1447,698,749,214,180,116,46,453,255,198,62,49,29,19,0
37591,301,119,182,53,47,14,20,483,287,196,71,50,54,17,0
37592,589,282,307,68,67,70,23,1338,720,618,179,145,141,85,0
37593,172,82,90,21,35,21,5,737,397,340,87,104,90,14,0
37594,489,253,236,73,36,62,17,244,143,101,31,29,26,8,0
37595,1498,731,767,220,175,148,68,175,91,84,19,21,21,10,0
37596,349,131,218,66,76,22,9,283,142,141,41,33,26,18,0
37597,391,204,187,47,48,38,18,331,180,151,46,35,47,17,0
37598,1107,601,506,155,138,103,49,419,233,186,54,53,55,17,0
37599,326,154,172,45,39,20,10,323,168,155,51,41,38,12,0
37600,562,214,348,120,86,69,42,89,51,38,15,15,5,4,0
37601,454,230,224,63,56,38,33,362,156,206,74,42,36,22,0
37602,1390,585,805,241,230,118,46,1034,495,539,150,134,114,71,0
37603,345,208,137,44,27,33,8,474,268,206,66,42,45,24,0
37604,508,267,241,43,35,25,17,1425,670,755,153,189,122,85,0
37605,727,426,301,79,71,64,32,173,94,79,18,24,12,7,0
37606,798,287,511,126,125,77,26,278,154,124,42,32,38,7,0
37607,127,62,65,13,33,7,6,551,226,325,96,103,43,11,0
37608,332,173,159,48,42,42,9,227,130,97,32,25,22,12,0
37609,610,249,361,107,69,72,33,138,69,69,28,7,10,10,0
37610,376,176,200,31,53,27,8,1061,543,518,146,123,109,67,0
37611,335,148,187,52,26,51,12,607,293,314,98,71,62,32,0
37612,126,56,70,31,10,10,3,403,221,182,62,50,42,12,0
37613,178,89,89,40,12,18,7,397,223,174,50,39,29,17,0
37614,616,304,312,75,71,55,25,104,46,58,15,17,9,5,0
37615,492,253,239,73,67,77,29,386,207,179,43,48,44,19,0
37616,423,247,176,58,55,29,20,105,51,54,13,17,12,8,0
37617,126,56,70,31,10,10,3,188,88,100,53,12,15,6,0
37618,251,139,112,41,18,27,11,277,152,125,31,35,22,19,0
37619,130,71,59,30,9,8,1,708,328,380,113,100,82,34,0
37620,836,370,466,126,96,72,30,397,223,174,50,39,29,17,0
37621,347,181,166,27,20,12,12,594,312,282,72,67,73,31,0
37622,722,390,332,125,69,67,25,1062,522,540,151,147,105,66,0
37623,240,99,141,53,38,29,15,225,111,114,32,34,32,16,0
37624,282,163,119,40,23,25,17,169,74,95,33,26,22,3,0
37625,785,374,411,56,42,38,25,514,262,252,78,58,54,26,0
37626,368,154,214,80,52,41,16,332,173,159,48,40,31,11,0
37627,437,212,225,66,44,44,11,94,45,49,11,20,10,4,0
37628,732,355,377,108,109,79,27,1606,753,853,215,227,182,48,0
37629,577,342,235,63,57,23,37,395,169,226,73,55,38,9,0
37630,231,105,126,56,10,24,10,647,324,323,101,80,76,43,0
37631,1542,682,860,290,158,120,47,727,362,365,123,107,63,23,0
37632,359,204,155,39,36,34,13,276,149,127,34,31,32,10,0
37633,452,202,250,83,60,56,19,538,274,264,84,67,52,35,0
37634,327,174,153,42,35,16,12,556,290,266,75,74,29,24,0
37635,410,200,210,60,54,46,19,690,345,345,96,83,73,42,0
37636,745,402,343,95,71,69,40,201,93,108,34,39,21,6,0
37637,468,233,235,65,61,49,34,194,109,85,23,24,21,9,0
37638,344,168,176,50,39,30,20,329,196,133,41,36,31,15,0
37639,502,229,273,63,66,40,31,611,314,297,79,75,78,22,0
37640,793,355,438,134,117,77,43,1606,753,853,215,227,182,48,0
37641,457,261,196,55,27,57,34,261,127,134,36,27,36,4,0
37642,1163,417,746,209,145,87,28,660,332,328,84,73,47,19,0
37643,144,57,87,38,26,10,4,286,160,126,37,27,23,10,0
37644,535,217,318,87,106,41,14,375,209,166,50,37,29,23,0
37645,658,349,309,77,70,73,35,285,143,142,45,32,21,17,0
37646,127,62,65,13,33,7,6,783,406,377,102,91,57,29,0
37647,260,133,127,43,29,34,11,323,168,155,51,41,38,12,0
37648,677,361,316,81,61,42,22,164,79,85,28,28,16,7,0
37649,204,109,95,21,35,27,7,204,96,108,31,37,20,5,0
37650,853,400,453,137,109,88,42,132,61,71,19,20,14,6,0
37651,423,247,176,58,55,29,20,111,60,51,17,23,10,7,0
37652,426,213,213,60,56,46,24,89,38,51,14,6,3,9,0
37653,469,253,216,49,51,48,18,337,152,185,49,54,42,21,0
37654,605,277,328,99,54,63,43,188,93,95,33,18,16,10,0
37655,800,328,472,159,159,41,15,142,76,66,21,21,22,11,0
37656,805,338,467,153,138,99,55,359,171,188,49,74,45,11,0
37657,734,339,395,135,89,78,36,413,223,190,52,45,53,10,0
37658,260,138,122,44,30,28,6,640,364,276,84,68,69,33,0
37659,365,222,143,44,24,35,11,778,391,387,94,77,41,33,0
37660,852,461,391,109,102,72,24,374,191,183,40,52,40,16,0
37661,479,228,251,71,57,60,14,452,231,221,74,53,56,20,0
37662,1220,575,645,208,179,99,56,349,200,149,41,39,30,20,0
37663,233,110,123,34,22,34,9,1114,539,575,145,131,94,56,0
37664,575,295,280,89,68,54,18,377,184,193,50,43,33,17,0
37665,512,254,258,70,48,37,32,413,223,190,52,45,53,10,0
37666,557,211,346,129,125,48,19,935,515,420,126,107,73,32,0
37667,349,131,218,66,76,22,9,654,295,359,99,88,71,25,0
37668,1011,559,452,121,97,132,33,647,350,297,95,79,77,29,0
37669,332,170,162,44,38,39,10,619,305,314,85,93,71,29,0
37670,255,136,119,39,20,32,10,326,149,177,51,51,28,10,0
37671,1257,464,793,221,264,75,37,1543,794,749,182,152,132,55,0
37672,519,245,274,58,61,34,22,640,364,276,84,68,69,33,0
37673,313,178,135,43,18,35,6,148,69,79,26,18,16,3,0
37674,949,466,483,125,126,101,50,225,114,111,32,29,26,6,0
37675,231,105,126,56,10,24,10,744,385,359,105,96,57,31,0
37676,139,64,75,18,17,18,4,406,223,183,61,53,46,17,0
37677,243,100,143,58,50,24,5,974,457,517,133,117,69,26,0
37678,852,461,391,109,102,72,24,535,288,247,79,72,35,21,0
37679,380,187,193,38,51,30,18,175,91,84,19,21,21,10,0
37680,919,444,475,141,148,62,20,73,35,38,14,10,9,4,0
37681,130,70,60,30,9,8,1,160,60,100,23,40,19,11,0
37682,308,129,179,44,60,19,8,332,180,152,46,36,28,14,0
37683,476,254,222,58,33,46,23,1606,753,853,215,227,182,48,0
37684,135,64,71,31,11,8,4,2542,1245,1297,285,287,170,84,0
37685,688,310,378,130,82,78,47,1606,753,853,215,227,182,48,0
37686,879,457,422,93,98,143,32,402,186,216,64,47,38,20,0
37687,261,126,135,41,36,24,11,334,181,153,56,31,28,18,0
37688,304,149,155,46,32,39,14,1208,565,643,182,162,120,57,0
37689,449,179,270,80,77,49,29,536,267,269,60,70,41,22,0
37690,567,256,311,91,81,53,17,200,89,111,26,25,17,7,0
37691,373,164,209,51,45,44,21,963,455,508,127,130,115,48,0
37692,128,67,61,29,9,9,1,189,95,94,25,33,16,8,0
37693,456,214,242,76,62,52,22,439,231,208,65,51,55,17,0
37694,210,101,109,33,33,19,9,732,402,330,81,86,87,33,0
37695,773,383,390,108,76,79,30,461,223,238,45,62,18,35,0
37696,536,237,299,116,87,42,17,498,244,254,81,67,58,19,0
37697,692,305,387,100,97,78,30,926,340,586,133,119,60,40,0
37698,325,177,148,40,24,23,13,408,221,187,55,51,57,14,0
37699,126,57,69,31,10,10,3,866,397,469,117,153,95,48,0
37700,904,436,468,138,146,82,39,339,180,159,36,29,16,16,0
37701,496,210,286,111,55,74,13,1537,701,836,209,187,129,58,0
37702,412,193,219,69,57,43,14,1314,693,621,174,155,140,58,0
37703,376,249,127,47,23,43,16,390,190,200,66,50,43,12,0
37704,412,146,266,106,38,67,35,1606,753,853,215,227,182,48,0
37705,682,292,390,89,69,58,20,904,436,468,143,118,108,32,0
37706,218,133,85,20,19,13,6,337,170,167,59,33,47,17,0
37707,1960,875,1085,287,189,162,66,660,333,327,102,95,69,31,0
37708,571,298,273,81,72,57,25,375,176,199,48,61,40,12,0
37709,346,209,137,46,37,44,10,535,301,234,63,48,47,27,0
37710,442,254,188,46,22,40,19,953,489,464,126,104,111,44,0
37711,898,397,501,102,98,54,37,169,74,95,33,26,22,3,0
37712,415,217,198,50,31,42,17,375,210,165,49,37,29,27,0
37713,465,240,225,50,54,24,14,406,234,172,63,35,43,10,0
37714,280,128,152,39,37,38,18,665,361,304,87,91,84,31,0
37715,755,271,484,113,226,61,20,928,440,488,111,157,82,35,0
37716,118,56,62,24,12,6,9,445,192,253,86,58,53,18,0
37717,286,111,175,51,47,21,12,1239,659,580,169,148,131,54,0
37718,126,57,69,31,10,10,3,405,214,191,53,42,49,20,0
37719,2236,1195,1041,227,187,186,118,320,168,152,38,42,24,18,0
37720,319,153,166,61,52,26,12,1061,543,518,146,123,109,67,0
37721,150,64,86,22,12,29,12,418,223,195,51,45,49,14,0
37722,278,110,168,58,49,29,5,285,146,139,41,41,48,13,0
37723,335,148,187,52,26,51,12,2547,1280,1267,331,335,293,118,0
37724,624,222,402,92,81,39,15,811,361,450,124,107,80,31,0
37725,67,40,27,10,8,7,6,556,290,266,75,74,29,24,0
37726,127,62,65,13,33,7,6,1239,659,580,169,148,131,54,0
37727,584,340,244,77,60,47,25,354,183,171,54,43,49,8,0
37728,204,103,101,16,32,22,8,798,385,413,120,115,79,30,0
37729,258,144,114,33,22,19,9,290,147,143,34,34,39,13,0
37730,90,54,36,20,4,14,5,374,174,200,54,52,42,21,0
37731,441,216,225,57,66,57,19,729,358,371,116,99,89,33,0
37732,126,58,68,31,10,10,3,389,207,182,53,58,52,18,0
37733,170,82,88,32,23,22,8,548,273,275,84,81,64,30,0
37734,443,212,231,74,24,60,24,222,125,97,34,27,27,7,0
37735,1052,492,560,184,163,103,44,418,223,195,53,43,49,15,0
37736,772,417,355,118,92,80,23,375,176,199,48,61,40,12,0
37737,1341,481,860,275,264,57,21,579,285,294,78,72,64,32,0
37738,249,114,135,47,33,25,4,515,276,239,62,59,43,31,0
37739,397,180,217,61,59,39,13,153,80,73,26,18,19,4,0
37740,586,309,277,81,64,76,25,447,179,268,81,49,35,29,0
37741,226,120,106,68,8,2,1,251,143,108,47,25,29,11,0
37742,325,152,173,43,47,28,17,303,138,165,47,46,35,18,0
37743,1011,559,452,121,97,132,33,277,145,132,41,32,22,10,0
37744,507,242,265,53,44,31,22,389,210,179,51,37,43,9,0
37745,359,167,192,49,37,27,19,482,232,250,77,81,44,13,0
37746,789,362,427,90,82,70,35,622,344,278,80,77,68,36,0
37747,335,155,180,64,48,36,10,846,425,421,125,97,98,38,0
37748,129,70,59,29,9,7,2,297,164,133,45,39,40,9,0
37749,840,411,429,122,101,79,34,457,253,204,67,51,48,13,0
37750,188,84,104,35,36,18,9,1154,489,665,200,196,95,54,0
37751,631,316,315,64,57,49,15,148,84,64,30,7,17,4,0
37752,2525,1232,1293,398,317,186,61,665,361,304,87,91,84,31,0
37753,130,70,60,30,9,8,1,1265,689,576,169,177,128,60,0
37754,1058,497,561,194,142,87,63,699,334,365,108,80,70,20,0
37755,2285,1219,1066,207,180,178,106,277,144,133,42,30,41,8,0
37756,346,209,137,46,37,44,10,106,54,52,12,9,7,6,0
37757,1872,837,1035,280,338,169,80,729,358,371,116,99,89,33,0
37758,446,283,163,51,26,33,19,309,159,150,47,43,43,13,0
37759,164,77,87,33,19,6,7,260,131,129,42,31,40,9,0
37760,283,172,111,39,31,29,8,898,469,429,125,125,134,35,0
37761,281,154,127,45,31,24,9,295,160,135,44,36,46,16,0
37762,403,176,227,71,56,51,11,402,186,216,64,47,38,20,0
37763,546,265,281,101,64,38,16,723,353,370,120,109,96,33,0
37764,412,203,209,65,47,37,18,199,105,94,27,27,28,9,0
37765,350,212,138,32,26,40,13,903,436,467,128,116,83,33,0
37766,527,276,251,64,60,70,20,106,46,60,29,13,14,5,0
37767,854,435,419,118,91,95,42,363,180,183,60,34,10,6,0
37768,126,56,70,31,10,10,3,88,50,38,13,8,16,4,0
37769,347,181,166,27,20,12,12,147,74,73,28,20,24,4,0
37770,432,190,242,85,82,28,11,2517,1275,1242,304,324,245,135,0
37771,162,73,89,32,19,4,4,201,104,97,36,32,24,7,0
37772,473,217,256,59,44,34,21,396,199,197,54,50,45,14,0
37773,124,58,66,20,28,11,7,127,66,61,13,14,19,8,0
37774,532,254,278,91,48,23,17,620,324,296,81,68,66,31,0
37775,631,316,315,64,57,49,15,132,77,55,20,9,13,10,0
37776,772,332,440,136,104,72,28,2202,1121,1081,338,274,269,81,0
37777,461,207,254,82,66,55,33,843,391,452,139,104,91,35,0
37778,272,136,136,32,34,12,12,286,160,126,37,27,23,10,0
37779,552,295,257,67,49,70,30,376,183,193,50,50,43,21,0
37780,361,171,190,44,40,18,13,1062,522,540,151,147,105,66,0
37781,372,171,201,47,53,39,18,520,244,276,91,60,68,20,0
37782,127,55,72,25,18,5,7,373,189,184,54,46,50,23,0
37783,249,104,145,47,41,24,17,286,160,126,37,27,23,10,0
37784,728,358,370,118,100,55,29,192,110,82,33,21,10,3,0
37785,919,444,475,141,148,62,20,299,140,159,49,44,26,11,0
37786,805,338,467,153,138,99,55,54,26,28,11,4,3,3,0
37787,3969,1703,2266,619,432,259,144,223,113,110,31,33,22,12,0
37788,3969,1703,2266,619,432,259,144,397,223,174,50,39,29,17,0
37789,331,165,166,52,34,48,22,541,279,262,79,82,31,32,0
37790,571,298,273,81,72,57,25,293,142,151,49,40,42,17,0
37791,241,122,119,27,34,17,16,370,173,197,65,57,42,10,0
37792,436,209,227,66,47,52,22,400,187,213,56,59,42,20,0
37793,502,236,266,66,66,58,17,300,148,152,45,43,40,8,0
37794,1439,713,726,195,180,110,34,137,78,59,22,16,17,4,0
37795,727,426,301,79,71,64,32,1001,417,584,186,147,96,47,0
37796,305,124,181,27,25,32,21,106,54,52,12,9,7,6,0
37797,879,457,422,93,98,143,32,723,363,360,107,106,52,14,0
37798,1560,778,782,224,235,132,78,277,138,139,40,39,20,14,0
37799,330,182,148,47,27,40,11,455,191,264,68,86,21,19,0
37800,475,235,240,77,58,43,22,201,99,102,34,26,23,6,0
37801,270,131,139,47,37,41,11,644,343,301,96,69,59,28,0
37802,584,297,287,89,80,65,17,231,126,105,28,26,34,9,0
37803,243,70,173,54,65,8,6,588,286,302,78,99,53,25,0
37804,130,71,59,30,9,8,1,821,394,427,122,117,109,38,0
37805,1148,472,676,229,164,86,37,230,125,105,29,40,20,6,0
37806,130,70,60,30,9,8,1,212,127,85,28,21,26,6,0
37807,510,269,241,66,67,71,26,212,127,85,28,21,26,6,0
37808,1121,458,663,158,210,76,47,710,375,335,95,94,110,28,0
37809,443,206,237,76,68,52,28,225,129,96,32,33,20,8,0
37810,412,208,204,54,47,42,17,611,314,297,79,75,78,22,0
37811,282,163,119,40,23,25,17,91,42,49,21,9,8,3,0
37812,743,377,366,87,74,68,30,246,107,139,55,33,27,11,0
37813,1161,514,647,159,138,122,37,323,171,152,48,41,40,16,0
37814,953,421,532,131,131,70,37,439,231,208,65,51,55,17,0
37815,220,121,99,28,26,17,6,751,394,357,107,96,73,35,0
37816,126,58,68,31,10,10,3,1537,701,836,209,187,129,58,0
37817,631,316,315,64,57,49,15,396,199,197,54,50,45,14,0
37818,391,204,187,47,48,38,18,531,277,254,82,75,33,22,0
37819,1023,449,574,141,174,76,43,213,129,84,32,14,21,15,0
37820,227,120,107,31,28,28,13,459,260,199,56,42,47,21,0
37821,438,185,253,71,64,52,28,373,189,184,54,46,50,23,0
37822,376,176,200,31,53,27,8,564,264,300,79,84,65,26,0
37823,336,134,202,51,64,27,12,422,237,185,53,47,62,20,0
37824,126,56,70,31,10,10,3,536,251,285,75,79,60,23,0
37825,221,114,107,65,7,2,1,241,127,114,34,33,29,12,0
37826,473,217,256,59,44,34,21,218,114,104,32,31,33,11,0
37827,772,332,440,136,104,72,28,246,107,139,55,33,27,11,0
37828,346,191,155,52,38,40,13,240,141,99,34,28,29,8,0
37829,325,177,148,40,24,23,13,338,169,169,53,44,39,21,0
37830,425,198,227,57,69,59,13,633,311,322,94,82,45,20,0
37831,297,182,115,41,22,23,8,475,251,224,67,49,48,23,0
37832,385,203,182,47,43,51,21,410,197,213,67,43,56,18,0
37833,474,250,224,58,47,37,12,507,270,237,89,59,57,22,0
37834,726,312,414,121,73,82,23,492,278,214,65,58,32,11,0
37835,565,264,301,101,73,72,15,2335,1200,1135,374,268,340,83,0
37836,567,256,311,91,81,53,17,551,226,325,96,103,43,11,0
37837,546,265,281,101,64,38,16,545,269,276,80,76,27,32,0
37838,615,308,307,83,75,58,32,192,91,101,29,28,17,7,0
37839,589,282,307,68,67,70,23,89,42,47,16,12,15,6,0
37840,508,267,241,43,35,25,17,434,213,221,77,62,53,12,0
37841,380,185,195,68,54,32,16,378,154,224,74,84,35,22,0
37842,301,156,145,32,25,15,5,741,383,358,92,63,79,36,0
37843,505,226,279,68,51,30,15,710,375,335,95,94,110,28,0
37844,267,146,121,40,24,25,7,385,212,173,57,40,39,21,0
37845,439,205,234,64,88,41,21,285,143,142,45,32,21,17,0
37846,57,24,33,11,3,5,3,467,240,227,65,65,51,23,0
37847,340,176,164,50,50,33,13,1471,709,762,198,184,154,62,0
37848,395,195,200,41,55,23,10,457,242,215,39,46,53,10,0
37849,553,319,234,56,37,54,18,1114,539,575,145,131,94,56,0
37850,346,209,137,46,37,44,10,507,270,237,89,59,57,22,0
37851,504,222,282,71,64,53,29,346,196,150,43,26,27,14,0
37852,371,209,162,46,17,36,19,139,68,71,14,26,14,9,0
37853,505,201,304,116,58,75,31,602,310,292,87,66,70,36,0
37854,319,222,97,36,23,28,8,332,180,152,46,36,28,14,0
37855,525,302,223,56,48,67,19,127,58,69,18,17,10,5,0
37856,270,128,142,36,43,15,11,303,138,165,47,46,35,18,0
37857,458,210,248,39,38,25,16,405,181,224,71,57,31,12,0
37858,443,250,193,52,23,49,13,778,391,387,94,77,41,33,0
37859,446,283,163,51,26,33,19,103,50,53,19,10,7,5,0
37860,1447,698,749,214,180,116,46,1425,670,755,153,189,122,85,0
37861,433,188,245,63,45,26,14,135,65,70,21,25,15,9,0
37862,753,395,358,93,72,71,16,2225,1244,981,271,243,217,93,0
37863,2525,1232,1293,398,317,186,61,277,124,153,44,40,35,18,0
37864,1220,575,645,208,179,99,56,381,187,194,37,49,36,17,0
37865,431,199,232,59,54,40,17,277,124,153,44,40,35,18,0
37866,1214,612,602,169,173,98,35,231,126,105,28,26,34,9,0
37867,781,316,465,130,129,65,23,234,129,105,31,22,19,17,0
37868,604,239,365,124,63,84,37,173,90,83,21,36,12,15,0
37869,429,238,191,47,49,56,29,252,130,122,45,23,32,11,0
37870,211,92,119,33,44,11,7,974,457,517,133,117,69,26,0
37871,429,238,191,47,49,56,29,329,194,135,45,32,33,9,0
37872,209,75,134,53,48,20,9,385,212,173,57,40,39,21,0
37873,247,128,119,40,21,27,11,373,183,190,49,37,33,18,0
37874,959,496,463,144,132,75,35,763,418,345,113,84,59,32,0
37875,972,501,471,125,156,106,39,478,254,224,67,74,56,28,0
37876,389,176,213,81,59,24,7,135,65,70,21,25,15,9,0
37877,552,295,257,67,49,70,30,72,32,40,8,2,2,13,0
37878,474,243,231,66,54,41,29,1507,737,770,188,228,147,71,0
37879,126,56,70,31,10,10,3,163,79,84,22,24,13,5,0
37880,346,209,137,46,37,44,10,169,84,85,29,19,21,7,0
37881,336,199,137,46,22,51,13,374,212,162,48,40,32,23,0
37882,496,210,286,112,55,72,13,963,525,438,119,102,102,34,0
37883,444,250,194,58,21,60,23,286,160,126,37,27,23,10,0
37884,795,384,411,133,109,85,38,467,231,236,71,65,58,18,0
37885,1327,520,807,241,174,141,60,362,156,206,74,42,36,22,0
37886,480,257,223,74,26,60,27,314,151,163,42,61,39,16,0
37887,1711,865,846,204,176,105,60,173,86,87,30,22,19,12,0
37888,535,315,220,57,55,71,19,811,361,450,124,107,80,31,0
37889,107,36,71,27,15,0,1,274,142,132,33,34,18,14,0
37890,873,366,507,127,125,75,21,679,338,341,96,95,40,23,0
37891,603,311,292,102,71,66,23,2038,1059,979,262,237,208,100,0
37892,639,368,271,72,51,38,38,403,233,170,38,29,21,14,0
37893,579,281,298,91,78,74,27,761,351,410,117,73,103,45,0
37894,567,256,311,91,81,53,17,1700,731,969,198,233,110,87,0
37895,155,85,70,17,16,4,8,375,176,199,48,61,40,12,0
37896,99,35,64,25,18,0,1,966,478,488,108,144,74,43,0
37897,240,98,142,49,42,23,17,124,69,55,14,7,9,4,0
37898,429,227,202,49,51,46,26,531,277,254,82,75,33,22,0
37899,904,436,468,138,146,82,39,308,146,162,42,39,24,12,0
37900,1214,612,602,169,173,98,35,557,281,276,80,59,43,21,0
37901,246,111,135,64,47,27,3,399,190,209,61,41,39,18,0
37902,331,169,162,40,28,22,14,741,383,358,92,63,79,36,0
37903,513,276,237,73,43,57,24,287,151,136,51,42,36,7,0
37904,446,174,272,84,61,57,23,720,357,363,113,85,62,39,0
37905,317,153,164,39,30,35,13,706,346,360,118,92,98,56,0
37906,379,217,162,47,20,50,23,761,351,410,117,73,103,45,0
37907,680,308,372,82,72,71,40,129,60,69,21,15,8,5,0
37908,259,119,140,48,28,29,19,536,267,269,60,70,41,22,0
37909,1711,865,846,204,176,105,60,225,129,96,32,33,20,8,0
37910,473,212,261,72,64,45,28,439,227,212,60,55,58,8,0
37911,539,283,256,75,73,53,26,622,344,278,80,77,68,36,0
37912,752,313,439,121,106,68,27,306,157,149,52,35,39,16,0
37913,410,208,202,59,58,43,26,487,252,235,79,58,55,26,0
37914,261,126,135,41,36,24,11,792,398,394,109,96,90,39,0
37915,178,87,91,20,32,13,10,671,321,350,95,87,75,34,0
37916,456,223,233,77,54,47,20,295,158,137,42,34,38,14,0
37917,392,205,187,83,49,38,10,430,212,218,88,43,40,20,0
37918,375,201,174,52,56,39,15,2382,1162,1220,237,220,140,49,0
37919,291,131,160,49,35,32,15,231,126,105,37,26,29,6,0
37920,717,381,336,118,103,85,29,127,54,73,11,33,15,6,0
37921,717,281,436,165,81,112,49,246,125,121,38,36,30,11,0
37922,236,141,95,36,32,14,6,597,269,328,102,84,69,24,0
37923,90,54,36,20,4,14,5,417,232,185,58,50,29,21,0
37924,215,104,111,61,7,2,1,149,52,97,36,36,7,4,0
37925,585,277,308,92,73,61,32,87,38,49,23,10,10,9,0
37926,756,362,394,102,104,73,25,405,214,191,53,42,49,20,0
37927,270,166,104,30,26,28,14,1382,508,874,334,320,98,36,0
37928,949,466,483,125,126,101,50,862,409,453,149,125,86,29,0
37929,181,75,106,35,26,11,9,447,232,215,55,65,50,25,0
37930,255,126,129,41,37,13,5,128,63,65,30,11,13,8,0
37931,298,141,157,51,33,21,22,260,133,127,43,32,39,3,0
37932,228,105,123,34,43,20,10,260,133,127,43,32,39,3,0
37933,436,209,227,66,47,52,22,367,199,168,62,44,34,8,0
37934,454,230,224,63,56,38,33,380,178,202,69,53,37,10,0
37935,349,153,196,54,47,28,13,188,101,87,20,18,20,14,0
37936,3859,2011,1848,535,391,422,207,621,310,311,100,106,77,27,0
37937,126,58,68,31,10,10,3,107,77,30,7,2,9,5,0
37938,357,182,175,49,36,39,15,906,455,451,116,105,87,46,0
37939,747,469,278,60,41,53,23,220,107,113,36,35,28,9,0
37940,299,151,148,35,34,26,16,679,338,341,96,95,40,23,0
37941,124,58,66,20,28,11,7,137,63,74,20,22,14,6,0
37942,432,233,199,52,28,47,18,137,63,74,20,22,14,6,0
37943,533,300,233,74,50,74,17,165,90,75,36,18,20,6,0
37944,222,108,114,37,20,25,12,277,144,133,42,30,41,8,0
37945,658,349,309,77,70,73,35,396,199,197,54,50,45,14,0
37946,227,109,118,42,35,29,8,207,86,121,34,39,11,13,0
37947,107,36,71,27,15,0,1,218,115,103,32,32,34,11,0
37948,1441,504,937,264,329,69,46,455,229,226,66,62,63,29,0
37949,983,449,534,95,77,55,36,935,515,420,126,107,73,32,0
37950,253,133,120,44,31,22,8,602,310,292,87,66,70,36,0
37951,685,393,292,75,66,113,16,406,223,183,61,53,46,17,0
37952,1560,778,782,224,235,132,78,621,310,311,100,106,77,27,0
37953,283,112,171,48,39,34,15,406,234,172,63,35,43,10,0
37954,126,66,60,24,10,7,9,200,89,111,26,25,17,7,0
37955,207,93,114,20,33,19,10,89,37,52,13,6,2,9,0
37956,391,203,188,49,34,36,9,447,212,235,86,55,58,21,0
37957,228,82,146,45,37,18,8,344,190,154,34,31,36,10,0
37958,2663,1073,1590,548,499,192,64,239,113,126,36,49,20,8,0
37959,535,217,318,87,106,41,14,360,185,175,51,43,36,16,0
37960,575,290,285,67,70,28,9,487,252,235,79,58,55,26,0
37961,588,267,321,99,79,87,28,165,87,78,24,19,22,9,0
37962,350,172,178,61,45,32,13,207,86,121,34,39,11,13,0
37963,364,168,196,64,61,27,6,758,319,439,101,123,78,25,0
37964,1616,735,881,285,248,153,72,744,385,359,105,96,57,31,0
37965,227,120,107,31,28,28,13,601,278,323,124,87,65,21,0
37966,484,194,290,70,93,47,16,354,183,171,54,43,49,8,0
37967,2236,1195,1041,227,187,186,118,323,168,155,51,41,38,12,0
37968,412,146,266,106,38,67,35,302,150,152,56,40,52,15,0
37969,1139,537,602,162,139,109,50,792,398,394,109,96,90,39,0
37970,51,10,41,25,0,5,8,395,198,197,55,55,36,10,0
37971,502,250,252,70,47,57,15,282,134,148,38,45,29,10,0
37972,574,284,290,64,50,65,20,708,328,380,113,100,82,34,0
37973,919,444,475,141,148,62,20,384,204,180,53,47,49,17,0
37974,753,395,358,93,72,71,16,188,93,95,33,18,16,10,0
37975,1007,353,654,277,147,70,26,509,267,242,79,81,38,20,0
37976,1009,487,522,177,121,103,51,335,186,149,40,28,29,13,0
37977,1505,680,825,202,204,73,32,935,515,420,126,107,73,32,0
37978,1498,731,767,220,175,148,68,127,64,63,26,8,12,8,0
37979,476,254,222,58,33,46,23,332,180,152,46,36,28,14,0
37980,372,171,201,47,53,39,18,602,310,292,87,66,70,36,0
37981,126,58,68,31,10,10,3,780,337,443,112,116,77,28,0
37982,435,230,205,51,37,55,18,294,146,148,50,45,51,15,0
37983,342,185,157,42,27,31,14,107,77,30,7,2,9,5,0
37984,853,400,453,137,109,88,42,212,127,85,28,21,26,6,0
37985,341,195,146,42,21,36,9,287,151,136,51,42,36,7,0
37986,484,261,223,59,48,49,24,1154,489,665,200,196,95,54,0
37987,261,130,131,27,41,19,16,326,149,177,51,51,28,10,0
37988,375,201,174,52,56,39,15,536,222,314,101,100,34,22,0
37989,127,55,72,25,18,5,7,1265,689,576,169,177,128,60,0
37990,326,176,150,35,22,29,11,261,148,113,31,28,14,10,0
37991,211,92,119,33,44,11,7,127,64,63,26,8,12,8,0
37992,420,189,231,79,67,33,17,811,361,450,124,107,80,31,0
37993,435,222,213,67,49,67,12,582,264,318,84,60,58,23,0
37994,309,137,172,51,50,28,14,322,180,142,45,38,28,7,0
37995,360,205,155,35,24,52,14,338,169,169,53,44,39,21,0
37996,932,575,357,94,69,76,40,538,274,264,84,67,52,35,0
37997,1759,838,921,269,212,191,92,1114,539,575,145,131,94,56,0
37998,125,53,72,18,21,18,12,1239,659,580,169,148,131,54,0
37999,682,292,390,89,69,58,20,792,398,394,109,96,90,39,0
38000,279,129,150,43,34,17,13,649,307,342,71,134,45,17,0
38001,222,110,112,43,30,14,6,751,394,357,107,96,73,35,0
38002,142,60,82,20,28,13,5,279,161,118,37,32,7,7,0
38003,233,110,123,34,22,34,9,654,295,359,99,88,71,25,0
38004,2062,706,1356,414,368,158,63,389,207,182,53,58,52,18,0
38005,334,190,144,42,42,16,5,277,145,132,41,32,22,10,0
38006,559,217,342,105,86,42,16,2542,1245,1297,285,287,170,84,0
38007,403,176,227,71,56,51,11,334,182,152,45,41,27,13,0
38008,202,113,89,16,27,21,11,467,240,227,65,65,51,23,0
38009,629,338,291,92,57,64,22,975,400,575,160,162,62,31,0
38010,224,108,116,31,32,22,8,130,67,63,24,10,12,4,0
38011,452,202,250,83,60,56,19,374,181,193,55,58,48,23,0
38012,261,130,131,27,41,19,16,277,138,139,40,39,20,14,0
38013,161,75,86,24,20,10,7,198,115,83,30,22,8,8,0
38014,426,214,212,63,47,53,20,1065,581,484,134,97,76,46,0
38015,343,189,154,44,24,39,12,258,129,129,45,24,31,10,0
38016,372,189,183,60,44,41,18,274,142,132,33,34,18,14,0
38017,301,157,144,31,28,34,9,384,204,180,53,47,49,17,0
38018,803,358,445,135,117,80,43,172,79,93,34,27,23,10,0
38019,234,108,126,42,40,15,9,201,98,103,28,25,19,13,0
38020,860,349,511,166,166,58,19,481,223,258,71,70,49,26,0
38021,164,61,103,47,19,14,5,889,505,384,107,97,99,30,0
38022,288,142,146,52,32,26,8,169,85,84,21,14,9,9,0
38023,867,415,452,123,87,62,27,402,186,216,64,47,38,20,0
38024,401,183,218,72,73,28,10,557,281,276,80,59,43,21,0
38025,743,366,377,41,37,26,14,531,261,270,73,80,68,26,0
38026,658,349,309,77,70,73,35,501,240,261,80,62,49,42,0
38027,1464,693,771,153,136,91,86,325,172,153,44,34,27,14,0
38028,303,161,142,38,31,42,17,452,254,198,72,57,38,18,0
38029,802,375,427,133,103,81,41,390,190,200,66,50,43,12,0
38030,129,70,59,29,9,7,2,194,106,88,33,10,15,6,0
38031,188,84,104,35,36,18,9,132,67,65,24,21,8,10,0
38032,245,111,134,36,27,18,6,673,313,360,102,101,46,17,0
38033,242,104,138,41,33,37,8,142,65,77,30,17,22,9,0
38034,186,56,130,46,50,16,7,403,225,178,56,38,33,25,0
38035,348,198,150,57,25,37,18,295,160,135,44,36,46,16,0
38036,543,265,278,52,37,54,19,225,114,111,32,29,26,6,0
38037,2286,1154,1132,338,314,278,103,348,212,136,53,31,25,18,0
38038,458,210,248,39,38,25,16,332,180,152,44,36,27,13,0
38039,677,361,316,81,61,42,22,1352,602,750,166,185,81,70,0
38040,793,355,438,134,117,77,43,245,121,124,37,35,36,12,0
38041,111,29,82,10,54,0,1,780,337,443,112,116,77,28,0
38042,446,195,251,56,53,31,15,1113,480,633,170,173,81,34,0
38043,107,56,51,18,16,12,5,279,142,137,43,39,28,7,0
38044,666,204,462,110,194,42,14,1001,417,584,186,147,96,47,0
38045,1041,497,544,180,167,98,34,279,142,137,43,39,28,7,0
38046,161,94,67,23,13,8,10,516,245,271,82,84,70,26,0
38047,329,171,158,49,41,31,10,213,129,84,32,14,21,15,0
38048,118,51,67,25,13,6,7,462,229,233,63,49,42,18,0
38049,341,177,164,57,42,40,18,279,161,118,37,32,7,7,0
38050,2063,1024,1039,175,117,80,97,2225,1244,981,271,243,217,93,0
38051,587,318,269,76,50,38,21,396,213,183,68,44,47,18,0
38052,852,461,391,109,102,72,24,352,207,145,40,33,25,21,0
38053,919,493,426,100,92,88,49,148,84,64,30,7,17,4,0
38054,548,310,238,72,62,54,13,561,279,282,85,81,88,24,0
38055,439,183,256,60,64,36,14,395,198,197,55,55,36,10,0
38056,178,74,104,31,28,9,4,400,187,213,56,59,42,20,0
38057,648,262,386,113,108,78,29,1249,638,611,166,153,141,45,0
38058,508,251,257,74,53,51,18,274,157,117,40,29,40,8,0
38059,449,179,270,80,77,49,29,627,289,338,101,73,62,43,0
38060,221,114,107,65,7,2,1,295,160,135,42,37,46,16,0
38061,360,205,155,35,24,52,14,377,184,193,50,43,33,17,0
38062,269,156,113,37,32,17,7,160,60,100,23,40,19,11,0
38063,82,36,46,17,10,5,1,701,380,321,94,84,96,34,0
38064,1004,464,540,143,104,78,55,928,440,488,111,157,82,35,0
38065,532,254,278,91,48,23,17,455,191,264,68,86,21,19,0
38066,649,304,345,99,80,67,40,1241,619,622,183,169,155,59,0
38067,414,206,208,56,68,35,19,337,170,167,59,33,47,17,0
38068,1217,647,570,142,160,129,45,205,94,111,48,31,15,6,0
38069,1718,735,983,266,225,130,68,1239,659,580,169,148,131,54,0
38070,575,295,280,89,68,54,18,295,160,135,44,36,46,16,0
38071,531,259,272,75,81,39,13,198,86,112,36,27,23,9,0
38072,813,412,401,114,93,112,26,597,269,328,102,84,69,24,0
38073,911,445,466,154,121,108,48,710,375,335,95,94,110,28,0
38074,150,64,86,22,12,29,12,172,79,93,34,27,23,10,0
38075,1186,495,691,182,208,88,32,1922,923,999,267,275,215,90,0
38076,325,186,139,49,36,20,5,393,210,183,58,37,34,20,0
38077,228,105,123,34,43,20,10,415,226,189,51,40,40,29,0
38078,822,416,406,111,97,88,42,294,146,148,50,45,51,15,0
38079,367,167,200,63,42,60,17,607,293,314,98,71,62,32,0
38080,162,73,89,32,19,4,4,475,251,224,67,49,48,23,0
38081,482,245,237,69,64,66,24,389,207,182,53,58,52,18,0
38082,526,268,258,54,37,55,12,1040,564,476,134,110,114,51,0
38083,234,110,124,39,29,23,2,598,333,265,79,66,54,33,0
38084,224,101,123,45,32,21,3,660,333,327,102,95,69,31,0
38085,451,278,173,71,35,58,12,374,174,200,54,52,42,21,0
38086,272,94,178,76,33,19,4,671,306,365,114,76,49,19,0
38087,961,465,496,139,156,62,34,320,168,152,38,42,24,18,0
38088,255,110,145,34,32,23,17,478,254,224,67,74,56,28,0
38089,1441,504,937,264,329,69,46,1338,720,618,179,145,141,85,0
38090,221,75,146,68,21,16,5,94,45,49,11,20,10,4,0
38091,1058,497,561,194,142,87,63,334,182,152,45,41,27,13,0
38092,90,54,36,20,4,14,5,662,312,350,103,104,59,20,0
38093,582,328,254,78,48,35,9,415,189,226,68,54,50,21,0
38094,301,157,144,31,28,34,9,518,292,226,60,60,52,21,0
38095,708,344,364,106,98,66,33,766,386,380,101,81,78,31,0
38096,640,271,369,111,79,57,17,2547,1280,1267,331,335,293,118,0
38097,520,261,259,74,52,49,22,378,154,224,74,84,35,22,0
38098,613,303,310,70,28,28,18,194,109,85,23,24,21,9,0
38099,346,168,178,36,43,20,9,212,127,85,28,21,26,6,0
38100,1007,353,654,277,147,70,26,389,210,179,51,37,43,9,0
38101,1171,542,629,170,146,114,64,528,276,252,86,78,49,17,0
38102,3859,2011,1848,535,391,422,207,1154,489,665,200,196,95,54,0
38103,484,194,290,70,93,47,16,148,84,64,30,7,17,4,0
38104,3969,1703,2266,619,432,259,144,810,310,500,164,162,42,26,0
38105,269,127,142,43,24,34,26,710,375,335,95,94,110,28,0
38106,376,176,200,31,53,27,8,156,90,66,17,22,11,10,0
38107,467,233,234,83,37,77,22,390,223,167,58,36,45,18,0
38108,593,282,311,75,70,29,25,348,212,136,53,31,25,18,0
38109,803,358,445,135,117,80,43,337,152,185,49,54,42,21,0
38110,682,260,422,98,83,42,31,218,111,107,45,29,24,6,0
38111,457,261,196,55,27,57,34,396,197,199,75,49,49,16,0
38112,142,76,66,21,21,22,11,364,189,175,58,41,35,17,0
38113,433,188,245,63,45,26,14,316,159,157,38,48,30,11,0
38114,680,308,372,82,72,71,40,664,350,314,86,90,82,36,0
38115,426,231,195,51,52,45,24,251,143,108,47,25,29,11,0
38116,484,194,290,70,93,47,16,187,89,98,36,24,20,6,0
38117,244,104,140,52,31,30,14,94,45,49,11,20,10,4,0
38118,126,56,70,31,10,10,3,395,198,197,55,55,36,10,0
38119,1960,875,1085,287,189,162,66,1154,489,665,200,196,95,54,0
38120,231,105,126,56,10,24,10,536,251,285,75,79,60,23,0
38121,522,302,220,61,49,75,19,963,455,508,127,130,115,48,0
38122,134,60,74,19,13,10,7,142,73,69,27,9,15,11,0
38123,527,276,251,64,60,70,20,690,345,345,96,83,73,42,0
38124,361,171,190,44,40,18,13,1537,701,836,209,187,129,58,0
38125,410,211,199,55,42,34,27,91,44,47,9,12,4,7,0
38126,1501,679,822,251,196,174,67,222,125,97,34,27,27,7,0
38127,130,71,59,30,9,8,2,314,177,137,34,40,29,9,0
38128,180,92,88,29,20,26,8,198,86,112,36,27,23,9,0
38129,142,60,82,20,28,13,5,229,120,109,31,30,22,9,0
38130,341,195,146,42,21,36,9,517,295,222,69,62,40,28,0
38131,76,30,46,7,15,1,5,598,333,265,79,66,54,33,0
38132,727,426,301,79,71,64,32,423,234,189,66,44,57,12,0
38133,784,351,433,118,87,73,41,704,355,349,113,94,71,24,0
38134,203,80,123,40,37,20,3,528,276,252,86,78,49,17,0
38135,270,128,142,36,43,15,11,457,253,204,67,51,48,13,0
38136,500,245,255,66,57,52,27,201,99,102,34,26,23,6,0
38137,1085,646,439,108,65,36,19,1230,644,586,198,125,123,61,0
38138,486,243,243,65,48,63,22,270,130,140,48,44,37,12,0
38139,673,317,356,101,85,76,49,1061,543,518,146,123,109,67,0
38140,577,251,326,92,84,60,11,562,273,289,76,92,45,24,0
38141,420,248,172,64,30,43,17,588,286,302,78,99,53,25,0
38142,299,128,171,57,40,13,25,455,229,226,66,62,63,29,0
38143,1849,931,918,245,220,158,90,633,311,322,94,82,45,20,0
38144,260,120,140,34,39,36,12,873,411,462,132,107,84,40,0
38145,127,54,73,31,10,11,3,437,224,213,40,29,42,25,0
38146,126,57,69,31,10,10,3,480,255,225,67,64,50,22,0
38147,626,308,318,105,89,77,25,465,252,213,73,58,60,18,0
38148,739,389,350,129,61,69,25,966,478,488,108,144,74,43,0
38149,367,167,200,63,42,60,17,535,311,224,66,52,49,24,0
38150,928,442,486,139,118,91,43,164,79,85,28,28,16,7,0
38151,379,217,162,47,20,50,23,165,90,75,36,18,20,6,0
38152,588,317,271,78,49,54,17,246,107,139,55,33,27,11,0
38153,685,393,292,75,66,113,16,396,213,183,68,44,47,18,0
38154,134,60,74,19,13,10,7,405,181,224,71,57,31,12,0
38155,270,147,123,34,17,39,21,1543,794,749,182,152,132,55,0
38156,319,222,97,36,23,28,8,758,319,439,101,123,78,25,0
38157,283,112,171,48,39,34,15,320,168,152,38,42,24,18,0
38158,3230,1724,1506,361,358,157,75,474,268,206,66,42,45,24,0
38159,952,547,405,95,90,127,35,267,141,126,53,27,23,7,0
38160,160,53,107,31,29,13,3,1698,875,823,222,219,173,64,0
38161,960,409,551,166,134,77,44,445,264,181,35,35,34,14,0
38162,273,126,147,54,49,25,18,166,88,78,23,18,13,7,0
38163,472,222,250,46,61,33,23,106,54,52,12,9,7,6,0
38164,261,130,131,27,41,19,16,396,213,183,68,44,47,18,0
38165,107,53,54,15,15,13,4,72,32,40,8,2,2,13,0
38166,253,133,120,44,31,22,8,378,154,224,74,84,35,22,0
38167,401,236,165,53,38,34,9,172,79,93,34,27,23,10,0
38168,493,208,285,75,77,70,40,1700,731,969,198,233,110,87,0
38169,303,161,142,38,31,42,17,423,234,189,66,44,57,12,0
38170,615,308,307,83,75,58,32,201,117,83,22,21,19,9,0
38171,243,114,129,37,30,32,8,480,255,225,67,64,50,22,0
38172,979,534,445,83,77,80,24,501,249,252,77,70,55,22,0
38173,391,204,187,47,48,38,18,396,223,173,57,37,44,19,0
38174,213,113,100,26,21,26,12,334,181,153,41,40,25,15,0
38175,345,208,137,44,27,33,8,234,116,118,34,35,23,9,0
38176,674,268,406,118,96,70,21,329,196,133,41,36,31,15,0
38177,243,114,129,37,30,32,8,223,113,110,31,33,22,12,0
38178,436,201,235,54,37,35,18,277,152,125,31,35,22,19,0
38179,833,295,538,146,139,65,34,846,425,421,125,97,98,38,0
38180,443,226,217,67,34,53,10,245,121,124,37,35,36,12,0
38181,238,158,80,28,15,31,7,406,202,204,54,51,63,21,0
38182,708,344,364,106,98,66,33,2517,1275,1242,304,324,245,135,0
38183,953,421,532,131,131,70,37,381,187,194,37,49,36,17,0
38184,372,189,183,60,44,41,18,395,169,226,73,55,38,9,0
38185,301,157,144,31,28,34,9,279,142,137,43,39,28,7,0
38186,524,361,163,41,8,28,16,647,350,297,95,79,77,29,0
38187,554,217,337,112,72,90,38,375,176,199,48,61,40,12,0
38188,250,123,127,40,28,29,8,671,306,365,114,76,49,19,0
38189,730,298,432,128,69,86,26,207,114,93,33,20,31,13,0
38190,325,186,139,49,36,20,5,617,314,303,96,68,68,37,0
38191,346,174,172,36,43,21,9,2382,1162,1220,237,220,140,49,0
38192,574,284,290,64,50,65,20,715,345,370,110,97,64,25,0
38193,322,164,158,46,44,29,7,384,212,172,44,43,34,14,0
38194,180,57,123,39,22,10,8,125,66,59,24,16,11,5,0
38195,416,207,209,63,47,56,15,230,125,105,29,40,20,6,0
38196,127,54,73,31,10,11,3,403,184,219,75,51,47,20,0
38197,743,366,377,41,37,26,14,548,296,252,71,74,43,28,0
38198,127,62,65,13,33,7,6,222,125,97,34,27,27,7,0
38199,365,222,143,44,24,35,11,180,90,90,31,19,20,8,0
38200,960,409,551,166,134,77,44,332,173,159,48,40,31,11,0
38201,1124,442,682,148,189,72,43,536,251,285,75,79,60,23,0
38202,714,260,454,140,97,120,54,811,361,450,124,107,80,31,0
38203,244,104,140,52,31,30,14,963,525,438,119,102,102,34,0
38204,879,457,422,93,98,143,32,153,65,88,28,21,20,8,0
38205,664,269,395,117,107,36,15,406,234,172,63,35,43,10,0
38206,269,124,145,36,24,32,11,199,105,94,27,27,28,9,0
38207,482,231,251,76,81,64,26,953,489,464,126,104,111,44,0
38208,312,173,139,43,47,28,6,107,77,30,7,2,9,5,0
38209,522,302,220,61,49,75,19,565,237,328,75,88,32,11,0
38210,1647,794,853,279,235,128,65,380,178,202,69,53,37,10,0
38211,451,225,226,69,57,64,22,413,223,190,52,45,53,10,0
38212,798,287,511,126,125,77,26,231,126,105,28,26,34,9,0
38213,743,377,366,87,74,68,30,286,160,126,37,27,23,10,0
38214,800,416,384,102,105,83,22,541,279,262,79,82,31,32,0
38215,330,77,253,86,52,20,12,380,178,202,69,53,37,10,0
38216,579,281,298,91,78,74,27,285,143,142,45,32,21,17,0
38217,717,281,436,165,81,112,49,296,151,145,45,42,32,11,0
38218,431,202,229,57,50,50,25,261,162,99,24,21,14,10,0
38219,157,62,95,41,18,10,11,462,229,233,63,49,42,18,0
38220,616,323,293,98,71,31,15,346,178,168,58,41,33,12,0
38221,428,226,202,52,60,75,20,270,162,108,26,26,16,11,0
38222,142,76,66,21,21,22,11,392,155,237,68,61,34,16,0
38223,1339,494,845,216,298,92,37,761,351,410,117,73,103,45,0
38224,451,225,226,69,57,64,22,300,148,152,45,43,40,8,0
38225,1189,653,536,152,118,109,56,621,310,311,100,106,77,27,0
38226,1580,742,838,208,146,144,71,334,181,153,41,40,25,15,0
38227,919,444,475,141,148,62,20,2202,1121,1081,338,274,269,81,0
38228,374,187,187,51,52,40,27,551,226,325,96,103,43,11,0
38229,577,251,326,92,84,60,11,620,324,296,81,68,66,31,0
38230,390,199,191,72,42,35,12,323,168,155,51,41,38,12,0
38231,288,142,146,52,32,26,8,600,254,346,104,100,44,17,0
38232,734,366,368,121,99,63,39,153,65,88,28,21,20,8,0
38233,476,199,277,82,80,49,24,180,108,72,22,22,15,5,0
38234,349,153,196,54,47,28,13,346,178,168,58,41,33,12,0
38235,142,60,82,20,28,13,5,664,350,314,86,90,82,36,0
38236,265,165,100,32,19,27,5,149,52,97,36,36,7,4,0
38237,1970,978,992,245,206,198,80,316,166,150,45,38,37,13,0
38238,325,152,173,43,47,28,17,541,279,262,79,82,31,32,0
38239,615,308,307,83,75,58,32,475,251,224,67,49,48,23,0
38240,155,85,70,17,16,4,8,392,214,178,48,40,53,22,0
38241,118,51,67,25,13,6,7,328,195,133,39,40,27,13,0
38242,457,228,229,64,36,52,21,530,287,243,79,70,33,26,0
38243,92,46,46,14,9,8,6,374,191,183,40,52,40,16,0
38244,496,210,286,112,55,72,13,332,173,159,48,40,31,11,0
38245,734,366,368,121,99,63,39,376,189,187,47,53,44,26,0
38246,550,304,246,60,64,77,16,482,232,250,77,81,44,13,0
38247,860,348,512,121,136,75,35,1507,737,770,188,228,147,71,0
38248,427,191,236,67,60,41,34,297,175,122,46,30,31,6,0
38249,919,444,475,141,148,62,20,710,375,335,95,94,110,28,0
38250,244,104,140,52,31,30,14,348,212,136,53,31,25,18,0
38251,313,134,179,58,37,43,19,212,127,85,28,21,26,6,0
38252,435,222,213,67,49,67,12,406,223,183,61,53,46,17,0
38253,753,361,392,99,94,66,16,607,294,313,94,95,62,14,0
38254,221,75,146,68,21,16,5,723,363,360,107,106,52,14,0
38255,346,168,178,36,43,20,9,198,113,85,19,20,26,12,0
38256,726,312,414,121,73,82,23,68,23,45,12,9,3,9,0
38257,666,204,462,110,194,42,14,1321,653,668,186,195,70,35,0
38258,469,253,216,49,51,48,18,1040,564,476,134,110,114,51,0
38259,345,203,142,47,35,31,11,561,279,282,85,81,88,24,0
38260,739,323,416,127,89,76,33,2225,1244,981,271,243,217,93,0
38261,130,71,59,30,9,8,1,381,186,195,69,55,46,15,0
38262,232,134,98,28,20,20,5,724,353,371,94,95,71,31,0
38263,349,167,182,54,38,30,28,496,251,245,78,62,61,23,0
38264,156,64,92,31,19,5,4,306,157,149,52,35,39,16,0
38265,1647,794,853,279,235,128,65,748,359,389,125,113,86,31,0
38266,536,237,299,116,87,42,17,1040,564,476,134,110,114,51,0
38267,584,340,244,77,60,47,25,257,126,131,61,24,22,8,0
38268,76,42,34,12,8,5,7,381,187,194,37,49,36,17,0
38269,71,39,32,7,11,6,4,929,459,470,140,120,94,45,0
38270,509,251,258,69,49,55,17,866,397,469,117,153,95,48,0
38271,76,30,46,7,15,1,5,520,272,248,60,65,58,22,0
38272,434,221,213,58,47,54,15,246,125,121,38,36,30,11,0
38273,367,167,200,63,42,60,17,536,222,314,101,100,34,22,0
38274,325,152,173,43,47,28,17,332,173,159,48,40,31,11,0
38275,395,219,176,47,41,50,18,508,253,255,73,60,50,13,0
38276,756,265,491,129,127,51,17,457,242,215,39,46,53,10,0
38277,1367,690,677,172,175,154,83,673,328,345,107,112,63,27,0
38278,157,62,95,41,18,10,11,405,214,191,53,42,49,20,0
38279,323,142,181,67,26,45,33,279,106,173,48,35,41,39,0
38280,313,134,179,58,37,43,19,1239,659,580,169,148,131,54,0
38281,574,269,305,91,63,54,27,1061,543,518,146,123,109,67,0
38282,836,370,466,126,96,72,30,137,63,74,20,22,14,6,0
38283,3703,1708,1995,456,428,305,162,290,147,143,34,34,39,13,0
38284,359,204,155,39,36,34,13,462,251,211,74,53,41,18,0
38285,760,405,355,112,95,92,29,198,86,112,36,27,23,9,0
38286,127,55,72,25,18,5,7,104,46,58,15,17,9,5,0
38287,412,203,209,65,47,37,18,171,94,77,24,28,30,11,0
38288,828,355,473,126,134,77,37,260,131,129,42,31,40,9,0
38289,1068,434,634,173,160,61,29,866,397,469,117,153,95,48,0
38290,392,205,187,83,49,38,10,405,181,224,71,57,31,12,0
38291,240,99,141,53,38,29,15,166,102,64,19,14,17,2,0
38292,338,208,130,39,30,35,12,251,143,108,47,25,29,11,0
38293,458,222,236,69,39,35,18,330,157,173,43,30,36,11,0
38294,439,183,256,60,64,36,14,720,361,359,98,98,70,37,0
38295,483,236,247,82,60,43,18,335,170,165,52,36,47,11,0
38296,425,198,227,57,69,59,13,497,227,270,70,63,66,30,0
38297,557,250,307,70,47,51,22,597,269,328,102,84,69,24,0
38298,255,136,119,39,20,32,10,480,255,225,67,64,50,22,0
38299,118,51,67,25,13,6,7,299,140,159,49,44,26,11,0
38300,1001,422,579,185,180,51,32,323,168,155,51,41,38,12,0
38301,343,189,154,44,24,39,12,203,98,105,34,29,19,10,0
38302,220,121,99,28,26,17,6,103,59,44,25,2,13,6,0
38303,520,231,289,89,59,58,26,475,251,224,67,49,48,23,0
38304,526,228,298,69,64,32,30,271,150,121,39,36,37,5,0
38305,176,74,102,20,29,7,7,594,312,282,72,67,73,31,0
38306,167,70,97,32,20,15,7,87,38,49,23,10,10,9,0
38307,2799,1324,1475,369,371,215,124,457,245,212,62,58,57,21,0
38308,972,501,471,125,156,106,39,207,113,94,33,18,30,9,0
38309,1594,660,934,251,272,117,77,818,357,461,122,136,54,25,0
38310,456,223,233,77,54,47,20,418,223,195,53,43,49,15,0
38311,469,221,248,49,60,55,21,225,129,96,32,33,20,8,0
38312,654,344,310,80,69,57,15,1249,638,611,166,153,141,45,0
38313,519,259,260,86,78,59,22,265,134,131,48,34,33,15,0
38314,371,143,228,77,48,29,26,274,142,132,33,34,18,14,0
38315,632,360,272,75,65,36,19,510,264,246,67,66,38,29,0
38316,404,197,207,60,48,47,20,376,189,187,47,53,44,26,0
38317,136,65,71,33,11,9,6,101,59,42,11,17,10,1,0
38318,490,224,266,80,70,39,32,549,273,276,74,68,72,24,0
38319,181,75,106,35,26,11,9,308,129,179,44,60,19,8,0
38320,911,441,470,123,108,60,21,329,194,135,45,32,33,9,0
38321,335,148,187,52,26,51,12,478,254,224,67,74,56,28,0
38322,103,56,47,27,7,8,2,1698,875,823,222,219,173,64,0
38323,618,289,329,97,86,70,17,389,207,182,53,58,52,18,0
38324,342,150,192,52,43,31,17,621,273,348,104,102,48,19,0
38325,431,216,215,46,40,33,9,270,162,108,26,26,16,11,0
38326,664,269,395,117,107,36,15,2346,1231,1115,316,292,266,105,0
38327,625,283,342,93,89,67,25,138,69,69,28,7,10,10,0
38328,919,493,426,100,92,88,49,65,32,33,16,4,8,3,0
38329,202,113,89,16,27,21,11,142,73,69,27,9,15,11,0
38330,580,240,340,108,81,59,22,137,85,52,15,11,11,2,0
38331,213,88,125,21,54,14,15,483,215,268,66,70,30,16,0
38332,466,259,207,59,50,83,12,180,108,72,22,22,15,5,0
38333,457,261,196,55,27,57,34,251,143,108,47,25,29,11,0
38334,130,70,60,30,9,8,1,377,184,193,50,43,33,17,0
38335,312,164,148,54,29,25,15,530,287,243,79,70,33,26,0
38336,125,53,72,18,21,18,12,415,226,189,51,40,40,29,0
38337,210,84,126,44,43,9,4,264,138,126,33,34,29,12,0
38338,246,111,135,64,47,27,3,1230,644,586,198,125,123,61,0
38339,347,198,149,45,29,29,8,96,46,50,16,12,7,5,0
38340,126,57,69,31,10,10,3,89,38,51,14,6,3,9,0
38341,607,294,313,94,95,62,14,528,188,340,130,58,77,41,0
38342,475,208,267,84,67,50,20,906,455,451,116,105,87,46,0
38343,188,84,104,35,36,18,9,926,340,586,133,119,60,40,0
38344,362,181,181,67,46,43,8,453,247,206,58,53,45,20,0
38345,443,226,217,67,34,53,10,531,277,254,82,75,33,22,0
38346,204,109,95,21,35,27,7,928,440,488,111,157,82,35,0
38347,360,205,155,35,24,52,14,367,199,168,62,44,34,8,0
38348,332,172,160,50,33,35,9,134,72,62,14,28,8,4,0
38349,328,195,133,36,23,35,9,89,51,38,15,15,5,4,0
38350,126,57,69,31,10,10,3,620,324,296,81,68,66,31,0
38351,127,48,79,27,20,6,5,758,319,439,101,123,78,25,0
38352,447,225,222,76,35,75,21,727,362,365,123,107,63,23,0
38353,1189,653,536,152,118,109,56,368,183,185,40,42,40,15,0
38354,1096,563,533,158,136,120,53,309,159,150,47,43,43,13,0
38355,369,166,203,59,55,41,14,978,536,442,132,107,67,32,0
38356,727,426,301,79,71,64,32,892,475,417,130,108,68,38,0
38357,658,349,309,77,70,73,35,198,115,83,30,22,8,8,0
38358,411,202,209,60,67,57,24,403,192,211,102,39,49,15,0
38359,1395,595,800,223,206,113,61,132,61,71,19,20,14,6,0
38360,1054,497,557,190,168,107,45,218,111,107,45,29,24,6,0
38361,1441,504,937,264,329,69,46,406,223,183,61,53,46,17,0
38362,798,364,434,133,88,74,35,348,194,154,57,31,43,12,0
38363,687,351,336,106,67,70,41,306,157,149,52,35,39,16,0
38364,391,203,188,49,34,36,9,1378,692,686,194,174,105,56,0
38365,260,120,140,34,39,36,12,708,328,380,113,100,82,34,0
38366,1087,523,564,146,177,103,33,230,125,105,29,40,20,6,0
38367,303,161,142,38,31,42,17,1182,591,591,155,139,83,46,0
38368,356,199,157,36,43,28,12,437,224,213,40,29,42,25,0
38369,928,442,486,139,118,91,43,200,99,101,31,24,26,6,0
38370,802,430,372,65,102,87,23,160,76,84,19,24,8,5,0
38371,258,130,128,44,37,29,10,378,154,224,74,84,35,22,0
38372,71,28,43,15,9,5,2,732,402,330,81,86,87,33,0
38373,221,80,141,48,37,14,10,748,359,389,125,113,86,31,0
38374,202,113,89,16,27,21,11,309,159,150,47,43,43,13,0
38375,1616,735,881,285,248,153,72,498,244,254,81,67,58,19,0
38376,417,222,195,53,39,43,10,579,285,294,78,72,64,32,0
38377,2624,999,1625,415,495,109,84,239,113,126,36,49,20,8,0
38378,631,316,315,64,57,49,15,459,260,199,56,42,47,21,0
38379,130,71,59,30,9,8,1,798,385,413,120,115,79,30,0
38380,462,233,229,66,49,43,30,169,84,85,29,19,21,7,0
38381,376,249,127,47,23,43,16,421,222,199,69,50,60,18,0
38382,170,82,88,32,23,22,8,1040,564,476,134,110,114,51,0
38383,519,245,274,58,61,34,22,1314,693,621,174,155,140,58,0
38384,562,214,348,120,86,69,42,196,105,91,40,13,19,10,0
38385,454,214,240,56,71,35,16,1062,522,540,151,147,105,66,0
38386,462,258,204,59,41,56,15,647,350,297,95,79,77,29,0
38387,1030,438,592,184,104,108,30,385,188,197,57,42,36,16,0
38388,854,435,419,118,91,95,42,169,85,84,21,14,9,9,0
38389,1849,931,918,245,220,158,90,516,245,271,82,84,70,26,0
38390,1052,492,560,184,163,103,44,234,129,105,31,22,19,17,0
38391,485,183,302,79,81,73,33,422,237,185,53,47,62,20,0
38392,1647,794,853,279,235,128,65,541,279,262,79,82,31,32,0
38393,316,157,159,45,38,22,19,72,33,39,8,2,3,12,0
38394,130,71,59,30,9,8,1,375,210,165,49,37,29,27,0
38395,261,137,124,34,23,13,8,900,441,459,125,127,110,32,0
38396,505,226,279,68,51,30,15,671,321,350,95,87,75,34,0
38397,546,285,261,71,49,47,24,328,195,133,39,40,27,13,0
38398,234,110,124,39,29,23,2,335,170,165,52,36,47,11,0
38399,451,225,226,69,57,64,22,862,409,453,149,125,86,29,0
38400,279,127,152,50,36,28,8,425,177,248,60,62,33,16,0
38401,1912,880,1032,331,334,180,84,846,425,421,125,97,98,38,0
38402,609,292,317,102,96,64,21,386,207,179,43,48,44,19,0
38403,2062,706,1356,414,368,158,63,947,482,465,143,107,89,37,0
38404,594,279,315,93,68,68,26,1114,539,575,145,131,94,56,0
38405,736,353,383,117,83,71,18,403,221,182,62,50,42,12,0
38406,414,206,208,56,68,35,19,244,143,101,31,29,26,8,0
38407,130,71,59,30,9,8,1,294,146,148,50,45,51,15,0
38408,640,308,332,91,102,49,21,261,148,113,31,28,14,10,0
38409,331,165,166,52,34,48,22,107,77,30,7,2,9,5,0
38410,575,290,285,67,70,28,9,457,242,215,39,46,53,10,0
38411,252,121,131,42,34,12,16,1338,720,618,179,145,141,85,0
38412,436,201,235,54,37,35,18,504,272,232,75,57,53,19,0
38413,437,212,225,66,44,44,11,169,74,95,33,26,22,3,0
38414,251,139,112,41,18,27,11,1182,591,591,155,139,83,46,0
38415,554,217,337,112,72,90,38,192,91,101,29,28,17,7,0
38416,392,221,171,53,30,25,8,1113,480,633,170,173,81,34,0
38417,674,268,406,118,96,70,21,367,218,149,45,43,42,16,0
38418,136,66,70,33,11,9,4,153,80,73,26,18,19,4,0
38419,772,417,355,118,92,80,23,598,333,265,79,66,54,33,0
38420,328,195,133,36,23,35,9,418,223,195,51,45,49,14,0
38421,163,70,93,28,21,17,6,1230,644,586,198,125,123,61,0
38422,126,56,70,31,10,10,3,201,99,102,34,26,23,6,0
38423,350,190,160,48,25,27,18,252,130,122,45,23,32,11,0
38424,196,107,89,20,31,17,4,346,178,168,58,41,33,12,0
38425,1208,575,633,187,204,117,41,640,364,276,84,68,69,33,0
38426,308,163,145,38,33,30,20,467,231,236,71,65,58,18,0
38427,313,178,135,43,18,35,6,218,111,107,45,29,24,6,0
38428,71,39,32,7,11,6,4,798,385,413,120,115,79,30,0
38429,343,162,181,65,38,29,12,218,115,103,32,32,34,11,0
38430,255,110,145,34,32,23,17,679,338,341,96,95,40,23,0
38431,616,323,293,98,71,31,15,906,455,451,116,105,87,46,0
38432,1098,519,579,182,159,79,42,1239,659,580,169,148,131,54,0
38433,1001,422,579,185,180,51,32,188,105,83,25,17,24,7,0
38434,422,207,215,79,38,53,23,434,213,221,77,62,53,12,0
38435,233,110,123,34,22,34,9,528,276,252,86,78,49,17,0
38436,334,155,179,47,34,38,11,319,185,134,42,31,22,13,0
38437,130,70,60,30,9,8,1,277,144,133,42,30,41,8,0
38438,269,156,113,37,32,17,7,564,264,300,79,84,65,26,0
38439,949,466,483,125,126,101,50,710,375,335,95,94,110,28,0
38440,1327,520,807,241,174,141,60,374,191,183,40,52,40,16,0
38441,852,472,380,99,79,70,27,403,225,178,56,38,33,25,0
38442,282,84,198,60,102,1,6,902,499,403,118,117,92,35,0
38443,1390,585,805,241,230,118,46,261,162,99,24,21,14,10,0
38444,358,212,146,51,36,33,9,207,86,121,34,39,11,13,0
38445,461,207,254,82,66,55,33,611,314,297,79,75,78,22,0
38446,359,204,155,39,36,34,13,732,402,330,81,86,87,33,0
38447,546,285,261,71,49,47,24,207,114,93,33,20,31,13,0
38448,396,150,246,103,64,38,3,300,148,152,45,43,40,8,0
38449,473,265,208,47,26,50,30,478,254,224,67,74,56,28,0
38450,769,329,440,116,66,55,22,219,105,114,36,29,19,8,0
38451,364,192,172,49,36,39,14,715,345,370,110,97,64,25,0
38452,485,237,248,83,35,52,24,710,375,335,95,94,110,28,0
38453,126,57,69,31,10,10,3,1113,480,633,170,173,81,34,0
38454,475,235,240,77,58,43,22,375,211,164,50,36,31,23,0
38455,341,195,146,42,21,36,9,463,259,204,62,55,34,22,0
38456,528,273,255,67,53,29,20,601,278,323,124,87,65,21,0
38457,179,78,101,29,22,10,8,374,181,193,55,58,48,23,0
38458,531,259,272,75,81,39,13,437,221,216,62,64,47,13,0
38459,784,351,433,118,87,73,41,518,292,226,60,60,52,21,0
38460,107,36,71,27,15,0,1,396,199,197,54,50,45,14,0
38461,1276,607,669,192,178,136,63,1922,923,999,267,275,215,90,0
38462,282,160,122,36,28,27,7,690,345,345,96,83,73,42,0
38463,306,172,134,35,31,37,18,375,176,199,48,61,40,12,0
38464,314,178,136,42,32,30,17,975,400,575,160,162,62,31,0
38465,458,226,232,77,59,61,14,133,61,72,21,19,13,4,0
38466,563,255,308,91,111,42,30,295,156,139,41,40,42,15,0
38467,1499,864,635,141,99,76,110,386,207,179,43,48,44,19,0
38468,413,206,207,38,55,19,10,309,164,145,35,47,30,11,0
38469,800,416,384,102,105,83,22,385,212,173,57,40,39,21,0
38470,240,166,74,32,12,8,15,496,285,211,62,54,46,22,0
38471,260,133,127,43,29,34,11,792,398,394,109,96,90,39,0
38472,734,339,395,135,89,78,36,925,439,486,141,134,105,46,0
38473,202,103,99,28,20,12,8,218,115,103,32,32,34,11,0
38474,124,58,66,20,28,11,7,483,287,196,71,50,54,17,0
38475,588,317,271,78,49,54,17,555,292,263,75,63,67,27,0
38476,2285,1219,1066,207,180,178,106,285,146,139,41,41,48,13,0
38477,302,178,124,34,29,50,13,199,92,107,34,30,18,9,0
38478,433,188,245,63,45,26,14,555,292,263,75,63,67,27,0
38479,828,368,460,118,98,59,38,463,268,195,59,46,46,21,0
38480,519,245,274,58,61,34,22,301,168,133,49,37,34,11,0
38481,2063,1024,1039,175,117,80,97,111,60,51,17,23,10,7,0
38482,451,225,226,69,57,64,22,292,143,149,38,42,36,16,0
38483,344,168,176,50,39,30,20,223,113,110,31,33,22,12,0
38484,119,59,60,29,10,6,4,778,391,387,94,77,41,33,0
38485,427,191,236,67,60,41,34,188,90,98,44,7,21,7,0
38486,384,198,186,58,48,37,12,287,151,136,51,42,36,7,0
38487,318,164,154,52,43,34,10,471,238,233,66,63,62,19,0
38488,275,160,115,40,31,34,17,180,108,72,22,22,15,5,0
38489,207,128,79,26,17,19,9,296,151,145,45,42,32,11,0
38490,509,246,263,84,71,56,22,507,270,237,89,59,57,22,0
38491,258,130,128,44,37,29,10,293,142,151,49,40,42,17,0
38492,524,262,262,62,72,39,49,373,181,192,54,35,44,20,0
38493,474,243,231,66,54,41,29,392,186,206,62,56,29,15,0
38494,513,276,237,73,43,57,24,196,105,91,40,13,19,10,0
38495,561,282,279,68,62,36,14,295,158,137,42,34,38,14,0
38496,458,226,232,77,59,61,14,142,73,69,27,9,15,11,0
38497,215,80,135,54,56,21,9,437,224,213,40,29,42,25,0
38498,220,121,99,28,26,17,6,531,277,254,82,75,33,22,0
38499,156,64,92,31,19,5,4,106,46,60,27,18,12,3,0
38500,384,198,186,58,48,37,12,295,158,137,42,34,38,14,0
38501,168,67,101,37,17,13,13,103,44,59,16,17,9,5,0
38502,887,439,448,137,99,91,38,1101,626,475,145,122,120,50,0
38503,600,324,276,89,73,45,39,602,310,292,87,66,70,36,0
38504,1007,353,654,277,147,70,26,535,301,234,63,48,47,27,0
38505,1105,544,561,165,167,99,40,561,279,282,85,81,88,24,0
38506,589,282,307,68,67,70,23,231,126,105,37,26,29,6,0
38507,466,199,267,86,59,32,17,132,61,71,19,20,14,6,0
38508,406,208,198,41,26,43,21,144,67,77,28,14,9,8,0
38509,83,45,38,11,8,8,3,218,111,107,45,29,24,6,0
38510,57,24,33,11,3,5,3,271,150,121,39,36,37,5,0
38511,470,163,307,99,68,73,30,445,202,243,70,73,51,15,0
38512,338,172,166,59,30,39,18,329,194,135,45,32,33,9,0
38513,343,189,154,44,24,39,12,627,289,338,101,73,62,43,0
38514,1139,537,602,162,139,109,50,68,36,32,11,8,9,2,0
38515,376,249,127,47,23,43,16,975,400,575,160,162,62,31,0
38516,373,194,179,42,54,26,13,384,204,180,53,47,49,17,0
38517,2279,996,1283,375,328,158,60,350,196,154,52,37,21,14,0
38518,357,182,175,49,36,39,15,319,185,134,42,31,22,13,0
38519,840,411,429,122,101,79,34,465,252,213,73,58,60,18,0
38520,279,127,152,50,36,28,8,175,82,93,33,26,17,5,0
38521,327,174,153,42,35,16,12,194,106,88,33,10,15,6,0
38522,318,164,154,52,43,34,10,228,130,98,35,29,30,10,0
38523,658,349,309,77,70,73,35,926,425,501,159,147,77,35,0
38524,339,118,221,77,68,33,13,810,310,500,164,162,42,26,0
38525,494,233,261,87,57,46,18,593,289,304,85,69,48,19,0
38526,758,378,380,89,64,37,31,96,46,50,16,12,7,5,0
38527,161,99,62,15,22,9,7,335,186,149,40,28,29,13,0
38528,1011,559,452,121,97,132,33,644,343,301,96,69,59,28,0
38529,374,202,172,58,40,41,7,200,89,111,26,25,17,7,0
38530,288,140,148,59,33,27,12,810,310,500,164,162,42,26,0
38531,302,178,124,34,29,50,13,261,148,113,31,28,14,10,0
38532,773,361,412,126,126,65,30,1204,623,581,144,146,119,83,0
38533,646,304,342,104,93,58,26,463,268,195,59,46,46,21,0
38534,115,62,53,13,10,9,7,230,125,105,29,40,20,6,0
38535,240,99,141,53,38,29,15,201,117,83,22,21,19,9,0
38536,178,74,104,31,28,9,4,123,61,62,17,18,17,7,0
38537,526,228,298,69,64,32,30,96,46,50,16,12,7,5,0
38538,406,207,199,56,46,68,19,222,125,97,34,27,27,7,0
38539,341,177,164,57,42,40,18,279,142,137,43,39,28,7,0
38540,217,109,108,30,23,28,10,621,310,311,100,106,77,27,0
38541,5890,3314,2576,970,956,293,265,335,186,149,40,28,29,13,0
38542,272,141,131,45,29,36,9,2038,1059,979,262,237,208,100,0
38543,411,171,240,61,81,30,15,175,91,84,19,21,21,10,0
38544,1171,542,629,170,146,114,64,1113,480,633,170,173,81,34,0
38545,977,462,515,185,119,76,12,218,118,100,33,30,25,11,0
38546,234,108,126,42,40,15,9,332,180,152,44,36,27,13,0
38547,1464,693,771,153,136,91,86,583,321,262,73,67,45,25,0
38548,371,143,228,77,48,29,26,330,166,164,55,51,36,16,0
38549,395,219,176,47,41,50,18,520,272,248,60,65,58,22,0
38550,136,66,70,33,11,9,4,94,45,49,11,20,10,4,0
38551,385,179,206,58,56,38,19,715,345,370,110,97,64,25,0
38552,150,60,90,27,16,6,3,158,71,87,23,21,17,12,0
38553,898,397,501,102,98,54,37,225,129,96,32,33,20,8,0
38554,392,221,171,53,30,25,8,393,210,183,58,37,34,20,0
38555,486,243,243,65,48,63,22,609,335,274,79,57,45,22,0
38556,71,39,32,7,11,6,4,362,156,206,74,42,36,22,0
38557,313,148,165,45,33,36,11,305,163,142,38,27,47,11,0
38558,781,367,414,60,67,43,17,172,88,84,24,31,20,12,0
38559,1174,594,580,175,155,126,66,572,305,267,74,72,58,21,0
38560,722,390,332,125,69,67,25,171,94,77,24,28,30,11,0
38561,861,393,468,150,101,69,35,2382,1162,1220,237,220,140,49,0
38562,729,351,378,111,98,58,18,432,244,188,51,51,27,14,0
38563,533,297,236,74,57,39,28,260,131,129,42,31,40,9,0
38564,503,260,243,46,56,33,16,434,213,221,77,62,53,12,0
38565,398,186,212,76,70,18,13,644,343,301,96,69,59,28,0
38566,202,113,89,16,27,21,11,627,289,338,101,73,62,43,0
38567,431,202,229,57,50,50,25,367,218,149,45,43,42,16,0
38568,418,163,255,57,54,38,24,579,285,294,78,72,64,32,0
38569,521,289,232,71,58,49,16,647,324,323,101,80,76,43,0
38570,575,295,280,89,68,54,18,229,120,109,31,30,22,9,0
38571,684,353,331,95,98,77,38,1061,543,518,146,123,109,67,0
38572,178,89,89,40,12,18,7,96,45,51,13,12,6,4,0
38573,391,203,188,49,34,36,9,1249,638,611,166,153,141,45,0
38574,546,278,268,94,60,32,22,261,162,99,24,21,14,10,0
38575,323,171,152,36,36,47,15,403,221,182,47,41,47,8,0
38576,580,240,340,108,81,59,22,156,90,66,17,22,11,10,0
38577,440,267,173,52,29,42,12,925,439,486,141,134,105,46,0
38578,130,71,59,30,9,8,1,279,161,118,37,32,7,7,0
38579,338,208,130,39,30,35,12,72,32,40,8,2,2,13,0
38580,785,374,411,56,42,38,25,947,482,465,143,107,89,37,0
38581,437,230,207,41,55,27,13,240,141,99,34,28,29,8,0
38582,291,142,149,50,29,35,7,1061,543,518,146,123,109,67,0
38583,410,209,201,72,30,48,22,515,276,239,62,59,43,31,0
38584,1555,702,853,250,199,139,31,131,55,76,28,9,14,12,0
38585,425,199,226,54,71,56,11,966,478,488,108,144,74,43,0
38586,130,70,60,30,9,8,1,399,190,209,61,41,39,18,0
38587,887,439,448,137,99,91,38,201,93,108,34,39,21,6,0
38588,688,310,378,130,82,78,47,205,94,111,48,31,15,6,0
38589,550,304,246,60,64,77,16,326,169,157,51,41,41,12,0
38590,341,183,158,36,34,36,15,415,226,189,51,40,40,29,0
38591,341,183,158,36,34,36,15,593,289,304,85,69,48,19,0
38592,332,170,162,44,38,39,10,107,77,30,7,2,9,5,0
38593,317,153,164,34,52,30,14,279,106,173,48,35,41,39,0
38594,1342,640,702,187,163,123,57,246,125,121,38,36,30,11,0
38595,470,163,307,99,68,73,30,148,69,79,26,18,16,3,0
38596,919,493,426,100,92,88,49,453,247,206,58,53,45,20,0
38597,207,128,79,26,17,19,9,453,247,206,58,53,45,20,0
38598,524,262,262,62,72,39,49,292,155,137,50,34,29,13,0
38599,228,105,123,34,43,20,10,289,140,149,33,42,30,15,0
38600,1030,567,463,118,106,94,49,447,212,235,86,55,58,21,0
38601,282,135,147,27,37,30,19,520,244,276,91,60,68,20,0
38602,598,322,276,67,57,63,26,325,172,153,44,34,27,14,0
38603,615,308,307,83,75,58,32,96,45,51,13,12,6,4,0
38604,282,84,198,60,102,1,6,2547,1280,1267,331,335,293,118,0
38605,471,221,250,87,68,42,25,403,184,219,75,51,47,20,0
38606,584,340,244,77,60,47,25,172,79,93,34,27,23,10,0
38607,4128,2104,2024,581,505,453,205,598,333,265,79,66,54,33,0
38608,463,225,238,76,36,59,26,106,46,60,29,13,14,5,0
38609,519,245,274,58,61,34,22,160,60,100,23,40,19,11,0
38610,225,111,114,38,22,25,10,295,160,135,42,37,46,16,0
38611,666,204,462,110,194,42,14,564,264,300,79,84,65,26,0
38612,1616,735,881,285,248,153,72,622,344,278,80,77,68,36,0
38613,270,158,112,35,20,23,7,199,105,94,27,27,28,9,0
38614,126,56,70,31,10,10,3,392,155,237,68,61,34,16,0
38615,119,67,52,15,15,7,7,531,277,254,82,75,33,22,0
38616,317,153,164,34,52,30,14,381,187,194,37,49,36,17,0
38617,1043,479,564,200,131,123,62,1047,562,485,141,127,114,41,0
38618,1711,865,846,204,176,105,60,277,144,133,42,30,41,8,0
38619,474,243,231,66,54,41,29,201,99,102,34,26,23,6,0
38620,272,94,178,76,33,19,4,98,49,49,14,15,9,2,0
38621,531,259,272,75,81,39,13,223,113,110,31,33,22,12,0
38622,473,217,256,59,44,34,21,622,344,278,80,77,68,36,0
38623,282,96,186,80,21,28,7,171,94,77,24,28,30,11,0
38624,465,220,245,88,34,61,23,724,353,371,94,95,71,31,0
38625,126,58,68,31,10,10,3,737,397,340,87,104,90,14,0
38626,546,285,261,71,49,47,24,132,61,71,19,20,14,6,0
38627,130,70,60,30,9,8,1,389,210,179,51,37,43,9,0
38628,437,228,209,47,61,26,11,286,152,134,38,38,32,11,0
38629,478,177,301,109,66,59,25,415,205,210,77,52,55,17,0
38630,570,238,332,112,95,39,23,621,310,311,100,106,77,27,0
38631,629,338,291,92,57,64,22,332,180,152,44,36,27,13,0
38632,128,69,59,29,9,8,1,169,84,85,29,19,21,7,0
38633,339,118,221,77,68,33,13,148,69,79,26,18,16,3,0
38634,561,282,279,68,62,36,14,821,394,427,122,117,109,38,0
38635,1709,650,1059,338,286,185,46,471,238,233,66,63,62,19,0
38636,464,237,227,64,66,33,12,222,124,98,37,29,22,9,0
38637,505,247,258,72,71,60,27,715,345,370,110,97,64,25,0
38638,222,108,114,37,20,25,12,225,111,114,32,34,32,16,0
38639,181,75,106,35,26,11,9,129,60,69,21,15,8,5,0
38640,636,288,348,94,77,65,30,107,77,30,7,2,9,5,0
38641,311,154,157,47,29,34,13,350,196,154,52,37,21,14,0
38642,303,161,142,38,31,42,17,223,113,110,31,33,22,12,0
38643,255,136,119,39,20,32,10,87,38,49,23,10,10,9,0
38644,529,290,239,54,63,85,15,331,180,151,46,35,47,17,0
38645,465,220,245,88,34,61,23,607,293,314,98,71,62,32,0
38646,291,142,149,50,29,35,7,601,279,322,81,65,27,12,0
38647,347,181,166,27,20,12,12,242,121,121,39,30,29,10,0
38648,1130,614,516,129,138,98,42,422,237,185,53,47,62,20,0
38649,269,156,113,37,32,17,7,218,117,101,35,32,34,12,0
38650,136,66,70,33,11,9,5,465,252,213,73,58,60,18,0
38651,728,358,370,118,100,55,29,198,110,88,27,27,24,4,0
38652,210,84,126,44,43,9,4,179,101,78,25,15,13,13,0
38653,376,176,200,31,53,27,8,975,400,575,160,162,62,31,0
38654,109,42,67,25,13,1,1,199,105,94,27,27,28,9,0
38655,500,297,203,66,33,53,15,65,32,33,16,4,8,3,0
38656,335,171,164,51,38,38,10,314,151,163,42,61,39,16,0
38657,109,50,59,12,12,9,3,251,143,108,47,25,29,11,0
38658,524,361,163,41,8,28,16,104,46,58,15,17,9,5,0
38659,665,341,324,109,79,38,22,390,190,200,66,50,43,12,0
38660,595,339,256,64,36,54,24,597,300,297,96,89,68,29,0
38661,258,126,132,38,22,29,8,551,226,325,96,103,43,11,0
38662,315,170,145,48,56,22,11,963,525,438,119,102,102,34,0
38663,251,131,120,49,35,25,5,723,363,360,107,106,52,14,0
38664,269,127,142,43,24,34,26,338,169,169,53,44,39,21,0
38665,167,70,97,32,20,15,7,325,172,153,44,34,27,14,0
38666,439,205,234,64,88,41,21,761,351,410,117,73,103,45,0
38667,176,74,102,20,29,7,7,758,319,439,101,123,78,25,0
38668,215,104,111,61,7,2,1,89,42,47,16,12,15,6,0
38669,126,57,69,31,10,10,3,536,267,269,60,70,41,22,0
38670,315,170,145,48,56,22,11,194,94,100,33,28,14,7,0
38671,1221,597,624,201,152,83,31,978,536,442,132,107,67,32,0
38672,238,158,80,28,15,31,7,1873,935,938,233,225,203,79,0
38673,184,88,96,15,40,17,8,277,144,133,42,30,41,8,0
38674,325,186,139,49,36,20,5,892,475,417,130,108,68,38,0
38675,1447,698,749,214,180,116,46,360,180,180,57,48,39,12,0
38676,600,324,276,89,73,45,39,926,425,501,159,147,77,35,0
38677,979,534,445,83,77,80,24,129,60,69,21,15,8,5,0
38678,941,459,482,167,140,82,38,290,142,148,41,37,43,11,0
38679,482,245,237,69,64,66,24,169,84,85,29,19,21,7,0
38680,1463,521,942,252,204,105,52,1425,670,755,153,189,122,85,0
38681,577,342,235,63,57,23,37,483,258,225,70,53,54,20,0
38682,684,353,331,95,98,77,38,213,129,84,32,14,21,15,0
38683,472,222,250,46,61,33,23,530,287,243,79,70,33,26,0
38684,107,56,51,18,16,12,5,403,233,170,38,29,21,14,0
38685,1360,644,716,213,194,136,62,199,105,94,27,27,28,9,0
38686,329,171,158,49,41,31,10,250,116,134,41,30,33,19,0
38687,729,351,378,111,98,58,18,128,63,65,30,11,13,8,0
38688,272,94,178,76,33,19,4,180,90,90,31,19,20,8,0
38689,330,182,148,47,27,40,11,223,113,110,31,33,22,12,0
38690,178,89,89,40,12,18,7,556,290,266,75,74,29,24,0
38691,1014,488,526,178,137,94,39,640,364,276,84,68,69,33,0
38692,760,405,355,112,95,92,29,134,72,62,14,28,8,4,0
38693,316,157,159,45,38,22,19,234,116,118,34,35,23,9,0
38694,496,210,286,111,55,74,13,422,202,220,80,52,57,18,0
38695,319,153,166,61,52,26,12,904,436,468,143,118,108,32,0
38696,298,129,169,51,40,29,8,559,317,242,58,65,37,23,0
38697,763,354,409,101,90,63,26,704,355,349,113,94,71,24,0
38698,443,206,237,76,68,52,28,392,186,206,62,56,29,15,0
38699,369,166,203,59,55,41,14,137,85,52,15,11,11,2,0
38700,172,98,74,20,21,22,8,386,207,179,43,48,44,19,0
38701,161,94,67,23,13,8,10,201,104,97,36,32,24,7,0
38702,445,231,214,45,64,53,23,763,418,345,113,84,59,32,0
38703,1342,640,702,187,163,123,57,1239,659,580,169,148,131,54,0
38704,480,257,223,74,26,60,27,432,244,188,51,51,27,14,0
38705,454,230,224,63,56,38,33,375,211,164,50,36,31,23,0
38706,782,372,410,127,111,89,36,744,385,359,105,96,57,31,0
38707,238,158,80,28,15,31,7,621,273,348,104,102,48,19,0
38708,304,149,155,46,32,39,14,515,276,239,62,59,43,31,0
38709,428,248,180,44,39,28,9,520,244,276,91,60,68,20,0
38710,983,449,534,95,77,55,36,334,181,153,41,40,25,15,0
38711,447,236,211,56,52,49,14,551,226,325,96,103,43,11,0
38712,346,173,173,50,56,31,14,339,175,164,51,49,37,9,0
38713,577,251,326,92,84,60,11,160,76,84,19,24,8,5,0
38714,928,442,486,139,118,91,43,375,176,199,48,61,40,12,0
38715,368,154,214,80,52,41,16,329,194,135,45,32,33,9,0
38716,258,130,128,44,37,29,10,374,174,200,54,52,42,21,0
38717,332,170,162,44,38,39,10,1543,794,749,182,152,132,55,0
38718,533,297,236,74,57,39,28,427,251,176,51,39,25,22,0
38719,412,193,219,69,57,43,14,531,261,270,73,80,68,26,0
38720,736,353,383,117,83,71,18,406,223,183,61,53,46,17,0
38721,485,237,248,83,35,52,24,204,96,108,31,37,20,5,0
38722,424,170,254,69,56,47,28,727,388,339,102,87,70,29,0
38723,458,226,232,77,59,61,14,483,287,196,71,50,54,17,0
38724,227,109,118,42,35,29,8,148,84,64,30,7,17,4,0
38725,467,269,198,46,51,60,18,340,158,182,51,56,9,7,0
38726,815,356,459,128,125,82,26,368,183,185,40,42,40,15,0
38727,121,69,52,15,18,14,8,225,114,111,32,29,26,6,0
38728,339,118,221,77,68,33,13,134,55,79,22,24,16,6,0
38729,325,177,148,40,24,23,13,392,155,237,68,61,34,16,0
38730,548,310,238,72,62,54,13,201,99,102,34,26,23,6,0
38731,641,349,292,92,60,39,24,332,180,152,44,36,27,13,0
38732,407,207,200,53,36,38,8,376,183,193,50,50,43,21,0
38733,103,44,59,16,17,9,5,632,360,272,75,65,36,19,0
38734,304,149,155,46,32,39,14,1241,619,622,183,169,155,59,0
38735,654,344,310,80,69,57,15,231,126,105,28,26,34,9,0
38736,261,148,113,23,29,26,21,1262,653,609,169,165,152,50,0
38737,785,351,434,136,93,71,37,396,223,173,57,37,44,19,0
38738,215,80,135,54,56,21,9,360,185,175,51,43,36,16,0
38739,349,153,196,54,47,28,13,241,127,114,34,33,29,12,0
38740,119,57,62,18,16,17,4,180,115,65,17,12,9,9,0
38741,217,98,119,38,35,18,9,119,61,58,17,12,10,6,0
38742,126,56,70,31,10,10,3,231,126,105,37,26,29,6,0
38743,220,113,107,37,24,16,7,572,305,267,74,72,58,21,0
38744,391,203,188,49,34,36,9,1239,659,580,169,148,131,54,0
38745,270,147,123,34,17,39,21,68,36,32,11,8,9,2,0
38746,436,201,235,54,37,35,18,375,176,199,48,61,40,12,0
38747,837,443,394,129,89,87,38,410,197,213,67,43,56,18,0
38748,879,457,422,93,98,143,32,188,93,95,33,18,16,10,0
38749,126,57,69,31,10,10,3,4646,2328,2318,674,639,475,170,0
38750,213,114,99,62,7,2,1,368,183,185,40,42,40,15,0
38751,207,128,79,26,17,19,9,286,152,134,38,38,32,11,0
38752,756,362,394,102,104,73,25,334,182,152,45,41,27,13,0
38753,1084,538,546,154,121,92,35,669,406,263,69,68,64,27,0
38754,357,182,175,49,36,39,15,598,333,265,79,66,54,33,0
38755,122,56,66,26,13,11,5,660,332,328,84,73,47,19,0
38756,394,207,187,52,42,37,24,518,292,226,60,60,52,21,0
38757,1417,598,819,223,188,135,58,135,57,78,21,20,9,11,0
38758,350,172,178,61,45,32,13,363,180,183,60,34,10,6,0
38759,785,325,460,114,123,61,28,535,311,224,66,52,49,24,0
38760,595,339,256,64,36,54,24,297,164,133,45,39,40,9,0
38761,3969,1703,2266,619,432,259,144,360,185,175,51,43,36,16,0
38762,502,229,273,63,66,40,31,91,42,49,21,9,8,3,0
38763,1107,601,506,155,138,103,49,1004,457,547,150,150,74,52,0
38764,526,268,258,54,37,55,12,297,175,122,46,30,31,6,0
38765,204,103,101,16,32,22,8,106,41,65,36,6,11,7,0
38766,115,62,53,13,10,9,7,222,124,98,37,29,22,9,0
38767,529,290,239,54,63,85,15,483,215,268,66,70,30,16,0
38768,1001,422,579,185,180,51,32,561,279,282,85,81,88,24,0
38769,1447,698,749,214,180,116,46,142,65,77,30,17,22,9,0
38770,319,153,166,61,52,26,12,271,150,121,39,36,37,5,0
38771,837,381,456,123,109,65,25,400,187,213,56,59,42,20,0
38772,484,261,223,59,48,49,24,295,160,135,42,37,46,16,0
38773,2062,706,1356,414,368,158,63,455,191,264,68,86,21,19,0
38774,281,154,127,45,31,24,9,741,383,358,92,63,79,36,0
38775,127,48,79,27,20,6,5,169,74,95,33,26,22,3,0
38776,380,187,193,38,51,30,18,169,74,95,33,26,22,3,0
38777,417,176,241,75,61,51,20,462,229,233,63,49,42,18,0
38778,734,366,368,121,99,63,39,374,212,162,48,40,32,23,0
38779,587,318,269,76,50,38,21,1755,905,850,214,196,183,79,0
38780,493,281,212,56,61,30,13,551,226,325,96,103,43,11,0
38781,156,64,92,31,19,5,4,408,221,187,55,51,57,14,0
38782,322,164,158,46,44,29,7,198,113,85,19,20,26,12,0
38783,911,445,466,154,121,108,48,483,287,196,71,50,54,17,0
38784,371,143,228,77,48,29,26,132,77,55,20,9,13,10,0
38785,258,126,132,38,22,29,8,288,156,132,36,36,24,15,0
38786,764,277,487,158,162,64,31,314,177,137,34,40,29,9,0
38787,445,231,214,45,64,53,23,548,296,252,71,74,43,28,0
38788,1047,443,604,162,156,78,52,584,249,335,80,96,22,13,0
38789,340,145,195,46,38,26,23,391,189,202,55,56,56,12,0
38790,360,175,185,73,36,27,7,323,162,161,52,41,39,13,0
38791,213,113,100,26,21,26,12,312,165,147,41,39,29,16,0
38792,204,109,95,21,35,27,7,246,107,139,55,33,27,11,0
38793,443,250,193,52,23,49,13,380,211,169,47,37,33,21,0
38794,338,173,165,31,42,22,10,798,385,413,120,115,79,30,0
38795,420,202,218,67,43,51,15,471,238,233,66,63,62,19,0
38796,756,265,491,129,127,51,17,305,163,142,38,27,47,11,0
38797,802,430,372,65,102,87,23,720,361,359,98,98,70,37,0
38798,297,182,115,41,22,23,8,452,254,198,72,57,38,18,0
38799,57,24,33,11,3,5,3,338,169,169,53,44,39,21,0
38800,238,158,80,28,15,31,7,171,94,77,24,28,30,11,0
38801,837,443,394,129,89,87,38,903,436,467,128,116,83,33,0
38802,142,76,66,21,21,22,11,597,269,328,102,84,69,24,0
38803,1214,612,602,169,173,98,35,187,89,98,36,24,20,6,0
38804,385,203,182,47,43,51,21,370,190,180,60,52,37,13,0
38805,714,260,454,140,97,120,54,225,114,111,32,29,26,6,0
38806,613,303,310,70,28,28,18,729,358,371,116,99,89,33,0
38807,231,105,126,56,10,24,10,175,82,93,33,26,17,5,0
38808,306,172,134,35,31,37,18,386,181,205,55,51,57,31,0
38809,529,290,239,54,63,85,15,172,88,84,24,31,20,12,0
38810,485,237,248,83,35,52,24,316,159,157,38,48,30,11,0
38811,344,168,176,50,39,30,20,322,180,142,45,38,28,7,0
38812,269,124,145,36,24,32,11,290,147,143,34,34,39,13,0
38813,215,104,111,61,7,2,1,189,95,94,25,33,16,8,0
38814,1249,543,706,187,164,125,52,172,79,93,34,27,23,10,0
38815,648,262,386,113,108,78,29,427,251,176,51,39,25,22,0
38816,808,366,442,130,133,66,31,319,185,134,42,31,22,13,0
38817,432,233,199,52,28,47,18,124,69,55,14,7,9,4,0
38818,395,189,206,63,50,49,28,627,323,304,81,90,53,27,0
38819,164,81,83,37,8,14,10,492,278,214,65,58,32,11,0
38820,215,80,135,54,56,21,9,403,233,170,38,29,21,14,0
38821,272,94,178,76,33,19,4,279,142,137,43,39,28,7,0
38822,109,50,59,12,12,9,3,419,233,186,54,53,55,17,0
38823,681,367,314,83,74,78,31,72,33,39,8,2,3,12,0
38824,411,236,175,39,45,50,30,1182,591,591,155,139,83,46,0
38825,126,56,70,31,10,10,3,1507,737,770,188,228,147,71,0
38826,840,411,429,122,101,79,34,189,95,94,25,33,16,8,0
38827,588,267,321,99,79,87,28,229,120,109,31,30,22,9,0
38828,291,131,160,49,35,32,15,780,337,443,112,116,77,28,0
38829,406,208,198,41,26,43,21,2517,1275,1242,304,324,245,135,0
38830,726,312,414,121,73,82,23,378,154,224,74,84,35,22,0
38831,301,150,151,45,47,33,13,89,37,52,13,6,2,9,0
38832,362,174,188,46,55,35,23,487,252,235,79,58,55,26,0
38833,348,198,150,57,25,37,18,375,209,166,50,37,29,23,0
38834,429,227,202,49,51,46,26,354,183,171,54,43,49,8,0
38835,739,323,416,127,89,76,33,282,134,148,38,45,29,10,0
38836,1200,602,598,145,116,110,50,134,55,79,22,24,16,6,0
38837,609,292,317,102,96,64,21,928,440,488,111,157,82,35,0
38838,258,144,114,33,22,19,9,452,252,200,55,49,61,16,0
38839,467,233,234,83,37,77,22,748,359,389,125,113,86,31,0
38840,445,231,214,45,64,53,23,144,67,77,28,14,9,8,0
38841,107,56,51,18,16,12,5,664,350,314,86,90,82,36,0
38842,130,71,59,30,9,8,1,328,199,129,39,29,27,14,0
38843,567,256,311,91,81,53,17,2517,1275,1242,304,324,245,135,0
38844,297,182,115,41,22,23,8,307,132,175,48,53,26,10,0
38845,184,88,96,15,40,17,8,1114,539,575,145,131,94,56,0
38846,584,340,244,77,60,47,25,396,213,183,68,44,47,18,0
38847,469,253,216,49,51,48,18,397,223,174,50,39,29,17,0
38848,251,139,112,41,18,27,11,434,213,221,77,62,53,12,0
38849,664,269,395,117,107,36,15,406,223,183,61,53,46,17,0
38850,560,279,281,113,64,58,15,619,305,314,85,93,71,29,0
38851,439,178,261,77,73,40,21,544,291,253,63,53,35,25,0
38852,1161,514,647,159,138,122,37,392,155,237,68,61,34,16,0
38853,536,287,249,64,73,21,27,1507,737,770,188,228,147,71,0
38854,588,317,271,78,49,54,17,520,272,248,60,65,58,22,0
38855,586,298,288,80,75,64,37,330,166,164,55,51,36,16,0
38856,508,267,241,43,35,25,17,1020,538,482,145,115,111,58,0
38857,160,53,107,31,29,13,3,261,148,113,31,28,14,10,0
38858,326,176,150,35,22,29,11,359,171,188,49,74,45,11,0
38859,250,123,127,40,28,29,8,389,207,182,53,58,52,18,0
38860,490,198,292,65,81,39,27,289,140,149,33,42,30,15,0
38861,856,429,427,113,105,96,24,673,313,360,102,101,46,17,0
38862,476,276,200,57,34,43,16,1047,562,485,141,127,114,41,0
38863,126,58,68,31,10,10,3,349,200,149,41,39,30,20,0
38864,346,168,178,36,43,20,9,288,156,132,36,36,24,15,0
38865,350,178,172,49,62,29,16,201,117,83,22,21,19,9,0
38866,567,256,311,91,81,53,17,660,303,357,97,89,85,33,0
38867,325,152,173,43,47,28,17,622,344,278,80,77,68,36,0
38868,503,260,243,46,56,33,16,172,79,93,34,27,23,10,0
38869,514,226,288,71,66,63,32,274,142,132,33,34,18,14,0
38870,282,135,147,27,37,30,19,536,251,285,75,79,60,23,0
38871,445,231,214,45,64,53,23,662,312,350,103,104,59,20,0
38872,157,62,95,41,18,10,11,138,69,69,28,7,10,10,0
38873,411,211,200,61,46,35,18,204,96,108,31,37,20,5,0
38874,604,320,284,80,65,57,34,1816,816,1000,298,272,148,63,0
38875,101,41,60,18,19,10,5,2000,965,1035,357,313,198,75,0
38876,929,410,519,187,146,53,30,88,50,38,13,8,16,4,0
38877,397,180,217,61,59,39,13,332,180,152,46,36,28,14,0
38878,279,129,150,43,34,17,13,467,240,227,65,65,51,23,0
38879,233,107,126,40,40,20,16,504,272,232,75,57,53,19,0
38880,142,60,82,20,28,13,5,975,400,575,160,162,62,31,0
38881,584,340,244,77,60,47,25,518,292,226,60,60,52,21,0
38882,325,177,148,40,24,23,13,106,41,65,36,6,11,7,0
38883,753,361,392,99,94,66,16,364,192,172,49,36,39,14,0
38884,977,462,515,185,119,76,12,429,187,242,79,72,28,19,0
38885,1755,849,906,245,226,148,56,425,177,248,60,62,33,16,0
38886,1276,607,669,192,178,136,63,106,46,60,27,18,12,3,0
38887,1439,713,726,195,180,110,34,975,400,575,160,162,62,31,0
38888,347,212,135,35,32,17,6,285,143,142,45,32,21,17,0
38889,338,172,166,59,30,39,18,385,212,173,57,40,39,21,0
38890,529,290,239,54,63,85,15,319,185,134,42,31,22,13,0
38891,215,104,111,61,7,2,1,375,210,165,49,37,29,27,0
38892,616,323,293,98,71,31,15,966,478,488,108,144,74,43,0
38893,428,226,202,52,60,75,20,341,170,171,41,66,27,10,0
38894,4128,2104,2024,581,505,453,205,389,207,182,53,58,52,18,0
38895,328,156,172,44,37,44,15,256,141,115,32,22,32,8,0
38896,736,320,416,113,97,61,36,209,119,90,28,24,27,9,0
38897,619,289,330,67,77,36,19,455,229,226,66,62,63,29,0
38898,687,351,336,106,67,70,41,756,348,408,101,103,60,40,0
38899,784,353,431,56,47,26,18,163,79,84,22,24,13,5,0
38900,953,421,532,131,131,70,37,497,227,270,70,63,66,30,0
38901,445,231,214,45,64,53,23,1425,670,755,153,189,122,85,0
38902,895,388,507,130,84,90,31,331,180,151,46,35,47,17,0
38903,766,336,430,133,97,79,21,364,189,175,58,41,35,17,0
38904,330,182,148,47,27,40,11,673,313,360,102,101,46,17,0
38905,95,47,48,13,12,10,4,139,73,66,26,13,9,9,0
38906,454,214,240,56,71,35,16,222,124,98,37,29,22,9,0
38907,301,150,151,45,47,33,13,215,115,100,27,19,16,7,0
38908,2285,1219,1066,207,180,178,106,89,51,38,15,15,5,4,0
38909,1214,498,716,197,180,121,65,405,181,224,71,57,31,12,0
38910,781,367,414,60,67,43,17,336,200,136,34,29,25,24,0
38911,756,265,491,129,127,51,17,148,84,64,30,7,17,4,0
38912,258,126,132,38,22,29,8,496,285,211,62,54,46,22,0
38913,2048,855,1193,297,287,191,93,536,267,269,60,70,41,22,0
38914,222,110,112,43,30,14,6,129,60,69,21,15,8,5,0
38915,615,308,307,83,75,58,32,588,286,302,78,99,53,25,0
38916,392,205,187,83,49,38,10,437,224,213,40,29,42,25,0
38917,457,261,196,55,27,57,34,582,264,318,84,60,58,23,0
38918,2442,1193,1249,278,183,170,145,381,196,185,55,57,43,16,0
38919,963,477,486,134,143,123,38,459,260,199,56,42,47,21,0
38920,338,208,130,39,30,35,12,1004,457,547,150,150,74,52,0
38921,193,105,88,33,16,9,4,96,46,50,16,12,7,5,0
38922,756,265,491,129,127,51,17,260,131,129,42,31,40,9,0
38923,392,221,171,53,30,25,8,866,478,388,121,101,101,26,0
38924,484,194,290,70,93,47,16,200,89,111,26,25,17,7,0
38925,557,211,346,129,125,48,19,329,196,133,41,36,31,15,0
38926,548,250,298,85,64,56,21,171,94,77,24,28,30,11,0
38927,784,351,433,118,87,73,41,312,165,147,41,39,29,16,0
38928,747,469,278,60,41,53,23,821,394,427,122,117,109,38,0
38929,500,245,255,66,57,52,27,188,93,95,33,18,16,10,0
38930,82,36,46,17,10,5,1,271,150,121,39,36,37,5,0
38931,640,308,332,91,102,49,21,180,89,91,28,27,18,7,0
38932,734,339,395,135,89,78,36,579,285,294,78,72,64,32,0
38933,435,222,213,67,49,67,12,368,183,185,40,42,40,15,0
38934,1560,778,782,224,235,132,78,501,257,244,75,57,48,29,0
38935,539,283,256,75,73,53,26,234,129,105,31,22,19,17,0
38936,471,221,250,87,68,42,25,89,38,51,14,6,3,9,0
38937,475,235,240,77,58,43,22,403,221,182,62,50,42,12,0
38938,2624,999,1625,415,495,109,84,266,146,120,41,28,31,7,0
38939,436,209,227,66,47,52,22,102,51,51,12,15,12,3,0
38940,443,250,193,52,23,49,13,223,113,110,31,33,22,12,0
38941,1107,601,506,155,138,103,49,565,237,328,75,88,32,11,0
38942,123,58,65,22,14,13,3,278,154,124,42,32,38,7,0
38943,76,42,34,12,8,5,7,320,168,152,38,42,24,18,0
38944,350,178,172,49,62,29,16,277,145,132,41,32,22,10,0
38945,193,107,86,13,20,13,6,134,55,79,22,24,16,6,0
38946,493,208,285,75,77,70,40,104,46,58,15,17,9,5,0
38947,281,154,127,45,31,24,9,123,61,62,17,18,17,7,0
38948,333,171,162,50,34,19,8,279,161,118,37,32,7,7,0
38949,5890,3314,2576,970,956,293,265,441,189,252,73,50,47,23,0
38950,959,496,463,144,132,75,35,329,194,135,45,32,33,9,0
38951,2279,996,1283,375,328,158,60,283,160,123,25,20,37,9,0
38952,282,96,186,80,21,28,7,389,207,182,53,58,52,18,0
38953,683,304,379,140,101,48,19,142,76,66,21,21,22,11,0
38954,493,281,212,56,61,30,13,749,384,365,108,105,86,31,0
38955,508,267,241,43,35,25,17,277,152,125,31,35,22,19,0
38956,1867,973,894,256,222,194,65,611,314,297,79,75,78,22,0
38957,282,84,198,60,102,1,6,373,213,160,44,33,26,17,0
38958,299,128,171,57,40,13,25,283,142,141,41,33,26,18,0
38959,583,279,304,99,71,59,31,175,82,93,33,26,17,5,0
38960,559,217,342,105,86,42,16,1248,584,664,184,164,155,67,0
38961,1439,713,726,195,180,110,34,538,274,264,84,67,52,35,0
38962,126,56,70,31,10,10,3,359,171,188,49,74,45,11,0
38963,1054,453,601,183,183,107,35,54,26,28,11,4,3,3,0
38964,301,150,151,45,47,33,13,862,426,436,113,115,84,37,0
38965,653,379,274,89,56,86,13,601,279,322,81,65,27,12,0
38966,119,67,52,15,15,7,7,715,345,370,110,97,64,25,0
38967,454,214,240,56,71,35,16,364,189,175,58,41,35,17,0
38968,813,412,401,114,93,112,26,367,218,149,45,43,42,16,0
38969,1755,849,906,245,226,148,56,663,354,309,91,84,79,31,0
38970,165,66,99,28,32,16,3,108,59,49,17,13,12,5,0
38971,488,237,251,79,78,65,27,230,125,105,29,40,20,6,0
38972,176,74,102,20,29,7,7,547,295,252,81,65,57,23,0
38973,204,93,111,35,35,16,11,751,394,357,107,96,73,35,0
38974,275,160,115,40,31,34,17,246,125,121,38,36,30,11,0
38975,149,78,71,20,20,19,5,744,385,359,105,96,57,31,0
38976,130,70,60,30,9,8,1,160,60,100,23,40,19,11,0
38977,443,206,237,76,68,52,28,277,152,125,31,35,22,19,0
38978,130,70,60,30,9,8,1,101,59,42,11,17,10,1,0
38979,236,141,95,36,32,14,6,780,337,443,112,116,77,28,0
38980,952,547,405,95,90,127,35,452,231,221,74,53,56,20,0
38981,412,208,204,54,47,42,17,132,67,65,24,21,8,10,0
38982,733,382,351,126,92,93,27,873,411,462,132,107,84,40,0
38983,396,150,246,103,64,38,3,2346,1231,1115,316,292,266,105,0
38984,680,308,372,82,72,71,40,332,173,159,48,40,31,11,0
38985,331,177,154,54,38,27,11,947,482,465,143,107,89,37,0
38986,282,84,198,60,102,1,6,821,394,427,122,117,109,38,0
38987,538,263,275,71,85,44,18,215,115,100,27,19,16,7,0
38988,714,260,454,140,97,120,54,660,303,357,97,89,85,33,0
38989,473,212,261,72,64,45,28,222,124,98,37,29,22,9,0
38990,318,161,157,53,51,32,13,452,254,198,72,57,38,18,0
38991,480,257,223,74,26,60,27,94,45,49,11,20,10,4,0
38992,325,181,144,46,31,48,9,134,72,62,14,28,8,4,0
38993,869,489,380,110,77,79,29,1208,565,643,182,162,120,57,0
38994,424,170,254,69,56,47,28,384,204,180,53,47,49,17,0
38995,420,202,218,67,43,51,15,375,211,164,50,36,31,23,0
38996,397,180,217,61,59,39,13,245,121,124,37,35,36,12,0
38997,316,157,159,45,38,22,19,2382,1162,1220,237,220,140,49,0
38998,457,261,196,55,27,57,34,519,287,232,68,58,45,21,0
38999,142,60,82,20,28,13,5,137,85,52,15,11,11,2,0
39000,130,70,60,30,9,8,1,158,71,87,23,21,17,12,0
39001,130,70,60,30,9,8,1,524,300,223,70,54,51,25,0
39002,1200,602,598,145,116,110,50,1500,804,696,190,172,144,60,0
39003,681,367,314,83,74,78,31,207,113,94,33,18,30,9,0
39004,322,164,158,46,44,29,7,292,143,149,38,42,36,16,0
39005,1208,575,633,187,204,117,41,593,289,304,85,69,48,19,0
39006,667,366,301,96,55,84,25,547,295,252,81,65,57,23,0
39007,127,54,73,31,10,11,3,264,138,126,33,34,29,12,0
39008,428,248,180,44,39,28,9,261,148,113,31,28,14,10,0
39009,747,469,278,60,41,53,23,207,86,121,34,39,11,13,0
39010,375,167,208,55,83,44,9,605,283,322,94,72,64,39,0
39011,347,212,135,35,32,17,6,201,99,102,34,26,23,6,0
39012,461,257,204,63,49,50,29,289,140,149,33,42,30,15,0
39013,489,253,236,73,36,62,17,325,159,166,59,46,30,12,0
39014,482,245,237,69,64,66,24,277,145,132,41,32,22,10,0
39015,333,171,162,41,44,48,23,192,110,82,33,21,10,3,0
39016,319,153,166,61,52,26,12,367,218,149,45,43,42,16,0
39017,666,204,462,110,194,42,14,125,66,59,24,16,11,5,0
39018,217,109,108,30,23,28,10,299,140,159,49,44,26,11,0
39019,126,56,70,31,10,10,3,2382,1162,1220,237,220,140,49,0
39020,220,121,99,28,26,17,6,644,343,301,96,69,59,28,0
39021,301,119,182,53,47,14,20,1182,591,591,155,139,83,46,0
39022,2624,999,1625,415,495,109,84,514,262,252,78,58,54,26,0
39023,452,202,250,83,60,56,19,242,121,121,39,30,29,10,0
39024,162,73,89,32,19,4,4,277,138,139,40,39,20,14,0
39025,92,46,46,14,9,8,6,620,324,296,81,68,66,31,0
39026,437,225,212,61,57,66,12,758,361,397,114,107,51,19,0
39027,589,282,307,68,67,70,23,54,26,28,11,4,3,3,0
39028,1395,595,800,223,206,113,61,277,124,153,44,40,35,18,0
39029,181,92,89,34,22,17,9,478,254,224,67,74,56,28,0
39030,82,36,46,17,10,5,1,257,126,131,61,24,22,8,0
39031,517,196,321,103,98,33,12,103,50,53,19,10,7,5,0
39032,853,400,453,137,109,88,42,496,285,211,62,54,46,22,0
39033,861,393,468,150,101,69,35,278,154,124,42,32,38,7,0
39034,415,133,282,114,65,27,7,904,436,468,143,118,108,32,0
39035,280,156,124,36,19,20,13,1507,737,770,188,228,147,71,0
39036,236,120,116,32,28,21,11,622,344,278,80,77,68,36,0
39037,1014,488,526,178,137,94,39,900,441,459,125,127,110,32,0
39038,199,113,86,27,17,10,7,400,187,213,56,59,42,20,0
39039,798,364,434,133,88,74,35,4646,2328,2318,674,639,475,170,0
39040,789,362,427,90,82,70,35,474,268,206,66,42,45,24,0
39041,322,164,158,46,44,29,7,846,425,421,125,97,98,38,0
39042,2624,999,1625,415,495,109,84,105,51,54,13,17,12,8,0
39043,390,199,191,72,42,35,12,547,295,252,81,65,57,23,0
39044,658,349,309,77,70,73,35,662,312,350,103,104,59,20,0
39045,464,237,227,64,66,33,12,392,186,206,62,56,29,15,0
39046,176,74,102,20,29,7,7,344,190,154,34,31,36,10,0
39047,454,214,240,56,71,35,16,169,84,85,29,19,21,7,0
39048,320,183,137,51,18,38,8,323,171,152,48,41,40,16,0
39049,228,105,123,34,43,20,10,316,159,157,38,48,30,11,0
39050,490,198,292,65,81,39,27,218,117,101,35,32,34,12,0
39051,654,344,310,80,69,57,15,701,380,321,94,84,96,34,0
39052,334,190,144,42,42,16,5,928,440,488,111,157,82,35,0
39053,397,180,217,61,59,39,13,337,152,185,49,54,42,21,0
39054,510,269,241,66,67,71,26,1034,495,539,150,134,114,71,0
39055,1163,417,746,209,145,87,28,926,340,586,133,119,60,40,0
39056,376,171,205,45,45,34,12,866,478,388,121,101,101,26,0
39057,496,209,287,113,55,72,14,766,386,380,101,81,78,31,0
39058,169,64,105,23,37,11,3,289,140,149,33,42,30,15,0
39059,217,98,119,38,35,18,9,106,54,52,12,9,7,6,0
39060,157,62,95,41,18,10,11,336,200,136,34,29,25,24,0
39061,161,75,86,24,20,10,7,526,266,260,76,75,53,22,0
39062,532,291,241,83,36,79,25,396,213,183,68,44,47,18,0
39063,520,261,259,74,52,49,22,723,353,370,120,109,96,33,0
39064,496,209,287,113,55,72,14,1922,923,999,267,275,215,90,0
39065,443,250,193,52,23,49,13,963,525,438,119,102,102,34,0
39066,450,227,223,53,36,48,12,452,254,198,72,57,38,18,0
39067,394,207,187,52,42,37,24,715,348,367,109,84,68,30,0
39068,57,24,33,11,3,5,3,348,194,154,57,31,43,12,0
39069,428,248,180,44,39,28,9,205,94,111,48,31,15,6,0
39070,346,186,160,50,33,27,12,1471,709,762,198,184,154,62,0
39071,341,175,166,48,43,35,18,337,170,167,59,33,47,17,0
39072,138,35,103,38,2,15,9,137,72,65,27,13,15,8,0
39073,411,211,200,61,46,35,18,974,457,517,133,117,69,26,0
39074,1249,543,706,187,164,125,52,305,161,144,39,40,44,17,0
39075,412,146,266,106,38,67,35,386,207,179,43,48,44,19,0
39076,1226,513,713,184,147,87,43,134,72,62,14,28,8,4,0
39077,127,62,65,13,33,7,6,405,195,210,57,74,24,17,0
39078,410,208,202,59,58,43,26,89,37,52,13,6,2,9,0
39079,159,105,54,22,9,14,25,381,186,195,69,55,46,15,0
39080,533,300,233,74,50,74,17,231,126,105,28,26,34,9,0
39081,785,325,460,114,123,61,28,68,36,32,11,8,9,2,0
39082,305,124,181,27,25,32,21,536,222,314,101,100,34,22,0
39083,240,167,73,32,12,8,21,415,203,212,77,44,49,18,0
39084,563,255,308,91,111,42,30,139,68,71,14,26,14,9,0
39085,160,53,107,31,29,13,3,188,90,98,44,7,21,7,0
39086,789,362,427,90,82,70,35,314,177,137,34,40,29,9,0
39087,911,441,470,123,108,60,21,200,99,101,31,24,26,6,0
39088,282,84,198,60,102,1,6,947,482,465,143,107,89,37,0
39089,949,466,483,125,126,101,50,384,212,172,44,43,34,14,0
39090,242,111,131,35,35,17,13,421,222,199,69,50,60,18,0
39091,1121,458,663,158,210,76,47,403,185,218,67,62,63,19,0
39092,345,203,142,47,35,31,11,377,184,193,50,43,33,17,0
39093,252,121,131,42,34,12,16,128,63,65,30,11,13,8,0
39094,604,239,365,124,63,84,37,397,223,174,50,39,29,17,0
39095,207,93,114,20,33,19,10,334,182,152,45,41,27,13,0
39096,179,96,83,24,8,26,4,137,78,59,22,16,17,4,0
39097,282,163,119,40,23,25,17,461,223,238,45,62,18,35,0
39098,873,366,507,127,125,75,21,536,267,269,60,70,41,22,0
39099,485,183,302,79,81,73,33,335,186,149,40,28,29,13,0
39100,747,360,387,125,92,69,32,165,87,78,24,19,22,9,0
39101,155,85,70,17,16,4,8,145,77,68,26,7,15,8,0
39102,206,100,106,34,26,11,7,1382,508,874,334,320,98,36,0
39103,3703,1708,1995,456,428,305,162,597,300,297,96,89,68,29,0
39104,520,240,280,67,72,42,14,421,219,202,68,57,56,13,0
39105,76,30,46,7,15,1,5,402,186,216,64,47,38,20,0
39106,119,67,52,15,15,7,7,1230,644,586,198,125,123,61,0
39107,357,182,175,49,36,39,15,332,180,152,46,36,28,14,0
39108,519,245,274,58,61,34,22,296,140,156,49,40,42,19,0
39109,305,124,181,27,25,32,21,367,218,149,45,43,42,16,0
39110,249,114,135,47,33,25,4,898,469,429,125,125,134,35,0
39111,240,166,74,32,12,8,15,261,127,134,36,27,36,4,0
39112,546,285,261,71,49,47,24,403,184,219,75,51,47,20,0
39113,240,99,141,53,38,29,15,54,26,28,11,4,3,3,0
39114,837,443,394,129,89,87,38,72,33,39,8,2,3,12,0
39115,199,113,86,27,17,10,7,507,270,237,89,59,57,22,0
39116,252,121,131,42,34,12,16,715,348,367,109,84,68,30,0
39117,784,353,431,56,47,26,18,405,181,224,71,57,31,12,0
39118,462,228,234,59,47,37,32,496,285,211,62,54,46,22,0
39119,338,172,166,59,30,39,18,2225,1244,981,271,243,217,93,0
39120,567,266,301,139,46,76,37,751,394,357,107,96,73,35,0
39121,347,212,135,35,32,17,6,266,146,120,41,28,31,7,0
39122,813,412,401,114,93,112,26,173,86,87,30,22,19,12,0
39123,315,170,145,48,56,22,11,974,457,517,133,117,69,26,0
39124,2414,1189,1225,277,178,170,169,531,277,254,82,75,33,22,0
39125,441,216,225,57,66,57,19,171,94,77,24,28,30,11,0
39126,747,469,278,60,41,53,23,196,105,91,40,13,19,10,0
39127,503,260,243,46,56,33,16,1020,538,482,145,115,111,58,0
39128,388,244,144,46,25,42,16,65,32,33,16,4,8,3,0
39129,332,172,160,50,33,35,9,526,266,260,76,75,53,22,0
39130,297,182,115,41,22,23,8,770,390,380,104,76,78,32,0
39131,202,113,89,16,27,21,11,1922,923,999,267,275,215,90,0
39132,900,434,466,134,97,86,36,218,111,107,45,29,24,6,0
39133,444,250,194,58,21,60,23,242,124,118,39,32,28,22,0
39134,928,442,486,139,118,91,43,200,89,111,26,25,17,7,0
39135,136,66,70,33,11,9,3,374,174,200,54,52,42,21,0
39136,280,128,152,39,37,38,18,323,171,152,48,41,40,16,0
39137,403,176,227,71,56,51,11,662,373,289,89,80,77,29,0
39138,1161,514,647,159,138,122,37,360,180,180,57,48,39,12,0
39139,305,124,181,27,25,32,21,270,162,108,26,26,16,11,0
39140,526,228,298,69,64,32,30,225,129,96,32,33,20,8,0
39141,546,265,281,101,64,38,16,314,151,163,42,61,39,16,0
39142,436,209,227,66,47,52,22,430,212,218,88,43,40,20,0
39143,357,182,175,49,36,39,15,258,129,129,45,24,31,10,0
39144,227,120,107,31,28,28,13,374,212,162,48,40,32,23,0
39145,524,361,163,41,8,28,16,189,95,94,25,33,16,8,0
39146,206,96,110,33,25,8,6,545,269,276,80,76,27,32,0
39147,525,302,223,56,48,67,19,127,64,63,26,8,12,8,0
39148,130,71,59,30,9,8,2,783,406,377,102,91,57,29,0
39149,509,246,263,84,71,56,22,132,61,71,22,21,15,3,0
39150,166,59,107,36,41,10,4,378,154,224,74,84,35,22,0
39151,342,150,192,52,43,31,17,223,113,110,31,33,22,12,0
39152,378,202,176,34,32,44,13,295,160,135,44,36,46,16,0
39153,496,272,224,70,58,42,18,98,49,49,14,15,9,2,0
39154,561,282,279,68,62,36,14,360,185,175,51,43,36,16,0
39155,615,308,307,83,75,58,32,370,173,197,65,57,42,10,0
39156,332,172,160,50,33,35,9,903,436,467,128,116,83,33,0
39157,410,200,210,60,54,46,19,218,118,100,33,30,25,11,0
39158,121,69,52,15,18,14,8,386,207,179,43,48,44,19,0
39159,425,199,226,54,71,56,11,241,127,114,34,33,29,12,0
39160,502,274,228,64,49,75,17,370,190,180,60,52,37,13,0
39161,136,65,71,33,11,9,6,308,146,162,42,39,24,12,0
39162,412,203,209,65,47,37,18,319,185,134,42,31,22,13,0
39163,373,164,209,51,45,44,21,119,61,58,17,12,10,6,0
39164,781,316,465,130,129,65,23,106,54,52,12,9,7,6,0
39165,333,171,162,41,44,48,23,974,457,517,133,117,69,26,0
39166,977,462,515,185,119,76,12,179,101,78,25,15,13,13,0
39167,730,298,432,128,69,86,26,200,89,111,26,25,17,7,0
39168,496,209,287,113,55,72,14,519,287,232,68,58,45,21,0
39169,629,374,255,74,53,87,27,403,221,182,62,50,42,12,0
39170,579,321,258,74,70,47,22,455,191,264,68,86,21,19,0
39171,184,93,91,26,25,14,11,325,159,166,59,46,30,12,0
39172,237,127,110,34,30,16,9,360,180,180,57,48,39,12,0
39173,303,147,156,49,49,20,8,792,398,394,109,96,90,39,0
39174,233,110,123,34,22,34,9,665,361,304,87,91,84,31,0
39175,76,42,34,12,8,5,7,763,418,345,113,84,59,32,0
39176,371,209,162,46,17,36,19,246,125,121,38,36,30,11,0
39177,860,349,511,166,166,58,19,160,60,100,23,40,19,11,0
39178,315,111,204,82,66,46,11,373,189,184,54,46,50,23,0
39179,279,106,173,48,35,41,39,173,90,83,30,19,19,11,0
39180,388,209,179,46,24,31,28,175,91,84,19,21,21,10,0
39181,236,120,116,32,28,21,11,297,164,133,45,39,40,9,0
39182,977,462,515,185,119,76,12,144,67,77,28,14,9,8,0
39183,136,66,70,33,11,9,3,662,312,350,103,104,59,20,0
39184,172,98,74,20,21,22,8,467,231,236,71,65,58,18,0
39185,1112,457,655,180,164,99,39,375,176,199,48,61,40,12,0
39186,550,304,246,60,64,77,16,359,171,188,49,74,45,11,0
39187,685,393,292,75,66,113,16,462,229,233,63,49,42,18,0
39188,270,131,139,47,37,41,11,392,155,237,68,61,34,16,0
39189,726,312,414,121,73,82,23,873,411,462,132,107,84,40,0
39190,785,374,411,56,42,38,25,386,207,179,43,48,44,19,0
39191,126,58,68,31,10,10,3,316,159,157,38,48,30,11,0
39192,317,140,177,43,26,31,16,396,197,199,75,49,49,16,0
39193,346,205,141,47,34,30,7,207,86,121,34,39,11,13,0
39194,165,66,99,28,32,16,3,376,189,187,47,53,44,26,0
39195,588,267,321,99,79,87,28,299,140,159,49,44,26,11,0
39196,362,174,188,46,55,35,23,758,319,439,101,123,78,25,0
39197,380,148,232,81,69,24,8,403,225,178,56,38,33,25,0
39198,1647,794,853,279,235,128,65,1241,619,622,183,169,155,59,0
39199,1501,679,822,251,196,174,67,415,203,212,77,44,49,18,0
39200,398,186,212,76,70,18,13,1230,644,586,198,125,123,61,0
39201,200,103,97,17,16,10,10,348,212,136,53,31,25,18,0
39202,1867,973,894,256,222,194,65,556,290,266,75,74,29,24,0
39203,567,266,301,139,46,76,37,317,161,156,50,36,47,12,0
39204,667,366,301,96,55,84,25,4646,2328,2318,674,639,475,170,0
39205,933,456,477,123,108,83,29,292,143,149,38,42,36,16,0
39206,1124,442,682,148,189,72,43,1755,905,850,214,196,183,79,0
39207,257,132,125,39,27,26,10,1020,538,482,145,115,111,58,0
39208,559,217,342,105,86,42,16,153,80,73,26,18,19,4,0
39209,496,210,286,111,55,74,13,142,73,69,27,9,15,11,0
39210,322,164,158,46,44,29,7,352,207,145,40,33,25,21,0
39211,502,229,273,63,66,40,31,403,225,178,56,38,33,25,0
39212,559,217,342,105,86,42,16,264,138,126,33,34,29,12,0
39213,150,60,90,27,16,6,3,524,300,223,70,54,51,25,0
39214,420,189,231,79,67,33,17,689,343,346,105,102,81,35,0
39215,730,298,432,128,69,86,26,244,143,101,31,29,26,8,0
39216,682,260,422,153,78,109,46,283,160,123,25,20,37,9,0
39217,496,274,222,57,43,75,22,455,229,226,66,62,63,29,0
39218,414,195,219,51,60,40,17,373,189,184,54,46,50,23,0
39219,887,439,448,137,99,91,38,332,180,152,44,36,27,13,0
39220,310,141,169,36,38,20,8,133,61,72,21,19,13,4,0
39221,802,375,427,133,103,81,41,736,388,348,88,85,67,28,0
39222,343,162,181,65,38,29,12,423,234,189,66,44,57,12,0
39223,1499,864,635,141,99,76,110,582,264,318,84,60,58,23,0
39224,867,415,452,123,87,62,27,397,223,174,50,39,29,17,0
39225,803,358,445,135,117,80,43,727,362,365,123,107,63,23,0
39226,279,129,150,43,34,17,13,1279,669,610,164,162,104,55,0
39227,149,68,81,15,38,11,10,715,345,370,110,97,64,25,0
39228,1098,519,579,182,159,79,42,699,334,365,108,80,70,20,0
39229,282,84,198,60,102,1,6,649,307,342,71,134,45,17,0
39230,270,131,139,47,37,41,11,207,113,94,33,18,30,9,0
39231,329,168,161,48,34,41,16,180,90,90,31,19,20,8,0
39232,658,349,309,77,70,73,35,295,156,139,41,40,42,15,0
39233,335,155,180,64,48,36,10,222,127,95,23,28,22,7,0
39234,895,388,507,130,84,90,31,290,147,143,34,34,39,13,0
39235,207,128,79,26,17,19,9,2202,1121,1081,338,274,269,81,0
39236,401,236,165,53,38,34,9,374,212,162,48,40,32,23,0
39237,854,435,419,118,91,95,42,360,180,180,57,48,39,12,0
39238,388,244,144,46,25,42,16,381,186,195,69,55,46,15,0
39239,399,220,179,48,37,68,18,300,148,152,45,43,40,8,0
39240,521,289,232,71,58,49,16,617,314,303,96,68,68,37,0
39241,1555,702,853,250,199,139,31,598,333,265,79,66,54,33,0
39242,149,78,71,20,20,19,5,222,127,95,23,28,22,7,0
39243,1199,589,610,189,128,167,65,386,181,205,55,51,57,31,0
39244,414,195,219,51,60,40,17,925,439,486,141,134,105,46,0
39245,325,186,139,49,36,20,5,172,88,84,24,31,20,12,0
39246,432,190,242,85,82,28,11,413,223,190,52,45,53,10,0
39247,365,148,217,86,37,51,28,455,191,264,68,86,21,19,0
39248,338,164,174,45,32,37,13,350,196,154,52,37,21,14,0
39249,297,161,136,36,35,24,9,605,283,322,94,72,64,39,0
39250,399,196,203,62,45,38,19,437,221,216,62,64,47,13,0
39251,111,29,82,10,54,0,1,1062,522,540,151,147,105,66,0
39252,504,222,282,71,64,53,29,54,26,28,11,4,3,3,0
39253,510,269,241,66,67,71,26,2547,1280,1267,331,335,293,118,0
39254,76,42,34,12,8,5,7,662,312,350,103,104,59,20,0
39255,949,467,482,126,127,102,51,222,127,95,23,28,22,7,0
39256,525,302,223,56,48,67,19,172,88,84,24,31,20,12,0
39257,486,243,243,65,48,63,22,471,238,233,66,63,62,19,0
39258,261,130,131,27,41,19,16,106,46,60,27,18,12,3,0
39259,836,370,466,126,96,72,30,396,199,197,54,50,45,14,0
39260,136,66,70,33,11,9,3,439,227,212,60,55,58,8,0
39261,384,198,186,58,48,37,12,213,129,84,32,14,21,15,0
39262,496,210,286,111,55,74,13,1061,543,518,146,123,109,67,0
39263,434,221,213,58,47,54,15,89,37,52,13,6,2,9,0
39264,261,126,135,41,36,24,11,329,194,135,45,32,33,9,0
39265,395,195,200,41,55,23,10,98,49,49,14,15,9,2,0
39266,519,245,274,58,61,34,22,644,343,301,96,69,59,28,0
39267,414,195,219,51,60,40,17,617,314,303,96,68,68,37,0
39268,813,412,401,114,93,112,26,295,160,135,42,37,46,16,0
39269,492,253,239,73,67,77,29,647,324,323,101,80,76,43,0
39270,149,78,71,20,20,19,5,367,218,149,45,43,42,16,0
39271,1011,559,452,121,97,132,33,163,79,84,22,24,13,5,0
39272,837,381,456,123,109,65,25,220,107,113,36,35,28,9,0
39273,556,306,250,69,60,80,18,408,221,187,55,51,57,14,0
39274,202,103,99,28,20,12,8,701,380,321,94,84,96,34,0
39275,527,254,273,67,66,70,31,906,455,451,116,105,87,46,0
39276,1276,607,669,192,178,136,63,1230,644,586,198,125,123,61,0
39277,911,441,470,123,108,60,21,1700,731,969,198,233,110,87,0
39278,207,89,118,56,8,4,3,1873,935,938,233,225,203,79,0
39279,436,201,235,54,37,35,18,660,333,327,102,95,69,31,0
39280,502,250,252,70,47,57,15,149,52,97,36,36,7,4,0
39281,150,64,86,22,12,29,12,496,285,211,62,54,46,22,0
39282,900,434,466,134,97,86,36,169,84,85,29,19,21,7,0
39283,335,171,164,51,38,38,10,234,129,105,31,22,19,17,0
39284,121,69,52,15,18,14,8,317,161,156,50,36,47,12,0
39285,473,212,261,72,64,45,28,536,222,314,101,100,34,22,0
39286,336,134,202,51,64,27,12,166,102,64,19,14,17,2,0
39287,419,210,209,54,44,31,23,415,189,226,68,54,50,21,0
39288,802,375,427,133,103,81,41,180,89,91,28,27,18,7,0
39289,789,362,427,90,82,70,35,396,197,199,75,49,49,16,0
39290,314,158,156,39,28,30,17,538,274,264,84,67,52,35,0
39291,327,174,153,42,35,16,12,332,180,152,44,36,27,13,0
39292,824,391,433,106,90,88,32,545,269,276,80,76,27,32,0
39293,279,127,152,50,36,28,8,732,366,366,108,86,74,41,0
39294,299,151,148,35,34,26,16,619,305,314,85,93,71,29,0
39295,228,82,146,45,37,18,8,209,119,90,28,24,27,9,0
39296,956,450,506,122,117,82,36,462,251,211,74,53,41,18,0
39297,424,170,254,69,56,47,28,332,180,152,44,36,27,13,0
39298,427,191,236,67,60,41,34,316,166,150,45,38,37,13,0
39299,241,122,119,27,34,17,16,189,95,94,25,33,16,8,0
39300,953,421,532,131,131,70,37,583,321,262,73,67,45,25,0
39301,250,123,127,40,28,29,8,392,214,178,48,40,53,22,0
39302,301,119,182,53,47,14,20,147,74,73,28,20,24,4,0
39303,313,148,165,45,33,36,11,303,138,165,47,46,35,18,0
39304,161,75,86,24,20,10,7,207,86,121,34,39,11,13,0
39305,292,102,190,71,27,51,21,452,254,198,72,57,38,18,0
39306,613,303,310,70,28,28,18,866,478,388,121,101,101,26,0
39307,431,216,215,46,40,33,9,396,199,197,54,50,45,14,0
39308,331,177,154,54,38,27,11,935,515,420,126,107,73,32,0
39309,687,351,336,106,67,70,41,1507,737,770,188,228,147,71,0
39310,1544,738,806,239,217,145,91,699,334,365,108,80,70,20,0
39311,233,110,123,34,22,34,9,501,249,252,77,70,55,22,0
39312,415,133,282,114,65,27,7,1922,923,999,267,275,215,90,0
39313,428,248,180,44,39,28,9,583,321,262,73,67,45,25,0
39314,450,227,223,53,36,48,12,222,124,98,37,29,22,9,0
39315,414,195,219,51,60,40,17,137,85,52,15,11,11,2,0
39316,786,378,408,106,98,77,39,514,262,252,78,58,54,26,0
39317,434,216,218,72,58,40,20,736,388,348,88,85,67,28,0
39318,622,354,268,89,60,64,18,664,350,314,86,90,82,36,0
39319,1121,458,663,158,210,76,47,975,400,575,160,162,62,31,0
39320,202,113,89,16,27,21,11,367,199,168,62,44,34,8,0
39321,512,254,258,70,48,37,32,966,478,488,108,144,74,43,0
39322,465,305,160,40,47,34,9,744,385,359,105,96,57,31,0
39323,435,187,248,62,51,51,21,344,190,154,34,31,36,10,0
39324,522,302,220,61,49,75,19,660,332,328,84,73,47,19,0
39325,785,325,460,114,123,61,28,359,171,188,49,74,45,11,0
39326,1276,607,669,192,178,136,63,290,147,143,34,34,39,13,0
39327,311,154,157,47,29,34,13,535,311,224,66,52,49,24,0
39328,282,160,122,36,28,27,7,142,73,69,27,9,15,11,0
39329,728,358,370,118,100,55,29,475,251,224,67,49,48,23,0
39330,246,123,123,40,31,27,7,277,138,139,40,39,20,14,0
39331,1105,544,561,165,167,99,40,763,418,345,113,84,59,32,0
39332,1447,698,749,214,180,116,46,1249,638,611,166,153,141,45,0
39333,904,436,468,138,146,82,39,1166,514,652,150,159,107,70,0
39334,1912,880,1032,331,334,180,84,403,225,178,56,38,33,25,0
39335,237,127,110,34,30,16,9,621,310,311,100,106,77,27,0
39336,457,228,229,64,36,52,21,660,333,327,102,95,69,31,0
39337,312,164,148,54,29,25,15,72,33,39,8,2,3,12,0
39338,300,136,164,45,35,45,14,481,223,258,71,70,49,26,0
39339,240,167,73,32,12,8,21,1182,591,591,155,139,83,46,0
39340,249,114,135,47,33,25,4,455,229,226,66,62,63,29,0
39341,407,164,243,88,42,40,22,403,225,178,56,38,33,25,0
39342,594,321,273,98,59,57,23,331,180,151,46,35,47,17,0
39343,505,247,258,72,71,60,27,600,254,346,104,100,44,17,0
39344,626,300,326,91,82,68,26,374,202,172,50,39,31,24,0
39345,334,155,179,47,34,38,11,201,93,108,34,39,21,6,0
39346,502,250,252,70,47,57,15,218,114,104,32,31,33,11,0
39347,203,97,106,30,22,18,10,262,129,133,40,41,31,10,0
39348,505,226,279,68,51,30,15,535,301,234,63,48,47,27,0
39349,126,56,70,31,10,10,3,136,65,71,26,11,7,5,0
39350,2062,706,1356,414,368,158,63,736,388,348,88,85,67,28,0
39351,650,330,320,97,77,65,28,403,184,219,75,51,47,20,0
39352,149,78,71,20,20,19,5,89,38,51,14,6,3,9,0
39353,895,388,507,130,84,90,31,242,124,118,39,32,28,22,0
39354,598,300,298,68,77,59,21,348,194,154,57,31,43,12,0
39355,379,217,162,47,20,50,23,332,155,177,55,51,44,13,0
39356,479,228,251,71,57,60,14,87,38,49,23,10,10,9,0
39357,852,461,391,109,102,72,24,469,225,244,64,68,25,11,0
39358,425,220,205,60,55,45,18,335,186,149,40,28,29,13,0
39359,983,449,534,95,77,55,36,663,360,303,87,82,80,35,0
39360,803,358,445,135,117,80,43,332,180,152,46,36,28,14,0
39361,867,415,452,123,87,62,27,457,245,212,62,58,57,21,0
39362,320,183,137,51,18,38,8,963,455,508,127,130,115,48,0
39363,545,221,324,101,72,55,30,375,209,166,50,37,29,23,0
39364,339,118,221,77,68,33,13,276,149,127,34,31,32,10,0
39365,862,384,478,127,110,75,42,108,59,49,17,13,12,5,0
39366,580,281,299,95,60,74,29,212,127,85,28,21,26,6,0
39367,169,64,105,23,37,11,3,947,482,465,143,107,89,37,0
39368,3230,1724,1506,361,358,157,75,381,187,194,37,49,36,17,0
39369,282,163,119,40,23,25,17,257,126,131,61,24,22,8,0
39370,435,222,213,67,49,67,12,445,192,253,86,58,53,18,0
39371,213,104,109,56,14,9,2,1922,923,999,267,275,215,90,0
39372,615,308,307,83,75,58,32,457,242,215,39,46,53,10,0
39373,426,214,212,63,47,53,20,89,37,52,13,6,2,9,0
39374,763,371,392,104,88,52,23,137,85,52,15,11,11,2,0
39375,1580,742,838,208,146,144,71,101,59,42,11,17,10,1,0
39376,130,70,60,30,9,8,1,381,196,185,55,57,43,16,0
39377,329,168,161,48,34,41,16,91,44,47,9,12,4,7,0
39378,461,207,254,82,66,55,33,209,119,90,28,24,27,9,0
39379,949,466,483,125,126,101,50,309,159,150,47,43,43,13,0
39380,473,265,208,47,26,50,30,647,350,297,95,79,77,29,0
39381,1098,519,579,182,159,79,42,483,215,268,66,70,30,16,0
39382,1047,443,604,162,156,78,52,501,274,227,63,58,53,20,0
39383,406,208,198,41,26,43,21,1208,565,643,182,162,120,57,0
39384,276,149,127,45,34,39,9,783,406,377,102,91,57,29,0
39385,149,78,71,20,20,19,5,316,166,150,45,38,37,13,0
39386,456,214,242,76,62,52,22,368,204,164,43,35,30,24,0
39387,250,123,127,40,28,29,8,406,234,172,63,35,43,10,0
39388,577,251,326,92,84,60,11,756,348,408,101,103,60,40,0
39389,338,139,199,54,54,18,11,227,130,97,32,25,22,12,0
39390,269,124,145,36,24,32,11,892,475,417,130,108,68,38,0
39391,517,245,272,92,77,46,24,598,333,265,79,66,54,33,0
39392,605,277,328,99,54,63,43,173,94,79,18,24,12,7,0
39393,419,210,209,54,44,31,23,73,35,38,14,10,9,4,0
39394,332,172,160,50,33,35,9,1922,923,999,267,275,215,90,0
39395,505,226,279,68,51,30,15,452,252,200,55,49,61,16,0
39396,165,66,99,28,32,16,3,234,129,105,31,22,19,17,0
39397,126,57,69,31,10,10,3,701,380,321,94,84,96,34,0
39398,319,222,97,36,23,28,8,207,86,121,34,39,11,13,0
39399,464,237,227,64,66,33,12,156,90,66,17,22,11,10,0
39400,280,128,152,39,37,38,18,627,323,304,81,90,53,27,0
39401,454,230,224,63,56,38,33,283,142,141,41,33,26,18,0
39402,665,341,324,109,79,38,22,415,226,189,51,40,40,29,0
39403,543,221,322,78,122,37,12,632,360,272,75,65,36,19,0
39404,1590,726,864,270,237,126,59,547,295,252,81,65,57,23,0
39405,207,89,118,56,8,4,3,535,311,224,66,52,49,24,0
39406,711,330,381,111,86,86,34,514,248,266,86,82,52,22,0
39407,439,205,234,64,88,41,21,384,212,172,44,43,34,14,0
39408,271,110,161,33,27,11,8,710,375,335,95,94,110,28,0
39409,476,199,277,82,80,49,24,584,249,335,80,96,22,13,0
39410,1505,680,825,202,204,73,32,386,207,179,43,48,44,19,0
39411,711,330,381,111,86,86,34,375,209,166,50,37,29,23,0
39412,496,210,286,111,55,74,13,296,151,145,45,42,32,11,0
39413,262,133,129,44,38,31,12,232,111,121,23,29,17,9,0
39414,1336,724,612,209,141,133,60,242,124,118,39,32,28,22,0
39415,500,245,255,66,57,52,27,452,252,200,55,49,61,16,0
39416,504,222,282,71,64,53,29,483,258,225,70,53,54,20,0
39417,204,93,111,35,35,16,11,301,168,133,49,37,34,11,0
39418,1505,680,825,202,204,73,32,415,226,189,51,40,40,29,0
39419,412,208,204,54,47,42,17,323,171,152,48,41,40,16,0
39420,3969,1703,2266,619,432,259,144,341,170,171,41,66,27,10,0
39421,381,146,235,74,48,47,34,496,285,211,62,54,46,22,0
39422,1463,521,942,252,204,105,52,1001,417,584,186,147,96,47,0
39423,673,317,356,101,85,76,49,474,268,206,66,42,45,24,0
39424,325,186,139,49,36,20,5,136,65,71,26,11,7,5,0
39425,273,126,147,54,49,25,18,496,251,245,78,62,61,23,0
39426,335,155,180,64,48,36,10,582,264,318,84,60,58,23,0
39427,444,250,194,58,21,60,23,222,124,98,37,29,22,9,0
39428,376,176,200,31,53,27,8,1154,489,665,200,196,95,54,0
39429,484,264,220,59,62,68,15,225,111,114,32,34,32,16,0
39430,473,265,208,47,26,50,30,346,196,150,43,26,27,14,0
39431,1544,738,806,239,217,145,91,445,264,181,35,35,34,14,0
39432,565,264,301,101,73,72,15,926,340,586,133,119,60,40,0
39433,1912,880,1032,331,334,180,84,166,90,76,27,18,21,5,0
39434,240,99,141,53,38,29,15,963,525,438,119,102,102,34,0
39435,548,310,238,72,62,54,13,375,210,165,49,37,29,27,0
39436,557,211,346,129,125,48,19,892,475,417,130,108,68,38,0
39437,3703,1708,1995,456,428,305,162,457,253,204,67,51,48,13,0
39438,501,230,271,63,90,50,18,633,311,322,94,82,45,20,0
39439,261,148,113,23,29,26,21,866,397,469,117,153,95,48,0
39440,411,236,175,39,45,50,30,471,238,233,66,63,62,19,0
39441,2000,965,1035,357,313,198,75,339,180,159,36,29,16,16,0
39442,1143,574,569,176,151,123,59,368,200,168,54,49,43,9,0
39443,418,188,230,64,49,35,15,1471,709,762,198,184,154,62,0
39444,681,367,314,83,74,78,31,332,180,152,46,36,28,14,0
39445,249,104,145,47,41,24,17,415,189,226,68,54,50,21,0
39446,272,141,131,45,29,36,9,188,101,87,20,18,20,14,0
39447,983,449,534,95,77,55,36,445,202,243,70,73,51,15,0
39448,347,198,149,45,29,29,8,256,141,115,32,22,32,8,0
39449,496,209,287,112,55,71,14,1395,627,768,172,263,141,59,0
39450,1054,497,557,190,168,107,45,153,65,88,28,21,20,8,0
39451,126,56,70,31,10,10,3,376,189,187,47,53,44,26,0
39452,338,173,165,31,42,22,10,478,254,224,67,74,56,28,0
39453,260,138,122,44,30,28,6,127,54,73,11,33,15,6,0
39454,126,58,68,31,10,10,3,445,202,243,70,73,51,15,0
39455,632,360,272,75,65,36,19,219,105,114,36,29,19,8,0
39456,259,119,140,48,28,29,19,452,254,198,72,57,38,18,0
39457,172,82,90,21,35,21,5,671,321,350,95,87,75,34,0
39458,595,208,387,157,60,91,48,1113,480,633,170,173,81,34,0
39459,444,250,194,58,21,60,23,374,191,183,40,52,40,16,0
39460,462,233,229,66,49,43,30,148,69,79,26,18,16,3,0
39461,315,174,141,46,38,47,16,406,223,183,61,53,46,17,0
39462,259,119,140,48,28,29,19,1182,591,591,155,139,83,46,0
39463,595,316,279,86,60,65,40,798,385,413,120,115,79,30,0
39464,648,262,386,113,108,78,29,475,251,224,67,49,48,23,0
39465,167,70,97,32,20,15,7,627,323,304,81,90,53,27,0
39466,908,324,584,181,162,81,29,434,213,221,77,62,53,12,0
39467,729,351,378,111,98,58,18,134,55,79,22,24,16,6,0
39468,215,104,111,61,7,2,1,354,183,171,54,43,49,8,0
39469,373,183,190,49,37,33,18,403,221,182,47,41,47,8,0
39470,727,426,301,79,71,64,32,415,205,210,77,52,55,17,0
39471,470,163,307,99,68,73,30,461,223,238,45,62,18,35,0
39472,157,62,95,41,18,10,11,166,102,64,19,14,17,2,0
39473,410,208,202,59,58,43,26,665,361,304,87,91,84,31,0
39474,86,50,36,9,14,8,7,169,84,85,29,19,21,7,0
39475,305,124,181,27,25,31,21,483,215,268,66,70,30,16,0
39476,439,183,256,60,64,36,14,732,402,330,81,86,87,33,0
39477,766,336,430,133,97,79,21,475,251,224,67,49,48,23,0
39478,395,195,200,41,55,23,10,496,285,211,62,54,46,22,0
39479,1542,682,860,290,158,120,47,218,117,101,35,32,34,12,0
39480,1341,481,860,275,264,57,21,792,398,394,109,96,90,39,0
39481,665,341,324,109,79,38,22,715,348,367,109,84,68,30,0
39482,471,221,250,87,68,42,25,724,353,371,94,95,71,31,0
39483,336,199,137,46,22,51,13,156,90,66,17,22,11,10,0
39484,546,278,268,94,60,32,22,201,99,102,34,26,23,6,0
39485,881,492,389,87,97,59,51,406,202,204,54,51,63,21,0
39486,342,150,192,52,43,31,17,252,130,122,45,23,32,11,0
39487,450,227,223,53,36,48,12,1154,489,665,200,196,95,54,0
39488,281,154,127,45,31,24,9,218,118,100,33,30,25,11,0
39489,1009,487,522,177,121,103,51,295,160,135,44,36,46,16,0
39490,199,107,92,41,15,14,8,153,65,88,28,21,20,8,0
39491,894,448,446,123,100,82,30,663,354,309,91,84,79,31,0
39492,180,92,88,29,20,26,8,341,170,171,41,66,27,10,0
39493,2285,1219,1066,207,180,178,106,119,61,58,17,12,10,6,0
39494,673,317,356,101,85,76,49,457,245,212,62,58,57,21,0
39495,446,265,181,51,35,27,17,425,177,248,60,62,33,16,0
39496,815,356,459,128,125,82,26,207,113,94,33,18,30,9,0
39497,261,130,131,27,41,19,16,398,200,198,68,43,51,14,0
39498,1054,453,601,183,183,107,35,295,160,135,42,37,46,16,0
39499,758,361,397,114,107,51,19,219,105,114,36,29,19,8,0
39500,144,57,87,38,26,10,4,1065,581,484,134,97,76,46,0
39501,392,205,187,83,49,38,10,229,120,109,31,30,22,9,0
39502,772,383,389,105,76,82,33,2517,1275,1242,304,324,245,135,0
39503,314,178,136,42,32,30,17,332,180,152,46,36,28,14,0
39504,117,58,59,17,17,12,2,526,266,260,76,75,53,22,0
39505,130,70,60,30,9,8,1,1114,539,575,145,131,94,56,0
39506,310,141,169,36,38,20,8,1382,508,874,334,320,98,36,0
39507,707,250,457,171,84,117,61,218,118,100,33,30,25,11,0
39508,374,187,187,51,52,40,27,457,245,212,62,58,57,21,0
39509,837,443,394,129,89,87,38,535,311,224,66,52,49,24,0
39510,746,312,434,129,115,77,47,449,252,197,61,52,36,18,0
39511,312,173,139,43,47,28,6,389,210,179,51,37,43,9,0
39512,492,253,239,73,67,77,29,163,79,84,22,24,13,5,0
39513,1124,442,682,148,189,72,43,584,249,335,80,96,22,13,0
39514,822,416,406,111,97,88,42,175,82,93,33,26,17,5,0
39515,233,110,123,34,22,34,9,430,212,218,88,43,40,20,0
39516,172,98,74,20,21,22,8,127,64,63,26,8,12,8,0
39517,421,237,184,47,54,45,10,320,168,152,38,42,24,18,0
39518,570,238,332,112,95,39,23,198,115,83,30,22,8,8,0
39519,241,122,119,27,34,17,16,111,60,51,17,23,10,7,0
39520,595,316,279,86,60,65,40,344,190,154,34,31,36,10,0
39521,588,300,288,100,57,65,27,209,119,90,28,24,27,9,0
39522,393,223,170,44,36,32,14,261,127,134,36,27,36,4,0
39523,421,219,202,68,57,56,13,559,317,242,58,65,37,23,0
39524,565,264,301,101,73,72,15,337,170,167,59,33,47,17,0
39525,752,313,439,121,106,68,27,180,90,90,31,19,20,8,0
39526,125,46,79,24,16,12,2,377,184,193,50,43,33,17,0
39527,107,36,71,27,15,0,1,188,93,95,33,18,16,10,0
39528,246,123,123,40,31,27,7,1114,539,575,145,131,94,56,0
39529,674,318,356,86,139,50,11,279,161,118,37,32,7,7,0
39530,130,70,60,30,9,8,1,441,189,252,73,50,47,23,0
39531,426,231,195,51,52,45,24,201,104,97,36,32,24,7,0
39532,401,183,218,72,73,28,10,54,26,28,11,4,3,3,0
39533,260,120,140,34,39,36,12,1025,549,476,118,109,88,61,0
39534,407,164,243,88,42,40,22,873,411,462,132,107,84,40,0
39535,436,209,227,66,47,52,22,470,205,265,71,80,33,11,0
39536,1912,880,1032,331,334,180,84,775,407,368,122,100,97,32,0
39537,338,164,174,45,32,37,13,673,313,360,102,101,46,17,0
39538,785,351,434,136,93,71,37,169,74,95,33,26,22,3,0
39539,431,202,229,57,50,50,25,405,181,224,71,57,31,12,0
39540,135,64,71,31,11,8,4,329,194,135,45,32,33,9,0
39541,504,222,282,71,64,53,29,367,199,168,62,44,34,8,0
39542,1336,724,612,209,141,133,60,627,323,304,81,90,53,27,0
39543,435,225,210,58,46,50,14,715,345,370,110,97,64,25,0
39544,815,356,459,128,125,82,26,434,213,221,77,62,53,12,0
39545,250,123,127,40,28,29,8,507,270,237,89,59,57,22,0
39546,406,208,198,41,26,43,21,465,252,213,73,58,60,18,0
39547,736,320,416,113,97,61,36,392,214,178,48,40,53,22,0
39548,243,100,143,58,50,24,5,270,162,108,26,26,16,11,0
39549,417,176,241,75,61,51,20,277,163,114,33,24,21,16,0
39550,532,254,278,91,48,23,17,277,138,139,40,39,20,14,0
39551,260,136,124,24,41,19,4,198,113,85,19,20,26,12,0
39552,732,355,377,108,109,79,27,406,234,172,63,35,43,10,0
39553,565,264,301,101,73,72,15,2547,1280,1267,331,335,293,118,0
39554,362,181,181,67,46,43,8,89,37,52,13,6,2,9,0
39555,193,105,88,33,16,9,4,557,281,276,80,59,43,21,0
39556,961,465,496,139,156,62,34,562,273,289,76,92,45,24,0
39557,319,222,97,36,23,28,8,481,223,258,71,70,49,26,0
39558,243,100,143,58,50,24,5,617,314,303,96,68,68,37,0
39559,752,313,439,121,106,68,27,264,138,126,33,34,29,12,0
39560,760,322,438,81,130,57,19,156,90,66,17,22,11,10,0
39561,546,285,261,71,49,47,24,377,184,193,50,43,33,17,0
39562,342,185,157,42,27,31,14,423,234,189,66,44,57,12,0
39563,341,183,158,36,34,36,15,531,277,254,82,75,33,22,0
39564,879,457,422,93,98,143,32,427,251,176,51,39,25,22,0
39565,733,382,351,126,92,93,27,94,45,49,11,20,10,4,0
39566,461,257,204,63,49,50,29,1606,753,853,215,227,182,48,0
39567,315,111,204,82,66,46,11,497,257,240,71,63,62,16,0
39568,270,130,140,43,24,36,10,1262,653,609,169,165,152,50,0
39569,283,112,171,48,39,34,15,810,310,500,164,162,42,26,0
39570,368,201,167,61,38,38,12,234,116,118,34,35,23,9,0
39571,338,139,199,54,54,18,11,943,463,480,91,144,70,30,0
39572,326,154,172,45,39,20,10,497,257,240,71,63,62,16,0
39573,439,205,234,64,88,41,21,375,176,199,48,61,40,12,0
39574,828,355,473,126,134,77,37,548,296,252,71,74,43,28,0
39575,394,207,187,52,42,37,24,325,159,166,59,46,30,12,0
39576,126,56,70,31,10,10,3,403,233,170,38,29,21,14,0
39577,898,397,501,102,98,54,37,732,402,330,81,86,87,33,0
39578,485,237,248,83,35,52,24,415,189,226,68,54,50,21,0
39579,458,226,232,77,59,61,14,148,69,79,26,18,16,3,0
39580,474,243,231,66,54,41,29,497,227,270,70,63,66,30,0
39581,259,151,108,39,18,23,11,305,164,141,43,23,47,18,0
39582,852,461,391,109,102,72,24,485,244,241,80,55,59,20,0
39583,600,324,276,89,73,45,39,732,366,366,108,86,74,41,0
39584,346,168,178,36,43,20,9,293,142,151,49,40,42,17,0
39585,1235,584,651,140,226,82,52,106,46,60,27,18,12,3,0
39586,531,260,271,97,68,47,11,200,99,101,31,24,26,6,0
39587,349,153,196,54,47,28,13,758,319,439,101,123,78,25,0
39588,972,501,471,125,156,106,39,452,254,198,72,57,38,18,0
39589,193,107,86,13,20,13,6,338,169,169,53,44,39,21,0
39590,246,111,135,64,47,27,3,96,45,51,13,12,6,4,0
39591,1186,495,691,182,208,88,32,415,203,212,77,44,49,18,0
39592,326,148,178,55,42,31,12,222,125,97,34,27,27,7,0
39593,356,199,157,36,43,28,12,158,71,87,23,21,17,12,0
39594,238,158,80,28,15,31,7,297,164,133,45,39,40,9,0
39595,520,231,289,89,59,58,26,386,207,179,43,48,44,19,0
39596,234,108,126,42,40,15,9,293,142,151,49,40,42,17,0
39597,1284,511,773,227,166,169,107,1338,720,618,179,145,141,85,0
39598,320,183,137,51,18,38,8,137,85,52,15,11,11,2,0
39599,957,381,576,184,158,86,48,769,329,440,116,66,55,22,0
39600,340,181,159,44,39,35,21,452,231,221,74,53,56,20,0
39601,503,260,243,46,56,33,16,1230,644,586,198,125,123,61,0
39602,567,266,301,139,46,76,37,225,114,111,32,29,26,6,0
39603,583,279,304,99,71,59,31,928,440,488,111,157,82,35,0
39604,349,153,196,54,47,28,13,1314,693,621,174,155,140,58,0
39605,258,144,114,33,22,19,9,483,215,268,66,70,30,16,0
39606,1755,849,906,245,226,148,56,584,249,335,80,96,22,13,0
39607,203,97,106,30,22,18,10,225,114,111,32,29,26,6,0
39608,692,305,387,100,97,78,30,517,295,222,69,62,40,28,0
39609,439,183,256,60,64,36,14,562,273,289,76,92,45,24,0
39610,346,186,160,40,37,34,21,225,114,111,32,29,26,6,0
39611,404,197,207,60,48,47,20,373,181,192,54,35,44,20,0
39612,1124,442,682,148,189,72,43,403,185,218,67,62,63,19,0
39613,257,132,125,39,27,26,10,266,146,120,41,28,31,7,0
39614,1199,589,610,189,128,167,65,405,181,224,71,57,31,12,0
39615,840,411,429,122,101,79,34,497,227,270,70,63,66,30,0
39616,335,183,152,40,26,54,22,906,455,451,116,105,87,46,0
39617,1439,713,726,195,180,110,34,846,425,421,125,97,98,38,0
39618,326,154,172,45,39,20,10,483,258,225,70,53,54,20,0
39619,553,276,277,88,61,45,27,609,335,274,79,57,45,22,0
39620,444,250,194,58,21,60,23,375,176,199,48,61,40,12,0
39621,272,94,178,76,33,19,4,660,332,328,84,73,47,19,0
39622,206,96,110,33,25,8,6,367,218,149,45,43,42,16,0
39623,443,250,193,52,23,49,13,332,173,159,48,40,31,11,0
39624,51,10,41,25,0,5,8,487,252,235,79,58,55,26,0
39625,407,164,243,88,42,40,22,398,200,198,68,43,51,14,0
39626,210,101,109,33,33,19,9,843,391,452,139,104,91,35,0
39627,446,283,163,51,26,33,19,975,400,575,160,162,62,31,0
39628,347,154,193,48,51,25,11,375,209,166,50,37,29,23,0
39629,594,248,346,104,109,53,5,432,244,188,51,51,27,14,0
39630,2488,1085,1403,346,253,162,76,1382,508,874,334,320,98,36,0
39631,389,176,213,81,59,24,7,2542,1245,1297,285,287,170,84,0
39632,160,53,107,31,29,13,3,403,192,211,102,39,49,15,0
39633,156,64,92,31,19,5,4,597,269,328,102,84,69,24,0
39634,1011,559,452,121,97,132,33,89,42,47,16,12,15,6,0
39635,261,137,124,34,23,13,8,715,345,370,110,97,64,25,0
39636,484,261,223,59,48,49,24,483,258,225,70,53,54,20,0
39637,103,56,47,27,7,8,2,258,129,129,45,24,31,10,0
39638,303,147,156,49,49,20,8,818,357,461,122,136,54,25,0
39639,734,339,395,135,89,78,36,475,251,224,67,49,48,23,0
39640,673,317,356,101,85,76,49,252,130,122,45,23,32,11,0
39641,323,156,167,52,45,39,18,963,525,438,119,102,102,34,0
39642,359,167,192,49,37,27,19,766,386,380,101,81,78,31,0
39643,342,150,192,52,43,31,17,385,212,173,57,40,39,21,0
39644,270,147,123,34,17,39,21,660,332,328,84,73,47,19,0
39645,425,198,227,57,69,59,13,395,169,226,73,55,38,9,0
39646,496,272,224,70,58,42,18,406,234,172,63,35,43,10,0
39647,898,397,501,102,98,54,37,107,77,30,7,2,9,5,0
39648,507,314,193,49,45,59,25,218,114,104,32,31,33,11,0
39649,781,316,465,130,129,65,23,145,77,68,26,7,15,8,0
39650,92,46,46,14,9,8,6,173,90,83,21,36,12,15,0
39651,389,176,213,81,59,24,7,156,90,66,17,22,11,10,0
39652,1052,492,560,184,163,103,44,354,188,166,46,40,34,10,0
39653,959,496,463,144,132,75,35,367,218,149,45,43,42,16,0
39654,824,391,433,106,90,88,32,201,98,103,28,25,19,13,0
39655,247,128,119,40,21,27,11,377,171,206,46,59,22,6,0
39656,328,195,133,36,23,35,9,437,221,216,62,64,47,13,0
39657,429,227,202,49,51,46,26,1065,581,484,134,97,76,46,0
39658,98,32,66,15,25,5,4,317,161,156,40,49,41,11,0
39659,320,163,157,44,44,26,15,609,335,274,79,57,45,22,0
39660,533,300,233,74,50,74,17,609,335,274,79,57,45,22,0
39661,314,158,156,39,28,30,17,336,200,136,34,29,25,24,0
39662,504,222,282,71,64,53,29,535,301,234,63,48,47,27,0
39663,119,67,52,15,15,7,7,173,90,83,30,19,19,11,0
39664,1616,735,881,285,248,153,72,297,164,133,45,39,40,9,0
39665,210,84,126,44,43,9,4,192,110,82,33,21,10,3,0
39666,756,265,491,129,127,51,17,201,99,102,34,26,23,6,0
39667,579,246,333,102,79,41,19,179,101,78,25,15,13,13,0
39668,730,298,432,128,69,86,26,274,142,132,33,34,18,14,0
39669,344,168,176,50,39,30,20,302,150,152,56,40,52,15,0
39670,260,136,124,24,41,19,4,1001,417,584,186,147,96,47,0
39671,391,203,188,49,34,36,9,380,178,202,69,53,37,10,0
39672,1336,724,612,209,141,133,60,166,90,76,27,18,21,5,0
39673,412,208,204,54,47,42,17,622,344,278,80,77,68,36,0
39674,126,57,69,31,10,10,3,538,274,264,84,67,52,35,0
39675,1121,458,663,158,210,76,47,296,140,156,49,40,42,19,0
39676,350,178,172,49,62,29,16,445,202,243,70,73,51,15,0
39677,739,389,350,129,61,69,25,385,188,197,57,42,36,16,0
39678,1755,849,906,245,226,148,56,329,196,133,41,36,31,15,0
39679,520,261,259,74,52,49,22,414,203,211,58,56,48,14,0
39680,330,151,179,68,36,56,9,2346,1231,1115,316,292,266,105,0
39681,250,123,127,40,28,29,8,192,110,82,33,21,10,3,0
39682,118,56,62,24,12,6,9,389,207,182,53,58,52,18,0
39683,341,177,164,57,42,40,18,149,77,72,37,10,20,5,0
39684,440,267,173,52,29,42,12,384,204,180,53,47,49,17,0
39685,429,227,202,49,51,46,26,278,154,124,42,32,38,7,0
39686,463,250,213,56,45,73,25,132,77,55,20,9,13,10,0
39687,76,30,46,7,15,1,5,751,394,357,107,96,73,35,0
39688,808,366,442,130,133,66,31,296,159,137,49,28,38,13,0
39689,213,114,99,62,7,2,1,471,238,233,66,63,62,19,0
39690,852,472,380,99,79,70,27,328,195,133,39,40,27,13,0
39691,666,204,462,110,194,42,14,132,77,55,20,9,13,10,0
39692,177,100,77,22,17,20,11,2335,1200,1135,374,268,340,83,0
39693,616,304,312,75,71,55,25,437,224,213,40,29,42,25,0
39694,1498,731,767,220,175,148,68,91,42,49,21,9,8,3,0
39695,410,209,201,72,30,48,22,1378,692,686,194,174,105,56,0
39696,1058,497,561,194,142,87,63,149,77,72,37,10,20,5,0
39697,283,112,171,48,39,34,15,297,164,133,45,39,40,9,0
39698,207,128,79,26,17,19,9,96,45,51,13,12,6,4,0
39699,539,283,256,75,73,53,26,346,196,150,43,26,27,14,0
39700,253,133,120,44,31,22,8,296,151,145,45,42,32,11,0
39701,253,133,120,44,31,22,8,926,425,501,159,147,77,35,0
39702,674,268,406,118,96,70,21,393,210,183,58,37,34,20,0
39703,852,472,380,99,79,70,27,689,343,346,105,102,81,35,0
39704,423,247,176,58,55,29,20,1020,538,482,145,115,111,58,0
39705,887,439,448,137,99,91,38,811,361,450,124,107,80,31,0
39706,193,110,83,18,20,15,12,103,59,44,25,2,13,6,0
39707,128,70,58,29,9,8,1,166,90,76,27,18,21,5,0
39708,526,268,258,54,37,55,12,403,221,182,62,50,42,12,0
39709,553,276,277,88,61,45,27,1507,737,770,188,228,147,71,0
39710,502,274,228,64,49,75,17,1698,875,823,222,219,173,64,0
39711,303,147,156,49,49,20,8,720,361,359,98,98,70,37,0
39712,1004,464,540,143,104,78,55,264,138,126,33,34,29,12,0
39713,271,110,161,33,27,11,8,295,158,137,42,34,38,14,0
39714,375,167,208,55,83,44,9,425,177,248,60,62,33,16,0
39715,395,195,200,41,55,23,10,257,126,131,61,24,22,8,0
39716,898,397,501,102,98,54,37,763,418,345,113,84,59,32,0
39717,1439,713,726,195,180,110,34,213,129,84,32,14,21,15,0
39718,413,169,244,66,94,28,19,715,345,370,110,97,64,25,0
39719,760,322,438,81,130,57,19,492,278,214,65,58,32,11,0
39720,261,137,124,34,23,13,8,180,95,85,22,21,17,8,0
39721,911,489,422,121,98,97,36,295,158,137,42,34,38,14,0
39722,649,304,345,99,80,67,40,756,348,408,101,103,60,40,0
39723,1130,614,516,129,138,98,42,103,59,44,25,2,13,6,0
39724,222,110,112,43,30,14,6,339,180,159,36,29,16,16,0
39725,1867,973,894,256,222,194,65,218,115,103,37,33,33,9,0
39726,167,70,97,32,20,15,7,380,211,169,47,37,33,21,0
39727,119,59,60,29,10,6,4,302,150,152,56,40,52,15,0
39728,282,163,119,40,23,25,17,188,105,83,25,17,24,7,0
39729,270,131,139,47,37,41,11,376,183,193,50,50,43,21,0
39730,639,368,271,72,51,38,38,374,174,200,54,52,42,21,0
39731,251,139,112,41,18,27,11,935,515,420,126,107,73,32,0
39732,136,66,70,33,11,9,5,257,126,131,61,24,22,8,0
39733,322,164,158,46,44,29,7,582,264,318,84,60,58,23,0
39734,584,297,287,89,80,65,17,588,286,302,78,99,53,25,0
39735,320,183,137,51,18,38,8,497,257,240,71,63,62,16,0
39736,336,199,137,46,22,51,13,562,273,289,76,92,45,24,0
39737,249,104,145,47,41,24,17,588,286,302,78,99,53,25,0
39738,552,295,257,67,49,70,30,91,44,47,9,12,4,7,0
39739,415,217,198,50,31,42,17,501,240,261,80,62,49,42,0
39740,410,209,201,72,30,48,22,317,161,156,50,36,47,12,0
39741,215,104,111,61,7,2,1,295,156,139,41,40,42,15,0
39742,462,228,234,59,47,37,32,68,23,45,12,9,3,9,0
39743,376,171,205,45,45,34,12,220,107,113,36,35,28,9,0
39744,786,378,408,106,98,77,39,72,32,40,8,2,1,14,0
39745,507,314,193,49,45,59,25,649,307,342,71,134,45,17,0
39746,360,205,155,35,24,52,14,601,279,322,81,65,27,12,0
39747,540,252,288,73,67,57,20,166,90,76,27,18,21,5,0
39748,350,178,172,49,62,29,16,348,194,154,57,31,43,12,0
39749,682,260,422,153,78,109,46,348,212,136,53,31,25,18,0
39750,243,100,143,58,50,24,5,127,64,63,26,8,12,8,0
39751,472,222,250,46,61,33,23,198,113,85,19,20,26,12,0
39752,308,129,179,44,60,19,8,289,140,149,33,42,30,15,0
39753,492,242,250,52,78,28,19,1425,670,755,153,189,122,85,0
39754,215,117,98,28,19,15,8,334,182,152,45,41,27,13,0
39755,372,171,201,47,53,39,18,189,95,94,25,33,16,8,0
39756,261,126,135,41,36,24,11,160,76,84,19,24,8,5,0
39757,291,142,149,50,29,35,7,222,124,98,37,29,22,9,0
39758,658,349,309,77,70,73,35,729,358,371,116,99,89,33,0
39759,280,156,124,36,19,20,13,72,32,40,8,2,1,14,0
39760,371,209,162,46,17,36,19,749,384,365,108,105,86,31,0
39761,207,89,118,56,8,4,3,127,54,73,11,33,15,6,0
39762,416,207,209,63,47,56,15,88,50,38,13,8,16,4,0
39763,156,64,92,31,19,5,4,180,90,90,31,19,20,8,0
39764,708,344,364,106,98,66,33,204,80,124,29,51,10,5,0
39765,292,102,190,71,27,51,21,963,525,438,119,102,102,34,0
39766,406,208,198,41,26,43,21,132,77,55,20,9,13,10,0
39767,538,263,275,71,85,44,18,406,202,204,54,51,63,21,0
39768,532,291,241,83,36,79,25,763,418,345,113,84,59,32,0
39769,626,308,318,105,89,77,25,373,213,160,44,33,26,17,0
39770,451,225,226,69,57,64,22,178,69,109,29,25,21,13,0
39771,524,262,262,62,72,39,49,189,105,84,25,26,21,9,0
39772,427,191,236,67,60,41,34,89,37,52,13,6,2,9,0
39773,1107,601,506,155,138,103,49,963,525,438,119,102,102,34,0
39774,224,101,123,45,32,21,3,307,132,175,48,53,26,10,0
39775,1161,514,647,159,138,122,37,2382,1162,1220,237,220,140,49,0
39776,746,312,434,129,115,77,47,375,209,166,50,37,29,23,0
39777,743,377,366,87,74,68,30,690,345,345,96,83,73,42,0
39778,1759,838,921,269,212,191,92,1065,581,484,134,97,76,46,0
39779,346,168,178,36,43,20,9,164,79,85,28,28,16,7,0
39780,297,161,136,36,35,24,9,846,425,421,125,97,98,38,0
39781,760,405,355,112,95,92,29,188,93,95,33,18,16,10,0
39782,468,233,235,65,61,49,34,312,165,147,41,39,29,16,0
39783,413,206,207,38,55,19,10,598,333,265,79,66,54,33,0
39784,1556,718,838,280,182,161,49,103,50,53,19,10,7,5,0
39785,3703,1708,1995,456,428,305,162,467,231,236,71,65,58,18,0
39786,546,285,261,71,49,47,24,392,155,237,68,61,34,16,0
39787,510,269,241,66,67,71,26,452,254,198,72,57,38,18,0
39788,325,181,144,46,31,48,9,419,233,186,54,53,55,17,0
39789,130,71,59,30,9,8,1,163,79,84,22,24,13,5,0
39790,565,264,301,101,73,72,15,189,95,94,25,33,16,8,0
39791,416,222,194,58,38,38,20,2547,1280,1267,331,335,293,118,0
39792,306,172,134,35,31,37,18,434,213,221,77,62,53,12,0
39793,682,260,422,98,83,42,31,693,360,333,100,88,62,26,0
39794,1544,738,806,239,217,145,91,239,113,126,36,49,20,8,0
39795,200,94,106,33,22,18,8,258,129,129,45,24,31,10,0
39796,452,202,250,83,60,56,19,1040,564,476,134,110,114,51,0
39797,428,248,180,44,39,28,9,572,305,267,74,72,58,21,0
39798,322,164,158,46,44,29,7,332,155,177,55,51,44,13,0
39799,376,171,205,45,45,34,12,169,84,85,29,19,21,7,0
39800,840,411,429,122,101,79,34,1507,737,770,188,228,147,71,0
39801,704,342,362,113,91,85,33,222,124,98,37,29,22,9,0
39802,221,75,146,68,21,16,5,671,321,350,95,87,75,34,0
39803,479,228,251,71,57,60,14,562,273,289,76,92,45,24,0
39804,512,254,258,70,48,37,32,295,160,135,42,37,46,16,0
39805,435,225,210,58,46,50,14,252,130,122,45,23,32,11,0
39806,745,402,343,95,71,69,40,547,295,252,81,65,57,23,0
39807,188,84,104,35,36,18,9,89,51,38,15,15,5,4,0
39808,126,57,69,31,10,10,3,367,218,149,45,43,42,16,0
39809,772,332,440,136,104,72,28,296,151,145,45,42,32,11,0
39810,193,105,88,33,16,9,4,1208,565,643,182,162,120,57,0
39811,164,61,103,47,19,14,5,471,238,233,66,63,62,19,0
39812,206,96,110,33,25,8,6,483,215,268,66,70,30,16,0
39813,426,213,213,60,56,46,24,137,85,52,15,11,11,2,0
39814,412,193,219,69,57,43,14,811,361,450,124,107,80,31,0
39815,1023,449,574,141,174,76,43,741,383,358,92,63,79,36,0
39816,346,173,173,50,56,31,14,218,115,103,37,33,33,9,0
39817,126,58,68,31,10,10,3,810,310,500,164,162,42,26,0
39818,595,208,387,157,60,91,48,449,252,197,61,52,36,18,0
39819,1439,713,726,195,180,110,34,1113,480,633,170,173,81,34,0
39820,746,312,434,129,115,77,47,903,436,467,128,116,83,33,0
39821,358,212,146,51,36,33,9,198,115,83,30,22,8,8,0
39822,149,78,71,20,20,19,5,410,197,213,67,43,56,18,0
39823,2799,1324,1475,369,371,215,124,339,175,164,51,49,37,9,0
39824,480,257,223,74,26,60,27,418,223,195,53,43,49,15,0
39825,279,129,150,43,34,17,13,2382,1162,1220,237,220,140,49,0
39826,860,348,512,121,136,75,35,526,266,260,76,75,53,22,0
39827,650,330,320,97,77,65,28,368,183,185,40,42,40,15,0
39828,161,75,86,24,20,10,7,204,80,124,29,51,10,5,0
39829,502,274,228,64,49,75,17,199,92,107,34,30,18,9,0
39830,258,126,132,38,22,29,8,339,180,159,36,29,16,16,0
39831,631,304,327,98,75,52,23,701,380,321,94,84,96,34,0
39832,425,198,227,57,69,59,13,198,113,85,19,20,26,12,0
39833,2136,1063,1073,317,308,223,90,205,94,111,48,31,15,6,0
39834,270,131,139,47,37,41,11,108,59,49,17,13,12,5,0
39835,315,174,141,46,38,47,16,190,93,97,35,27,23,2,0
39836,519,259,260,86,78,59,22,723,363,360,107,106,52,14,0
39837,869,489,380,110,77,79,29,389,210,179,51,37,43,9,0
39838,554,217,337,112,72,90,38,375,209,166,50,37,29,23,0
39839,3969,1703,2266,619,432,259,144,328,199,129,39,29,27,14,0
39840,760,405,355,112,95,92,29,166,78,88,27,25,19,7,0
39841,471,221,250,87,68,42,25,445,202,243,70,73,51,15,0
39842,854,435,419,118,91,95,42,277,145,132,41,32,22,10,0
39843,320,163,157,44,44,26,15,244,143,101,31,29,26,8,0
39844,528,273,255,67,53,29,20,492,278,214,65,58,32,11,0
39845,979,534,445,83,77,80,24,335,186,149,40,28,29,13,0
39846,688,310,378,130,82,78,47,180,95,85,22,21,17,8,0
39847,346,174,172,36,43,21,9,418,246,172,52,39,57,10,0
39848,3859,2011,1848,535,391,422,207,106,41,65,36,6,11,7,0
39849,607,305,302,92,89,74,23,250,119,131,58,26,29,7,0
39850,334,155,179,47,34,38,11,445,202,243,70,73,51,15,0
39851,346,205,141,47,34,30,7,169,74,95,33,26,22,3,0
39852,417,176,241,75,61,51,20,1543,794,749,182,152,132,55,0
39853,332,170,162,44,38,39,10,422,237,185,53,47,62,20,0
39854,350,190,160,48,25,27,18,609,335,274,79,57,45,22,0
39855,344,168,176,50,39,30,20,467,240,227,65,65,51,23,0
39856,281,125,156,44,47,17,7,367,218,149,45,43,42,16,0
39857,385,179,206,58,56,38,19,314,151,163,42,61,39,16,0
39858,673,317,356,101,85,76,49,325,172,153,44,34,27,14,0
39859,192,91,101,28,21,18,8,1395,627,768,172,263,141,59,0
39860,466,259,207,59,50,83,12,262,129,133,40,41,31,10,0
39861,772,417,355,118,92,80,23,213,129,84,32,14,21,15,0
39862,1009,487,522,177,121,103,51,289,140,149,33,42,30,15,0
39863,1214,612,602,169,173,98,35,1279,669,610,164,162,104,55,0
39864,365,148,217,86,37,51,28,338,169,169,53,44,39,21,0
39865,313,178,135,43,18,35,6,72,33,39,8,2,3,12,0
39866,478,220,258,47,70,41,10,671,306,365,114,76,49,19,0
39867,258,144,114,33,22,19,9,524,300,223,70,54,51,25,0
39868,520,240,280,87,63,67,16,974,457,517,133,117,69,26,0
39869,426,214,212,63,47,53,20,290,142,148,41,37,43,11,0
39870,126,66,60,24,10,7,9,290,142,148,41,37,43,11,0
39871,193,105,88,33,16,9,4,395,198,197,55,55,36,10,0
39872,527,254,273,67,66,70,31,127,54,73,11,33,15,6,0
39873,334,155,179,47,34,38,11,172,79,93,34,27,23,10,0
39874,346,168,178,36,43,20,9,73,35,38,14,10,9,4,0
39875,2525,1232,1293,398,317,186,61,818,357,461,122,136,54,25,0
39876,861,393,468,150,101,69,35,132,61,71,22,21,15,3,0
39877,728,358,370,118,100,55,29,103,44,59,16,17,9,5,0
39878,164,61,103,47,19,14,5,348,212,136,53,31,25,18,0
39879,258,144,114,33,22,19,9,86,40,46,16,13,9,7,0
39880,413,169,244,66,94,28,19,392,214,178,48,40,53,22,0
39881,82,36,46,17,10,5,1,588,286,302,78,99,53,25,0
39882,282,105,177,77,28,39,6,106,46,60,29,13,14,5,0
39883,416,207,209,63,47,56,15,250,116,134,41,30,33,19,0
39884,808,366,442,130,133,66,31,661,325,336,81,75,65,28,0
39885,359,167,192,49,37,27,19,132,67,65,24,21,8,10,0
39886,785,351,434,136,93,71,37,279,142,137,43,39,28,7,0
39887,260,136,124,24,41,19,4,622,344,278,80,77,68,36,0
39888,1531,649,882,108,122,93,72,519,287,232,68,58,45,21,0
39889,1970,978,992,245,206,198,80,467,240,227,65,65,51,23,0
39890,574,269,305,91,63,54,27,926,425,501,159,147,77,35,0
39891,574,347,227,61,55,46,34,622,315,307,106,95,50,34,0
39892,301,119,182,53,47,14,20,290,142,148,41,37,43,11,0
39893,500,245,255,66,57,52,27,665,361,304,87,91,84,31,0
39894,270,166,104,30,26,28,14,455,191,264,68,86,21,19,0
39895,465,305,160,40,47,34,9,301,168,133,49,37,34,11,0
39896,587,300,287,67,102,34,20,3224,1440,1784,455,440,333,126,0
39897,126,58,68,31,10,10,3,239,113,126,36,49,20,8,0
39898,557,250,307,70,47,51,22,260,133,127,43,32,39,3,0
39899,319,222,97,36,23,28,8,1507,737,770,188,228,147,71,0
39900,279,127,152,50,36,28,8,963,525,438,119,102,102,34,0
39901,782,372,410,127,111,89,36,405,214,191,53,42,49,20,0
39902,479,227,252,69,48,46,18,633,311,322,94,82,45,20,0
39903,886,440,446,116,140,95,45,1279,669,610,164,162,104,55,0
39904,625,283,342,93,89,67,25,480,255,225,67,64,50,22,0
39905,261,148,113,23,29,26,21,258,129,129,45,24,31,10,0
39906,466,199,267,86,59,32,17,277,152,125,31,35,22,19,0
39907,329,165,164,61,44,29,17,278,154,124,42,32,38,7,0
39908,1249,543,706,187,164,125,52,251,143,108,47,25,29,11,0
39909,593,282,311,75,70,29,25,106,46,60,27,18,12,3,0
39910,480,257,223,74,26,60,27,128,63,65,30,11,13,8,0
39911,264,122,142,46,24,35,10,592,249,343,91,90,50,42,0
39912,335,183,152,40,26,54,22,737,397,340,87,104,90,14,0
39913,395,189,206,63,50,49,28,106,46,60,27,18,12,3,0
39914,319,153,166,61,52,26,12,935,515,420,126,107,73,32,0
39915,658,349,309,77,70,73,35,288,156,132,36,36,24,15,0
39916,411,171,240,61,81,30,15,88,50,38,13,8,16,4,0
39917,520,231,289,89,59,58,26,104,46,58,15,17,9,5,0
39918,674,268,406,118,96,70,21,1241,619,622,183,169,155,59,0
39919,915,336,579,185,199,56,29,673,313,360,102,101,46,17,0
39920,401,204,197,49,33,29,17,192,110,82,33,21,10,3,0
39921,130,71,59,30,9,8,1,508,261,247,65,53,58,23,0
39922,210,101,109,33,33,19,9,545,269,276,80,76,27,32,0
39923,519,245,274,58,61,34,22,169,84,85,29,19,21,7,0
39924,330,151,179,68,36,56,9,198,113,85,19,20,26,12,0
39925,344,109,235,100,39,26,5,452,252,200,55,49,61,16,0
39926,959,496,463,144,132,75,35,199,105,94,27,27,28,9,0
39927,443,226,217,67,34,53,10,727,388,339,102,87,70,29,0
39928,1130,614,516,129,138,98,42,528,276,252,86,78,49,17,0
39929,399,220,179,48,37,68,18,368,200,168,54,49,43,9,0
39930,180,57,123,39,22,10,8,91,44,47,9,12,4,7,0
39931,260,136,124,24,41,19,4,252,130,122,45,23,32,11,0
39932,462,233,229,66,49,43,30,246,125,121,38,36,30,11,0
39933,412,146,266,106,38,67,35,514,248,266,86,82,52,22,0
39934,299,151,148,35,34,26,16,360,185,175,51,43,36,16,0
39935,466,259,207,59,50,83,12,289,140,149,33,42,30,15,0
39936,349,167,182,54,38,30,28,400,187,213,56,59,42,20,0
39937,417,176,241,75,61,51,20,518,292,226,60,60,52,21,0
39938,236,141,95,36,32,14,6,341,170,171,41,66,27,10,0
39939,226,115,111,38,16,26,6,770,390,380,104,76,78,32,0
39940,684,353,331,95,98,77,38,317,161,156,40,49,41,11,0
39941,86,50,36,9,14,8,7,337,170,167,59,33,47,17,0
39942,202,103,99,28,20,12,8,437,224,213,40,29,42,25,0
39943,563,255,308,91,111,42,30,699,334,365,108,80,70,20,0
39944,338,208,130,39,30,35,12,1101,626,475,145,122,120,50,0
39945,435,230,205,51,37,55,18,87,38,49,23,10,10,9,0
39946,308,129,179,44,60,19,8,660,333,327,102,95,69,31,0
39947,521,249,272,53,36,50,18,736,388,348,88,85,67,28,0
39948,886,440,446,116,140,95,45,130,67,63,24,10,12,4,0
39949,341,177,164,57,42,40,18,180,89,91,28,27,18,7,0
39950,2136,1063,1073,317,308,223,90,198,110,88,27,27,24,4,0
39951,2109,999,1110,332,294,187,89,332,173,159,48,40,31,11,0
39952,1068,434,634,173,160,61,29,413,223,190,52,45,53,10,0
39953,550,304,246,60,64,77,16,107,77,30,7,2,9,5,0
39954,276,149,127,45,34,39,9,515,276,239,62,59,43,31,0
39955,130,72,58,28,9,7,1,873,411,462,132,107,84,40,0
39956,619,289,330,67,77,36,19,257,139,118,64,17,24,7,0
39957,1217,647,570,142,160,129,45,187,89,98,36,24,20,6,0
39958,213,88,125,21,54,14,15,756,348,408,101,103,60,40,0
39959,136,66,70,33,11,9,4,323,171,152,48,41,40,16,0
39960,640,279,361,102,83,69,21,404,190,214,55,55,35,27,0
39961,485,183,302,79,81,73,33,306,157,149,52,35,39,16,0
39962,414,195,219,51,60,40,17,395,198,197,55,55,36,10,0
39963,127,62,65,13,33,7,6,169,85,84,21,14,9,9,0
39964,275,125,150,37,48,27,7,517,295,222,69,62,40,28,0
39965,629,374,255,74,53,87,27,415,189,226,68,54,50,21,0
39966,1462,711,751,219,222,148,65,279,142,137,43,39,28,7,0
39967,346,174,172,36,43,21,9,127,64,63,26,8,12,8,0
39968,532,291,241,83,36,79,25,482,232,250,77,81,44,13,0
39969,333,171,162,41,44,48,23,201,104,97,36,32,24,7,0
39970,270,147,123,34,17,39,21,337,152,185,49,54,42,21,0
39971,164,81,83,37,8,14,10,390,223,167,58,36,45,18,0
39972,836,370,466,126,96,72,30,663,360,303,87,82,80,35,0
39973,856,429,427,113,105,96,24,402,186,216,64,47,38,20,0
39974,301,119,182,53,47,14,20,302,150,152,56,40,52,15,0
39975,577,251,326,92,84,60,11,748,359,389,125,113,86,31,0
39976,130,71,59,30,9,8,2,127,58,69,18,17,10,5,0
39977,527,254,273,67,66,70,31,127,58,69,18,17,10,5,0
39978,333,171,162,41,44,48,23,194,109,85,23,24,21,9,0
39979,227,109,118,42,35,29,8,441,189,252,73,50,47,23,0
39980,372,171,201,47,53,39,18,297,175,122,46,30,31,6,0
39981,222,110,112,43,30,14,6,203,98,105,34,29,19,10,0
39982,178,89,89,40,12,18,7,203,98,105,34,29,19,10,0
39983,262,133,129,44,38,31,12,331,180,151,46,35,47,17,0
39984,426,214,212,63,47,53,20,344,190,154,34,31,36,10,0
39985,598,322,276,67,57,63,26,326,149,177,51,51,28,10,0
39986,240,166,74,32,12,8,15,1249,638,611,166,153,141,45,0
39987,507,314,193,49,45,59,25,418,246,172,52,39,57,10,0
39988,1390,585,805,241,230,118,46,277,163,114,33,24,21,16,0
39989,291,131,160,49,35,32,15,509,267,242,79,81,38,20,0
39990,420,189,231,79,67,33,17,187,89,98,36,24,20,6,0
39991,138,35,103,38,2,15,9,2517,1275,1242,304,324,245,135,0
39992,524,262,262,62,72,39,49,346,178,168,58,41,33,12,0
39993,475,208,267,84,67,50,20,196,105,91,40,13,19,10,0
39994,682,260,422,98,83,42,31,374,181,193,55,58,48,23,0
39995,193,95,98,33,17,25,17,528,276,252,86,78,49,17,0
39996,228,82,146,45,37,18,8,207,113,94,33,18,30,9,0
39997,972,501,471,125,156,106,39,892,475,417,130,108,68,38,0
39998,1221,597,624,201,152,83,31,715,345,370,110,97,64,25,0
39999,636,288,348,94,77,65,30,662,312,350,103,104,59,20,0
40000,135,64,71,31,11,8,4,341,170,171,41,66,27,10,0
40001,282,163,119,40,23,25,17,455,191,264,68,86,21,19,0
40002,919,444,475,141,148,62,20,295,160,135,44,36,46,16,0
40003,109,50,59,12,12,9,3,611,314,297,79,75,78,22,0
40004,319,222,97,36,23,28,8,496,251,245,78,62,61,23,0
40005,3703,1708,1995,456,428,305,162,334,181,153,41,40,25,15,0
40006,1542,682,860,290,158,120,47,601,279,322,81,65,27,12,0
40007,727,426,301,79,71,64,32,332,180,152,46,36,28,14,0
40008,781,316,465,130,129,65,23,212,127,85,28,21,26,6,0
40009,466,259,207,59,50,83,12,530,287,243,79,70,33,26,0
40010,2442,1193,1249,278,183,170,145,305,163,142,38,27,47,11,0
40011,288,140,148,59,33,27,12,387,193,194,60,53,57,15,0
40012,333,171,162,41,44,48,23,288,156,132,36,36,24,15,0
40013,840,411,429,122,101,79,34,72,34,38,8,2,3,12,0
40014,226,120,106,68,8,2,1,508,253,255,73,60,50,13,0
40015,432,190,242,85,82,28,11,405,195,210,57,74,24,17,0
40016,625,283,342,93,89,67,25,266,150,116,28,28,24,12,0
40017,435,230,205,51,37,55,18,339,180,159,36,29,16,16,0
40018,941,459,482,167,140,82,38,665,361,304,87,91,84,31,0
40019,598,300,298,68,77,59,21,2202,1121,1081,338,274,269,81,0
40020,312,164,148,54,29,25,15,241,127,114,34,33,29,12,0
40021,119,59,60,29,10,6,4,336,200,136,34,29,25,24,0
40022,261,148,113,23,29,26,21,723,353,370,120,109,96,33,0
40023,199,107,92,41,15,14,8,862,409,453,149,125,86,29,0
40024,315,111,204,82,66,46,11,349,200,149,41,39,30,20,0
40025,200,94,106,33,22,18,8,900,441,459,125,127,110,32,0
40026,210,84,126,44,43,9,4,103,44,59,16,17,9,5,0
40027,933,456,477,123,108,83,29,72,32,40,8,2,2,13,0
40028,556,306,250,69,60,80,18,266,146,120,41,28,31,7,0
40029,1709,650,1059,338,286,185,46,1214,475,739,177,250,89,49,0
40030,833,295,538,146,139,65,34,234,116,118,34,35,23,9,0
40031,473,212,261,72,64,45,28,928,440,488,111,157,82,35,0
40032,308,129,179,44,60,19,8,138,69,69,28,7,10,10,0
40033,763,371,392,104,88,52,23,1755,905,850,214,196,183,79,0
40034,431,199,232,59,54,40,17,508,262,246,66,67,51,20,0
40035,1439,713,726,195,180,110,34,88,50,38,13,8,16,4,0
40036,391,203,188,49,34,36,9,127,64,63,26,8,12,8,0
40037,398,186,212,76,70,18,13,137,63,74,20,22,14,6,0
40038,664,269,395,117,107,36,15,557,281,276,80,59,43,21,0
40039,271,136,135,37,30,18,10,385,188,197,57,42,36,16,0
40040,636,288,348,94,77,65,30,671,306,365,114,76,49,19,0
40041,373,194,179,42,54,26,13,287,151,136,51,42,36,7,0
40042,83,45,38,11,8,8,3,862,409,453,149,125,86,29,0
40043,426,213,213,60,56,46,24,218,115,103,32,32,34,11,0
40044,828,368,460,118,98,59,38,303,137,166,54,54,31,15,0
40045,240,167,73,32,12,8,21,947,482,465,143,107,89,37,0
40046,1041,497,544,180,167,98,34,376,189,187,47,53,44,26,0
40047,531,260,271,97,68,47,11,132,77,55,20,9,13,10,0
40048,707,250,457,171,84,117,61,469,225,244,64,68,25,11,0
40049,559,217,342,105,86,42,16,277,145,132,41,32,22,10,0
40050,471,221,250,87,68,42,25,508,262,246,66,67,51,20,0
40051,338,164,174,45,32,37,13,290,147,143,34,34,39,13,0
40052,111,29,82,10,54,0,1,531,277,254,82,75,33,22,0
40053,134,60,74,19,13,10,7,264,138,126,33,34,29,12,0
40054,873,366,507,127,125,75,21,424,179,245,65,67,29,11,0
40055,443,206,237,76,68,52,28,250,119,131,58,26,29,7,0
40056,228,82,146,45,37,18,8,689,343,346,105,102,81,35,0
40057,221,80,141,48,37,14,10,2038,1059,979,262,237,208,100,0
40058,852,472,380,99,79,70,27,178,69,109,29,25,21,13,0
40059,233,107,126,40,40,20,16,352,207,145,40,33,25,21,0
40060,330,77,253,86,52,20,12,462,251,211,74,53,41,18,0
40061,350,190,160,48,25,27,18,404,190,214,55,55,35,27,0
40062,828,355,473,126,134,77,37,664,350,314,86,90,82,36,0
40063,431,199,232,59,54,40,17,152,71,81,41,16,14,2,0
40064,483,236,247,82,60,43,18,415,226,189,51,40,40,29,0
40065,276,149,127,45,34,39,9,662,312,350,103,104,59,20,0
40066,392,221,171,53,30,25,8,516,245,271,82,84,70,26,0
40067,1120,436,684,208,120,101,115,134,72,62,14,28,8,4,0
40068,793,355,438,134,117,77,43,132,61,71,19,20,14,6,0
40069,496,209,287,113,55,72,14,843,391,452,139,104,91,35,0
40070,290,156,134,44,29,39,9,295,160,135,42,37,46,16,0
40071,332,170,162,44,38,39,10,282,134,148,38,45,29,10,0
40072,766,336,430,133,97,79,21,381,196,185,55,57,43,16,0
40073,3859,2011,1848,535,391,422,207,406,202,204,54,51,63,21,0
40074,745,402,343,95,71,69,40,164,79,85,28,28,16,7,0
40075,207,89,118,56,8,4,3,132,61,71,22,21,15,3,0
40076,654,344,310,80,69,57,15,1323,690,633,132,178,112,61,0
40077,493,281,212,56,61,30,13,137,63,74,20,22,14,6,0
40078,619,289,330,67,77,36,19,519,287,232,68,58,45,21,0
40079,626,300,326,91,82,68,26,422,237,185,53,47,62,20,0
40080,270,166,104,30,26,28,14,561,279,282,85,81,88,24,0
40081,132,66,66,21,18,11,7,1321,653,668,186,195,70,35,0
40082,410,211,199,55,42,34,27,199,92,107,34,30,18,9,0
40083,1327,520,807,241,174,141,60,322,180,142,45,38,28,7,0
40084,410,209,201,72,30,48,22,1543,794,749,182,152,132,55,0
40085,425,220,205,60,55,45,18,198,115,83,30,22,8,8,0
40086,410,188,222,53,52,31,14,483,258,225,70,53,54,20,0
40087,179,78,101,29,22,10,8,929,459,470,140,120,94,45,0
40088,155,85,70,17,16,4,8,270,130,140,48,44,37,12,0
40089,372,189,183,60,44,41,18,198,113,85,19,20,26,12,0
40090,419,210,209,54,44,31,23,396,213,183,68,44,47,18,0
40091,462,228,234,59,47,37,32,344,190,154,34,31,36,10,0
40092,282,163,119,40,23,25,17,171,94,77,24,28,30,11,0
40093,1499,864,635,141,99,76,110,222,125,97,34,27,27,7,0
40094,546,265,281,101,64,38,16,647,350,297,95,79,77,29,0
40095,257,122,135,44,19,21,16,396,199,197,54,50,45,14,0
40096,350,172,178,61,45,32,13,101,59,42,11,17,10,1,0
40097,358,206,152,45,38,67,16,266,150,116,28,28,24,12,0
40098,565,264,301,101,73,72,15,101,59,42,11,17,10,1,0
40099,484,192,292,118,68,83,22,225,129,96,32,33,20,8,0
40100,414,195,219,51,60,40,17,1698,875,823,222,219,173,64,0
40101,457,261,196,55,27,57,34,858,398,460,126,138,75,39,0
40102,169,64,105,23,37,11,3,766,386,380,101,81,78,31,0
40103,312,164,148,54,29,25,15,465,252,213,73,58,60,18,0
40104,453,240,213,53,33,44,16,647,324,323,101,80,76,43,0
40105,1043,479,564,200,131,123,62,430,212,218,88,43,40,20,0
40106,489,253,236,73,36,62,17,220,107,113,36,35,28,9,0
40107,784,351,433,118,87,73,41,261,127,134,36,27,36,4,0
40108,680,308,372,82,72,71,40,295,160,135,44,36,46,16,0
40109,410,209,201,72,30,48,22,335,186,149,40,28,29,13,0
40110,395,219,176,47,41,50,18,149,52,97,36,36,7,4,0
40111,240,98,142,49,42,23,17,218,115,103,32,32,34,11,0
40112,545,221,324,101,72,55,30,96,45,51,13,12,6,4,0
40113,734,366,368,121,99,63,39,103,44,59,16,17,9,5,0
40114,574,269,305,91,63,54,27,483,215,268,66,70,30,16,0
40115,290,156,134,44,29,39,9,1395,627,768,172,263,141,59,0
40116,482,231,251,76,81,64,26,166,102,64,19,14,17,2,0
40117,960,409,551,166,134,77,44,415,226,189,51,40,40,29,0
40118,136,66,70,33,11,9,3,1425,670,755,153,189,122,85,0
40119,378,202,176,34,32,44,13,485,244,241,80,55,59,20,0
40120,466,259,207,59,50,83,12,564,264,300,79,84,65,26,0
40121,879,457,422,93,98,143,32,218,118,100,33,30,25,11,0
40122,232,134,98,28,20,20,5,86,40,46,16,13,9,7,0
40123,484,192,292,118,68,83,22,309,164,145,35,47,30,11,0
40124,215,80,135,54,56,21,9,292,155,137,50,34,29,13,0
40125,160,53,107,31,29,13,3,593,289,304,85,69,48,19,0
40126,446,265,181,51,35,27,17,463,259,204,62,55,34,22,0
40127,764,277,487,158,162,64,31,370,173,197,65,57,42,10,0
40128,1339,494,845,216,298,92,37,953,489,464,126,104,111,44,0
40129,336,134,202,51,64,27,12,414,203,211,58,56,48,14,0
40130,262,133,129,44,38,31,12,947,482,465,143,107,89,37,0
40131,257,148,109,28,20,21,14,462,251,211,74,53,41,18,0
40132,469,253,216,49,51,48,18,335,186,149,40,28,29,13,0
40133,139,64,75,18,17,18,4,338,169,169,53,44,39,21,0
40134,496,210,286,112,55,72,13,335,170,165,52,36,47,11,0
40135,674,318,356,86,139,50,11,323,171,152,48,41,40,16,0
40136,349,167,182,54,38,30,28,205,94,111,48,31,15,6,0
40137,336,134,202,51,64,27,12,130,67,63,24,10,12,4,0
40138,431,199,232,59,54,40,17,166,88,78,23,18,13,7,0
40139,2062,706,1356,414,368,158,63,1034,495,539,150,134,114,71,0
40140,323,156,167,52,45,39,18,266,150,116,28,28,24,12,0
40141,399,196,203,62,45,38,19,479,215,264,67,80,46,28,0
40142,313,134,179,58,37,43,19,515,276,239,62,59,43,31,0
40143,462,233,229,66,49,43,30,737,320,417,112,94,73,34,0
40144,257,148,109,28,20,21,14,295,160,135,44,36,46,16,0
40145,364,168,196,64,61,27,6,693,360,333,100,88,62,26,0
40146,665,341,324,109,79,38,22,483,287,196,71,50,54,17,0
40147,351,166,185,48,61,24,15,308,129,179,44,60,19,8,0
40148,267,146,121,40,24,25,7,187,89,98,36,24,20,6,0
40149,335,183,152,40,26,54,22,160,60,100,23,40,19,11,0
40150,1226,513,713,184,147,87,43,367,218,149,45,43,42,16,0
40151,681,367,314,83,74,78,31,336,200,136,34,29,25,24,0
40152,132,66,66,21,18,11,7,270,130,140,48,44,37,12,0
40153,200,94,106,33,22,18,8,1020,538,482,145,115,111,58,0
40154,217,109,108,30,23,28,10,627,289,338,101,73,62,43,0
40155,346,174,172,36,43,21,9,972,471,501,152,138,112,40,0
40156,181,75,106,35,26,11,9,450,241,209,67,58,54,23,0
40157,932,575,357,94,69,76,40,138,69,69,28,7,10,10,0
40158,2649,1431,1218,377,299,266,102,403,233,170,38,29,21,14,0
40159,977,462,515,185,119,76,12,406,202,204,54,51,63,21,0
40160,412,146,266,106,38,67,35,319,185,134,42,31,22,13,0
40161,412,193,219,69,57,43,14,978,536,442,132,107,67,32,0
40162,67,40,27,10,8,7,6,287,151,136,51,42,36,7,0
40163,478,177,301,109,66,59,25,201,104,97,36,32,24,7,0
40164,238,158,80,28,15,31,7,242,121,121,39,30,29,10,0
40165,288,140,148,59,33,27,12,262,129,133,40,41,31,10,0
40166,603,311,292,102,71,66,23,309,159,150,47,43,43,13,0
40167,583,279,304,99,71,59,31,363,180,183,60,34,10,6,0
40168,577,342,235,63,57,23,37,1182,591,591,155,139,83,46,0
40169,401,204,197,49,33,29,17,386,181,205,55,51,57,31,0
40170,265,165,100,32,19,27,5,2517,1275,1242,304,324,245,135,0
40171,407,207,200,53,36,38,8,370,173,197,65,57,42,10,0
40172,261,148,113,23,29,26,21,405,181,224,71,57,31,12,0
40173,109,42,67,25,13,1,1,87,38,49,23,10,10,9,0
40174,911,441,470,123,108,60,21,350,196,154,52,37,21,14,0
40175,630,231,399,150,83,84,50,87,38,49,23,10,10,9,0
40176,548,310,238,72,62,54,13,209,119,90,28,24,27,9,0
40177,860,349,511,166,166,58,19,724,353,371,94,95,71,31,0
40178,595,316,279,86,60,65,40,332,180,152,46,36,28,14,0
40179,580,265,315,97,89,79,17,737,397,340,87,104,90,14,0
40180,509,246,263,84,71,56,22,584,249,335,80,96,22,13,0
40181,588,317,271,78,49,54,17,862,426,436,113,115,84,37,0
40182,574,284,290,64,50,65,20,422,237,185,53,47,62,20,0
40183,127,55,72,25,18,5,7,276,149,127,34,31,32,10,0
40184,450,231,219,77,50,76,16,463,259,204,62,55,34,22,0
40185,953,421,532,131,131,70,37,297,164,133,45,39,40,9,0
40186,319,222,97,36,23,28,8,305,161,144,39,40,44,17,0
40187,454,230,224,63,56,38,33,346,196,150,43,26,27,14,0
40188,2525,1232,1293,398,317,186,61,332,180,152,46,36,28,14,0
40189,745,402,343,95,71,69,40,1696,771,925,257,225,149,63,0
40190,164,81,83,37,8,14,10,107,77,30,7,2,9,5,0
40191,496,272,224,70,58,42,18,337,170,167,59,33,47,17,0
40192,180,92,88,29,20,26,8,218,111,107,45,29,24,6,0
40193,445,231,214,45,64,53,23,395,198,197,55,55,36,10,0
40194,559,217,342,105,86,42,16,205,94,111,48,31,15,6,0
40195,1226,513,713,184,147,87,43,360,180,180,57,48,39,12,0
40196,505,226,279,68,51,30,15,198,115,83,30,22,8,8,0
40197,557,211,346,129,125,48,19,866,478,388,121,101,101,26,0
40198,325,177,148,40,24,23,13,447,212,235,86,55,58,21,0
40199,653,379,274,89,56,86,13,374,191,183,40,52,40,16,0
40200,414,195,219,51,60,40,17,508,261,247,65,53,58,23,0
40201,270,147,123,34,17,39,21,373,189,184,54,46,50,23,0
40202,376,171,205,45,45,34,12,548,273,275,84,81,64,30,0
40203,595,208,387,157,60,91,48,337,170,167,59,33,47,17,0
40204,510,269,241,66,67,71,26,189,95,94,25,33,16,8,0
40205,347,181,166,27,20,12,12,257,139,118,64,17,24,7,0
40206,82,36,46,17,10,5,1,630,321,309,86,90,57,26,0
40207,1498,731,767,220,175,148,68,148,84,64,30,7,17,4,0
40208,162,73,89,32,19,4,4,483,287,196,71,50,54,17,0
40209,463,225,238,76,36,59,26,389,210,179,51,37,43,9,0
40210,411,236,175,39,45,50,30,173,86,87,30,22,19,12,0
40211,574,269,305,91,63,54,27,647,350,297,95,79,77,29,0
40212,479,228,251,71,57,60,14,252,130,122,45,23,32,11,0
40213,929,410,519,187,146,53,30,201,117,83,22,21,19,9,0
40214,437,228,209,47,61,26,11,475,251,224,67,49,48,23,0
40215,485,183,302,79,81,73,33,437,224,213,40,29,42,25,0
40216,682,260,422,153,78,109,46,127,54,73,11,33,15,6,0
40217,674,268,406,118,96,70,21,889,505,384,107,97,99,30,0
40218,772,332,440,136,104,72,28,862,409,453,149,125,86,29,0
40219,1047,443,604,162,156,78,52,1154,489,665,200,196,95,54,0
40220,475,235,240,77,58,43,22,517,295,222,69,62,40,28,0
40221,132,66,66,21,18,11,7,132,61,71,22,21,15,3,0
40222,410,188,222,53,52,31,14,461,223,238,45,62,18,35,0
40223,2048,855,1193,297,287,191,93,277,138,139,40,39,20,14,0
40224,203,80,123,40,37,20,3,467,240,227,65,65,51,23,0
40225,1014,488,526,178,137,94,39,415,226,189,51,40,40,29,0
40226,629,374,255,74,53,87,27,314,151,163,42,61,39,16,0
40227,452,202,250,83,60,56,19,557,281,276,80,59,43,21,0
40228,1970,978,992,245,206,198,80,464,236,228,64,56,53,28,0
40229,828,355,473,126,134,77,37,127,66,61,13,14,19,8,0
40230,346,205,141,47,34,30,7,2517,1275,1242,304,324,245,135,0
40231,461,207,254,82,66,55,33,374,191,183,40,52,40,16,0
40232,532,291,241,83,36,79,25,346,178,168,58,41,33,12,0
40233,520,261,259,74,52,49,22,204,96,108,31,37,20,5,0
40234,550,304,246,60,64,77,16,469,225,244,64,68,25,11,0
40235,178,89,89,40,12,18,7,222,119,103,37,32,24,8,0
40236,245,137,108,34,30,19,10,958,451,507,165,135,97,41,0
40237,284,128,156,48,29,34,8,317,161,156,40,49,41,11,0
40238,579,246,333,102,79,41,19,295,160,135,42,37,46,16,0
40239,532,291,241,83,36,79,25,293,142,151,49,40,42,17,0
40240,427,191,236,67,60,41,34,1154,489,665,200,196,95,54,0
40241,381,146,235,74,48,47,34,866,397,469,117,153,95,48,0
40242,567,256,311,91,81,53,17,556,290,266,75,74,29,24,0
40243,510,269,241,66,67,71,26,283,142,141,41,33,26,18,0
40244,588,300,288,100,57,65,27,258,129,129,45,24,31,10,0
40245,604,239,365,124,63,84,37,352,207,145,40,33,25,21,0
40246,211,92,119,33,44,11,7,978,536,442,132,107,67,32,0
40247,126,57,69,31,10,10,3,87,38,49,23,10,10,9,0
40248,434,221,213,58,47,54,15,423,234,189,66,44,57,12,0
40249,579,281,298,91,78,74,27,611,314,297,79,75,78,22,0
40250,431,245,186,50,23,46,17,452,252,200,55,49,61,16,0
40251,202,103,99,28,20,12,8,103,50,53,19,10,7,5,0
40252,649,304,345,99,80,67,40,279,161,118,37,32,7,7,0
40253,265,165,100,32,19,27,5,367,199,168,62,44,34,8,0
40254,55,16,39,24,2,5,2,4646,2328,2318,674,639,475,170,0
40255,327,174,153,42,35,16,12,87,51,35,15,9,9,4,0
40256,392,221,171,53,30,25,8,127,54,73,11,33,15,6,0
40257,500,245,255,66,57,52,27,246,125,121,38,36,30,11,0
40258,371,143,228,77,48,29,26,136,65,71,26,11,7,5,0
40259,747,360,387,125,92,69,32,359,171,188,49,74,45,11,0
40260,122,56,66,26,13,11,5,609,335,274,79,57,45,22,0
40261,648,376,272,70,60,73,24,602,310,292,87,66,70,36,0
40262,391,203,188,49,34,36,9,348,194,154,57,31,43,12,0
40263,674,318,356,86,139,50,11,299,140,159,49,44,26,11,0
40264,365,148,217,86,37,51,28,403,185,218,67,62,63,19,0
40265,71,39,32,7,11,6,4,218,115,103,32,32,34,11,0
40266,580,265,315,97,89,79,17,103,44,59,16,17,9,5,0
40267,895,388,507,130,84,90,31,664,350,314,86,90,82,36,0
40268,98,32,66,15,25,5,4,171,94,77,24,28,30,11,0
40269,270,147,123,34,17,39,21,1500,804,696,190,172,144,60,0
40270,484,192,292,118,68,83,22,130,67,63,24,10,12,4,0
40271,404,197,207,60,48,47,20,218,118,100,33,30,25,11,0
40272,533,300,233,74,50,74,17,701,380,321,94,84,96,34,0
40273,202,113,89,16,27,21,11,2517,1275,1242,304,324,245,135,0
40274,119,67,52,15,15,7,7,535,301,234,63,48,47,27,0
40275,139,81,58,17,14,24,9,354,183,171,54,43,49,8,0
40276,446,195,251,56,53,31,15,565,237,328,75,88,32,11,0
40277,1339,494,845,216,298,92,37,373,189,184,54,46,50,23,0
40278,490,224,266,80,70,39,32,323,168,155,51,41,38,12,0
40279,347,181,166,27,20,12,12,732,402,330,81,86,87,33,0
40280,781,367,414,60,67,43,17,132,61,71,19,20,14,6,0
40281,504,222,282,71,64,53,29,463,268,195,59,46,46,21,0
40282,529,290,239,54,63,85,15,1382,508,874,334,320,98,36,0
40283,1498,731,767,220,175,148,68,218,115,103,32,32,34,11,0
40284,334,190,144,42,42,16,5,223,113,110,31,33,22,12,0
40285,275,160,115,40,31,34,17,1214,475,739,177,250,89,49,0
40286,395,219,176,47,41,50,18,317,161,156,50,36,47,12,0
40287,426,213,213,60,56,46,24,422,202,220,80,52,57,18,0
40288,162,73,89,32,19,4,4,736,388,348,88,85,67,28,0
40289,887,439,448,137,99,91,38,720,361,359,98,98,70,37,0
40290,313,158,155,43,35,43,16,862,409,453,149,125,86,29,0
40291,181,92,89,34,22,17,9,230,113,117,31,40,28,10,0
40292,476,199,277,82,80,49,24,199,92,107,34,30,18,9,0
40293,911,445,466,154,121,108,48,1314,693,621,174,155,140,58,0
40294,3859,2011,1848,535,391,422,207,1279,669,610,164,162,104,55,0
40295,261,126,135,41,36,24,11,775,407,368,122,100,97,32,0
40296,484,261,223,59,48,49,24,906,455,451,116,105,87,46,0
40297,236,120,116,32,28,21,11,194,106,88,33,10,15,6,0
40298,728,358,370,118,100,55,29,530,287,243,79,70,33,26,0
40299,301,156,145,32,25,15,5,479,215,264,67,80,46,28,0
40300,784,351,433,118,87,73,41,240,141,99,34,28,29,8,0
40301,230,114,116,30,33,29,8,873,411,462,132,107,84,40,0
40302,207,89,118,56,8,4,3,296,140,156,49,40,42,19,0
40303,314,158,156,39,28,30,17,106,46,60,27,18,12,3,0
40304,593,325,268,84,66,73,24,447,179,268,81,49,35,29,0
40305,482,245,237,69,64,66,24,862,426,436,113,115,84,37,0
40306,149,68,81,15,38,11,10,340,169,171,40,39,36,22,0
40307,837,381,456,123,109,65,25,515,276,239,62,59,43,31,0
40308,434,216,218,72,58,40,20,188,101,87,20,18,20,14,0
40309,1058,497,561,194,142,87,63,395,198,197,55,55,36,10,0
40310,977,462,515,185,119,76,12,483,287,196,71,50,54,17,0
40311,587,318,269,76,50,38,21,326,149,177,51,51,28,10,0
40312,136,66,70,33,11,9,3,621,310,311,100,106,77,27,0
40313,343,162,181,65,38,29,12,660,333,327,102,95,69,31,0
40314,398,186,212,76,70,18,13,336,200,136,34,29,25,24,0
40315,1064,495,569,157,159,124,58,326,169,157,51,41,41,12,0
40316,315,174,141,46,38,47,16,229,120,109,31,30,22,9,0
40317,443,212,231,74,24,60,24,160,76,84,19,24,8,5,0
40318,326,176,150,35,22,29,11,904,436,468,143,118,108,32,0
40319,222,110,112,43,30,14,6,261,162,99,24,21,14,10,0
40320,345,203,142,47,35,31,11,188,101,87,20,18,20,14,0
40321,207,128,79,26,17,19,9,419,233,186,54,53,55,17,0
40322,154,74,80,18,19,7,2,437,224,213,40,29,42,25,0
40323,422,196,226,52,35,33,20,601,279,322,81,65,27,12,0
40324,385,203,182,47,43,51,21,279,161,118,37,32,7,7,0
40325,654,344,310,80,69,57,15,72,33,39,8,2,3,12,0
40326,319,222,97,36,23,28,8,583,321,262,73,67,45,25,0
40327,862,384,478,127,110,75,42,432,244,188,51,51,27,14,0
40328,390,199,191,72,42,35,12,1248,584,664,184,164,155,67,0
40329,203,80,123,40,37,20,3,463,259,204,62,55,34,22,0
40330,368,201,167,61,38,38,12,344,190,154,34,31,36,10,0
40331,202,113,89,16,27,21,11,231,126,105,28,26,34,9,0
40332,126,58,68,31,10,10,3,65,32,33,16,4,8,3,0
40333,1047,443,604,162,156,78,52,307,132,175,48,53,26,10,0
40334,431,245,186,50,23,46,17,344,190,154,34,31,36,10,0
40335,1148,472,676,229,164,86,37,485,244,241,80,55,59,20,0
40336,331,177,154,54,38,27,11,344,190,154,34,31,36,10,0
40337,692,305,387,100,97,78,30,192,110,82,33,21,10,3,0
40338,301,150,151,45,47,33,13,775,407,368,122,100,97,32,0
40339,960,409,551,166,134,77,44,277,138,139,40,39,20,14,0
40340,546,285,261,71,49,47,24,87,51,35,15,9,9,4,0
40341,929,410,519,187,146,53,30,526,266,260,76,75,53,22,0
40342,1464,693,771,153,136,91,86,2724,1157,1567,269,518,239,77,0
40343,613,303,310,70,28,28,18,348,212,136,53,31,25,18,0
40344,213,88,125,21,54,14,15,487,252,235,79,58,55,26,0
40345,260,120,140,34,39,36,12,862,426,436,113,115,84,37,0
40346,561,282,279,68,62,36,14,228,130,98,35,29,30,10,0
40347,436,201,235,54,37,35,18,282,134,148,38,45,29,10,0
40348,221,80,141,48,37,14,10,335,186,149,40,28,29,13,0
40349,443,206,237,76,68,52,28,156,90,66,17,22,11,10,0
40350,339,170,169,32,17,24,13,171,94,77,24,28,30,11,0
40351,1447,698,749,214,180,116,46,260,133,127,43,32,39,3,0
40352,1200,602,598,145,116,110,50,285,146,139,41,41,48,13,0
40353,1284,511,773,227,166,169,107,445,202,243,70,73,51,15,0
40354,493,208,285,75,77,70,40,390,190,200,66,50,43,12,0
40355,346,208,138,46,39,51,18,889,505,384,107,97,99,30,0
40356,421,237,184,47,54,45,10,314,151,163,42,61,39,16,0
40357,911,489,422,121,98,97,36,737,397,340,87,104,90,14,0
40358,416,207,209,63,47,56,15,1378,692,686,194,174,105,56,0
40359,136,66,70,33,11,9,5,377,184,193,50,43,33,17,0
40360,1342,640,702,187,163,123,57,535,288,247,79,72,35,21,0
40361,401,204,197,49,33,29,17,282,134,148,38,45,29,10,0
40362,261,126,135,41,36,24,11,250,119,131,58,26,29,7,0
40363,280,156,124,36,19,20,13,775,407,368,122,100,97,32,0
40364,267,146,121,40,24,25,7,727,362,365,123,107,63,23,0
40365,1759,838,921,269,212,191,92,172,88,84,24,31,20,12,0
40366,270,128,142,36,43,15,11,201,104,97,36,32,24,7,0
40367,350,178,172,49,62,29,16,518,292,226,60,60,52,21,0
40368,685,393,292,75,66,113,16,662,312,350,103,104,59,20,0
40369,929,410,519,187,146,53,30,194,94,100,33,28,14,7,0
40370,184,88,96,15,40,17,8,89,37,52,13,6,2,9,0
40371,443,250,193,52,23,49,13,103,59,44,25,2,13,6,0
40372,398,186,212,76,70,18,13,449,252,197,61,52,36,18,0
40373,220,121,99,28,26,17,6,142,65,77,30,17,22,9,0
40374,127,54,73,31,10,11,3,763,418,345,113,84,59,32,0
40375,282,163,119,40,23,25,17,778,391,387,94,77,41,33,0
40376,1139,537,602,162,139,109,50,536,222,314,101,100,34,22,0
40377,161,75,86,24,20,10,7,821,394,427,122,117,109,38,0
40378,221,80,141,48,37,14,10,1352,602,750,166,185,81,70,0
40379,546,265,281,101,64,38,16,1262,653,609,169,165,152,50,0
40380,330,151,179,68,36,56,9,180,89,91,28,27,18,7,0
40381,372,171,201,47,53,39,18,487,252,235,79,58,55,26,0
40382,264,122,142,46,24,35,10,720,361,359,98,98,70,37,0
40383,434,216,218,72,58,40,20,278,154,124,42,32,38,7,0
40384,729,351,378,111,98,58,18,424,179,245,65,67,29,11,0
40385,217,98,119,38,35,18,9,601,278,323,124,87,65,21,0
40386,674,268,406,118,96,70,21,289,140,149,33,42,30,15,0
40387,203,97,106,30,22,18,10,136,65,71,26,11,7,5,0
40388,1590,726,864,270,237,126,59,277,138,139,40,39,20,14,0
40389,1499,864,635,141,99,76,110,192,91,101,29,28,17,7,0
40390,107,53,54,15,15,13,4,1047,562,485,141,127,114,41,0
40391,4640,2231,2409,660,549,437,245,148,69,79,26,18,16,3,0
40392,325,152,173,43,47,28,17,305,163,142,38,27,47,11,0
40393,1439,713,726,195,180,110,34,902,499,403,118,117,92,35,0
40394,615,308,307,83,75,58,32,418,223,195,51,45,49,14,0
40395,333,171,162,50,34,19,8,593,289,304,85,69,48,19,0
40396,2446,1099,1347,363,294,233,100,1873,935,938,233,225,203,79,0
40397,210,101,109,33,33,19,9,1543,794,749,182,152,132,55,0
40398,272,136,136,32,34,12,12,1507,737,770,188,228,147,71,0
40399,733,382,351,126,92,93,27,818,357,461,122,136,54,25,0
40400,521,249,272,53,36,50,18,418,223,195,51,45,49,14,0
40401,323,156,167,52,45,39,18,943,463,480,91,144,70,30,0
40402,219,116,103,66,7,2,1,145,77,68,26,7,15,8,0
40403,450,227,223,53,36,48,12,1395,627,768,172,263,141,59,0
40404,184,93,91,26,25,14,11,644,343,301,96,69,59,28,0
40405,269,156,113,37,32,17,7,437,221,216,62,64,47,13,0
40406,490,198,292,65,81,39,27,601,278,323,124,87,65,21,0
40407,1112,457,655,180,164,99,39,305,163,142,38,27,47,11,0
40408,107,36,71,27,15,0,1,124,69,55,14,7,9,4,0
40409,181,75,106,35,26,11,9,559,317,242,58,65,37,23,0
40410,347,198,149,45,29,29,8,1249,638,611,166,153,141,45,0
40411,375,167,208,55,83,44,9,385,212,173,57,40,39,21,0
40412,126,56,70,31,10,10,3,108,59,49,17,13,12,5,0
40413,837,381,456,123,109,65,25,260,133,127,43,32,39,3,0
40414,312,173,139,43,47,28,6,302,150,152,56,40,52,15,0
40415,755,271,484,113,226,61,20,334,182,152,45,41,27,13,0
40416,414,216,198,51,32,42,28,507,270,237,89,59,57,22,0
40417,412,208,204,54,47,42,17,261,162,99,24,21,14,10,0
40418,290,156,134,44,29,39,9,1062,522,540,151,147,105,66,0
40419,496,274,222,57,43,75,22,134,55,79,22,24,16,6,0
40420,375,167,208,55,83,44,9,583,321,262,73,67,45,25,0
40421,233,107,126,40,40,20,16,727,362,365,123,107,63,23,0
40422,2649,1431,1218,377,299,266,102,978,536,442,132,107,67,32,0
40423,717,281,436,165,81,112,49,404,190,214,55,55,35,27,0
40424,124,58,66,20,28,11,7,240,141,99,34,28,29,8,0
40425,336,134,202,51,64,27,12,94,45,49,11,20,10,4,0
40426,452,202,250,83,60,56,19,137,85,52,15,11,11,2,0
40427,213,104,109,56,14,9,2,601,279,322,81,65,27,12,0
40428,531,284,247,66,42,49,15,898,469,429,125,125,134,35,0
40429,131,69,62,29,9,9,1,286,160,126,37,27,23,10,0
40430,126,57,69,31,10,10,3,663,354,309,91,84,79,31,0
40431,412,208,204,54,47,42,17,285,146,139,41,41,48,13,0
40432,478,220,258,47,70,41,10,475,251,224,67,49,48,23,0
40433,1130,614,516,129,138,98,42,751,394,357,107,96,73,35,0
40434,595,339,256,64,36,54,24,144,67,77,28,14,9,8,0
40435,411,236,175,39,45,50,30,381,186,195,69,55,46,15,0
40436,361,177,184,59,51,24,15,301,168,133,49,37,34,11,0
40437,180,57,123,39,22,10,8,166,102,64,19,14,17,2,0
40438,286,111,175,51,47,21,12,378,154,224,74,84,35,22,0
40439,158,85,73,24,18,18,8,322,180,142,45,38,28,7,0
40440,119,67,52,15,15,7,7,286,160,126,37,27,23,10,0
40441,575,305,270,74,87,73,25,199,92,107,34,30,18,9,0
40442,282,135,147,27,37,30,19,175,91,84,19,21,21,10,0
40443,325,181,144,46,31,48,9,2202,1121,1081,338,274,269,81,0
40444,1124,442,682,148,189,72,43,267,141,126,53,27,23,7,0
40445,598,322,276,67,57,63,26,359,171,188,49,74,45,11,0
40446,431,199,232,59,54,40,17,708,328,380,113,100,82,34,0
40447,250,123,127,40,28,29,8,520,244,276,91,60,68,20,0
40448,546,285,261,71,49,47,24,172,79,93,34,27,23,10,0
40449,484,194,290,70,93,47,16,1378,692,686,194,174,105,56,0
40450,385,203,182,47,43,51,21,199,92,107,34,30,18,9,0
40451,588,267,321,99,79,87,28,329,194,135,45,32,33,9,0
40452,196,107,89,20,31,17,4,319,185,134,42,31,22,13,0
40453,607,305,302,92,89,74,23,724,353,371,94,95,71,31,0
40454,326,148,178,55,42,31,12,376,189,187,47,53,44,26,0
40455,379,217,162,47,20,50,23,173,86,87,30,22,19,12,0
40456,200,94,106,33,22,18,8,390,223,167,58,36,45,18,0
40457,651,357,294,81,67,103,18,354,183,171,54,43,49,8,0
40458,365,148,217,86,37,51,28,374,202,172,50,39,31,24,0
40459,571,298,273,81,72,57,25,737,397,340,87,104,90,14,0
40460,347,181,166,27,20,12,12,617,314,303,96,68,68,37,0
40461,126,58,68,31,10,10,3,300,148,152,45,43,40,8,0
40462,607,294,313,94,95,62,14,119,67,52,15,15,7,7,0
40463,793,355,438,134,117,77,43,395,169,226,73,55,38,9,0
40464,983,449,534,95,77,55,36,902,499,403,118,117,92,35,0
40465,598,300,298,68,77,59,21,699,334,365,108,80,70,20,0
40466,1054,453,601,183,183,107,35,377,184,193,50,43,33,17,0
40467,240,98,142,49,42,23,17,198,113,85,19,20,26,12,0
40468,346,173,173,50,56,31,14,1262,653,609,169,165,152,50,0
40469,255,136,119,39,20,32,10,376,189,187,47,53,44,26,0
40470,733,438,295,95,79,67,32,480,255,225,67,64,50,22,0
40471,717,381,336,118,103,85,29,192,91,101,29,28,17,7,0
40472,852,472,380,99,79,70,27,381,187,194,37,49,36,17,0
40473,1970,978,992,245,206,198,80,207,113,94,33,18,30,9,0
40474,437,225,212,61,57,66,12,510,264,246,67,66,38,29,0
40475,850,445,405,93,94,92,37,572,309,263,64,55,47,29,0
40476,391,204,187,47,48,38,18,397,223,174,50,39,29,17,0
40477,335,171,164,51,38,38,10,620,324,296,81,68,66,31,0
40478,328,156,172,44,37,44,15,164,79,85,28,28,16,7,0
40479,51,10,41,25,0,5,8,163,79,84,22,24,13,5,0
40480,265,165,100,32,19,27,5,101,59,42,11,17,10,1,0
40481,109,50,59,12,12,9,3,2382,1162,1220,237,220,140,49,0
40482,282,84,198,60,102,1,6,756,348,408,101,103,60,40,0
40483,536,287,249,64,73,21,27,349,200,149,41,39,30,20,0
40484,782,372,410,127,111,89,36,727,362,365,123,107,63,23,0
40485,415,217,198,50,31,42,17,230,113,117,31,40,28,10,0
40486,1009,487,522,177,121,103,51,732,366,366,108,86,74,41,0
40487,1464,693,771,153,136,91,86,180,108,72,22,22,15,5,0
40488,401,204,197,49,33,29,17,296,159,137,49,28,38,13,0
40489,280,156,124,36,19,20,13,418,246,172,52,39,57,10,0
40490,443,250,193,52,23,49,13,178,99,79,31,19,26,8,0
40491,303,161,142,38,31,42,17,87,51,35,15,9,9,4,0
40492,881,492,389,87,97,59,51,149,52,97,36,36,7,4,0
40493,1867,973,894,256,222,194,65,447,212,235,86,55,58,21,0
40494,1171,542,629,170,146,114,64,328,195,133,39,40,27,13,0
40495,711,330,381,111,86,86,34,169,74,95,33,26,22,3,0
40496,359,204,155,39,36,34,13,370,173,197,65,57,42,10,0
40497,117,58,59,17,17,12,2,346,196,150,43,26,27,14,0
40498,739,323,416,127,89,76,33,459,260,199,56,42,47,21,0
40499,415,133,282,114,65,27,7,289,140,149,33,42,30,15,0
40500,648,376,272,70,60,73,24,1062,522,540,151,147,105,66,0
40501,801,331,470,151,139,99,55,640,364,276,84,68,69,33,0
40502,158,85,73,24,18,18,8,447,212,235,86,55,58,21,0
40503,346,173,173,50,56,31,14,328,195,133,39,40,27,13,0
40504,203,97,106,30,22,18,10,260,131,129,42,31,40,9,0
40505,1186,495,691,182,208,88,32,169,84,85,29,19,21,7,0
40506,119,67,52,15,15,7,7,391,165,226,67,64,36,27,0
40507,828,355,473,126,134,77,37,198,115,83,30,22,8,8,0
40508,333,171,162,50,34,19,8,363,180,183,60,34,10,6,0
40509,179,96,83,24,8,26,4,693,360,333,100,88,62,26,0
40510,2109,999,1110,332,294,187,89,302,150,152,56,40,52,15,0
40511,345,208,137,44,27,33,8,266,150,116,28,28,24,12,0
40512,102,22,80,48,8,18,6,487,252,235,79,58,55,26,0
40513,204,109,95,21,35,27,7,723,353,370,120,109,96,33,0
40514,524,361,163,41,8,28,16,290,147,143,34,34,39,13,0
40515,488,237,251,79,78,65,27,501,249,252,77,70,55,22,0
40516,109,42,67,25,13,1,1,943,463,480,91,144,70,30,0
40517,454,230,224,63,56,38,33,748,359,389,125,113,86,31,0
40518,284,160,124,37,23,32,11,858,398,460,126,138,75,39,0
40519,260,133,127,43,29,34,11,621,273,348,104,102,48,19,0
40520,281,154,127,45,31,24,9,462,251,211,74,53,41,18,0
40521,525,254,271,60,76,46,13,528,276,252,86,78,49,17,0
40522,224,101,123,45,32,21,3,903,436,467,128,116,83,33,0
40523,346,186,160,40,37,34,21,671,306,365,114,76,49,19,0
40524,732,355,377,108,109,79,27,622,344,278,80,77,68,36,0
40525,249,104,145,47,41,24,17,218,115,103,32,32,34,11,0
40526,466,199,267,86,59,32,17,232,111,121,23,29,17,9,0
40527,345,203,142,47,35,31,11,2517,1275,1242,304,324,245,135,0
40528,1390,705,685,219,164,129,74,629,317,312,80,87,51,22,0
40529,320,163,157,44,44,26,15,165,87,78,24,19,22,9,0
40530,531,260,271,97,68,47,11,283,142,141,41,33,26,18,0
40531,439,205,234,64,88,41,21,708,328,380,113,100,82,34,0
40532,362,174,188,46,55,35,23,516,245,271,82,84,70,26,0
40533,209,75,134,53,48,20,9,437,221,216,62,64,47,13,0
40534,833,295,538,146,139,65,34,445,202,243,70,73,51,15,0
40535,144,57,87,38,26,10,4,277,145,132,41,32,22,10,0
40536,1689,821,868,277,250,177,78,693,360,333,100,88,62,26,0
40537,1047,443,604,162,156,78,52,492,278,214,65,58,32,11,0
40538,502,250,252,70,47,57,15,290,142,148,41,37,43,11,0
40539,439,205,234,64,88,41,21,1537,701,836,209,187,129,58,0
40540,704,342,362,113,91,85,33,194,106,88,33,10,15,6,0
40541,213,113,100,26,21,26,12,320,168,152,38,42,24,18,0
40542,466,259,207,59,50,83,12,517,295,222,69,62,40,28,0
40543,193,90,103,44,9,19,13,1239,659,580,169,148,131,54,0
40544,393,223,170,44,36,32,14,663,360,303,87,82,80,35,0
40545,232,134,98,28,20,20,5,190,93,97,35,27,23,2,0
40546,533,300,233,74,50,74,17,415,226,189,51,40,40,29,0
40547,282,105,177,77,28,39,6,926,425,501,159,147,77,35,0
40548,478,220,258,47,70,41,10,135,65,70,21,25,15,9,0
40549,648,262,386,113,108,78,29,144,67,77,28,14,9,8,0
40550,395,189,206,63,50,49,28,277,152,125,31,35,22,19,0
40551,107,53,54,15,15,13,4,1061,543,518,146,123,109,67,0
40552,255,126,129,41,37,13,5,230,113,117,31,40,28,10,0
40553,343,189,154,44,24,39,12,758,319,439,101,123,78,25,0
40554,493,281,212,56,61,30,13,325,172,153,44,34,27,14,0
40555,412,208,204,54,47,42,17,432,244,188,51,51,27,14,0
40556,209,75,134,53,48,20,9,1279,669,610,164,162,104,55,0
40557,953,421,532,131,131,70,37,514,262,252,78,58,54,26,0
40558,798,287,511,126,125,77,26,297,164,133,45,39,40,9,0
40559,118,51,67,25,13,6,7,846,425,421,125,97,98,38,0
40560,343,189,154,44,24,39,12,584,249,335,80,96,22,13,0
40561,3230,1724,1506,361,358,157,75,1062,522,540,151,147,105,66,0
40562,416,222,194,58,38,38,20,220,107,113,36,35,28,9,0
40563,227,109,118,42,35,29,8,1873,935,938,233,225,203,79,0
40564,238,91,147,68,19,22,7,413,223,190,52,45,53,10,0
40565,443,212,231,74,24,60,24,282,134,148,38,45,29,10,0
40566,343,162,181,65,38,29,12,741,383,358,92,63,79,36,0
40567,358,206,152,45,38,67,16,274,142,132,33,34,18,14,0
40568,736,320,416,113,97,61,36,312,165,147,41,39,29,16,0
40569,853,400,453,137,109,88,42,479,215,264,67,80,46,28,0
40570,1441,504,937,264,329,69,46,297,175,122,46,30,31,6,0
40571,450,231,219,77,50,76,16,2038,1059,979,262,237,208,100,0
40572,524,270,254,84,72,70,23,265,134,131,48,34,33,15,0
40573,299,151,148,35,34,26,16,846,425,421,125,97,98,38,0
40574,252,121,131,42,34,12,16,415,205,210,77,52,55,17,0
40575,1221,597,624,201,152,83,31,749,384,365,108,105,86,31,0
40576,452,217,235,59,47,60,20,1230,644,586,198,125,123,61,0
40577,1007,353,654,277,147,70,26,1001,417,584,186,147,96,47,0
40578,306,172,134,35,31,37,18,89,37,52,13,6,2,9,0
40579,243,114,129,37,30,32,8,978,536,442,132,107,67,32,0
40580,362,181,181,67,46,43,8,376,183,193,50,50,43,21,0
40581,318,161,157,53,51,32,13,889,505,384,107,97,99,30,0
40582,222,110,112,43,30,14,6,457,245,212,62,58,57,21,0
40583,155,85,70,17,16,4,8,299,140,159,49,44,26,11,0
40584,261,130,131,27,41,19,16,579,285,294,78,72,64,32,0
40585,425,220,205,60,55,45,18,282,134,148,38,45,29,10,0
40586,484,264,220,59,62,68,15,312,165,147,41,39,29,16,0
40587,714,260,454,140,97,120,54,87,38,49,23,10,10,9,0
40588,251,139,112,41,18,27,11,377,184,193,50,43,33,17,0
40589,256,152,104,18,23,23,8,679,338,341,96,95,40,23,0
40590,330,141,189,65,29,51,19,149,77,72,37,10,20,5,0
40591,435,230,205,51,37,55,18,322,180,142,45,38,28,7,0
40592,428,226,202,52,60,75,20,457,242,215,39,46,53,10,0
40593,535,315,220,57,55,71,19,276,149,127,34,31,32,10,0
40594,286,111,175,51,47,21,12,403,192,211,102,39,49,15,0
40595,127,55,72,25,18,5,7,86,40,46,16,13,9,7,0
40596,172,98,74,20,21,22,8,536,267,269,60,70,41,22,0
40597,126,58,68,31,10,10,3,189,105,84,25,26,21,9,0
40598,304,149,155,46,32,39,14,671,306,365,114,76,49,19,0
40599,553,319,234,56,37,54,18,295,160,135,42,37,46,16,0
40600,125,53,72,18,21,18,12,1004,457,547,150,150,74,52,0
40601,158,85,73,24,18,18,8,469,225,244,64,68,25,11,0
40602,338,164,174,45,32,37,13,397,234,163,44,38,23,21,0
40603,348,198,150,57,25,37,18,386,181,205,55,51,57,31,0
40604,228,105,123,34,43,20,10,222,125,97,34,27,27,7,0
40605,278,104,174,46,34,23,14,244,143,101,31,29,26,8,0
40606,281,154,127,45,31,24,9,328,195,133,39,40,27,13,0
40607,587,318,269,76,50,38,21,218,117,101,35,32,34,12,0
40608,474,250,224,58,47,37,12,600,254,346,104,100,44,17,0
40609,142,76,66,21,21,22,11,173,94,79,18,24,12,7,0
40610,179,78,101,29,22,10,8,160,60,100,23,40,19,11,0
40611,476,199,277,82,80,49,24,535,288,247,79,72,35,21,0
40612,516,224,292,79,29,45,33,225,129,96,32,33,20,8,0
40613,5890,3314,2576,970,956,293,265,289,140,149,33,42,30,15,0
40614,410,208,202,59,58,43,26,252,130,122,45,23,32,11,0
40615,815,356,459,128,125,82,26,194,106,88,33,10,15,6,0
40616,1058,497,561,194,142,87,63,213,129,84,32,14,21,15,0
40617,228,82,146,45,37,18,8,212,127,85,28,21,26,6,0
40618,376,171,205,45,45,34,12,326,149,177,51,51,28,10,0
40619,616,304,312,75,71,55,25,209,119,90,28,24,27,9,0
40620,2696,1169,1527,432,347,193,146,671,321,350,95,87,75,34,0
40621,256,152,104,18,23,23,8,400,187,213,56,59,42,20,0
40622,109,42,67,25,13,1,1,462,251,211,74,53,41,18,0
40623,142,60,82,20,28,13,5,89,51,38,15,15,5,4,0
40624,928,442,486,139,118,91,43,480,255,225,67,64,50,22,0
40625,504,222,282,71,64,53,29,385,188,197,57,42,36,16,0
40626,299,151,148,35,34,26,16,470,205,265,71,80,33,11,0
40627,350,190,160,48,25,27,18,88,50,38,13,8,16,4,0
40628,520,231,289,89,59,58,26,148,69,79,26,18,16,3,0
40629,475,208,267,84,67,50,20,135,57,78,21,20,9,11,0
40630,315,111,204,82,66,46,11,1425,670,755,153,189,122,85,0
40631,475,235,240,77,58,43,22,479,215,264,67,80,46,28,0
40632,283,172,111,39,31,29,8,323,171,152,48,41,40,16,0
40633,375,167,208,55,83,44,9,317,161,156,40,49,41,11,0
40634,1009,478,531,166,126,96,42,1265,689,576,169,177,128,60,0
40635,260,120,140,34,39,36,12,778,391,387,94,77,41,33,0
40636,753,395,358,93,72,71,16,1114,539,575,145,131,94,56,0
40637,553,276,277,88,61,45,27,620,324,296,81,68,66,31,0
40638,959,496,463,144,132,75,35,665,361,304,87,91,84,31,0
40639,626,308,318,105,89,77,25,225,129,96,32,33,20,8,0
40640,1594,660,934,251,272,117,77,367,199,168,62,44,34,8,0
40641,1214,612,602,169,173,98,35,620,324,296,81,68,66,31,0
40642,425,199,226,54,71,56,11,290,147,143,34,34,39,13,0
40643,326,156,170,60,47,43,5,590,303,287,69,65,46,17,0
40644,752,313,439,121,106,68,27,188,90,98,44,7,21,7,0
40645,180,57,123,39,22,10,8,434,213,221,77,62,53,12,0
40646,308,163,145,38,33,30,20,288,156,132,36,36,24,15,0
40647,457,228,229,64,36,52,21,160,76,84,19,24,8,5,0
40648,281,125,156,44,47,17,7,2542,1245,1297,285,287,170,84,0
40649,434,221,213,58,47,54,15,424,179,245,65,67,29,11,0
40650,261,137,124,34,23,13,8,403,192,211,102,39,49,15,0
40651,1174,594,580,175,155,126,66,334,182,152,45,41,27,13,0
40652,1043,479,564,200,131,123,62,180,89,91,28,27,18,7,0
40653,411,171,240,61,81,30,15,374,202,172,50,39,31,24,0
40654,502,229,273,63,66,40,31,390,223,167,58,36,45,18,0
40655,204,103,101,16,32,22,8,346,196,150,43,26,27,14,0
40656,1417,598,819,223,188,135,58,773,389,384,119,91,79,26,0
40657,92,46,46,14,9,8,6,165,87,78,24,19,22,9,0
40658,445,231,214,45,64,53,23,693,360,333,100,88,62,26,0
40659,972,501,471,125,156,106,39,485,244,241,80,55,59,20,0
40660,332,173,159,48,42,42,9,862,426,436,113,115,84,37,0
40661,1960,875,1085,287,189,162,66,179,101,78,25,15,13,13,0
40662,204,103,101,16,32,22,8,601,278,323,124,87,65,21,0
40663,840,411,429,122,101,79,34,541,279,262,79,82,31,32,0
40664,240,167,73,32,12,8,21,346,196,150,43,26,27,14,0
40665,215,80,135,54,56,21,9,1114,539,575,145,131,94,56,0
40666,1339,494,845,216,298,92,37,89,51,38,15,15,5,4,0
40667,343,189,154,44,24,39,12,199,92,107,34,30,18,9,0
40668,736,353,383,117,83,71,18,363,180,183,60,34,10,6,0
40669,331,169,162,40,28,22,14,487,252,235,79,58,55,26,0
40670,753,395,358,93,72,71,16,234,116,118,34,35,23,9,0
40671,259,119,140,48,28,29,19,471,238,233,66,63,62,19,0
40672,687,351,336,106,67,70,41,1696,771,925,257,225,149,63,0
40673,313,148,165,45,33,36,11,748,359,389,125,113,86,31,0
40674,419,210,209,54,44,31,23,360,185,175,51,43,36,16,0
40675,505,226,279,68,51,30,15,395,198,197,55,55,36,10,0
40676,313,148,165,45,33,36,11,1873,935,938,233,225,203,79,0
40677,1004,498,506,94,59,46,33,418,223,195,53,43,49,15,0
40678,904,436,468,138,146,82,39,331,180,151,46,35,47,17,0
40679,224,101,123,45,32,21,3,295,158,137,42,34,38,14,0
40680,338,172,166,59,30,39,18,173,86,87,30,22,19,12,0
40681,1867,973,894,256,222,194,65,250,119,131,58,26,29,7,0
40682,977,462,515,185,119,76,12,617,314,303,96,68,68,37,0
40683,143,81,62,28,9,8,1,439,231,208,65,51,55,17,0
40684,226,120,106,68,8,2,1,662,312,350,103,104,59,20,0
40685,739,323,416,127,89,76,33,862,409,453,149,125,86,29,0
40686,1030,567,463,118,106,94,49,158,71,87,23,21,17,12,0
40687,429,238,191,47,49,56,29,305,163,142,38,27,47,11,0
40688,789,362,427,90,82,70,35,123,61,62,17,18,17,7,0
40689,609,292,317,102,96,64,21,892,475,417,130,108,68,38,0
40690,306,172,134,35,31,37,18,336,200,136,34,29,25,24,0
40691,480,267,213,49,44,70,21,205,94,111,48,31,15,6,0
40692,467,233,234,83,37,77,22,756,348,408,101,103,60,40,0
40693,894,448,446,123,100,82,30,741,383,358,92,63,79,36,0
40694,193,107,86,13,20,13,6,418,246,172,52,39,57,10,0
40695,206,96,110,33,25,8,6,158,71,87,23,21,17,12,0
40696,313,134,179,58,37,43,19,87,51,35,15,9,9,4,0
40697,207,128,79,26,17,19,9,492,278,214,65,58,32,11,0
40698,350,172,178,61,45,32,13,858,461,397,125,114,79,45,0
40699,570,238,332,112,95,39,23,906,455,451,116,105,87,46,0
40700,1121,458,663,158,210,76,47,461,223,238,45,62,18,35,0
40701,887,439,448,137,99,91,38,242,121,121,39,30,29,10,0
40702,1148,472,676,229,164,86,37,200,99,101,31,24,26,6,0
40703,221,114,107,65,7,2,1,144,67,77,28,14,9,8,0
40704,441,218,223,69,55,50,27,647,324,323,101,80,76,43,0
40705,1439,713,726,195,180,110,34,400,187,213,56,59,42,20,0
40706,178,87,91,20,32,13,10,334,182,152,45,41,27,13,0
40707,577,342,235,63,57,23,37,1606,753,853,215,227,182,48,0
40708,316,157,159,45,38,22,19,621,273,348,104,102,48,19,0
40709,727,426,301,79,71,64,32,380,211,169,47,37,33,21,0
40710,98,32,66,15,25,5,4,94,45,49,11,20,10,4,0
40711,331,177,154,54,38,27,11,810,310,500,164,162,42,26,0
40712,648,376,272,70,60,73,24,288,156,132,36,36,24,15,0
40713,600,324,276,89,73,45,39,106,46,60,27,18,12,3,0
40714,213,104,109,56,14,9,2,1352,602,750,166,185,81,70,0
40715,483,236,247,82,60,43,18,664,350,314,86,90,82,36,0
40716,653,379,274,89,56,86,13,508,253,255,73,60,50,13,0
40717,626,300,326,91,82,68,26,277,124,153,44,40,35,18,0
40718,820,333,487,202,152,59,23,274,157,117,40,29,40,8,0
40719,179,78,101,29,22,10,8,300,148,152,45,43,40,8,0
40720,603,311,292,102,71,66,23,142,65,77,30,17,22,9,0
40721,371,209,162,46,17,36,19,231,126,105,28,26,34,9,0
40722,331,169,162,40,28,22,14,338,169,169,53,44,39,21,0
40723,328,156,172,44,37,44,15,306,157,149,52,35,39,16,0
40724,469,253,216,49,51,48,18,620,324,296,81,68,66,31,0
40725,388,209,179,46,24,31,28,319,185,134,42,31,22,13,0
40726,318,164,154,52,43,34,10,247,128,119,34,14,16,14,0
40727,457,261,196,55,27,57,34,244,143,101,31,29,26,8,0
40728,607,294,313,94,95,62,14,715,345,370,110,97,64,25,0
40729,456,214,242,76,62,52,22,463,268,195,59,46,46,21,0
40730,919,444,475,141,148,62,20,457,253,204,67,51,48,13,0
40731,503,260,243,46,56,33,16,289,140,149,33,42,30,15,0
40732,446,283,163,51,26,33,19,665,361,304,87,91,84,31,0
40733,271,136,135,37,30,18,10,798,385,413,120,115,79,30,0
40734,282,96,186,80,21,28,7,386,181,205,55,51,57,31,0
40735,115,62,53,13,10,9,7,483,258,225,70,53,54,20,0
40736,556,306,250,69,60,80,18,96,45,51,13,12,6,4,0
40737,258,126,132,38,22,29,8,821,394,427,122,117,109,38,0
40738,209,75,134,53,48,20,9,196,105,91,40,13,19,10,0
40739,2696,1169,1527,432,347,193,146,622,344,278,80,77,68,36,0
40740,607,305,302,92,89,74,23,386,181,205,55,51,57,31,0
40741,1849,931,918,245,220,158,90,367,218,149,45,43,42,16,0
40742,71,39,32,7,11,6,4,229,120,109,31,30,22,9,0
40743,420,202,218,67,43,51,15,277,124,153,44,40,35,18,0
40744,434,216,218,72,58,40,20,729,358,371,116,99,89,33,0
40745,580,240,340,108,81,59,22,377,184,193,50,43,33,17,0
40746,146,73,73,18,24,17,9,403,192,211,102,39,49,15,0
40747,782,372,410,127,111,89,36,601,279,322,81,65,27,12,0
40748,410,200,210,60,54,46,19,334,181,153,41,40,25,15,0
40749,126,56,70,31,10,10,3,384,212,172,44,43,34,14,0
40750,282,96,186,80,21,28,7,106,41,65,36,6,11,7,0
40751,106,43,63,28,13,8,1,344,190,154,34,31,36,10,0
40752,531,260,271,97,68,47,11,732,366,366,108,86,74,41,0
40753,341,177,164,57,42,40,18,536,251,285,75,79,60,23,0
40754,312,164,148,54,29,25,15,422,237,185,53,47,62,20,0
40755,325,177,148,40,24,23,13,265,134,131,48,34,33,15,0
40756,399,220,179,48,37,68,18,239,113,126,36,49,20,8,0
40757,505,201,304,116,58,75,31,267,141,126,53,27,23,7,0
40758,213,114,99,62,7,2,1,338,169,169,53,44,39,21,0
40759,457,228,229,64,36,52,21,334,182,152,45,41,27,13,0
40760,887,439,448,137,99,91,38,222,124,98,37,29,22,9,0
40761,2220,1085,1135,312,304,202,91,403,225,178,56,38,33,25,0
40762,264,122,142,46,24,35,10,947,482,465,143,107,89,37,0
40763,556,306,250,69,60,80,18,201,99,102,34,26,23,6,0
40764,666,204,462,110,194,42,14,2547,1280,1267,331,335,293,118,0
40765,5890,3314,2576,970,956,293,265,107,77,30,7,2,9,5,0
40766,360,205,155,35,24,52,14,303,137,166,54,54,31,15,0
40767,411,171,240,61,81,30,15,414,203,211,58,56,48,14,0
40768,895,388,507,130,84,90,31,507,270,237,89,59,57,22,0
40769,341,195,146,42,21,36,9,91,42,49,21,9,8,3,0
40770,1463,521,942,252,204,105,52,104,46,58,15,17,9,5,0
40771,734,339,395,135,89,78,36,380,211,169,47,37,33,21,0
40772,631,316,315,64,57,49,15,518,292,226,60,60,52,21,0
40773,193,95,98,33,17,25,17,142,65,77,30,17,22,9,0
40774,462,233,229,66,49,43,30,531,261,270,73,80,68,26,0
40775,414,216,198,51,32,42,28,240,141,99,34,28,29,8,0
40776,1327,520,807,241,174,141,60,285,146,139,41,41,48,13,0
40777,1284,511,773,227,166,169,107,305,163,142,38,27,47,11,0
40778,299,151,148,35,34,26,16,455,229,226,66,62,63,29,0
40779,338,172,166,59,30,39,18,1338,720,618,179,145,141,85,0
40780,236,120,116,32,28,21,11,2382,1162,1220,237,220,140,49,0
40781,587,318,269,76,50,38,21,148,69,79,26,18,16,3,0
40782,276,149,127,45,34,39,9,858,398,460,126,138,75,39,0
40783,598,300,298,68,77,59,21,337,170,167,59,33,47,17,0
40784,128,67,61,29,9,9,1,609,335,274,79,57,45,22,0
40785,181,92,89,34,22,17,9,405,181,224,71,57,31,12,0
40786,410,211,199,55,42,34,27,381,187,194,37,49,36,17,0
40787,220,113,107,37,24,16,7,277,124,153,44,40,35,18,0
40788,640,279,361,102,83,69,21,663,360,303,87,82,80,35,0
40789,388,244,144,46,25,42,16,266,146,120,41,28,31,7,0
40790,688,310,378,130,82,78,47,189,105,84,25,26,21,9,0
40791,1120,436,684,208,120,101,115,929,459,470,140,120,94,45,0
40792,228,105,123,34,43,20,10,389,207,182,53,58,52,18,0
40793,577,342,235,63,57,23,37,445,192,253,86,58,53,18,0
40794,333,171,162,41,44,48,23,598,333,265,79,66,54,33,0
40795,953,421,532,131,131,70,37,497,257,240,71,63,62,16,0
40796,1235,584,651,140,226,82,52,395,169,226,73,55,38,9,0
40797,583,279,304,99,71,59,31,158,71,87,23,21,17,12,0
40798,1174,594,580,175,155,126,66,464,236,228,64,56,53,28,0
40799,1004,464,540,143,104,78,55,73,35,38,14,10,9,4,0
40800,362,181,181,67,46,43,8,218,115,103,37,33,33,9,0
40801,301,150,151,45,47,33,13,415,203,212,77,44,49,18,0
40802,269,156,113,37,32,17,7,397,234,163,44,38,23,21,0
40803,215,104,111,61,7,2,1,399,190,209,61,41,39,18,0
40804,609,292,317,102,96,64,21,548,296,252,71,74,43,28,0
40805,483,236,247,82,60,43,18,178,99,79,31,19,26,8,0
40806,142,60,82,20,28,13,5,239,113,126,36,49,20,8,0
40807,802,375,427,133,103,81,41,332,180,152,46,36,28,14,0
40808,260,138,122,44,30,28,6,673,313,360,102,101,46,17,0
40809,1107,601,506,155,138,103,49,1425,670,755,153,189,122,85,0
40810,399,196,203,62,45,38,19,508,253,255,73,60,50,13,0
40811,305,124,181,27,25,31,21,391,189,202,55,56,56,12,0
40812,619,289,330,67,77,36,19,200,99,101,31,24,26,6,0
40813,423,247,176,58,55,29,20,452,252,200,55,49,61,16,0
40814,414,206,208,56,68,35,19,260,131,129,42,31,40,9,0
40815,539,283,256,75,73,53,26,975,475,500,139,140,119,28,0
40816,1099,491,608,163,141,107,62,192,110,82,33,21,10,3,0
40817,1390,585,805,241,230,118,46,370,173,197,65,57,42,10,0
40818,193,105,88,33,16,9,4,317,161,156,40,49,41,11,0
40819,1390,705,685,219,164,129,74,370,173,197,65,57,42,10,0
40820,1462,711,751,219,222,148,65,294,146,148,50,45,51,15,0
40821,553,319,234,56,37,54,18,148,69,79,26,18,16,3,0
40822,341,175,166,48,43,35,18,89,37,52,13,6,2,9,0
40823,264,122,142,33,29,13,13,103,44,59,16,17,9,5,0
40824,516,224,292,79,29,45,33,780,337,443,112,116,77,28,0
40825,98,32,66,15,25,5,4,419,233,186,54,53,55,17,0
40826,410,208,202,59,58,43,26,405,214,191,53,42,49,20,0
40827,631,304,327,98,75,52,23,124,69,55,14,7,9,4,0
40828,653,379,274,89,56,86,13,88,50,38,13,8,16,4,0
40829,358,212,146,51,36,33,9,270,130,140,48,44,37,12,0
40830,803,358,445,135,117,80,43,693,360,333,100,88,62,26,0
40831,1004,498,506,94,59,46,33,457,242,215,39,46,53,10,0
40832,417,222,195,53,39,43,10,230,125,105,29,40,20,6,0
40833,516,224,292,79,29,45,33,277,138,139,40,39,20,14,0
40834,470,163,307,99,68,73,30,201,93,108,34,39,21,6,0
40835,801,331,470,151,139,99,55,660,332,328,84,73,47,19,0
40836,527,254,273,67,66,70,31,314,151,163,42,61,39,16,0
40837,1098,519,579,182,159,79,42,708,328,380,113,100,82,34,0
40838,443,206,237,76,68,52,28,190,93,97,35,27,23,2,0
40839,915,336,579,185,199,56,29,119,61,58,17,12,10,6,0
40840,385,203,182,47,43,51,21,173,90,83,21,36,12,15,0
40841,210,101,109,33,33,19,9,518,292,226,60,60,52,21,0
40842,339,118,221,77,68,33,13,396,199,197,54,50,45,14,0
40843,124,58,66,20,28,11,7,501,274,227,63,58,53,20,0
40844,252,121,131,42,34,12,16,622,344,278,80,77,68,36,0
40845,528,273,255,67,53,29,20,424,179,245,65,67,29,11,0
40846,280,156,124,36,19,20,13,1062,522,540,151,147,105,66,0
40847,342,185,157,42,27,31,14,166,102,64,19,14,17,2,0
40848,318,161,157,53,51,32,13,326,169,157,51,41,41,12,0
40849,1054,497,557,190,168,107,45,535,311,224,66,52,49,24,0
40850,1849,931,918,245,220,158,90,415,226,189,51,40,40,29,0
40851,629,374,255,74,53,87,27,292,155,137,50,34,29,13,0
40852,1098,519,579,182,159,79,42,501,257,244,75,57,48,29,0
40853,161,99,62,15,22,9,7,381,196,185,55,57,43,16,0
40854,243,114,129,37,30,32,8,132,61,71,22,21,15,3,0
40855,840,411,429,122,101,79,34,583,321,262,73,67,45,25,0
40856,128,69,59,29,9,8,1,384,212,172,44,43,34,14,0
40857,1007,353,654,277,147,70,26,464,236,228,64,56,53,28,0
40858,306,172,134,35,31,37,18,169,85,84,21,14,9,9,0
40859,739,389,350,129,61,69,25,335,186,149,40,28,29,13,0
40860,535,217,318,87,106,41,14,629,317,312,80,87,51,22,0
40861,688,310,378,130,82,78,47,963,455,508,127,130,115,48,0
40862,146,73,73,18,24,17,9,392,155,237,68,61,34,16,0
40863,575,305,270,74,87,73,25,87,51,35,15,9,9,4,0
40864,456,214,242,76,62,52,22,531,277,254,82,75,33,22,0
40865,580,265,315,97,89,79,17,710,375,335,95,94,110,28,0
40866,275,160,115,40,31,34,17,144,67,77,28,14,9,8,0
40867,206,100,106,34,26,11,7,902,499,403,118,117,92,35,0
40868,425,198,227,57,69,59,13,699,334,365,108,80,70,20,0
40869,536,287,249,64,73,21,27,376,183,193,50,50,43,21,0
40870,323,156,167,52,45,39,18,498,244,254,81,67,58,19,0
40871,433,188,245,63,45,26,14,201,117,83,22,21,19,9,0
40872,446,265,181,51,35,27,17,2547,1280,1267,331,335,293,118,0
40873,502,229,273,63,66,40,31,103,44,59,16,17,9,5,0
40874,213,88,125,21,54,14,15,312,165,147,41,39,29,16,0
40875,126,58,68,31,10,10,3,337,170,167,59,33,47,17,0
40876,1395,595,800,223,206,113,61,597,300,297,96,89,68,29,0
40877,413,206,207,38,55,19,10,308,146,162,42,39,24,12,0
40878,126,57,69,31,10,10,3,1500,804,696,190,172,144,60,0
40879,98,32,66,15,25,5,4,630,321,309,86,90,57,26,0
40880,330,182,148,47,27,40,11,630,321,309,86,90,57,26,0
40881,302,178,124,34,29,50,13,201,98,103,28,25,19,13,0
40882,1498,731,767,220,175,148,68,1314,693,621,174,155,140,58,0
40883,837,443,394,129,89,87,38,337,170,167,59,33,47,17,0
40884,496,272,224,70,58,42,18,103,50,53,19,10,7,5,0
40885,927,457,470,130,99,118,42,245,121,124,37,35,36,12,0
40886,579,281,298,91,78,74,27,360,180,180,57,48,39,12,0
40887,236,120,116,32,28,21,11,180,108,72,22,22,15,5,0
40888,407,164,243,88,42,40,22,104,46,58,15,17,9,5,0
40889,533,300,233,74,50,74,17,497,227,270,70,63,66,30,0
40890,482,231,251,76,81,64,26,389,210,179,51,37,43,9,0
40891,911,441,470,123,108,60,21,1154,489,665,200,196,95,54,0
40892,126,58,68,31,10,10,3,485,244,241,80,55,59,20,0
40893,221,114,107,65,7,2,1,147,74,73,28,20,24,4,0
40894,1360,644,716,213,194,136,62,279,161,118,37,32,7,7,0
40895,502,229,273,63,66,40,31,132,61,71,22,21,15,3,0
40896,399,220,179,48,37,68,18,862,409,453,149,125,86,29,0
40897,508,267,241,43,35,25,17,811,361,450,124,107,80,31,0
40898,1590,726,864,270,237,126,59,462,229,233,63,49,42,18,0
40899,739,323,416,127,89,76,33,265,134,131,48,34,33,15,0
40900,410,200,210,60,54,46,19,346,196,150,43,26,27,14,0
40901,359,167,192,49,37,27,19,710,375,335,95,94,110,28,0
40902,1161,514,647,159,138,122,37,404,190,214,55,55,35,27,0
40903,217,109,108,30,23,28,10,337,170,167,59,33,47,17,0
40904,480,257,223,74,26,60,27,1062,522,540,151,147,105,66,0
40905,577,342,235,63,57,23,37,127,58,69,18,17,10,5,0
40906,237,127,110,34,30,16,9,363,180,183,60,34,10,6,0
40907,494,233,261,87,57,46,18,335,170,165,52,36,47,11,0
40908,415,133,282,114,65,27,7,406,234,172,63,35,43,10,0
40909,961,465,496,139,156,62,34,449,252,197,61,52,36,18,0
40910,911,445,466,154,121,108,48,337,152,185,49,54,42,21,0
40911,1257,464,793,221,264,75,37,106,46,60,29,13,14,5,0
40912,326,176,150,35,22,29,11,316,166,150,45,38,37,13,0
40913,354,169,185,54,54,41,19,702,358,344,113,87,81,30,0
40914,338,164,174,45,32,37,13,252,130,122,45,23,32,11,0
40915,399,196,203,62,45,38,19,180,108,72,22,22,15,5,0
40916,336,199,137,46,22,51,13,1265,689,576,169,177,128,60,0
40917,350,172,178,61,45,32,13,966,478,488,108,144,74,43,0
40918,1099,491,608,163,141,107,62,204,96,108,31,37,20,5,0
40919,406,208,198,41,26,43,21,68,23,45,12,9,3,9,0
40920,149,78,71,20,20,19,5,531,261,270,73,80,68,26,0
40921,368,154,214,80,52,41,16,729,358,371,116,99,89,33,0
40922,372,171,201,47,53,39,18,594,312,282,72,67,73,31,0
40923,51,10,41,25,0,5,8,127,54,73,11,33,15,6,0
40924,258,130,128,44,37,29,10,374,202,172,50,39,31,24,0
40925,1689,821,868,277,250,177,78,583,280,303,95,66,76,25,0
40926,420,248,172,64,30,43,17,607,293,314,98,71,62,32,0
40927,326,154,172,45,39,20,10,4646,2328,2318,674,639,475,170,0
40928,403,176,227,71,56,51,11,1873,935,938,233,225,203,79,0
40929,756,362,394,102,104,73,25,1061,543,518,146,123,109,67,0
40930,178,89,89,40,12,18,7,180,89,91,28,27,18,7,0
40931,482,245,237,69,64,66,24,660,303,357,97,89,85,33,0
40932,2236,1195,1041,227,187,186,118,194,94,100,33,28,14,7,0
40933,178,74,104,31,28,9,4,374,202,172,50,39,31,24,0
40934,282,135,147,27,37,30,19,654,295,359,99,88,71,25,0
40935,260,133,127,43,29,34,11,399,190,209,61,41,39,18,0
40936,510,288,222,44,36,24,7,1230,644,586,198,125,123,61,0
40937,524,361,163,41,8,28,16,715,345,370,110,97,64,25,0
40938,270,147,123,34,17,39,21,903,436,467,128,116,83,33,0
40939,2442,1193,1249,278,183,170,145,551,226,325,96,103,43,11,0
40940,753,361,392,99,94,66,16,308,129,179,44,60,19,8,0
40941,127,62,65,13,33,7,6,368,204,164,43,35,30,24,0
40942,332,172,160,50,33,35,9,461,223,238,45,62,18,35,0
40943,189,90,99,26,29,17,11,360,188,172,50,50,45,15,0
40944,1439,713,726,195,180,110,34,654,295,359,99,88,71,25,0
40945,579,281,298,91,78,74,27,225,129,96,32,33,20,8,0
40946,235,100,135,36,25,30,8,334,182,152,45,41,27,13,0
40947,932,575,357,94,69,76,40,483,287,196,71,50,54,17,0
40948,474,250,224,58,47,37,12,309,164,145,35,47,30,11,0
40949,279,127,152,50,36,28,8,497,257,240,71,63,62,16,0
40950,193,110,83,18,20,15,12,149,52,97,36,36,7,4,0
40951,2285,1219,1066,207,180,178,106,798,385,413,120,115,79,30,0
40952,560,279,281,113,64,58,15,620,324,296,81,68,66,31,0
40953,221,80,141,48,37,14,10,337,170,167,59,33,47,17,0
40954,461,207,254,82,66,55,33,737,320,417,112,94,73,34,0
40955,350,178,172,49,62,29,16,158,71,87,23,21,17,12,0
40956,426,196,230,76,65,54,20,1395,627,768,172,263,141,59,0
40957,820,333,487,202,152,59,23,145,77,68,26,7,15,8,0
40958,181,75,106,35,26,11,9,340,169,171,40,39,36,22,0
40959,135,64,71,31,11,8,4,132,67,65,24,21,8,10,0
40960,118,56,62,24,12,6,9,415,189,226,68,54,50,21,0
40961,972,501,471,125,156,106,39,761,351,410,117,73,103,45,0
40962,385,179,206,58,56,38,19,1208,565,643,182,162,120,57,0
40963,580,281,299,95,60,74,29,215,115,100,27,19,16,7,0
40964,213,104,109,56,14,9,2,207,86,121,34,39,11,13,0
40965,1087,523,564,146,177,103,33,200,89,111,26,25,17,7,0
40966,344,168,176,50,39,30,20,1262,653,609,169,165,152,50,0
40967,532,291,241,83,36,79,25,935,515,420,126,107,73,32,0
40968,375,201,174,52,56,39,15,462,229,233,63,49,42,18,0
40969,580,281,299,95,60,74,29,166,78,88,27,25,19,7,0
40970,437,212,225,66,44,44,11,240,141,99,34,28,29,8,0
40971,908,324,584,181,162,81,29,1321,653,668,186,195,70,35,0
40972,1390,705,685,219,164,129,74,693,360,333,100,88,62,26,0
40973,157,62,95,41,18,10,11,279,142,137,43,39,28,7,0
40974,441,218,223,69,55,50,27,180,89,91,28,27,18,7,0
40975,546,265,281,101,64,38,16,285,143,142,45,32,21,17,0
40976,482,231,251,76,81,64,26,172,88,84,24,31,20,12,0
40977,504,222,282,71,64,53,29,457,253,204,67,51,48,13,0
40978,432,190,242,85,82,28,11,508,262,246,66,67,51,20,0
40979,622,354,268,89,60,64,18,323,162,161,52,41,39,13,0
40980,478,177,301,109,66,59,25,418,223,195,53,43,49,15,0
40981,272,94,178,76,33,19,4,1020,538,482,145,115,111,58,0
40982,360,175,185,73,36,27,7,314,151,163,42,61,39,16,0
40983,358,206,152,45,38,67,16,354,188,166,46,40,34,10,0
40984,625,283,342,93,89,67,25,1696,771,925,257,225,149,63,0
40985,594,279,315,93,68,68,26,199,92,107,34,30,18,9,0
40986,472,222,250,46,61,33,23,277,145,132,41,32,22,10,0
40987,492,253,239,73,67,77,29,415,226,189,51,40,40,29,0
40988,242,104,138,41,33,37,8,244,143,101,31,29,26,8,0
40989,463,250,213,56,45,73,25,290,142,148,41,37,43,11,0
40990,524,270,254,84,72,70,23,551,226,325,96,103,43,11,0
40991,570,238,332,112,95,39,23,292,155,137,50,34,29,13,0
40992,446,265,181,51,35,27,17,363,180,183,60,34,10,6,0
40993,435,230,205,51,37,55,18,515,276,239,62,59,43,31,0
40994,437,167,270,126,95,34,10,695,264,431,172,114,51,23,0
40995,233,107,126,40,40,20,16,328,199,129,39,29,27,14,0
40996,221,80,141,48,37,14,10,239,113,126,36,49,20,8,0
40997,181,75,106,35,26,11,9,364,192,172,49,36,39,14,0
40998,800,416,384,102,105,83,22,242,121,121,39,30,29,10,0
40999,272,141,131,45,29,36,9,336,200,136,34,29,25,24,0
41000,164,81,83,37,8,14,10,302,150,152,56,40,52,15,0
41001,119,67,52,15,15,7,7,462,229,233,63,49,42,18,0
41002,325,186,139,49,36,20,5,245,131,114,30,27,18,13,0
41003,388,244,144,46,25,42,16,319,185,134,42,31,22,13,0
41004,1342,640,702,187,163,123,57,245,121,124,37,35,36,12,0
41005,433,188,245,63,45,26,14,364,189,175,58,41,35,17,0
41006,3703,1708,1995,456,428,305,162,900,441,459,125,127,110,32,0
41007,384,198,186,58,48,37,12,811,361,450,124,107,80,31,0
41008,753,395,358,93,72,71,16,166,88,78,23,18,13,7,0
41009,485,246,239,74,48,47,22,137,63,74,20,22,14,6,0
41010,253,133,120,44,31,22,8,630,321,309,86,90,57,26,0
41011,426,231,195,51,52,45,24,572,305,267,74,72,58,21,0
41012,376,249,127,47,23,43,16,396,199,197,54,50,45,14,0
41013,535,315,220,57,55,71,19,1182,591,591,155,139,83,46,0
41014,1689,821,868,277,250,177,78,246,107,139,55,33,27,11,0
41015,732,355,377,108,109,79,27,370,190,180,60,52,37,13,0
41016,919,493,426,100,92,88,49,295,156,139,41,40,42,15,0
41017,103,56,47,27,7,8,2,723,353,370,120,109,96,33,0
41018,423,247,176,58,55,29,20,665,361,304,87,91,84,31,0
41019,514,226,288,71,66,63,32,548,273,275,84,81,64,30,0
41020,332,173,159,48,42,42,9,138,69,69,28,7,10,10,0
41021,582,328,254,78,48,35,9,392,155,237,68,61,34,16,0
41022,567,266,301,139,46,76,37,108,59,49,17,13,12,5,0
41023,339,118,221,77,68,33,13,172,88,84,24,31,20,12,0
41024,270,128,142,36,43,15,11,297,164,133,45,39,40,9,0
41025,225,111,114,38,22,25,10,215,115,100,27,19,16,7,0
41026,434,216,218,72,58,40,20,1034,495,539,150,134,114,71,0
41027,265,165,100,32,19,27,5,662,312,350,103,104,59,20,0
41028,76,30,46,7,15,1,5,200,89,111,26,25,17,7,0
41029,169,64,105,23,37,11,3,622,344,278,80,77,68,36,0
41030,933,456,477,123,108,83,29,441,189,252,73,50,47,23,0
41031,763,371,392,104,88,52,23,1507,737,770,188,228,147,71,0
41032,125,57,68,31,10,10,3,708,328,380,113,100,82,34,0
41033,784,351,433,118,87,73,41,583,321,262,73,67,45,25,0
41034,490,198,292,65,81,39,27,1239,659,580,169,148,131,54,0
41035,360,175,185,73,36,27,7,978,536,442,132,107,67,32,0
41036,1689,821,868,277,250,177,78,617,314,303,96,68,68,37,0
41037,887,439,448,137,99,91,38,142,65,77,30,17,22,9,0
41038,961,465,496,139,156,62,34,261,127,134,36,27,36,4,0
41039,465,305,160,40,47,34,9,198,86,112,36,27,23,9,0
41040,432,233,199,52,28,47,18,364,189,175,58,41,35,17,0
41041,343,162,181,65,38,29,12,194,109,85,23,24,21,9,0
41042,260,133,127,43,29,34,11,307,132,175,48,53,26,10,0
41043,258,126,132,38,22,29,8,346,196,150,43,26,27,14,0
41044,736,353,383,117,83,71,18,821,394,427,122,117,109,38,0
41045,502,236,266,66,66,58,17,528,276,252,86,78,49,17,0
41046,228,105,123,34,43,20,10,1395,627,768,172,263,141,59,0
41047,328,195,133,36,23,35,9,323,168,155,51,41,38,12,0
41048,2236,1195,1041,227,187,186,118,171,94,77,24,28,30,11,0
41049,326,148,178,55,42,31,12,309,159,150,47,43,43,13,0
41050,504,222,282,71,64,53,29,732,402,330,81,86,87,33,0
41051,1560,778,782,224,235,132,78,180,108,72,22,22,15,5,0
41052,285,148,137,31,42,42,16,165,90,75,36,18,20,6,0
41053,466,199,267,86,59,32,17,498,244,254,81,67,58,19,0
41054,269,124,145,36,24,32,11,332,173,159,48,40,31,11,0
41055,213,88,125,21,54,14,15,763,418,345,113,84,59,32,0
41056,489,253,236,73,36,62,17,148,84,64,30,7,17,4,0
41057,242,104,138,41,33,37,8,290,142,148,41,37,43,11,0
41058,915,336,579,185,199,56,29,447,212,235,86,55,58,21,0
41059,755,271,484,113,226,61,20,142,73,69,27,9,15,11,0
41060,1849,931,918,245,220,158,90,283,142,141,41,33,26,18,0
41061,1341,481,860,275,264,57,21,622,344,278,80,77,68,36,0
41062,1441,504,937,264,329,69,46,452,231,221,74,53,56,20,0
41063,193,90,103,44,9,19,13,572,305,267,74,72,58,21,0
41064,372,171,201,47,53,39,18,732,402,330,81,86,87,33,0
41065,416,222,194,58,38,38,20,605,283,322,94,72,64,39,0
41066,577,342,235,63,57,23,37,898,469,429,125,125,134,35,0
41067,681,367,314,83,74,78,31,89,38,51,14,6,3,9,0
41068,752,313,439,121,106,68,27,250,119,131,58,26,29,7,0
41069,278,110,168,58,49,29,5,322,180,142,45,38,28,7,0
41070,580,240,340,108,81,59,22,251,143,108,47,25,29,11,0
41071,301,119,182,53,47,14,20,597,269,328,102,84,69,24,0
41072,261,137,124,34,23,13,8,134,72,62,14,28,8,4,0
41073,579,281,298,91,78,74,27,387,193,194,60,53,57,15,0
41074,165,66,99,28,32,16,3,396,213,183,68,44,47,18,0
41075,963,477,486,134,143,123,38,761,351,410,117,73,103,45,0
41076,507,314,193,49,45,59,25,218,115,103,32,32,34,11,0
41077,434,221,213,58,47,54,15,308,146,162,42,39,24,12,0
41078,747,360,387,125,92,69,32,332,180,152,44,36,27,13,0
41079,207,93,114,20,33,19,10,65,32,33,16,4,8,3,0
41080,250,123,127,40,28,29,8,188,101,87,20,18,20,14,0
41081,805,338,467,153,138,99,55,900,441,459,125,127,110,32,0
41082,443,206,237,76,68,52,28,455,191,264,68,86,21,19,0
41083,758,378,380,89,64,37,31,188,101,87,20,18,20,14,0
41084,260,120,140,34,39,36,12,290,147,143,34,34,39,13,0
41085,666,204,462,110,194,42,14,245,121,124,37,35,36,12,0
41086,443,226,217,67,34,53,10,148,69,79,26,18,16,3,0
41087,446,195,251,56,53,31,15,325,172,153,44,34,27,14,0
41088,781,316,465,130,129,65,23,144,67,77,28,14,9,8,0
41089,420,202,218,67,43,51,15,528,276,252,86,78,49,17,0
41090,557,211,346,129,125,48,19,1698,875,823,222,219,173,64,0
41091,149,78,71,20,20,19,5,496,251,245,78,62,61,23,0
41092,377,171,206,46,59,22,6,305,164,141,43,23,47,18,0
41093,233,107,126,40,40,20,16,277,138,139,40,39,20,14,0
41094,314,178,136,42,32,30,17,597,269,328,102,84,69,24,0
41095,346,173,173,50,56,31,14,215,115,100,27,19,16,7,0
41096,184,88,96,15,40,17,8,633,311,322,94,82,45,20,0
41097,583,279,304,99,71,59,31,773,389,384,119,91,79,26,0
41098,521,249,272,53,36,50,18,222,124,98,37,29,22,9,0
41099,636,288,348,94,77,65,30,430,212,218,88,43,40,20,0
41100,431,202,229,57,50,50,25,279,161,118,37,32,7,7,0
41101,1174,594,580,175,155,126,66,1040,564,476,134,110,114,51,0
41102,240,99,141,53,38,29,15,943,463,480,91,144,70,30,0
41103,847,452,395,100,94,81,36,1270,682,588,165,147,136,54,0
41104,1085,646,439,108,65,36,19,348,194,154,57,31,43,12,0
41105,726,312,414,121,73,82,23,710,375,335,95,94,110,28,0
41106,794,322,472,122,108,79,34,386,181,205,55,51,57,31,0
41107,333,171,162,41,44,48,23,309,164,145,35,47,30,11,0
41108,332,172,160,50,33,35,9,455,191,264,68,86,21,19,0
41109,1030,567,463,118,106,94,49,287,151,136,51,42,36,7,0
41110,437,212,225,66,44,44,11,727,362,365,123,107,63,23,0
41111,559,217,342,105,86,42,16,535,311,224,66,52,49,24,0
41112,911,489,422,121,98,97,36,180,115,65,17,12,9,9,0
41113,482,231,251,76,81,64,26,531,277,254,82,75,33,22,0
41114,1594,660,934,251,272,117,77,317,161,156,40,49,41,11,0
41115,963,477,486,134,143,123,38,926,340,586,133,119,60,40,0
41116,184,93,91,26,25,14,11,660,303,357,97,89,85,33,0
41117,342,185,157,42,27,31,14,103,44,59,16,17,9,5,0
41118,476,199,277,82,80,49,24,660,332,328,84,73,47,19,0
41119,532,254,278,91,48,23,17,279,142,137,43,39,28,7,0
41120,785,325,460,114,123,61,28,199,92,107,34,30,18,9,0
41121,371,209,162,46,17,36,19,346,178,168,58,41,33,12,0
41122,494,233,261,87,57,46,18,123,61,62,17,18,17,7,0
41123,181,75,106,35,26,11,9,381,187,194,37,49,36,17,0
41124,654,344,310,80,69,57,15,292,143,149,38,42,36,16,0
41125,436,201,235,54,37,35,18,350,196,154,52,37,21,14,0
41126,1009,487,522,177,121,103,51,332,180,152,46,36,28,14,0
41127,209,75,134,53,48,20,9,423,234,189,66,44,57,12,0
41128,376,171,205,45,45,34,12,296,140,156,49,40,42,19,0
41129,630,231,399,150,83,84,50,704,355,349,113,94,71,24,0
41130,567,266,301,139,46,76,37,2346,1231,1115,316,292,266,105,0
41131,2624,999,1625,415,495,109,84,452,254,198,72,57,38,18,0
41132,257,148,109,28,20,21,14,737,320,417,112,94,73,34,0
41133,435,187,248,62,51,51,21,290,147,143,34,34,39,13,0
41134,180,57,123,39,22,10,8,403,233,170,38,29,21,14,0
41135,118,51,67,25,13,6,7,437,224,213,40,29,42,25,0
41136,490,224,266,80,70,39,32,212,127,85,28,21,26,6,0
41137,548,250,298,85,64,56,21,292,155,137,50,34,29,13,0
41138,202,103,99,28,20,12,8,178,69,109,29,25,21,13,0
41139,128,69,59,29,9,8,1,132,67,65,24,21,8,10,0
41140,2799,1324,1475,369,371,215,124,699,334,365,108,80,70,20,0
41141,429,238,191,47,49,56,29,229,120,109,31,30,22,9,0
41142,595,208,387,157,60,91,48,517,295,222,69,62,40,28,0
41143,278,104,174,46,34,23,14,737,397,340,87,104,90,14,0
41144,196,107,89,20,31,17,4,427,251,176,51,39,25,22,0
41145,853,400,453,137,109,88,42,775,407,368,122,100,97,32,0
41146,136,66,70,33,11,9,4,1507,737,770,188,228,147,71,0
41147,209,75,134,53,48,20,9,89,37,52,13,6,2,9,0
41148,428,226,202,52,60,75,20,317,161,156,50,36,47,12,0
41149,181,75,106,35,26,11,9,528,188,340,130,58,77,41,0
41150,755,271,484,113,226,61,20,98,49,49,14,15,9,2,0
41151,131,69,62,29,9,9,1,492,278,214,65,58,32,11,0
41152,813,412,401,114,93,112,26,218,117,101,35,32,34,12,0
41153,554,217,337,112,72,90,38,319,185,134,42,31,22,13,0
41154,224,101,123,45,32,21,3,245,121,124,37,35,36,12,0
41155,398,186,212,76,70,18,13,290,147,143,34,34,39,13,0
41156,1139,537,602,162,139,109,50,621,310,311,100,106,77,27,0
41157,704,342,362,113,91,85,33,704,355,349,113,94,71,24,0
41158,330,182,148,47,27,40,11,445,192,253,86,58,53,18,0
41159,640,279,361,102,83,69,21,317,161,156,40,49,41,11,0
41160,136,66,70,33,11,9,4,783,406,377,102,91,57,29,0
41161,494,242,252,67,47,25,21,384,204,180,53,47,49,17,0
41162,474,250,224,58,47,37,12,188,101,87,20,18,20,14,0
41163,530,259,271,83,50,54,41,627,323,304,81,90,53,27,0
41164,270,128,142,36,43,15,11,323,171,152,48,41,40,16,0
41165,410,208,202,59,58,43,26,602,310,292,87,66,70,36,0
41166,465,305,160,40,47,34,9,320,168,152,38,42,24,18,0
41167,468,233,235,65,61,49,34,223,113,110,31,33,22,12,0
41168,401,204,197,49,33,29,17,415,205,210,77,52,55,17,0
41169,442,254,188,46,22,40,19,225,111,114,32,34,32,16,0
41170,359,167,192,49,37,27,19,445,202,243,70,73,51,15,0
41171,388,209,179,46,24,31,28,609,335,274,79,57,45,22,0
41172,139,81,58,17,14,24,9,266,150,116,28,28,24,12,0
41173,1009,478,531,166,126,96,42,332,155,177,55,51,44,13,0
41174,341,195,146,42,21,36,9,403,233,170,38,29,21,14,0
41175,529,290,239,54,63,85,15,545,269,276,80,76,27,32,0
41176,202,113,89,16,27,21,11,309,164,145,35,47,30,11,0
41177,1001,422,579,185,180,51,32,593,289,304,85,69,48,19,0
41178,437,228,209,47,61,26,11,526,266,260,76,75,53,22,0
41179,695,343,352,96,78,62,22,420,216,204,57,41,45,14,0
41180,582,328,254,78,48,35,9,727,362,365,123,107,63,23,0
41181,163,70,93,28,21,17,6,621,310,311,100,106,77,27,0
41182,317,167,150,45,21,30,26,1047,562,485,141,127,114,41,0
41183,406,207,199,56,46,68,19,723,363,360,107,106,52,14,0
41184,584,340,244,77,60,47,25,1208,565,643,182,162,120,57,0
41185,414,195,219,51,60,40,17,474,268,206,66,42,45,24,0
41186,315,174,141,46,38,47,16,267,141,126,53,27,23,7,0
41187,4640,2231,2409,660,549,437,245,708,328,380,113,100,82,34,0
41188,1047,443,604,162,156,78,52,335,186,149,40,28,29,13,0
41189,626,300,326,91,82,68,26,346,178,168,58,41,33,12,0
41190,282,160,122,36,28,27,7,335,170,165,52,36,47,11,0
41191,130,70,60,30,9,8,1,475,251,224,67,49,48,23,0
41192,204,93,111,35,35,16,11,497,227,270,70,63,66,30,0
41193,496,209,287,113,55,72,14,89,51,38,15,15,5,4,0
41194,2799,1324,1475,369,371,215,124,555,292,263,75,63,67,27,0
41195,429,227,202,49,51,46,26,429,187,242,79,72,28,19,0
41196,1257,464,793,221,264,75,37,201,98,103,28,25,19,13,0
41197,202,113,89,16,27,21,11,149,77,72,37,10,20,5,0
41198,553,319,234,56,37,54,18,73,35,38,14,10,9,4,0
41199,484,264,220,59,62,68,15,72,32,40,8,2,1,14,0
41200,527,276,251,64,60,70,20,314,151,163,42,61,39,16,0
41201,580,240,340,108,81,59,22,103,59,44,25,2,13,6,0
41202,1594,660,934,251,272,117,77,660,333,327,102,95,69,31,0
41203,423,247,176,58,55,29,20,153,65,88,28,21,20,8,0
41204,51,10,41,25,0,5,8,175,91,84,19,21,21,10,0
41205,412,203,209,65,47,37,18,189,105,84,25,26,21,9,0
41206,374,202,172,58,40,41,7,751,394,357,107,96,73,35,0
41207,726,312,414,121,73,82,23,196,105,91,40,13,19,10,0
41208,251,131,120,49,35,25,5,588,286,302,78,99,53,25,0
41209,439,205,234,64,88,41,21,222,125,97,34,27,27,7,0
41210,375,201,174,52,56,39,15,242,124,118,39,32,28,22,0
41211,150,64,86,22,12,29,12,386,181,205,55,51,57,31,0
41212,640,279,361,102,83,69,21,467,231,236,71,65,58,18,0
41213,682,260,422,153,78,109,46,368,200,168,54,49,43,9,0
41214,911,445,466,154,121,108,48,326,149,177,51,51,28,10,0
41215,468,233,235,65,61,49,34,671,306,365,114,76,49,19,0
41216,142,76,66,21,21,22,11,972,501,471,125,156,106,39,0
41217,828,368,460,118,98,59,38,504,272,232,75,57,53,19,0
41218,502,236,266,66,66,58,17,403,184,219,75,51,47,20,0
41219,361,167,194,55,35,41,11,516,245,271,82,84,70,26,0
41220,692,305,387,100,97,78,30,148,69,79,26,18,16,3,0
41221,528,188,340,130,58,77,41,232,108,124,33,27,19,16,0
41222,854,435,419,118,91,95,42,727,388,339,102,87,70,29,0
41223,298,167,131,47,33,40,8,711,330,381,111,86,86,34,0
41224,251,131,120,49,35,25,5,531,261,270,73,80,68,26,0
41225,334,155,179,47,34,38,11,723,353,370,120,109,96,33,0
41226,595,339,256,64,36,54,24,602,310,292,87,66,70,36,0
41227,629,374,255,74,53,87,27,124,69,55,14,7,9,4,0
41228,388,209,179,46,24,31,28,744,385,359,105,96,57,31,0
41229,206,100,106,34,26,11,7,1755,905,850,214,196,183,79,0
41230,124,58,66,20,28,11,7,545,269,276,80,76,27,32,0
41231,441,216,225,57,66,57,19,180,95,85,22,21,17,8,0
41232,305,124,181,27,25,31,21,541,279,262,79,82,31,32,0
41233,364,172,192,55,57,32,15,389,210,179,51,37,43,9,0
41234,435,225,210,58,46,50,14,222,124,98,37,29,22,9,0
41235,5890,3314,2576,970,956,293,265,497,227,270,70,63,66,30,0
41236,516,210,306,113,53,81,33,758,319,439,101,123,78,25,0
41237,414,216,198,51,32,42,28,660,333,327,102,95,69,31,0
41238,552,295,257,67,49,70,30,241,127,114,34,33,29,12,0
41239,711,330,381,111,86,86,34,230,125,105,29,40,20,6,0
41240,580,308,272,82,79,58,25,158,71,87,23,21,17,12,0
41241,1499,864,635,141,99,76,110,246,107,139,55,33,27,11,0
41242,685,393,292,75,66,113,16,611,314,297,79,75,78,22,0
41243,952,547,405,95,90,127,35,605,283,322,94,72,64,39,0
41244,458,210,248,39,38,25,16,391,189,202,55,56,56,12,0
41245,1505,680,825,202,204,73,32,455,191,264,68,86,21,19,0
41246,401,183,218,72,73,28,10,732,366,366,108,86,74,41,0
41247,1960,875,1085,287,189,162,66,766,386,380,101,81,78,31,0
41248,828,368,460,118,98,59,38,858,398,460,126,138,75,39,0
41249,627,237,390,137,57,108,44,470,205,265,71,80,33,11,0
41250,179,96,83,24,8,26,4,627,289,338,101,73,62,43,0
41251,121,69,52,15,18,14,8,199,105,94,27,27,28,9,0
41252,238,158,80,28,15,31,7,285,146,139,41,41,48,13,0
41253,1014,488,526,178,137,94,39,474,268,206,66,42,45,24,0
41254,372,171,201,47,53,39,18,2547,1280,1267,331,335,293,118,0
41255,436,209,227,66,47,52,22,515,276,239,62,59,43,31,0
41256,127,55,72,25,18,5,7,548,296,252,71,74,43,28,0
41257,1365,590,775,257,168,136,93,287,151,136,51,42,36,7,0
41258,530,259,271,83,50,54,41,374,191,183,40,52,40,16,0
41259,143,81,62,28,9,8,1,1214,475,739,177,250,89,49,0
41260,433,188,245,63,45,26,14,662,312,350,103,104,59,20,0
41261,346,209,137,46,37,44,10,729,358,371,116,99,89,33,0
41262,461,257,204,63,49,50,29,218,117,101,35,32,34,12,0
41263,485,237,248,83,35,52,24,277,124,153,44,40,35,18,0
41264,933,456,477,123,108,83,29,1034,495,539,150,134,114,71,0
41265,766,336,430,133,97,79,21,396,197,199,75,49,49,16,0
41266,269,156,113,37,32,17,7,277,145,132,41,32,22,10,0
41267,800,416,384,102,105,83,22,453,247,206,58,53,45,20,0
41268,646,304,342,104,93,58,26,507,270,237,89,59,57,22,0
41269,122,56,66,26,13,11,5,231,126,105,37,26,29,6,0
41270,763,354,409,101,90,63,26,1114,539,575,145,131,94,56,0
41271,666,204,462,110,194,42,14,334,182,152,45,41,27,13,0
41272,328,156,172,44,37,44,15,215,115,100,27,19,16,7,0
41273,308,163,145,38,33,30,20,103,59,44,25,2,13,6,0
41274,225,111,114,38,22,25,10,213,129,84,32,14,21,15,0
41275,616,304,312,75,71,55,25,319,185,134,42,31,22,13,0
41276,376,171,205,45,45,34,12,103,44,59,16,17,9,5,0
41277,156,64,92,31,19,5,4,332,180,152,44,36,27,13,0
41278,356,199,157,36,43,28,12,339,175,164,51,49,37,9,0
41279,347,154,193,48,51,25,11,561,279,282,85,81,88,24,0
41280,2414,1189,1225,277,178,170,169,352,194,158,66,35,51,11,0
41281,360,205,155,35,24,52,14,514,262,252,78,58,54,26,0
41282,359,204,155,39,36,34,13,663,360,303,87,82,80,35,0
41283,852,472,380,99,79,70,27,390,223,167,58,36,45,18,0
41284,178,87,91,20,32,13,10,65,32,33,16,4,8,3,0
41285,313,134,179,58,37,43,19,1338,720,618,179,145,141,85,0
41286,416,222,194,58,38,38,20,207,114,93,33,20,31,13,0
41287,261,130,131,27,41,19,16,530,287,243,79,70,33,26,0
41288,436,201,235,54,37,35,18,729,358,371,116,99,89,33,0
41289,562,214,348,120,86,69,42,98,49,49,14,15,9,2,0
41290,431,245,186,50,23,46,17,165,90,75,36,18,20,6,0
41291,135,64,71,31,11,8,4,501,240,261,80,62,49,42,0
41292,532,254,278,91,48,23,17,664,350,314,86,90,82,36,0
41293,193,83,110,26,20,16,9,101,41,60,18,19,10,5,0
41294,346,174,172,36,43,21,9,231,126,105,37,26,29,6,0
41295,346,209,137,46,37,44,10,207,113,94,33,18,30,9,0
41296,143,81,62,28,9,8,1,598,325,273,67,53,61,16,0
41297,860,348,512,121,136,75,35,425,177,248,60,62,33,16,0
41298,654,344,310,80,69,57,15,415,203,212,77,44,49,18,0
41299,323,156,167,52,45,39,18,188,105,83,25,17,24,7,0
41300,454,214,240,56,71,35,16,474,268,206,66,42,45,24,0
41301,347,181,166,27,20,12,12,2542,1245,1297,285,287,170,84,0
41302,524,270,254,84,72,70,23,104,46,58,15,17,9,5,0
41303,344,109,235,100,39,26,5,647,324,323,101,80,76,43,0
41304,483,236,247,82,60,43,18,225,114,111,32,29,26,6,0
41305,629,374,255,74,53,87,27,858,398,460,126,138,75,39,0
41306,178,89,89,40,12,18,7,594,312,282,72,67,73,31,0
41307,202,113,89,16,27,21,11,267,141,126,53,27,23,7,0
41308,199,107,92,41,15,14,8,404,190,214,55,55,35,27,0
41309,138,35,103,38,2,15,9,301,168,133,49,37,34,11,0
41310,155,85,70,17,16,4,8,348,212,136,53,31,25,18,0
41311,288,104,184,80,30,39,6,370,173,197,65,57,42,10,0
41312,598,322,276,67,57,63,26,132,77,55,20,9,13,10,0
41313,424,170,254,69,56,47,28,334,182,152,45,41,27,13,0
41314,291,131,160,49,35,32,15,496,251,245,78,62,61,23,0
41315,326,154,172,45,39,20,10,89,42,47,16,12,15,6,0
41316,82,36,46,17,10,5,1,720,361,359,98,98,70,37,0
41317,648,262,386,113,108,78,29,810,310,500,164,162,42,26,0
41318,1226,513,713,184,147,87,43,821,394,427,122,117,109,38,0
41319,427,191,236,67,60,41,34,555,292,263,75,63,67,27,0
41320,571,298,273,81,72,57,25,276,149,127,34,31,32,10,0
41321,631,316,315,64,57,49,15,103,50,53,19,10,7,5,0
41322,972,501,471,125,156,106,39,963,525,438,119,102,102,34,0
41323,462,228,234,59,47,37,32,1755,905,850,214,196,183,79,0
41324,127,54,73,31,10,11,3,873,411,462,132,107,84,40,0
41325,1327,520,807,241,174,141,60,1338,720,618,179,145,141,85,0
41326,339,118,221,77,68,33,13,536,267,269,60,70,41,22,0
41327,253,133,120,44,31,22,8,86,40,46,16,13,9,7,0
41328,272,173,99,32,32,11,8,958,451,507,165,135,97,41,0
41329,785,374,411,56,42,38,25,329,194,135,45,32,33,9,0
41330,331,177,154,54,38,27,11,1241,619,622,183,169,155,59,0
41331,217,109,108,30,23,28,10,334,181,153,41,40,25,15,0
41332,665,341,324,109,79,38,22,1166,514,652,150,159,107,70,0
41333,395,219,176,47,41,50,18,1239,659,580,169,148,131,54,0
41334,160,53,107,31,29,13,3,579,285,294,78,72,64,32,0
41335,225,111,114,38,22,25,10,423,234,189,66,44,57,12,0
41336,258,130,128,44,37,29,10,360,185,175,51,43,36,16,0
41337,362,181,181,67,46,43,8,748,359,389,125,113,86,31,0
41338,1555,702,853,250,199,139,31,1034,495,539,150,134,114,71,0
41339,330,77,253,86,52,20,12,627,323,304,81,90,53,27,0
41340,159,105,54,22,9,14,25,715,348,367,109,84,68,30,0
41341,439,183,256,60,64,36,14,322,180,142,45,38,28,7,0
41342,496,209,287,113,55,72,14,424,179,245,65,67,29,11,0
41343,860,349,511,166,166,58,19,362,156,206,74,42,36,22,0
41344,346,205,141,47,34,30,7,173,86,87,30,22,19,12,0
41345,367,167,200,63,42,60,17,370,173,197,65,57,42,10,0
41346,407,230,177,44,39,34,19,198,115,83,30,22,8,8,0
41347,630,231,399,150,83,84,50,335,186,149,40,28,29,13,0
41348,407,164,243,88,42,40,22,166,88,78,23,18,13,7,0
41349,306,172,134,35,31,37,18,748,359,389,125,113,86,31,0
41350,625,283,342,93,89,67,25,188,105,83,25,17,24,7,0
41351,341,177,164,57,42,40,18,483,287,196,71,50,54,17,0
41352,90,54,36,20,4,14,5,549,273,276,74,68,72,24,0
41353,258,130,128,44,37,29,10,408,221,187,55,51,57,14,0
41354,1755,849,906,245,226,148,56,441,189,252,73,50,47,23,0
41355,378,202,176,34,32,44,13,821,394,427,122,117,109,38,0
41356,130,71,59,30,9,8,1,265,134,131,48,34,33,15,0
41357,1220,575,645,208,179,99,56,763,418,345,113,84,59,32,0
41358,933,456,477,123,108,83,29,312,165,147,41,39,29,16,0
41359,231,105,126,56,10,24,10,415,203,212,77,44,49,18,0
41360,312,164,148,54,29,25,15,104,46,58,15,17,9,5,0
41361,380,187,193,38,51,30,18,373,181,192,54,35,44,20,0
41362,454,230,224,63,56,38,33,285,146,139,41,41,48,13,0
41363,784,351,433,118,87,73,41,729,358,371,116,99,89,33,0
41364,281,125,156,44,47,17,7,557,281,276,80,59,43,21,0
41365,253,133,120,44,31,22,8,277,144,133,42,30,41,8,0
41366,161,99,62,15,22,9,7,201,117,83,22,21,19,9,0
41367,226,120,106,68,8,2,1,2346,1231,1115,316,292,266,105,0
41368,462,233,229,66,49,43,30,257,139,118,64,17,24,7,0
41369,213,114,99,62,7,2,1,72,34,38,8,2,3,12,0
41370,772,417,355,118,92,80,23,189,95,94,25,33,16,8,0
41371,625,283,342,93,89,67,25,889,505,384,107,97,99,30,0
41372,117,57,60,17,14,11,10,256,141,115,32,22,32,8,0
41373,532,291,241,83,36,79,25,455,191,264,68,86,21,19,0
41374,136,65,71,33,11,9,6,501,257,244,75,57,48,29,0
41375,972,501,471,125,156,106,39,818,357,461,122,136,54,25,0
41376,124,58,66,20,28,11,7,1507,737,770,188,228,147,71,0
41377,1447,698,749,214,180,116,46,572,305,267,74,72,58,21,0
41378,329,165,164,61,44,29,17,354,188,166,46,40,34,10,0
41379,496,272,224,70,58,42,18,507,270,237,89,59,57,22,0
41380,421,237,184,47,54,45,10,902,499,403,118,117,92,35,0
41381,674,268,406,118,96,70,21,230,113,117,31,40,28,10,0
41382,1199,589,610,189,128,167,65,1500,804,696,190,172,144,60,0
41383,344,168,176,50,39,30,20,96,46,50,16,12,7,5,0
41384,333,171,162,50,34,19,8,108,59,49,17,13,12,5,0
41385,1085,646,439,108,65,36,19,415,189,226,68,54,50,21,0
41386,380,148,232,81,69,24,8,332,155,177,55,51,44,13,0
41387,222,110,112,43,30,14,6,548,273,275,84,81,64,30,0
41388,1439,713,726,195,180,110,34,323,162,161,52,41,39,13,0
41389,919,493,426,100,92,88,49,966,478,488,108,144,74,43,0
41390,494,233,261,87,57,46,18,483,215,268,66,70,30,16,0
41391,323,156,167,52,45,39,18,279,161,118,37,32,7,7,0
41392,526,268,258,54,37,55,12,810,310,500,164,162,42,26,0
41393,371,209,162,46,17,36,19,180,89,91,28,27,18,7,0
41394,502,250,252,70,47,57,15,1321,653,668,186,195,70,35,0
41395,346,168,178,36,43,20,9,565,237,328,75,88,32,11,0
41396,270,130,140,43,24,36,10,245,131,114,30,27,18,13,0
41397,1616,735,881,285,248,153,72,260,131,129,42,31,40,9,0
41398,240,167,73,32,12,8,21,131,55,76,28,9,14,12,0
41399,215,80,135,54,56,21,9,381,196,185,55,57,43,16,0
41400,244,104,140,52,31,30,14,609,335,274,79,57,45,22,0
41401,291,142,149,50,29,35,7,330,166,164,55,51,36,16,0
41402,406,207,199,56,46,68,19,555,292,263,75,63,67,27,0
41403,126,56,70,31,10,10,3,392,214,178,48,40,53,22,0
41404,446,174,272,84,61,57,23,559,317,242,58,65,37,23,0
41405,288,104,184,80,30,39,6,516,245,271,82,84,70,26,0
41406,577,342,235,63,57,23,37,222,125,97,34,27,27,7,0
41407,594,321,273,98,59,57,23,283,142,141,41,33,26,18,0
41408,269,127,142,43,24,34,26,201,99,102,34,26,23,6,0
41409,478,177,301,109,66,59,25,1314,693,621,174,155,140,58,0
41410,392,221,171,53,30,25,8,405,214,191,53,42,49,20,0
41411,915,336,579,185,199,56,29,89,38,51,14,6,3,9,0
41412,1009,487,522,177,121,103,51,818,357,461,122,136,54,25,0
41413,272,94,178,76,33,19,4,561,279,282,85,81,88,24,0
41414,361,167,194,55,35,41,11,396,197,199,75,49,49,16,0
41415,1718,735,983,266,225,130,68,536,267,269,60,70,41,22,0
41416,919,493,426,100,92,88,49,763,418,345,113,84,59,32,0
41417,577,342,235,63,57,23,37,556,290,266,75,74,29,24,0
41418,952,547,405,95,90,127,35,68,36,32,11,8,9,2,0
41419,626,308,318,105,89,77,25,348,212,136,53,31,25,18,0
41420,473,212,261,72,64,45,28,341,170,171,41,66,27,10,0
41421,785,351,434,136,93,71,37,105,51,54,13,17,12,8,0
41422,1257,464,793,221,264,75,37,282,134,148,38,45,29,10,0
41423,682,260,422,153,78,109,46,172,88,84,24,31,20,12,0
41424,503,260,243,46,56,33,16,334,181,153,41,40,25,15,0
41425,479,227,252,69,48,46,18,91,42,49,21,9,8,3,0
41426,119,57,62,18,16,17,4,118,63,55,19,12,15,7,0
41427,305,124,181,27,25,31,21,152,71,81,41,16,14,2,0
41428,193,90,103,44,9,19,13,290,147,143,34,34,39,13,0
41429,203,80,123,40,37,20,3,234,129,105,31,22,19,17,0
41430,283,172,111,39,31,29,8,207,114,93,33,20,31,13,0
41431,143,81,62,28,9,8,1,223,113,110,31,33,22,12,0
41432,493,281,212,56,61,30,13,904,436,468,143,118,108,32,0
41433,616,323,293,98,71,31,15,377,184,193,50,43,33,17,0
41434,282,135,147,27,37,30,19,277,152,125,31,35,22,19,0
41435,326,148,178,55,42,31,12,622,344,278,80,77,68,36,0
41436,579,281,298,91,78,74,27,395,198,197,55,55,36,10,0
41437,494,242,252,67,47,25,21,720,361,359,98,98,70,37,0
41438,1186,495,691,182,208,88,32,139,68,71,14,26,14,9,0
41439,326,156,170,60,47,43,5,432,188,244,76,81,26,13,0
41440,584,297,287,89,80,65,17,256,141,115,32,22,32,8,0
41441,217,98,119,38,35,18,9,966,478,488,108,144,74,43,0
41442,290,156,134,44,29,39,9,201,104,97,36,32,24,7,0
41443,200,103,97,17,16,10,10,720,361,359,98,98,70,37,0
41444,860,348,512,121,136,75,35,207,86,121,34,39,11,13,0
41445,1220,575,645,208,179,99,56,89,42,47,16,12,15,6,0
41446,275,125,150,37,48,27,7,328,199,129,39,29,27,14,0
41447,753,395,358,93,72,71,16,290,142,148,41,37,43,11,0
41448,421,219,202,68,57,56,13,585,277,308,92,73,61,32,0
41449,476,199,277,82,80,49,24,328,195,133,39,40,27,13,0
41450,650,330,320,97,77,65,28,314,177,137,34,40,29,9,0
41451,232,134,98,28,20,20,5,389,210,179,51,37,43,9,0
41452,983,449,534,95,77,55,36,1338,720,618,179,145,141,85,0
41453,92,46,46,14,9,8,6,410,197,213,67,43,56,18,0
41454,410,208,202,59,58,43,26,299,140,159,49,44,26,11,0
41455,869,489,380,110,77,79,29,144,67,77,28,14,9,8,0
41456,421,219,202,68,57,56,13,173,90,83,30,19,19,11,0
41457,915,336,579,185,199,56,29,201,104,97,36,32,24,7,0
41458,798,287,511,126,125,77,26,296,151,145,45,42,32,11,0
41459,4640,2231,2409,660,549,437,245,368,200,168,54,49,43,9,0
41460,1360,644,716,213,194,136,62,288,156,132,36,36,24,15,0
41461,560,279,281,113,64,58,15,173,90,83,21,36,12,15,0
41462,595,316,279,86,60,65,40,335,186,149,40,28,29,13,0
41463,159,105,54,22,9,14,25,166,88,78,23,18,13,7,0
41464,346,186,160,40,37,34,21,218,111,107,45,29,24,6,0
41465,3230,1724,1506,361,358,157,75,732,402,330,81,86,87,33,0
41466,315,111,204,82,66,46,11,296,151,145,45,42,32,11,0
41467,359,167,192,49,37,27,19,389,210,179,51,37,43,9,0
41468,126,58,68,31,10,10,3,189,95,94,25,33,16,8,0
41469,747,360,387,125,92,69,32,415,226,189,51,40,40,29,0
41470,789,362,427,90,82,70,35,148,84,64,30,7,17,4,0
41471,374,187,187,51,52,40,27,520,244,276,91,60,68,20,0
41472,325,181,144,46,31,48,9,171,94,77,24,28,30,11,0
41473,369,166,203,59,55,41,14,662,373,289,89,80,77,29,0
41474,462,258,204,59,41,56,15,72,32,40,8,2,2,13,0
41475,958,451,507,165,135,97,41,195,100,95,27,20,17,11,0
41476,1148,472,676,229,164,86,37,144,67,77,28,14,9,8,0
41477,240,167,73,32,12,8,21,152,71,81,41,16,14,2,0
41478,654,344,310,80,69,57,15,107,77,30,7,2,9,5,0
41479,447,236,211,56,52,49,14,222,127,95,23,28,22,7,0
41480,1009,487,522,177,121,103,51,364,189,175,58,41,35,17,0
41481,305,124,181,27,25,31,21,179,101,78,25,15,13,13,0
41482,587,318,269,76,50,38,21,396,223,173,57,37,44,19,0
41483,136,66,70,33,11,9,4,415,226,189,51,40,40,29,0
41484,1043,479,564,200,131,123,62,104,46,58,15,17,9,5,0
41485,1336,724,612,209,141,133,60,322,180,142,45,38,28,7,0
41486,196,107,89,20,31,17,4,246,125,121,38,36,30,11,0
41487,298,141,157,51,33,21,22,297,175,122,46,30,31,6,0
41488,206,100,106,34,26,11,7,111,60,51,17,23,10,7,0
41489,126,56,70,31,10,10,3,972,471,501,152,138,112,40,0
41490,213,104,109,56,14,9,2,396,223,173,57,37,44,19,0
41491,251,131,120,49,35,25,5,715,348,367,109,84,68,30,0
41492,532,254,278,91,48,23,17,531,261,270,73,80,68,26,0
41493,309,137,172,51,50,28,14,557,281,276,80,59,43,21,0
41494,911,489,422,121,98,97,36,395,198,197,55,55,36,10,0
41495,415,133,282,114,65,27,7,299,140,159,49,44,26,11,0
41496,665,341,324,109,79,38,22,198,113,85,19,20,26,12,0
41497,457,261,196,55,27,57,34,165,90,75,36,18,20,6,0
41498,507,242,265,53,44,31,22,374,191,183,40,52,40,16,0
41499,213,114,99,62,7,2,1,309,164,145,35,47,30,11,0
41500,898,397,501,102,98,54,37,332,180,152,46,36,28,14,0
41501,525,302,223,56,48,67,19,385,212,173,57,40,39,21,0
41502,802,430,372,65,102,87,23,132,67,65,24,21,8,10,0
41503,1186,495,691,182,208,88,32,367,199,168,62,44,34,8,0
41504,158,85,73,24,18,18,8,314,151,163,42,61,39,16,0
41505,128,69,59,29,9,8,1,727,362,365,123,107,63,23,0
41506,371,209,162,46,17,36,19,175,91,84,19,21,21,10,0
41507,688,310,378,130,82,78,47,582,264,318,84,60,58,23,0
41508,574,269,305,91,63,54,27,328,199,129,39,29,27,14,0
41509,181,75,106,35,26,11,9,649,307,342,71,134,45,17,0
41510,280,156,124,36,19,20,13,661,325,336,81,75,65,28,0
41511,375,167,208,55,83,44,9,201,99,102,34,26,23,6,0
41512,364,168,196,64,61,27,6,374,191,183,40,52,40,16,0
41513,125,46,79,24,16,12,2,375,176,199,48,61,40,12,0
41514,763,354,409,101,90,63,26,296,151,145,45,42,32,11,0
41515,979,534,445,83,77,80,24,282,134,148,38,45,29,10,0
41516,505,247,258,72,71,60,27,89,42,47,16,12,15,6,0
41517,474,243,231,66,54,41,29,204,96,108,31,37,20,5,0
41518,585,277,308,92,73,61,32,531,277,254,82,75,33,22,0
41519,156,64,92,31,19,5,4,1698,875,823,222,219,173,64,0
41520,509,246,263,84,71,56,22,200,99,101,31,24,26,6,0
41521,165,66,99,28,32,16,3,496,285,211,62,54,46,22,0
41522,376,249,127,47,23,43,16,88,50,38,13,8,16,4,0
41523,474,250,224,58,47,37,12,244,143,101,31,29,26,8,0
41524,2525,1232,1293,398,317,186,61,283,142,141,41,33,26,18,0
41525,529,290,239,54,63,85,15,430,212,218,88,43,40,20,0
41526,107,36,71,27,15,0,1,732,402,330,81,86,87,33,0
41527,282,96,186,80,21,28,7,286,152,134,38,38,32,11,0
41528,1647,794,853,279,235,128,65,303,137,166,54,54,31,15,0
41529,126,58,68,31,10,10,3,314,177,137,34,40,29,9,0
41530,747,360,387,125,92,69,32,271,150,121,39,36,37,5,0
41531,550,304,246,60,64,77,16,194,109,85,23,24,21,9,0
41532,649,304,345,99,80,67,40,68,23,45,12,9,3,9,0
41533,126,56,70,31,10,10,3,285,146,139,41,41,48,13,0
41534,478,177,301,109,66,59,25,660,303,357,97,89,85,33,0
41535,941,459,482,167,140,82,38,277,144,133,42,30,41,8,0
41536,525,302,223,56,48,67,19,123,61,62,17,18,17,7,0
41537,593,282,311,75,70,29,25,483,215,268,66,70,30,16,0
41538,291,146,145,39,45,22,16,275,155,120,37,31,16,14,0
41539,685,393,292,75,66,113,16,381,186,195,69,55,46,15,0
41540,411,211,200,61,46,35,18,218,118,100,33,30,25,11,0
41541,159,105,54,22,9,14,25,222,127,95,23,28,22,7,0
41542,482,231,251,76,81,64,26,65,32,33,16,4,8,3,0
41543,172,98,74,20,21,22,8,374,202,172,50,39,31,24,0
41544,121,69,52,15,18,14,8,900,441,459,125,127,110,32,0
41545,291,131,160,49,35,32,15,178,99,79,31,19,26,8,0
41546,130,72,58,28,9,7,1,301,168,133,49,37,34,11,0
41547,492,253,239,73,67,77,29,756,348,408,101,103,60,40,0
41548,361,183,178,50,54,51,22,504,272,232,75,57,53,19,0
41549,785,325,460,114,123,61,28,858,398,460,126,138,75,39,0
41550,492,253,239,73,67,77,29,1382,508,874,334,320,98,36,0
41551,312,164,148,54,29,25,15,139,68,71,14,26,14,9,0
41552,160,53,107,31,29,13,3,535,311,224,66,52,49,24,0
41553,411,236,175,39,45,50,30,671,306,365,114,76,49,19,0
41554,1226,513,713,184,147,87,43,198,110,88,27,27,24,4,0
41555,331,165,166,52,34,48,22,225,114,111,32,29,26,6,0
41556,119,59,60,29,10,6,4,200,99,101,31,24,26,6,0
41557,280,156,124,36,19,20,13,381,196,185,55,57,43,16,0
41558,341,154,187,34,36,11,11,720,361,359,98,98,70,37,0
41559,1099,491,608,163,141,107,62,403,185,218,67,62,63,19,0
41560,193,107,86,13,20,13,6,127,64,63,26,8,12,8,0
41561,260,136,124,24,41,19,4,250,116,134,41,30,33,19,0
41562,421,219,202,68,57,56,13,232,108,124,33,27,19,16,0
41563,186,56,130,46,50,16,7,663,354,309,91,84,79,31,0
41564,221,75,146,68,21,16,5,406,234,172,63,35,43,10,0
41565,822,416,406,111,97,88,42,207,113,94,33,18,30,9,0
41566,260,133,127,43,29,34,11,405,181,224,71,57,31,12,0
41567,571,298,273,81,72,57,25,516,245,271,82,84,70,26,0
41568,262,133,129,44,38,31,12,375,209,166,50,37,29,23,0
41569,682,260,422,98,83,42,31,329,196,133,41,36,31,15,0
41570,863,418,445,127,114,70,31,711,330,381,111,86,86,34,0
41571,739,389,350,129,61,69,25,434,213,221,77,62,53,12,0
41572,359,167,192,49,37,27,19,536,267,269,60,70,41,22,0
41573,416,222,194,58,38,38,20,257,126,131,61,24,22,8,0
41574,181,92,89,34,22,17,9,178,69,109,29,25,21,13,0
41575,536,287,249,64,73,21,27,557,281,276,80,59,43,21,0
41576,109,42,67,25,13,1,1,536,267,269,60,70,41,22,0
41577,1439,713,726,195,180,110,34,904,436,468,143,118,108,32,0
41578,106,43,63,28,13,8,1,341,170,171,41,66,27,10,0
41579,1616,735,881,285,248,153,72,1061,543,518,146,123,109,67,0
41580,349,131,218,66,76,22,9,127,54,73,11,33,15,6,0
41581,732,355,377,108,109,79,27,279,161,118,37,32,7,7,0
41582,213,104,109,56,14,9,2,188,88,100,53,12,15,6,0
41583,622,299,323,86,86,69,35,491,233,258,73,58,56,30,0
41584,458,226,232,77,59,61,14,89,37,52,13,6,2,9,0
41585,399,196,203,62,45,38,19,297,164,133,45,39,40,9,0
41586,700,305,395,111,99,54,18,54,26,28,11,4,3,3,0
41587,441,216,225,57,66,57,19,565,237,328,75,88,32,11,0
41588,1912,880,1032,331,334,180,84,178,99,79,31,19,26,8,0
41589,579,281,298,91,78,74,27,579,285,294,78,72,64,32,0
41590,860,348,512,121,136,75,35,1166,514,652,150,159,107,70,0
41591,580,281,299,95,60,74,29,105,51,54,13,17,12,8,0
41592,552,295,257,67,49,70,30,437,224,213,40,29,42,25,0
41593,710,352,358,104,86,84,41,54,26,28,11,4,3,3,0
41594,707,250,457,171,84,117,61,366,204,162,47,41,31,23,0
41595,1235,584,651,140,226,82,52,873,411,462,132,107,84,40,0
41596,626,308,318,105,89,77,25,1262,653,609,169,165,152,50,0
41597,711,330,381,111,86,86,34,297,175,122,46,30,31,6,0
41598,92,46,46,14,9,8,6,180,115,65,17,12,9,9,0
41599,525,254,271,60,76,46,13,1321,653,668,186,195,70,35,0
41600,82,36,46,17,10,5,1,334,181,153,41,40,25,15,0
41601,130,70,60,30,9,8,1,898,469,429,125,125,134,35,0
41602,582,328,254,78,48,35,9,607,293,314,98,71,62,32,0
41603,911,489,422,121,98,97,36,218,117,101,35,32,34,12,0
41604,453,240,213,53,33,44,16,445,192,253,86,58,53,18,0
41605,269,127,142,43,24,34,26,974,457,517,133,117,69,26,0
41606,736,353,383,117,83,71,18,405,181,224,71,57,31,12,0
41607,553,319,234,56,37,54,18,629,317,312,80,87,51,22,0
41608,434,216,218,72,58,40,20,137,78,59,22,16,17,4,0
41609,336,199,137,46,22,51,13,299,140,159,49,44,26,11,0
41610,262,133,129,44,38,31,12,89,51,38,15,15,5,4,0
41611,398,186,212,76,70,18,13,188,90,98,44,7,21,7,0
41612,346,168,178,36,43,20,9,902,499,403,118,117,92,35,0
41613,348,198,150,57,25,37,18,1230,644,586,198,125,123,61,0
41614,531,259,272,75,81,39,13,137,63,74,20,22,14,6,0
41615,1214,612,602,169,173,98,35,903,436,467,128,116,83,33,0
41616,318,164,154,52,43,34,10,194,109,85,23,24,21,9,0
41617,654,344,310,80,69,57,15,751,394,357,107,96,73,35,0
41618,169,64,105,23,37,11,3,375,176,199,48,61,40,12,0
41619,338,173,165,31,42,22,10,180,95,85,22,21,17,8,0
41620,557,250,307,70,47,51,22,137,85,52,15,11,11,2,0
41621,710,352,358,104,86,84,41,103,50,53,19,10,7,5,0
41622,415,133,282,114,65,27,7,873,411,462,132,107,84,40,0
41623,528,273,255,67,53,29,20,966,478,488,108,144,74,43,0
41624,211,92,119,33,44,11,7,482,232,250,77,81,44,13,0
41625,1054,497,557,190,168,107,45,403,185,218,67,62,63,19,0
41626,213,114,99,62,7,2,1,225,111,114,32,34,32,16,0
41627,479,228,251,71,57,60,14,966,478,488,108,144,74,43,0
41628,150,64,86,22,12,29,12,593,289,304,85,69,48,19,0
41629,162,73,89,32,19,4,4,142,73,69,27,9,15,11,0
41630,457,228,229,64,36,52,21,2382,1162,1220,237,220,140,49,0
41631,372,189,183,60,44,41,18,376,189,187,47,53,44,26,0
41632,468,233,235,65,61,49,34,292,155,137,50,34,29,13,0
41633,125,57,68,31,10,10,3,179,101,78,25,15,13,13,0
41634,919,444,475,141,148,62,20,204,80,124,29,51,10,5,0
41635,417,222,195,53,39,43,10,508,253,255,73,60,50,13,0
41636,543,265,278,52,37,54,19,325,159,166,59,46,30,12,0
41637,224,108,116,33,26,32,10,1214,475,739,177,250,89,49,0
41638,124,58,66,20,28,11,7,517,295,222,69,62,40,28,0
41639,516,224,292,79,29,45,33,903,436,467,128,116,83,33,0
41640,217,98,119,38,35,18,9,247,128,119,34,14,16,14,0
41641,136,66,70,33,11,9,5,557,281,276,80,59,43,21,0
41642,361,167,194,55,35,41,11,1239,659,580,169,148,131,54,0
41643,286,111,175,51,47,21,12,173,86,87,30,22,19,12,0
41644,1327,520,807,241,174,141,60,137,72,65,27,13,15,8,0
41645,482,245,237,69,64,66,24,647,324,323,101,80,76,43,0
41646,315,170,145,48,56,22,11,514,262,252,78,58,54,26,0
41647,395,195,200,41,55,23,10,515,276,239,62,59,43,31,0
41648,401,236,165,53,38,34,9,600,254,346,104,100,44,17,0
41649,473,217,256,59,44,34,21,305,161,144,39,40,44,17,0
41650,221,114,107,65,7,2,1,264,138,126,33,34,29,12,0
41651,378,202,176,34,32,44,13,555,282,273,82,69,65,21,0
41652,1560,778,782,224,235,132,78,399,190,209,61,41,39,18,0
41653,957,381,576,184,158,86,48,219,105,114,36,29,19,8,0
41654,242,104,138,41,33,37,8,467,226,241,55,48,54,23,0
41655,359,198,161,51,28,54,13,336,190,146,52,30,41,6,0
41656,478,220,258,47,70,41,10,385,212,173,57,40,39,21,0
41657,410,188,222,53,52,31,14,535,301,234,63,48,47,27,0
41658,1544,738,806,239,217,145,91,423,234,189,66,44,57,12,0
41659,125,53,72,18,21,18,12,403,192,211,102,39,49,15,0
41660,461,257,204,63,49,50,29,106,46,60,27,18,12,3,0
41661,380,187,193,38,51,30,18,572,305,267,74,72,58,21,0
41662,422,207,215,79,38,53,23,338,169,169,53,44,39,21,0
41663,745,402,343,95,71,69,40,130,67,63,24,10,12,4,0
41664,103,56,47,27,7,8,2,441,189,252,73,50,47,23,0
41665,340,181,159,44,39,35,21,129,60,69,21,15,8,5,0
41666,125,53,72,18,21,18,12,403,185,218,67,62,63,19,0
41667,222,110,112,43,30,14,6,547,295,252,81,65,57,23,0
41668,419,210,209,54,44,31,23,966,478,488,108,144,74,43,0
41669,530,259,271,83,50,54,41,326,169,157,51,41,41,12,0
41670,301,156,145,32,25,15,5,520,244,276,91,60,68,20,0
41671,961,465,496,139,156,62,34,482,232,250,77,81,44,13,0
41672,519,245,274,58,61,34,22,445,264,181,35,35,34,14,0
41673,130,71,59,30,9,8,1,1214,475,739,177,250,89,49,0
41674,435,187,248,62,51,51,21,200,99,101,31,24,26,6,0
41675,1872,837,1035,280,338,169,80,396,213,183,68,44,47,18,0
41676,126,56,70,31,10,10,3,375,209,166,50,37,29,23,0
41677,580,240,340,108,81,59,22,453,255,198,62,49,29,19,0
41678,504,222,282,71,64,53,29,508,262,246,66,67,51,20,0
41679,457,261,196,55,27,57,34,663,354,309,91,84,79,31,0
41680,802,430,372,65,102,87,23,524,300,223,70,54,51,25,0
41681,318,164,154,52,43,34,10,866,478,388,121,101,101,26,0
41682,521,289,232,71,58,49,16,704,355,349,113,94,71,24,0
41683,496,210,286,112,55,72,13,459,260,199,56,42,47,21,0
41684,441,218,223,69,55,50,27,1114,539,575,145,131,94,56,0
41685,451,225,226,69,57,64,22,165,90,75,36,18,20,6,0
41686,626,308,318,105,89,77,25,455,191,264,68,86,21,19,0
41687,123,58,65,22,14,13,3,125,66,59,24,16,11,5,0
41688,1007,353,654,277,147,70,26,123,61,62,17,18,17,7,0
41689,346,208,138,46,39,51,18,166,88,78,23,18,13,7,0
41690,514,226,288,71,66,63,32,715,348,367,109,84,68,30,0
41691,86,50,36,9,14,8,7,904,436,468,143,118,108,32,0
41692,282,84,198,60,102,1,6,332,180,152,44,36,27,13,0
41693,301,119,182,53,47,14,20,270,162,108,26,26,16,11,0
41694,415,133,282,114,65,27,7,169,84,85,29,19,21,7,0
41695,340,169,171,40,39,36,22,528,188,340,130,58,77,41,0
41696,1054,497,557,190,168,107,45,65,32,33,16,4,8,3,0
41697,535,315,220,57,55,71,19,380,211,169,47,37,33,21,0
41698,546,278,268,94,60,32,22,862,409,453,149,125,86,29,0
41699,407,164,243,88,42,40,22,149,77,72,37,10,20,5,0
41700,727,426,301,79,71,64,32,245,131,114,30,27,18,13,0
41701,1120,436,684,208,120,101,115,1395,627,768,172,263,141,59,0
41702,207,128,79,26,17,19,9,89,37,52,13,6,2,9,0
41703,269,124,145,36,24,32,11,975,475,500,139,140,119,28,0
41704,343,162,181,65,38,29,12,247,128,119,34,14,16,14,0
41705,410,200,210,60,54,46,19,374,174,200,54,52,42,21,0
41706,282,135,147,27,37,30,19,427,251,176,51,39,25,22,0
41707,856,429,427,113,105,96,24,218,111,107,45,29,24,6,0
41708,422,196,226,52,35,33,20,405,195,210,57,74,24,17,0
41709,249,104,145,47,41,24,17,380,211,169,47,37,33,21,0
41710,692,305,387,100,97,78,30,231,126,105,37,26,29,6,0
41711,446,283,163,51,26,33,19,715,345,370,110,97,64,25,0
41712,126,56,70,31,10,10,3,282,134,148,38,45,29,10,0
41713,130,71,59,30,9,8,2,555,282,273,82,69,65,21,0
41714,224,101,123,45,32,21,3,504,272,232,75,57,53,19,0
41715,747,360,387,125,92,69,32,277,124,153,44,40,35,18,0
41716,3969,1703,2266,619,432,259,144,396,199,197,54,50,45,14,0
41717,373,164,209,51,45,44,21,277,152,125,31,35,22,19,0
41718,1068,434,634,173,160,61,29,309,159,150,47,43,43,13,0
41719,333,171,162,41,44,48,23,194,94,100,33,28,14,7,0
41720,1970,978,992,245,206,198,80,453,255,198,62,49,29,19,0
41721,257,148,109,28,20,21,14,405,181,224,71,57,31,12,0
41722,480,257,223,74,26,60,27,862,426,436,113,115,84,37,0
41723,126,58,68,31,10,10,3,447,212,235,86,55,58,21,0
41724,493,208,285,75,77,70,40,277,152,125,31,35,22,19,0
41725,490,198,292,65,81,39,27,316,159,157,38,48,30,11,0
41726,466,259,207,59,50,83,12,277,124,153,44,40,35,18,0
41727,412,146,266,106,38,67,35,497,227,270,70,63,66,30,0
41728,422,196,226,52,35,33,20,501,257,244,75,57,48,29,0
41729,646,304,342,104,93,58,26,245,131,114,30,27,18,13,0
41730,272,94,178,76,33,19,4,107,77,30,7,2,9,5,0
41731,361,167,194,55,35,41,11,125,66,59,24,16,11,5,0
41732,255,126,129,41,37,13,5,1239,659,580,169,148,131,54,0
41733,1042,529,513,161,151,103,52,291,146,145,39,45,22,16,0
41734,431,216,215,46,40,33,9,397,234,163,44,38,23,21,0
41735,525,254,271,60,76,46,13,68,23,45,12,9,3,9,0
41736,240,99,141,53,38,29,15,148,84,64,30,7,17,4,0
41737,452,217,235,59,47,60,20,334,181,153,41,40,25,15,0
41738,340,145,195,46,38,26,23,508,261,247,65,53,58,23,0
41739,739,389,350,129,61,69,25,127,66,61,13,14,19,8,0
41740,202,113,89,16,27,21,11,368,204,164,43,35,30,24,0
41741,763,371,392,104,88,52,23,341,170,171,41,66,27,10,0
41742,131,69,62,29,9,9,1,459,260,199,56,42,47,21,0
41743,340,181,159,44,39,35,21,866,478,388,121,101,101,26,0
41744,579,281,298,91,78,74,27,609,335,274,79,57,45,22,0
41745,325,186,139,49,36,20,5,474,268,206,66,42,45,24,0
41746,264,122,142,33,29,13,13,300,148,152,45,43,40,8,0
41747,210,101,109,33,33,19,9,267,141,126,53,27,23,7,0
41748,476,254,222,58,33,46,23,188,93,95,33,18,16,10,0
41749,484,192,292,118,68,83,22,198,110,88,27,27,24,4,0
41750,782,372,410,127,111,89,36,149,52,97,36,36,7,4,0
41751,1336,724,612,209,141,133,60,261,148,113,31,28,14,10,0
41752,432,190,242,85,82,28,11,295,160,135,44,36,46,16,0
41753,178,87,91,20,32,13,10,264,138,126,33,34,29,12,0
41754,717,381,336,118,103,85,29,91,44,47,9,12,4,7,0
41755,126,56,70,31,10,10,3,1061,543,518,146,123,109,67,0
41756,372,171,201,47,53,39,18,457,253,204,67,51,48,13,0
41757,207,89,118,56,8,4,3,1020,538,482,145,115,111,58,0
41758,199,107,92,41,15,14,8,375,211,164,50,36,31,23,0
41759,343,162,181,65,38,29,12,204,96,108,31,37,20,5,0
41760,117,57,60,17,14,11,10,201,104,97,36,32,24,7,0
41761,424,170,254,69,56,47,28,87,38,49,23,10,10,9,0
41762,1214,498,716,197,180,121,65,339,180,159,36,29,16,16,0
41763,156,64,92,31,19,5,4,1114,539,575,145,131,94,56,0
41764,160,53,107,31,29,13,3,244,143,101,31,29,26,8,0
41765,650,330,320,97,77,65,28,818,357,461,122,136,54,25,0
41766,1199,589,610,189,128,167,65,497,227,270,70,63,66,30,0
41767,126,57,69,31,10,10,3,455,191,264,68,86,21,19,0
41768,412,203,209,65,47,37,18,508,262,246,66,67,51,20,0
41769,1327,520,807,241,174,141,60,189,105,84,25,26,21,9,0
41770,125,53,72,18,21,18,12,187,89,98,36,24,20,6,0
41771,3230,1724,1506,361,358,157,75,483,258,225,70,53,54,20,0
41772,401,204,197,49,33,29,17,395,169,226,73,55,38,9,0
41773,122,56,66,26,13,11,5,153,80,73,26,18,19,4,0
41774,784,353,431,56,47,26,18,708,328,380,113,100,82,34,0
41775,119,67,52,15,15,7,7,463,170,293,115,54,75,32,0
41776,560,279,281,113,64,58,15,89,38,51,14,6,3,9,0
41777,125,53,72,18,21,18,12,690,345,345,96,83,73,42,0
41778,396,150,246,103,64,38,3,561,279,282,85,81,88,24,0
41779,213,88,125,21,54,14,15,457,242,215,39,46,53,10,0
41780,553,319,234,56,37,54,18,1062,522,540,151,147,105,66,0
41781,57,24,33,11,3,5,3,277,152,125,31,35,22,19,0
41782,522,302,220,61,49,75,19,201,104,97,36,32,24,7,0
41783,610,249,361,107,69,72,33,305,163,142,38,27,47,11,0
41784,176,74,102,20,29,7,7,153,65,88,28,21,20,8,0
41785,366,190,176,39,62,55,14,334,181,153,56,31,28,18,0
41786,456,214,242,76,62,52,22,583,321,262,73,67,45,25,0
41787,413,169,244,66,94,28,19,169,74,95,33,26,22,3,0
41788,342,150,192,52,43,31,17,508,262,246,66,67,51,20,0
41789,435,225,210,58,46,50,14,375,176,199,48,61,40,12,0
41790,270,158,112,35,20,23,7,72,33,39,8,2,3,12,0
41791,763,371,392,104,88,52,23,1114,539,575,145,131,94,56,0
41792,415,217,198,50,31,42,17,1265,689,576,169,177,128,60,0
41793,150,60,90,27,16,6,3,166,90,76,27,18,21,5,0
41794,136,65,71,33,11,9,6,408,221,187,55,51,57,14,0
41795,162,73,89,32,19,4,4,374,212,162,48,40,32,23,0
41796,475,208,267,84,67,50,20,105,51,54,13,17,12,8,0
41797,180,57,123,39,22,10,8,303,138,165,47,46,35,18,0
41798,454,230,224,63,56,38,33,337,170,167,59,33,47,17,0
41799,330,182,148,47,27,40,11,557,281,276,80,59,43,21,0
41800,586,298,288,80,75,64,37,308,146,162,42,39,24,12,0
41801,808,366,442,130,133,66,31,660,303,357,97,89,85,33,0
41802,535,217,318,87,106,41,14,165,90,75,36,18,20,6,0
41803,126,57,69,31,10,10,3,1025,549,476,118,109,88,61,0
41804,801,331,470,151,139,99,55,277,124,153,44,40,35,18,0
41805,577,251,326,92,84,60,11,349,200,149,41,39,30,20,0
41806,484,264,220,59,62,68,15,338,169,169,53,44,39,21,0
41807,439,241,198,67,40,40,13,127,64,63,26,8,12,8,0
41808,439,205,234,64,88,41,21,189,105,84,25,26,21,9,0
41809,134,60,74,19,13,10,7,410,197,213,67,43,56,18,0
41810,338,208,130,39,30,35,12,128,63,65,30,11,13,8,0
41811,341,154,187,34,36,11,11,736,388,348,88,85,67,28,0
41812,426,214,212,63,47,53,20,425,177,248,60,62,33,16,0
41813,176,74,102,20,29,7,7,469,225,244,64,68,25,11,0
41814,502,250,252,70,47,57,15,223,113,110,31,33,22,12,0
41815,766,336,430,133,97,79,21,710,375,335,95,94,110,28,0
41816,76,30,46,7,15,1,5,2202,1121,1081,338,274,269,81,0
41817,434,216,218,72,58,40,20,974,457,517,133,117,69,26,0
41818,822,416,406,111,97,88,42,106,46,60,29,13,14,5,0
41819,267,146,121,40,24,25,7,178,99,79,31,19,26,8,0
41820,1390,705,685,219,164,129,74,368,183,185,40,42,40,15,0
41821,502,250,252,70,47,57,15,247,128,119,34,14,16,14,0
41822,501,230,271,63,90,50,18,314,177,137,34,40,29,9,0
41823,513,276,237,73,43,57,24,531,277,254,82,75,33,22,0
41824,328,195,133,36,23,35,9,389,207,182,53,58,52,18,0
41825,156,64,92,31,19,5,4,551,226,325,96,103,43,11,0
41826,465,220,245,88,34,61,23,892,475,417,130,108,68,38,0
41827,376,171,205,45,45,34,12,555,282,273,82,69,65,21,0
41828,1214,612,602,169,173,98,35,317,161,156,40,49,41,11,0
41829,139,81,58,17,14,24,9,397,234,163,44,38,23,21,0
41830,227,109,118,42,35,29,8,178,99,79,31,19,26,8,0
41831,313,178,135,43,18,35,6,1338,720,618,179,145,141,85,0
41832,496,210,286,111,55,74,13,337,170,167,59,33,47,17,0
41833,1098,519,579,182,159,79,42,392,214,178,48,40,53,22,0
41834,456,223,233,77,54,47,20,515,276,239,62,59,43,31,0
41835,1221,597,624,201,152,83,31,376,189,187,47,53,44,26,0
41836,316,157,159,45,38,22,19,391,189,202,55,56,56,12,0
41837,651,357,294,81,67,103,18,866,397,469,117,153,95,48,0
41838,3859,2011,1848,535,391,422,207,91,44,47,9,12,4,7,0
41839,595,316,279,86,60,65,40,103,44,59,16,17,9,5,0
41840,347,154,193,48,51,25,11,370,173,197,65,57,42,10,0
41841,781,367,414,60,67,43,17,396,213,183,68,44,47,18,0
41842,178,74,104,31,28,9,4,660,333,327,102,95,69,31,0
41843,443,206,237,76,68,52,28,430,212,218,88,43,40,20,0
41844,270,166,104,30,26,28,14,328,195,133,39,40,27,13,0
41845,3703,1708,1995,456,428,305,162,662,312,350,103,104,59,20,0
41846,622,354,268,89,60,64,18,257,139,118,64,17,24,7,0
41847,782,372,410,127,111,89,36,640,364,276,84,68,69,33,0
41848,429,238,191,47,49,56,29,663,354,309,91,84,79,31,0
41849,164,61,103,47,19,14,5,538,274,264,84,67,52,35,0
41850,345,208,137,44,27,33,8,780,337,443,112,116,77,28,0
41851,313,158,155,43,35,43,16,1314,693,621,174,155,140,58,0
41852,329,165,164,61,44,29,17,708,328,380,113,100,82,34,0
41853,616,323,293,98,71,31,15,406,202,204,54,51,63,21,0
41854,528,273,255,67,53,29,20,963,525,438,119,102,102,34,0
41855,389,176,213,81,59,24,7,518,292,226,60,60,52,21,0
41856,340,145,195,46,38,26,23,376,189,187,47,53,44,26,0
41857,376,176,200,31,53,27,8,520,272,248,60,65,58,22,0
41858,282,105,177,77,28,39,6,1755,905,850,214,196,183,79,0
41859,840,411,429,122,101,79,34,507,270,237,89,59,57,22,0
41860,627,237,390,137,57,108,44,142,73,69,27,9,15,11,0
41861,502,236,266,66,66,58,17,127,54,73,11,33,15,6,0
41862,2525,1232,1293,398,317,186,61,528,276,252,86,78,49,17,0
41863,1365,590,775,257,168,136,93,520,244,276,91,60,68,20,0
41864,496,210,286,112,55,71,14,375,176,199,48,61,40,12,0
41865,605,277,328,99,54,63,43,242,121,121,39,30,29,10,0
41866,424,170,254,69,56,47,28,679,338,341,96,95,40,23,0
41867,476,199,277,82,80,49,24,775,407,368,122,100,97,32,0
41868,160,53,107,31,29,13,3,545,269,276,80,76,27,32,0
41869,188,84,104,35,36,18,9,392,155,237,68,61,34,16,0
41870,126,57,69,31,10,10,3,222,122,100,39,32,24,9,0
41871,404,197,207,60,48,47,20,270,162,108,26,26,16,11,0
41872,115,62,53,13,10,9,7,601,279,322,81,65,27,12,0
41873,557,211,346,129,125,48,19,415,189,226,68,54,50,21,0
41874,259,119,140,48,28,29,19,262,129,133,40,41,31,10,0
41875,334,190,144,42,42,16,5,198,110,88,27,27,24,4,0
41876,886,428,458,107,122,78,39,317,153,164,39,30,35,13,0
41877,580,265,315,97,89,79,17,279,142,137,43,39,28,7,0
41878,217,109,108,30,23,28,10,103,44,59,16,17,9,5,0
41879,338,139,199,54,54,18,11,261,127,134,36,27,36,4,0
41880,258,126,132,38,22,29,8,308,146,162,42,39,24,12,0
41881,639,368,271,72,51,38,38,810,310,500,164,162,42,26,0
41882,526,228,298,69,64,32,30,314,177,137,34,40,29,9,0
41883,574,269,305,91,63,54,27,551,226,325,96,103,43,11,0
41884,281,125,156,44,47,17,7,943,463,480,91,144,70,30,0
41885,331,169,162,40,28,22,14,250,116,134,41,30,33,19,0
41886,476,199,277,82,80,49,24,763,418,345,113,84,59,32,0
41887,764,277,487,158,162,64,31,381,196,185,55,57,43,16,0
41888,351,166,185,48,61,24,15,364,192,172,49,36,39,14,0
41889,805,338,467,153,138,99,55,314,177,137,34,40,29,9,0
41890,577,342,235,63,57,23,37,68,36,32,11,8,9,2,0
41891,476,276,200,57,34,43,16,758,319,439,101,123,78,25,0
41892,1759,838,921,269,212,191,92,276,149,127,34,31,32,10,0
41893,437,167,270,126,95,34,10,926,340,586,133,119,60,40,0
41894,472,222,250,46,61,33,23,584,249,335,80,96,22,13,0
41895,115,62,53,13,10,9,7,736,388,348,88,85,67,28,0
41896,1284,511,773,227,166,169,107,404,190,214,55,55,35,27,0
41897,1580,742,838,208,146,144,71,286,152,134,38,38,32,11,0
41898,329,171,158,49,41,31,10,1113,480,633,170,173,81,34,0
41899,854,435,419,118,91,95,42,173,90,83,21,36,12,15,0
41900,350,212,138,32,26,40,13,306,157,149,52,35,39,16,0
41901,422,207,215,79,38,53,23,1378,692,686,194,174,105,56,0
41902,580,281,299,95,60,74,29,555,282,273,82,69,65,21,0
41903,522,251,271,87,68,60,21,820,333,487,202,152,59,23,0
41904,1004,464,540,143,104,78,55,403,221,182,62,50,42,12,0
41905,494,233,261,87,57,46,18,135,57,78,21,20,9,11,0
41906,1139,537,602,162,139,109,50,798,385,413,120,115,79,30,0
41907,428,226,202,52,60,75,20,975,475,500,139,140,119,28,0
41908,500,257,243,60,55,27,22,736,388,348,88,85,67,28,0
41909,785,351,434,136,93,71,37,588,286,302,78,99,53,25,0
41910,338,139,199,54,54,18,11,218,111,107,45,29,24,6,0
41911,358,212,146,51,36,33,9,180,115,65,17,12,9,9,0
41912,528,188,340,130,58,77,41,298,129,169,51,40,29,8,0
41913,71,39,32,7,11,6,4,516,245,271,82,84,70,26,0
41914,961,465,496,139,156,62,34,663,354,309,91,84,79,31,0
41915,154,74,80,18,19,7,2,397,234,163,44,38,23,21,0
41916,330,182,148,47,27,40,11,104,46,58,15,17,9,5,0
41917,347,154,193,48,51,25,11,91,42,49,21,9,8,3,0
41918,516,210,306,113,53,81,33,520,272,248,60,65,58,22,0
41919,360,205,155,35,24,52,14,708,328,380,113,100,82,34,0
41920,471,221,250,87,68,42,25,172,88,84,24,31,20,12,0
41921,154,74,80,18,19,7,2,2202,1121,1081,338,274,269,81,0
41922,315,174,141,46,38,47,16,296,140,156,49,40,42,19,0
41923,411,211,200,61,46,35,18,418,223,195,53,43,49,15,0
41924,525,302,223,56,48,67,19,415,203,212,77,44,49,18,0
41925,956,450,506,122,117,82,36,862,409,453,149,125,86,29,0
41926,1249,543,706,187,164,125,52,125,66,59,24,16,11,5,0
41927,178,89,89,40,12,18,7,405,195,210,57,74,24,17,0
41928,514,226,288,71,66,63,32,301,168,133,49,37,34,11,0
41929,763,371,392,104,88,52,23,105,51,54,13,17,12,8,0
41930,563,255,308,91,111,42,30,218,117,101,35,32,34,12,0
41931,368,154,214,80,52,41,16,247,128,119,34,14,16,14,0
41932,365,148,217,86,37,51,28,106,41,65,36,6,11,7,0
41933,650,330,320,97,77,65,28,166,88,78,23,18,13,7,0
41934,824,391,433,106,90,88,32,1262,653,609,169,165,152,50,0
41935,181,92,89,34,22,17,9,629,317,312,80,87,51,22,0
41936,546,265,281,101,64,38,16,975,400,575,160,162,62,31,0
41937,325,177,148,40,24,23,13,598,333,265,79,66,54,33,0
41938,130,70,60,30,9,8,1,242,121,121,39,30,29,10,0
41939,441,216,225,57,66,57,19,723,353,370,120,109,96,33,0
41940,470,163,307,99,68,73,30,588,286,302,78,99,53,25,0
41941,820,333,487,202,152,59,23,331,180,151,46,35,47,17,0
41942,781,316,465,130,129,65,23,701,380,321,94,84,96,34,0
41943,1041,497,544,180,167,98,34,72,33,39,8,2,3,12,0
41944,894,448,446,123,100,82,30,89,42,47,16,12,15,6,0
41945,952,547,405,95,90,127,35,373,189,184,54,46,50,23,0
41946,524,262,262,62,72,39,49,1537,701,836,209,187,129,58,0
41947,130,71,59,30,9,8,1,283,160,123,25,20,37,9,0
41948,346,209,137,46,37,44,10,171,94,77,24,28,30,11,0
41949,2414,1189,1225,277,178,170,169,222,119,103,37,32,24,8,0
41950,346,186,160,40,37,34,21,866,397,469,117,153,95,48,0
41951,449,179,270,80,77,49,29,375,176,199,48,61,40,12,0
41952,963,477,486,134,143,123,38,199,92,107,34,30,18,9,0
41953,396,150,246,103,64,38,3,87,38,49,23,10,10,9,0
41954,593,282,311,75,70,29,25,2382,1162,1220,237,220,140,49,0
41955,138,35,103,38,2,15,9,198,115,83,30,22,8,8,0
41956,315,174,141,46,38,47,16,1214,475,739,177,250,89,49,0
41957,178,87,91,20,32,13,10,326,169,157,51,41,41,12,0
41958,378,202,176,34,32,44,13,963,525,438,119,102,102,34,0
41959,117,58,59,17,17,12,2,312,165,147,41,39,29,16,0
41960,1085,646,439,108,65,36,19,341,170,171,41,66,27,10,0
41961,625,283,342,93,89,67,25,564,264,300,79,84,65,26,0
41962,422,196,226,52,35,33,20,708,328,380,113,100,82,34,0
41963,269,124,145,36,24,32,11,515,276,239,62,59,43,31,0
41964,210,101,109,33,33,19,9,425,177,248,60,62,33,16,0
41965,299,151,148,35,34,26,16,773,389,384,119,91,79,26,0
41966,240,166,74,32,12,8,15,403,233,170,38,29,21,14,0
41967,345,208,137,44,27,33,8,629,317,312,80,87,51,22,0
41968,164,61,103,47,19,14,5,548,273,275,84,81,64,30,0
41969,894,448,446,123,100,82,30,234,116,118,34,35,23,9,0
41970,271,136,135,37,30,18,10,588,286,302,78,99,53,25,0
41971,1220,575,645,208,179,99,56,163,79,84,22,24,13,5,0
41972,326,154,172,45,39,20,10,334,181,153,56,31,28,18,0
41973,1214,612,602,169,173,98,35,328,199,129,39,29,27,14,0
41974,770,390,380,104,76,78,32,522,258,264,55,56,59,24,0
41975,440,267,173,52,29,42,12,538,274,264,84,67,52,35,0
41976,517,245,272,92,77,46,24,180,115,65,17,12,9,9,0
41977,879,457,422,93,98,143,32,334,181,153,56,31,28,18,0
41978,180,57,123,39,22,10,8,289,140,149,33,42,30,15,0
41979,342,185,157,42,27,31,14,250,119,131,58,26,29,7,0
41980,1120,436,684,208,120,101,115,594,312,282,72,67,73,31,0
41981,853,400,453,137,109,88,42,127,58,69,18,17,10,5,0
41982,860,348,512,121,136,75,35,137,72,65,27,13,15,8,0
41983,413,206,207,38,55,19,10,810,310,500,164,162,42,26,0
41984,404,197,207,60,48,47,20,389,207,182,53,58,52,18,0
41985,283,172,111,39,31,29,8,107,77,30,7,2,9,5,0
41986,107,36,71,27,15,0,1,422,237,185,53,47,62,20,0
41987,335,148,187,52,26,51,12,137,63,74,20,22,14,6,0
41988,616,323,293,98,71,31,15,169,74,95,33,26,22,3,0
41989,246,111,135,64,47,27,3,198,115,83,30,22,8,8,0
41990,1014,488,526,178,137,94,39,461,223,238,45,62,18,35,0
41991,802,375,427,133,103,81,41,199,92,107,34,30,18,9,0
41992,559,217,342,105,86,42,16,260,131,129,42,31,40,9,0
41993,130,70,60,30,9,8,1,1065,581,484,134,97,76,46,0
41994,760,405,355,112,95,92,29,200,99,101,31,24,26,6,0
41995,233,107,126,40,40,20,16,274,142,132,33,34,18,14,0
41996,181,92,89,34,22,17,9,207,114,93,33,20,31,13,0
41997,136,65,71,33,11,9,6,538,274,264,84,67,52,35,0
41998,344,168,176,50,39,30,20,230,125,105,29,40,20,6,0
41999,736,320,416,113,97,61,36,501,257,244,75,57,48,29,0
42000,859,411,448,118,100,95,49,1101,626,475,145,122,120,50,0
42001,745,402,343,95,71,69,40,2547,1280,1267,331,335,293,118,0
42002,1249,543,706,187,164,125,52,405,195,210,57,74,24,17,0
42003,204,109,95,21,35,27,7,223,113,110,31,33,22,12,0
42004,700,305,395,111,99,54,18,96,45,51,13,12,6,4,0
42005,789,362,427,90,82,70,35,329,194,135,45,32,33,9,0
42006,1462,711,751,219,222,148,65,285,146,139,41,41,48,13,0
42007,619,289,330,67,77,36,19,103,59,44,25,2,13,6,0
42008,282,84,198,60,102,1,6,1249,638,611,166,153,141,45,0
42009,486,243,243,65,48,63,22,1262,653,609,169,165,152,50,0
42010,476,254,222,58,33,46,23,264,138,126,33,34,29,12,0
42011,498,274,224,58,59,50,18,250,119,131,58,26,29,7,0
42012,371,209,162,46,17,36,19,260,133,127,43,32,39,3,0
42013,305,124,181,27,25,31,21,274,157,117,40,29,40,8,0
42014,437,167,270,126,95,34,10,430,212,218,88,43,40,20,0
42015,269,124,145,36,24,32,11,198,110,88,27,27,24,4,0
42016,407,164,243,88,42,40,22,246,107,139,55,33,27,11,0
42017,600,324,276,89,73,45,39,727,362,365,123,107,63,23,0
42018,330,182,148,47,27,40,11,531,277,254,82,75,33,22,0
42019,1220,575,645,208,179,99,56,257,139,118,64,17,24,7,0
42020,800,416,384,102,105,83,22,535,311,224,66,52,49,24,0
42021,479,228,251,71,57,60,14,1248,584,664,184,164,155,67,0
42022,131,69,62,29,9,9,1,393,210,183,58,37,34,20,0
42023,960,409,551,166,134,77,44,314,177,137,34,40,29,9,0
42024,401,236,165,53,38,34,9,164,79,85,28,28,16,7,0
42025,594,321,273,98,59,57,23,453,255,198,62,49,29,19,0
42026,193,105,88,33,16,9,4,462,229,233,63,49,42,18,0
42027,2446,1099,1347,363,294,233,100,761,351,410,117,73,103,45,0
42028,722,390,332,125,69,67,25,1606,753,853,215,227,182,48,0
42029,710,352,358,104,86,84,41,1248,584,664,184,164,155,67,0
42030,339,170,169,32,17,24,13,91,42,49,21,9,8,3,0
42031,166,59,107,36,41,10,4,262,129,133,40,41,31,10,0
42032,326,154,172,45,39,20,10,463,268,195,59,46,46,21,0
42033,124,58,66,20,28,11,7,207,86,121,34,39,11,13,0
42034,2062,706,1356,414,368,158,63,597,300,297,96,89,68,29,0
42035,837,381,456,123,109,65,25,128,63,65,30,11,13,8,0
42036,308,163,145,38,33,30,20,341,170,171,41,66,27,10,0
42037,509,246,263,84,71,56,22,583,280,303,95,66,76,25,0
42038,538,263,275,71,85,44,18,329,194,135,45,32,33,9,0
42039,127,54,73,31,10,11,3,498,244,254,81,67,58,19,0
42040,118,56,62,24,12,6,9,137,85,52,15,11,11,2,0
42041,1505,680,825,202,204,73,32,279,142,137,43,39,28,7,0
42042,960,409,551,166,134,77,44,381,186,195,69,55,46,15,0
42043,376,249,127,47,23,43,16,378,154,224,74,84,35,22,0
42044,425,199,226,54,71,56,11,270,130,140,48,44,37,12,0
42045,2649,1431,1218,377,299,266,102,89,51,38,15,15,5,4,0
42046,1276,607,669,192,178,136,63,408,221,187,55,51,57,14,0
42047,130,71,59,30,9,8,2,363,180,183,60,34,10,6,0
42048,403,176,227,71,56,51,11,299,140,159,49,44,26,11,0
42049,861,393,468,150,101,69,35,299,140,159,49,44,26,11,0
42050,325,181,144,46,31,48,9,230,125,105,29,40,20,6,0
42051,401,236,165,53,38,34,9,266,150,116,28,28,24,12,0
42052,1499,864,635,141,99,76,110,261,162,99,24,21,14,10,0
42053,262,133,129,44,38,31,12,294,146,148,50,45,51,15,0
42054,494,233,261,87,57,46,18,469,225,244,64,68,25,11,0
42055,124,58,66,20,28,11,7,427,251,176,51,39,25,22,0
42056,853,400,453,137,109,88,42,410,197,213,67,43,56,18,0
42057,1200,602,598,145,116,110,50,190,93,97,35,27,23,2,0
42058,760,322,438,81,130,57,19,145,77,68,26,7,15,8,0
42059,708,344,364,106,98,66,33,245,131,114,30,27,18,13,0
42060,327,174,153,42,35,16,12,89,51,38,15,15,5,4,0
42061,722,390,332,125,69,67,25,727,388,339,102,87,70,29,0
42062,485,246,239,74,48,47,22,425,177,248,60,62,33,16,0
42063,470,163,307,99,68,73,30,1698,875,823,222,219,173,64,0
42064,509,251,258,69,49,55,17,169,74,95,33,26,22,3,0
42065,3230,1724,1506,361,358,157,75,239,113,126,36,49,20,8,0
42066,629,338,291,92,57,64,22,517,295,222,69,62,40,28,0
42067,536,237,299,116,87,42,17,331,180,151,46,35,47,17,0
42068,376,176,200,31,53,27,8,449,252,197,61,52,36,18,0
42069,1121,458,663,158,210,76,47,429,187,242,79,72,28,19,0
42070,376,249,127,47,23,43,16,727,362,365,123,107,63,23,0
42071,466,199,267,86,59,32,17,257,139,118,64,17,24,7,0
42072,126,56,70,31,10,10,3,548,296,252,71,74,43,28,0
42073,531,259,272,75,81,39,13,205,94,111,48,31,15,6,0
42074,2624,999,1625,415,495,109,84,212,127,85,28,21,26,6,0
42075,1214,498,716,197,180,121,65,332,155,177,55,51,44,13,0
42076,443,206,237,76,68,52,28,297,175,122,46,30,31,6,0
42077,126,56,70,31,10,10,3,373,213,160,44,33,26,17,0
42078,407,230,177,44,39,34,19,360,180,180,57,48,39,12,0
42079,420,248,172,64,30,43,17,536,267,269,60,70,41,22,0
42080,341,195,146,42,21,36,9,160,60,100,23,40,19,11,0
42081,521,249,272,53,36,50,18,417,232,185,58,50,29,21,0
42082,739,389,350,129,61,69,25,723,353,370,120,109,96,33,0
42083,161,75,86,24,20,10,7,222,125,97,34,27,27,7,0
42084,282,160,122,36,28,27,7,153,80,73,26,18,19,4,0
42085,192,91,101,28,21,18,8,292,143,149,38,42,36,16,0
42086,264,122,142,33,29,13,13,386,181,205,55,51,57,31,0
42087,449,179,270,80,77,49,29,524,300,223,70,54,51,25,0
42088,538,263,275,71,85,44,18,142,65,77,30,17,22,9,0
42089,604,239,365,124,63,84,37,662,312,350,103,104,59,20,0
42090,150,64,86,22,12,29,12,242,124,118,39,32,28,22,0
42091,311,154,157,47,29,34,13,756,348,408,101,103,60,40,0
42092,130,70,60,30,9,8,1,457,253,204,67,51,48,13,0
42093,685,393,292,75,66,113,16,325,159,166,59,46,30,12,0
42094,1249,543,706,187,164,125,52,264,138,126,33,34,29,12,0
42095,2136,1063,1073,317,308,223,90,410,197,213,67,43,56,18,0
42096,142,62,80,13,18,15,6,119,57,62,18,16,17,4,0
42097,1463,521,942,252,204,105,52,2346,1231,1115,316,292,266,105,0
42098,454,214,240,56,71,35,16,339,180,159,36,29,16,16,0
42099,234,108,126,42,40,15,9,132,61,71,22,21,15,3,0
42100,373,164,209,51,45,44,21,1507,737,770,188,228,147,71,0
42101,533,300,233,74,50,74,17,671,321,350,95,87,75,34,0
42102,521,289,232,71,58,49,16,346,196,150,43,26,27,14,0
42103,580,281,299,95,60,74,29,1230,644,586,198,125,123,61,0
42104,457,261,196,55,27,57,34,418,246,172,52,39,57,10,0
42105,410,209,201,72,30,48,22,647,350,297,95,79,77,29,0
42106,384,198,186,58,48,37,12,218,115,103,32,32,34,11,0
42107,856,429,427,113,105,96,24,73,35,38,14,10,9,4,0
42108,215,117,98,28,19,15,8,457,242,215,39,46,53,10,0
42109,331,177,154,54,38,27,11,160,76,84,19,24,8,5,0
42110,217,98,119,38,35,18,9,370,173,197,65,57,42,10,0
42111,359,204,155,39,36,34,13,524,300,223,70,54,51,25,0
42112,516,224,292,79,29,45,33,218,118,100,33,30,25,11,0
42113,630,231,399,150,83,84,50,508,262,246,66,67,51,20,0
42114,1189,653,536,152,118,109,56,392,155,237,68,61,34,16,0
42115,465,305,160,40,47,34,9,94,45,49,11,20,10,4,0
42116,312,164,148,54,29,25,15,341,170,171,41,66,27,10,0
42117,674,318,356,86,139,50,11,346,178,168,58,41,33,12,0
42118,314,178,136,42,32,30,17,732,366,366,108,86,74,41,0
42119,476,199,277,82,80,49,24,1922,923,999,267,275,215,90,0
42120,249,104,145,47,41,24,17,127,64,63,26,8,12,8,0
42121,345,203,142,47,35,31,11,724,353,371,94,95,71,31,0
42122,176,74,102,20,29,7,7,600,254,346,104,100,44,17,0
42123,745,402,343,95,71,69,40,751,394,357,107,96,73,35,0
42124,314,178,136,42,32,30,17,654,295,359,99,88,71,25,0
42125,258,126,132,38,22,29,8,1239,659,580,169,148,131,54,0
42126,467,310,157,42,28,28,33,568,292,276,69,74,59,34,0
42127,496,272,224,70,58,42,18,902,499,403,118,117,92,35,0
42128,3230,1724,1506,361,358,157,75,89,37,52,13,6,2,9,0
42129,168,67,101,37,17,13,13,873,366,507,127,125,75,21,0
42130,326,154,172,45,39,20,10,1378,692,686,194,174,105,56,0
42131,126,57,69,31,10,10,3,196,105,91,40,13,19,10,0
42132,785,325,460,114,123,61,28,403,185,218,67,62,63,19,0
42133,146,73,73,18,24,17,9,106,54,52,12,9,7,6,0
42134,144,57,87,38,26,10,4,250,116,134,41,30,33,19,0
42135,533,297,236,74,57,39,28,660,333,327,102,95,69,31,0
42136,447,225,222,76,35,75,21,453,255,198,62,49,29,19,0
42137,600,324,276,89,73,45,39,862,409,453,149,125,86,29,0
42138,2279,996,1283,375,328,158,60,756,348,408,101,103,60,40,0
42139,139,64,75,18,17,18,4,518,292,226,60,60,52,21,0
42140,1276,607,669,192,178,136,63,928,440,488,111,157,82,35,0
42141,2220,1085,1135,312,304,202,91,374,202,172,50,39,31,24,0
42142,164,61,103,47,19,14,5,194,94,100,33,28,14,7,0
42143,341,183,158,36,34,36,15,317,161,156,40,49,41,11,0
42144,588,317,271,78,49,54,17,629,317,312,80,87,51,22,0
42145,365,222,143,44,24,35,11,305,163,142,38,27,47,11,0
42146,2220,1085,1135,312,304,202,91,1352,602,750,166,185,81,70,0
42147,92,46,46,14,9,8,6,187,89,98,36,24,20,6,0
42148,4640,2231,2409,660,549,437,245,1230,644,586,198,125,123,61,0
42149,510,288,222,44,36,24,7,125,66,59,24,16,11,5,0
42150,165,66,99,28,32,16,3,225,129,96,32,33,20,8,0
42151,1336,724,612,209,141,133,60,403,184,219,75,51,47,20,0
42152,1594,660,934,251,272,117,77,2517,1275,1242,304,324,245,135,0
42153,397,180,217,61,59,39,13,422,202,220,80,52,57,18,0
42154,348,198,150,57,25,37,18,724,353,371,94,95,71,31,0
42155,717,381,336,118,103,85,29,583,321,262,73,67,45,25,0
42156,270,147,123,34,17,39,21,200,99,101,31,24,26,6,0
42157,232,134,98,28,20,20,5,723,353,370,120,109,96,33,0
42158,399,220,179,48,37,68,18,260,131,129,42,31,40,9,0
42159,437,230,207,41,55,27,13,89,37,52,13,6,2,9,0
42160,475,208,267,84,67,50,20,548,273,275,84,81,64,30,0
42161,380,148,232,81,69,24,8,242,121,121,39,30,29,10,0
42162,1099,491,608,163,141,107,62,389,210,179,51,37,43,9,0
42163,220,121,99,28,26,17,6,737,397,340,87,104,90,14,0
42164,524,270,254,84,72,70,23,106,41,65,36,6,11,7,0
42165,372,189,183,60,44,41,18,106,46,60,27,18,12,3,0
42166,457,261,196,55,27,57,34,138,69,69,28,7,10,10,0
42167,461,257,204,63,49,50,29,213,129,84,32,14,21,15,0
42168,126,56,70,31,10,10,3,1040,564,476,134,110,114,51,0
42169,528,273,255,67,53,29,20,205,94,111,48,31,15,6,0
42170,526,268,258,54,37,55,12,354,183,171,54,43,49,8,0
42171,587,318,269,76,50,38,21,192,110,82,33,21,10,3,0
42172,476,276,200,57,34,43,16,173,86,87,30,22,19,12,0
42173,640,308,332,91,102,49,21,180,90,90,31,19,20,8,0
42174,427,191,236,67,60,41,34,478,254,224,67,74,56,28,0
42175,1501,679,822,251,196,174,67,381,187,194,37,49,36,17,0
42176,437,230,207,41,55,27,13,660,333,327,102,95,69,31,0
42177,1214,612,602,169,173,98,35,654,295,359,99,88,71,25,0
42178,466,259,207,59,50,83,12,368,183,185,40,42,40,15,0
42179,329,168,161,48,34,41,16,662,312,350,103,104,59,20,0
42180,127,54,73,31,10,11,3,1040,564,476,134,110,114,51,0
42181,262,133,129,44,38,31,12,662,373,289,89,80,77,29,0
42182,250,123,127,40,28,29,8,410,197,213,67,43,56,18,0
42183,727,426,301,79,71,64,32,107,77,30,7,2,9,5,0
42184,332,172,160,50,33,35,9,137,72,65,27,13,15,8,0
42185,172,82,90,21,35,21,5,439,227,212,60,55,58,8,0
42186,739,323,416,127,89,76,33,508,253,255,73,60,50,13,0
42187,2799,1324,1475,369,371,215,124,1873,935,938,233,225,203,79,0
42188,510,269,241,66,67,71,26,413,223,190,52,45,53,10,0
42189,983,449,534,95,77,55,36,201,93,108,34,39,21,6,0
42190,508,136,372,157,91,22,9,106,46,60,29,13,14,5,0
42191,653,379,274,89,56,86,13,453,255,198,62,49,29,19,0
42192,458,226,232,77,59,61,14,362,156,206,74,42,36,22,0
42193,760,322,438,81,130,57,19,524,300,223,70,54,51,25,0
42194,525,254,271,60,76,46,13,330,166,164,55,51,36,16,0
42195,184,88,96,15,40,17,8,108,59,49,17,13,12,5,0
42196,375,167,208,55,83,44,9,192,91,101,29,28,17,7,0
42197,107,53,54,15,15,13,4,302,150,152,56,40,52,15,0
42198,520,261,259,74,52,49,22,389,207,182,53,58,52,18,0
42199,1085,646,439,108,65,36,19,900,441,459,125,127,110,32,0
42200,908,324,584,181,162,81,29,314,177,137,34,40,29,9,0
42201,225,111,114,38,22,25,10,405,195,210,57,74,24,17,0
42202,401,204,197,49,33,29,17,306,157,149,52,35,39,16,0
42203,485,237,248,83,35,52,24,286,152,134,38,38,32,11,0
42204,410,208,202,59,58,43,26,403,185,218,67,62,63,19,0
42205,272,141,131,45,29,36,9,308,146,162,42,39,24,12,0
42206,291,142,149,50,29,35,7,396,199,197,54,50,45,14,0
42207,127,55,72,25,18,5,7,375,176,199,48,61,40,12,0
42208,329,165,164,61,44,29,17,689,343,346,105,102,81,35,0
42209,341,175,166,48,43,35,18,588,286,302,78,99,53,25,0
42210,755,271,484,113,226,61,20,374,181,193,55,58,48,23,0
42211,1186,495,691,182,208,88,32,600,254,346,104,100,44,17,0
42212,755,271,484,113,226,61,20,337,170,167,59,33,47,17,0
42213,763,354,409,101,90,63,26,600,254,346,104,100,44,17,0
42214,624,222,402,92,81,39,15,289,140,149,33,42,30,15,0
42215,739,389,350,129,61,69,25,400,187,213,56,59,42,20,0
42216,320,183,137,51,18,38,8,439,227,212,60,55,58,8,0
42217,330,182,148,47,27,40,11,463,268,195,59,46,46,21,0
42218,853,400,453,137,109,88,42,142,73,69,27,9,15,11,0
42219,1463,521,942,252,204,105,52,501,249,252,77,70,55,22,0
42220,808,366,442,130,133,66,31,363,180,183,60,34,10,6,0
42221,181,92,89,34,22,17,9,179,101,78,25,15,13,13,0
42222,610,249,361,107,69,72,33,328,199,129,39,29,27,14,0
42223,162,73,89,32,19,4,4,295,160,135,44,36,46,16,0
42224,1417,598,819,223,188,135,58,392,214,178,48,40,53,22,0
42225,232,134,98,28,20,20,5,536,251,285,75,79,60,23,0
42226,346,208,138,46,39,51,18,103,50,53,19,10,7,5,0
42227,399,220,179,48,37,68,18,207,86,121,34,39,11,13,0
42228,664,269,395,117,107,36,15,246,108,138,32,44,21,10,0
42229,118,56,62,24,12,6,9,403,233,170,38,29,21,14,0
42230,107,56,51,18,16,12,5,279,161,118,37,32,7,7,0
42231,484,194,290,70,93,47,16,584,249,335,80,96,22,13,0
42232,282,160,122,36,28,27,7,419,233,186,54,53,55,17,0
42233,535,217,318,87,106,41,14,228,130,98,35,29,30,10,0
42234,302,160,142,35,35,37,10,483,258,225,70,53,54,20,0
42235,207,128,79,26,17,19,9,374,202,172,50,39,31,24,0
42236,378,202,176,34,32,44,13,514,262,252,78,58,54,26,0
42237,215,104,111,61,7,2,1,701,380,321,94,84,96,34,0
42238,479,227,252,69,48,46,18,180,115,65,17,12,9,9,0
42239,476,254,222,58,33,46,23,1004,457,547,150,150,74,52,0
42240,570,238,332,112,95,39,23,337,170,167,59,33,47,17,0
42241,805,338,467,153,138,99,55,463,268,195,59,46,46,21,0
42242,433,188,245,63,45,26,14,373,213,160,44,33,26,17,0
42243,154,74,80,18,19,7,2,487,252,235,79,58,55,26,0
42244,619,289,330,67,77,36,19,218,115,103,32,32,34,11,0
42245,772,332,440,136,104,72,28,475,251,224,67,49,48,23,0
42246,249,104,145,47,41,24,17,326,149,177,51,51,28,10,0
42247,516,224,292,79,29,45,33,234,129,105,31,22,19,17,0
42248,285,148,137,31,42,42,16,286,152,134,38,38,32,11,0
42249,136,65,71,33,11,9,6,508,261,247,65,53,58,23,0
42250,126,56,70,31,10,10,3,231,126,105,37,26,29,6,0
42251,270,158,112,35,20,23,7,261,162,99,24,21,14,10,0
42252,213,113,100,26,21,26,12,403,221,182,62,50,42,12,0
42253,341,177,164,57,42,40,18,373,213,160,44,33,26,17,0
42254,335,155,180,64,48,36,10,710,375,335,95,94,110,28,0
42255,1107,601,506,155,138,103,49,756,348,408,101,103,60,40,0
42256,300,136,164,45,35,45,14,352,207,145,40,33,25,21,0
42257,485,237,248,83,35,52,24,200,89,111,26,25,17,7,0
42258,220,113,107,37,24,16,7,203,98,105,34,29,19,10,0
42259,280,128,152,39,37,38,18,106,46,60,29,13,14,5,0
42260,1163,417,746,209,145,87,28,325,172,153,44,34,27,14,0
42261,764,277,487,158,162,64,31,127,54,73,11,33,15,6,0
42262,179,78,101,29,22,10,8,862,409,453,149,125,86,29,0
42263,341,154,187,34,36,11,11,601,278,323,124,87,65,21,0
42264,496,210,286,112,55,71,14,349,200,149,41,39,30,20,0
42265,933,456,477,123,108,83,29,127,58,69,18,17,10,5,0
42266,1139,537,602,162,139,109,50,266,150,116,28,28,24,12,0
42267,793,355,438,134,117,77,43,449,252,197,61,52,36,18,0
42268,269,156,113,37,32,17,7,279,161,118,37,32,7,7,0
42269,318,161,157,53,51,32,13,169,74,95,33,26,22,3,0
42270,1120,436,684,208,120,101,115,72,34,38,8,2,3,12,0
42271,360,205,155,35,24,52,14,134,72,62,14,28,8,4,0
42272,272,141,131,45,29,36,9,164,79,85,28,28,16,7,0
42273,109,50,59,12,12,9,3,593,289,304,85,69,48,19,0
42274,126,57,69,31,10,10,3,445,202,243,70,73,51,15,0
42275,1439,713,726,195,180,110,34,418,246,172,52,39,57,10,0
42276,836,370,466,126,96,72,30,900,441,459,125,127,110,32,0
42277,1087,523,564,146,177,103,33,1696,771,925,257,225,149,63,0
42278,2109,999,1110,332,294,187,89,106,54,52,12,9,7,6,0
42279,228,82,146,45,37,18,8,354,183,171,54,43,49,8,0
42280,411,211,200,61,46,35,18,366,204,162,47,41,31,23,0
42281,221,75,146,68,21,16,5,360,180,180,57,48,39,12,0
42282,288,140,148,59,33,27,12,104,46,58,15,17,9,5,0
42283,862,409,453,149,125,86,29,465,225,240,65,44,65,25,0
42284,908,324,584,181,162,81,29,963,525,438,119,102,102,34,0
42285,616,304,312,75,71,55,25,198,113,85,19,20,26,12,0
42286,1284,511,773,227,166,169,107,531,261,270,73,80,68,26,0
42287,504,222,282,71,64,53,29,649,307,342,71,134,45,17,0
42288,281,154,127,45,31,24,9,375,209,166,50,37,29,23,0
42289,2048,855,1193,297,287,191,93,445,192,253,86,58,53,18,0
42290,202,113,89,16,27,21,11,437,221,216,62,64,47,13,0
42291,785,325,460,114,123,61,28,218,111,107,45,29,24,6,0
42292,837,443,394,129,89,87,38,520,272,248,60,65,58,22,0
42293,270,166,104,30,26,28,14,737,397,340,87,104,90,14,0
42294,860,349,511,166,166,58,19,149,52,97,36,36,7,4,0
42295,301,157,144,31,28,34,9,88,50,38,13,8,16,4,0
42296,281,154,127,45,31,24,9,194,109,85,23,24,21,9,0
42297,399,196,203,62,45,38,19,102,51,51,12,15,12,3,0
42298,2414,1189,1225,277,178,170,169,257,139,118,64,17,24,7,0
42299,107,56,51,18,16,12,5,904,436,468,143,118,108,32,0
42300,250,123,127,40,28,29,8,316,166,150,45,38,37,13,0
42301,232,134,98,28,20,20,5,329,194,135,45,32,33,9,0
42302,272,94,178,76,33,19,4,364,189,175,58,41,35,17,0
42303,361,183,178,50,54,51,22,644,343,301,96,69,59,28,0
42304,1395,595,800,223,206,113,61,501,249,252,77,70,55,22,0
42305,505,201,304,116,58,75,31,231,126,105,37,26,29,6,0
42306,143,81,62,28,9,8,1,775,407,368,122,100,97,32,0
42307,565,264,301,101,73,72,15,457,242,215,39,46,53,10,0
42308,235,100,135,36,25,30,8,1382,508,874,334,320,98,36,0
42309,164,81,83,37,8,14,10,535,301,234,63,48,47,27,0
42310,359,167,192,49,37,27,19,497,257,240,71,63,62,16,0
42311,305,124,181,27,25,31,21,943,463,480,91,144,70,30,0
42312,526,268,258,54,37,55,12,198,113,85,19,20,26,12,0
42313,325,186,139,49,36,20,5,463,259,204,62,55,34,22,0
42314,496,209,287,112,55,71,14,483,258,225,70,53,54,20,0
42315,582,328,254,78,48,35,9,2517,1275,1242,304,324,245,135,0
42316,626,308,318,105,89,77,25,374,191,183,40,52,40,16,0
42317,204,93,111,35,35,16,11,858,398,460,126,138,75,39,0
42318,341,195,146,42,21,36,9,1352,602,750,166,185,81,70,0
42319,438,185,253,71,64,52,28,127,66,61,13,14,19,8,0
42320,428,248,180,44,39,28,9,843,391,452,139,104,91,35,0
42321,516,224,292,79,29,45,33,278,154,124,42,32,38,7,0
42322,199,113,86,27,17,10,7,364,189,175,58,41,35,17,0
42323,420,248,172,64,30,43,17,270,130,140,48,44,37,12,0
42324,517,245,272,92,77,46,24,583,321,262,73,67,45,25,0
42325,365,222,143,44,24,35,11,422,237,185,53,47,62,20,0
42326,548,250,298,85,64,56,21,142,65,77,30,17,22,9,0
42327,453,240,213,53,33,44,16,303,137,166,54,54,31,15,0
42328,193,90,103,44,9,19,13,374,202,172,50,39,31,24,0
42329,2063,1024,1039,175,117,80,97,485,244,241,80,55,59,20,0
42330,980,481,499,131,107,85,44,657,326,331,80,81,53,31,0
42331,496,210,286,112,55,72,13,701,380,321,94,84,96,34,0
42332,869,489,380,110,77,79,29,398,200,198,68,43,51,14,0
42333,188,84,104,35,36,18,9,207,114,93,33,20,31,13,0
42334,496,209,287,112,55,71,14,724,353,371,94,95,71,31,0
42335,261,148,113,23,29,26,21,1166,514,652,150,159,107,70,0
42336,76,30,46,7,15,1,5,530,287,243,79,70,33,26,0
42337,588,267,321,99,79,87,28,194,109,85,23,24,21,9,0
42338,315,174,141,46,38,47,16,481,223,258,71,70,49,26,0
42339,521,249,272,53,36,50,18,526,266,260,76,75,53,22,0
42340,319,222,97,36,23,28,8,350,196,154,52,37,21,14,0
42341,579,246,333,102,79,41,19,925,439,486,141,134,105,46,0
42342,318,161,157,53,51,32,13,584,249,335,80,96,22,13,0
42343,340,145,195,46,38,26,23,396,213,183,68,44,47,18,0
42344,595,339,256,64,36,54,24,339,180,159,36,29,16,16,0
42345,1544,738,806,239,217,145,91,421,222,199,69,50,60,18,0
42346,251,131,120,49,35,25,5,445,202,243,70,73,51,15,0
42347,2442,1193,1249,278,183,170,145,536,251,285,75,79,60,23,0
42348,533,300,233,74,50,74,17,169,74,95,33,26,22,3,0
42349,258,130,128,44,37,29,10,1230,644,586,198,125,123,61,0
42350,360,205,155,35,24,52,14,194,106,88,33,10,15,6,0
42351,362,181,181,67,46,43,8,679,338,341,96,95,40,23,0
42352,213,88,125,21,54,14,15,399,190,209,61,41,39,18,0
42353,2446,1099,1347,363,294,233,100,241,127,114,34,33,29,12,0
42354,297,161,136,36,35,24,9,165,87,78,24,19,22,9,0
42355,344,168,176,50,39,30,20,1040,564,476,134,110,114,51,0
42356,126,57,69,31,10,10,3,737,397,340,87,104,90,14,0
42357,653,379,274,89,56,86,13,329,196,133,41,36,31,15,0
42358,798,287,511,126,125,77,26,346,196,150,43,26,27,14,0
42359,593,282,311,75,70,29,25,756,348,408,101,103,60,40,0
42360,803,358,445,135,117,80,43,303,138,165,47,46,35,18,0
42361,1284,511,773,227,166,169,107,108,59,49,17,13,12,5,0
42362,107,56,51,18,16,12,5,654,295,359,99,88,71,25,0
42363,502,250,252,70,47,57,15,178,99,79,31,19,26,8,0
42364,224,108,116,31,32,22,8,277,138,139,40,39,20,14,0
42365,441,218,223,69,55,50,27,902,499,403,118,117,92,35,0
42366,493,208,285,75,77,70,40,1873,935,938,233,225,203,79,0
42367,316,157,159,45,38,22,19,396,197,199,75,49,49,16,0
42368,346,209,137,46,37,44,10,792,398,394,109,96,90,39,0
42369,215,117,98,28,19,15,8,535,301,234,63,48,47,27,0
42370,704,342,362,113,91,85,33,418,246,172,52,39,57,10,0
42371,507,242,265,53,44,31,22,403,225,178,56,38,33,25,0
42372,272,173,99,32,32,11,8,275,155,120,37,31,16,14,0
42373,681,367,314,83,74,78,31,1154,489,665,200,196,95,54,0
42374,1342,640,702,187,163,123,57,963,455,508,127,130,115,48,0
42375,332,173,159,48,42,42,9,374,202,172,50,39,31,24,0
42376,785,351,434,136,93,71,37,501,240,261,80,62,49,42,0
42377,220,113,107,37,24,16,7,425,177,248,60,62,33,16,0
42378,404,197,207,60,48,47,20,178,99,79,31,19,26,8,0
42379,734,339,395,135,89,78,36,293,142,151,49,40,42,17,0
42380,462,258,204,59,41,56,15,312,165,147,41,39,29,16,0
42381,428,226,202,52,60,75,20,736,388,348,88,85,67,28,0
42382,414,195,219,51,60,40,17,266,150,116,28,28,24,12,0
42383,395,219,176,47,41,50,18,963,525,438,119,102,102,34,0
42384,426,213,213,60,56,46,24,346,196,150,43,26,27,14,0
42385,98,32,66,15,25,5,4,123,61,62,17,18,17,7,0
42386,1257,464,793,221,264,75,37,98,49,49,14,15,9,2,0
42387,527,254,273,67,66,70,31,135,65,70,21,25,15,9,0
42388,130,72,58,28,9,7,1,376,189,187,47,53,44,26,0
42389,546,285,261,71,49,47,24,900,441,459,125,127,110,32,0
42390,626,300,326,91,82,68,26,1230,644,586,198,125,123,61,0
42391,358,206,152,45,38,67,16,132,61,71,19,20,14,6,0
42392,453,240,213,53,33,44,16,424,179,245,65,67,29,11,0
42393,243,70,173,54,65,8,6,508,261,247,65,53,58,23,0
42394,575,295,280,89,68,54,18,296,140,156,49,40,42,19,0
42395,747,469,278,60,41,53,23,309,164,145,35,47,30,11,0
42396,241,122,119,27,34,17,16,106,41,65,36,6,11,7,0
42397,726,312,414,121,73,82,23,279,142,137,43,39,28,7,0
42398,300,136,164,45,35,45,14,579,285,294,78,72,64,32,0
42399,815,356,459,128,125,82,26,135,57,78,21,20,9,11,0
42400,1041,497,544,180,167,98,34,479,215,264,67,80,46,28,0
42401,527,276,251,64,60,70,20,2547,1280,1267,331,335,293,118,0
42402,179,96,83,24,8,26,4,408,221,187,55,51,57,14,0
42403,149,68,81,15,38,11,10,381,187,194,37,49,36,17,0
42404,426,231,195,51,52,45,24,137,63,74,20,22,14,6,0
42405,397,180,217,61,59,39,13,385,188,197,57,42,36,16,0
42406,963,477,486,134,143,123,38,285,146,139,41,41,48,13,0
42407,756,265,491,129,127,51,17,447,212,235,86,55,58,21,0
42408,332,170,162,44,38,39,10,173,90,83,21,36,12,15,0
42409,351,166,185,48,61,24,15,232,108,124,33,27,19,16,0
42410,118,51,67,25,13,6,7,906,455,451,116,105,87,46,0
42411,326,176,150,35,22,29,11,1113,480,633,170,173,81,34,0
42412,760,405,355,112,95,92,29,317,161,156,40,49,41,11,0
42413,527,254,273,67,66,70,31,189,95,94,25,33,16,8,0
42414,1447,698,749,214,180,116,46,153,65,88,28,21,20,8,0
42415,204,93,111,35,35,16,11,123,61,62,17,18,17,7,0
42416,127,62,65,13,33,7,6,766,386,380,101,81,78,31,0
42417,450,231,219,77,50,76,16,339,175,164,51,49,37,9,0
42418,475,235,240,77,58,43,22,474,268,206,66,42,45,24,0
42419,862,384,478,127,110,75,42,501,249,252,77,70,55,22,0
42420,265,165,100,32,19,27,5,374,202,172,50,39,31,24,0
42421,983,449,534,95,77,55,36,508,253,255,73,60,50,13,0
42422,632,360,272,75,65,36,19,873,366,507,127,125,75,21,0
42423,305,124,181,27,25,31,21,246,107,139,55,33,27,11,0
42424,1390,705,685,219,164,129,74,821,394,427,122,117,109,38,0
42425,264,122,142,46,24,35,10,381,186,195,69,55,46,15,0
42426,4640,2231,2409,660,549,437,245,207,86,121,34,39,11,13,0
42427,427,191,236,67,60,41,34,251,143,108,47,25,29,11,0
42428,636,288,348,94,77,65,30,218,115,103,32,32,34,11,0
42429,431,245,186,50,23,46,17,178,69,109,29,25,21,13,0
42430,406,207,199,56,46,68,19,421,222,199,69,50,60,18,0
42431,1555,702,853,250,199,139,31,330,166,164,55,51,36,16,0
42432,1580,742,838,208,146,144,71,928,440,488,111,157,82,35,0
42433,886,440,446,116,140,95,45,396,199,197,54,50,45,14,0
42434,130,70,60,30,9,8,1,439,231,208,65,51,55,17,0
42435,443,212,231,74,24,60,24,132,61,71,19,20,14,6,0
42436,186,56,130,46,50,16,7,125,66,59,24,16,11,5,0
42437,313,178,135,43,18,35,6,65,32,33,16,4,8,3,0
42438,255,136,119,39,20,32,10,2542,1245,1297,285,287,170,84,0
42439,881,492,389,87,97,59,51,188,105,83,25,17,24,7,0
42440,300,136,164,45,35,45,14,414,203,211,58,56,48,14,0
42441,326,154,172,45,39,20,10,258,129,129,45,24,31,10,0
42442,178,74,104,31,28,9,4,264,138,126,33,34,29,12,0
42443,1221,597,624,201,152,83,31,699,334,365,108,80,70,20,0
42444,1214,498,716,197,180,121,65,4646,2328,2318,674,639,475,170,0
42445,559,217,342,105,86,42,16,277,152,125,31,35,22,19,0
42446,524,361,163,41,8,28,16,267,141,126,53,27,23,7,0
42447,118,56,62,24,12,6,9,947,482,465,143,107,89,37,0
42448,251,131,120,49,35,25,5,538,274,264,84,67,52,35,0
42449,240,167,73,32,12,8,21,270,162,108,26,26,16,11,0
42450,1014,488,526,178,137,94,39,220,107,113,36,35,28,9,0
42451,717,281,436,165,81,112,49,323,171,152,48,41,40,16,0
42452,726,312,414,121,73,82,23,137,63,74,20,22,14,6,0
42453,150,60,90,27,16,6,3,338,169,169,53,44,39,21,0
42454,867,415,452,123,87,62,27,359,171,188,49,74,45,11,0
42455,496,209,287,113,55,72,14,252,130,122,45,23,32,11,0
42456,180,92,88,29,20,26,8,348,212,136,53,31,25,18,0
42457,166,59,107,36,41,10,4,541,279,262,79,82,31,32,0
42458,180,92,88,29,20,26,8,459,260,199,56,42,47,21,0
42459,594,248,346,104,109,53,5,277,145,132,41,32,22,10,0
42460,505,201,304,116,58,75,31,929,459,470,140,120,94,45,0
42461,326,154,172,45,39,20,10,264,138,126,33,34,29,12,0
42462,502,229,273,63,66,40,31,378,154,224,74,84,35,22,0
42463,372,189,183,60,44,41,18,679,338,341,96,95,40,23,0
42464,1542,682,860,290,158,120,47,156,90,66,17,22,11,10,0
42465,378,202,176,34,32,44,13,654,295,359,99,88,71,25,0
42466,1220,575,645,208,179,99,56,323,168,155,51,41,38,12,0
42467,580,308,272,82,79,58,25,227,130,97,32,25,22,12,0
42468,682,292,390,89,69,58,20,277,124,153,44,40,35,18,0
42469,102,22,80,48,8,18,6,223,113,110,31,33,22,12,0
42470,887,439,448,137,99,91,38,189,95,94,25,33,16,8,0
42471,138,35,103,38,2,15,9,461,223,238,45,62,18,35,0
42472,264,122,142,33,29,13,13,325,172,153,44,34,27,14,0
42473,245,111,134,36,27,18,6,316,166,150,45,38,37,13,0
42474,598,322,276,67,57,63,26,926,425,501,159,147,77,35,0
42475,427,191,236,67,60,41,34,274,157,117,40,29,40,8,0
42476,546,285,261,71,49,47,24,172,88,84,24,31,20,12,0
42477,331,177,154,54,38,27,11,1382,508,874,334,320,98,36,0
42478,480,267,213,49,44,70,21,303,137,166,54,54,31,15,0
42479,332,173,159,48,42,42,9,592,249,343,91,90,50,42,0
42480,431,216,215,46,40,33,9,160,60,100,23,40,19,11,0
42481,580,265,315,97,89,79,17,198,115,83,30,22,8,8,0
42482,251,139,112,41,18,27,11,180,115,65,17,12,9,9,0
42483,739,323,416,127,89,76,33,136,65,71,26,11,7,5,0
42484,410,208,202,59,58,43,26,173,94,79,18,24,12,7,0
42485,207,89,118,56,8,4,3,111,60,51,17,23,10,7,0
42486,71,39,32,7,11,6,4,198,115,83,30,22,8,8,0
42487,772,383,389,105,76,82,33,148,69,79,26,18,16,3,0
42488,211,92,119,33,44,11,7,199,92,107,34,30,18,9,0
42489,143,81,62,28,9,8,1,926,425,501,159,147,77,35,0
42490,374,187,187,51,52,40,27,328,195,133,39,40,27,13,0
42491,437,225,212,61,57,66,12,769,329,440,116,66,55,22,0
42492,1555,702,853,250,199,139,31,483,258,225,70,53,54,20,0
42493,253,133,120,44,31,22,8,2724,1157,1567,269,518,239,77,0
42494,98,32,66,15,25,5,4,452,252,200,55,49,61,16,0
42495,553,276,277,88,61,45,27,230,113,117,31,40,28,10,0
42496,700,305,395,111,99,54,18,374,202,172,50,39,31,24,0
42497,2174,1057,1117,241,241,214,117,396,223,173,57,37,44,19,0
42498,2414,1189,1225,277,178,170,169,225,129,96,32,33,20,8,0
42499,531,260,271,97,68,47,11,252,130,122,45,23,32,11,0
42500,2649,1431,1218,377,299,266,102,565,237,328,75,88,32,11,0
42501,1085,646,439,108,65,36,19,137,85,52,15,11,11,2,0
42502,648,262,386,113,108,78,29,457,245,212,62,58,57,21,0
42503,462,233,229,66,49,43,30,323,168,155,51,41,38,12,0
42504,420,202,218,67,43,51,15,368,204,164,43,35,30,24,0
42505,473,212,261,72,64,45,28,207,86,121,34,39,11,13,0
42506,314,178,136,42,32,30,17,375,176,199,48,61,40,12,0
42507,118,51,67,25,13,6,7,246,125,121,38,36,30,11,0
42508,109,50,59,12,12,9,3,555,292,263,75,63,67,27,0
42509,282,135,147,27,37,30,19,149,77,72,37,10,20,5,0
42510,640,271,369,111,79,57,17,862,426,436,113,115,84,37,0
42511,504,222,282,71,64,53,29,452,254,198,72,57,38,18,0
42512,739,323,416,127,89,76,33,380,211,169,47,37,33,21,0
42513,262,133,129,44,38,31,12,399,190,209,61,41,39,18,0
42514,746,312,434,129,115,77,47,258,129,129,45,24,31,10,0
42515,249,114,135,47,33,25,4,367,199,168,62,44,34,8,0
42516,331,165,166,52,34,48,22,230,125,105,29,40,20,6,0
42517,929,410,519,187,146,53,30,445,264,181,35,35,34,14,0
42518,385,203,182,47,43,51,21,536,222,314,101,100,34,22,0
42519,439,241,198,67,40,40,13,124,69,55,14,7,9,4,0
42520,505,247,258,72,71,60,27,453,255,198,62,49,29,19,0
42521,520,240,280,67,72,42,14,364,192,172,49,36,39,14,0
42522,128,70,58,29,9,8,1,862,409,453,149,125,86,29,0
42523,972,501,471,125,156,106,39,180,95,85,22,21,17,8,0
42524,1148,472,676,229,164,86,37,487,252,235,79,58,55,26,0
42525,505,282,223,60,57,66,23,398,200,198,68,43,51,14,0
42526,682,260,422,98,83,42,31,292,155,137,50,34,29,13,0
42527,338,139,199,54,54,18,11,295,160,135,42,37,46,16,0
42528,375,167,208,55,83,44,9,354,183,171,54,43,49,8,0
42529,1120,436,684,208,120,101,115,889,505,384,107,97,99,30,0
42530,580,308,272,82,79,58,25,270,130,140,48,44,37,12,0
42531,1058,497,561,194,142,87,63,582,264,318,84,60,58,23,0
42532,339,170,169,32,17,24,13,1352,602,750,166,185,81,70,0
42533,1580,742,838,208,146,144,71,286,160,126,37,27,23,10,0
42534,717,381,336,118,103,85,29,373,189,184,54,46,50,23,0
42535,279,129,150,43,34,17,13,1214,475,739,177,250,89,49,0
42536,1342,640,702,187,163,123,57,207,86,121,34,39,11,13,0
42537,186,56,130,46,50,16,7,943,463,480,91,144,70,30,0
42538,349,167,182,54,38,30,28,363,180,183,60,34,10,6,0
42539,1217,647,570,142,160,129,45,396,199,197,54,50,45,14,0
42540,1342,640,702,187,163,123,57,943,463,480,91,144,70,30,0
42541,172,98,74,20,21,22,8,548,273,275,84,81,64,30,0
42542,434,221,213,58,47,54,15,188,88,100,53,12,15,6,0
42543,169,64,105,23,37,11,3,380,178,202,69,53,37,10,0
42544,435,222,213,67,49,67,12,334,181,153,41,40,25,15,0
42545,270,158,112,35,20,23,7,751,394,357,107,96,73,35,0
42546,332,170,162,44,38,39,10,724,353,371,94,95,71,31,0
42547,446,265,181,51,35,27,17,286,152,134,38,38,32,11,0
42548,444,250,194,58,21,60,23,531,261,270,73,80,68,26,0
42549,580,281,299,95,60,74,29,701,380,321,94,84,96,34,0
42550,292,102,190,71,27,51,21,548,296,252,71,74,43,28,0
42551,593,282,311,75,70,29,25,723,363,360,107,106,52,14,0
42552,339,118,221,77,68,33,13,663,354,309,91,84,79,31,0
42553,674,268,406,118,96,70,21,665,361,304,87,91,84,31,0
42554,1096,563,533,158,136,120,53,627,323,304,81,90,53,27,0
42555,123,58,65,22,14,13,3,302,150,152,56,40,52,15,0
42556,584,340,244,77,60,47,25,127,64,63,26,8,12,8,0
42557,161,94,67,23,13,8,10,723,353,370,120,109,96,33,0
42558,471,221,250,87,68,42,25,240,141,99,34,28,29,8,0
42559,257,122,135,44,19,21,16,283,142,141,41,33,26,18,0
42560,595,339,256,64,36,54,24,2382,1162,1220,237,220,140,49,0
42561,255,136,119,39,20,32,10,903,436,467,128,116,83,33,0
42562,480,257,223,74,26,60,27,474,268,206,66,42,45,24,0
42563,301,150,151,45,47,33,13,133,61,72,21,19,13,4,0
42564,285,148,137,31,42,42,16,536,251,285,75,79,60,23,0
42565,253,133,120,44,31,22,8,660,332,328,84,73,47,19,0
42566,4640,2231,2409,660,549,437,245,320,168,152,38,42,24,18,0
42567,911,445,466,154,121,108,48,889,505,384,107,97,99,30,0
42568,524,262,262,62,72,39,49,89,51,38,15,15,5,4,0
42569,677,361,316,81,61,42,22,535,301,234,63,48,47,27,0
42570,217,98,119,38,35,18,9,417,232,185,58,50,29,21,0
42571,249,114,135,47,33,25,4,264,138,126,33,34,29,12,0
42572,125,57,68,31,10,10,3,699,334,365,108,80,70,20,0
42573,1214,498,716,197,180,121,65,303,137,166,54,54,31,15,0
42574,582,328,254,78,48,35,9,218,114,104,32,31,33,11,0
42575,350,172,178,61,45,32,13,194,106,88,33,10,15,6,0
42576,465,240,225,50,54,24,14,929,459,470,140,120,94,45,0
42577,1189,653,536,152,118,109,56,501,240,261,80,62,49,42,0
42578,579,281,298,91,78,74,27,1352,602,750,166,185,81,70,0
42579,589,282,307,68,67,70,23,475,251,224,67,49,48,23,0
42580,468,233,235,65,61,49,34,201,98,103,28,25,19,13,0
42581,837,381,456,123,109,65,25,455,191,264,68,86,21,19,0
42582,979,534,445,83,77,80,24,278,154,124,42,32,38,7,0
42583,736,353,383,117,83,71,18,277,152,125,31,35,22,19,0
42584,979,534,445,83,77,80,24,137,63,74,20,22,14,6,0
42585,413,206,207,38,55,19,10,127,66,61,13,14,19,8,0
42586,385,179,206,58,56,38,19,496,251,245,78,62,61,23,0
42587,485,246,239,74,48,47,22,364,189,175,58,41,35,17,0
42588,562,214,348,120,86,69,42,455,191,264,68,86,21,19,0
42589,503,260,243,46,56,33,16,270,130,140,48,44,37,12,0
42590,219,100,119,40,29,21,3,1065,581,484,134,97,76,46,0
42591,646,304,342,104,93,58,26,94,45,49,11,20,10,4,0
42592,117,57,60,17,14,11,10,302,150,152,56,40,52,15,0
42593,1447,698,749,214,180,116,46,583,321,262,73,67,45,25,0
42594,785,351,434,136,93,71,37,478,254,224,67,74,56,28,0
42595,349,167,182,54,38,30,28,821,394,427,122,117,109,38,0
42596,538,263,275,71,85,44,18,644,343,301,96,69,59,28,0
42597,331,177,154,54,38,27,11,276,149,127,34,31,32,10,0
42598,574,284,290,64,50,65,20,467,231,236,71,65,58,18,0
42599,346,186,160,40,37,34,21,244,143,101,31,29,26,8,0
42600,1011,559,452,121,97,132,33,673,313,360,102,101,46,17,0
42601,407,164,243,88,42,40,22,330,166,164,55,51,36,16,0
42602,126,58,68,31,10,10,3,179,101,78,25,15,13,13,0
42603,469,253,216,49,51,48,18,846,425,421,125,97,98,38,0
42604,313,134,179,58,37,43,19,1700,731,969,198,233,110,87,0
42605,336,199,137,46,22,51,13,91,44,47,9,12,4,7,0
42606,413,236,177,41,25,35,19,173,90,83,21,36,12,15,0
42607,242,111,131,35,35,17,13,926,425,501,159,147,77,35,0
42608,364,168,196,64,61,27,6,72,33,39,8,2,3,12,0
42609,217,109,108,30,23,28,10,858,398,460,126,138,75,39,0
42610,1464,693,771,153,136,91,86,1698,875,823,222,219,173,64,0
42611,743,366,377,41,37,26,14,1248,584,664,184,164,155,67,0
42612,588,317,271,78,49,54,17,737,397,340,87,104,90,14,0
42613,1439,713,726,195,180,110,34,479,215,264,67,80,46,28,0
42614,155,85,70,17,16,4,8,366,204,162,47,41,31,23,0
42615,502,236,266,66,66,58,17,395,198,197,55,55,36,10,0
42616,255,110,145,34,32,23,17,548,273,275,84,81,64,30,0
42617,236,141,95,36,32,14,6,689,343,346,105,102,81,35,0
42618,118,56,62,24,12,6,9,501,257,244,75,57,48,29,0
42619,766,336,430,133,97,79,21,904,436,468,143,118,108,32,0
42620,1112,457,655,180,164,99,39,165,87,78,24,19,22,9,0
42621,1124,442,682,148,189,72,43,975,475,500,139,140,119,28,0
42622,531,259,272,75,81,39,13,222,127,95,23,28,22,7,0
42623,245,111,134,36,27,18,6,410,197,213,67,43,56,18,0
42624,269,124,145,36,24,32,11,165,90,75,36,18,20,6,0
42625,311,154,157,47,29,34,13,662,373,289,89,80,77,29,0
42626,1226,513,713,184,147,87,43,732,402,330,81,86,87,33,0
42627,465,305,160,40,47,34,9,286,160,126,37,27,23,10,0
42628,165,66,99,28,32,16,3,649,307,342,71,134,45,17,0
42629,666,204,462,110,194,42,14,392,214,178,48,40,53,22,0
42630,520,240,280,67,72,42,14,585,277,308,92,73,61,32,0
42631,275,160,115,40,31,34,17,504,272,232,75,57,53,19,0
42632,304,149,155,46,32,39,14,198,110,88,27,27,24,4,0
42633,335,183,152,40,26,54,22,723,363,360,107,106,52,14,0
42634,533,297,236,74,57,39,28,418,223,195,53,43,49,15,0
42635,346,205,141,47,34,30,7,102,51,51,12,15,12,3,0
42636,126,56,70,31,10,10,3,154,78,76,23,21,13,5,0
42637,257,148,109,28,20,21,14,565,237,328,75,88,32,11,0
42638,1531,649,882,108,122,93,72,337,152,185,49,54,42,21,0
42639,428,226,202,52,60,75,20,758,319,439,101,123,78,25,0
42640,760,322,438,81,130,57,19,314,177,137,34,40,29,9,0
42641,520,240,280,67,72,42,14,715,345,370,110,97,64,25,0
42642,641,349,292,92,60,39,24,457,242,215,39,46,53,10,0
42643,540,252,288,73,67,57,20,98,49,49,14,15,9,2,0
42644,524,270,254,84,72,70,23,231,126,105,37,26,29,6,0
42645,431,202,229,57,50,50,25,497,257,240,71,63,62,16,0
42646,238,91,147,68,19,22,7,323,168,155,51,41,38,12,0
42647,312,173,139,43,47,28,6,509,267,242,79,81,38,20,0
42648,425,198,227,57,69,59,13,125,66,59,24,16,11,5,0
42649,760,322,438,81,130,57,19,261,148,113,31,28,14,10,0
42650,516,224,292,79,29,45,33,588,286,302,78,99,53,25,0
42651,524,361,163,41,8,28,16,68,23,45,12,9,3,9,0
42652,401,183,218,72,73,28,10,404,190,214,55,55,35,27,0
42653,200,103,97,17,16,10,10,261,148,113,31,28,14,10,0
42654,346,191,155,52,38,40,13,257,139,118,64,17,24,7,0
42655,192,91,101,28,21,18,8,386,207,179,43,48,44,19,0
42656,361,177,184,59,51,24,15,350,196,154,52,37,21,14,0
42657,340,145,195,46,38,26,23,374,174,200,54,52,42,21,0
42658,317,140,177,43,26,31,16,339,180,159,36,29,16,16,0
42659,313,134,179,58,37,43,19,396,223,173,57,37,44,19,0
42660,301,156,145,32,25,15,5,296,151,145,45,42,32,11,0
42661,3859,2011,1848,535,391,422,207,732,366,366,108,86,74,41,0
42662,103,56,47,27,7,8,2,68,36,32,11,8,9,2,0
42663,685,393,292,75,66,113,16,947,482,465,143,107,89,37,0
42664,246,123,123,40,31,27,7,935,515,420,126,107,73,32,0
42665,577,342,235,63,57,23,37,975,400,575,160,162,62,31,0
42666,1099,491,608,163,141,107,62,892,475,417,130,108,68,38,0
42667,519,259,260,86,78,59,22,373,189,184,54,46,50,23,0
42668,136,65,71,33,11,9,6,528,276,252,86,78,49,17,0
42669,539,283,256,75,73,53,26,156,90,66,17,22,11,10,0
42670,1327,520,807,241,174,141,60,373,213,160,44,33,26,17,0
42671,282,84,198,60,102,1,6,301,168,133,49,37,34,11,0
42672,416,222,194,58,38,38,20,978,536,442,132,107,67,32,0
42673,109,50,59,12,12,9,3,86,40,46,16,13,9,7,0
42674,412,193,219,69,57,43,14,266,146,120,41,28,31,7,0
42675,618,289,329,97,86,70,17,405,195,210,57,74,24,17,0
42676,960,409,551,166,134,77,44,547,295,252,81,65,57,23,0
42677,836,370,466,126,96,72,30,335,186,149,40,28,29,13,0
42678,411,202,209,60,67,57,24,380,211,169,47,37,33,21,0
42679,346,191,155,52,38,40,13,889,505,384,107,97,99,30,0
42680,4640,2231,2409,660,549,437,245,278,154,124,42,32,38,7,0
42681,213,88,125,21,54,14,15,953,489,464,126,104,111,44,0
42682,250,123,127,40,28,29,8,647,324,323,101,80,76,43,0
42683,532,254,278,91,48,23,17,640,364,276,84,68,69,33,0
42684,474,250,224,58,47,37,12,166,78,88,27,25,19,7,0
42685,717,281,436,165,81,112,49,380,178,202,69,53,37,10,0
42686,688,310,378,130,82,78,47,89,37,52,13,6,2,9,0
42687,251,131,120,49,35,25,5,528,276,252,86,78,49,17,0
42688,259,119,140,48,28,29,19,192,110,82,33,21,10,3,0
42689,465,240,225,50,54,24,14,297,164,133,45,39,40,9,0
42690,204,93,111,35,35,16,11,375,176,199,48,61,40,12,0
42691,420,202,218,67,43,51,15,425,177,248,60,62,33,16,0
42692,346,186,160,40,37,34,21,218,115,103,37,33,33,9,0
42693,1441,504,937,264,329,69,46,972,471,501,152,138,112,40,0
42694,960,409,551,166,134,77,44,483,258,225,70,53,54,20,0
42695,443,212,231,74,24,60,24,375,210,165,49,37,29,27,0
42696,180,92,88,29,20,26,8,346,196,150,43,26,27,14,0
42697,284,128,156,48,29,34,8,452,252,200,55,49,61,16,0
42698,480,232,248,73,40,44,30,277,144,133,42,30,41,8,0
42699,594,279,315,93,68,68,26,173,94,79,18,24,12,7,0
42700,374,187,187,51,52,40,27,286,152,134,38,38,32,11,0
42701,127,62,65,13,33,7,6,452,254,198,72,57,38,18,0
42702,1867,973,894,256,222,194,65,165,90,75,36,18,20,6,0
42703,271,136,135,37,30,18,10,582,264,318,84,60,58,23,0
42704,502,236,266,66,66,58,17,549,273,276,74,68,72,24,0
42705,128,67,61,29,9,9,1,419,233,186,54,53,55,17,0
42706,436,201,235,54,37,35,18,1040,564,476,134,110,114,51,0
42707,567,266,301,139,46,76,37,139,68,71,14,26,14,9,0
42708,651,357,294,81,67,103,18,194,106,88,33,10,15,6,0
42709,282,96,186,80,21,28,7,368,204,164,43,35,30,24,0
42710,760,405,355,112,95,92,29,398,200,198,68,43,51,14,0
42711,135,64,71,31,11,8,4,528,276,252,86,78,49,17,0
42712,302,178,124,34,29,50,13,375,176,199,48,61,40,12,0
42713,365,148,217,86,37,51,28,172,79,93,34,27,23,10,0
42714,272,122,150,33,30,27,26,369,181,188,41,36,54,16,0
42715,445,231,214,45,64,53,23,142,73,69,27,9,15,11,0
42716,445,231,214,45,64,53,23,467,231,236,71,65,58,18,0
42717,385,179,206,58,56,38,19,545,269,276,80,76,27,32,0
42718,824,391,433,106,90,88,32,372,189,183,60,44,41,18,0
42719,269,156,113,37,32,17,7,175,91,84,19,21,21,10,0
42720,726,312,414,121,73,82,23,180,95,85,22,21,17,8,0
42721,886,440,446,116,140,95,45,528,276,252,86,78,49,17,0
42722,144,57,87,38,26,10,4,334,182,152,45,41,27,13,0
42723,4128,2104,2024,581,505,453,205,889,505,384,107,97,99,30,0
42724,301,150,151,45,47,33,13,1262,653,609,169,165,152,50,0
42725,398,186,212,76,70,18,13,654,295,359,99,88,71,25,0
42726,444,250,194,58,21,60,23,1262,653,609,169,165,152,50,0
42727,1464,693,771,153,136,91,86,227,130,97,32,25,22,12,0
42728,111,29,82,10,54,0,1,127,64,63,26,8,12,8,0
42729,1276,607,669,192,178,136,63,1020,538,482,145,115,111,58,0
42730,485,246,239,74,48,47,22,406,202,204,54,51,63,21,0
42731,193,90,103,44,9,19,13,516,245,271,82,84,70,26,0
42732,259,119,140,48,28,29,19,346,196,150,43,26,27,14,0
42733,178,89,89,40,12,18,7,374,181,193,55,58,48,23,0
42734,911,489,422,121,98,97,36,387,193,194,60,53,57,15,0
42735,347,212,135,35,32,17,6,149,77,72,37,10,20,5,0
42736,314,158,156,39,28,30,17,137,63,74,20,22,14,6,0
42737,330,151,179,68,36,56,9,119,61,58,17,12,10,6,0
42738,473,265,208,47,26,50,30,2038,1059,979,262,237,208,100,0
42739,1174,594,580,175,155,126,66,514,262,252,78,58,54,26,0
42740,587,318,269,76,50,38,21,487,252,235,79,58,55,26,0
42741,251,139,112,41,18,27,11,1248,584,664,184,164,155,67,0
42742,330,151,179,68,36,56,9,241,127,114,34,33,29,12,0
42743,911,445,466,154,121,108,48,2038,1059,979,262,237,208,100,0
42744,380,148,232,81,69,24,8,317,161,156,40,49,41,11,0
42745,717,281,436,165,81,112,49,457,245,212,62,58,57,21,0
42746,805,338,467,153,138,99,55,103,59,44,25,2,13,6,0
42747,1339,494,845,216,298,92,37,352,207,145,40,33,25,21,0
42748,413,236,177,41,25,35,19,531,261,270,73,80,68,26,0
42749,1336,724,612,209,141,133,60,583,280,303,95,66,76,25,0
42750,270,128,142,36,43,15,11,1061,543,518,146,123,109,67,0
42751,107,56,51,18,16,12,5,165,87,78,24,19,22,9,0
42752,900,434,466,134,97,86,36,509,267,242,79,81,38,20,0
42753,329,171,158,49,41,31,10,1062,522,540,151,147,105,66,0
42754,482,231,251,76,81,64,26,290,147,143,34,34,39,13,0
42755,446,283,163,51,26,33,19,4646,2328,2318,674,639,475,170,0
42756,941,459,482,167,140,82,38,230,125,105,29,40,20,6,0
42757,2279,996,1283,375,328,158,60,359,171,188,49,74,45,11,0
42758,2285,1219,1066,207,180,178,106,331,180,151,46,35,47,17,0
42759,1004,464,540,143,104,78,55,453,255,198,62,49,29,19,0
42760,575,290,285,67,70,28,9,212,127,85,28,21,26,6,0
42761,1395,595,800,223,206,113,61,286,160,126,37,27,23,10,0
42762,299,128,171,57,40,13,25,242,124,118,39,32,28,22,0
42763,465,220,245,88,34,61,23,341,170,171,41,66,27,10,0
42764,580,265,315,97,89,79,17,276,149,127,34,31,32,10,0
42765,284,128,156,48,29,34,8,192,110,82,33,21,10,3,0
42766,202,103,99,28,20,12,8,375,210,165,49,37,29,27,0
42767,326,148,178,55,42,31,12,1230,644,586,198,125,123,61,0
42768,280,156,124,36,19,20,13,180,108,72,22,22,15,5,0
42769,480,232,248,73,40,44,30,4646,2328,2318,674,639,475,170,0
42770,293,153,140,45,38,22,15,958,451,507,165,135,97,41,0
42771,333,171,162,50,34,19,8,584,249,335,80,96,22,13,0
42772,188,84,104,35,36,18,9,661,325,336,81,75,65,28,0
42773,640,308,332,91,102,49,21,267,141,126,53,27,23,7,0
42774,781,316,465,130,129,65,23,223,113,110,31,33,22,12,0
42775,2696,1169,1527,432,347,193,146,424,179,245,65,67,29,11,0
42776,92,46,46,14,9,8,6,504,272,232,75,57,53,19,0
42777,371,143,228,77,48,29,26,457,242,215,39,46,53,10,0
42778,667,366,301,96,55,84,25,222,122,100,39,32,24,9,0
42779,181,75,106,35,26,11,9,391,165,226,67,64,36,27,0
42780,128,67,61,29,9,9,1,72,32,40,8,2,2,13,0
42781,579,321,258,74,70,47,22,228,130,98,35,29,30,10,0
42782,507,242,265,53,44,31,22,367,199,168,62,44,34,8,0
42783,447,236,211,56,52,49,14,514,262,252,78,58,54,26,0
42784,785,374,411,56,42,38,25,483,215,268,66,70,30,16,0
42785,279,127,152,50,36,28,8,134,72,62,14,28,8,4,0
42786,545,221,324,101,72,55,30,457,253,204,67,51,48,13,0
42787,952,547,405,95,90,127,35,325,159,166,59,46,30,12,0
42788,127,48,79,27,20,6,5,305,161,144,39,40,44,17,0
42789,272,136,136,32,34,12,12,91,42,49,21,9,8,3,0
42790,533,297,236,74,57,39,28,194,94,100,33,28,14,7,0
42791,438,185,253,71,64,52,28,619,305,314,85,93,71,29,0
42792,493,208,285,75,77,70,40,773,389,384,119,91,79,26,0
42793,1555,702,853,250,199,139,31,520,244,276,91,60,68,20,0
42794,784,351,433,118,87,73,41,103,50,53,19,10,7,5,0
42795,2136,1063,1073,317,308,223,90,160,60,100,23,40,19,11,0
42796,565,264,301,101,73,72,15,1239,659,580,169,148,131,54,0
42797,375,201,174,52,56,39,15,91,42,49,21,9,8,3,0
42798,410,188,222,53,52,31,14,1700,731,969,198,233,110,87,0
42799,649,304,345,99,80,67,40,230,125,105,29,40,20,6,0
42800,941,459,482,167,140,82,38,218,115,103,32,32,34,11,0
42801,180,92,88,29,20,26,8,230,113,117,31,40,28,10,0
42802,837,443,394,129,89,87,38,633,311,322,94,82,45,20,0
42803,374,202,172,58,40,41,7,227,130,97,32,25,22,12,0
42804,83,45,38,11,8,8,3,374,202,172,50,39,31,24,0
42805,517,196,321,103,98,33,12,260,131,129,42,31,40,9,0
42806,517,196,321,103,98,33,12,627,289,338,101,73,62,43,0
42807,553,276,277,88,61,45,27,222,122,100,39,32,24,9,0
42808,760,322,438,81,130,57,19,270,162,108,26,26,16,11,0
42809,364,172,192,55,57,32,15,375,176,199,48,61,40,12,0
42810,138,35,103,38,2,15,9,381,196,185,55,57,43,16,0
42811,836,370,466,126,96,72,30,297,175,122,46,30,31,6,0
42812,202,103,99,28,20,12,8,1101,626,475,145,122,120,50,0
42813,488,237,251,79,78,65,27,422,237,185,53,47,62,20,0
42814,722,390,332,125,69,67,25,91,44,47,9,12,4,7,0
42815,478,220,258,47,70,41,10,375,176,199,48,61,40,12,0
42816,272,136,136,32,34,12,12,218,118,100,33,30,25,11,0
42817,281,154,127,45,31,24,9,423,234,189,66,44,57,12,0
42818,952,547,405,95,90,127,35,447,212,235,86,55,58,21,0
42819,867,415,452,123,87,62,27,441,189,252,73,50,47,23,0
42820,1208,575,633,187,204,117,41,375,209,166,50,37,29,23,0
42821,164,61,103,47,19,14,5,215,115,100,27,19,16,7,0
42822,503,260,243,46,56,33,16,536,222,314,101,100,34,22,0
42823,900,434,466,134,97,86,36,413,223,190,52,45,53,10,0
42824,450,241,209,67,58,54,23,715,345,370,110,97,64,25,0
42825,228,105,123,34,43,20,10,445,202,243,70,73,51,15,0
42826,704,342,362,113,91,85,33,312,165,147,41,39,29,16,0
42827,533,297,236,74,57,39,28,1698,875,823,222,219,173,64,0
42828,476,276,200,57,34,43,16,748,359,389,125,113,86,31,0
42829,330,77,253,86,52,20,12,194,109,85,23,24,21,9,0
42830,378,202,176,34,32,44,13,334,181,153,41,40,25,15,0
42831,1616,735,881,285,248,153,72,1352,602,750,166,185,81,70,0
42832,215,117,98,28,19,15,8,647,324,323,101,80,76,43,0
42833,507,242,265,53,44,31,22,627,323,304,81,90,53,27,0
42834,2062,706,1356,414,368,158,63,483,287,196,71,50,54,17,0
42835,548,310,238,72,62,54,13,541,279,262,79,82,31,32,0
42836,1220,575,645,208,179,99,56,96,46,50,16,12,7,5,0
42837,798,364,434,133,88,74,35,421,222,199,69,50,60,18,0
42838,584,340,244,77,60,47,25,508,253,255,73,60,50,13,0
42839,557,211,346,129,125,48,19,367,199,168,62,44,34,8,0
42840,1390,585,805,241,230,118,46,507,270,237,89,59,57,22,0
42841,55,16,39,24,2,5,2,792,398,394,109,96,90,39,0
42842,604,239,365,124,63,84,37,266,146,120,41,28,31,7,0
42843,278,104,174,46,34,23,14,654,295,359,99,88,71,25,0
42844,595,316,279,86,60,65,40,415,226,189,51,40,40,29,0
42845,441,216,225,57,66,57,19,514,248,266,86,82,52,22,0
42846,458,210,248,39,38,25,16,660,332,328,84,73,47,19,0
42847,300,136,164,45,35,45,14,336,200,136,34,29,25,24,0
42848,130,71,59,30,9,8,1,271,150,121,39,36,37,5,0
42849,519,259,260,86,78,59,22,252,130,122,45,23,32,11,0
42850,130,71,59,30,9,8,1,270,130,140,48,44,37,12,0
42851,219,100,119,40,29,21,3,296,151,145,45,42,32,11,0
42852,439,183,256,60,64,36,14,364,189,175,58,41,35,17,0
42853,255,136,119,39,20,32,10,136,65,71,26,11,7,5,0
42854,618,289,329,97,86,70,17,375,211,164,50,36,31,23,0
42855,444,250,194,58,21,60,23,234,116,118,34,35,23,9,0
42856,793,355,438,134,117,77,43,278,154,124,42,32,38,7,0
42857,565,264,301,101,73,72,15,421,222,199,69,50,60,18,0
42858,567,256,311,91,81,53,17,723,353,370,120,109,96,33,0
42859,270,147,123,34,17,39,21,564,264,300,79,84,65,26,0
42860,854,435,419,118,91,95,42,349,200,149,41,39,30,20,0
42861,249,114,135,47,33,25,4,530,287,243,79,70,33,26,0
42862,531,284,247,66,42,49,15,621,310,311,100,106,77,27,0
42863,146,75,71,13,32,15,11,690,345,345,96,83,73,42,0
42864,479,227,252,69,48,46,18,1208,565,643,182,162,120,57,0
42865,343,162,181,65,38,29,12,172,79,93,34,27,23,10,0
42866,346,191,155,52,38,40,13,821,394,427,122,117,109,38,0
42867,1759,838,921,269,212,191,92,375,210,165,49,37,29,27,0
42868,221,75,146,68,21,16,5,699,334,365,108,80,70,20,0
42869,1709,650,1059,338,286,185,46,337,170,167,59,33,47,17,0
42870,128,70,58,29,9,8,1,902,499,403,118,117,92,35,0
42871,900,434,466,134,97,86,36,260,133,127,43,32,39,3,0
42872,142,76,66,21,21,22,11,660,303,357,97,89,85,33,0
42873,493,208,285,75,77,70,40,207,114,93,33,20,31,13,0
42874,240,166,74,32,12,8,15,663,360,303,87,82,80,35,0
42875,238,91,147,68,19,22,7,277,152,125,31,35,22,19,0
42876,1403,702,701,176,173,168,74,239,110,129,32,32,24,10,0
42877,860,348,512,121,136,75,35,663,354,309,91,84,79,31,0
42878,521,249,272,53,36,50,18,462,251,211,74,53,41,18,0
42879,567,256,311,91,81,53,17,132,77,55,20,9,13,10,0
42880,340,181,159,44,39,35,21,391,189,202,55,56,56,12,0
42881,345,208,137,44,27,33,8,1352,602,750,166,185,81,70,0
42882,503,260,243,46,56,33,16,498,244,254,81,67,58,19,0
42883,426,196,230,76,65,54,20,203,98,105,34,29,19,10,0
42884,165,66,99,28,32,16,3,332,155,177,55,51,44,13,0
42885,414,206,208,56,68,35,19,133,61,72,21,19,13,4,0
42886,441,218,223,69,55,50,27,127,54,73,11,33,15,6,0
42887,107,53,54,15,15,13,4,152,71,81,41,16,14,2,0
42888,143,81,62,28,9,8,1,325,172,153,44,34,27,14,0
42889,640,271,369,111,79,57,17,947,482,465,143,107,89,37,0
42890,320,163,157,44,44,26,15,496,251,245,78,62,61,23,0
42891,1555,702,853,250,199,139,31,293,142,151,49,40,42,17,0
42892,531,284,247,66,42,49,15,134,72,62,14,28,8,4,0
42893,717,381,336,118,103,85,29,296,140,156,49,40,42,19,0
42894,282,84,198,60,102,1,6,165,87,78,24,19,22,9,0
42895,411,236,175,39,45,50,30,218,115,103,37,33,33,9,0
42896,260,133,127,43,29,34,11,1154,489,665,200,196,95,54,0
42897,233,107,126,40,40,20,16,119,61,58,17,12,10,6,0
42898,462,228,234,59,47,37,32,699,334,365,108,80,70,20,0
42899,269,127,142,43,24,34,26,250,119,131,58,26,29,7,0
42900,478,177,301,109,66,59,25,508,253,255,73,60,50,13,0
42901,271,110,161,33,27,11,8,242,124,118,39,32,28,22,0
42902,763,371,392,104,88,52,23,317,161,156,50,36,47,12,0
42903,132,66,66,21,18,11,7,323,171,152,48,41,40,16,0
42904,332,173,159,48,42,42,9,732,402,330,81,86,87,33,0
42905,128,70,58,29,9,8,1,600,254,346,104,100,44,17,0
42906,929,410,519,187,146,53,30,393,210,183,58,37,34,20,0
42907,305,124,181,27,25,32,21,368,183,185,40,42,40,15,0
42908,130,71,59,30,9,8,2,129,60,69,21,15,8,5,0
42909,341,183,158,36,34,36,15,415,205,210,77,52,55,17,0
42910,682,292,390,89,69,58,20,68,36,32,11,8,9,2,0
42911,129,70,59,29,9,7,2,947,482,465,143,107,89,37,0
42912,315,170,145,48,56,22,11,326,169,157,51,41,41,12,0
42913,763,371,392,104,88,52,23,131,55,76,28,9,14,12,0
42914,587,318,269,76,50,38,21,246,107,139,55,33,27,11,0
42915,364,168,196,64,61,27,6,579,285,294,78,72,64,32,0
42916,130,71,59,30,9,8,1,106,54,52,12,9,7,6,0
42917,269,127,142,43,24,34,26,501,257,244,75,57,48,29,0
42918,485,246,239,74,48,47,22,194,94,100,33,28,14,7,0
42919,496,272,224,70,58,42,18,536,222,314,101,100,34,22,0
42920,336,199,137,46,22,51,13,180,108,72,22,22,15,5,0
42921,664,269,395,117,107,36,15,710,375,335,95,94,110,28,0
42922,1960,875,1085,287,189,162,66,467,240,227,65,65,51,23,0
42923,226,120,106,68,8,2,1,135,57,78,21,20,9,11,0
42924,51,10,41,25,0,5,8,201,93,108,34,39,21,6,0
42925,1499,864,635,141,99,76,110,520,272,248,60,65,58,22,0
42926,292,102,190,71,27,51,21,374,202,172,50,39,31,24,0
42927,820,333,487,202,152,59,23,414,203,211,58,56,48,14,0
42928,1096,563,533,158,136,120,53,406,234,172,63,35,43,10,0
42929,919,493,426,100,92,88,49,72,32,40,8,2,1,14,0
42930,244,105,139,38,28,20,15,508,215,293,72,71,42,15,0
42931,434,216,218,72,58,40,20,1020,538,482,145,115,111,58,0
42932,2624,999,1625,415,495,109,84,898,469,429,125,125,134,35,0
42933,270,158,112,35,20,23,7,1166,514,652,150,159,107,70,0
42934,649,304,345,99,80,67,40,727,388,339,102,87,70,29,0
42935,126,57,69,31,10,10,3,457,253,204,67,51,48,13,0
42936,625,283,342,93,89,67,25,509,267,242,79,81,38,20,0
42937,364,172,192,55,57,32,15,548,296,252,71,74,43,28,0
42938,243,114,129,37,30,32,8,621,310,311,100,106,77,27,0
42939,527,276,251,64,60,70,20,180,115,65,17,12,9,9,0
42940,227,120,107,31,28,28,13,88,50,38,13,8,16,4,0
42941,1007,353,654,277,147,70,26,536,251,285,75,79,60,23,0
42942,1360,644,716,213,194,136,62,386,181,205,55,51,57,31,0
42943,860,348,512,121,136,75,35,334,181,153,56,31,28,18,0
42944,531,284,247,66,42,49,15,405,214,191,53,42,49,20,0
42945,282,135,147,27,37,30,19,287,151,136,51,42,36,7,0
42946,418,163,255,57,54,38,24,374,174,200,54,52,42,21,0
42947,789,362,427,90,82,70,35,457,245,212,62,58,57,21,0
42948,941,459,482,167,140,82,38,565,264,301,101,73,72,15,0
42949,526,228,298,69,64,32,30,572,305,267,74,72,58,21,0
42950,2048,855,1193,297,287,191,93,225,111,114,32,34,32,16,0
42951,546,278,268,94,60,32,22,192,91,101,29,28,17,7,0
42952,1580,742,838,208,146,144,71,1239,659,580,169,148,131,54,0
42953,512,261,251,79,73,60,21,672,334,338,110,93,91,41,0
42954,429,227,202,49,51,46,26,778,391,387,94,77,41,33,0
42955,1214,612,602,169,173,98,35,354,183,171,54,43,49,8,0
42956,476,276,200,57,34,43,16,374,174,200,54,52,42,21,0
42957,862,384,478,127,110,75,42,2346,1231,1115,316,292,266,105,0
42958,130,72,58,28,9,7,1,172,79,93,34,27,23,10,0
42959,391,204,187,47,48,38,18,514,262,252,78,58,54,26,0
42960,384,198,186,58,48,37,12,607,293,314,98,71,62,32,0
42961,447,236,211,56,52,49,14,198,86,112,36,27,23,9,0
42962,707,250,457,171,84,117,61,541,279,262,79,82,31,32,0
42963,418,163,255,57,54,38,24,96,45,51,13,12,6,4,0
42964,688,310,378,130,82,78,47,94,45,49,11,20,10,4,0
42965,210,129,81,29,20,11,9,119,57,62,18,16,17,4,0
42966,2488,1085,1403,346,253,162,76,663,360,303,87,82,80,35,0
42967,258,144,114,33,22,19,9,225,129,96,32,33,20,8,0
42968,600,324,276,89,73,45,39,758,319,439,101,123,78,25,0
42969,257,122,135,44,19,21,16,947,482,465,143,107,89,37,0
42970,593,282,311,75,70,29,25,106,46,60,29,13,14,5,0
42971,717,281,436,165,81,112,49,1698,875,823,222,219,173,64,0
42972,463,225,238,76,36,59,26,209,119,90,28,24,27,9,0
42973,360,175,185,73,36,27,7,135,65,70,21,25,15,9,0
42974,51,10,41,25,0,5,8,148,84,64,30,7,17,4,0
42975,473,217,256,59,44,34,21,108,59,49,17,13,12,5,0
42976,292,102,190,71,27,51,21,261,162,99,24,21,14,10,0
42977,1417,598,819,223,188,135,58,545,269,276,80,76,27,32,0
42978,824,391,433,106,90,88,32,220,107,113,36,35,28,9,0
42979,485,237,248,83,35,52,24,364,189,175,58,41,35,17,0
42980,933,456,477,123,108,83,29,220,107,113,36,35,28,9,0
42981,298,141,157,51,33,21,22,153,80,73,26,18,19,4,0
42982,348,198,150,57,25,37,18,926,425,501,159,147,77,35,0
42983,1030,438,592,184,104,108,30,548,296,252,71,74,43,28,0
42984,710,352,358,104,86,84,41,286,160,126,37,27,23,10,0
42985,1043,479,564,200,131,123,62,1248,584,664,184,164,155,67,0
42986,417,222,195,53,39,43,10,130,67,63,24,10,12,4,0
42987,593,282,311,75,70,29,25,662,373,289,89,80,77,29,0
42988,414,216,198,51,32,42,28,352,207,145,40,33,25,21,0
42989,299,151,148,35,34,26,16,149,77,72,37,10,20,5,0
42990,330,182,148,47,27,40,11,244,143,101,31,29,26,8,0
42991,443,226,217,67,34,53,10,329,196,133,41,36,31,15,0
42992,297,161,136,36,35,24,9,414,203,211,58,56,48,14,0
42993,583,279,304,99,71,59,31,305,163,142,38,27,47,11,0
42994,2663,1073,1590,548,499,192,64,190,93,97,35,27,23,2,0
42995,520,240,280,87,63,67,16,352,207,145,40,33,25,21,0
42996,530,259,271,83,50,54,41,775,407,368,122,100,97,32,0
42997,227,120,107,31,28,28,13,153,80,73,26,18,19,4,0
42998,1580,742,838,208,146,144,71,430,212,218,88,43,40,20,0
42999,548,310,238,72,62,54,13,207,113,94,33,18,30,9,0
43000,2286,1154,1132,338,314,278,103,519,287,232,68,58,45,21,0
43001,532,254,278,91,48,23,17,496,251,245,78,62,61,23,0
43002,335,171,164,51,38,38,10,457,253,204,67,51,48,13,0
43003,281,125,156,44,47,17,7,296,140,156,49,40,42,19,0
43004,336,134,202,51,64,27,12,261,162,99,24,21,14,10,0
43005,1189,653,536,152,118,109,56,778,391,387,94,77,41,33,0
43006,122,56,66,26,13,11,5,565,237,328,75,88,32,11,0
43007,126,57,69,31,10,10,3,1004,457,547,150,150,74,52,0
43008,374,202,172,58,40,41,7,478,254,224,67,74,56,28,0
43009,861,393,468,150,101,69,35,344,190,154,34,31,36,10,0
43010,546,278,268,94,60,32,22,135,65,70,21,25,15,9,0
43011,4128,2104,2024,581,505,453,205,487,252,235,79,58,55,26,0
43012,553,319,234,56,37,54,18,91,44,47,9,12,4,7,0
43013,340,169,171,40,39,36,22,232,108,124,33,27,19,16,0
43014,109,50,59,12,12,9,3,565,237,328,75,88,32,11,0
43015,288,104,184,80,30,39,6,389,210,179,51,37,43,9,0
43016,2048,855,1193,297,287,191,93,467,240,227,65,65,51,23,0
43017,1257,464,793,221,264,75,37,748,359,389,125,113,86,31,0
43018,365,210,155,46,30,24,12,396,199,197,54,50,45,14,0
43019,483,236,247,82,60,43,18,479,215,264,67,80,46,28,0
43020,442,254,188,46,22,40,19,142,65,77,30,17,22,9,0
43021,437,212,225,66,44,44,11,385,212,173,57,40,39,21,0
43022,2062,706,1356,414,368,158,63,88,50,38,13,8,16,4,0
43023,472,222,250,46,61,33,23,103,59,44,25,2,13,6,0
43024,379,217,162,47,20,50,23,142,65,77,30,17,22,9,0
43025,1030,438,592,184,104,108,30,218,118,100,33,30,25,11,0
43026,331,165,166,52,34,48,22,611,314,297,79,75,78,22,0
43027,1112,457,655,180,164,99,39,405,214,191,53,42,49,20,0
43028,329,171,158,49,41,31,10,393,210,183,58,37,34,20,0
43029,346,174,172,36,43,21,9,204,80,124,29,51,10,5,0
43030,540,252,288,73,67,57,20,349,200,149,41,39,30,20,0
43031,598,322,276,67,57,63,26,144,67,77,28,14,9,8,0
43032,234,110,124,39,29,23,2,662,312,350,103,104,59,20,0
43033,426,231,195,51,52,45,24,374,191,183,40,52,40,16,0
43034,927,457,470,130,99,118,42,270,130,140,48,44,37,12,0
43035,854,435,419,118,91,95,42,593,289,304,85,69,48,19,0
43036,4640,2231,2409,660,549,437,245,257,139,118,64,17,24,7,0
43037,714,260,454,140,97,120,54,378,154,224,74,84,35,22,0
43038,282,163,119,40,23,25,17,551,226,325,96,103,43,11,0
43039,1226,513,713,184,147,87,43,239,113,126,36,49,20,8,0
43040,476,276,200,57,34,43,16,198,110,88,27,27,24,4,0
43041,512,254,258,70,48,37,32,153,80,73,26,18,19,4,0
43042,107,53,54,15,15,13,4,375,176,199,48,61,40,12,0
43043,200,103,97,17,16,10,10,1395,627,768,172,263,141,59,0
43044,341,154,187,34,36,11,11,727,388,339,102,87,70,29,0
43045,604,239,365,124,63,84,37,1001,417,584,186,147,96,47,0
43046,331,165,166,52,34,48,22,222,125,97,34,27,27,7,0
43047,466,199,267,86,59,32,17,535,301,234,63,48,47,27,0
43048,1417,598,819,223,188,135,58,376,189,187,47,53,44,26,0
43049,2649,1431,1218,377,299,266,102,756,348,408,101,103,60,40,0
43050,631,304,327,98,75,52,23,1230,644,586,198,125,123,61,0
43051,3969,1703,2266,619,432,259,144,403,192,211,102,39,49,15,0
43052,1462,711,751,219,222,148,65,386,207,179,43,48,44,19,0
43053,1064,495,569,157,159,124,58,283,160,123,25,20,37,9,0
43054,441,216,225,57,66,57,19,194,106,88,33,10,15,6,0
43055,280,128,152,39,37,38,18,88,50,38,13,8,16,4,0
43056,428,248,180,44,39,28,9,1543,794,749,182,152,132,55,0
43057,181,92,89,34,22,17,9,323,171,152,48,41,40,16,0
43058,126,56,70,31,10,10,3,160,60,100,23,40,19,11,0
43059,350,178,172,49,62,29,16,165,90,75,36,18,20,6,0
43060,584,340,244,77,60,47,25,445,202,243,70,73,51,15,0
43061,582,328,254,78,48,35,9,180,95,85,22,21,17,8,0
43062,422,207,215,79,38,53,23,462,251,211,74,53,41,18,0
43063,146,75,71,13,32,15,11,207,113,94,33,18,30,9,0
43064,1004,464,540,143,104,78,55,531,277,254,82,75,33,22,0
43065,243,114,129,37,30,32,8,329,196,133,41,36,31,15,0
43066,852,461,391,109,102,72,24,583,321,262,73,67,45,25,0
43067,373,194,179,42,54,26,13,474,268,206,66,42,45,24,0
43068,350,212,138,32,26,40,13,188,105,83,25,17,24,7,0
43069,479,227,252,69,48,46,18,147,74,73,28,20,24,4,0
43070,1139,537,602,162,139,109,50,418,246,172,52,39,57,10,0
43071,435,230,205,51,37,55,18,462,229,233,63,49,42,18,0
43072,677,361,316,81,61,42,22,133,61,72,21,19,13,4,0
43073,335,183,152,40,26,54,22,265,134,131,48,34,33,15,0
43074,631,316,315,64,57,49,15,403,192,211,102,39,49,15,0
43075,341,183,158,36,34,36,15,149,77,72,37,10,20,5,0
43076,747,469,278,60,41,53,23,485,244,241,80,55,59,20,0
43077,412,146,266,106,38,67,35,517,295,222,69,62,40,28,0
43078,856,429,427,113,105,96,24,198,110,88,27,27,24,4,0
43079,394,207,187,52,42,37,24,331,180,151,46,35,47,17,0
43080,483,236,247,82,60,43,18,403,192,211,102,39,49,15,0
43081,203,97,106,30,22,18,10,551,226,325,96,103,43,11,0
43082,442,254,188,46,22,40,19,1323,690,633,132,178,112,61,0
43083,126,56,70,31,10,10,3,1382,508,874,334,320,98,36,0
43084,346,173,173,50,56,31,14,630,321,309,86,90,57,26,0
43085,2488,1085,1403,346,253,162,76,205,94,111,48,31,15,6,0
43086,772,383,389,105,76,82,33,111,60,51,17,23,10,7,0
43087,282,84,198,60,102,1,6,593,289,304,85,69,48,19,0
43088,546,285,261,71,49,47,24,514,248,266,86,82,52,22,0
43089,1505,680,825,202,204,73,32,520,272,248,60,65,58,22,0
43090,513,276,237,73,43,57,24,1065,581,484,134,97,76,46,0
43091,325,152,173,43,47,28,17,339,175,164,51,49,37,9,0
43092,349,167,182,54,38,30,28,736,388,348,88,85,67,28,0
43093,680,308,372,82,72,71,40,462,229,233,63,49,42,18,0
43094,753,395,358,93,72,71,16,387,193,194,60,53,57,15,0
43095,1171,542,629,170,146,114,64,105,51,54,13,17,12,8,0
43096,717,381,336,118,103,85,29,349,200,149,41,39,30,20,0
43097,244,104,140,52,31,30,14,260,133,127,43,32,39,3,0
43098,230,114,116,30,33,29,8,331,180,151,46,35,47,17,0
43099,2442,1193,1249,278,183,170,145,131,55,76,28,9,14,12,0
43100,178,87,91,20,32,13,10,322,180,142,45,38,28,7,0
43101,340,181,159,44,39,35,21,1239,659,580,169,148,131,54,0
43102,557,250,307,70,47,51,22,943,463,480,91,144,70,30,0
43103,346,186,160,40,37,34,21,231,126,105,37,26,29,6,0
43104,391,204,187,47,48,38,18,462,251,211,74,53,41,18,0
43105,502,274,228,64,49,75,17,926,425,501,159,147,77,35,0
43106,667,366,301,96,55,84,25,332,155,177,55,51,44,13,0
43107,297,161,136,36,35,24,9,201,93,108,34,39,21,6,0
43108,853,400,453,137,109,88,42,422,237,185,53,47,62,20,0
43109,406,207,199,56,46,68,19,561,279,282,85,81,88,24,0
43110,490,224,266,80,70,39,32,627,289,338,101,73,62,43,0
43111,1544,738,806,239,217,145,91,132,77,55,20,9,13,10,0
43112,330,151,179,68,36,56,9,218,117,101,35,32,34,12,0
43113,163,70,93,28,21,17,6,376,189,187,47,53,44,26,0
43114,828,368,460,118,98,59,38,597,300,297,96,89,68,29,0
43115,429,227,202,49,51,46,26,267,141,126,53,27,23,7,0
43116,356,199,157,36,43,28,12,107,77,30,7,2,9,5,0
43117,1447,698,749,214,180,116,46,266,150,116,28,28,24,12,0
43118,231,105,126,56,10,24,10,758,319,439,101,123,78,25,0
43119,439,183,256,60,64,36,14,156,90,66,17,22,11,10,0
43120,284,128,156,48,29,34,8,362,156,206,74,42,36,22,0
43121,681,367,314,83,74,78,31,419,233,186,54,53,55,17,0
43122,335,148,187,52,26,51,12,288,156,132,36,36,24,15,0
43123,802,430,372,65,102,87,23,261,127,134,36,27,36,4,0
43124,286,111,175,51,47,21,12,363,180,183,60,34,10,6,0
43125,1441,504,937,264,329,69,46,602,310,292,87,66,70,36,0
43126,1085,646,439,108,65,36,19,397,234,163,44,38,23,21,0
43127,222,108,114,37,20,25,12,564,264,300,79,84,65,26,0
43128,454,230,224,63,56,38,33,172,79,93,34,27,23,10,0
43129,949,467,482,126,127,102,51,453,247,206,58,53,45,20,0
43130,406,208,198,41,26,43,21,261,127,134,36,27,36,4,0
43131,1174,594,580,175,155,126,66,485,244,241,80,55,59,20,0
43132,428,226,202,52,60,75,20,294,146,148,50,45,51,15,0
43133,435,225,210,58,46,50,14,200,99,101,31,24,26,6,0
43134,801,331,470,151,139,99,55,583,321,262,73,67,45,25,0
43135,286,111,175,51,47,21,12,201,104,97,36,32,24,7,0
43136,446,265,181,51,35,27,17,660,303,357,97,89,85,33,0
43137,395,189,206,63,50,49,28,1338,720,618,179,145,141,85,0
43138,1835,904,931,192,144,135,63,536,251,285,75,79,60,23,0
43139,346,208,138,46,39,51,18,188,93,95,33,18,16,10,0
43140,222,108,114,37,20,25,12,103,59,44,25,2,13,6,0
43141,203,97,106,30,22,18,10,54,26,28,11,4,3,3,0
43142,927,457,470,130,99,118,42,218,115,103,32,32,34,11,0
43143,436,201,235,54,37,35,18,470,205,265,71,80,33,11,0
43144,486,243,243,65,48,63,22,242,124,118,39,32,28,22,0
43145,1174,594,580,175,155,126,66,1025,549,476,118,109,88,61,0
43146,501,230,271,63,90,50,18,405,214,191,53,42,49,20,0
43147,326,148,178,55,42,31,12,376,183,193,50,50,43,21,0
43148,1276,607,669,192,178,136,63,395,198,197,55,55,36,10,0
43149,643,284,359,129,71,84,43,134,55,79,22,24,16,6,0
43150,1544,738,806,239,217,145,91,267,141,126,53,27,23,7,0
43151,527,276,251,64,60,70,20,732,366,366,108,86,74,41,0
43152,649,304,345,99,80,67,40,526,266,260,76,75,53,22,0
43153,143,81,62,28,9,8,1,242,124,118,39,32,28,22,0
43154,395,195,200,41,55,23,10,231,126,105,37,26,29,6,0
43155,556,306,250,69,60,80,18,501,274,227,63,58,53,20,0
43156,579,281,298,91,78,74,27,54,26,28,11,4,3,3,0
43157,432,190,242,85,82,28,11,418,223,195,51,45,49,14,0
43158,1417,598,819,223,188,135,58,766,386,380,101,81,78,31,0
43159,314,178,136,42,32,30,17,354,183,171,54,43,49,8,0
43160,1867,973,894,256,222,194,65,474,268,206,66,42,45,24,0
43161,138,35,103,38,2,15,9,54,26,28,11,4,3,3,0
43162,451,278,173,71,35,58,12,200,89,111,26,25,17,7,0
43163,739,389,350,129,61,69,25,203,98,105,34,29,19,10,0
43164,563,255,308,91,111,42,30,556,290,266,75,74,29,24,0
43165,346,191,155,52,38,40,13,501,257,244,75,57,48,29,0
43166,280,156,124,36,19,20,13,766,386,380,101,81,78,31,0
43167,1711,865,846,204,176,105,60,673,313,360,102,101,46,17,0
43168,257,148,109,28,20,21,14,447,212,235,86,55,58,21,0
43169,649,304,345,99,80,67,40,341,170,171,41,66,27,10,0
43170,510,269,241,66,67,71,26,106,46,60,27,18,12,3,0
43171,473,217,256,59,44,34,21,1248,584,664,184,164,155,67,0
43172,328,156,172,44,37,44,15,222,119,103,37,32,24,8,0
43173,2220,1085,1135,312,304,202,91,135,65,70,21,25,15,9,0
43174,540,252,288,73,67,57,20,375,210,165,49,37,29,27,0
43175,323,156,167,52,45,39,18,218,111,107,45,29,24,6,0
43176,322,164,158,46,44,29,7,188,93,95,33,18,16,10,0
43177,443,250,193,52,23,49,13,1166,514,652,150,159,107,70,0
43178,1200,602,598,145,116,110,50,305,163,142,38,27,47,11,0
43179,371,209,162,46,17,36,19,434,213,221,77,62,53,12,0
43180,267,146,121,40,24,25,7,277,124,153,44,40,35,18,0
43181,119,59,60,29,10,6,4,289,140,149,33,42,30,15,0
43182,2174,1057,1117,241,241,214,117,149,52,97,36,36,7,4,0
43183,915,336,579,185,199,56,29,403,185,218,67,62,63,19,0
43184,588,267,321,99,79,87,28,319,185,134,42,31,22,13,0
43185,434,221,213,58,47,54,15,65,32,33,16,4,8,3,0
43186,598,322,276,67,57,63,26,107,77,30,7,2,9,5,0
43187,664,269,395,117,107,36,15,296,151,145,45,42,32,11,0
43188,502,250,252,70,47,57,15,188,88,100,53,12,15,6,0
43189,410,209,201,72,30,48,22,1321,653,668,186,195,70,35,0
43190,160,53,107,31,29,13,3,415,203,212,77,44,49,18,0
43191,302,178,124,34,29,50,13,152,71,81,41,16,14,2,0
43192,1390,705,685,219,164,129,74,354,183,171,54,43,49,8,0
43193,270,128,142,36,43,15,11,302,150,152,56,40,52,15,0
43194,461,257,204,63,49,50,29,1500,804,696,190,172,144,60,0
43195,1001,422,579,185,180,51,32,336,200,136,34,29,25,24,0
43196,433,188,245,63,45,26,14,392,155,237,68,61,34,16,0
43197,303,161,142,38,31,42,17,173,90,83,21,36,12,15,0
43198,648,262,386,113,108,78,29,367,218,149,45,43,42,16,0
43199,466,199,267,86,59,32,17,425,177,248,60,62,33,16,0
43200,489,253,236,73,36,62,17,277,152,125,31,35,22,19,0
43201,557,250,307,70,47,51,22,277,144,133,42,30,41,8,0
43202,439,241,198,67,40,40,13,123,61,62,17,18,17,7,0
43203,221,80,141,48,37,14,10,396,213,183,68,44,47,18,0
43204,252,121,131,42,34,12,16,373,181,192,54,35,44,20,0
43205,270,147,123,34,17,39,21,132,61,71,22,21,15,3,0
43206,1594,660,934,251,272,117,77,172,88,84,24,31,20,12,0
43207,533,300,233,74,50,74,17,163,79,84,22,24,13,5,0
43208,431,199,232,59,54,40,17,452,254,198,72,57,38,18,0
43209,399,196,203,62,45,38,19,223,113,110,31,33,22,12,0
43210,1390,585,805,241,230,118,46,1696,771,925,257,225,149,63,0
43211,339,170,169,32,17,24,13,234,129,105,31,22,19,17,0
43212,422,196,226,52,35,33,20,172,88,84,24,31,20,12,0
43213,535,315,220,57,55,71,19,447,212,235,86,55,58,21,0
43214,1004,464,540,143,104,78,55,509,267,242,79,81,38,20,0
43215,282,160,122,36,28,27,7,1061,543,518,146,123,109,67,0
43216,441,216,225,57,66,57,19,137,72,65,27,13,15,8,0
43217,615,308,307,83,75,58,32,266,150,116,28,28,24,12,0
43218,517,245,272,92,77,46,24,601,278,323,124,87,65,21,0
43219,142,60,82,20,28,13,5,232,111,121,23,29,17,9,0
43220,520,240,280,87,63,67,16,459,260,199,56,42,47,21,0
43221,1711,865,846,204,176,105,60,261,162,99,24,21,14,10,0
43222,422,196,226,52,35,33,20,432,244,188,51,51,27,14,0
43223,785,325,460,114,123,61,28,153,80,73,26,18,19,4,0
43224,900,434,466,134,97,86,36,127,54,73,11,33,15,6,0
43225,959,496,463,144,132,75,35,300,148,152,45,43,40,8,0
43226,1014,488,526,178,137,94,39,335,186,149,40,28,29,13,0
43227,126,56,70,31,10,10,3,1262,653,609,169,165,152,50,0
43228,953,421,532,131,131,70,37,229,120,109,31,30,22,9,0
43229,729,351,378,111,98,58,18,286,160,126,37,27,23,10,0
43230,1711,865,846,204,176,105,60,524,300,223,70,54,51,25,0
43231,485,237,248,83,35,52,24,538,274,264,84,67,52,35,0
43232,508,136,372,157,91,22,9,139,68,71,14,26,14,9,0
43233,604,239,365,124,63,84,37,425,177,248,60,62,33,16,0
43234,311,154,157,47,29,34,13,647,350,297,95,79,77,29,0
43235,747,469,278,60,41,53,23,332,155,177,55,51,44,13,0
43236,2000,965,1035,357,313,198,75,222,122,100,39,32,24,9,0
43237,949,466,483,125,126,101,50,780,337,443,112,116,77,28,0
43238,567,266,301,139,46,76,37,198,115,83,30,22,8,8,0
43239,502,229,273,63,66,40,31,1001,417,584,186,147,96,47,0
43240,462,233,229,66,49,43,30,761,351,410,117,73,103,45,0
43241,557,250,307,70,47,51,22,128,63,65,30,11,13,8,0
43242,315,170,145,48,56,22,11,1395,627,768,172,263,141,59,0
43243,215,104,111,61,7,2,1,715,348,367,109,84,68,30,0
43244,318,164,154,52,43,34,10,406,234,172,63,35,43,10,0
43245,365,148,217,86,37,51,28,148,84,64,30,7,17,4,0
43246,249,104,145,47,41,24,17,230,125,105,29,40,20,6,0
43247,509,246,263,84,71,56,22,257,126,131,61,24,22,8,0
43248,508,136,372,157,91,22,9,204,80,124,29,51,10,5,0
43249,412,193,219,69,57,43,14,535,301,234,63,48,47,27,0
43250,1208,575,633,187,204,117,41,256,141,115,32,22,32,8,0
43251,272,94,178,76,33,19,4,348,194,154,57,31,43,12,0
43252,222,108,114,37,20,25,12,593,289,304,85,69,48,19,0
43253,728,358,370,118,100,55,29,621,310,311,100,106,77,27,0
43254,130,72,58,28,9,7,1,545,269,276,80,76,27,32,0
43255,2799,1324,1475,369,371,215,124,260,131,129,42,31,40,9,0
43256,111,29,82,10,54,0,1,317,161,156,50,36,47,12,0
43257,500,257,243,60,55,27,22,166,90,76,27,18,21,5,0
43258,605,277,328,99,54,63,43,406,223,183,61,53,46,17,0
43259,156,94,62,22,22,10,6,711,330,381,111,86,86,34,0
43260,126,57,69,31,10,10,3,328,199,129,39,29,27,14,0
43261,1560,778,782,224,235,132,78,123,61,62,17,18,17,7,0
43262,234,108,126,42,40,15,9,679,338,341,96,95,40,23,0
43263,478,177,301,109,66,59,25,403,221,182,62,50,42,12,0
43264,588,267,321,99,79,87,28,501,257,244,75,57,48,29,0
43265,251,139,112,41,18,27,11,328,195,133,39,40,27,13,0
43266,795,384,411,133,109,85,38,935,515,420,126,107,73,32,0
43267,1009,478,531,166,126,96,42,467,231,236,71,65,58,18,0
43268,265,165,100,32,19,27,5,555,292,263,75,63,67,27,0
43269,707,250,457,171,84,117,61,220,107,113,36,35,28,9,0
43270,640,271,369,111,79,57,17,295,160,135,42,37,46,16,0
43271,616,323,293,98,71,31,15,483,287,196,71,50,54,17,0
43272,111,29,82,10,54,0,1,308,146,162,42,39,24,12,0
43273,304,149,155,46,32,39,14,727,388,339,102,87,70,29,0
43274,118,51,67,25,13,6,7,405,214,191,53,42,49,20,0
43275,369,207,162,67,35,16,14,439,231,208,65,51,55,17,0
43276,441,216,225,57,66,57,19,727,388,339,102,87,70,29,0
43277,1220,575,645,208,179,99,56,463,259,204,62,55,34,22,0
43278,527,254,273,67,66,70,31,323,168,155,51,41,38,12,0
43279,674,268,406,118,96,70,21,339,180,159,36,29,16,16,0
43280,588,300,288,100,57,65,27,1755,905,850,214,196,183,79,0
43281,243,114,129,37,30,32,8,300,148,152,45,43,40,8,0
43282,980,481,499,131,107,85,44,612,341,271,66,76,57,23,0
43283,531,260,271,97,68,47,11,761,351,410,117,73,103,45,0
43284,412,203,209,65,47,37,18,316,166,150,45,38,37,13,0
43285,130,71,59,30,9,8,1,935,515,420,126,107,73,32,0
43286,781,316,465,130,129,65,23,1543,794,749,182,152,132,55,0
43287,492,253,239,73,67,77,29,465,252,213,73,58,60,18,0
43288,160,53,107,31,29,13,3,551,226,325,96,103,43,11,0
43289,332,172,160,50,33,35,9,403,184,219,75,51,47,20,0
43290,420,202,218,67,43,51,15,660,333,327,102,95,69,31,0
43291,672,300,372,77,91,57,22,1013,577,436,127,97,78,26,0
43292,224,101,123,45,32,21,3,846,425,421,125,97,98,38,0
43293,793,355,438,134,117,77,43,866,478,388,121,101,101,26,0
43294,436,209,227,66,47,52,22,329,194,135,45,32,33,9,0
43295,733,382,351,126,92,93,27,602,310,292,87,66,70,36,0
43296,2000,965,1035,357,313,198,75,219,105,114,36,29,19,8,0
43297,136,66,70,33,11,9,5,1113,480,633,170,173,81,34,0
43298,648,262,386,113,108,78,29,145,77,68,26,7,15,8,0
43299,1556,718,838,280,182,161,49,392,186,206,62,56,29,15,0
43300,519,245,274,58,61,34,22,256,141,115,32,22,32,8,0
43301,252,121,131,42,34,12,16,405,214,191,53,42,49,20,0
43302,172,82,90,21,35,21,5,583,280,303,95,66,76,25,0
43303,579,281,298,91,78,74,27,418,246,172,52,39,57,10,0
43304,156,64,92,31,19,5,4,130,67,63,24,10,12,4,0
43305,1030,567,463,118,106,94,49,250,116,134,41,30,33,19,0
43306,640,271,369,111,79,57,17,699,334,365,108,80,70,20,0
43307,138,35,103,38,2,15,9,145,77,68,26,7,15,8,0
43308,312,164,148,54,29,25,15,299,140,159,49,44,26,11,0
43309,136,66,70,33,11,9,5,663,360,303,87,82,80,35,0
43310,282,135,147,27,37,30,19,415,189,226,68,54,50,21,0
43311,411,236,175,39,45,50,30,360,185,175,51,43,36,16,0
43312,117,57,60,17,14,11,10,862,409,453,149,125,86,29,0
43313,1462,711,751,219,222,148,65,536,251,285,75,79,60,23,0
43314,422,196,226,52,35,33,20,377,184,193,50,43,33,17,0
43315,1189,653,536,152,118,109,56,405,214,191,53,42,49,20,0
43316,828,355,473,126,134,77,37,515,276,239,62,59,43,31,0
43317,242,111,131,35,35,17,13,101,59,42,11,17,10,1,0
43318,475,235,240,77,58,43,22,406,234,172,63,35,43,10,0
43319,420,202,218,67,43,51,15,285,146,139,41,41,48,13,0
43320,259,151,108,39,18,23,11,403,221,182,47,41,47,8,0
43321,1058,497,561,194,142,87,63,296,151,145,45,42,32,11,0
43322,594,321,273,98,59,57,23,326,149,177,51,51,28,10,0
43323,484,264,220,59,62,68,15,425,177,248,60,62,33,16,0
43324,559,217,342,105,86,42,16,302,150,152,56,40,52,15,0
43325,234,110,124,39,29,23,2,729,358,371,116,99,89,33,0
43326,734,339,395,135,89,78,36,404,190,214,55,55,35,27,0
43327,492,253,239,73,67,77,29,251,143,108,47,25,29,11,0
43328,329,168,161,48,34,41,16,430,212,218,88,43,40,20,0
43329,536,237,299,116,87,42,17,86,40,46,16,13,9,7,0
43330,734,339,395,135,89,78,36,165,87,78,24,19,22,9,0
43331,361,177,184,59,51,24,15,201,98,103,28,25,19,13,0
43332,158,85,73,24,18,18,8,229,120,109,31,30,22,9,0
43333,342,150,192,52,43,31,17,127,64,63,26,8,12,8,0
43334,161,75,86,24,20,10,7,663,354,309,91,84,79,31,0
43335,374,187,187,51,52,40,27,903,436,467,128,116,83,33,0
43336,758,378,380,89,64,37,31,279,142,137,43,39,28,7,0
43337,376,249,127,47,23,43,16,406,223,183,61,53,46,17,0
43338,462,228,234,59,47,37,32,180,89,91,28,27,18,7,0
43339,341,154,187,34,36,11,11,165,87,78,24,19,22,9,0
43340,1439,713,726,195,180,110,34,368,183,185,40,42,40,15,0
43341,207,89,118,56,8,4,3,902,499,403,118,117,92,35,0
43342,262,133,129,44,38,31,12,391,189,202,55,56,56,12,0
43343,722,390,332,125,69,67,25,260,133,127,43,32,39,3,0
43344,233,110,123,34,22,34,9,602,310,292,87,66,70,36,0
43345,199,113,86,27,17,10,7,149,77,72,37,10,20,5,0
43346,919,493,426,100,92,88,49,389,210,179,51,37,43,9,0
43347,557,211,346,129,125,48,19,1020,538,482,145,115,111,58,0
43348,347,154,193,48,51,25,11,234,116,118,34,35,23,9,0
43349,613,303,310,70,28,28,18,352,207,145,40,33,25,21,0
43350,516,224,292,79,29,45,33,647,350,297,95,79,77,29,0
43351,336,134,202,51,64,27,12,96,46,50,16,12,7,5,0
43352,346,186,160,40,37,34,21,2382,1162,1220,237,220,140,49,0
43353,500,297,203,66,33,53,15,811,361,450,124,107,80,31,0
43354,567,256,311,91,81,53,17,975,400,575,160,162,62,31,0
43355,521,249,272,53,36,50,18,751,394,357,107,96,73,35,0
43356,650,330,320,97,77,65,28,415,226,189,51,40,40,29,0
43357,282,84,198,60,102,1,6,439,227,212,60,55,58,8,0
43358,760,322,438,81,130,57,19,483,258,225,70,53,54,20,0
43359,378,202,176,34,32,44,13,889,505,384,107,97,99,30,0
43360,1043,479,564,200,131,123,62,1922,923,999,267,275,215,90,0
43361,522,251,271,87,68,60,21,565,264,301,101,73,72,15,0
43362,641,349,292,92,60,39,24,309,159,150,47,43,43,13,0
43363,331,165,166,52,34,48,22,137,72,65,27,13,15,8,0
43364,350,190,160,48,25,27,18,555,282,273,82,69,65,21,0
43365,362,174,188,46,55,35,23,732,366,366,108,86,74,41,0
43366,728,358,370,118,100,55,29,360,180,180,57,48,39,12,0
43367,213,114,99,62,7,2,1,588,286,302,78,99,53,25,0
43368,1058,497,561,194,142,87,63,461,223,238,45,62,18,35,0
43369,447,225,222,76,35,75,21,192,91,101,29,28,17,7,0
43370,554,217,337,112,72,90,38,403,221,182,62,50,42,12,0
43371,411,202,209,60,67,57,24,1214,475,739,177,250,89,49,0
43372,426,213,213,60,56,46,24,810,310,500,164,162,42,26,0
43373,1342,640,702,187,163,123,57,390,223,167,58,36,45,18,0
43374,303,147,156,49,49,20,8,535,301,234,63,48,47,27,0
43375,272,136,136,32,34,12,12,545,269,276,80,76,27,32,0
43376,728,358,370,118,100,55,29,289,140,149,33,42,30,15,0
43377,246,123,123,40,31,27,7,396,199,197,54,50,45,14,0
43378,181,75,106,35,26,11,9,520,240,280,67,72,42,14,0
43379,184,93,91,26,25,14,11,597,269,328,102,84,69,24,0
43380,213,88,125,21,54,14,15,418,223,195,51,45,49,14,0
43381,729,351,378,111,98,58,18,376,183,193,50,50,43,21,0
43382,262,133,129,44,38,31,12,555,292,263,75,63,67,27,0
43383,437,212,225,66,44,44,11,469,225,244,64,68,25,11,0
43384,1462,711,751,219,222,148,65,329,194,135,45,32,33,9,0
43385,963,477,486,134,143,123,38,415,203,212,77,44,49,18,0
43386,605,277,328,99,54,63,43,467,231,236,71,65,58,18,0
43387,561,282,279,68,62,36,14,439,227,212,60,55,58,8,0
43388,521,249,272,53,36,50,18,1239,659,580,169,148,131,54,0
43389,320,183,137,51,18,38,8,410,197,213,67,43,56,18,0
43390,276,149,127,45,34,39,9,131,55,76,28,9,14,12,0
43391,417,222,195,53,39,43,10,180,108,72,22,22,15,5,0
43392,743,366,377,41,37,26,14,222,124,98,37,29,22,9,0
43393,126,57,69,31,10,10,3,1239,659,580,169,148,131,54,0
43394,347,198,149,45,29,29,8,517,295,222,69,62,40,28,0
43395,704,342,362,113,91,85,33,661,325,336,81,75,65,28,0
43396,2442,1193,1249,278,183,170,145,557,281,276,80,59,43,21,0
43397,361,177,184,59,51,24,15,963,455,508,127,130,115,48,0
43398,291,131,160,49,35,32,15,303,137,166,54,54,31,15,0
43399,380,148,232,81,69,24,8,427,251,176,51,39,25,22,0
43400,278,110,168,58,49,29,5,277,152,125,31,35,22,19,0
43401,344,109,235,100,39,26,5,188,88,100,53,12,15,6,0
43402,376,249,127,47,23,43,16,673,313,360,102,101,46,17,0
43403,1835,904,931,192,144,135,63,557,281,276,80,59,43,21,0
43404,915,336,579,185,199,56,29,200,89,111,26,25,17,7,0
43405,364,204,160,65,35,15,13,189,95,94,25,33,16,8,0
43406,162,73,89,32,19,4,4,535,288,247,79,72,35,21,0
43407,519,259,260,86,78,59,22,475,251,224,67,49,48,23,0
43408,394,207,187,52,42,37,24,925,439,486,141,134,105,46,0
43409,432,233,199,52,28,47,18,1338,720,618,179,145,141,85,0
43410,334,155,179,47,34,38,11,364,189,175,58,41,35,17,0
43411,109,50,59,12,12,9,3,137,72,65,27,13,15,8,0
43412,319,153,166,61,52,26,12,862,409,453,149,125,86,29,0
43413,270,128,142,36,43,15,11,4646,2328,2318,674,639,475,170,0
43414,155,85,70,17,16,4,8,376,183,193,50,50,43,21,0
43415,428,226,202,52,60,75,20,403,225,178,56,38,33,25,0
43416,255,122,133,35,51,22,13,1243,650,593,158,159,98,55,0
43417,346,174,172,36,43,21,9,277,144,133,42,30,41,8,0
43418,368,201,167,61,38,38,12,583,280,303,95,66,76,25,0
43419,196,107,89,20,31,17,4,463,268,195,59,46,46,21,0
43420,443,226,217,67,34,53,10,215,115,100,27,19,16,7,0
43421,401,204,197,49,33,29,17,190,93,97,35,27,23,2,0
43422,349,153,196,54,47,28,13,474,268,206,66,42,45,24,0
43423,124,58,66,20,28,11,7,483,215,268,66,70,30,16,0
43424,1464,693,771,153,136,91,86,972,471,501,152,138,112,40,0
43425,798,287,511,126,125,77,26,660,333,327,102,95,69,31,0
43426,1498,731,767,220,175,148,68,252,130,122,45,23,32,11,0
43427,206,100,106,34,26,11,7,294,146,148,50,45,51,15,0
43428,339,118,221,77,68,33,13,536,251,285,75,79,60,23,0
43429,368,154,214,80,52,41,16,257,139,118,64,17,24,7,0
43430,482,231,251,76,81,64,26,555,292,263,75,63,67,27,0
43431,237,127,110,34,30,16,9,375,209,166,50,37,29,23,0
43432,264,122,142,46,24,35,10,222,119,103,37,32,24,8,0
43433,437,212,225,66,44,44,11,629,317,312,80,87,51,22,0
43434,508,136,372,157,91,22,9,218,115,103,32,32,34,11,0
43435,1531,649,882,108,122,93,72,171,94,77,24,28,30,11,0
43436,510,288,222,44,36,24,7,378,154,224,74,84,35,22,0
43437,224,108,116,33,26,32,10,592,249,343,91,90,50,42,0
43438,270,128,142,36,43,15,11,597,269,328,102,84,69,24,0
43439,526,228,298,69,64,32,30,452,252,200,55,49,61,16,0
43440,439,183,256,60,64,36,14,277,124,153,44,40,35,18,0
43441,493,281,212,56,61,30,13,531,261,270,73,80,68,26,0
43442,919,493,426,100,92,88,49,300,148,152,45,43,40,8,0
43443,407,164,243,88,42,40,22,479,215,264,67,80,46,28,0
43444,282,135,147,27,37,30,19,228,130,98,35,29,30,10,0
43445,674,268,406,118,96,70,21,225,111,114,32,34,32,16,0
43446,519,259,260,86,78,59,22,462,251,211,74,53,41,18,0
43447,588,267,321,99,79,87,28,257,126,131,61,24,22,8,0
43448,1249,543,706,187,164,125,52,260,131,129,42,31,40,9,0
43449,833,295,538,146,139,65,34,408,221,187,55,51,57,14,0
43450,972,501,471,125,156,106,39,367,199,168,62,44,34,8,0
43451,215,117,98,28,19,15,8,218,118,100,33,30,25,11,0
43452,394,207,187,52,42,37,24,633,311,322,94,82,45,20,0
43453,2285,1219,1066,207,180,178,106,866,478,388,121,101,101,26,0
43454,536,287,249,64,73,21,27,390,190,200,66,50,43,12,0
43455,1041,497,544,180,167,98,34,165,87,78,24,19,22,9,0
43456,414,206,208,56,68,35,19,339,175,164,51,49,37,9,0
43457,467,233,234,83,37,77,22,270,162,108,26,26,16,11,0
43458,394,207,187,52,42,37,24,720,361,359,98,98,70,37,0
43459,508,251,257,74,53,51,18,647,350,297,95,79,77,29,0
43460,341,177,164,57,42,40,18,147,74,73,28,20,24,4,0
43461,332,170,162,44,38,39,10,350,196,154,52,37,21,14,0
43462,3230,1724,1506,361,358,157,75,403,221,182,62,50,42,12,0
43463,484,261,223,59,48,49,24,501,249,252,77,70,55,22,0
43464,411,211,200,61,46,35,18,261,148,113,31,28,14,10,0
43465,215,80,135,54,56,21,9,201,104,97,36,32,24,7,0
43466,232,108,124,33,27,19,16,173,90,83,30,19,19,11,0
43467,278,104,174,46,34,23,14,274,157,117,40,29,40,8,0
43468,482,245,237,69,64,66,24,423,234,189,66,44,57,12,0
43469,346,186,160,40,37,34,21,392,186,206,62,56,29,15,0
43470,291,131,160,49,35,32,15,508,262,246,66,67,51,20,0
43471,401,183,218,72,73,28,10,701,380,321,94,84,96,34,0
43472,135,64,71,31,11,8,4,508,262,246,66,67,51,20,0
43473,496,209,287,113,55,72,14,299,140,159,49,44,26,11,0
43474,1030,567,463,118,106,94,49,1241,619,622,183,169,155,59,0
43475,1284,511,773,227,166,169,107,374,202,172,50,39,31,24,0
43476,1647,794,853,279,235,128,65,246,107,139,55,33,27,11,0
43477,494,242,252,67,47,25,21,396,223,173,57,37,44,19,0
43478,211,92,119,33,44,11,7,303,137,166,54,54,31,15,0
43479,338,208,130,39,30,35,12,72,33,39,8,2,3,12,0
43480,334,190,144,42,42,16,5,545,269,276,80,76,27,32,0
43481,820,333,487,202,152,59,23,644,343,301,96,69,59,28,0
43482,336,134,202,51,64,27,12,405,214,191,53,42,49,20,0
43483,1327,520,807,241,174,141,60,763,418,345,113,84,59,32,0
43484,369,207,162,67,35,16,14,1314,693,621,174,155,140,58,0
43485,255,136,119,39,20,32,10,481,223,258,71,70,49,26,0
43486,323,156,167,52,45,39,18,295,156,139,41,40,42,15,0
43487,439,205,234,64,88,41,21,398,200,198,68,43,51,14,0
43488,117,57,60,17,14,11,10,818,357,461,122,136,54,25,0
43489,478,177,301,109,66,59,25,199,92,107,34,30,18,9,0
43490,323,171,152,36,36,47,15,305,164,141,43,23,47,18,0
43491,127,62,65,13,33,7,6,1065,581,484,134,97,76,46,0
43492,161,94,67,23,13,8,10,1279,669,610,164,162,104,55,0
43493,257,148,109,28,20,21,14,364,189,175,58,41,35,17,0
43494,119,67,52,15,15,7,7,424,179,245,65,67,29,11,0
43495,413,236,177,41,25,35,19,928,440,488,111,157,82,35,0
43496,869,489,380,110,77,79,29,538,274,264,84,67,52,35,0
43497,371,143,228,77,48,29,26,96,46,50,16,12,7,5,0
43498,372,189,183,60,44,41,18,366,204,162,47,41,31,23,0
43499,130,70,60,30,9,8,1,729,358,371,116,99,89,33,0
43500,457,261,196,55,27,57,34,1606,753,853,215,227,182,48,0
43501,665,341,324,109,79,38,22,89,38,51,14,6,3,9,0
43502,397,180,217,61,59,39,13,145,77,68,26,7,15,8,0
43503,272,141,131,45,29,36,9,520,244,276,91,60,68,20,0
43504,727,426,301,79,71,64,32,497,227,270,70,63,66,30,0
43505,1107,601,506,155,138,103,49,330,166,164,55,51,36,16,0
43506,165,66,99,28,32,16,3,974,457,517,133,117,69,26,0
43507,479,227,252,69,48,46,18,137,78,59,22,16,17,4,0
43508,210,101,109,33,33,19,9,679,338,341,96,95,40,23,0
43509,332,172,160,50,33,35,9,245,121,124,37,35,36,12,0
43510,146,73,73,18,24,17,9,192,91,101,29,28,17,7,0
43511,624,222,402,92,81,39,15,926,340,586,133,119,60,40,0
43512,494,242,252,67,47,25,21,926,425,501,159,147,77,35,0
43513,193,107,86,13,20,13,6,341,170,171,41,66,27,10,0
43514,215,80,135,54,56,21,9,414,203,211,58,56,48,14,0
43515,502,274,228,64,49,75,17,902,499,403,118,117,92,35,0
43516,302,178,124,34,29,50,13,293,142,151,49,40,42,17,0
43517,682,260,422,98,83,42,31,1378,692,686,194,174,105,56,0
43518,412,146,266,106,38,67,35,704,355,349,113,94,71,24,0
43519,476,254,222,58,33,46,23,1700,731,969,198,233,110,87,0
43520,1004,498,506,94,59,46,33,374,174,200,54,52,42,21,0
43521,752,313,439,121,106,68,27,127,66,61,13,14,19,8,0
43522,204,103,101,16,32,22,8,375,209,166,50,37,29,23,0
43523,365,148,217,86,37,51,28,267,141,126,53,27,23,7,0
43524,1163,417,746,209,145,87,28,953,489,464,126,104,111,44,0
43525,640,308,332,91,102,49,21,132,61,71,19,20,14,6,0
43526,439,211,228,65,73,26,21,958,451,507,165,135,97,41,0
43527,161,94,67,23,13,8,10,526,266,260,76,75,53,22,0
43528,429,227,202,49,51,46,26,732,366,366,108,86,74,41,0
43529,784,353,431,56,47,26,18,264,138,126,33,34,29,12,0
43530,552,295,257,67,49,70,30,441,189,252,73,50,47,23,0
43531,802,375,427,133,103,81,41,647,324,323,101,80,76,43,0
43532,437,167,270,126,95,34,10,244,143,101,31,29,26,8,0
43533,270,130,140,43,24,36,10,1321,653,668,186,195,70,35,0
43534,682,292,390,89,69,58,20,390,223,167,58,36,45,18,0
43535,395,195,200,41,55,23,10,89,37,52,13,6,2,9,0
43536,264,122,142,33,29,13,13,415,189,226,68,54,50,21,0
43537,138,35,103,38,2,15,9,465,252,213,73,58,60,18,0
43538,704,342,362,113,91,85,33,218,114,104,32,31,33,11,0
43539,479,228,251,71,57,60,14,536,267,269,60,70,41,22,0
43540,536,287,249,64,73,21,27,204,80,124,29,51,10,5,0
43541,588,317,271,78,49,54,17,551,226,325,96,103,43,11,0
43542,677,361,316,81,61,42,22,337,170,167,59,33,47,17,0
43543,130,70,60,30,9,8,1,169,84,85,29,19,21,7,0
43544,271,136,135,37,30,18,10,620,324,296,81,68,66,31,0
43545,219,116,103,66,7,2,1,346,196,150,43,26,27,14,0
43546,349,153,196,54,47,28,13,354,183,171,54,43,49,8,0
43547,385,203,182,47,43,51,21,339,175,164,51,49,37,9,0
43548,1068,434,634,173,160,61,29,665,361,304,87,91,84,31,0
43549,764,277,487,158,162,64,31,346,196,150,43,26,27,14,0
43550,1099,491,608,163,141,107,62,673,313,360,102,101,46,17,0
43551,399,220,179,48,37,68,18,619,305,314,85,93,71,29,0
43552,431,216,215,46,40,33,9,627,289,338,101,73,62,43,0
43553,426,214,212,63,47,53,20,201,93,108,34,39,21,6,0
43554,1555,702,853,250,199,139,31,322,180,142,45,38,28,7,0
43555,381,146,235,74,48,47,34,302,150,152,56,40,52,15,0
43556,1284,511,773,227,166,169,107,1004,457,547,150,150,74,52,0
43557,304,149,155,46,32,39,14,346,196,150,43,26,27,14,0
43558,567,266,301,139,46,76,37,292,155,137,50,34,29,13,0
43559,345,203,142,47,35,31,11,471,238,233,66,63,62,19,0
43560,824,391,433,106,90,88,32,246,125,121,38,36,30,11,0
43561,496,209,287,112,55,71,14,620,324,296,81,68,66,31,0
43562,674,318,356,86,139,50,11,260,131,129,42,31,40,9,0
43563,802,375,427,133,103,81,41,1065,581,484,134,97,76,46,0
43564,802,344,458,156,136,57,24,711,330,381,111,86,86,34,0
43565,536,237,299,116,87,42,17,654,295,359,99,88,71,25,0
43566,243,100,143,58,50,24,5,256,141,115,32,22,32,8,0
43567,297,161,136,36,35,24,9,198,113,85,19,20,26,12,0
43568,640,308,332,91,102,49,21,866,397,469,117,153,95,48,0
43569,338,164,174,45,32,37,13,230,125,105,29,40,20,6,0
43570,103,56,47,27,7,8,2,2382,1162,1220,237,220,140,49,0
43571,250,123,127,40,28,29,8,963,525,438,119,102,102,34,0
43572,193,107,86,13,20,13,6,295,156,139,41,40,42,15,0
43573,1542,682,860,290,158,120,47,180,89,91,28,27,18,7,0
43574,288,104,184,80,30,39,6,548,273,275,84,81,64,30,0
43575,1590,726,864,270,237,126,59,199,92,107,34,30,18,9,0
43576,375,201,174,52,56,39,15,127,58,69,18,17,10,5,0
43577,650,330,320,93,93,51,28,510,264,246,67,66,38,29,0
43578,535,217,318,87,106,41,14,445,264,181,35,35,34,14,0
43579,440,267,173,52,29,42,12,169,84,85,29,19,21,7,0
43580,176,74,102,20,29,7,7,690,345,345,96,83,73,42,0
43581,746,312,434,129,115,77,47,427,251,176,51,39,25,22,0
43582,432,190,242,85,82,28,11,729,358,371,116,99,89,33,0
43583,502,229,273,63,66,40,31,593,289,304,85,69,48,19,0
43584,949,466,483,125,126,101,50,463,259,204,62,55,34,22,0
43585,1360,644,716,213,194,136,62,285,143,142,45,32,21,17,0
43586,932,575,357,94,69,76,40,430,212,218,88,43,40,20,0
43587,784,351,433,118,87,73,41,402,186,216,64,47,38,20,0
43588,126,57,69,31,10,10,3,902,499,403,118,117,92,35,0
43589,1560,778,782,224,235,132,78,65,32,33,16,4,8,3,0
43590,257,132,125,39,27,26,10,858,461,397,125,114,79,45,0
43591,288,140,148,59,33,27,12,551,226,325,96,103,43,11,0
43592,130,72,58,28,9,7,1,474,268,206,66,42,45,24,0
43593,126,56,70,31,10,10,3,978,536,442,132,107,67,32,0
43594,395,189,206,63,50,49,28,98,49,49,14,15,9,2,0
43595,192,91,101,28,21,18,8,1239,659,580,169,148,131,54,0
43596,334,190,144,42,42,16,5,305,161,144,39,40,44,17,0
43597,257,148,109,28,20,21,14,89,42,47,16,12,15,6,0
43598,2624,999,1625,415,495,109,84,136,65,71,26,11,7,5,0
43599,82,36,46,17,10,5,1,295,160,135,44,36,46,16,0
43600,489,253,236,73,36,62,17,246,107,139,55,33,27,11,0
43601,1174,594,580,175,155,126,66,524,300,223,70,54,51,25,0
43602,1030,438,592,184,104,108,30,387,193,194,60,53,57,15,0
43603,513,276,237,73,43,57,24,524,300,223,70,54,51,25,0
43604,283,112,171,48,39,34,15,439,227,212,60,55,58,8,0
43605,5890,3314,2576,970,956,293,265,274,157,117,40,29,40,8,0
43606,425,220,205,60,55,45,18,72,34,38,8,2,3,12,0
43607,603,311,292,102,71,66,23,528,276,252,86,78,49,17,0
43608,313,158,155,43,35,43,16,103,59,44,25,2,13,6,0
43609,456,214,242,76,62,52,22,386,207,179,43,48,44,19,0
43610,236,141,95,36,32,14,6,173,86,87,30,22,19,12,0
43611,781,367,414,60,67,43,17,339,175,164,51,49,37,9,0
43612,717,281,436,165,81,112,49,124,69,55,14,7,9,4,0
43613,318,164,154,52,43,34,10,384,212,172,44,43,34,14,0
43614,439,178,261,77,73,40,21,500,236,264,85,69,33,17,0
43615,1112,457,655,180,164,99,39,336,200,136,34,29,25,24,0
43616,1544,738,806,239,217,145,91,360,180,180,57,48,39,12,0
43617,313,178,135,43,18,35,6,508,262,246,66,67,51,20,0
43618,685,393,292,75,66,113,16,396,199,197,54,50,45,14,0
43619,2063,1024,1039,175,117,80,97,501,240,261,80,62,49,42,0
43620,574,269,305,91,63,54,27,452,252,200,55,49,61,16,0
43621,431,199,232,59,54,40,17,621,310,311,100,106,77,27,0
43622,136,65,71,33,11,9,6,89,42,47,16,12,15,6,0
43623,360,175,185,73,36,27,7,127,64,63,26,8,12,8,0
43624,270,128,142,36,43,15,11,295,160,135,42,37,46,16,0
43625,204,109,95,21,35,27,7,1378,692,686,194,174,105,56,0
43626,949,466,483,125,126,101,50,222,124,98,37,29,22,9,0
43627,236,120,116,32,28,21,11,514,248,266,86,82,52,22,0
43628,178,87,91,20,32,13,10,292,143,149,38,42,36,16,0
43629,131,69,62,29,9,9,1,497,257,240,71,63,62,16,0
43630,329,171,158,49,41,31,10,627,323,304,81,90,53,27,0
43631,1590,726,864,270,237,126,59,496,285,211,62,54,46,22,0
43632,407,207,200,53,36,38,8,479,215,264,67,80,46,28,0
43633,434,216,218,72,58,40,20,326,169,157,51,41,41,12,0
43634,486,243,243,65,48,63,22,242,121,121,39,30,29,10,0
43635,519,245,274,58,61,34,22,103,50,53,19,10,7,5,0
43636,180,57,123,39,22,10,8,418,246,172,52,39,57,10,0
43637,139,81,58,17,14,24,9,1873,935,938,233,225,203,79,0
43638,494,242,252,67,47,25,21,459,260,199,56,42,47,21,0
43639,640,279,361,102,83,69,21,1034,495,539,150,134,114,71,0
43640,249,104,145,47,41,24,17,413,223,190,52,45,53,10,0
43641,281,125,156,44,47,17,7,2724,1157,1567,269,518,239,77,0
43642,953,421,532,131,131,70,37,103,50,53,19,10,7,5,0
43643,732,355,377,108,109,79,27,316,159,157,38,48,30,11,0
43644,580,281,299,95,60,74,29,663,360,303,87,82,80,35,0
43645,859,411,448,118,100,95,49,222,124,98,37,29,22,9,0
43646,196,107,89,20,31,17,4,611,314,297,79,75,78,22,0
43647,540,252,288,73,67,57,20,296,140,156,49,40,42,19,0
43648,246,123,123,40,31,27,7,215,115,100,27,19,16,7,0
43649,959,496,463,144,132,75,35,583,321,262,73,67,45,25,0
43650,911,441,470,123,108,60,21,317,161,156,40,49,41,11,0
43651,269,156,113,37,32,17,7,729,358,371,116,99,89,33,0
43652,480,257,223,74,26,60,27,621,273,348,104,102,48,19,0
43653,867,415,452,123,87,62,27,701,380,321,94,84,96,34,0
43654,203,80,123,40,37,20,3,439,227,212,60,55,58,8,0
43655,4128,2104,2024,581,505,453,205,316,166,150,45,38,37,13,0
43656,475,208,267,84,67,50,20,258,129,129,45,24,31,10,0
43657,1249,543,706,187,164,125,52,137,85,52,15,11,11,2,0
43658,256,152,104,18,23,23,8,459,260,199,56,42,47,21,0
43659,953,421,532,131,131,70,37,766,386,380,101,81,78,31,0
43660,1501,679,822,251,196,174,67,316,159,157,38,48,30,11,0
43661,956,450,506,122,117,82,36,1001,417,584,186,147,96,47,0
43662,350,178,172,49,62,29,16,305,161,144,39,40,44,17,0
43663,199,107,92,41,15,14,8,465,252,213,73,58,60,18,0
43664,1501,679,822,251,196,174,67,257,139,118,64,17,24,7,0
43665,1417,598,819,223,188,135,58,137,78,59,22,16,17,4,0
43666,1121,458,663,158,210,76,47,245,131,114,30,27,18,13,0
43667,115,62,53,13,10,9,7,758,319,439,101,123,78,25,0
43668,180,57,123,39,22,10,8,136,65,71,26,11,7,5,0
43669,128,70,58,29,9,8,1,1696,771,925,257,225,149,63,0
43670,150,64,86,22,12,29,12,348,212,136,53,31,25,18,0
43671,462,258,204,59,41,56,15,227,130,97,32,25,22,12,0
43672,677,361,316,81,61,42,22,1001,417,584,186,147,96,47,0
43673,313,134,179,58,37,43,19,749,384,365,108,105,86,31,0
43674,416,222,194,58,38,38,20,2202,1121,1081,338,274,269,81,0
43675,397,180,217,61,59,39,13,453,255,198,62,49,29,19,0
43676,261,126,135,41,36,24,11,266,146,120,41,28,31,7,0
43677,574,284,290,64,50,65,20,582,264,318,84,60,58,23,0
43678,341,175,166,48,43,35,18,180,108,72,22,22,15,5,0
43679,510,288,222,44,36,24,7,1265,689,576,169,177,128,60,0
43680,1009,478,531,166,126,96,42,496,251,245,78,62,61,23,0
43681,627,237,390,137,57,108,44,68,23,45,12,9,3,9,0
43682,260,136,124,24,41,19,4,496,251,245,78,62,61,23,0
43683,1004,498,506,94,59,46,33,294,146,148,50,45,51,15,0
43684,2525,1232,1293,398,317,186,61,89,42,47,16,12,15,6,0
43685,412,208,204,54,47,42,17,396,199,197,54,50,45,14,0
43686,127,48,79,27,20,6,5,531,261,270,73,80,68,26,0
43687,318,161,157,53,51,32,13,328,195,133,39,40,27,13,0
43688,426,231,195,51,52,45,24,963,455,508,127,130,115,48,0
43689,682,260,422,153,78,109,46,103,44,59,16,17,9,5,0
43690,135,64,71,31,11,8,4,218,114,104,32,31,33,11,0
43691,543,265,278,52,37,54,19,741,383,358,92,63,79,36,0
43692,484,194,290,70,93,47,16,963,455,508,127,130,115,48,0
43693,301,157,144,31,28,34,9,188,90,98,44,7,21,7,0
43694,376,171,205,45,45,34,12,322,180,142,45,38,28,7,0
43695,785,351,434,136,93,71,37,326,149,177,51,51,28,10,0
43696,332,173,159,48,42,42,9,663,354,309,91,84,79,31,0
43697,580,308,272,82,79,58,25,374,181,193,55,58,48,23,0
43698,567,266,301,139,46,76,37,508,253,255,73,60,50,13,0
43699,1235,584,651,140,226,82,52,218,115,103,37,33,33,9,0
43700,932,575,357,94,69,76,40,262,129,133,40,41,31,10,0
43701,269,124,145,36,24,32,11,501,249,252,77,70,55,22,0
43702,335,183,152,40,26,54,22,375,209,166,50,37,29,23,0
43703,1043,479,564,200,131,123,62,609,335,274,79,57,45,22,0
43704,270,147,123,34,17,39,21,551,226,325,96,103,43,11,0
43705,126,56,70,31,10,10,3,425,177,248,60,62,33,16,0
43706,618,289,329,97,86,70,17,480,255,225,67,64,50,22,0
43707,178,74,104,31,28,9,4,515,276,239,62,59,43,31,0
43708,911,445,466,154,121,108,48,375,176,199,48,61,40,12,0
43709,1447,698,749,214,180,116,46,758,319,439,101,123,78,25,0
43710,1217,647,570,142,160,129,45,744,385,359,105,96,57,31,0
43711,310,141,169,36,38,20,8,415,226,189,51,40,40,29,0
43712,763,354,409,101,90,63,26,137,72,65,27,13,15,8,0
43713,594,279,315,93,68,68,26,227,130,97,32,25,22,12,0
43714,667,366,301,96,55,84,25,156,90,66,17,22,11,10,0
43715,867,415,452,123,87,62,27,218,115,103,32,32,34,11,0
43716,631,304,327,98,75,52,23,445,264,181,35,35,34,14,0
43717,432,190,242,85,82,28,11,564,264,300,79,84,65,26,0
43718,213,88,125,21,54,14,15,904,436,468,143,118,108,32,0
43719,1221,597,624,201,152,83,31,536,267,269,60,70,41,22,0
43720,298,141,157,51,33,21,22,73,35,38,14,10,9,4,0
43721,270,128,142,36,43,15,11,241,127,114,34,33,29,12,0
43722,531,259,272,75,81,39,13,508,262,246,66,67,51,20,0
43723,496,210,286,112,55,72,13,530,287,243,79,70,33,26,0
43724,349,167,182,54,38,30,28,846,425,421,125,97,98,38,0
43725,743,377,366,87,74,68,30,654,295,359,99,88,71,25,0
43726,452,217,235,59,47,60,20,647,324,323,101,80,76,43,0
43727,362,181,181,67,46,43,8,387,193,194,60,53,57,15,0
43728,532,291,241,83,36,79,25,773,389,384,119,91,79,26,0
43729,243,100,143,58,50,24,5,605,283,322,94,72,64,39,0
43730,426,231,195,51,52,45,24,87,51,35,15,9,9,4,0
43731,393,223,170,44,36,32,14,166,102,64,19,14,17,2,0
43732,2285,1219,1066,207,180,178,106,264,138,126,33,34,29,12,0
43733,267,146,121,40,24,25,7,403,184,219,75,51,47,20,0
43734,1068,434,634,173,160,61,29,555,292,263,75,63,67,27,0
43735,1068,434,634,173,160,61,29,690,345,345,96,83,73,42,0
43736,264,122,142,46,24,35,10,160,76,84,19,24,8,5,0
43737,310,141,169,36,38,20,8,715,345,370,110,97,64,25,0
43738,126,56,70,31,10,10,3,565,237,328,75,88,32,11,0
43739,279,129,150,43,34,17,13,531,277,254,82,75,33,22,0
43740,531,284,247,66,42,49,15,164,79,85,28,28,16,7,0
43741,196,107,89,20,31,17,4,368,183,185,40,42,40,15,0
43742,1580,742,838,208,146,144,71,627,289,338,101,73,62,43,0
43743,462,233,229,66,49,43,30,452,231,221,74,53,56,20,0
43744,385,179,206,58,56,38,19,127,58,69,18,17,10,5,0
43745,258,144,114,33,22,19,9,201,104,97,36,32,24,7,0
43746,607,305,302,92,89,74,23,366,204,162,47,41,31,23,0
43747,127,62,65,13,33,7,6,457,242,215,39,46,53,10,0
43748,389,176,213,81,59,24,7,396,223,173,57,37,44,19,0
43749,411,171,240,61,81,30,15,339,180,159,36,29,16,16,0
43750,1043,479,564,200,131,123,62,354,188,166,46,40,34,10,0
43751,252,121,131,42,34,12,16,1208,565,643,182,162,120,57,0
43752,887,439,448,137,99,91,38,2202,1121,1081,338,274,269,81,0
43753,580,308,272,82,79,58,25,457,242,215,39,46,53,10,0
43754,1849,931,918,245,220,158,90,517,295,222,69,62,40,28,0
43755,1014,488,526,178,137,94,39,288,156,132,36,36,24,15,0
43756,520,231,289,89,59,58,26,218,117,101,35,32,34,12,0
43757,275,160,115,40,31,34,17,201,93,108,34,39,21,6,0
43758,156,64,92,31,19,5,4,1338,720,618,179,145,141,85,0
43759,260,138,122,44,30,28,6,1378,692,686,194,174,105,56,0
43760,126,57,69,31,10,10,3,142,65,77,30,17,22,9,0
43761,1542,682,860,290,158,120,47,316,159,157,38,48,30,11,0
43762,209,75,134,53,48,20,9,1378,692,686,194,174,105,56,0
43763,1030,438,592,184,104,108,30,2346,1231,1115,316,292,266,105,0
43764,860,349,511,166,166,58,19,309,159,150,47,43,43,13,0
43765,1041,497,544,180,167,98,34,201,104,97,36,32,24,7,0
43766,243,114,129,37,30,32,8,457,242,215,39,46,53,10,0
43767,380,148,232,81,69,24,8,316,159,157,38,48,30,11,0
43768,219,116,103,66,7,2,1,405,195,210,57,74,24,17,0
43769,610,249,361,107,69,72,33,671,306,365,114,76,49,19,0
43770,312,164,148,54,29,25,15,4646,2328,2318,674,639,475,170,0
43771,202,113,89,16,27,21,11,810,310,500,164,162,42,26,0
43772,269,127,142,43,24,34,26,154,78,76,23,21,13,5,0
43773,687,351,336,106,67,70,41,437,221,216,62,64,47,13,0
43774,900,434,466,134,97,86,36,396,199,197,54,50,45,14,0
43775,1226,513,713,184,147,87,43,403,221,182,62,50,42,12,0
43776,262,133,129,44,38,31,12,257,126,131,61,24,22,8,0
43777,782,372,410,127,111,89,36,192,91,101,29,28,17,7,0
43778,299,128,171,57,40,13,25,86,40,46,16,13,9,7,0
43779,626,308,318,105,89,77,25,461,223,238,45,62,18,35,0
43780,245,111,134,36,27,18,6,65,32,33,16,4,8,3,0
43781,281,125,156,44,47,17,7,87,51,35,15,9,9,4,0
43782,431,245,186,50,23,46,17,2382,1162,1220,237,220,140,49,0
43783,265,165,100,32,19,27,5,180,108,72,22,22,15,5,0
43784,406,208,198,41,26,43,21,461,223,238,45,62,18,35,0
43785,1023,449,574,141,174,76,43,72,34,38,8,2,3,12,0
43786,681,367,314,83,74,78,31,723,353,370,120,109,96,33,0
43787,407,207,200,53,36,38,8,405,181,224,71,57,31,12,0
43788,365,222,143,44,24,35,11,266,150,116,28,28,24,12,0
43789,235,100,135,36,25,30,8,133,61,72,21,19,13,4,0
43790,453,240,213,53,33,44,16,274,142,132,33,34,18,14,0
43791,437,225,212,61,57,66,12,103,44,59,16,17,9,5,0
43792,440,267,173,52,29,42,12,475,251,224,67,49,48,23,0
43793,450,231,219,77,50,76,16,374,212,162,48,40,32,23,0
43794,267,146,121,40,24,25,7,257,139,118,64,17,24,7,0
43795,245,111,134,36,27,18,6,462,229,233,63,49,42,18,0
43796,1007,353,654,277,147,70,26,127,58,69,18,17,10,5,0
43797,213,114,99,62,7,2,1,661,325,336,81,75,65,28,0
43798,358,212,146,51,36,33,9,978,536,442,132,107,67,32,0
43799,445,231,214,45,64,53,23,189,105,84,25,26,21,9,0
43800,520,240,280,67,72,42,14,298,129,169,51,40,29,8,0
43801,181,75,106,35,26,11,9,405,181,224,71,57,31,12,0
43802,325,177,148,40,24,23,13,396,213,183,68,44,47,18,0
43803,461,257,204,63,49,50,29,314,177,137,34,40,29,9,0
43804,2000,965,1035,357,313,198,75,98,49,49,14,15,9,2,0
43805,431,245,186,50,23,46,17,425,177,248,60,62,33,16,0
43806,146,73,73,18,24,17,9,166,88,78,23,18,13,7,0
43807,365,148,217,86,37,51,28,119,61,58,17,12,10,6,0
43808,318,164,154,52,43,34,10,381,186,195,69,55,46,15,0
43809,1390,705,685,219,164,129,74,127,64,63,26,8,12,8,0
43810,747,469,278,60,41,53,23,536,251,285,75,79,60,23,0
43811,401,236,165,53,38,34,9,1062,522,540,151,147,105,66,0
43812,429,227,202,49,51,46,26,381,186,195,69,55,46,15,0
43813,471,221,250,87,68,42,25,328,195,133,39,40,27,13,0
43814,210,101,109,33,33,19,9,778,391,387,94,77,41,33,0
43815,949,467,482,126,127,102,51,250,119,131,58,26,29,7,0
43816,301,156,145,32,25,15,5,445,202,243,70,73,51,15,0
43817,186,56,130,46,50,16,7,773,389,384,119,91,79,26,0
43818,159,105,54,22,9,14,25,169,84,85,29,19,21,7,0
43819,331,165,166,52,34,48,22,96,46,50,16,12,7,5,0
43820,854,435,419,118,91,95,42,169,84,85,29,19,21,7,0
43821,1042,529,513,161,151,103,52,885,424,461,143,114,92,32,0
43822,556,279,277,83,69,71,19,68,23,45,12,9,3,9,0
43823,512,254,258,70,48,37,32,370,173,197,65,57,42,10,0
43824,437,228,209,47,61,26,11,192,110,82,33,21,10,3,0
43825,422,196,226,52,35,33,20,305,163,142,38,27,47,11,0
43826,728,358,370,118,100,55,29,132,61,71,22,21,15,3,0
43827,1441,504,937,264,329,69,46,903,436,467,128,116,83,33,0
43828,526,228,298,69,64,32,30,515,276,239,62,59,43,31,0
43829,548,310,238,72,62,54,13,1182,591,591,155,139,83,46,0
43830,396,150,246,103,64,38,3,766,386,380,101,81,78,31,0
43831,303,161,142,38,31,42,17,485,244,241,80,55,59,20,0
43832,432,233,199,52,28,47,18,376,189,187,47,53,44,26,0
43833,595,208,387,157,60,91,48,497,227,270,70,63,66,30,0
43834,1531,649,882,108,122,93,72,152,71,81,41,16,14,2,0
43835,681,367,314,83,74,78,31,317,161,156,50,36,47,12,0
43836,630,231,399,150,83,84,50,660,333,327,102,95,69,31,0
43837,546,278,268,94,60,32,22,1248,584,664,184,164,155,67,0
43838,279,129,150,43,34,17,13,323,168,155,51,41,38,12,0
43839,517,196,321,103,98,33,12,766,386,380,101,81,78,31,0
43840,1163,417,746,209,145,87,28,285,146,139,41,41,48,13,0
43841,667,366,301,96,55,84,25,289,140,149,33,42,30,15,0
43842,179,96,83,24,8,26,4,403,192,211,102,39,49,15,0
43843,1590,726,864,270,237,126,59,138,69,69,28,7,10,10,0
43844,219,98,121,43,19,11,7,494,123,371,160,58,29,5,0
43845,436,209,227,66,47,52,22,396,223,173,57,37,44,19,0
43846,257,148,109,28,20,21,14,457,245,212,62,58,57,21,0
43847,317,140,177,43,26,31,16,535,311,224,66,52,49,24,0
43848,378,202,176,34,32,44,13,172,79,93,34,27,23,10,0
43849,329,168,161,48,34,41,16,89,38,51,14,6,3,9,0
43850,384,198,186,58,48,37,12,367,218,149,45,43,42,16,0
43851,217,98,119,38,35,18,9,605,283,322,94,72,64,39,0
43852,228,105,123,34,43,20,10,538,274,264,84,67,52,35,0
43853,215,117,98,28,19,15,8,314,177,137,34,40,29,9,0
43854,631,304,327,98,75,52,23,323,171,152,48,41,40,16,0
43855,520,231,289,89,59,58,26,396,223,173,57,37,44,19,0
43856,302,178,124,34,29,50,13,1352,602,750,166,185,81,70,0
43857,262,133,129,44,38,31,12,904,436,468,143,118,108,32,0
43858,1189,653,536,152,118,109,56,352,207,145,40,33,25,21,0
43859,1030,438,592,184,104,108,30,201,93,108,34,39,21,6,0
43860,272,136,136,32,34,12,12,497,257,240,71,63,62,16,0
43861,507,314,193,49,45,59,25,821,394,427,122,117,109,38,0
43862,2446,1099,1347,363,294,233,100,250,116,134,41,30,33,19,0
43863,574,269,305,91,63,54,27,334,181,153,56,31,28,18,0
43864,99,35,64,25,18,0,1,158,71,87,23,21,17,12,0
43865,193,107,86,13,20,13,6,220,107,113,36,35,28,9,0
43866,747,360,387,125,92,69,32,601,278,323,124,87,65,21,0
43867,255,126,129,41,37,13,5,483,287,196,71,50,54,17,0
43868,781,367,414,60,67,43,17,139,68,71,14,26,14,9,0
43869,269,127,142,43,24,34,26,218,115,103,37,33,33,9,0
43870,496,210,286,112,55,71,14,328,199,129,39,29,27,14,0
43871,580,308,272,82,79,58,25,367,218,149,45,43,42,16,0
43872,451,225,226,69,57,64,22,773,389,384,119,91,79,26,0
43873,130,72,58,28,9,7,1,277,152,125,31,35,22,19,0
43874,421,237,184,47,54,45,10,445,192,253,86,58,53,18,0
43875,476,276,200,57,34,43,16,536,222,314,101,100,34,22,0
43876,756,265,491,129,127,51,17,218,114,104,32,31,33,11,0
43877,682,260,422,98,83,42,31,260,133,127,43,32,39,3,0
43878,98,32,66,15,25,5,4,260,133,127,43,32,39,3,0
43879,928,442,486,139,118,91,43,549,273,276,74,68,72,24,0
43880,475,208,267,84,67,50,20,732,366,366,108,86,74,41,0
43881,188,84,104,35,36,18,9,524,300,223,70,54,51,25,0
43882,1011,559,452,121,97,132,33,437,221,216,62,64,47,13,0
43883,282,135,147,27,37,30,19,103,50,53,19,10,7,5,0
43884,396,150,246,103,64,38,3,422,202,220,80,52,57,18,0
43885,733,438,295,95,79,67,32,1020,538,482,145,115,111,58,0
43886,360,175,185,73,36,27,7,133,61,72,21,19,13,4,0
43887,282,105,177,77,28,39,6,1382,508,874,334,320,98,36,0
43888,527,254,273,67,66,70,31,308,146,162,42,39,24,12,0
43889,136,66,70,33,11,9,3,373,213,160,44,33,26,17,0
43890,449,179,270,80,77,49,29,469,225,244,64,68,25,11,0
43891,756,362,394,102,104,73,25,189,95,94,25,33,16,8,0
43892,331,169,162,40,28,22,14,337,152,185,49,54,42,21,0
43893,83,45,38,11,8,8,3,1323,690,633,132,178,112,61,0
43894,313,148,165,45,33,36,11,125,66,59,24,16,11,5,0
43895,733,382,351,126,92,93,27,594,312,282,72,67,73,31,0
43896,264,122,142,33,29,13,13,261,148,113,31,28,14,10,0
43897,1096,563,533,158,136,120,53,375,209,166,50,37,29,23,0
43898,1099,491,608,163,141,107,62,588,286,302,78,99,53,25,0
43899,411,236,175,39,45,50,30,403,185,218,67,62,63,19,0
43900,1107,601,506,155,138,103,49,519,287,232,68,58,45,21,0
43901,55,16,39,24,2,5,2,492,278,214,65,58,32,11,0
43902,346,205,141,47,34,30,7,180,90,90,31,19,20,8,0
43903,146,73,73,18,24,17,9,520,272,248,60,65,58,22,0
43904,394,207,187,52,42,37,24,1113,480,633,170,173,81,34,0
43905,357,182,175,49,36,39,15,148,69,79,26,18,16,3,0
43906,717,381,336,118,103,85,29,441,189,252,73,50,47,23,0
43907,131,69,62,29,9,9,1,131,55,76,28,9,14,12,0
43908,135,64,71,31,11,8,4,903,436,467,128,116,83,33,0
43909,178,74,104,31,28,9,4,1101,626,475,145,122,120,50,0
43910,121,69,52,15,18,14,8,453,255,198,62,49,29,19,0
43911,236,141,95,36,32,14,6,943,463,480,91,144,70,30,0
43912,908,324,584,181,162,81,29,377,184,193,50,43,33,17,0
43913,770,394,376,90,96,78,34,980,481,499,131,107,85,44,0
43914,122,56,66,26,13,11,5,963,525,438,119,102,102,34,0
43915,739,323,416,127,89,76,33,227,130,97,32,25,22,12,0
43916,420,189,231,79,67,33,17,395,198,197,55,55,36,10,0
43917,255,110,145,34,32,23,17,562,273,289,76,92,45,24,0
43918,753,395,358,93,72,71,16,406,223,183,61,53,46,17,0
43919,476,254,222,58,33,46,23,127,66,61,13,14,19,8,0
43920,1221,597,624,201,152,83,31,470,205,265,71,80,33,11,0
43921,341,177,164,57,42,40,18,1004,457,547,150,150,74,52,0
43922,300,136,164,45,35,45,14,660,303,357,97,89,85,33,0
43923,953,421,532,131,131,70,37,242,124,118,39,32,28,22,0
43924,1284,511,773,227,166,169,107,367,199,168,62,44,34,8,0
43925,375,167,208,55,83,44,9,1314,693,621,174,155,140,58,0
43926,272,141,131,45,29,36,9,701,380,321,94,84,96,34,0
43927,747,360,387,125,92,69,32,102,51,51,12,15,12,3,0
43928,1390,585,805,241,230,118,46,818,357,461,122,136,54,25,0
43929,615,308,307,83,75,58,32,312,165,147,41,39,29,16,0
43930,507,242,265,53,44,31,22,741,383,358,92,63,79,36,0
43931,898,397,501,102,98,54,37,593,289,304,85,69,48,19,0
43932,1342,640,702,187,163,123,57,123,61,62,17,18,17,7,0
43933,639,368,271,72,51,38,38,374,191,183,40,52,40,16,0
43934,482,231,251,76,81,64,26,366,204,162,47,41,31,23,0
43935,325,181,144,46,31,48,9,975,475,500,139,140,119,28,0
43936,413,236,177,41,25,35,19,556,290,266,75,74,29,24,0
43937,415,133,282,114,65,27,7,384,204,180,53,47,49,17,0
43938,474,243,231,66,54,41,29,1208,565,643,182,162,120,57,0
43939,199,107,92,41,15,14,8,611,314,297,79,75,78,22,0
43940,315,111,204,82,66,46,11,257,139,118,64,17,24,7,0
43941,1030,438,592,184,104,108,30,231,126,105,28,26,34,9,0
43942,610,249,361,107,69,72,33,169,84,85,29,19,21,7,0
43943,422,207,215,79,38,53,23,187,89,98,36,24,20,6,0
43944,618,289,329,97,86,70,17,461,223,238,45,62,18,35,0
43945,929,410,519,187,146,53,30,87,51,35,15,9,9,4,0
43946,736,353,383,117,83,71,18,201,104,97,36,32,24,7,0
43947,435,222,213,67,49,67,12,619,305,314,85,93,71,29,0
43948,436,201,235,54,37,35,18,89,42,47,16,12,15,6,0
43949,325,186,139,49,36,20,5,130,67,63,24,10,12,4,0
43950,1560,778,782,224,235,132,78,535,311,224,66,52,49,24,0
43951,640,279,361,102,83,69,21,1352,602,750,166,185,81,70,0
43952,781,316,465,130,129,65,23,437,221,216,62,64,47,13,0
43953,327,174,153,42,35,16,12,314,151,163,42,61,39,16,0
43954,485,237,248,83,35,52,24,693,360,333,100,88,62,26,0
43955,209,75,134,53,48,20,9,297,164,133,45,39,40,9,0
43956,490,198,292,65,81,39,27,390,190,200,66,50,43,12,0
43957,451,278,173,71,35,58,12,175,91,84,19,21,21,10,0
43958,115,62,53,13,10,9,7,261,162,99,24,21,14,10,0
43959,384,198,186,58,48,37,12,621,273,348,104,102,48,19,0
43960,665,341,324,109,79,38,22,404,190,214,55,55,35,27,0
43961,395,195,200,41,55,23,10,362,156,206,74,42,36,22,0
43962,341,154,187,34,36,11,11,531,277,254,82,75,33,22,0
43963,335,183,152,40,26,54,22,124,69,55,14,7,9,4,0
43964,188,84,104,35,36,18,9,266,146,120,41,28,31,7,0
43965,904,436,468,138,146,82,39,384,212,172,44,43,34,14,0
43966,837,381,456,123,109,65,25,306,157,149,52,35,39,16,0
43967,1590,726,864,270,237,126,59,429,187,242,79,72,28,19,0
43968,334,155,179,47,34,38,11,387,193,194,60,53,57,15,0
43969,180,92,88,29,20,26,8,135,57,78,21,20,9,11,0
43970,358,212,146,51,36,33,9,96,45,51,13,12,6,4,0
43971,118,51,67,25,13,6,7,362,156,206,74,42,36,22,0
43972,312,164,148,54,29,25,15,437,221,216,62,64,47,13,0
43973,861,393,468,150,101,69,35,526,266,260,76,75,53,22,0
43974,356,199,157,36,43,28,12,471,238,233,66,63,62,19,0
43975,346,208,138,46,39,51,18,152,71,81,41,16,14,2,0
43976,406,207,199,56,46,68,19,277,163,114,33,24,21,16,0
43977,484,261,223,59,48,49,24,225,129,96,32,33,20,8,0
43978,760,405,355,112,95,92,29,2542,1245,1297,285,287,170,84,0
43979,204,103,101,16,32,22,8,387,193,194,60,53,57,15,0
43980,539,283,256,75,73,53,26,247,128,119,34,14,16,14,0
43981,636,288,348,94,77,65,30,414,203,211,58,56,48,14,0
43982,167,70,97,32,20,15,7,173,90,83,21,36,12,15,0
43983,1107,601,506,155,138,103,49,332,173,159,48,40,31,11,0
43984,700,305,395,111,99,54,18,1166,514,652,150,159,107,70,0
43985,225,111,114,38,22,25,10,508,253,255,73,60,50,13,0
43986,447,225,222,76,35,75,21,283,142,141,41,33,26,18,0
43987,361,177,184,59,51,24,15,201,93,108,34,39,21,6,0
43988,339,170,169,32,17,24,13,142,65,77,30,17,22,9,0
43989,1336,724,612,209,141,133,60,630,321,309,86,90,57,26,0
43990,150,60,90,27,16,6,3,317,161,156,40,49,41,11,0
43991,881,492,389,87,97,59,51,218,118,100,33,30,25,11,0
43992,795,384,411,133,109,85,38,583,280,303,95,66,76,25,0
43993,380,185,195,68,54,32,16,479,215,264,67,80,46,28,0
43994,350,172,178,61,45,32,13,662,312,350,103,104,59,20,0
43995,1498,731,767,220,175,148,68,975,475,500,139,140,119,28,0
43996,411,171,240,61,81,30,15,374,191,183,40,52,40,16,0
43997,772,417,355,118,92,80,23,761,351,410,117,73,103,45,0
43998,1463,521,942,252,204,105,52,228,130,98,35,29,30,10,0
43999,763,354,409,101,90,63,26,778,391,387,94,77,41,33,0
44000,561,282,279,68,62,36,14,403,192,211,102,39,49,15,0
44001,243,70,173,54,65,8,6,2225,1244,981,271,243,217,93,0
44002,280,128,152,39,37,38,18,142,65,77,30,17,22,9,0
44003,486,243,243,65,48,63,22,285,146,139,41,41,48,13,0
44004,336,199,137,46,22,51,13,368,183,185,40,42,40,15,0
44005,391,204,187,47,48,38,18,906,455,451,116,105,87,46,0
44006,1360,644,716,213,194,136,62,178,99,79,31,19,26,8,0
44007,215,117,98,28,19,15,8,561,279,282,85,81,88,24,0
44008,624,222,402,92,81,39,15,314,177,137,34,40,29,9,0
44009,502,236,266,66,66,58,17,178,99,79,31,19,26,8,0
44010,139,81,58,17,14,24,9,928,440,488,111,157,82,35,0
44011,733,382,351,126,92,93,27,538,274,264,84,67,52,35,0
44012,1912,880,1032,331,334,180,84,166,78,88,27,25,19,7,0
44013,1054,497,557,190,168,107,45,363,180,183,60,34,10,6,0
44014,362,174,188,46,55,35,23,205,94,111,48,31,15,6,0
44015,458,210,248,39,38,25,16,188,105,83,25,17,24,7,0
44016,435,230,205,51,37,55,18,367,199,168,62,44,34,8,0
44017,285,148,137,31,42,42,16,274,142,132,33,34,18,14,0
44018,380,187,193,38,51,30,18,482,232,250,77,81,44,13,0
44019,669,406,263,69,68,64,27,1215,652,563,129,142,121,62,0
44020,485,183,302,79,81,73,33,180,115,65,17,12,9,9,0
44021,605,277,328,99,54,63,43,290,147,143,34,34,39,13,0
44022,766,336,430,133,97,79,21,514,248,266,86,82,52,22,0
44023,99,35,64,25,18,0,1,373,181,192,54,35,44,20,0
44024,915,336,579,185,199,56,29,925,439,486,141,134,105,46,0
44025,411,171,240,61,81,30,15,478,254,224,67,74,56,28,0
44026,260,120,140,34,39,36,12,134,72,62,14,28,8,4,0
44027,243,114,129,37,30,32,8,464,236,228,64,56,53,28,0
44028,773,383,390,108,76,79,30,1543,794,749,182,152,132,55,0
44029,2446,1099,1347,363,294,233,100,679,338,341,96,95,40,23,0
44030,1096,563,533,158,136,120,53,125,66,59,24,16,11,5,0
44031,368,201,167,61,38,38,12,276,149,127,34,31,32,10,0
44032,454,214,240,56,71,35,16,2346,1231,1115,316,292,266,105,0
44033,447,236,211,56,52,49,14,756,348,408,101,103,60,40,0
44034,1007,353,654,277,147,70,26,201,98,103,28,25,19,13,0
44035,1462,711,751,219,222,148,65,530,287,243,79,70,33,26,0
44036,361,167,194,55,35,41,11,524,300,223,70,54,51,25,0
44037,585,277,308,92,73,61,32,166,102,64,19,14,17,2,0
44038,346,209,137,46,37,44,10,218,118,100,33,30,25,11,0
44039,510,288,222,44,36,24,7,225,111,114,32,34,32,16,0
44040,795,384,411,133,109,85,38,252,130,122,45,23,32,11,0
44041,368,201,167,61,38,38,12,261,127,134,36,27,36,4,0
44042,219,100,119,40,29,21,3,1214,475,739,177,250,89,49,0
44043,270,158,112,35,20,23,7,975,400,575,160,162,62,31,0
44044,334,190,144,42,42,16,5,1606,753,853,215,227,182,48,0
44045,522,302,220,61,49,75,19,286,152,134,38,38,32,11,0
44046,1214,498,716,197,180,121,65,375,211,164,50,36,31,23,0
44047,209,75,134,53,48,20,9,408,221,187,55,51,57,14,0
44048,381,187,194,37,49,36,17,308,129,179,44,60,19,8,0
44049,5890,3314,2576,970,956,293,265,415,203,212,77,44,49,18,0
44050,325,177,148,40,24,23,13,160,60,100,23,40,19,11,0
44051,57,24,33,11,3,5,3,423,234,189,66,44,57,12,0
44052,610,249,361,107,69,72,33,106,46,60,27,18,12,3,0
44053,434,216,218,72,58,40,20,285,143,142,45,32,21,17,0
44054,273,126,147,54,49,25,18,749,384,365,108,105,86,31,0
44055,291,131,160,49,35,32,15,770,390,380,104,76,78,32,0
44056,881,492,389,87,97,59,51,129,60,69,21,15,8,5,0
44057,493,281,212,56,61,30,13,250,116,134,41,30,33,19,0
44058,340,181,159,44,39,35,21,335,170,165,52,36,47,11,0
44059,1124,442,682,148,189,72,43,374,174,200,54,52,42,21,0
44060,221,75,146,68,21,16,5,368,200,168,54,49,43,9,0
44061,540,252,288,73,67,57,20,609,335,274,79,57,45,22,0
44062,911,441,470,123,108,60,21,647,324,323,101,80,76,43,0
44063,219,100,119,40,29,21,3,301,168,133,49,37,34,11,0
44064,1217,647,570,142,160,129,45,163,79,84,22,24,13,5,0
44065,1098,519,579,182,159,79,42,106,41,65,36,6,11,7,0
44066,1867,973,894,256,222,194,65,403,233,170,38,29,21,14,0
44067,983,449,534,95,77,55,36,423,234,189,66,44,57,12,0
44068,604,239,365,124,63,84,37,125,66,59,24,16,11,5,0
44069,241,122,119,27,34,17,16,398,200,198,68,43,51,14,0
44070,557,211,346,129,125,48,19,105,51,54,13,17,12,8,0
44071,1390,585,805,241,230,118,46,535,288,247,79,72,35,21,0
44072,326,154,172,45,39,20,10,1239,659,580,169,148,131,54,0
44073,450,227,223,53,36,48,12,392,214,178,48,40,53,22,0
44074,199,107,92,41,15,14,8,180,115,65,17,12,9,9,0
44075,972,501,471,125,156,106,39,376,189,187,47,53,44,26,0
44076,349,131,218,66,76,22,9,497,227,270,70,63,66,30,0
44077,1542,682,860,290,158,120,47,172,88,84,24,31,20,12,0
44078,836,370,466,126,96,72,30,602,310,292,87,66,70,36,0
44079,1030,567,463,118,106,94,49,277,124,153,44,40,35,18,0
44080,338,139,199,54,54,18,11,405,195,210,57,74,24,17,0
44081,708,344,364,106,98,66,33,368,183,185,40,42,40,15,0
44082,416,222,194,58,38,38,20,469,225,244,64,68,25,11,0
44083,490,198,292,65,81,39,27,194,109,85,23,24,21,9,0
44084,454,230,224,63,56,38,33,314,151,163,42,61,39,16,0
44085,1014,488,526,178,137,94,39,551,226,325,96,103,43,11,0
44086,507,242,265,53,44,31,22,508,253,255,73,60,50,13,0
44087,933,456,477,123,108,83,29,350,196,154,52,37,21,14,0
44088,527,276,251,64,60,70,20,229,120,109,31,30,22,9,0
44089,643,284,359,129,71,84,43,290,142,148,41,37,43,11,0
44090,327,174,153,42,35,16,12,689,343,346,105,102,81,35,0
44091,181,92,89,34,22,17,9,1061,543,518,146,123,109,67,0
44092,423,247,176,58,55,29,20,748,359,389,125,113,86,31,0
44093,1030,567,463,118,106,94,49,199,105,94,27,27,28,9,0
44094,1124,442,682,148,189,72,43,1382,508,874,334,320,98,36,0
44095,270,147,123,34,17,39,21,257,126,131,61,24,22,8,0
44096,956,450,506,122,117,82,36,898,469,429,125,125,134,35,0
44097,536,237,299,116,87,42,17,403,185,218,67,62,63,19,0
44098,895,388,507,130,84,90,31,1425,670,755,153,189,122,85,0
44099,600,324,276,89,73,45,39,147,74,73,28,20,24,4,0
44100,260,120,140,34,39,36,12,207,114,93,33,20,31,13,0
44101,1464,693,771,153,136,91,86,671,306,365,114,76,49,19,0
44102,411,202,209,60,67,57,24,96,45,51,13,12,6,4,0
44103,447,225,222,76,35,75,21,507,270,237,89,59,57,22,0
44104,314,178,136,42,32,30,17,647,350,297,95,79,77,29,0
44105,193,107,86,13,20,13,6,775,407,368,122,100,97,32,0
44106,414,216,198,51,32,42,28,261,162,99,24,21,14,10,0
44107,361,183,178,50,54,51,22,199,105,94,27,27,28,9,0
44108,782,372,410,127,111,89,36,508,253,255,73,60,50,13,0
44109,1208,575,633,187,204,117,41,654,295,359,99,88,71,25,0
44110,319,222,97,36,23,28,8,128,63,65,30,11,13,8,0
44111,514,226,288,71,66,63,32,1873,935,938,233,225,203,79,0
44112,570,238,332,112,95,39,23,91,44,47,9,12,4,7,0
44113,505,226,279,68,51,30,15,152,71,81,41,16,14,2,0
44114,631,304,327,98,75,52,23,778,391,387,94,77,41,33,0
44115,414,195,219,51,60,40,17,453,255,198,62,49,29,19,0
44116,828,368,460,118,98,59,38,332,173,159,48,40,31,11,0
44117,643,284,359,129,71,84,43,302,150,152,56,40,52,15,0
44118,338,164,174,45,32,37,13,607,293,314,98,71,62,32,0
44119,641,349,292,92,60,39,24,609,335,274,79,57,45,22,0
44120,900,434,466,134,97,86,36,230,125,105,29,40,20,6,0
44121,257,148,109,28,20,21,14,904,436,468,143,118,108,32,0
44122,164,61,103,47,19,14,5,727,388,339,102,87,70,29,0
44123,163,70,93,28,21,17,6,65,32,33,16,4,8,3,0
44124,204,93,111,35,35,16,11,320,168,152,38,42,24,18,0
44125,334,190,144,42,42,16,5,360,180,180,57,48,39,12,0
44126,313,158,155,43,35,43,16,332,180,152,44,36,27,13,0
44127,164,77,87,33,19,6,7,497,257,240,71,63,62,16,0
44128,423,247,176,58,55,29,20,756,348,408,101,103,60,40,0
44129,1014,488,526,178,137,94,39,1047,562,485,141,127,114,41,0
44130,347,198,149,45,29,29,8,1922,923,999,267,275,215,90,0
44131,1441,504,937,264,329,69,46,485,244,241,80,55,59,20,0
44132,447,236,211,56,52,49,14,392,186,206,62,56,29,15,0
44133,733,438,295,95,79,67,32,437,221,216,62,64,47,13,0
44134,442,254,188,46,22,40,19,471,238,233,66,63,62,19,0
44135,473,212,261,72,64,45,28,1182,591,591,155,139,83,46,0
44136,1171,542,629,170,146,114,64,386,181,205,55,51,57,31,0
44137,588,317,271,78,49,54,17,386,207,179,43,48,44,19,0
44138,446,265,181,51,35,27,17,518,292,226,60,60,52,21,0
44139,630,231,399,150,83,84,50,2225,1244,981,271,243,217,93,0
44140,329,168,161,48,34,41,16,305,163,142,38,27,47,11,0
44141,805,338,467,153,138,99,55,207,114,93,33,20,31,13,0
44142,1339,494,845,216,298,92,37,619,305,314,85,93,71,29,0
44143,546,285,261,71,49,47,24,241,127,114,34,33,29,12,0
44144,276,149,127,45,34,39,9,209,119,90,28,24,27,9,0
44145,898,397,501,102,98,54,37,166,78,88,27,25,19,7,0
44146,335,155,180,64,48,36,10,1265,689,576,169,177,128,60,0
44147,640,271,369,111,79,57,17,201,104,97,36,32,24,7,0
44148,467,233,234,83,37,77,22,432,244,188,51,51,27,14,0
44149,453,240,213,53,33,44,16,142,73,69,27,9,15,11,0
44150,215,104,111,61,7,2,1,1001,417,584,186,147,96,47,0
44151,305,124,181,27,25,32,21,1425,670,755,153,189,122,85,0
44152,139,64,75,18,17,18,4,445,192,253,86,58,53,18,0
44153,340,181,159,44,39,35,21,792,398,394,109,96,90,39,0
44154,493,208,285,75,77,70,40,172,79,93,34,27,23,10,0
44155,365,222,143,44,24,35,11,1062,522,540,151,147,105,66,0
44156,505,226,279,68,51,30,15,260,131,129,42,31,40,9,0
44157,651,357,294,81,67,103,18,251,143,108,47,25,29,11,0
44158,219,100,119,40,29,21,3,153,80,73,26,18,19,4,0
44159,728,358,370,118,100,55,29,242,124,118,39,32,28,22,0
44160,444,250,194,58,21,60,23,660,333,327,102,95,69,31,0
44161,753,361,392,99,94,66,16,559,317,242,58,65,37,23,0
44162,123,58,65,22,14,13,3,621,273,348,104,102,48,19,0
44163,359,167,192,49,37,27,19,408,221,187,55,51,57,14,0
44164,173,90,83,30,19,19,11,720,357,363,113,85,62,39,0
44165,577,342,235,63,57,23,37,368,200,168,54,49,43,9,0
44166,155,85,70,17,16,4,8,724,353,371,94,95,71,31,0
44167,680,308,372,82,72,71,40,348,212,136,53,31,25,18,0
44168,2649,1431,1218,377,299,266,102,455,191,264,68,86,21,19,0
44169,206,100,106,34,26,11,7,974,457,517,133,117,69,26,0
44170,454,214,240,56,71,35,16,134,72,62,14,28,8,4,0
44171,503,260,243,46,56,33,16,607,293,314,98,71,62,32,0
44172,422,207,215,79,38,53,23,180,115,65,17,12,9,9,0
44173,361,167,194,55,35,41,11,380,178,202,69,53,37,10,0
44174,178,87,91,20,32,13,10,555,282,273,82,69,65,21,0
44175,1041,497,544,180,167,98,34,198,110,88,27,27,24,4,0
44176,1041,497,544,180,167,98,34,601,278,323,124,87,65,21,0
44177,420,189,231,79,67,33,17,701,380,321,94,84,96,34,0
44178,507,314,193,49,45,59,25,199,105,94,27,27,28,9,0
44179,465,305,160,40,47,34,9,689,343,346,105,102,81,35,0
44180,933,456,477,123,108,83,29,354,183,171,54,43,49,8,0
44181,388,209,179,46,24,31,28,339,175,164,51,49,37,9,0
44182,593,282,311,75,70,29,25,904,436,468,143,118,108,32,0
44183,692,305,387,100,97,78,30,660,332,328,84,73,47,19,0
44184,500,297,203,66,33,53,15,172,88,84,24,31,20,12,0
44185,466,199,267,86,59,32,17,588,286,302,78,99,53,25,0
44186,331,169,162,40,28,22,14,346,178,168,58,41,33,12,0
44187,317,167,150,45,21,30,26,729,358,371,116,99,89,33,0
44188,717,381,336,118,103,85,29,360,180,180,57,48,39,12,0
44189,233,110,123,34,22,34,9,562,273,289,76,92,45,24,0
44190,326,176,150,35,22,29,11,663,354,309,91,84,79,31,0
44191,356,199,157,36,43,28,12,405,181,224,71,57,31,12,0
44192,437,167,270,126,95,34,10,127,64,63,26,8,12,8,0
44193,180,57,123,39,22,10,8,501,257,244,75,57,48,29,0
44194,304,149,155,46,32,39,14,892,475,417,130,108,68,38,0
44195,2048,855,1193,297,287,191,93,715,348,367,109,84,68,30,0
44196,465,220,245,88,34,61,23,222,124,98,37,29,22,9,0
44197,1007,353,654,277,147,70,26,360,185,175,51,43,36,16,0
44198,438,185,253,71,64,52,28,375,176,199,48,61,40,12,0
44199,462,233,229,66,49,43,30,218,114,104,32,31,33,11,0
44200,1867,973,894,256,222,194,65,381,187,194,37,49,36,17,0
44201,852,461,391,109,102,72,24,244,143,101,31,29,26,8,0
44202,485,237,248,83,35,52,24,360,180,180,57,48,39,12,0
44203,494,242,252,67,47,25,21,368,200,168,54,49,43,9,0
44204,873,366,507,127,125,75,21,134,72,62,14,28,8,4,0
44205,2063,1024,1039,175,117,80,97,278,154,124,42,32,38,7,0
44206,329,171,158,49,41,31,10,199,92,107,34,30,18,9,0
44207,1960,875,1085,287,189,162,66,169,74,95,33,26,22,3,0
44208,664,269,395,117,107,36,15,2382,1162,1220,237,220,140,49,0
44209,376,249,127,47,23,43,16,265,134,131,48,34,33,15,0
44210,1112,457,655,180,164,99,39,480,255,225,67,64,50,22,0
44211,702,358,344,113,87,81,30,340,163,177,39,38,37,23,0
44212,126,56,70,31,10,10,3,198,110,88,27,27,24,4,0
44213,279,129,150,43,34,17,13,928,440,488,111,157,82,35,0
44214,1130,614,516,129,138,98,42,160,60,100,23,40,19,11,0
44215,1098,519,579,182,159,79,42,303,138,165,47,46,35,18,0
44216,210,101,109,33,33,19,9,4646,2328,2318,674,639,475,170,0
44217,729,351,378,111,98,58,18,564,264,300,79,84,65,26,0
44218,616,323,293,98,71,31,15,862,426,436,113,115,84,37,0
44219,784,353,431,56,47,26,18,415,203,212,77,44,49,18,0
44220,228,82,146,45,37,18,8,215,115,100,27,19,16,7,0
44221,233,107,126,40,40,20,16,218,115,103,32,32,34,11,0
44222,1872,837,1035,280,338,169,80,605,283,322,94,72,64,39,0
44223,418,163,255,57,54,38,24,1241,619,622,183,169,155,59,0
44224,414,216,198,51,32,42,28,597,300,297,96,89,68,29,0
44225,450,231,219,77,50,76,16,260,131,129,42,31,40,9,0
44226,359,204,155,39,36,34,13,234,116,118,34,35,23,9,0
44227,410,188,222,53,52,31,14,1338,720,618,179,145,141,85,0
44228,179,96,83,24,8,26,4,194,109,85,23,24,21,9,0
44229,236,141,95,36,32,14,6,142,65,77,30,17,22,9,0
44230,772,417,355,118,92,80,23,392,214,178,48,40,53,22,0
44231,315,111,204,82,66,46,11,261,148,113,31,28,14,10,0
44232,414,206,208,56,68,35,19,621,310,311,100,106,77,27,0
44233,341,154,187,34,36,11,11,192,110,82,33,21,10,3,0
44234,257,148,109,28,20,21,14,530,287,243,79,70,33,26,0
44235,546,285,261,71,49,47,24,251,143,108,47,25,29,11,0
44236,361,167,194,55,35,41,11,265,134,131,48,34,33,15,0
44237,86,50,36,9,14,8,7,338,169,169,53,44,39,21,0
44238,726,312,414,121,73,82,23,264,138,126,33,34,29,12,0
44239,341,195,146,42,21,36,9,415,226,189,51,40,40,29,0
44240,213,104,109,56,14,9,2,334,181,153,41,40,25,15,0
44241,380,185,195,68,54,32,16,152,71,81,41,16,14,2,0
44242,279,129,150,43,34,17,13,756,348,408,101,103,60,40,0
44243,401,183,218,72,73,28,10,127,58,69,18,17,10,5,0
44244,142,60,82,20,28,13,5,463,268,195,59,46,46,21,0
44245,286,111,175,51,47,21,12,732,402,330,81,86,87,33,0
44246,3859,2011,1848,535,391,422,207,381,186,195,69,55,46,15,0
44247,193,110,83,18,20,15,12,617,314,303,96,68,68,37,0
44248,639,368,271,72,51,38,38,194,106,88,33,10,15,6,0
44249,202,113,89,16,27,21,11,188,88,100,53,12,15,6,0
44250,300,136,164,45,35,45,14,246,125,121,38,36,30,11,0
44251,438,185,253,71,64,52,28,555,282,273,82,69,65,21,0
44252,283,112,171,48,39,34,15,314,177,137,34,40,29,9,0
44253,437,212,225,66,44,44,11,188,105,83,25,17,24,7,0
44254,470,163,307,99,68,73,30,267,141,126,53,27,23,7,0
44255,648,262,386,113,108,78,29,392,214,178,48,40,53,22,0
44256,215,117,98,28,19,15,8,314,151,163,42,61,39,16,0
44257,1068,434,634,173,160,61,29,283,160,123,25,20,37,9,0
44258,1718,735,983,266,225,130,68,198,110,88,27,27,24,4,0
44259,483,236,247,82,60,43,18,492,278,214,65,58,32,11,0
44260,785,325,460,114,123,61,28,135,65,70,21,25,15,9,0
44261,317,167,150,45,21,30,26,572,305,267,74,72,58,21,0
44262,301,119,182,53,47,14,20,72,32,40,8,2,2,13,0
44263,763,371,392,104,88,52,23,234,129,105,31,22,19,17,0
44264,301,119,182,53,47,14,20,257,139,118,64,17,24,7,0
44265,539,283,256,75,73,53,26,410,197,213,67,43,56,18,0
44266,421,237,184,47,54,45,10,947,482,465,143,107,89,37,0
44267,873,366,507,127,125,75,21,381,196,185,55,57,43,16,0
44268,815,356,459,128,125,82,26,474,268,206,66,42,45,24,0
44269,519,245,274,58,61,34,22,367,218,149,45,43,42,16,0
44270,509,251,258,69,49,55,17,778,391,387,94,77,41,33,0
44271,894,448,446,123,100,82,30,396,213,183,68,44,47,18,0
44272,255,126,129,41,37,13,5,866,397,469,117,153,95,48,0
44273,853,400,453,137,109,88,42,132,67,65,24,21,8,10,0
44274,126,56,70,31,10,10,3,89,38,51,14,6,3,9,0
44275,1023,449,574,141,174,76,43,242,124,118,39,32,28,22,0
44276,524,270,254,84,72,70,23,225,129,96,32,33,20,8,0
44277,365,222,143,44,24,35,11,277,138,139,40,39,20,14,0
44278,510,269,241,66,67,71,26,516,245,271,82,84,70,26,0
44279,475,208,267,84,67,50,20,1065,581,484,134,97,76,46,0
44280,919,493,426,100,92,88,49,483,258,225,70,53,54,20,0
44281,224,108,116,33,26,32,10,866,478,388,121,101,101,26,0
44282,861,393,468,150,101,69,35,201,104,97,36,32,24,7,0
44283,412,208,204,54,47,42,17,689,343,346,105,102,81,35,0
44284,475,235,240,77,58,43,22,278,154,124,42,32,38,7,0
44285,957,381,576,184,158,86,48,168,67,101,37,17,13,13,0
44286,650,330,320,97,77,65,28,222,124,98,37,29,22,9,0
44287,106,43,63,28,13,8,1,222,127,95,23,28,22,7,0
44288,5890,3314,2576,970,956,293,265,292,155,137,50,34,29,13,0
44289,232,134,98,28,20,20,5,207,114,93,33,20,31,13,0
44290,165,66,99,28,32,16,3,192,110,82,33,21,10,3,0
44291,326,148,178,55,42,31,12,130,67,63,24,10,12,4,0
44292,531,260,271,97,68,47,11,103,44,59,16,17,9,5,0
44293,739,389,350,129,61,69,25,496,251,245,78,62,61,23,0
44294,305,124,181,27,25,31,21,497,227,270,70,63,66,30,0
44295,482,245,237,69,64,66,24,72,34,38,8,2,3,12,0
44296,173,90,83,30,19,19,11,298,129,169,51,40,29,8,0
44297,224,108,116,33,26,32,10,137,78,59,22,16,17,4,0
44298,1208,575,633,187,204,117,41,198,110,88,27,27,24,4,0
44299,624,222,402,92,81,39,15,439,231,208,65,51,55,17,0
44300,756,265,491,129,127,51,17,169,74,95,33,26,22,3,0
44301,90,46,44,14,15,8,3,94,45,49,11,20,10,4,0
44302,329,171,158,49,41,31,10,316,166,150,45,38,37,13,0
44303,1130,614,516,129,138,98,42,496,285,211,62,54,46,22,0
44304,546,278,268,94,60,32,22,286,152,134,38,38,32,11,0
44305,536,287,249,64,73,21,27,391,189,202,55,56,56,12,0
44306,322,164,158,46,44,29,7,261,148,113,31,28,14,10,0
44307,1505,680,825,202,204,73,32,266,150,116,28,28,24,12,0
44308,350,190,160,48,25,27,18,619,305,314,85,93,71,29,0
44309,417,176,241,75,61,51,20,287,151,136,51,42,36,7,0
44310,260,133,127,43,29,34,11,900,441,459,125,127,110,32,0
44311,1030,438,592,184,104,108,30,292,143,149,38,42,36,16,0
44312,904,436,468,138,146,82,39,579,285,294,78,72,64,32,0
44313,158,71,87,23,21,17,12,1138,615,523,142,120,116,57,0
44314,486,243,243,65,48,63,22,169,85,84,21,14,9,9,0
44315,125,53,72,18,21,18,12,329,196,133,41,36,31,15,0
44316,410,211,199,55,42,34,27,504,272,232,75,57,53,19,0
44317,1052,492,560,184,163,103,44,1698,875,823,222,219,173,64,0
44318,335,171,164,51,38,38,10,323,162,161,52,41,39,13,0
44319,1047,443,604,162,156,78,52,348,212,136,53,31,25,18,0
44320,115,62,53,13,10,9,7,274,157,117,40,29,40,8,0
44321,500,245,255,66,57,52,27,390,223,167,58,36,45,18,0
44322,282,163,119,40,23,25,17,1700,731,969,198,233,110,87,0
44323,279,127,152,50,36,28,8,423,234,189,66,44,57,12,0
44324,420,202,218,67,43,51,15,432,244,188,51,51,27,14,0
44325,224,101,123,45,32,21,3,187,89,98,36,24,20,6,0
44326,55,16,39,24,2,5,2,289,140,149,33,42,30,15,0
44327,126,58,68,31,10,10,3,376,183,193,50,50,43,21,0
44328,424,170,254,69,56,47,28,319,185,134,42,31,22,13,0
44329,394,207,187,52,42,37,24,373,189,184,54,46,50,23,0
44330,155,85,70,17,16,4,8,165,90,75,36,18,20,6,0
44331,594,248,346,104,109,53,5,194,109,85,23,24,21,9,0
44332,236,141,95,36,32,14,6,478,254,224,67,74,56,28,0
44333,359,204,155,39,36,34,13,1352,602,750,166,185,81,70,0
44334,55,16,39,24,2,5,2,601,278,323,124,87,65,21,0
44335,215,117,98,28,19,15,8,406,202,204,54,51,63,21,0
44336,315,111,204,82,66,46,11,640,364,276,84,68,69,33,0
44337,680,308,372,82,72,71,40,496,251,245,78,62,61,23,0
44338,919,444,475,141,148,62,20,975,475,500,139,140,119,28,0
44339,270,166,104,30,26,28,14,508,262,246,66,67,51,20,0
44340,815,356,459,128,125,82,26,403,221,182,62,50,42,12,0
44341,574,269,305,91,63,54,27,1352,602,750,166,185,81,70,0
44342,490,224,266,80,70,39,32,295,158,137,42,34,38,14,0
44343,323,156,167,52,45,39,18,798,385,413,120,115,79,30,0
44344,588,267,321,99,79,87,28,220,107,113,36,35,28,9,0
44345,795,384,411,133,109,85,38,555,292,263,75,63,67,27,0
44346,213,113,100,26,21,26,12,508,261,247,65,53,58,23,0
44347,398,186,212,76,70,18,13,398,200,198,68,43,51,14,0
44348,345,203,142,47,35,31,11,1114,539,575,145,131,94,56,0
44349,233,107,126,40,40,20,16,2202,1121,1081,338,274,269,81,0
44350,391,204,187,47,48,38,18,482,232,250,77,81,44,13,0
44351,209,78,131,33,42,11,7,904,436,468,138,146,82,39,0
44352,127,54,73,31,10,11,3,425,177,248,60,62,33,16,0
44353,546,278,268,94,60,32,22,337,152,185,49,54,42,21,0
44354,2109,999,1110,332,294,187,89,430,212,218,88,43,40,20,0
44355,2799,1324,1475,369,371,215,124,299,140,159,49,44,26,11,0
44356,2488,1085,1403,346,253,162,76,144,67,77,28,14,9,8,0
44357,442,254,188,46,22,40,19,98,49,49,14,15,9,2,0
44358,580,240,340,108,81,59,22,551,226,325,96,103,43,11,0
44359,2446,1099,1347,363,294,233,100,701,380,321,94,84,96,34,0
44360,1960,875,1085,287,189,162,66,262,129,133,40,41,31,10,0
44361,121,69,52,15,18,14,8,165,87,78,24,19,22,9,0
44362,339,170,169,32,17,24,13,2724,1157,1567,269,518,239,77,0
44363,437,167,270,126,95,34,10,459,260,199,56,42,47,21,0
44364,260,136,124,24,41,19,4,497,227,270,70,63,66,30,0
44365,613,303,310,70,28,28,18,123,61,62,17,18,17,7,0
44366,1689,821,868,277,250,177,78,283,142,141,41,33,26,18,0
44367,313,158,155,43,35,43,16,335,170,165,52,36,47,11,0
44368,474,250,224,58,47,37,12,189,95,94,25,33,16,8,0
44369,399,220,179,48,37,68,18,600,254,346,104,100,44,17,0
44370,1124,442,682,148,189,72,43,103,44,59,16,17,9,5,0
44371,798,287,511,126,125,77,26,375,210,165,49,37,29,27,0
44372,494,242,252,67,47,25,21,1700,731,969,198,233,110,87,0
44373,192,91,101,28,21,18,8,292,155,137,50,34,29,13,0
44374,312,164,148,54,29,25,15,471,238,233,66,63,62,19,0
44375,510,288,222,44,36,24,7,766,386,380,101,81,78,31,0
44376,269,124,145,36,24,32,11,858,398,460,126,138,75,39,0
44377,2696,1169,1527,432,347,193,146,381,187,194,37,49,36,17,0
44378,1030,567,463,118,106,94,49,218,115,103,37,33,33,9,0
44379,398,186,212,76,70,18,13,514,248,266,86,82,52,22,0
44380,431,245,186,50,23,46,17,903,436,467,128,116,83,33,0
44381,1689,821,868,277,250,177,78,338,169,169,53,44,39,21,0
44382,376,176,200,31,53,27,8,462,229,233,63,49,42,18,0
44383,717,281,436,165,81,112,49,287,151,136,51,42,36,7,0
44384,270,128,142,36,43,15,11,400,187,213,56,59,42,20,0
44385,580,308,272,82,79,58,25,373,213,160,44,33,26,17,0
44386,284,160,124,37,23,32,11,332,180,152,46,36,28,14,0
44387,508,251,257,74,53,51,18,751,394,357,107,96,73,35,0
44388,616,323,293,98,71,31,15,452,252,200,55,49,61,16,0
44389,343,189,154,44,24,39,12,367,218,149,45,43,42,16,0
44390,378,202,176,34,32,44,13,663,360,303,87,82,80,35,0
44391,332,170,162,44,38,39,10,247,128,119,34,14,16,14,0
44392,860,349,511,166,166,58,19,201,93,108,34,39,21,6,0
44393,424,170,254,69,56,47,28,661,325,336,81,75,65,28,0
44394,4128,2104,2024,581,505,453,205,144,67,77,28,14,9,8,0
44395,2174,1057,1117,241,241,214,117,230,125,105,29,40,20,6,0
44396,494,242,252,67,47,25,21,584,249,335,80,96,22,13,0
44397,320,163,157,44,44,26,15,103,50,53,19,10,7,5,0
44398,126,56,70,31,10,10,3,301,168,133,49,37,34,11,0
44399,630,231,399,150,83,84,50,496,285,211,62,54,46,22,0
44400,1341,481,860,275,264,57,21,1696,771,925,257,225,149,63,0
44401,1647,794,853,279,235,128,65,966,478,488,108,144,74,43,0
44402,574,284,290,64,50,65,20,145,77,68,26,7,15,8,0
44403,411,171,240,61,81,30,15,163,79,84,22,24,13,5,0
44404,496,209,287,113,55,72,14,1040,564,476,134,110,114,51,0
44405,92,46,46,14,9,8,6,88,50,38,13,8,16,4,0
44406,136,66,70,33,11,9,5,536,222,314,101,100,34,22,0
44407,1023,449,574,141,174,76,43,445,202,243,70,73,51,15,0
44408,219,116,103,66,7,2,1,1040,564,476,134,110,114,51,0
44409,1226,513,713,184,147,87,43,106,41,65,36,6,11,7,0
44410,1616,735,881,285,248,153,72,104,46,58,15,17,9,5,0
44411,781,316,465,130,129,65,23,751,394,357,107,96,73,35,0
44412,437,212,225,66,44,44,11,665,361,304,87,91,84,31,0
44413,247,128,119,40,21,27,11,336,190,146,52,30,41,6,0
44414,265,165,100,32,19,27,5,605,283,322,94,72,64,39,0
44415,479,227,252,69,48,46,18,665,361,304,87,91,84,31,0
44416,575,305,270,74,87,73,25,445,264,181,35,35,34,14,0
44417,227,120,107,31,28,28,13,889,505,384,107,97,99,30,0
44418,801,331,470,151,139,99,55,889,505,384,107,97,99,30,0
44419,281,154,127,45,31,24,9,387,193,194,60,53,57,15,0
44420,204,109,95,21,35,27,7,106,46,60,27,18,12,3,0
44421,465,305,160,40,47,34,9,418,223,195,51,45,49,14,0
44422,734,366,368,121,99,63,39,390,223,167,58,36,45,18,0
44423,563,255,308,91,111,42,30,727,362,365,123,107,63,23,0
44424,1339,494,845,216,298,92,37,169,84,85,29,19,21,7,0
44425,180,57,123,39,22,10,8,337,170,167,59,33,47,17,0
44426,181,75,106,35,26,11,9,437,224,213,40,29,42,25,0
44427,604,239,365,124,63,84,37,715,348,367,109,84,68,30,0
44428,335,171,164,51,38,38,10,737,397,340,87,104,90,14,0
44429,498,274,224,58,59,50,18,535,301,234,63,48,47,27,0
44430,598,300,298,68,77,59,21,1208,565,643,182,162,120,57,0
44431,1257,464,793,221,264,75,37,720,361,359,98,98,70,37,0
44432,251,139,112,41,18,27,11,432,244,188,51,51,27,14,0
44433,493,281,212,56,61,30,13,127,54,73,11,33,15,6,0
44434,373,194,179,42,54,26,13,326,169,157,51,41,41,12,0
44435,983,449,534,95,77,55,36,332,173,159,48,40,31,11,0
44436,473,217,256,59,44,34,21,225,114,111,32,29,26,6,0
44437,358,212,146,51,36,33,9,91,44,47,9,12,4,7,0
44438,312,164,148,54,29,25,15,261,148,113,31,28,14,10,0
44439,279,129,150,43,34,17,13,332,180,152,46,36,28,14,0
44440,461,207,254,82,66,55,33,526,266,260,76,75,53,22,0
44441,269,156,113,37,32,17,7,108,59,49,17,13,12,5,0
44442,258,126,132,38,22,29,8,98,49,49,14,15,9,2,0
44443,685,393,292,75,66,113,16,536,267,269,60,70,41,22,0
44444,428,226,202,52,60,75,20,1208,565,643,182,162,120,57,0
44445,507,249,258,54,76,28,20,1539,686,853,166,229,123,68,0
44446,331,177,154,54,38,27,11,91,44,47,9,12,4,7,0
44447,330,77,253,86,52,20,12,902,499,403,118,117,92,35,0
44448,476,254,222,58,33,46,23,507,270,237,89,59,57,22,0
44449,516,210,306,113,53,81,33,593,289,304,85,69,48,19,0
44450,474,250,224,58,47,37,12,339,175,164,51,49,37,9,0
44451,422,207,215,79,38,53,23,72,33,39,8,2,3,12,0
44452,673,317,356,101,85,76,49,106,46,60,29,13,14,5,0
44453,446,265,181,51,35,27,17,671,306,365,114,76,49,19,0
44454,594,279,315,93,68,68,26,520,272,248,60,65,58,22,0
44455,516,210,306,113,53,81,33,91,44,47,9,12,4,7,0
44456,1001,422,579,185,180,51,32,192,91,101,29,28,17,7,0
44457,781,367,414,60,67,43,17,2547,1280,1267,331,335,293,118,0
44458,193,105,88,33,16,9,4,231,126,105,28,26,34,9,0
44459,411,236,175,39,45,50,30,314,151,163,42,61,39,16,0
44460,1594,660,934,251,272,117,77,1606,753,853,215,227,182,48,0
44461,640,308,332,91,102,49,21,538,274,264,84,67,52,35,0
44462,505,226,279,68,51,30,15,508,253,255,73,60,50,13,0
44463,2442,1193,1249,278,183,170,145,418,223,195,51,45,49,14,0
44464,463,250,213,56,45,73,25,278,154,124,42,32,38,7,0
44465,402,169,233,70,36,34,18,302,150,152,56,40,52,15,0
44466,119,67,52,15,15,7,7,1500,804,696,190,172,144,60,0
44467,622,354,268,89,60,64,18,203,98,105,34,29,19,10,0
44468,1200,602,598,145,116,110,50,261,148,113,31,28,14,10,0
44469,1199,589,610,189,128,167,65,261,162,99,24,21,14,10,0
44470,953,421,532,131,131,70,37,562,273,289,76,92,45,24,0
44471,240,98,142,49,42,23,17,335,170,165,52,36,47,11,0
44472,365,148,217,86,37,51,28,415,203,212,77,44,49,18,0
44473,570,238,332,112,95,39,23,611,314,297,79,75,78,22,0
44474,437,230,207,41,55,27,13,91,44,47,9,12,4,7,0
44475,393,223,170,44,36,32,14,605,283,322,94,72,64,39,0
44476,1711,865,846,204,176,105,60,2724,1157,1567,269,518,239,77,0
44477,613,303,310,70,28,28,18,644,343,301,96,69,59,28,0
44478,343,189,154,44,24,39,12,548,273,275,84,81,64,30,0
44479,332,173,159,48,42,42,9,295,158,137,42,34,38,14,0
44480,828,368,460,118,98,59,38,173,94,79,18,24,12,7,0
44481,1709,650,1059,338,286,185,46,137,72,65,27,13,15,8,0
44482,341,175,166,48,43,35,18,290,142,148,41,37,43,11,0
44483,369,207,162,67,35,16,14,439,227,212,60,55,58,8,0
44484,505,226,279,68,51,30,15,592,249,343,91,90,50,42,0
44485,588,300,288,100,57,65,27,465,252,213,73,58,60,18,0
44486,691,241,450,151,139,24,20,470,226,244,81,53,59,39,0
44487,666,204,462,110,194,42,14,375,209,166,50,37,29,23,0
44488,134,60,74,19,13,10,7,453,247,206,58,53,45,20,0
44489,525,302,223,56,48,67,19,418,223,195,51,45,49,14,0
44490,522,302,220,61,49,75,19,307,132,175,48,53,26,10,0
44491,288,142,146,52,32,26,8,301,168,133,49,37,34,11,0
44492,395,219,176,47,41,50,18,300,148,152,45,43,40,8,0
44493,313,158,155,43,35,43,16,723,353,370,120,109,96,33,0
44494,574,284,290,64,50,65,20,171,94,77,24,28,30,11,0
44495,726,312,414,121,73,82,23,1001,417,584,186,147,96,47,0
44496,1284,511,773,227,166,169,107,445,264,181,35,35,34,14,0
44497,1098,519,579,182,159,79,42,374,191,183,40,52,40,16,0
44498,334,155,179,47,34,38,11,180,89,91,28,27,18,7,0
44499,290,156,134,44,29,39,9,418,246,172,52,39,57,10,0
44500,132,66,66,21,18,11,7,425,177,248,60,62,33,16,0
44501,71,39,32,7,11,6,4,341,170,171,41,66,27,10,0
44502,631,316,315,64,57,49,15,344,190,154,34,31,36,10,0
44503,169,64,105,23,37,11,3,309,164,145,35,47,30,11,0
44504,388,209,179,46,24,31,28,72,32,40,8,2,2,13,0
44505,288,142,146,52,32,26,8,773,389,384,119,91,79,26,0
44506,854,435,419,118,91,95,42,218,115,103,37,33,33,9,0
44507,167,70,97,32,20,15,7,300,148,152,45,43,40,8,0
44508,1498,731,767,220,175,148,68,180,90,90,31,19,20,8,0
44509,345,203,142,47,35,31,11,260,133,127,43,32,39,3,0
44510,288,104,184,80,30,39,6,410,197,213,67,43,56,18,0
44511,284,160,124,37,23,32,11,395,169,226,73,55,38,9,0
44512,509,246,263,84,71,56,22,220,107,113,36,35,28,9,0
44513,385,179,206,58,56,38,19,376,183,193,50,50,43,21,0
44514,209,75,134,53,48,20,9,1034,495,539,150,134,114,71,0
44515,411,171,240,61,81,30,15,744,385,359,105,96,57,31,0
44516,256,152,104,18,23,23,8,858,461,397,125,114,79,45,0
44517,330,151,179,68,36,56,9,107,77,30,7,2,9,5,0
44518,476,276,200,57,34,43,16,296,151,145,45,42,32,11,0
44519,575,295,280,89,68,54,18,222,122,100,39,32,24,9,0
44520,682,260,422,153,78,109,46,640,364,276,84,68,69,33,0
44521,1009,487,522,177,121,103,51,660,332,328,84,73,47,19,0
44522,626,300,326,91,82,68,26,274,142,132,33,34,18,14,0
44523,109,50,59,12,12,9,3,630,321,309,86,90,57,26,0
44524,963,477,486,134,143,123,38,131,55,76,28,9,14,12,0
44525,520,240,280,87,63,67,16,400,187,213,56,59,42,20,0
44526,1249,543,706,187,164,125,52,665,361,304,87,91,84,31,0
44527,325,152,173,43,47,28,17,286,152,134,38,38,32,11,0
44528,502,250,252,70,47,57,15,732,366,366,108,86,74,41,0
44529,630,231,399,150,83,84,50,773,389,384,119,91,79,26,0
44530,867,415,452,123,87,62,27,741,383,358,92,63,79,36,0
44531,548,250,298,85,64,56,21,180,108,72,22,22,15,5,0
44532,1007,353,654,277,147,70,26,137,72,65,27,13,15,8,0
44533,473,217,256,59,44,34,21,724,353,371,94,95,71,31,0
44534,392,221,171,53,30,25,8,583,321,262,73,67,45,25,0
44535,500,257,243,60,55,27,22,376,189,187,47,53,44,26,0
44536,240,166,74,32,12,8,15,579,285,294,78,72,64,32,0
44537,929,410,519,187,146,53,30,549,273,276,74,68,72,24,0
44538,314,178,136,42,32,30,17,72,33,39,8,2,3,12,0
44539,240,99,141,53,38,29,15,245,121,124,37,35,36,12,0
44540,824,391,433,106,90,88,32,727,362,365,123,107,63,23,0
44541,3859,2011,1848,535,391,422,207,975,400,575,160,162,62,31,0
44542,219,98,121,43,19,11,7,288,104,184,80,30,39,6,0
44543,801,331,470,151,139,99,55,1182,591,591,155,139,83,46,0
44544,1755,849,906,245,226,148,56,403,221,182,62,50,42,12,0
44545,584,297,287,89,80,65,17,415,205,210,77,52,55,17,0
44546,314,158,156,39,28,30,17,218,115,103,37,33,33,9,0
44547,494,233,261,87,57,46,18,1208,565,643,182,162,120,57,0
44548,708,344,364,106,98,66,33,620,324,296,81,68,66,31,0
44549,437,167,270,126,95,34,10,396,213,183,68,44,47,18,0
44550,316,157,159,45,38,22,19,204,80,124,29,51,10,5,0
44551,449,179,270,80,77,49,29,504,272,232,75,57,53,19,0
44552,346,174,172,36,43,21,9,301,168,133,49,37,34,11,0
44553,522,251,271,87,68,60,21,683,304,379,140,101,48,19,0
44554,373,164,209,51,45,44,21,303,138,165,47,46,35,18,0
44555,828,355,473,126,134,77,37,108,59,49,17,13,12,5,0
44556,496,210,286,112,55,71,14,376,183,193,50,50,43,21,0
44557,128,70,58,29,9,8,1,427,251,176,51,39,25,22,0
44558,261,126,135,41,36,24,11,222,127,95,23,28,22,7,0
44559,1054,497,557,190,168,107,45,247,128,119,34,14,16,14,0
44560,496,209,287,112,55,71,14,421,222,199,69,50,60,18,0
44561,196,107,89,20,31,17,4,180,95,85,22,21,17,8,0
44562,743,366,377,41,37,26,14,778,391,387,94,77,41,33,0
44563,462,258,204,59,41,56,15,843,391,452,139,104,91,35,0
44564,359,167,192,49,37,27,19,240,141,99,34,28,29,8,0
44565,496,274,222,57,43,75,22,773,389,384,119,91,79,26,0
44566,666,204,462,110,194,42,14,138,69,69,28,7,10,10,0
44567,285,148,137,31,42,42,16,153,80,73,26,18,19,4,0
44568,394,207,187,52,42,37,24,314,177,137,34,40,29,9,0
44569,347,154,193,48,51,25,11,622,344,278,80,77,68,36,0
44570,789,362,427,90,82,70,35,368,183,185,40,42,40,15,0
44571,983,449,534,95,77,55,36,175,82,93,33,26,17,5,0
44572,422,207,215,79,38,53,23,723,353,370,120,109,96,33,0
44573,71,39,32,7,11,6,4,277,138,139,40,39,20,14,0
44574,332,173,159,48,42,42,9,256,141,115,32,22,32,8,0
44575,326,148,178,55,42,31,12,277,144,133,42,30,41,8,0
44576,326,148,178,55,42,31,12,68,23,45,12,9,3,9,0
44577,425,220,205,60,55,45,18,421,222,199,69,50,60,18,0
44578,163,70,93,28,21,17,6,373,189,184,54,46,50,23,0
44579,117,58,59,17,17,12,2,261,127,134,36,27,36,4,0
44580,533,297,236,74,57,39,28,98,49,49,14,15,9,2,0
44581,464,237,227,64,66,33,12,673,313,360,102,101,46,17,0
44582,302,160,142,35,35,37,10,463,259,204,62,55,34,22,0
44583,446,195,251,56,53,31,15,430,212,218,88,43,40,20,0
44584,149,78,71,20,20,19,5,147,74,73,28,20,24,4,0
44585,728,358,370,118,100,55,29,386,207,179,43,48,44,19,0
44586,316,157,159,45,38,22,19,1395,627,768,172,263,141,59,0
44587,527,254,273,67,66,70,31,1314,693,621,174,155,140,58,0
44588,349,131,218,66,76,22,9,903,436,467,128,116,83,33,0
44589,107,56,51,18,16,12,5,207,86,121,34,39,11,13,0
44590,664,269,395,117,107,36,15,137,63,74,20,22,14,6,0
44591,164,81,83,37,8,14,10,257,126,131,61,24,22,8,0
44592,895,388,507,130,84,90,31,403,192,211,102,39,49,15,0
44593,228,105,123,34,43,20,10,557,281,276,80,59,43,21,0
44594,131,69,62,29,9,9,1,89,37,52,13,6,2,9,0
44595,747,360,387,125,92,69,32,261,127,134,36,27,36,4,0
44596,136,65,71,33,11,9,6,445,192,253,86,58,53,18,0
44597,437,230,207,41,55,27,13,261,162,99,24,21,14,10,0
44598,1395,595,800,223,206,113,61,137,85,52,15,11,11,2,0
44599,193,95,98,33,17,25,17,515,276,239,62,59,43,31,0
44600,361,177,184,59,51,24,15,562,273,289,76,92,45,24,0
44601,447,236,211,56,52,49,14,257,126,131,61,24,22,8,0
44602,785,325,460,114,123,61,28,1166,514,652,150,159,107,70,0
44603,401,236,165,53,38,34,9,131,55,76,28,9,14,12,0
44604,288,142,146,52,32,26,8,207,86,121,34,39,11,13,0
44605,346,174,172,36,43,21,9,480,255,225,67,64,50,22,0
44606,126,56,70,31,10,10,3,866,478,388,121,101,101,26,0
44607,760,322,438,81,130,57,19,344,190,154,34,31,36,10,0
44608,371,143,228,77,48,29,26,73,35,38,14,10,9,4,0
44609,193,90,103,44,9,19,13,207,86,121,34,39,11,13,0
44610,533,300,233,74,50,74,17,286,152,134,38,38,32,11,0
44611,873,366,507,127,125,75,21,661,325,336,81,75,65,28,0
44612,128,67,61,29,9,9,1,483,287,196,71,50,54,17,0
44613,278,110,168,58,49,29,5,405,181,224,71,57,31,12,0
44614,435,222,213,67,49,67,12,649,307,342,71,134,45,17,0
44615,407,230,177,44,39,34,19,104,46,58,15,17,9,5,0
44616,360,205,155,35,24,52,14,736,388,348,88,85,67,28,0
44617,911,441,470,123,108,60,21,400,187,213,56,59,42,20,0
44618,533,297,236,74,57,39,28,496,251,245,78,62,61,23,0
44619,3969,1703,2266,619,432,259,144,264,138,126,33,34,29,12,0
44620,365,148,217,86,37,51,28,766,386,380,101,81,78,31,0
44621,301,157,144,31,28,34,9,1239,659,580,169,148,131,54,0
44622,575,290,285,67,70,28,9,266,150,116,28,28,24,12,0
44623,130,70,60,30,9,8,1,198,110,88,27,27,24,4,0
44624,264,122,142,46,24,35,10,415,226,189,51,40,40,29,0
44625,414,206,208,56,68,35,19,647,324,323,101,80,76,43,0
44626,895,388,507,130,84,90,31,207,86,121,34,39,11,13,0
44627,469,221,248,49,60,55,21,133,61,72,21,19,13,4,0
44628,240,167,73,32,12,8,21,218,117,101,35,32,34,12,0
44629,283,172,111,39,31,29,8,751,394,357,107,96,73,35,0
44630,743,377,366,87,74,68,30,119,61,58,17,12,10,6,0
44631,1007,353,654,277,147,70,26,199,92,107,34,30,18,9,0
44632,291,131,160,49,35,32,15,261,127,134,36,27,36,4,0
44633,862,384,478,127,110,75,42,536,222,314,101,100,34,22,0
44634,673,317,356,101,85,76,49,459,260,199,56,42,47,21,0
44635,260,120,140,34,39,36,12,518,292,226,60,60,52,21,0
44636,862,384,478,127,110,75,42,260,131,129,42,31,40,9,0
44637,594,321,273,98,59,57,23,391,189,202,55,56,56,12,0
44638,270,147,123,34,17,39,21,325,172,153,44,34,27,14,0
44639,364,204,160,65,35,15,13,1265,689,576,169,177,128,60,0
44640,255,136,119,39,20,32,10,103,50,53,19,10,7,5,0
44641,219,100,119,40,29,21,3,261,162,99,24,21,14,10,0
44642,746,312,434,129,115,77,47,378,154,224,74,84,35,22,0
44643,207,93,114,20,33,19,10,1154,489,665,200,196,95,54,0
44644,1120,436,684,208,120,101,115,4646,2328,2318,674,639,475,170,0
44645,521,289,232,71,58,49,16,390,190,200,66,50,43,12,0
44646,211,92,119,33,44,11,7,701,380,321,94,84,96,34,0
44647,494,242,252,67,47,25,21,188,88,100,53,12,15,6,0
44648,328,195,133,36,23,35,9,301,168,133,49,37,34,11,0
44649,1342,640,702,187,163,123,57,485,244,241,80,55,59,20,0
44650,313,178,135,43,18,35,6,373,181,192,54,35,44,20,0
44651,550,304,246,60,64,77,16,246,125,121,38,36,30,11,0
44652,221,75,146,68,21,16,5,498,244,254,81,67,58,19,0
44653,331,144,187,57,46,33,19,380,211,169,47,37,33,21,0
44654,224,108,116,31,32,22,8,128,63,65,30,11,13,8,0
44655,298,141,157,51,33,21,22,385,188,197,57,42,36,16,0
44656,824,391,433,106,90,88,32,375,176,199,48,61,40,12,0
44657,450,227,223,53,36,48,12,160,60,100,23,40,19,11,0
44658,1099,491,608,163,141,107,62,396,223,173,57,37,44,19,0
44659,1501,679,822,251,196,174,67,325,172,153,44,34,27,14,0
44660,243,114,129,37,30,32,8,773,389,384,119,91,79,26,0
44661,563,255,308,91,111,42,30,1873,935,938,233,225,203,79,0
44662,428,248,180,44,39,28,9,792,398,394,109,96,90,39,0
44663,192,91,101,28,21,18,8,163,79,84,22,24,13,5,0
44664,410,200,210,60,54,46,19,487,252,235,79,58,55,26,0
44665,349,167,182,54,38,30,28,432,244,188,51,51,27,14,0
44666,373,164,209,51,45,44,21,296,151,145,45,42,32,11,0
44667,364,192,172,49,36,39,14,585,277,308,92,73,61,32,0
44668,126,56,70,31,10,10,3,204,96,108,31,37,20,5,0
44669,315,170,145,48,56,22,11,501,249,252,77,70,55,22,0
44670,243,70,173,54,65,8,6,258,129,129,45,24,31,10,0
44671,575,295,280,89,68,54,18,258,129,129,45,24,31,10,0
44672,648,376,272,70,60,73,24,541,279,262,79,82,31,32,0
44673,313,148,165,45,33,36,11,354,183,171,54,43,49,8,0
44674,282,163,119,40,23,25,17,148,69,79,26,18,16,3,0
44675,2663,1073,1590,548,499,192,64,1314,693,621,174,155,140,58,0
44676,517,245,272,92,77,46,24,257,126,131,61,24,22,8,0
44677,341,154,187,34,36,11,11,780,337,443,112,116,77,28,0
44678,1023,449,574,141,174,76,43,111,60,51,17,23,10,7,0
44679,441,216,225,57,66,57,19,663,354,309,91,84,79,31,0
44680,571,298,273,81,72,57,25,228,130,98,35,29,30,10,0
44681,126,56,70,31,10,10,3,262,129,133,40,41,31,10,0
44682,622,354,268,89,60,64,18,673,313,360,102,101,46,17,0
44683,237,127,110,34,30,16,9,103,44,59,16,17,9,5,0
44684,127,48,79,27,20,6,5,434,213,221,77,62,53,12,0
44685,485,246,239,74,48,47,22,172,88,84,24,31,20,12,0
44686,1360,644,716,213,194,136,62,517,295,222,69,62,40,28,0
44687,2624,999,1625,415,495,109,84,594,312,282,72,67,73,31,0
44688,525,302,223,56,48,67,19,218,117,101,35,32,34,12,0
44689,730,298,432,128,69,86,26,231,126,105,37,26,29,6,0
44690,557,211,346,129,125,48,19,1755,905,850,214,196,183,79,0
44691,458,226,232,77,59,61,14,449,252,197,61,52,36,18,0
44692,570,238,332,112,95,39,23,297,175,122,46,30,31,6,0
44693,128,69,59,29,9,8,1,72,34,38,8,2,3,12,0
44694,255,110,145,34,32,23,17,396,197,199,75,49,49,16,0
44695,412,208,204,54,47,42,17,1062,522,540,151,147,105,66,0
44696,1014,488,526,178,137,94,39,761,351,410,117,73,103,45,0
44697,282,135,147,27,37,30,19,449,252,197,61,52,36,18,0
44698,802,375,427,133,103,81,41,160,76,84,19,24,8,5,0
44699,443,226,217,67,34,53,10,134,55,79,22,24,16,6,0
44700,496,274,222,57,43,75,22,663,354,309,91,84,79,31,0
44701,350,178,172,49,62,29,16,73,35,38,14,10,9,4,0
44702,503,260,243,46,56,33,16,194,94,100,33,28,14,7,0
44703,127,54,73,31,10,11,3,87,51,35,15,9,9,4,0
44704,510,269,241,66,67,71,26,1265,689,576,169,177,128,60,0
44705,562,214,348,120,86,69,42,439,227,212,60,55,58,8,0
44706,343,189,154,44,24,39,12,445,264,181,35,35,34,14,0
44707,271,110,161,33,27,11,8,689,343,346,105,102,81,35,0
44708,252,121,131,42,34,12,16,153,65,88,28,21,20,8,0
44709,391,203,188,49,34,36,9,360,180,180,57,48,39,12,0
44710,763,354,409,101,90,63,26,286,160,126,37,27,23,10,0
44711,1709,650,1059,338,286,185,46,349,200,149,41,39,30,20,0
44712,443,226,217,67,34,53,10,283,160,123,25,20,37,9,0
44713,2285,1219,1066,207,180,178,106,287,151,136,51,42,36,7,0
44714,1835,904,931,192,144,135,63,370,173,197,65,57,42,10,0
44715,389,176,213,81,59,24,7,172,79,93,34,27,23,10,0
44716,758,378,380,89,64,37,31,445,202,243,70,73,51,15,0
44717,338,164,174,45,32,37,13,496,285,211,62,54,46,22,0
44718,338,164,174,45,32,37,13,2346,1231,1115,316,292,266,105,0
44719,560,279,281,113,64,58,15,520,272,248,60,65,58,22,0
44720,350,212,138,32,26,40,13,346,178,168,58,41,33,12,0
44721,2488,1085,1403,346,253,162,76,368,204,164,43,35,30,24,0
44722,256,152,104,18,23,23,8,277,138,139,40,39,20,14,0
44723,1124,442,682,148,189,72,43,367,199,168,62,44,34,8,0
44724,443,226,217,67,34,53,10,736,388,348,88,85,67,28,0
44725,434,216,218,72,58,40,20,374,191,183,40,52,40,16,0
44726,520,231,289,89,59,58,26,761,351,410,117,73,103,45,0
44727,130,70,60,30,9,8,1,376,189,187,47,53,44,26,0
44728,470,163,307,99,68,73,30,766,386,380,101,81,78,31,0
44729,465,305,160,40,47,34,9,404,190,214,55,55,35,27,0
44730,520,231,289,89,59,58,26,127,66,61,13,14,19,8,0
44731,1555,702,853,250,199,139,31,541,279,262,79,82,31,32,0
44732,1505,680,825,202,204,73,32,483,258,225,70,53,54,20,0
44733,325,186,139,49,36,20,5,328,195,133,39,40,27,13,0
44734,270,131,139,47,37,41,11,902,499,403,118,117,92,35,0
44735,476,254,222,58,33,46,23,165,87,78,24,19,22,9,0
44736,288,142,146,52,32,26,8,328,195,133,39,40,27,13,0
44737,639,368,271,72,51,38,38,127,54,73,11,33,15,6,0
44738,380,185,195,68,54,32,16,354,183,171,54,43,49,8,0
44739,204,93,111,35,35,16,11,492,278,214,65,58,32,11,0
44740,404,197,207,60,48,47,20,149,77,72,37,10,20,5,0
44741,507,242,265,53,44,31,22,437,224,213,40,29,42,25,0
44742,319,222,97,36,23,28,8,223,113,110,31,33,22,12,0
44743,887,439,448,137,99,91,38,459,260,199,56,42,47,21,0
44744,94,45,49,11,20,10,4,105,50,55,14,13,11,7,0
44745,682,260,422,98,83,42,31,397,223,174,50,39,29,17,0
44746,501,230,271,63,90,50,18,898,469,429,125,125,134,35,0
44747,520,240,280,87,63,67,16,1061,543,518,146,123,109,67,0
44748,484,194,290,70,93,47,16,736,388,348,88,85,67,28,0
44749,793,355,438,134,117,77,43,1004,457,547,150,150,74,52,0
44750,206,100,106,34,26,11,7,621,273,348,104,102,48,19,0
44751,130,70,60,30,9,8,1,178,99,79,31,19,26,8,0
44752,297,161,136,36,35,24,9,139,68,71,14,26,14,9,0
44753,155,85,70,17,16,4,8,547,295,252,81,65,57,23,0
44754,349,167,182,54,38,30,28,277,145,132,41,32,22,10,0
44755,161,94,67,23,13,8,10,88,50,38,13,8,16,4,0
44756,127,54,73,31,10,11,3,1698,875,823,222,219,173,64,0
44757,1711,865,846,204,176,105,60,104,46,58,15,17,9,5,0
44758,732,355,377,108,109,79,27,660,333,327,102,95,69,31,0
44759,375,201,174,52,56,39,15,429,187,242,79,72,28,19,0
44760,71,28,43,15,9,5,2,843,391,452,139,104,91,35,0
44761,461,207,254,82,66,55,33,399,190,209,61,41,39,18,0
44762,743,377,366,87,74,68,30,736,388,348,88,85,67,28,0
44763,146,73,73,18,24,17,9,300,148,152,45,43,40,8,0
44764,626,300,326,91,82,68,26,203,98,105,34,29,19,10,0
44765,135,64,71,31,11,8,4,483,215,268,66,70,30,16,0
44766,221,114,107,65,7,2,1,953,489,464,126,104,111,44,0
44767,117,58,59,17,17,12,2,900,441,459,125,127,110,32,0
44768,493,208,285,75,77,70,40,418,246,172,52,39,57,10,0
44769,413,236,177,41,25,35,19,188,105,83,25,17,24,7,0
44770,1759,838,921,269,212,191,92,239,113,126,36,49,20,8,0
44771,927,457,470,130,99,118,42,175,91,84,19,21,21,10,0
44772,282,163,119,40,23,25,17,104,46,58,15,17,9,5,0
44773,734,339,395,135,89,78,36,464,236,228,64,56,53,28,0
44774,519,259,260,86,78,59,22,445,202,243,70,73,51,15,0
44775,427,191,236,67,60,41,34,792,398,394,109,96,90,39,0
44776,533,300,233,74,50,74,17,953,489,464,126,104,111,44,0
44777,911,441,470,123,108,60,21,926,425,501,159,147,77,35,0
44778,291,120,171,63,39,26,6,1698,875,823,222,219,173,64,0
44779,2285,1219,1066,207,180,178,106,225,114,111,32,29,26,6,0
44780,598,300,298,68,77,59,21,134,55,79,22,24,16,6,0
44781,516,210,306,113,53,81,33,514,248,266,86,82,52,22,0
44782,149,78,71,20,20,19,5,467,240,227,65,65,51,23,0
44783,217,98,119,38,35,18,9,415,226,189,51,40,40,29,0
44784,446,174,272,84,61,57,23,298,129,169,51,40,29,8,0
44785,279,129,150,43,34,17,13,127,54,73,11,33,15,6,0
44786,192,91,101,28,21,18,8,515,276,239,62,59,43,31,0
44787,490,224,266,80,70,39,32,403,225,178,56,38,33,25,0
44788,1912,880,1032,331,334,180,84,330,166,164,55,51,36,16,0
44789,67,40,27,10,8,7,6,329,196,133,41,36,31,15,0
44790,426,196,230,76,65,54,20,225,114,111,32,29,26,6,0
44791,490,224,266,80,70,39,32,434,213,221,77,62,53,12,0
44792,423,247,176,58,55,29,20,317,161,156,50,36,47,12,0
44793,291,120,171,63,39,26,6,507,270,237,89,59,57,22,0
44794,2799,1324,1475,369,371,215,124,761,351,410,117,73,103,45,0
44795,567,266,301,139,46,76,37,72,33,39,8,2,3,12,0
44796,795,384,411,133,109,85,38,231,126,105,37,26,29,6,0
44797,743,377,366,87,74,68,30,127,64,63,26,8,12,8,0
44798,207,89,118,56,8,4,3,611,314,297,79,75,78,22,0
44799,368,154,214,80,52,41,16,134,72,62,14,28,8,4,0
44800,494,233,261,87,57,46,18,89,51,38,15,15,5,4,0
44801,222,110,112,43,30,14,6,437,224,213,40,29,42,25,0
44802,359,204,155,39,36,34,13,654,295,359,99,88,71,25,0
44803,443,206,237,76,68,52,28,720,361,359,98,98,70,37,0
44804,128,69,59,29,9,8,1,201,93,108,34,39,21,6,0
44805,203,97,106,30,22,18,10,171,94,77,24,28,30,11,0
44806,329,165,164,61,44,29,17,417,232,185,58,50,29,21,0
44807,258,144,114,33,22,19,9,302,150,152,56,40,52,15,0
44808,443,250,193,52,23,49,13,222,125,97,34,27,27,7,0
44809,794,322,472,122,108,79,34,397,234,163,44,38,23,21,0
44810,1174,594,580,175,155,126,66,209,119,90,28,24,27,9,0
44811,215,117,98,28,19,15,8,892,475,417,130,108,68,38,0
44812,1360,644,716,213,194,136,62,103,59,44,25,2,13,6,0
44813,531,259,272,75,81,39,13,285,146,139,41,41,48,13,0
44814,444,250,194,58,21,60,23,751,394,357,107,96,73,35,0
44815,374,187,187,51,52,40,27,518,292,226,60,60,52,21,0
44816,366,190,176,39,62,55,14,341,170,171,41,66,27,10,0
44817,345,208,137,44,27,33,8,1061,543,518,146,123,109,67,0
44818,332,170,162,44,38,39,10,91,42,49,21,9,8,3,0
44819,500,297,203,66,33,53,15,2382,1162,1220,237,220,140,49,0
44820,219,100,119,40,29,21,3,132,61,71,22,21,15,3,0
44821,441,216,225,57,66,57,19,699,334,365,108,80,70,20,0
44822,1163,417,746,209,145,87,28,1241,619,622,183,169,155,59,0
44823,410,211,199,55,42,34,27,295,160,135,42,37,46,16,0
44824,1096,563,533,158,136,120,53,234,116,118,34,35,23,9,0
44825,580,281,299,95,60,74,29,445,202,243,70,73,51,15,0
44826,509,246,263,84,71,56,22,978,536,442,132,107,67,32,0
44827,282,105,177,77,28,39,6,160,76,84,19,24,8,5,0
44828,507,314,193,49,45,59,25,1323,690,633,132,178,112,61,0
44829,288,142,146,52,32,26,8,708,328,380,113,100,82,34,0
44830,443,212,231,74,24,60,24,975,400,575,160,162,62,31,0
44831,204,93,111,35,35,16,11,242,124,118,39,32,28,22,0
44832,406,207,199,56,46,68,19,1062,522,540,151,147,105,66,0
44833,489,253,236,73,36,62,17,1922,923,999,267,275,215,90,0
44834,279,106,173,48,35,41,39,381,187,194,37,49,36,17,0
44835,2136,1063,1073,317,308,223,90,1182,591,591,155,139,83,46,0
44836,2220,1085,1135,312,304,202,91,346,178,168,58,41,33,12,0
44837,431,199,232,59,54,40,17,204,96,108,31,37,20,5,0
44838,528,273,255,67,53,29,20,2346,1231,1115,316,292,266,105,0
44839,364,168,196,64,61,27,6,483,215,268,66,70,30,16,0
44840,2525,1232,1293,398,317,186,61,329,194,135,45,32,33,9,0
44841,126,56,70,31,10,10,3,479,215,264,67,80,46,28,0
44842,626,300,326,91,82,68,26,2542,1245,1297,285,287,170,84,0
44843,311,154,157,47,29,34,13,316,159,157,38,48,30,11,0
44844,361,167,194,55,35,41,11,663,360,303,87,82,80,35,0
44845,1835,904,931,192,144,135,63,362,156,206,74,42,36,22,0
44846,1163,417,746,209,145,87,28,103,59,44,25,2,13,6,0
44847,1249,543,706,187,164,125,52,720,361,359,98,98,70,37,0
44848,636,288,348,94,77,65,30,2547,1280,1267,331,335,293,118,0
44849,443,250,193,52,23,49,13,516,245,271,82,84,70,26,0
44850,782,372,410,127,111,89,36,137,78,59,22,16,17,4,0
44851,949,466,483,125,126,101,50,346,178,168,58,41,33,12,0
44852,2062,706,1356,414,368,158,63,903,436,467,128,116,83,33,0
44853,371,209,162,46,17,36,19,354,183,171,54,43,49,8,0
44854,603,311,292,102,71,66,23,322,180,142,45,38,28,7,0
44855,3969,1703,2266,619,432,259,144,723,363,360,107,106,52,14,0
44856,952,547,405,95,90,127,35,601,279,322,81,65,27,12,0
44857,500,245,255,66,57,52,27,54,26,28,11,4,3,3,0
44858,604,239,365,124,63,84,37,501,257,244,75,57,48,29,0
44859,1447,698,749,214,180,116,46,579,285,294,78,72,64,32,0
44860,130,71,59,30,9,8,2,449,252,197,61,52,36,18,0
44861,184,88,96,15,40,17,8,94,45,49,11,20,10,4,0
44862,121,69,52,15,18,14,8,145,77,68,26,7,15,8,0
44863,557,250,307,70,47,51,22,265,134,131,48,34,33,15,0
44864,243,70,173,54,65,8,6,514,248,266,86,82,52,22,0
44865,243,70,173,54,65,8,6,392,214,178,48,40,53,22,0
44866,648,376,272,70,60,73,24,671,321,350,95,87,75,34,0
44867,915,336,579,185,199,56,29,91,44,47,9,12,4,7,0
44868,548,310,238,72,62,54,13,689,343,346,105,102,81,35,0
44869,479,228,251,71,57,60,14,270,162,108,26,26,16,11,0
44870,220,113,107,37,24,16,7,276,149,127,34,31,32,10,0
44871,1284,511,773,227,166,169,107,732,402,330,81,86,87,33,0
44872,528,188,340,130,58,77,41,715,345,370,110,97,64,25,0
44873,2442,1193,1249,278,183,170,145,375,209,166,50,37,29,23,0
44874,490,198,292,65,81,39,27,231,126,105,37,26,29,6,0
44875,1463,521,942,252,204,105,52,535,311,224,66,52,49,24,0
44876,949,467,482,126,127,102,51,229,120,109,31,30,22,9,0
44877,505,226,279,68,51,30,15,1262,653,609,169,165,152,50,0
44878,130,70,60,30,9,8,1,374,202,172,50,39,31,24,0
44879,421,237,184,47,54,45,10,230,113,117,31,40,28,10,0
44880,517,245,272,92,77,46,24,234,129,105,31,22,19,17,0
44881,1616,735,881,285,248,153,72,756,348,408,101,103,60,40,0
44882,728,358,370,118,100,55,29,611,314,297,79,75,78,22,0
44883,126,58,68,31,10,10,3,354,188,166,46,40,34,10,0
44884,291,120,171,63,39,26,6,306,157,149,52,35,39,16,0
44885,163,70,93,28,21,17,6,279,142,137,43,39,28,7,0
44886,406,207,199,56,46,68,19,227,130,97,32,25,22,12,0
44887,401,204,197,49,33,29,17,744,385,359,105,96,57,31,0
44888,143,81,62,28,9,8,1,929,459,470,140,120,94,45,0
44889,267,146,121,40,24,25,7,452,252,200,55,49,61,16,0
44890,452,202,250,83,60,56,19,89,38,51,14,6,3,9,0
44891,730,298,432,128,69,86,26,518,292,226,60,60,52,21,0
44892,545,221,324,101,72,55,30,594,312,282,72,67,73,31,0
44893,580,281,299,95,60,74,29,425,177,248,60,62,33,16,0
44894,589,282,307,68,67,70,23,341,170,171,41,66,27,10,0
44895,496,274,222,57,43,75,22,163,79,84,22,24,13,5,0
44896,311,154,157,47,29,34,13,205,94,111,48,31,15,6,0
44897,399,220,179,48,37,68,18,91,42,49,21,9,8,3,0
44898,305,124,181,27,25,31,21,1279,669,610,164,162,104,55,0
44899,624,222,402,92,81,39,15,597,269,328,102,84,69,24,0
44900,1447,698,749,214,180,116,46,384,204,180,53,47,49,17,0
44901,461,207,254,82,66,55,33,375,209,166,50,37,29,23,0
44902,431,199,232,59,54,40,17,277,145,132,41,32,22,10,0
44903,629,338,291,92,57,64,22,647,324,323,101,80,76,43,0
44904,346,168,178,36,43,20,9,1061,543,518,146,123,109,67,0
44905,364,172,192,55,57,32,15,133,61,72,21,19,13,4,0
44906,368,201,167,61,38,38,12,230,125,105,29,40,20,6,0
44907,525,254,271,60,76,46,13,173,90,83,21,36,12,15,0
44908,2649,1431,1218,377,299,266,102,462,229,233,63,49,42,18,0
44909,228,82,146,45,37,18,8,349,200,149,41,39,30,20,0
44910,221,80,141,48,37,14,10,665,361,304,87,91,84,31,0
44911,1186,495,691,182,208,88,32,192,91,101,29,28,17,7,0
44912,881,492,389,87,97,59,51,497,257,240,71,63,62,16,0
44913,364,172,192,55,57,32,15,744,385,359,105,96,57,31,0
44914,172,98,74,20,21,22,8,256,141,115,32,22,32,8,0
44915,381,146,235,74,48,47,34,866,478,388,121,101,101,26,0
44916,326,176,150,35,22,29,11,410,197,213,67,43,56,18,0
44917,1327,520,807,241,174,141,60,902,499,403,118,117,92,35,0
44918,432,233,199,52,28,47,18,240,141,99,34,28,29,8,0
44919,1023,449,574,141,174,76,43,335,170,165,52,36,47,11,0
44920,275,125,150,37,48,27,7,72,33,39,8,2,3,12,0
44921,246,123,123,40,31,27,7,179,101,78,25,15,13,13,0
44922,443,226,217,67,34,53,10,103,44,59,16,17,9,5,0
44923,794,322,472,122,108,79,34,135,65,70,21,25,15,9,0
44924,315,111,204,82,66,46,11,102,51,51,12,15,12,3,0
44925,119,67,52,15,15,7,7,198,110,88,27,27,24,4,0
44926,304,149,155,46,32,39,14,395,198,197,55,55,36,10,0
44927,2624,999,1625,415,495,109,84,1182,591,591,155,139,83,46,0
44928,616,323,293,98,71,31,15,250,119,131,58,26,29,7,0
44929,315,170,145,48,56,22,11,392,186,206,62,56,29,15,0
44930,524,262,262,62,72,39,49,225,114,111,32,29,26,6,0
44931,258,126,132,38,22,29,8,662,312,350,103,104,59,20,0
44932,437,212,225,66,44,44,11,251,143,108,47,25,29,11,0
44933,793,355,438,134,117,77,43,354,183,171,54,43,49,8,0
44934,401,236,165,53,38,34,9,218,114,104,32,31,33,11,0
44935,626,308,318,105,89,77,25,204,96,108,31,37,20,5,0
44936,521,249,272,53,36,50,18,325,159,166,59,46,30,12,0
44937,315,174,141,46,38,47,16,892,475,417,130,108,68,38,0
44938,319,222,97,36,23,28,8,73,35,38,14,10,9,4,0
44939,203,80,123,40,37,20,3,1034,495,539,150,134,114,71,0
44940,439,183,256,60,64,36,14,496,251,245,78,62,61,23,0
44941,410,208,202,59,58,43,26,349,200,149,41,39,30,20,0
44942,525,302,223,56,48,67,19,250,119,131,58,26,29,7,0
44943,428,248,180,44,39,28,9,452,254,198,72,57,38,18,0
44944,589,282,307,68,67,70,23,609,335,274,79,57,45,22,0
44945,485,237,248,83,35,52,24,724,353,371,94,95,71,31,0
44946,270,158,112,35,20,23,7,336,200,136,34,29,25,24,0
44947,333,171,162,41,44,48,23,758,319,439,101,123,78,25,0
44948,594,279,315,93,68,68,26,354,188,166,46,40,34,10,0
44949,480,267,213,49,44,70,21,138,69,69,28,7,10,10,0
44950,292,102,190,71,27,51,21,501,257,244,75,57,48,29,0
44951,380,185,195,68,54,32,16,277,138,139,40,39,20,14,0
44952,270,166,104,30,26,28,14,496,285,211,62,54,46,22,0
44953,180,57,123,39,22,10,8,370,190,180,60,52,37,13,0
44954,76,30,46,7,15,1,5,866,478,388,121,101,101,26,0
44955,861,393,468,150,101,69,35,974,457,517,133,117,69,26,0
44956,648,262,386,113,108,78,29,414,203,211,58,56,48,14,0
44957,648,262,386,113,108,78,29,257,139,118,64,17,24,7,0
44958,949,467,482,126,127,102,51,485,244,241,80,55,59,20,0
44959,1004,464,540,143,104,78,55,966,478,488,108,144,74,43,0
44960,1143,574,569,176,151,123,59,526,266,260,76,75,53,22,0
44961,469,253,216,49,51,48,18,91,44,47,9,12,4,7,0
44962,1542,682,860,290,158,120,47,1696,771,925,257,225,149,63,0
44963,502,250,252,70,47,57,15,1208,565,643,182,162,120,57,0
44964,607,305,302,92,89,74,23,975,475,500,139,140,119,28,0
44965,246,111,135,64,47,27,3,319,185,134,42,31,22,13,0
44966,437,212,225,66,44,44,11,300,148,152,45,43,40,8,0
44967,311,154,157,47,29,34,13,137,78,59,22,16,17,4,0
44968,595,208,387,157,60,91,48,105,51,54,13,17,12,8,0
44969,562,214,348,120,86,69,42,975,400,575,160,162,62,31,0
44970,681,367,314,83,74,78,31,661,325,336,81,75,65,28,0
44971,389,176,213,81,59,24,7,178,99,79,31,19,26,8,0
44972,119,59,60,29,10,6,4,277,145,132,41,32,22,10,0
44973,1276,607,669,192,178,136,63,87,51,35,15,9,9,4,0
44974,130,71,59,30,9,8,1,593,289,304,85,69,48,19,0
44975,815,356,459,128,125,82,26,693,360,333,100,88,62,26,0
44976,258,130,128,44,37,29,10,153,80,73,26,18,19,4,0
44977,406,207,199,56,46,68,19,325,159,166,59,46,30,12,0
44978,396,150,246,103,64,38,3,283,142,141,41,33,26,18,0
44979,407,207,200,53,36,38,8,166,88,78,23,18,13,7,0
44980,130,71,59,30,9,8,2,663,360,303,87,82,80,35,0
44981,129,70,59,29,9,7,2,201,104,97,36,32,24,7,0
44982,666,204,462,110,194,42,14,430,212,218,88,43,40,20,0
44983,677,361,316,81,61,42,22,528,276,252,86,78,49,17,0
44984,188,84,104,35,36,18,9,218,115,103,37,33,33,9,0
44985,747,360,387,125,92,69,32,862,409,453,149,125,86,29,0
44986,879,457,422,93,98,143,32,276,149,127,34,31,32,10,0
44987,710,352,358,104,86,84,41,296,151,145,45,42,32,11,0
44988,401,204,197,49,33,29,17,277,163,114,33,24,21,16,0
44989,507,242,265,53,44,31,22,866,478,388,121,101,101,26,0
44990,789,362,427,90,82,70,35,223,113,110,31,33,22,12,0
44991,125,57,68,31,10,10,3,593,289,304,85,69,48,19,0
44992,764,277,487,158,162,64,31,218,117,101,35,32,34,12,0
44993,2279,996,1283,375,328,158,60,704,355,349,113,94,71,24,0
44994,391,204,187,47,48,38,18,403,192,211,102,39,49,15,0
44995,318,164,154,52,43,34,10,106,46,60,27,18,12,3,0
44996,535,315,220,57,55,71,19,496,251,245,78,62,61,23,0
44997,215,104,111,61,7,2,1,627,323,304,81,90,53,27,0
44998,288,140,148,59,33,27,12,73,35,38,14,10,9,4,0
44999,184,93,91,26,25,14,11,904,436,468,143,118,108,32,0
45000,727,426,301,79,71,64,32,588,286,302,78,99,53,25,0
45001,514,226,288,71,66,63,32,257,126,131,61,24,22,8,0
45002,196,107,89,20,31,17,4,462,229,233,63,49,42,18,0
45003,420,202,218,67,43,51,15,334,181,153,41,40,25,15,0
45004,326,176,150,35,22,29,11,136,65,71,26,11,7,5,0
45005,340,169,171,40,39,36,22,702,358,344,113,87,81,30,0
45006,1580,742,838,208,146,144,71,467,231,236,71,65,58,18,0
45007,533,300,233,74,50,74,17,380,211,169,47,37,33,21,0
45008,475,235,240,77,58,43,22,452,254,198,72,57,38,18,0
45009,126,56,70,31,10,10,3,188,101,87,20,18,20,14,0
45010,535,315,220,57,55,71,19,1698,875,823,222,219,173,64,0
45011,210,101,109,33,33,19,9,390,223,167,58,36,45,18,0
45012,714,260,454,140,97,120,54,402,186,216,64,47,38,20,0
45013,251,139,112,41,18,27,11,194,109,85,23,24,21,9,0
45014,649,304,345,99,80,67,40,244,143,101,31,29,26,8,0
45015,126,56,70,31,10,10,3,132,67,65,24,21,8,10,0
45016,255,110,145,34,32,23,17,457,242,215,39,46,53,10,0
45017,416,222,194,58,38,38,20,101,59,42,11,17,10,1,0
45018,1004,498,506,94,59,46,33,395,169,226,73,55,38,9,0
45019,303,161,142,38,31,42,17,322,180,142,45,38,28,7,0
45020,1417,598,819,223,188,135,58,360,185,175,51,43,36,16,0
45021,126,57,69,31,10,10,3,322,180,142,45,38,28,7,0
45022,207,128,79,26,17,19,9,125,66,59,24,16,11,5,0
45023,325,181,144,46,31,48,9,953,489,464,126,104,111,44,0
45024,529,290,239,54,63,85,15,103,59,44,25,2,13,6,0
45025,286,111,175,51,47,21,12,277,138,139,40,39,20,14,0
45026,331,177,154,54,38,27,11,396,223,173,57,37,44,19,0
45027,1121,458,663,158,210,76,47,406,202,204,54,51,63,21,0
45028,1043,479,564,200,131,123,62,338,169,169,53,44,39,21,0
45029,416,207,209,63,47,56,15,124,69,55,14,7,9,4,0
45030,505,201,304,116,58,75,31,212,127,85,28,21,26,6,0
45031,489,253,236,73,36,62,17,773,389,384,119,91,79,26,0
45032,667,366,301,96,55,84,25,277,152,125,31,35,22,19,0
45033,260,136,124,24,41,19,4,334,182,152,45,41,27,13,0
45034,743,366,377,41,37,26,14,396,223,173,57,37,44,19,0
45035,410,209,201,72,30,48,22,584,249,335,80,96,22,13,0
45036,426,196,230,76,65,54,20,399,190,209,61,41,39,18,0
45037,664,269,395,117,107,36,15,205,106,99,28,26,23,3,0
45038,207,89,118,56,8,4,3,261,162,99,24,21,14,10,0
45039,782,372,410,127,111,89,36,430,212,218,88,43,40,20,0
45040,367,167,200,63,42,60,17,1922,923,999,267,275,215,90,0
45041,1009,478,531,166,126,96,42,103,59,44,25,2,13,6,0
45042,234,108,126,42,40,15,9,470,205,265,71,80,33,11,0
45043,375,167,208,55,83,44,9,607,293,314,98,71,62,32,0
45044,766,336,430,133,97,79,21,72,33,39,8,2,3,12,0
45045,322,164,158,46,44,29,7,536,267,269,60,70,41,22,0
45046,431,199,232,59,54,40,17,601,279,322,81,65,27,12,0
45047,306,172,134,35,31,37,18,381,186,195,69,55,46,15,0
45048,4640,2231,2409,660,549,437,245,723,363,360,107,106,52,14,0
45049,413,236,177,41,25,35,19,180,108,72,22,22,15,5,0
45050,343,189,154,44,24,39,12,133,61,72,21,19,13,4,0
45051,288,104,184,80,30,39,6,145,77,68,26,7,15,8,0
45052,380,187,193,38,51,30,18,373,213,160,44,33,26,17,0
45053,181,75,106,35,26,11,9,228,130,98,35,29,30,10,0
45054,420,248,172,64,30,43,17,261,148,113,31,28,14,10,0
45055,2799,1324,1475,369,371,215,124,189,95,94,25,33,16,8,0
45056,270,158,112,35,20,23,7,201,93,108,34,39,21,6,0
45057,457,228,229,64,36,52,21,384,212,172,44,43,34,14,0
45058,130,70,60,30,9,8,1,309,159,150,47,43,43,13,0
45059,170,82,88,32,23,22,8,536,267,269,60,70,41,22,0
45060,586,298,288,80,75,64,37,290,142,148,41,37,43,11,0
45061,180,57,123,39,22,10,8,218,114,104,32,31,33,11,0
45062,2696,1169,1527,432,347,193,146,403,192,211,102,39,49,15,0
45063,1709,650,1059,338,286,185,46,332,180,152,44,36,27,13,0
45064,473,212,261,72,64,45,28,892,475,417,130,108,68,38,0
45065,1052,492,560,184,163,103,44,620,324,296,81,68,66,31,0
45066,365,210,155,46,30,24,12,164,79,85,28,28,16,7,0
45067,234,108,126,42,40,15,9,180,90,90,31,19,20,8,0
45068,329,171,158,49,41,31,10,54,26,28,11,4,3,3,0
45069,342,185,157,42,27,31,14,296,151,145,45,42,32,11,0
45070,213,114,99,62,7,2,1,397,223,174,50,39,29,17,0
45071,616,323,293,98,71,31,15,91,42,49,21,9,8,3,0
45072,533,300,233,74,50,74,17,422,202,220,80,52,57,18,0
45073,505,226,279,68,51,30,15,4646,2328,2318,674,639,475,170,0
45074,315,170,145,48,56,22,11,352,207,145,40,33,25,21,0
45075,414,206,208,56,68,35,19,601,279,322,81,65,27,12,0
45076,425,198,227,57,69,59,13,350,196,154,52,37,21,14,0
45077,238,91,147,68,19,22,7,68,36,32,11,8,9,2,0
45078,406,207,199,56,46,68,19,201,104,97,36,32,24,7,0
45079,498,274,224,58,59,50,18,406,223,183,61,53,46,17,0
45080,824,391,433,106,90,88,32,366,204,162,47,41,31,23,0
45081,127,48,79,27,20,6,5,763,418,345,113,84,59,32,0
45082,329,171,158,49,41,31,10,286,160,126,37,27,23,10,0
45083,808,366,442,130,133,66,31,160,60,100,23,40,19,11,0
45084,795,384,411,133,109,85,38,384,212,172,44,43,34,14,0
45085,303,161,142,38,31,42,17,1352,602,750,166,185,81,70,0
45086,273,126,147,54,49,25,18,536,251,285,75,79,60,23,0
45087,953,421,532,131,131,70,37,277,138,139,40,39,20,14,0
45088,410,188,222,53,52,31,14,225,129,96,32,33,20,8,0
45089,393,223,170,44,36,32,14,341,170,171,41,66,27,10,0
45090,193,107,86,13,20,13,6,352,207,145,40,33,25,21,0
45091,653,379,274,89,56,86,13,68,36,32,11,8,9,2,0
45092,335,148,187,52,26,51,12,524,300,223,70,54,51,25,0
45093,496,274,222,57,43,75,22,276,149,127,34,31,32,10,0
45094,384,198,186,58,48,37,12,1338,720,618,179,145,141,85,0
45095,500,257,243,60,55,27,22,297,164,133,45,39,40,9,0
45096,396,150,246,103,64,38,3,297,175,122,46,30,31,6,0
45097,401,236,165,53,38,34,9,334,182,152,45,41,27,13,0
45098,311,154,157,47,29,34,13,376,183,193,50,50,43,21,0
45099,188,84,104,35,36,18,9,196,105,91,40,13,19,10,0
45100,395,195,200,41,55,23,10,497,227,270,70,63,66,30,0
45101,232,134,98,28,20,20,5,334,181,153,41,40,25,15,0
45102,341,175,166,48,43,35,18,138,69,69,28,7,10,10,0
45103,908,324,584,181,162,81,29,245,121,124,37,35,36,12,0
45104,282,135,147,27,37,30,19,325,172,153,44,34,27,14,0
45105,4128,2104,2024,581,505,453,205,337,170,167,59,33,47,17,0
45106,1068,434,634,173,160,61,29,2724,1157,1567,269,518,239,77,0
45107,221,80,141,48,37,14,10,286,160,126,37,27,23,10,0
45108,435,187,248,62,51,51,21,142,65,77,30,17,22,9,0
45109,658,349,309,77,70,73,35,562,273,289,76,92,45,24,0
45110,900,434,466,134,97,86,36,277,152,125,31,35,22,19,0
45111,766,336,430,133,97,79,21,449,252,197,61,52,36,18,0
45112,222,110,112,43,30,14,6,536,222,314,101,100,34,22,0
45113,1556,718,838,280,182,161,49,305,161,144,39,40,44,17,0
45114,856,429,427,113,105,96,24,389,210,179,51,37,43,9,0
45115,574,269,305,91,63,54,27,222,122,100,39,32,24,9,0
45116,648,262,386,113,108,78,29,89,37,52,13,6,2,9,0
45117,1505,680,825,202,204,73,32,701,380,321,94,84,96,34,0
45118,347,181,166,27,20,12,12,387,193,194,60,53,57,15,0
45119,1163,417,746,209,145,87,28,86,40,46,16,13,9,7,0
45120,380,185,195,68,54,32,16,136,65,71,26,11,7,5,0
45121,331,144,187,57,46,33,19,336,200,136,34,29,25,24,0
45122,412,146,266,106,38,67,35,178,99,79,31,19,26,8,0
45123,338,208,130,39,30,35,12,889,505,384,107,97,99,30,0
45124,380,185,195,68,54,32,16,619,305,314,85,93,71,29,0
45125,894,448,446,123,100,82,30,290,142,148,41,37,43,11,0
45126,219,116,103,66,7,2,1,180,95,85,22,21,17,8,0
45127,2048,855,1193,297,287,191,93,424,179,245,65,67,29,11,0
45128,1531,649,882,108,122,93,72,1700,731,969,198,233,110,87,0
45129,1284,511,773,227,166,169,107,514,262,252,78,58,54,26,0
45130,516,210,306,113,53,81,33,415,226,189,51,40,40,29,0
45131,118,51,67,25,13,6,7,528,276,252,86,78,49,17,0
45132,451,278,173,71,35,58,12,148,84,64,30,7,17,4,0
45133,361,183,178,50,54,51,22,629,317,312,80,87,51,22,0
45134,196,107,89,20,31,17,4,276,149,127,34,31,32,10,0
45135,584,340,244,77,60,47,25,602,310,292,87,66,70,36,0
45136,407,164,243,88,42,40,22,810,310,500,164,162,42,26,0
45137,3703,1708,1995,456,428,305,162,396,197,199,75,49,49,16,0
45138,567,266,301,139,46,76,37,1265,689,576,169,177,128,60,0
45139,2062,706,1356,414,368,158,63,218,118,100,33,30,25,11,0
45140,159,105,54,22,9,14,25,297,164,133,45,39,40,9,0
45141,278,110,168,58,49,29,5,978,536,442,132,107,67,32,0
45142,963,477,486,134,143,123,38,593,289,304,85,69,48,19,0
45143,1835,904,931,192,144,135,63,72,32,40,8,2,2,13,0
45144,784,351,433,118,87,73,41,535,311,224,66,52,49,24,0
45145,579,321,258,74,70,47,22,384,212,172,44,43,34,14,0
45146,554,217,337,112,72,90,38,169,84,85,29,19,21,7,0
45147,340,169,171,40,39,36,22,421,219,202,68,57,56,13,0
45148,961,465,496,139,156,62,34,102,51,51,12,15,12,3,0
45149,423,247,176,58,55,29,20,810,310,500,164,162,42,26,0
45150,648,376,272,70,60,73,24,906,455,451,116,105,87,46,0
45151,904,436,468,138,146,82,39,2547,1280,1267,331,335,293,118,0
45152,493,208,285,75,77,70,40,389,207,182,53,58,52,18,0
45153,119,67,52,15,15,7,7,364,192,172,49,36,39,14,0
45154,554,217,337,112,72,90,38,156,90,66,17,22,11,10,0
45155,203,80,123,40,37,20,3,337,170,167,59,33,47,17,0
45156,609,292,317,102,96,64,21,169,74,95,33,26,22,3,0
45157,653,379,274,89,56,86,13,385,188,197,57,42,36,16,0
45158,526,228,298,69,64,32,30,124,69,55,14,7,9,4,0
45159,476,254,222,58,33,46,23,322,180,142,45,38,28,7,0
45160,510,269,241,66,67,71,26,274,142,132,33,34,18,14,0
45161,203,80,123,40,37,20,3,561,279,282,85,81,88,24,0
45162,412,193,219,69,57,43,14,194,109,85,23,24,21,9,0
45163,218,133,85,20,19,13,6,843,391,452,139,104,91,35,0
45164,411,236,175,39,45,50,30,1543,794,749,182,152,132,55,0
45165,270,158,112,35,20,23,7,1507,737,770,188,228,147,71,0
45166,169,64,105,23,37,11,3,741,383,358,92,63,79,36,0
45167,335,183,152,40,26,54,22,1230,644,586,198,125,123,61,0
45168,414,206,208,56,68,35,19,189,95,94,25,33,16,8,0
45169,283,112,171,48,39,34,15,163,79,84,22,24,13,5,0
45170,122,56,66,26,13,11,5,1182,591,591,155,139,83,46,0
45171,654,344,310,80,69,57,15,2346,1231,1115,316,292,266,105,0
45172,521,289,232,71,58,49,16,414,203,211,58,56,48,14,0
45173,445,231,214,45,64,53,23,316,166,150,45,38,37,13,0
45174,407,230,177,44,39,34,19,274,157,117,40,29,40,8,0
45175,213,113,100,26,21,26,12,326,149,177,51,51,28,10,0
45176,873,366,507,127,125,75,21,96,46,50,16,12,7,5,0
45177,653,379,274,89,56,86,13,737,397,340,87,104,90,14,0
45178,456,214,242,76,62,52,22,1507,737,770,188,228,147,71,0
45179,102,22,80,48,8,18,6,285,146,139,41,41,48,13,0
45180,546,278,268,94,60,32,22,647,324,323,101,80,76,43,0
45181,1339,494,845,216,298,92,37,607,293,314,98,71,62,32,0
45182,149,68,81,15,38,11,10,298,129,169,51,40,29,8,0
45183,243,70,173,54,65,8,6,437,224,213,40,29,42,25,0
45184,949,466,483,125,126,101,50,160,60,100,23,40,19,11,0
45185,1867,973,894,256,222,194,65,127,54,73,11,33,15,6,0
45186,1163,417,746,209,145,87,28,376,189,187,47,53,44,26,0
45187,128,67,61,29,9,9,1,325,172,153,44,34,27,14,0
45188,462,258,204,59,41,56,15,461,223,238,45,62,18,35,0
45189,315,111,204,82,66,46,11,482,232,250,77,81,44,13,0
45190,594,279,315,93,68,68,26,732,402,330,81,86,87,33,0
45191,224,108,116,33,26,32,10,132,61,71,19,20,14,6,0
45192,232,134,98,28,20,20,5,370,190,180,60,52,37,13,0
45193,500,245,255,66,57,52,27,354,183,171,54,43,49,8,0
45194,739,389,350,129,61,69,25,137,63,74,20,22,14,6,0
45195,270,128,142,36,43,15,11,397,223,174,50,39,29,17,0
45196,326,156,170,60,47,43,5,466,186,280,71,84,30,11,0
45197,356,199,157,36,43,28,12,180,115,65,17,12,9,9,0
45198,658,349,309,77,70,73,35,277,124,153,44,40,35,18,0
45199,388,244,144,46,25,42,16,398,200,198,68,43,51,14,0
45200,395,189,206,63,50,49,28,405,195,210,57,74,24,17,0
45201,722,390,332,125,69,67,25,282,134,148,38,45,29,10,0
45202,526,228,298,69,64,32,30,145,77,68,26,7,15,8,0
45203,494,233,261,87,57,46,18,201,93,108,34,39,21,6,0
45204,837,443,394,129,89,87,38,350,196,154,52,37,21,14,0
45205,574,284,290,64,50,65,20,107,77,30,7,2,9,5,0
45206,432,233,199,52,28,47,18,783,406,377,102,91,57,29,0
45207,1217,647,570,142,160,129,45,279,161,118,37,32,7,7,0
45208,584,340,244,77,60,47,25,374,212,162,48,40,32,23,0
45209,802,375,427,133,103,81,41,514,262,252,78,58,54,26,0
45210,164,61,103,47,19,14,5,54,26,28,11,4,3,3,0
45211,1030,438,592,184,104,108,30,326,149,177,51,51,28,10,0
45212,397,180,217,61,59,39,13,194,94,100,33,28,14,7,0
45213,509,251,258,69,49,55,17,1700,731,969,198,233,110,87,0
45214,648,376,272,70,60,73,24,218,115,103,32,32,34,11,0
45215,894,448,446,123,100,82,30,644,343,301,96,69,59,28,0
45216,963,477,486,134,143,123,38,292,143,149,38,42,36,16,0
45217,953,421,532,131,131,70,37,374,174,200,54,52,42,21,0
45218,579,321,258,74,70,47,22,153,80,73,26,18,19,4,0
45219,251,139,112,41,18,27,11,766,386,380,101,81,78,31,0
45220,496,210,286,112,55,71,14,282,134,148,38,45,29,10,0
45221,122,56,66,26,13,11,5,520,244,276,91,60,68,20,0
45222,756,265,491,129,127,51,17,288,156,132,36,36,24,15,0
45223,200,103,97,17,16,10,10,2038,1059,979,262,237,208,100,0
45224,772,332,440,136,104,72,28,528,276,252,86,78,49,17,0
45225,852,461,391,109,102,72,24,704,355,349,113,94,71,24,0
45226,516,224,292,79,29,45,33,663,360,303,87,82,80,35,0
45227,507,314,193,49,45,59,25,2547,1280,1267,331,335,293,118,0
45228,700,305,395,111,99,54,18,1062,522,540,151,147,105,66,0
45229,548,310,238,72,62,54,13,274,142,132,33,34,18,14,0
45230,395,195,200,41,55,23,10,145,77,68,26,7,15,8,0
45231,243,114,129,37,30,32,8,548,296,252,71,74,43,28,0
45232,401,183,218,72,73,28,10,148,69,79,26,18,16,3,0
45233,280,156,124,36,19,20,13,898,469,429,125,125,134,35,0
45234,347,181,166,27,20,12,12,329,194,135,45,32,33,9,0
45235,463,225,238,76,36,59,26,535,311,224,66,52,49,24,0
45236,51,10,41,25,0,5,8,929,459,470,140,120,94,45,0
45237,314,158,156,39,28,30,17,756,348,408,101,103,60,40,0
45238,302,178,124,34,29,50,13,307,132,175,48,53,26,10,0
45239,752,313,439,121,106,68,27,308,146,162,42,39,24,12,0
45240,680,308,372,82,72,71,40,103,59,44,25,2,13,6,0
45241,142,76,66,21,21,22,11,381,186,195,69,55,46,15,0
45242,413,206,207,38,55,19,10,102,51,51,12,15,12,3,0
45243,3230,1724,1506,361,358,157,75,392,186,206,62,56,29,15,0
45244,677,361,316,81,61,42,22,375,211,164,50,36,31,23,0
45245,82,36,46,17,10,5,1,758,319,439,101,123,78,25,0
45246,532,291,241,83,36,79,25,508,253,255,73,60,50,13,0
45247,399,220,179,48,37,68,18,137,78,59,22,16,17,4,0
45248,707,250,457,171,84,117,61,963,455,508,127,130,115,48,0
45249,333,171,162,50,34,19,8,536,267,269,60,70,41,22,0
45250,217,109,108,30,23,28,10,471,238,233,66,63,62,19,0
45251,1120,436,684,208,120,101,115,68,23,45,12,9,3,9,0
45252,260,133,127,43,29,34,11,164,79,85,28,28,16,7,0
45253,1365,590,775,257,168,136,93,535,301,234,63,48,47,27,0
45254,414,216,198,51,32,42,28,91,42,49,21,9,8,3,0
45255,288,140,148,59,33,27,12,320,168,152,38,42,24,18,0
45256,521,289,232,71,58,49,16,1061,543,518,146,123,109,67,0
45257,894,448,446,123,100,82,30,862,409,453,149,125,86,29,0
45258,162,73,89,32,19,4,4,469,225,244,64,68,25,11,0
45259,331,165,166,52,34,48,22,644,343,301,96,69,59,28,0
45260,376,176,200,31,53,27,8,483,215,268,66,70,30,16,0
45261,2446,1099,1347,363,294,233,100,374,174,200,54,52,42,21,0
45262,178,87,91,20,32,13,10,630,321,309,86,90,57,26,0
45263,498,274,224,58,59,50,18,858,398,460,126,138,75,39,0
45264,480,232,248,73,40,44,30,102,51,51,12,15,12,3,0
45265,142,60,82,20,28,13,5,1873,935,938,233,225,203,79,0
45266,346,186,160,40,37,34,21,166,78,88,27,25,19,7,0
45267,335,148,187,52,26,51,12,242,121,121,39,30,29,10,0
45268,213,113,100,26,21,26,12,296,159,137,49,28,38,13,0
45269,364,172,192,55,57,32,15,334,182,152,45,41,27,13,0
45270,1542,682,860,290,158,120,47,415,205,210,77,52,55,17,0
45271,745,402,343,95,71,69,40,222,124,98,37,29,22,9,0
45272,736,320,416,113,97,61,36,305,163,142,38,27,47,11,0
45273,524,270,254,84,72,70,23,1323,690,633,132,178,112,61,0
45274,260,133,127,43,29,34,11,359,171,188,49,74,45,11,0
45275,2696,1169,1527,432,347,193,146,283,142,141,41,33,26,18,0
45276,595,339,256,64,36,54,24,325,159,166,59,46,30,12,0
45277,161,75,86,24,20,10,7,328,195,133,39,40,27,13,0
45278,339,170,169,32,17,24,13,370,190,180,60,52,37,13,0
45279,1189,653,536,152,118,109,56,322,180,142,45,38,28,7,0
45280,413,169,244,66,94,28,19,106,46,60,29,13,14,5,0
45281,136,66,70,33,11,9,3,792,398,394,109,96,90,39,0
45282,235,100,135,36,25,30,8,218,115,103,32,32,34,11,0
45283,306,172,134,35,31,37,18,225,111,114,32,34,32,16,0
45284,437,230,207,41,55,27,13,423,234,189,66,44,57,12,0
45285,609,292,317,102,96,64,21,649,304,345,99,80,67,40,0
45286,440,267,173,52,29,42,12,360,185,175,51,43,36,16,0
45287,781,316,465,130,129,65,23,222,125,97,34,27,27,7,0
45288,1068,434,634,173,160,61,29,403,192,211,102,39,49,15,0
45289,473,217,256,59,44,34,21,429,187,242,79,72,28,19,0
45290,206,100,106,34,26,11,7,215,115,100,27,19,16,7,0
45291,456,223,233,77,54,47,20,380,178,202,69,53,37,10,0
45292,334,190,144,42,42,16,5,175,91,84,19,21,21,10,0
45293,972,501,471,125,156,106,39,156,90,66,17,22,11,10,0
45294,543,221,322,78,122,37,12,168,67,101,37,17,13,13,0
45295,478,220,258,47,70,41,10,690,345,345,96,83,73,42,0
45296,465,305,160,40,47,34,9,196,105,91,40,13,19,10,0
45297,346,173,173,50,56,31,14,68,36,32,11,8,9,2,0
45298,130,71,59,30,9,8,2,535,301,234,63,48,47,27,0
45299,356,199,157,36,43,28,12,218,115,103,32,32,34,11,0
45300,364,168,196,64,61,27,6,434,213,221,77,62,53,12,0
45301,492,253,239,73,67,77,29,106,46,60,29,13,14,5,0
45302,180,92,88,29,20,26,8,124,69,55,14,7,9,4,0
45303,305,124,181,27,25,32,21,561,279,282,85,81,88,24,0
45304,473,212,261,72,64,45,28,137,63,74,20,22,14,6,0
45305,314,158,156,39,28,30,17,147,74,73,28,20,24,4,0
45306,462,233,229,66,49,43,30,445,192,253,86,58,53,18,0
45307,1042,529,513,161,151,103,52,276,143,133,34,38,20,15,0
45308,312,173,139,43,47,28,6,1004,457,547,150,150,74,52,0
45309,1099,491,608,163,141,107,62,173,90,83,21,36,12,15,0
45310,270,158,112,35,20,23,7,367,218,149,45,43,42,16,0
45311,130,71,59,30,9,8,2,94,45,49,11,20,10,4,0
45312,579,321,258,74,70,47,22,169,74,95,33,26,22,3,0
45313,1463,521,942,252,204,105,52,72,34,38,8,2,3,12,0
45314,222,108,114,37,20,25,12,929,459,470,140,120,94,45,0
45315,1284,511,773,227,166,169,107,520,272,248,60,65,58,22,0
45316,292,102,190,71,27,51,21,929,459,470,140,120,94,45,0
45317,361,167,194,55,35,41,11,391,189,202,55,56,56,12,0
45318,234,108,126,42,40,15,9,538,274,264,84,67,52,35,0
45319,500,245,255,66,57,52,27,737,397,340,87,104,90,14,0
45320,484,264,220,59,62,68,15,137,63,74,20,22,14,6,0
45321,1463,521,942,252,204,105,52,397,223,174,50,39,29,17,0
45322,550,304,246,60,64,77,16,583,280,303,95,66,76,25,0
45323,646,304,342,104,93,58,26,257,139,118,64,17,24,7,0
45324,179,96,83,24,8,26,4,334,181,153,41,40,25,15,0
45325,226,120,106,68,8,2,1,1755,905,850,214,196,183,79,0
45326,333,171,162,41,44,48,23,535,301,234,63,48,47,27,0
45327,2048,855,1193,297,287,191,93,1020,538,482,145,115,111,58,0
45328,367,167,200,63,42,60,17,508,253,255,73,60,50,13,0
45329,521,249,272,53,36,50,18,647,324,323,101,80,76,43,0
45330,674,318,356,86,139,50,11,337,170,167,59,33,47,17,0
45331,334,190,144,42,42,16,5,565,237,328,75,88,32,11,0
45332,399,220,179,48,37,68,18,302,150,152,56,40,52,15,0
45333,1096,563,533,158,136,120,53,445,202,243,70,73,51,15,0
45334,1341,481,860,275,264,57,21,335,186,149,40,28,29,13,0
45335,179,78,101,29,22,10,8,87,51,35,15,9,9,4,0
45336,480,257,223,74,26,60,27,415,226,189,51,40,40,29,0
45337,781,316,465,130,129,65,23,536,267,269,60,70,41,22,0
45338,505,282,223,60,57,66,23,693,360,333,100,88,62,26,0
45339,5890,3314,2576,970,956,293,265,338,169,169,53,44,39,21,0
45340,867,415,452,123,87,62,27,251,143,108,47,25,29,11,0
45341,979,534,445,83,77,80,24,246,107,139,55,33,27,11,0
45342,837,381,456,123,109,65,25,194,106,88,33,10,15,6,0
45343,127,62,65,13,33,7,6,303,138,165,47,46,35,18,0
45344,128,69,59,29,9,8,1,975,475,500,139,140,119,28,0
45345,111,29,82,10,54,0,1,171,94,77,24,28,30,11,0
45346,303,161,142,38,31,42,17,633,311,322,94,82,45,20,0
45347,531,284,247,66,42,49,15,1101,626,475,145,122,120,50,0
45348,733,382,351,126,92,93,27,607,293,314,98,71,62,32,0
45349,1555,702,853,250,199,139,31,756,348,408,101,103,60,40,0
45350,411,171,240,61,81,30,15,1382,508,874,334,320,98,36,0
45351,126,56,70,31,10,10,3,1352,602,750,166,185,81,70,0
45352,505,282,223,60,57,66,23,400,187,213,56,59,42,20,0
45353,1014,488,526,178,137,94,39,296,140,156,49,40,42,19,0
45354,1186,495,691,182,208,88,32,393,210,183,58,37,34,20,0
45355,536,237,299,116,87,42,17,1543,794,749,182,152,132,55,0
45356,772,383,389,105,76,82,33,457,253,204,67,51,48,13,0
45357,443,206,237,76,68,52,28,889,505,384,107,97,99,30,0
45358,282,96,186,80,21,28,7,252,130,122,45,23,32,11,0
45359,772,417,355,118,92,80,23,727,388,339,102,87,70,29,0
45360,129,70,59,29,9,7,2,223,113,110,31,33,22,12,0
45361,852,461,391,109,102,72,24,535,301,234,63,48,47,27,0
45362,369,166,203,59,55,41,14,178,69,109,29,25,21,13,0
45363,1043,479,564,200,131,123,62,123,61,62,17,18,17,7,0
45364,331,165,166,52,34,48,22,136,65,71,26,11,7,5,0
45365,900,434,466,134,97,86,36,323,162,161,52,41,39,13,0
45366,308,163,145,38,33,30,20,555,282,273,82,69,65,21,0
45367,512,254,258,70,48,37,32,294,146,148,50,45,51,15,0
45368,290,156,134,44,29,39,9,773,389,384,119,91,79,26,0
45369,361,183,178,50,54,51,22,241,127,114,34,33,29,12,0
45370,439,183,256,60,64,36,14,516,245,271,82,84,70,26,0
45371,291,120,171,63,39,26,6,328,199,129,39,29,27,14,0
45372,972,501,471,125,156,106,39,640,364,276,84,68,69,33,0
45373,200,103,97,17,16,10,10,792,398,394,109,96,90,39,0
45374,532,291,241,83,36,79,25,297,175,122,46,30,31,6,0
45375,261,130,131,27,41,19,16,1265,689,576,169,177,128,60,0
45376,1051,429,622,179,148,125,54,334,181,153,56,31,28,18,0
45377,131,69,62,29,9,9,1,463,259,204,62,55,34,22,0
45378,178,87,91,20,32,13,10,483,258,225,70,53,54,20,0
45379,99,35,64,25,18,0,1,188,105,83,25,17,24,7,0
45380,122,56,66,26,13,11,5,1425,670,755,153,189,122,85,0
45381,157,62,95,41,18,10,11,312,165,147,41,39,29,16,0
45382,1341,481,860,275,264,57,21,810,310,500,164,162,42,26,0
45383,413,236,177,41,25,35,19,89,42,47,16,12,15,6,0
45384,785,351,434,136,93,71,37,498,244,254,81,67,58,19,0
45385,833,295,538,146,139,65,34,798,385,413,120,115,79,30,0
45386,502,236,266,66,66,58,17,139,68,71,14,26,14,9,0
45387,466,259,207,59,50,83,12,508,253,255,73,60,50,13,0
45388,1463,521,942,252,204,105,52,230,125,105,29,40,20,6,0
45389,281,125,156,44,47,17,7,1166,514,652,150,159,107,70,0
45390,595,316,279,86,60,65,40,1696,771,925,257,225,149,63,0
45391,428,226,202,52,60,75,20,873,411,462,132,107,84,40,0
45392,798,287,511,126,125,77,26,148,84,64,30,7,17,4,0
45393,413,169,244,66,94,28,19,274,142,132,33,34,18,14,0
45394,413,169,244,66,94,28,19,133,61,72,21,19,13,4,0
45395,437,230,207,41,55,27,13,704,355,349,113,94,71,24,0
45396,828,368,460,118,98,59,38,370,173,197,65,57,42,10,0
45397,461,257,204,63,49,50,29,364,189,175,58,41,35,17,0
45398,219,116,103,66,7,2,1,251,143,108,47,25,29,11,0
45399,434,216,218,72,58,40,20,780,337,443,112,116,77,28,0
45400,457,261,196,55,27,57,34,352,207,145,40,33,25,21,0
45401,395,189,206,63,50,49,28,164,79,85,28,28,16,7,0
45402,1220,575,645,208,179,99,56,423,234,189,66,44,57,12,0
45403,334,155,179,47,34,38,11,403,233,170,38,29,21,14,0
45404,3859,2011,1848,535,391,422,207,103,44,59,16,17,9,5,0
45405,852,472,380,99,79,70,27,245,121,124,37,35,36,12,0
45406,308,129,179,44,60,19,8,225,111,114,32,34,32,16,0
45407,436,201,235,54,37,35,18,1230,644,586,198,125,123,61,0
45408,540,252,288,73,67,57,20,671,306,365,114,76,49,19,0
45409,1200,602,598,145,116,110,50,149,52,97,36,36,7,4,0
45410,236,120,116,32,28,21,11,178,99,79,31,19,26,8,0
45411,531,284,247,66,42,49,15,467,231,236,71,65,58,18,0
45412,344,109,235,100,39,26,5,295,156,139,41,40,42,15,0
45413,492,253,239,73,67,77,29,207,113,94,33,18,30,9,0
45414,390,199,191,72,42,35,12,127,54,73,11,33,15,6,0
45415,143,81,62,28,9,8,1,660,333,327,102,95,69,31,0
45416,525,302,223,56,48,67,19,619,305,314,85,93,71,29,0
45417,585,277,308,92,73,61,32,203,98,105,34,29,19,10,0
45418,919,444,475,141,148,62,20,142,73,69,27,9,15,11,0
45419,674,268,406,118,96,70,21,1543,794,749,182,152,132,55,0
45420,1220,575,645,208,179,99,56,368,183,185,40,42,40,15,0
45421,1235,584,651,140,226,82,52,290,142,148,41,37,43,11,0
45422,493,208,285,75,77,70,40,239,113,126,36,49,20,8,0
45423,179,78,101,29,22,10,8,1352,602,750,166,185,81,70,0
45424,179,78,101,29,22,10,8,199,105,94,27,27,28,9,0
45425,211,92,119,33,44,11,7,380,178,202,69,53,37,10,0
45426,729,351,378,111,98,58,18,138,69,69,28,7,10,10,0
45427,422,196,226,52,35,33,20,846,425,421,125,97,98,38,0
45428,270,128,142,36,43,15,11,301,168,133,49,37,34,11,0
45429,412,208,204,54,47,42,17,166,78,88,27,25,19,7,0
45430,453,240,213,53,33,44,16,427,251,176,51,39,25,22,0
45431,2488,1085,1403,346,253,162,76,139,68,71,14,26,14,9,0
45432,772,417,355,118,92,80,23,279,142,137,43,39,28,7,0
45433,1098,519,579,182,159,79,42,481,223,258,71,70,49,26,0
45434,255,136,119,39,20,32,10,926,425,501,159,147,77,35,0
45435,704,342,362,113,91,85,33,375,176,199,48,61,40,12,0
45436,297,182,115,41,22,23,8,536,267,269,60,70,41,22,0
45437,184,93,91,26,25,14,11,395,169,226,73,55,38,9,0
45438,432,190,242,85,82,28,11,935,515,420,126,107,73,32,0
45439,232,108,124,33,27,19,16,715,345,370,110,97,64,25,0
45440,545,221,324,101,72,55,30,633,311,322,94,82,45,20,0
45441,522,302,220,61,49,75,19,137,85,52,15,11,11,2,0
45442,347,198,149,45,29,29,8,374,191,183,40,52,40,16,0
45443,368,154,214,80,52,41,16,1182,591,591,155,139,83,46,0
45444,557,211,346,129,125,48,19,482,232,250,77,81,44,13,0
45445,257,148,109,28,20,21,14,720,361,359,98,98,70,37,0
45446,772,417,355,118,92,80,23,198,86,112,36,27,23,9,0
45447,739,389,350,129,61,69,25,679,338,341,96,95,40,23,0
45448,509,246,263,84,71,56,22,679,338,341,96,95,40,23,0
45449,959,496,463,144,132,75,35,178,69,109,29,25,21,13,0
45450,340,145,195,46,38,26,23,134,72,62,14,28,8,4,0
45451,579,281,298,91,78,74,27,811,361,450,124,107,80,31,0
45452,76,30,46,7,15,1,5,258,129,129,45,24,31,10,0
45453,240,99,141,53,38,29,15,1696,771,925,257,225,149,63,0
45454,126,58,68,31,10,10,3,497,227,270,70,63,66,30,0
45455,149,78,71,20,20,19,5,798,385,413,120,115,79,30,0
45456,291,131,160,49,35,32,15,1279,669,610,164,162,104,55,0
45457,373,194,179,42,54,26,13,862,426,436,113,115,84,37,0
45458,308,163,145,38,33,30,20,1279,669,610,164,162,104,55,0
45459,221,75,146,68,21,16,5,377,184,193,50,43,33,17,0
45460,417,222,195,53,39,43,10,320,168,152,38,42,24,18,0
45461,648,262,386,113,108,78,29,87,51,35,15,9,9,4,0
45462,743,366,377,41,37,26,14,463,268,195,59,46,46,21,0
45463,221,114,107,65,7,2,1,419,233,186,54,53,55,17,0
45464,785,351,434,136,93,71,37,1500,804,696,190,172,144,60,0
45465,138,35,103,38,2,15,9,439,231,208,65,51,55,17,0
45466,224,108,116,33,26,32,10,223,113,110,31,33,22,12,0
45467,473,212,261,72,64,45,28,295,158,137,42,34,38,14,0
45468,358,206,152,45,38,67,16,198,86,112,36,27,23,9,0
45469,245,111,134,36,27,18,6,508,253,255,73,60,50,13,0
45470,886,440,446,116,140,95,45,1700,731,969,198,233,110,87,0
45471,256,152,104,18,23,23,8,285,146,139,41,41,48,13,0
45472,320,183,137,51,18,38,8,583,321,262,73,67,45,25,0
45473,401,183,218,72,73,28,10,124,69,55,14,7,9,4,0
45474,784,351,433,118,87,73,41,538,274,264,84,67,52,35,0
45475,372,171,201,47,53,39,18,441,189,252,73,50,47,23,0
45476,1867,973,894,256,222,194,65,215,115,100,27,19,16,7,0
45477,375,201,174,52,56,39,15,464,236,228,64,56,53,28,0
45478,202,113,89,16,27,21,11,415,205,210,77,52,55,17,0
45479,667,366,301,96,55,84,25,149,52,97,36,36,7,4,0
45480,631,316,315,64,57,49,15,422,202,220,80,52,57,18,0
45481,529,290,239,54,63,85,15,344,190,154,34,31,36,10,0
45482,335,183,152,40,26,54,22,96,45,51,13,12,6,4,0
45483,650,330,320,97,77,65,28,250,119,131,58,26,29,7,0
45484,373,164,209,51,45,44,21,737,397,340,87,104,90,14,0
45485,758,378,380,89,64,37,31,535,288,247,79,72,35,21,0
45486,457,228,229,64,36,52,21,360,185,175,51,43,36,16,0
45487,326,148,178,55,42,31,12,1922,923,999,267,275,215,90,0
45488,411,202,209,60,67,57,24,326,169,157,51,41,41,12,0
45489,772,332,440,136,104,72,28,127,64,63,26,8,12,8,0
45490,281,125,156,44,47,17,7,974,457,517,133,117,69,26,0
45491,708,344,364,106,98,66,33,279,142,137,43,39,28,7,0
45492,458,210,248,39,38,25,16,403,192,211,102,39,49,15,0
45493,1047,443,604,162,156,78,52,928,440,488,111,157,82,35,0
45494,344,168,176,50,39,30,20,218,118,100,33,30,25,11,0
45495,130,71,59,30,9,8,2,418,246,172,52,39,57,10,0
45496,329,165,164,61,44,29,17,352,207,145,40,33,25,21,0
45497,237,127,110,34,30,16,9,2547,1280,1267,331,335,293,118,0
45498,525,254,271,60,76,46,13,665,361,304,87,91,84,31,0
45499,682,260,422,98,83,42,31,551,226,325,96,103,43,11,0
45500,146,75,71,13,32,15,11,338,169,169,53,44,39,21,0
45501,801,331,470,151,139,99,55,1101,626,475,145,122,120,50,0
45502,302,178,124,34,29,50,13,189,95,94,25,33,16,8,0
45503,280,128,152,39,37,38,18,374,202,172,50,39,31,24,0
45504,206,96,110,33,25,8,6,179,101,78,25,15,13,13,0
45505,295,143,152,38,47,22,25,904,436,468,138,146,82,39,0
45506,485,246,239,74,48,47,22,142,73,69,27,9,15,11,0
45507,431,199,232,59,54,40,17,501,274,227,63,58,53,20,0
45508,144,57,87,38,26,10,4,136,65,71,26,11,7,5,0
45509,853,400,453,137,109,88,42,265,134,131,48,34,33,15,0
45510,385,179,206,58,56,38,19,1182,591,591,155,139,83,46,0
45511,525,302,223,56,48,67,19,749,384,365,108,105,86,31,0
45512,687,351,336,106,67,70,41,866,478,388,121,101,101,26,0
45513,412,203,209,65,47,37,18,220,107,113,36,35,28,9,0
45514,559,217,342,105,86,42,16,432,244,188,51,51,27,14,0
45515,908,324,584,181,162,81,29,134,72,62,14,28,8,4,0
45516,507,314,193,49,45,59,25,144,67,77,28,14,9,8,0
45517,717,281,436,165,81,112,49,325,159,166,59,46,30,12,0
45518,574,284,290,64,50,65,20,549,273,276,74,68,72,24,0
45519,475,235,240,77,58,43,22,173,86,87,30,22,19,12,0
45520,125,53,72,18,21,18,12,106,54,52,12,9,7,6,0
45521,288,104,184,80,30,39,6,373,213,160,44,33,26,17,0
45522,436,209,227,66,47,52,22,335,170,165,52,36,47,11,0
45523,1208,575,633,187,204,117,41,404,190,214,55,55,35,27,0
45524,517,196,321,103,98,33,12,178,69,109,29,25,21,13,0
45525,239,146,93,30,22,35,9,350,200,150,45,47,23,8,0
45526,265,165,100,32,19,27,5,359,171,188,49,74,45,11,0
45527,582,328,254,78,48,35,9,334,182,152,45,41,27,13,0
45528,548,310,238,72,62,54,13,373,181,192,54,35,44,20,0
45529,904,436,468,138,146,82,39,385,212,173,57,40,39,21,0
45530,292,102,190,71,27,51,21,1040,564,476,134,110,114,51,0
45531,480,257,223,74,26,60,27,326,169,157,51,41,41,12,0
45532,1464,693,771,153,136,91,86,124,69,55,14,7,9,4,0
45533,367,167,200,63,42,60,17,137,78,59,22,16,17,4,0
45534,346,186,160,40,37,34,21,654,295,359,99,88,71,25,0
45535,2285,1219,1066,207,180,178,106,520,244,276,91,60,68,20,0
45536,349,131,218,66,76,22,9,229,120,109,31,30,22,9,0
45537,240,167,73,32,12,8,21,531,261,270,73,80,68,26,0
45538,200,94,106,33,22,18,8,732,402,330,81,86,87,33,0
45539,707,250,457,171,84,117,61,406,234,172,63,35,43,10,0
45540,411,211,200,61,46,35,18,425,177,248,60,62,33,16,0
45541,315,174,141,46,38,47,16,325,159,166,59,46,30,12,0
45542,338,208,130,39,30,35,12,478,254,224,67,74,56,28,0
45543,261,137,124,34,23,13,8,406,234,172,63,35,43,10,0
45544,607,305,302,92,89,74,23,761,351,410,117,73,103,45,0
45545,733,438,295,95,79,67,32,149,77,72,37,10,20,5,0
45546,483,236,247,82,60,43,18,462,229,233,63,49,42,18,0
45547,479,228,251,71,57,60,14,308,146,162,42,39,24,12,0
45548,158,85,73,24,18,18,8,1265,689,576,169,177,128,60,0
45549,653,379,274,89,56,86,13,1323,690,633,132,178,112,61,0
45550,235,119,116,31,26,15,13,958,451,507,165,135,97,41,0
45551,178,87,91,20,32,13,10,96,46,50,16,12,7,5,0
45552,160,53,107,31,29,13,3,818,357,461,122,136,54,25,0
45553,493,281,212,56,61,30,13,463,268,195,59,46,46,21,0
45554,860,348,512,121,136,75,35,68,36,32,11,8,9,2,0
45555,533,297,236,74,57,39,28,535,301,234,63,48,47,27,0
45556,199,107,92,41,15,14,8,520,244,276,91,60,68,20,0
45557,1531,649,882,108,122,93,72,207,113,94,33,18,30,9,0
45558,450,231,219,77,50,76,16,296,151,145,45,42,32,11,0
45559,463,225,238,76,36,59,26,317,161,156,50,36,47,12,0
45560,193,105,88,33,16,9,4,149,77,72,37,10,20,5,0
45561,911,445,466,154,121,108,48,496,251,245,78,62,61,23,0
45562,595,316,279,86,60,65,40,690,345,345,96,83,73,42,0
45563,255,126,129,41,37,13,5,303,138,165,47,46,35,18,0
45564,164,77,87,33,19,6,7,299,140,159,49,44,26,11,0
45565,1004,464,540,143,104,78,55,617,314,303,96,68,68,37,0
45566,269,124,145,36,24,32,11,393,210,183,58,37,34,20,0
45567,235,100,135,36,25,30,8,200,99,101,31,24,26,6,0
45568,325,181,144,46,31,48,9,708,328,380,113,100,82,34,0
45569,707,250,457,171,84,117,61,282,134,148,38,45,29,10,0
45570,345,203,142,47,35,31,11,201,93,108,34,39,21,6,0
45571,458,226,232,77,59,61,14,1025,549,476,118,109,88,61,0
45572,242,104,138,41,33,37,8,147,74,73,28,20,24,4,0
45573,213,114,99,62,7,2,1,127,64,63,26,8,12,8,0
45574,297,161,136,36,35,24,9,350,196,154,52,37,21,14,0
45575,5890,3314,2576,970,956,293,265,732,402,330,81,86,87,33,0
45576,200,103,97,17,16,10,10,164,79,85,28,28,16,7,0
45577,347,212,135,35,32,17,6,858,398,460,126,138,75,39,0
45578,674,318,356,86,139,50,11,410,197,213,67,43,56,18,0
45579,410,208,202,59,58,43,26,455,229,226,66,62,63,29,0
45580,881,492,389,87,97,59,51,384,212,172,44,43,34,14,0
45581,793,355,438,134,117,77,43,535,288,247,79,72,35,21,0
45582,230,114,116,30,33,29,8,277,152,125,31,35,22,19,0
45583,594,248,346,104,109,53,5,647,324,323,101,80,76,43,0
45584,344,168,176,50,39,30,20,354,188,166,46,40,34,10,0
45585,131,69,62,29,9,9,1,483,287,196,71,50,54,17,0
45586,443,212,231,74,24,60,24,715,345,370,110,97,64,25,0
45587,281,154,127,45,31,24,9,301,168,133,49,37,34,11,0
45588,136,66,70,33,11,9,4,452,252,200,55,49,61,16,0
45589,435,187,248,62,51,51,21,274,157,117,40,29,40,8,0
45590,1124,442,682,148,189,72,43,360,185,175,51,43,36,16,0
45591,336,199,137,46,22,51,13,277,163,114,33,24,21,16,0
45592,291,131,160,49,35,32,15,465,252,213,73,58,60,18,0
45593,562,214,348,120,86,69,42,192,91,101,29,28,17,7,0
45594,301,119,182,53,47,14,20,72,32,40,8,2,1,14,0
45595,584,297,287,89,80,65,17,536,267,269,60,70,41,22,0
45596,361,183,178,50,54,51,22,201,93,108,34,39,21,6,0
45597,756,265,491,129,127,51,17,551,226,325,96,103,43,11,0
45598,586,298,288,80,75,64,37,1755,905,850,214,196,183,79,0
45599,245,111,134,36,27,18,6,463,259,204,62,55,34,22,0
45600,2799,1324,1475,369,371,215,124,319,185,134,42,31,22,13,0
45601,589,282,307,68,67,70,23,708,328,380,113,100,82,34,0
45602,474,250,224,58,47,37,12,619,305,314,85,93,71,29,0
45603,1235,584,651,140,226,82,52,328,199,129,39,29,27,14,0
45604,711,330,381,111,86,86,34,1166,514,652,150,159,107,70,0
45605,502,236,266,66,66,58,17,171,94,77,24,28,30,11,0
45606,369,207,162,67,35,16,14,218,118,100,33,30,25,11,0
45607,392,221,171,53,30,25,8,373,181,192,54,35,44,20,0
45608,236,120,116,32,28,21,11,359,171,188,49,74,45,11,0
45609,86,50,36,9,14,8,7,364,189,175,58,41,35,17,0
45610,415,217,198,50,31,42,17,296,151,145,45,42,32,11,0
45611,2236,1195,1041,227,187,186,118,627,323,304,81,90,53,27,0
45612,584,297,287,89,80,65,17,482,232,250,77,81,44,13,0
45613,753,361,392,99,94,66,16,450,241,209,67,58,54,23,0
45614,485,183,302,79,81,73,33,434,213,221,77,62,53,12,0
45615,2048,855,1193,297,287,191,93,277,145,132,41,32,22,10,0
45616,341,154,187,34,36,11,11,127,64,63,26,8,12,8,0
45617,464,237,227,64,66,33,12,68,36,32,11,8,9,2,0
45618,418,163,255,57,54,38,24,332,180,152,46,36,28,14,0
45619,615,308,307,83,75,58,32,396,199,197,54,50,45,14,0
45620,225,111,114,38,22,25,10,137,72,65,27,13,15,8,0
45621,580,240,340,108,81,59,22,277,138,139,40,39,20,14,0
45622,466,259,207,59,50,83,12,404,190,214,55,55,35,27,0
45623,1064,495,569,157,159,124,58,535,288,247,79,72,35,21,0
45624,805,338,467,153,138,99,55,425,177,248,60,62,33,16,0
45625,298,141,157,51,33,21,22,439,231,208,65,51,55,17,0
45626,524,361,163,41,8,28,16,498,244,254,81,67,58,19,0
45627,257,132,125,39,27,26,10,704,355,349,113,94,71,24,0
45628,240,98,142,49,42,23,17,846,425,421,125,97,98,38,0
45629,233,107,126,40,40,20,16,72,32,40,8,2,2,13,0
45630,86,50,36,9,14,8,7,149,77,72,37,10,20,5,0
45631,179,78,101,29,22,10,8,810,310,500,164,162,42,26,0
45632,722,390,332,125,69,67,25,290,142,148,41,37,43,11,0
45633,422,207,215,79,38,53,23,194,94,100,33,28,14,7,0
45634,1276,607,669,192,178,136,63,497,227,270,70,63,66,30,0
45635,341,154,187,34,36,11,11,375,211,164,50,36,31,23,0
45636,222,110,112,43,30,14,6,748,359,389,125,113,86,31,0
45637,500,245,255,66,57,52,27,384,212,172,44,43,34,14,0
45638,622,354,268,89,60,64,18,337,152,185,49,54,42,21,0
45639,927,457,470,130,99,118,42,277,124,153,44,40,35,18,0
45640,760,405,355,112,95,92,29,297,175,122,46,30,31,6,0
45641,798,364,434,133,88,74,35,366,204,162,47,41,31,23,0
45642,334,155,179,47,34,38,11,320,168,152,38,42,24,18,0
45643,665,341,324,109,79,38,22,514,262,252,78,58,54,26,0
45644,454,230,224,63,56,38,33,209,119,90,28,24,27,9,0
45645,244,104,140,52,31,30,14,374,202,172,50,39,31,24,0
45646,275,125,150,37,48,27,7,346,196,150,43,26,27,14,0
45647,369,166,203,59,55,41,14,245,121,124,37,35,36,12,0
45648,736,320,416,113,97,61,36,180,108,72,22,22,15,5,0
45649,1544,738,806,239,217,145,91,375,211,164,50,36,31,23,0
45650,879,457,422,93,98,143,32,292,155,137,50,34,29,13,0
45651,106,43,63,28,13,8,1,374,202,172,50,39,31,24,0
45652,514,226,288,71,66,63,32,348,212,136,53,31,25,18,0
45653,519,259,260,86,78,59,22,701,380,321,94,84,96,34,0
45654,782,372,410,127,111,89,36,504,272,232,75,57,53,19,0
45655,451,225,226,69,57,64,22,846,425,421,125,97,98,38,0
45656,325,186,139,49,36,20,5,662,373,289,89,80,77,29,0
45657,952,547,405,95,90,127,35,344,190,154,34,31,36,10,0
45658,854,435,419,118,91,95,42,218,118,100,33,30,25,11,0
45659,496,272,224,70,58,42,18,671,321,350,95,87,75,34,0
45660,143,81,62,28,9,8,1,119,57,62,18,16,17,4,0
45661,784,353,431,56,47,26,18,332,180,152,46,36,28,14,0
45662,385,203,182,47,43,51,21,778,391,387,94,77,41,33,0
45663,343,189,154,44,24,39,12,535,311,224,66,52,49,24,0
45664,125,53,72,18,21,18,12,496,251,245,78,62,61,23,0
45665,301,157,144,31,28,34,9,565,237,328,75,88,32,11,0
45666,532,291,241,83,36,79,25,381,196,185,55,57,43,16,0
45667,1499,864,635,141,99,76,110,393,210,183,58,37,34,20,0
45668,837,443,394,129,89,87,38,386,207,179,43,48,44,19,0
45669,469,221,248,49,60,55,21,873,411,462,132,107,84,40,0
45670,281,154,127,45,31,24,9,142,65,77,30,17,22,9,0
45671,398,186,212,76,70,18,13,128,63,65,30,11,13,8,0
45672,323,156,167,52,45,39,18,619,305,314,85,93,71,29,0
45673,474,250,224,58,47,37,12,277,144,133,42,30,41,8,0
45674,362,174,188,46,55,35,23,201,104,97,36,32,24,7,0
45675,257,132,125,39,27,26,10,396,199,197,54,50,45,14,0
45676,109,50,59,12,12,9,3,403,184,219,75,51,47,20,0
45677,1257,464,793,221,264,75,37,729,358,371,116,99,89,33,0
45678,259,119,140,48,28,29,19,295,160,135,42,37,46,16,0
45679,442,254,188,46,22,40,19,1113,480,633,170,173,81,34,0
45680,651,357,294,81,67,103,18,305,161,144,39,40,44,17,0
45681,410,200,210,60,54,46,19,773,389,384,119,91,79,26,0
45682,246,123,123,40,31,27,7,230,113,117,31,40,28,10,0
45683,900,434,466,134,97,86,36,264,138,126,33,34,29,12,0
45684,475,208,267,84,67,50,20,437,221,216,62,64,47,13,0
45685,350,172,178,61,45,32,13,1873,935,938,233,225,203,79,0
45686,833,295,538,146,139,65,34,106,54,52,12,9,7,6,0
45687,246,123,123,40,31,27,7,929,459,470,140,120,94,45,0
45688,207,93,114,20,33,19,10,520,272,248,60,65,58,22,0
45689,122,56,66,26,13,11,5,470,205,265,71,80,33,11,0
45690,404,197,207,60,48,47,20,352,207,145,40,33,25,21,0
45691,361,183,178,50,54,51,22,445,264,181,35,35,34,14,0
45692,626,308,318,105,89,77,25,188,101,87,20,18,20,14,0
45693,336,134,202,51,64,27,12,91,42,49,21,9,8,3,0
45694,125,57,68,31,10,10,3,349,200,149,41,39,30,20,0
45695,548,310,238,72,62,54,13,326,149,177,51,51,28,10,0
45696,1199,589,610,189,128,167,65,127,54,73,11,33,15,6,0
45697,853,400,453,137,109,88,42,1873,935,938,233,225,203,79,0
45698,2696,1169,1527,432,347,193,146,427,251,176,51,39,25,22,0
45699,465,220,245,88,34,61,23,627,323,304,81,90,53,27,0
45700,1342,640,702,187,163,123,57,1323,690,633,132,178,112,61,0
45701,255,126,129,41,37,13,5,516,245,271,82,84,70,26,0
45702,451,225,226,69,57,64,22,427,251,176,51,39,25,22,0
45703,228,105,123,34,43,20,10,963,455,508,127,130,115,48,0
45704,323,156,167,52,45,39,18,778,391,387,94,77,41,33,0
45705,341,195,146,42,21,36,9,462,229,233,63,49,42,18,0
45706,526,268,258,54,37,55,12,128,63,65,30,11,13,8,0
45707,303,147,156,49,49,20,8,404,190,214,55,55,35,27,0
45708,314,178,136,42,32,30,17,663,360,303,87,82,80,35,0
45709,484,261,223,59,48,49,24,256,141,115,32,22,32,8,0
45710,442,254,188,46,22,40,19,106,41,65,36,6,11,7,0
45711,326,156,170,60,47,43,5,470,205,265,71,80,33,11,0
45712,494,233,261,87,57,46,18,334,181,153,41,40,25,15,0
45713,410,188,222,53,52,31,14,547,295,252,81,65,57,23,0
45714,801,331,470,151,139,99,55,305,161,144,39,40,44,17,0
45715,388,244,144,46,25,42,16,582,264,318,84,60,58,23,0
45716,288,142,146,52,32,26,8,425,177,248,60,62,33,16,0
45717,1052,492,560,184,163,103,44,375,176,199,48,61,40,12,0
45718,241,122,119,27,34,17,16,187,89,98,36,24,20,6,0
45719,359,204,155,39,36,34,13,1248,584,664,184,164,155,67,0
45720,346,208,138,46,39,51,18,2202,1121,1081,338,274,269,81,0
45721,2109,999,1110,332,294,187,89,452,231,221,74,53,56,20,0
45722,414,195,219,51,60,40,17,708,328,380,113,100,82,34,0
45723,802,430,372,65,102,87,23,380,178,202,69,53,37,10,0
45724,798,287,511,126,125,77,26,457,242,215,39,46,53,10,0
45725,2799,1324,1475,369,371,215,124,479,215,264,67,80,46,28,0
45726,1235,584,651,140,226,82,52,508,261,247,65,53,58,23,0
45727,2414,1189,1225,277,178,170,169,548,273,275,84,81,64,30,0
45728,808,366,442,130,133,66,31,266,146,120,41,28,31,7,0
45729,1042,529,513,161,151,103,52,235,119,116,31,26,15,13,0
45730,109,50,59,12,12,9,3,406,202,204,54,51,63,21,0
45731,364,192,172,49,36,39,14,559,317,242,58,65,37,23,0
45732,674,318,356,86,139,50,11,400,187,213,56,59,42,20,0
45733,157,62,95,41,18,10,11,188,105,83,25,17,24,7,0
45734,282,96,186,80,21,28,7,297,164,133,45,39,40,9,0
45735,473,265,208,47,26,50,30,1101,626,475,145,122,120,50,0
45736,317,153,164,39,30,35,13,736,318,418,96,108,72,37,0
45737,752,313,439,121,106,68,27,389,210,179,51,37,43,9,0
45738,467,233,234,83,37,77,22,72,33,39,8,2,3,12,0
45739,496,210,286,111,55,74,13,125,66,59,24,16,11,5,0
45740,727,426,301,79,71,64,32,1265,689,576,169,177,128,60,0
45741,525,302,223,56,48,67,19,274,157,117,40,29,40,8,0
45742,508,251,257,74,53,51,18,368,200,168,54,49,43,9,0
45743,346,174,172,36,43,21,9,375,176,199,48,61,40,12,0
45744,1390,585,805,241,230,118,46,178,99,79,31,19,26,8,0
45745,1498,731,767,220,175,148,68,325,172,153,44,34,27,14,0
45746,1011,559,452,121,97,132,33,244,143,101,31,29,26,8,0
45747,346,209,137,46,37,44,10,68,23,45,12,9,3,9,0
45748,553,276,277,88,61,45,27,370,190,180,60,52,37,13,0
45749,204,103,101,16,32,22,8,123,61,62,17,18,17,7,0
45750,520,231,289,89,59,58,26,375,209,166,50,37,29,23,0
45751,178,87,91,20,32,13,10,199,105,94,27,27,28,9,0
45752,134,60,74,19,13,10,7,148,84,64,30,7,17,4,0
45753,743,377,366,87,74,68,30,405,195,210,57,74,24,17,0
45754,308,129,179,44,60,19,8,723,353,370,120,109,96,33,0
45755,1647,794,853,279,235,128,65,395,169,226,73,55,38,9,0
45756,643,284,359,129,71,84,43,601,278,323,124,87,65,21,0
45757,626,308,318,105,89,77,25,439,227,212,60,55,58,8,0
45758,445,231,214,45,64,53,23,843,391,452,139,104,91,35,0
45759,1105,544,561,165,167,99,40,314,151,163,42,61,39,16,0
45760,221,75,146,68,21,16,5,293,142,151,49,40,42,17,0
45761,658,349,309,77,70,73,35,2382,1162,1220,237,220,140,49,0
45762,341,177,164,57,42,40,18,798,385,413,120,115,79,30,0
45763,308,163,145,38,33,30,20,497,227,270,70,63,66,30,0
45764,2136,1063,1073,317,308,223,90,565,264,301,101,73,72,15,0
45765,1098,519,579,182,159,79,42,701,380,321,94,84,96,34,0
45766,272,141,131,45,29,36,9,286,152,134,38,38,32,11,0
45767,299,151,148,35,34,26,16,296,140,156,49,40,42,19,0
45768,251,131,120,49,35,25,5,501,249,252,77,70,55,22,0
45769,288,104,184,80,30,39,6,744,385,359,105,96,57,31,0
45770,509,246,263,84,71,56,22,504,272,232,75,57,53,19,0
45771,450,231,219,77,50,76,16,483,287,196,71,50,54,17,0
45772,553,276,277,88,61,45,27,430,212,218,88,43,40,20,0
45773,343,189,154,44,24,39,12,373,189,184,54,46,50,23,0
45774,911,489,422,121,98,97,36,461,223,238,45,62,18,35,0
45775,466,199,267,86,59,32,17,256,141,115,32,22,32,8,0
45776,3703,1708,1995,456,428,305,162,228,130,98,35,29,30,10,0
45777,246,111,135,64,47,27,3,172,79,93,34,27,23,10,0
45778,376,249,127,47,23,43,16,741,383,358,92,63,79,36,0
45779,299,128,171,57,40,13,25,399,190,209,61,41,39,18,0
45780,350,190,160,48,25,27,18,520,244,276,91,60,68,20,0
45781,246,111,135,64,47,27,3,663,360,303,87,82,80,35,0
45782,269,156,113,37,32,17,7,405,181,224,71,57,31,12,0
45783,524,262,262,62,72,39,49,387,193,194,60,53,57,15,0
45784,802,375,427,133,103,81,41,229,120,109,31,30,22,9,0
45785,583,279,304,99,71,59,31,663,360,303,87,82,80,35,0
45786,869,489,380,110,77,79,29,204,96,108,31,37,20,5,0
45787,309,137,172,51,50,28,14,663,354,309,91,84,79,31,0
45788,172,98,74,20,21,22,8,858,398,460,126,138,75,39,0
45789,908,324,584,181,162,81,29,1262,653,609,169,165,152,50,0
45790,629,338,291,92,57,64,22,87,38,49,23,10,10,9,0
45791,411,202,209,60,67,57,24,605,283,322,94,72,64,39,0
45792,539,283,256,75,73,53,26,422,237,185,53,47,62,20,0
45793,224,108,116,33,26,32,10,260,133,127,43,32,39,3,0
45794,1099,491,608,163,141,107,62,227,130,97,32,25,22,12,0
45795,784,351,433,118,87,73,41,627,323,304,81,90,53,27,0
45796,1501,679,822,251,196,174,67,144,67,77,28,14,9,8,0
45797,222,110,112,43,30,14,6,319,185,134,42,31,22,13,0
45798,163,70,93,28,21,17,6,330,166,164,55,51,36,16,0
45799,115,62,53,13,10,9,7,2542,1245,1297,285,287,170,84,0
45800,378,202,176,34,32,44,13,370,190,180,60,52,37,13,0
45801,365,210,155,46,30,24,12,271,150,121,39,36,37,5,0
45802,862,384,478,127,110,75,42,1873,935,938,233,225,203,79,0
45803,282,84,198,60,102,1,6,1606,753,853,215,227,182,48,0
45804,385,203,182,47,43,51,21,397,234,163,44,38,23,21,0
45805,388,244,144,46,25,42,16,166,78,88,27,25,19,7,0
45806,510,288,222,44,36,24,7,285,146,139,41,41,48,13,0
45807,109,50,59,12,12,9,3,406,234,172,63,35,43,10,0
45808,368,154,214,80,52,41,16,188,105,83,25,17,24,7,0
45809,756,265,491,129,127,51,17,600,254,346,104,100,44,17,0
45810,431,199,232,59,54,40,17,317,161,156,40,49,41,11,0
45811,109,42,67,25,13,1,1,1537,701,836,209,187,129,58,0
45812,243,100,143,58,50,24,5,403,225,178,56,38,33,25,0
45813,820,333,487,202,152,59,23,469,225,244,64,68,25,11,0
45814,786,378,408,106,98,77,39,180,89,91,28,27,18,7,0
45815,390,199,191,72,42,35,12,218,117,101,35,32,34,12,0
45816,641,349,292,92,60,39,24,528,276,252,86,78,49,17,0
45817,640,279,361,102,83,69,21,326,149,177,51,51,28,10,0
45818,159,105,54,22,9,14,25,741,383,358,92,63,79,36,0
45819,478,177,301,109,66,59,25,1279,669,610,164,162,104,55,0
45820,490,198,292,65,81,39,27,105,51,54,13,17,12,8,0
45821,536,287,249,64,73,21,27,1004,457,547,150,150,74,52,0
45822,496,272,224,70,58,42,18,231,126,105,37,26,29,6,0
45823,1217,647,570,142,160,129,45,198,115,83,30,22,8,8,0
45824,369,166,203,59,55,41,14,139,68,71,14,26,14,9,0
45825,674,318,356,86,139,50,11,198,113,85,19,20,26,12,0
45826,479,227,252,69,48,46,18,663,354,309,91,84,79,31,0
45827,410,211,199,55,42,34,27,266,146,120,41,28,31,7,0
45828,76,30,46,7,15,1,5,89,38,51,14,6,3,9,0
45829,639,368,271,72,51,38,38,320,168,152,38,42,24,18,0
45830,603,311,292,102,71,66,23,373,213,160,44,33,26,17,0
45831,911,489,422,121,98,97,36,2547,1280,1267,331,335,293,118,0
45832,1970,978,992,245,206,198,80,406,202,204,54,51,63,21,0
45833,785,375,410,100,116,66,39,657,326,331,80,81,53,31,0
45834,739,323,416,127,89,76,33,873,411,462,132,107,84,40,0
45835,261,148,113,23,29,26,21,392,155,237,68,61,34,16,0
45836,708,344,364,106,98,66,33,348,212,136,53,31,25,18,0
45837,262,133,129,44,38,31,12,798,385,413,120,115,79,30,0
45838,615,308,307,83,75,58,32,663,354,309,91,84,79,31,0
45839,373,164,209,51,45,44,21,708,328,380,113,100,82,34,0
45840,407,164,243,88,42,40,22,222,122,100,39,32,24,9,0
45841,483,236,247,82,60,43,18,671,306,365,114,76,49,19,0
45842,178,87,91,20,32,13,10,744,385,359,105,96,57,31,0
45843,282,160,122,36,28,27,7,166,88,78,23,18,13,7,0
45844,1163,417,746,209,145,87,28,663,360,303,87,82,80,35,0
45845,220,121,99,28,26,17,6,501,249,252,77,70,55,22,0
45846,126,56,70,31,10,10,3,419,233,186,54,53,55,17,0
45847,535,217,318,87,106,41,14,201,104,97,36,32,24,7,0
45848,261,148,113,23,29,26,21,445,192,253,86,58,53,18,0
45849,417,176,241,75,61,51,20,54,26,28,11,4,3,3,0
45850,527,276,251,64,60,70,20,198,86,112,36,27,23,9,0
45851,316,157,159,45,38,22,19,346,178,168,58,41,33,12,0
45852,684,353,331,95,98,77,38,341,170,171,41,66,27,10,0
45853,288,142,146,52,32,26,8,201,104,97,36,32,24,7,0
45854,181,92,89,34,22,17,9,330,166,164,55,51,36,16,0
45855,215,80,135,54,56,21,9,330,166,164,55,51,36,16,0
45856,381,146,235,74,48,47,34,178,99,79,31,19,26,8,0
45857,919,444,475,141,148,62,20,166,90,76,27,18,21,5,0
45858,469,253,216,49,51,48,18,316,166,150,45,38,37,13,0
45859,539,283,256,75,73,53,26,137,63,74,20,22,14,6,0
45860,325,186,139,49,36,20,5,741,383,358,92,63,79,36,0
45861,380,185,195,68,54,32,16,134,55,79,22,24,16,6,0
45862,484,194,290,70,93,47,16,821,394,427,122,117,109,38,0
45863,517,245,272,92,77,46,24,377,184,193,50,43,33,17,0
45864,128,70,58,29,9,8,1,732,402,330,81,86,87,33,0
45865,626,300,326,91,82,68,26,207,114,93,33,20,31,13,0
45866,894,448,446,123,100,82,30,405,214,191,53,42,49,20,0
45867,478,177,301,109,66,59,25,665,361,304,87,91,84,31,0
45868,275,125,150,37,48,27,7,137,78,59,22,16,17,4,0
45869,2525,1232,1293,398,317,186,61,660,303,357,97,89,85,33,0
45870,726,312,414,121,73,82,23,1262,653,609,169,165,152,50,0
45871,521,249,272,53,36,50,18,756,348,408,101,103,60,40,0
45872,305,124,181,27,25,32,21,972,471,501,152,138,112,40,0
45873,156,64,92,31,19,5,4,201,99,102,34,26,23,6,0
45874,535,217,318,87,106,41,14,393,210,183,58,37,34,20,0
45875,1542,682,860,290,158,120,47,597,269,328,102,84,69,24,0
45876,450,231,219,77,50,76,16,87,38,49,23,10,10,9,0
45877,1041,497,544,180,167,98,34,106,41,65,36,6,11,7,0
45878,261,148,113,23,29,26,21,392,214,178,48,40,53,22,0
45879,360,205,155,35,24,52,14,134,55,79,22,24,16,6,0
45880,543,221,322,78,122,37,12,650,330,320,93,93,51,28,0
45881,650,330,320,93,93,51,28,873,366,507,127,125,75,21,0
45882,111,29,82,10,54,0,1,172,88,84,24,31,20,12,0
45883,376,171,205,45,45,34,12,225,111,114,32,34,32,16,0
45884,629,338,291,92,57,64,22,673,313,360,102,101,46,17,0
45885,840,411,429,122,101,79,34,621,273,348,104,102,48,19,0
45886,346,191,155,52,38,40,13,432,244,188,51,51,27,14,0
45887,641,349,292,92,60,39,24,418,246,172,52,39,57,10,0
45888,250,123,127,40,28,29,8,475,251,224,67,49,48,23,0
45889,345,203,142,47,35,31,11,400,187,213,56,59,42,20,0
45890,236,120,116,32,28,21,11,136,65,71,26,11,7,5,0
45891,3859,2011,1848,535,391,422,207,153,80,73,26,18,19,4,0
45892,1462,711,751,219,222,148,65,509,267,242,79,81,38,20,0
45893,478,220,258,47,70,41,10,375,211,164,50,36,31,23,0
45894,414,195,219,51,60,40,17,1500,804,696,190,172,144,60,0
45895,429,238,191,47,49,56,29,166,102,64,19,14,17,2,0
45896,2442,1193,1249,278,183,170,145,274,142,132,33,34,18,14,0
45897,136,65,71,33,11,9,6,461,223,238,45,62,18,35,0
45898,361,177,184,59,51,24,15,194,109,85,23,24,21,9,0
45899,407,207,200,53,36,38,8,378,154,224,74,84,35,22,0
45900,2136,1063,1073,317,308,223,90,165,90,75,36,18,20,6,0
45901,376,176,200,31,53,27,8,277,145,132,41,32,22,10,0
45902,465,305,160,40,47,34,9,160,60,100,23,40,19,11,0
45903,470,163,307,99,68,73,30,501,240,261,80,62,49,42,0
45904,206,96,110,33,25,8,6,138,69,69,28,7,10,10,0
45905,318,161,157,53,51,32,13,381,196,185,55,57,43,16,0
45906,238,91,147,68,19,22,7,368,204,164,43,35,30,24,0
45907,747,469,278,60,41,53,23,257,126,131,61,24,22,8,0
45908,338,173,165,31,42,22,10,289,140,149,33,42,30,15,0
45909,375,167,208,55,83,44,9,475,251,224,67,49,48,23,0
45910,315,111,204,82,66,46,11,234,129,105,31,22,19,17,0
45911,434,221,213,58,47,54,15,693,360,333,100,88,62,26,0
45912,480,232,248,73,40,44,30,192,110,82,33,21,10,3,0
45913,577,342,235,63,57,23,37,1507,737,770,188,228,147,71,0
45914,429,238,191,47,49,56,29,87,51,35,15,9,9,4,0
45915,250,123,127,40,28,29,8,194,94,100,33,28,14,7,0
45916,376,171,205,45,45,34,12,483,215,268,66,70,30,16,0
45917,476,199,277,82,80,49,24,173,86,87,30,22,19,12,0
45918,933,456,477,123,108,83,29,405,181,224,71,57,31,12,0
45919,1107,601,506,155,138,103,49,601,279,322,81,65,27,12,0
45920,861,393,468,150,101,69,35,846,425,421,125,97,98,38,0
45921,496,210,286,112,55,71,14,160,76,84,19,24,8,5,0
45922,1284,511,773,227,166,169,107,547,295,252,81,65,57,23,0
45923,270,147,123,34,17,39,21,158,71,87,23,21,17,12,0
45924,475,235,240,77,58,43,22,260,131,129,42,31,40,9,0
45925,521,249,272,53,36,50,18,1395,627,768,172,263,141,59,0
45926,378,202,176,34,32,44,13,286,160,126,37,27,23,10,0
45927,764,277,487,158,162,64,31,106,46,60,29,13,14,5,0
45928,704,342,362,113,91,85,33,261,148,113,31,28,14,10,0
45929,483,236,247,82,60,43,18,661,325,336,81,75,65,28,0
45930,176,74,102,20,29,7,7,447,212,235,86,55,58,21,0
45931,425,199,226,54,71,56,11,873,411,462,132,107,84,40,0
45932,710,352,358,104,86,84,41,303,138,165,47,46,35,18,0
45933,520,240,280,87,63,67,16,405,181,224,71,57,31,12,0
45934,600,324,276,89,73,45,39,169,84,85,29,19,21,7,0
45935,607,305,302,92,89,74,23,220,107,113,36,35,28,9,0
45936,2136,1063,1073,317,308,223,90,187,89,98,36,24,20,6,0
45937,613,303,310,70,28,28,18,405,195,210,57,74,24,17,0
45938,508,267,241,43,35,25,17,129,60,69,21,15,8,5,0
45939,262,133,129,44,38,31,12,370,173,197,65,57,42,10,0
45940,350,172,178,61,45,32,13,399,190,209,61,41,39,18,0
45941,667,366,301,96,55,84,25,898,469,429,125,125,134,35,0
45942,130,72,58,28,9,7,1,555,282,273,82,69,65,21,0
45943,802,430,372,65,102,87,23,597,269,328,102,84,69,24,0
45944,648,376,272,70,60,73,24,125,66,59,24,16,11,5,0
45945,279,129,150,43,34,17,13,152,71,81,41,16,14,2,0
45946,465,305,160,40,47,34,9,1034,495,539,150,134,114,71,0
45947,436,201,235,54,37,35,18,467,231,236,71,65,58,18,0
45948,227,109,118,42,35,29,8,266,146,120,41,28,31,7,0
45949,348,198,150,57,25,37,18,622,344,278,80,77,68,36,0
45950,392,221,171,53,30,25,8,349,200,149,41,39,30,20,0
45951,259,119,140,48,28,29,19,274,142,132,33,34,18,14,0
45952,502,274,228,64,49,75,17,196,105,91,40,13,19,10,0
45953,1441,504,937,264,329,69,46,286,152,134,38,38,32,11,0
45954,1189,653,536,152,118,109,56,289,140,149,33,42,30,15,0
45955,325,177,148,40,24,23,13,108,59,49,17,13,12,5,0
45956,447,236,211,56,52,49,14,579,285,294,78,72,64,32,0
45957,340,181,159,44,39,35,21,497,227,270,70,63,66,30,0
45958,265,165,100,32,19,27,5,354,183,171,54,43,49,8,0
45959,1755,849,906,245,226,148,56,319,185,134,42,31,22,13,0
45960,204,93,111,35,35,16,11,975,475,500,139,140,119,28,0
45961,2286,1154,1132,338,314,278,103,198,113,85,19,20,26,12,0
45962,610,249,361,107,69,72,33,464,236,228,64,56,53,28,0
45963,130,70,60,30,9,8,1,535,311,224,66,52,49,24,0
45964,126,57,69,31,10,10,3,531,261,270,73,80,68,26,0
45965,595,316,279,86,60,65,40,2724,1157,1567,269,518,239,77,0
45966,629,374,255,74,53,87,27,380,178,202,69,53,37,10,0
45967,666,204,462,110,194,42,14,139,68,71,14,26,14,9,0
45968,213,113,100,26,21,26,12,906,455,451,116,105,87,46,0
45969,483,236,247,82,60,43,18,89,51,38,15,15,5,4,0
45970,435,225,210,58,46,50,14,1062,522,540,151,147,105,66,0
45971,298,141,157,51,33,21,22,295,160,135,44,36,46,16,0
45972,136,66,70,33,11,9,3,180,108,72,22,22,15,5,0
45973,439,205,234,64,88,41,21,1239,659,580,169,148,131,54,0
45974,143,81,62,28,9,8,1,180,115,65,17,12,9,9,0
45975,126,57,69,31,10,10,3,359,171,188,49,74,45,11,0
45976,507,314,193,49,45,59,25,481,223,258,71,70,49,26,0
45977,240,98,142,49,42,23,17,134,72,62,14,28,8,4,0
45978,525,254,271,60,76,46,13,166,90,76,27,18,21,5,0
45979,374,202,172,58,40,41,7,1208,565,643,182,162,120,57,0
45980,134,60,74,19,13,10,7,1154,489,665,200,196,95,54,0
45981,119,67,52,15,15,7,7,179,101,78,25,15,13,13,0
45982,249,104,145,47,41,24,17,368,200,168,54,49,43,9,0
45983,963,477,486,134,143,123,38,376,183,193,50,50,43,21,0
45984,117,58,59,17,17,12,2,421,222,199,69,50,60,18,0
45985,415,217,198,50,31,42,17,390,190,200,66,50,43,12,0
45986,467,233,234,83,37,77,22,173,90,83,21,36,12,15,0
45987,475,208,267,84,67,50,20,1001,417,584,186,147,96,47,0
45988,554,217,337,112,72,90,38,582,264,318,84,60,58,23,0
45989,1718,735,983,266,225,130,68,209,119,90,28,24,27,9,0
45990,196,107,89,20,31,17,4,169,74,95,33,26,22,3,0
45991,220,113,107,37,24,16,7,98,49,49,14,15,9,2,0
45992,342,185,157,42,27,31,14,518,292,226,60,60,52,21,0
45993,531,259,272,75,81,39,13,601,279,322,81,65,27,12,0
45994,413,236,177,41,25,35,19,445,264,181,35,35,34,14,0
45995,117,58,59,17,17,12,2,362,156,206,74,42,36,22,0
45996,399,196,203,62,45,38,19,723,363,360,107,106,52,14,0
45997,629,338,291,92,57,64,22,196,105,91,40,13,19,10,0
45998,139,64,75,18,17,18,4,277,152,125,31,35,22,19,0
45999,441,218,223,69,55,50,27,541,279,262,79,82,31,32,0
46000,365,210,155,46,30,24,12,1034,495,539,150,134,114,71,0
46001,1120,436,684,208,120,101,115,732,366,366,108,86,74,41,0
46002,220,121,99,28,26,17,6,1034,495,539,150,134,114,71,0
46003,118,51,67,25,13,6,7,501,240,261,80,62,49,42,0
46004,1214,612,602,169,173,98,35,496,251,245,78,62,61,23,0
46005,1390,705,685,219,164,129,74,303,137,166,54,54,31,15,0
46006,900,434,466,134,97,86,36,374,202,172,50,39,31,24,0
46007,213,104,109,56,14,9,2,1338,720,618,179,145,141,85,0
46008,117,58,59,17,17,12,2,153,80,73,26,18,19,4,0
46009,121,69,52,15,18,14,8,317,161,156,40,49,41,11,0
46010,470,163,307,99,68,73,30,1873,935,938,233,225,203,79,0
46011,238,91,147,68,19,22,7,404,190,214,55,55,35,27,0
46012,496,274,222,57,43,75,22,487,252,235,79,58,55,26,0
46013,463,225,238,76,36,59,26,627,289,338,101,73,62,43,0
46014,407,164,243,88,42,40,22,234,116,118,34,35,23,9,0
46015,406,208,198,41,26,43,21,504,272,232,75,57,53,19,0
46016,593,282,311,75,70,29,25,225,114,111,32,29,26,6,0
46017,795,384,411,133,109,85,38,230,125,105,29,40,20,6,0
46018,127,55,72,25,18,5,7,404,190,214,55,55,35,27,0
46019,822,416,406,111,97,88,42,497,257,240,71,63,62,16,0
46020,1498,731,767,220,175,148,68,455,191,264,68,86,21,19,0
46021,233,107,126,40,40,20,16,165,90,75,36,18,20,6,0
46022,733,382,351,126,92,93,27,194,109,85,23,24,21,9,0
46023,270,166,104,30,26,28,14,251,143,108,47,25,29,11,0
46024,493,208,285,75,77,70,40,2542,1245,1297,285,287,170,84,0
46025,580,265,315,97,89,79,17,103,50,53,19,10,7,5,0
46026,928,442,486,139,118,91,43,1873,935,938,233,225,203,79,0
46027,795,384,411,133,109,85,38,1873,935,938,233,225,203,79,0
46028,1616,735,881,285,248,153,72,309,159,150,47,43,43,13,0
46029,674,318,356,86,139,50,11,328,199,129,39,29,27,14,0
46030,840,411,429,122,101,79,34,524,300,223,70,54,51,25,0
46031,619,289,330,67,77,36,19,160,76,84,19,24,8,5,0
46032,462,233,229,66,49,43,30,858,461,397,125,114,79,45,0
46033,808,366,442,130,133,66,31,362,156,206,74,42,36,22,0
46034,1960,875,1085,287,189,162,66,457,253,204,67,51,48,13,0
46035,1163,417,746,209,145,87,28,397,223,174,50,39,29,17,0
46036,441,218,223,69,55,50,27,406,202,204,54,51,63,21,0
46037,443,212,231,74,24,60,24,403,221,182,62,50,42,12,0
46038,178,87,91,20,32,13,10,1700,731,969,198,233,110,87,0
46039,1616,735,881,285,248,153,72,508,261,247,65,53,58,23,0
46040,279,106,173,48,35,41,39,298,129,169,51,40,29,8,0
46041,2285,1219,1066,207,180,178,106,424,179,245,65,67,29,11,0
46042,233,107,126,40,40,20,16,295,158,137,42,34,38,14,0
46043,282,84,198,60,102,1,6,288,156,132,36,36,24,15,0
46044,213,113,100,26,21,26,12,427,251,176,51,39,25,22,0
46045,410,209,201,72,30,48,22,301,168,133,49,37,34,11,0
46046,469,253,216,49,51,48,18,579,285,294,78,72,64,32,0
46047,395,189,206,63,50,49,28,483,287,196,71,50,54,17,0
46048,507,314,193,49,45,59,25,1040,564,476,134,110,114,51,0
46049,328,156,172,44,37,44,15,148,84,64,30,7,17,4,0
46050,228,105,123,34,43,20,10,352,207,145,40,33,25,21,0
46051,828,368,460,118,98,59,38,283,160,123,25,20,37,9,0
46052,117,58,59,17,17,12,2,87,51,35,15,9,9,4,0
46053,1464,693,771,153,136,91,86,337,152,185,49,54,42,21,0
46054,193,110,83,18,20,15,12,332,180,152,44,36,27,13,0
46055,399,220,179,48,37,68,18,751,394,357,107,96,73,35,0
46056,519,245,274,58,61,34,22,375,209,166,50,37,29,23,0
46057,57,24,33,11,3,5,3,286,152,134,38,38,32,11,0
46058,464,237,227,64,66,33,12,422,202,220,80,52,57,18,0
46059,429,227,202,49,51,46,26,414,203,211,58,56,48,14,0
46060,618,289,329,97,86,70,17,364,189,175,58,41,35,17,0
46061,253,133,120,44,31,22,8,464,236,228,64,56,53,28,0
46062,507,242,265,53,44,31,22,531,261,270,73,80,68,26,0
46063,454,214,240,56,71,35,16,137,72,65,27,13,15,8,0
46064,561,282,279,68,62,36,14,257,139,118,64,17,24,7,0
46065,431,216,215,46,40,33,9,295,158,137,42,34,38,14,0
46066,126,57,69,31,10,10,3,279,142,137,43,39,28,7,0
46067,781,316,465,130,129,65,23,873,411,462,132,107,84,40,0
46068,388,244,144,46,25,42,16,194,106,88,33,10,15,6,0
46069,588,317,271,78,49,54,17,437,224,213,40,29,42,25,0
46070,311,154,157,47,29,34,13,204,96,108,31,37,20,5,0
46071,717,281,436,165,81,112,49,514,262,252,78,58,54,26,0
46072,302,178,124,34,29,50,13,470,205,265,71,80,33,11,0
46073,745,402,343,95,71,69,40,536,267,269,60,70,41,22,0
46074,753,361,392,99,94,66,16,720,357,363,113,85,62,39,0
46075,772,417,355,118,92,80,23,246,107,139,55,33,27,11,0
46076,1970,978,992,245,206,198,80,204,80,124,29,51,10,5,0
46077,200,94,106,33,22,18,8,89,37,52,13,6,2,9,0
46078,5890,3314,2576,970,956,293,265,526,266,260,76,75,53,22,0
46079,334,155,179,47,34,38,11,149,52,97,36,36,7,4,0
46080,509,251,258,69,49,55,17,538,274,264,84,67,52,35,0
46081,317,167,150,45,21,30,26,811,361,450,124,107,80,31,0
46082,413,236,177,41,25,35,19,974,457,517,133,117,69,26,0
46083,514,226,288,71,66,63,32,137,85,52,15,11,11,2,0
46084,658,349,309,77,70,73,35,391,189,202,55,56,56,12,0
46085,244,104,140,52,31,30,14,467,231,236,71,65,58,18,0
46086,1221,597,624,201,152,83,31,547,295,252,81,65,57,23,0
46087,348,198,150,57,25,37,18,192,110,82,33,21,10,3,0
46088,249,104,145,47,41,24,17,274,157,117,40,29,40,8,0
46089,552,295,257,67,49,70,30,339,180,159,36,29,16,16,0
46090,570,238,332,112,95,39,23,332,173,159,48,40,31,11,0
46091,743,366,377,41,37,26,14,474,268,206,66,42,45,24,0
46092,123,58,65,22,14,13,3,748,359,389,125,113,86,31,0
46093,869,489,380,110,77,79,29,402,186,216,64,47,38,20,0
46094,512,254,258,70,48,37,32,481,223,258,71,70,49,26,0
46095,281,154,127,45,31,24,9,1352,602,750,166,185,81,70,0
46096,561,282,279,68,62,36,14,479,215,264,67,80,46,28,0
46097,640,271,369,111,79,57,17,149,77,72,37,10,20,5,0
46098,1718,735,983,266,225,130,68,2547,1280,1267,331,335,293,118,0
46099,1054,497,557,190,168,107,45,295,158,137,42,34,38,14,0
46100,625,283,342,93,89,67,25,386,181,205,55,51,57,31,0
46101,853,400,453,137,109,88,42,128,63,65,30,11,13,8,0
46102,4640,2231,2409,660,549,437,245,737,397,340,87,104,90,14,0
46103,416,201,215,54,52,39,25,691,241,450,151,139,24,20,0
46104,121,69,52,15,18,14,8,562,273,289,76,92,45,24,0
46105,781,316,465,130,129,65,23,260,133,127,43,32,39,3,0
46106,159,105,54,22,9,14,25,198,86,112,36,27,23,9,0
46107,894,448,446,123,100,82,30,873,411,462,132,107,84,40,0
46108,312,164,148,54,29,25,15,175,82,93,33,26,17,5,0
46109,822,416,406,111,97,88,42,246,125,121,38,36,30,11,0
46110,164,61,103,47,19,14,5,727,362,365,123,107,63,23,0
46111,421,237,184,47,54,45,10,289,140,149,33,42,30,15,0
46112,411,236,175,39,45,50,30,504,272,232,75,57,53,19,0
46113,341,175,166,48,43,35,18,395,169,226,73,55,38,9,0
46114,579,246,333,102,79,41,19,1114,539,575,145,131,94,56,0
46115,1220,575,645,208,179,99,56,1382,508,874,334,320,98,36,0
46116,242,104,138,41,33,37,8,906,455,451,116,105,87,46,0
46117,919,444,475,141,148,62,20,148,84,64,30,7,17,4,0
46118,552,295,257,67,49,70,30,374,181,193,55,58,48,23,0
46119,414,195,219,51,60,40,17,306,157,149,52,35,39,16,0
46120,240,98,142,49,42,23,17,108,59,49,17,13,12,5,0
46121,286,111,175,51,47,21,12,335,170,165,52,36,47,11,0
46122,338,139,199,54,54,18,11,457,245,212,62,58,57,21,0
46123,520,240,280,87,63,67,16,348,194,154,57,31,43,12,0
46124,1709,650,1059,338,286,185,46,582,264,318,84,60,58,23,0
46125,431,216,215,46,40,33,9,483,215,268,66,70,30,16,0
46126,1849,931,918,245,220,158,90,222,127,95,23,28,22,7,0
46127,207,89,118,56,8,4,3,123,61,62,17,18,17,7,0
46128,1199,589,610,189,128,167,65,403,221,182,62,50,42,12,0
46129,489,253,236,73,36,62,17,384,212,172,44,43,34,14,0
46130,624,222,402,92,81,39,15,459,260,199,56,42,47,21,0
46131,288,142,146,52,32,26,8,331,180,151,46,35,47,17,0
46132,1441,504,937,264,329,69,46,400,187,213,56,59,42,20,0
46133,204,93,111,35,35,16,11,475,251,224,67,49,48,23,0
46134,369,166,203,59,55,41,14,316,166,150,45,38,37,13,0
46135,1124,442,682,148,189,72,43,277,145,132,41,32,22,10,0
46136,643,284,359,129,71,84,43,517,295,222,69,62,40,28,0
46137,325,177,148,40,24,23,13,452,231,221,74,53,56,20,0
46138,454,214,240,56,71,35,16,240,141,99,34,28,29,8,0
46139,250,123,127,40,28,29,8,207,86,121,34,39,11,13,0
46140,245,111,134,36,27,18,6,978,536,442,132,107,67,32,0
46141,301,119,182,53,47,14,20,1020,538,482,145,115,111,58,0
46142,726,312,414,121,73,82,23,375,210,165,49,37,29,27,0
46143,347,154,193,48,51,25,11,200,99,101,31,24,26,6,0
46144,415,217,198,50,31,42,17,175,91,84,19,21,21,10,0
46145,325,152,173,43,47,28,17,144,67,77,28,14,9,8,0
46146,873,366,507,127,125,75,21,350,196,154,52,37,21,14,0
46147,516,224,292,79,29,45,33,142,73,69,27,9,15,11,0
46148,554,217,337,112,72,90,38,432,244,188,51,51,27,14,0
46149,575,295,280,89,68,54,18,131,55,76,28,9,14,12,0
46150,824,391,433,106,90,88,32,457,245,212,62,58,57,21,0
46151,646,304,342,104,93,58,26,261,162,99,24,21,14,10,0
46152,220,113,107,37,24,16,7,2202,1121,1081,338,274,269,81,0
46153,651,357,294,81,67,103,18,276,149,127,34,31,32,10,0
46154,900,434,466,134,97,86,36,136,65,71,26,11,7,5,0
46155,392,205,187,83,49,38,10,203,98,105,34,29,19,10,0
46156,149,78,71,20,20,19,5,397,234,163,44,38,23,21,0
46157,362,174,188,46,55,35,23,89,51,38,15,15,5,4,0
46158,278,104,174,46,34,23,14,483,287,196,71,50,54,17,0
46159,682,260,422,153,78,109,46,134,55,79,22,24,16,6,0
46160,1098,519,579,182,159,79,42,219,105,114,36,29,19,8,0
46161,264,122,142,46,24,35,10,406,223,183,61,53,46,17,0
46162,1447,698,749,214,180,116,46,654,295,359,99,88,71,25,0
46163,616,323,293,98,71,31,15,1922,923,999,267,275,215,90,0
46164,1441,504,937,264,329,69,46,384,212,172,44,43,34,14,0
46165,1098,519,579,182,159,79,42,1154,489,665,200,196,95,54,0
46166,251,139,112,41,18,27,11,374,181,193,55,58,48,23,0
46167,629,374,255,74,53,87,27,478,254,224,67,74,56,28,0
46168,394,207,187,52,42,37,24,274,157,117,40,29,40,8,0
46169,325,152,173,43,47,28,17,471,238,233,66,63,62,19,0
46170,374,187,187,51,52,40,27,647,350,297,95,79,77,29,0
46171,802,430,372,65,102,87,23,111,60,51,17,23,10,7,0
46172,434,216,218,72,58,40,20,376,183,193,50,50,43,21,0
46173,493,281,212,56,61,30,13,715,348,367,109,84,68,30,0
46174,308,129,179,44,60,19,8,373,181,192,54,35,44,20,0
46175,463,250,213,56,45,73,25,966,478,488,108,144,74,43,0
46176,475,208,267,84,67,50,20,389,210,179,51,37,43,9,0
46177,1143,574,569,176,151,123,59,1113,480,633,170,173,81,34,0
46178,801,331,470,151,139,99,55,153,80,73,26,18,19,4,0
46179,267,146,121,40,24,25,7,289,140,149,33,42,30,15,0
46180,588,300,288,100,57,65,27,165,87,78,24,19,22,9,0
46181,204,103,101,16,32,22,8,467,231,236,71,65,58,18,0
46182,347,198,149,45,29,29,8,385,212,173,57,40,39,21,0
46183,339,170,169,32,17,24,13,1543,794,749,182,152,132,55,0
46184,802,430,372,65,102,87,23,467,240,227,65,65,51,23,0
46185,366,190,176,39,62,55,14,380,211,169,47,37,33,21,0
46186,106,43,63,28,13,8,1,390,223,167,58,36,45,18,0
46187,524,262,262,62,72,39,49,403,225,178,56,38,33,25,0
46188,291,120,171,63,39,26,6,509,267,242,79,81,38,20,0
46189,1718,735,983,266,225,130,68,103,59,44,25,2,13,6,0
46190,275,125,150,37,48,27,7,935,515,420,126,107,73,32,0
46191,169,64,105,23,37,11,3,556,290,266,75,74,29,24,0
46192,410,200,210,60,54,46,19,654,295,359,99,88,71,25,0
46193,224,108,116,33,26,32,10,154,78,76,23,21,13,5,0
46194,4128,2104,2024,581,505,453,205,252,130,122,45,23,32,11,0
46195,1051,429,622,179,148,125,54,605,283,322,94,72,64,39,0
46196,313,148,165,45,33,36,11,708,328,380,113,100,82,34,0
46197,136,65,71,33,11,9,6,459,260,199,56,42,47,21,0
46198,471,221,250,87,68,42,25,621,273,348,104,102,48,19,0
46199,1112,457,655,180,164,99,39,1922,923,999,267,275,215,90,0
46200,410,209,201,72,30,48,22,295,160,135,42,37,46,16,0
46201,380,187,193,38,51,30,18,423,234,189,66,44,57,12,0
46202,381,146,235,74,48,47,34,1606,753,853,215,227,182,48,0
46203,859,411,448,118,100,95,49,148,69,79,26,18,16,3,0
46204,227,109,118,42,35,29,8,262,129,133,40,41,31,10,0
46205,255,136,119,39,20,32,10,188,93,95,33,18,16,10,0
46206,598,300,298,68,77,59,21,188,105,83,25,17,24,7,0
46207,837,443,394,129,89,87,38,261,148,113,31,28,14,10,0
46208,490,224,266,80,70,39,32,501,240,261,80,62,49,42,0
46209,758,378,380,89,64,37,31,1262,653,609,169,165,152,50,0
46210,517,245,272,92,77,46,24,449,252,197,61,52,36,18,0
46211,785,325,460,114,123,61,28,131,55,76,28,9,14,12,0
46212,808,366,442,130,133,66,31,222,119,103,37,32,24,8,0
46213,707,250,457,171,84,117,61,621,273,348,104,102,48,19,0
46214,257,132,125,39,27,26,10,406,234,172,63,35,43,10,0
46215,235,100,135,36,25,30,8,497,227,270,70,63,66,30,0
46216,856,429,427,113,105,96,24,792,398,394,109,96,90,39,0
46217,447,236,211,56,52,49,14,374,212,162,48,40,32,23,0
46218,437,167,270,126,95,34,10,339,180,159,36,29,16,16,0
46219,341,154,187,34,36,11,11,153,65,88,28,21,20,8,0
46220,598,300,298,68,77,59,21,708,328,380,113,100,82,34,0
46221,959,496,463,144,132,75,35,418,223,195,53,43,49,15,0
46222,560,279,281,113,64,58,15,98,49,49,14,15,9,2,0
46223,200,103,97,17,16,10,10,671,321,350,95,87,75,34,0
46224,275,160,115,40,31,34,17,300,148,152,45,43,40,8,0
46225,435,222,213,67,49,67,12,350,196,154,52,37,21,14,0
46226,360,175,185,73,36,27,7,481,223,258,71,70,49,26,0
46227,862,384,478,127,110,75,42,165,87,78,24,19,22,9,0
46228,325,181,144,46,31,48,9,137,72,65,27,13,15,8,0
46229,468,233,235,65,61,49,34,234,129,105,31,22,19,17,0
46230,543,265,278,52,37,54,19,359,171,188,49,74,45,11,0
46231,2624,999,1625,415,495,109,84,405,195,210,57,74,24,17,0
46232,640,279,361,102,83,69,21,384,204,180,53,47,49,17,0
46233,516,210,306,113,53,81,33,471,238,233,66,63,62,19,0
46234,554,217,337,112,72,90,38,1321,653,668,186,195,70,35,0
46235,643,284,359,129,71,84,43,396,213,183,68,44,47,18,0
46236,425,220,205,60,55,45,18,425,177,248,60,62,33,16,0
46237,1417,598,819,223,188,135,58,479,215,264,67,80,46,28,0
46238,297,161,136,36,35,24,9,72,33,39,8,2,3,12,0
46239,772,417,355,118,92,80,23,292,155,137,50,34,29,13,0
46240,624,222,402,92,81,39,15,1230,644,586,198,125,123,61,0
46241,840,411,429,122,101,79,34,230,113,117,31,40,28,10,0
46242,461,257,204,63,49,50,29,424,179,245,65,67,29,11,0
46243,305,124,181,27,25,32,21,2346,1231,1115,316,292,266,105,0
46244,432,233,199,52,28,47,18,873,411,462,132,107,84,40,0
46245,332,170,162,44,38,39,10,223,113,110,31,33,22,12,0
46246,423,247,176,58,55,29,20,978,536,442,132,107,67,32,0
46247,733,438,295,95,79,67,32,338,169,169,53,44,39,21,0
46248,417,176,241,75,61,51,20,329,194,135,45,32,33,9,0
46249,204,109,95,21,35,27,7,1606,753,853,215,227,182,48,0
46250,300,136,164,45,35,45,14,297,175,122,46,30,31,6,0
46251,687,351,336,106,67,70,41,267,141,126,53,27,23,7,0
46252,163,70,93,28,21,17,6,246,125,121,38,36,30,11,0
46253,478,220,258,47,70,41,10,282,134,148,38,45,29,10,0
46254,373,194,179,42,54,26,13,337,152,185,49,54,42,21,0
46255,785,325,460,114,123,61,28,262,129,133,40,41,31,10,0
46256,733,382,351,126,92,93,27,415,226,189,51,40,40,29,0
46257,929,410,519,187,146,53,30,647,350,297,95,79,77,29,0
46258,784,351,433,118,87,73,41,528,276,252,86,78,49,17,0
46259,388,244,144,46,25,42,16,597,269,328,102,84,69,24,0
46260,328,195,133,36,23,35,9,723,353,370,120,109,96,33,0
46261,467,233,234,83,37,77,22,607,293,314,98,71,62,32,0
46262,420,248,172,64,30,43,17,483,215,268,66,70,30,16,0
46263,803,358,445,135,117,80,43,397,223,174,50,39,29,17,0
46264,203,80,123,40,37,20,3,261,127,134,36,27,36,4,0
46265,465,220,245,88,34,61,23,531,261,270,73,80,68,26,0
46266,1689,821,868,277,250,177,78,1265,689,576,169,177,128,60,0
46267,142,60,82,20,28,13,5,611,314,297,79,75,78,22,0
46268,318,164,154,52,43,34,10,1047,562,485,141,127,114,41,0
46269,392,205,187,83,49,38,10,376,189,187,47,53,44,26,0
46270,1501,679,822,251,196,174,67,338,169,169,53,44,39,21,0
46271,215,80,135,54,56,21,9,1279,669,610,164,162,104,55,0
46272,546,278,268,94,60,32,22,329,196,133,41,36,31,15,0
46273,1590,726,864,270,237,126,59,662,373,289,89,80,77,29,0
46274,505,226,279,68,51,30,15,413,223,190,52,45,53,10,0
46275,329,168,161,48,34,41,16,376,189,187,47,53,44,26,0
46276,335,155,180,64,48,36,10,504,272,232,75,57,53,19,0
46277,1199,589,610,189,128,167,65,230,113,117,31,40,28,10,0
46278,505,226,279,68,51,30,15,418,223,195,51,45,49,14,0
46279,371,209,162,46,17,36,19,292,143,149,38,42,36,16,0
46280,585,277,308,92,73,61,32,559,317,242,58,65,37,23,0
46281,313,158,155,43,35,43,16,160,76,84,19,24,8,5,0
46282,207,89,118,56,8,4,3,266,150,116,28,28,24,12,0
46283,372,171,201,47,53,39,18,397,234,163,44,38,23,21,0
46284,149,68,81,15,38,11,10,495,217,278,79,64,44,22,0
46285,225,111,114,38,22,25,10,536,222,314,101,100,34,22,0
46286,204,109,95,21,35,27,7,481,223,258,71,70,49,26,0
46287,4128,2104,2024,581,505,453,205,415,203,212,77,44,49,18,0
46288,150,60,90,27,16,6,3,611,314,297,79,75,78,22,0
46289,584,340,244,77,60,47,25,723,353,370,120,109,96,33,0
46290,275,125,150,37,48,27,7,583,321,262,73,67,45,25,0
46291,960,409,551,166,134,77,44,222,124,98,37,29,22,9,0
46292,154,74,80,18,19,7,2,264,138,126,33,34,29,12,0
46293,473,265,208,47,26,50,30,349,200,149,41,39,30,20,0
46294,760,405,355,112,95,92,29,190,93,97,35,27,23,2,0
46295,291,142,149,50,29,35,7,972,471,501,152,138,112,40,0
46296,577,342,235,63,57,23,37,1321,653,668,186,195,70,35,0
46297,1054,453,601,183,183,107,35,619,305,314,85,93,71,29,0
46298,802,375,427,133,103,81,41,201,93,108,34,39,21,6,0
46299,484,194,290,70,93,47,16,380,178,202,69,53,37,10,0
46300,772,383,389,105,76,82,33,953,489,464,126,104,111,44,0
46301,525,254,271,60,76,46,13,332,173,159,48,40,31,11,0
46302,500,245,255,66,57,52,27,148,84,64,30,7,17,4,0
46303,388,209,179,46,24,31,28,531,277,254,82,75,33,22,0
46304,563,255,308,91,111,42,30,385,188,197,57,42,36,16,0
46305,315,170,145,48,56,22,11,230,113,117,31,40,28,10,0
46306,496,209,287,113,55,72,14,277,124,153,44,40,35,18,0
46307,441,218,223,69,55,50,27,279,161,118,37,32,7,7,0
46308,280,128,152,39,37,38,18,720,361,359,98,98,70,37,0
46309,260,136,124,24,41,19,4,904,436,468,143,118,108,32,0
46310,160,53,107,31,29,13,3,457,245,212,62,58,57,21,0
46311,346,186,160,40,37,34,21,390,190,200,66,50,43,12,0
46312,149,78,71,20,20,19,5,866,397,469,117,153,95,48,0
46313,472,222,250,46,61,33,23,889,505,384,107,97,99,30,0
46314,392,221,171,53,30,25,8,104,46,58,15,17,9,5,0
46315,279,127,152,50,36,28,8,926,340,586,133,119,60,40,0
46316,422,207,215,79,38,53,23,360,185,175,51,43,36,16,0
46317,1556,718,838,280,182,161,49,640,364,276,84,68,69,33,0
46318,437,167,270,126,95,34,10,316,166,150,45,38,37,13,0
46319,532,291,241,83,36,79,25,405,214,191,53,42,49,20,0
46320,207,128,79,26,17,19,9,192,110,82,33,21,10,3,0
46321,480,267,213,49,44,70,21,68,36,32,11,8,9,2,0
46322,531,284,247,66,42,49,15,607,293,314,98,71,62,32,0
46323,745,402,343,95,71,69,40,457,242,215,39,46,53,10,0
46324,360,175,185,73,36,27,7,218,114,104,32,31,33,11,0
46325,102,22,80,48,8,18,6,1113,480,633,170,173,81,34,0
46326,1208,575,633,187,204,117,41,391,189,202,55,56,56,12,0
46327,336,134,202,51,64,27,12,501,240,261,80,62,49,42,0
46328,1594,660,934,251,272,117,77,360,185,175,51,43,36,16,0
46329,186,56,130,46,50,16,7,296,159,137,49,28,38,13,0
46330,571,298,273,81,72,57,25,598,333,265,79,66,54,33,0
46331,484,192,292,118,68,83,22,245,121,124,37,35,36,12,0
46332,1257,464,793,221,264,75,37,1507,737,770,188,228,147,71,0
46333,172,82,90,21,35,21,5,763,418,345,113,84,59,32,0
46334,466,259,207,59,50,83,12,462,229,233,63,49,42,18,0
46335,224,108,116,31,32,22,8,457,242,215,39,46,53,10,0
46336,343,189,154,44,24,39,12,846,425,421,125,97,98,38,0
46337,540,252,288,73,67,57,20,619,305,314,85,93,71,29,0
46338,193,95,98,33,17,25,17,410,197,213,67,43,56,18,0
46339,583,279,304,99,71,59,31,483,258,225,70,53,54,20,0
46340,501,230,271,63,90,50,18,277,124,153,44,40,35,18,0
46341,238,91,147,68,19,22,7,194,94,100,33,28,14,7,0
46342,107,53,54,15,15,13,4,715,348,367,109,84,68,30,0
46343,1030,567,463,118,106,94,49,889,505,384,107,97,99,30,0
46344,338,173,165,31,42,22,10,301,168,133,49,37,34,11,0
46345,361,177,184,59,51,24,15,96,45,51,13,12,6,4,0
46346,251,139,112,41,18,27,11,302,150,152,56,40,52,15,0
46347,470,163,307,99,68,73,30,453,247,206,58,53,45,20,0
46348,357,182,175,49,36,39,15,103,59,44,25,2,13,6,0
46349,270,166,104,30,26,28,14,663,360,303,87,82,80,35,0
46350,243,100,143,58,50,24,5,515,276,239,62,59,43,31,0
46351,470,163,307,99,68,73,30,306,157,149,52,35,39,16,0
46352,755,271,484,113,226,61,20,607,293,314,98,71,62,32,0
46353,262,133,129,44,38,31,12,935,515,420,126,107,73,32,0
46354,290,156,134,44,29,39,9,557,281,276,80,59,43,21,0
46355,585,277,308,92,73,61,32,296,151,145,45,42,32,11,0
46356,1217,647,570,142,160,129,45,149,52,97,36,36,7,4,0
46357,281,125,156,44,47,17,7,1262,653,609,169,165,152,50,0
46358,305,124,181,27,25,32,21,334,181,153,41,40,25,15,0
46359,453,240,213,53,33,44,16,346,196,150,43,26,27,14,0
46360,250,123,127,40,28,29,8,421,222,199,69,50,60,18,0
46361,500,297,203,66,33,53,15,1922,923,999,267,275,215,90,0
46362,949,466,483,125,126,101,50,198,86,112,36,27,23,9,0
46363,215,104,111,61,7,2,1,257,139,118,64,17,24,7,0
46364,407,207,200,53,36,38,8,194,94,100,33,28,14,7,0
46365,292,102,190,71,27,51,21,232,111,121,23,29,17,9,0
46366,461,207,254,82,66,55,33,792,398,394,109,96,90,39,0
46367,488,237,251,79,78,65,27,129,60,69,21,15,8,5,0
46368,640,279,361,102,83,69,21,415,205,210,77,52,55,17,0
46369,242,104,138,41,33,37,8,194,106,88,33,10,15,6,0
46370,146,73,73,18,24,17,9,622,344,278,80,77,68,36,0
46371,242,104,138,41,33,37,8,223,113,110,31,33,22,12,0
46372,772,383,389,105,76,82,33,205,94,111,48,31,15,6,0
46373,271,110,161,33,27,11,8,858,398,460,126,138,75,39,0
46374,411,171,240,61,81,30,15,257,126,131,61,24,22,8,0
46375,833,295,538,146,139,65,34,601,278,323,124,87,65,21,0
46376,437,167,270,126,95,34,10,292,143,149,38,42,36,16,0
46377,422,207,215,79,38,53,23,250,116,134,41,30,33,19,0
46378,798,364,434,133,88,74,35,1378,692,686,194,174,105,56,0
46379,90,54,36,20,4,14,5,463,259,204,62,55,34,22,0
46380,496,210,286,112,55,72,13,322,180,142,45,38,28,7,0
46381,359,204,155,39,36,34,13,415,226,189,51,40,40,29,0
46382,210,101,109,33,33,19,9,926,340,586,133,119,60,40,0
46383,802,430,372,65,102,87,23,297,175,122,46,30,31,6,0
46384,760,322,438,81,130,57,19,207,114,93,33,20,31,13,0
46385,1498,731,767,220,175,148,68,621,273,348,104,102,48,19,0
46386,117,58,59,17,17,12,2,105,51,54,13,17,12,8,0
46387,462,233,229,66,49,43,30,644,343,301,96,69,59,28,0
46388,2136,1063,1073,317,308,223,90,780,337,443,112,116,77,28,0
46389,521,249,272,53,36,50,18,483,215,268,66,70,30,16,0
46390,312,173,139,43,47,28,6,710,375,335,95,94,110,28,0
46391,361,183,178,50,54,51,22,265,134,131,48,34,33,15,0
46392,753,361,392,99,94,66,16,279,106,173,48,35,41,39,0
46393,270,130,140,43,24,36,10,329,194,135,45,32,33,9,0
46394,1226,513,713,184,147,87,43,397,223,174,50,39,29,17,0
46395,126,58,68,31,10,10,3,661,325,336,81,75,65,28,0
46396,435,230,205,51,37,55,18,1543,794,749,182,152,132,55,0
46397,1390,705,685,219,164,129,74,723,353,370,120,109,96,33,0
46398,648,262,386,113,108,78,29,374,174,200,54,52,42,21,0
46399,1390,585,805,241,230,118,46,262,129,133,40,41,31,10,0
46400,365,210,155,46,30,24,12,2382,1162,1220,237,220,140,49,0
46401,165,66,99,28,32,16,3,2517,1275,1242,304,324,245,135,0
46402,317,167,150,45,21,30,26,633,311,322,94,82,45,20,0
46403,548,250,298,85,64,56,21,125,66,59,24,16,11,5,0
46404,368,154,214,80,52,41,16,252,130,122,45,23,32,11,0
46405,764,277,487,158,162,64,31,1239,659,580,169,148,131,54,0
46406,240,166,74,32,12,8,15,898,469,429,125,125,134,35,0
46407,82,36,46,17,10,5,1,142,73,69,27,9,15,11,0
46408,478,177,301,109,66,59,25,483,215,268,66,70,30,16,0
46409,184,88,96,15,40,17,8,314,177,137,34,40,29,9,0
46410,927,457,470,130,99,118,42,188,90,98,44,7,21,7,0
46411,450,227,223,53,36,48,12,199,105,94,27,27,28,9,0
46412,376,171,205,45,45,34,12,222,122,100,39,32,24,9,0
46413,733,438,295,95,79,67,32,364,189,175,58,41,35,17,0
46414,412,193,219,69,57,43,14,1279,669,610,164,162,104,55,0
46415,199,113,86,27,17,10,7,664,350,314,86,90,82,36,0
46416,717,281,436,165,81,112,49,556,290,266,75,74,29,24,0
46417,1417,598,819,223,188,135,58,810,310,500,164,162,42,26,0
46418,562,214,348,120,86,69,42,375,211,164,50,36,31,23,0
46419,303,147,156,49,49,20,8,199,105,94,27,27,28,9,0
46420,496,210,286,112,55,72,13,374,212,162,48,40,32,23,0
46421,452,202,250,83,60,56,19,689,343,346,105,102,81,35,0
46422,531,259,272,75,81,39,13,972,471,501,152,138,112,40,0
46423,521,249,272,53,36,50,18,1020,538,482,145,115,111,58,0
46424,739,389,350,129,61,69,25,334,181,153,56,31,28,18,0
46425,520,261,259,74,52,49,22,507,270,237,89,59,57,22,0
46426,385,203,182,47,43,51,21,91,44,47,9,12,4,7,0
46427,1004,498,506,94,59,46,33,188,88,100,53,12,15,6,0
46428,961,465,496,139,156,62,34,1034,495,539,150,134,114,71,0
46429,362,181,181,67,46,43,8,517,295,222,69,62,40,28,0
46430,801,331,470,151,139,99,55,188,93,95,33,18,16,10,0
46431,507,242,265,53,44,31,22,483,287,196,71,50,54,17,0
46432,213,113,100,26,21,26,12,153,80,73,26,18,19,4,0
46433,453,240,213,53,33,44,16,664,350,314,86,90,82,36,0
46434,710,352,358,104,86,84,41,104,46,58,15,17,9,5,0
46435,1447,698,749,214,180,116,46,279,142,137,43,39,28,7,0
46436,512,254,258,70,48,37,32,928,440,488,111,157,82,35,0
46437,722,390,332,125,69,67,25,395,169,226,73,55,38,9,0
46438,240,99,141,53,38,29,15,344,190,154,34,31,36,10,0
46439,418,163,255,57,54,38,24,330,166,164,55,51,36,16,0
46440,399,220,179,48,37,68,18,386,181,205,55,51,57,31,0
46441,361,183,178,50,54,51,22,360,185,175,51,43,36,16,0
46442,343,162,181,65,38,29,12,137,85,52,15,11,11,2,0
46443,226,120,106,68,8,2,1,2382,1162,1220,237,220,140,49,0
46444,222,108,114,37,20,25,12,445,202,243,70,73,51,15,0
46445,434,216,218,72,58,40,20,514,262,252,78,58,54,26,0
46446,126,56,70,31,10,10,3,246,125,121,38,36,30,11,0
46447,397,180,217,61,59,39,13,455,191,264,68,86,21,19,0
46448,1463,521,942,252,204,105,52,1873,935,938,233,225,203,79,0
46449,484,194,290,70,93,47,16,198,86,112,36,27,23,9,0
46450,270,130,140,43,24,36,10,147,74,73,28,20,24,4,0
46451,736,320,416,113,97,61,36,400,187,213,56,59,42,20,0
46452,553,276,277,88,61,45,27,633,311,322,94,82,45,20,0
46453,372,171,201,47,53,39,18,1755,905,850,214,196,183,79,0
46454,513,276,237,73,43,57,24,138,69,69,28,7,10,10,0
46455,505,282,223,60,57,66,23,485,244,241,80,55,59,20,0
46456,372,171,201,47,53,39,18,693,360,333,100,88,62,26,0
46457,653,379,274,89,56,86,13,360,180,180,57,48,39,12,0
46458,498,274,224,58,59,50,18,102,51,51,12,15,12,3,0
46459,259,119,140,48,28,29,19,689,343,346,105,102,81,35,0
46460,384,198,186,58,48,37,12,89,42,47,16,12,15,6,0
46461,290,156,134,44,29,39,9,188,88,100,53,12,15,6,0
46462,522,302,220,61,49,75,19,597,300,297,96,89,68,29,0
46463,139,81,58,17,14,24,9,349,200,149,41,39,30,20,0
46464,734,339,395,135,89,78,36,241,127,114,34,33,29,12,0
46465,1580,742,838,208,146,144,71,285,146,139,41,41,48,13,0
46466,388,209,179,46,24,31,28,780,337,443,112,116,77,28,0
46467,222,108,114,37,20,25,12,736,388,348,88,85,67,28,0
46468,580,308,272,82,79,58,25,611,314,297,79,75,78,22,0
46469,476,254,222,58,33,46,23,316,166,150,45,38,37,13,0
46470,1556,718,838,280,182,161,49,508,253,255,73,60,50,13,0
46471,484,264,220,59,62,68,15,556,290,266,75,74,29,24,0
46472,1030,567,463,118,106,94,49,376,183,193,50,50,43,21,0
46473,496,210,286,111,55,74,13,1323,690,633,132,178,112,61,0
46474,200,94,106,33,22,18,8,594,312,282,72,67,73,31,0
46475,700,305,395,111,99,54,18,213,129,84,32,14,21,15,0
46476,213,104,109,56,14,9,2,1507,737,770,188,228,147,71,0
46477,439,241,198,67,40,40,13,470,205,265,71,80,33,11,0
46478,442,254,188,46,22,40,19,265,134,131,48,34,33,15,0
46479,388,209,179,46,24,31,28,663,354,309,91,84,79,31,0
46480,310,141,169,36,38,20,8,283,160,123,25,20,37,9,0
46481,579,281,298,91,78,74,27,332,173,159,48,40,31,11,0
46482,346,205,141,47,34,30,7,548,296,252,71,74,43,28,0
46483,219,100,119,40,29,21,3,375,176,199,48,61,40,12,0
46484,1417,598,819,223,188,135,58,538,274,264,84,67,52,35,0
46485,282,160,122,36,28,27,7,501,240,261,80,62,49,42,0
46486,252,121,131,42,34,12,16,381,196,185,55,57,43,16,0
46487,217,109,108,30,23,28,10,360,180,180,57,48,39,12,0
46488,406,208,198,41,26,43,21,192,110,82,33,21,10,3,0
46489,362,181,181,67,46,43,8,761,351,410,117,73,103,45,0
46490,224,108,116,31,32,22,8,301,168,133,49,37,34,11,0
46491,456,223,233,77,54,47,20,662,373,289,89,80,77,29,0
46492,165,66,99,28,32,16,3,106,41,65,36,6,11,7,0
46493,625,283,342,93,89,67,25,91,42,49,21,9,8,3,0
46494,86,50,36,9,14,8,7,903,436,467,128,116,83,33,0
46495,215,117,98,28,19,15,8,198,113,85,19,20,26,12,0
46496,648,376,272,70,60,73,24,445,264,181,35,35,34,14,0
46497,237,127,110,34,30,16,9,387,193,194,60,53,57,15,0
46498,886,440,446,116,140,95,45,87,51,35,15,9,9,4,0
46499,745,402,343,95,71,69,40,250,116,134,41,30,33,19,0
46500,340,145,195,46,38,26,23,405,214,191,53,42,49,20,0
46501,369,166,203,59,55,41,14,422,237,185,53,47,62,20,0
46502,552,295,257,67,49,70,30,748,359,389,125,113,86,31,0
46503,801,331,470,151,139,99,55,548,273,275,84,81,64,30,0
46504,441,216,225,57,66,57,19,1262,653,609,169,165,152,50,0
46505,446,265,181,51,35,27,17,947,482,465,143,107,89,37,0
46506,320,163,157,44,44,26,15,810,310,500,164,162,42,26,0
46507,2109,999,1110,332,294,187,89,303,137,166,54,54,31,15,0
46508,567,256,311,91,81,53,17,285,143,142,45,32,21,17,0
46509,118,51,67,25,13,6,7,729,358,371,116,99,89,33,0
46510,412,193,219,69,57,43,14,541,279,262,79,82,31,32,0
46511,641,349,292,92,60,39,24,392,214,178,48,40,53,22,0
46512,441,218,223,69,55,50,27,363,180,183,60,34,10,6,0
46513,378,202,176,34,32,44,13,1700,731,969,198,233,110,87,0
46514,359,167,192,49,37,27,19,247,128,119,34,14,16,14,0
46515,410,188,222,53,52,31,14,127,64,63,26,8,12,8,0
46516,927,457,470,130,99,118,42,337,170,167,59,33,47,17,0
46517,410,209,201,72,30,48,22,464,236,228,64,56,53,28,0
46518,1004,464,540,143,104,78,55,463,259,204,62,55,34,22,0
46519,1009,487,522,177,121,103,51,471,238,233,66,63,62,19,0
46520,496,210,286,111,55,74,13,929,459,470,140,120,94,45,0
46521,584,297,287,89,80,65,17,277,124,153,44,40,35,18,0
46522,158,85,73,24,18,18,8,187,89,98,36,24,20,6,0
46523,434,216,218,72,58,40,20,305,163,142,38,27,47,11,0
46524,158,85,73,24,18,18,8,413,223,190,52,45,53,10,0
46525,127,62,65,13,33,7,6,153,65,88,28,21,20,8,0
46526,399,220,179,48,37,68,18,403,192,211,102,39,49,15,0
46527,261,137,124,34,23,13,8,1166,514,652,150,159,107,70,0
46528,309,154,155,42,44,45,16,193,102,91,23,25,20,10,0
46529,607,305,302,92,89,74,23,234,116,118,34,35,23,9,0
46530,385,179,206,58,56,38,19,549,273,276,74,68,72,24,0
46531,508,267,241,43,35,25,17,239,113,126,36,49,20,8,0
46532,524,361,163,41,8,28,16,758,319,439,101,123,78,25,0
46533,822,416,406,111,97,88,42,153,65,88,28,21,20,8,0
46534,224,108,116,33,26,32,10,180,115,65,17,12,9,9,0
46535,478,177,301,109,66,59,25,441,189,252,73,50,47,23,0
46536,496,210,286,111,55,74,13,690,345,345,96,83,73,42,0
46537,207,89,118,56,8,4,3,295,160,135,44,36,46,16,0
46538,833,295,538,146,139,65,34,396,199,197,54,50,45,14,0
46539,532,254,278,91,48,23,17,323,168,155,51,41,38,12,0
46540,346,205,141,47,34,30,7,261,148,113,31,28,14,10,0
46541,437,228,209,47,61,26,11,335,170,165,52,36,47,11,0
46542,373,194,179,42,54,26,13,201,117,83,22,21,19,9,0
46543,218,133,85,20,19,13,6,1382,508,874,334,320,98,36,0
46544,650,330,320,97,77,65,28,201,104,97,36,32,24,7,0
46545,222,108,114,37,20,25,12,332,155,177,55,51,44,13,0
46546,234,108,126,42,40,15,9,251,143,108,47,25,29,11,0
46547,261,130,131,27,41,19,16,231,126,105,37,26,29,6,0
46548,418,163,255,57,54,38,24,91,44,47,9,12,4,7,0
46549,449,179,270,80,77,49,29,1025,549,476,118,109,88,61,0
46550,447,225,222,76,35,75,21,384,212,172,44,43,34,14,0
46551,760,322,438,81,130,57,19,198,115,83,30,22,8,8,0
46552,142,60,82,20,28,13,5,125,66,59,24,16,11,5,0
46553,126,58,68,31,10,10,3,611,314,297,79,75,78,22,0
46554,144,57,87,38,26,10,4,360,185,175,51,43,36,16,0
46555,330,151,179,68,36,56,9,1020,538,482,145,115,111,58,0
46556,219,100,119,40,29,21,3,164,79,85,28,28,16,7,0
46557,575,290,285,67,70,28,9,332,155,177,55,51,44,13,0
46558,374,187,187,51,52,40,27,1338,720,618,179,145,141,85,0
46559,330,141,189,65,29,51,19,363,180,183,60,34,10,6,0
46560,2624,999,1625,415,495,109,84,290,147,143,34,34,39,13,0
46561,350,172,178,61,45,32,13,520,272,248,60,65,58,22,0
46562,496,274,222,57,43,75,22,325,172,153,44,34,27,14,0
46563,441,218,223,69,55,50,27,437,221,216,62,64,47,13,0
46564,734,339,395,135,89,78,36,346,196,150,43,26,27,14,0
46565,291,120,171,63,39,26,6,96,45,51,13,12,6,4,0
46566,232,134,98,28,20,20,5,286,160,126,37,27,23,10,0
46567,605,277,328,99,54,63,43,594,312,282,72,67,73,31,0
46568,241,122,119,27,34,17,16,1606,753,853,215,227,182,48,0
46569,392,205,187,83,49,38,10,406,202,204,54,51,63,21,0
46570,1011,559,452,121,97,132,33,663,354,309,91,84,79,31,0
46571,180,92,88,29,20,26,8,727,388,339,102,87,70,29,0
46572,130,72,58,28,9,7,1,166,88,78,23,18,13,7,0
46573,384,198,186,58,48,37,12,464,236,228,64,56,53,28,0
46574,685,393,292,75,66,113,16,88,50,38,13,8,16,4,0
46575,626,308,318,105,89,77,25,134,72,62,14,28,8,4,0
46576,822,416,406,111,97,88,42,173,94,79,18,24,12,7,0
46577,125,53,72,18,21,18,12,392,155,237,68,61,34,16,0
46578,802,375,427,133,103,81,41,130,67,63,24,10,12,4,0
46579,607,294,313,94,95,62,14,232,108,124,33,27,19,16,0
46580,244,104,140,52,31,30,14,464,236,228,64,56,53,28,0
46581,279,106,173,48,35,41,39,232,108,124,33,27,19,16,0
46582,346,209,137,46,37,44,10,598,333,265,79,66,54,33,0
46583,313,158,155,43,35,43,16,373,213,160,44,33,26,17,0
46584,648,376,272,70,60,73,24,209,119,90,28,24,27,9,0
46585,128,70,58,29,9,8,1,663,354,309,91,84,79,31,0
46586,376,176,200,31,53,27,8,166,102,64,19,14,17,2,0
46587,456,214,242,76,62,52,22,374,174,200,54,52,42,21,0
46588,828,355,473,126,134,77,37,671,321,350,95,87,75,34,0
46589,837,381,456,123,109,65,25,1248,584,664,184,164,155,67,0
46590,531,259,272,75,81,39,13,180,95,85,22,21,17,8,0
46591,2109,999,1110,332,294,187,89,350,196,154,52,37,21,14,0
46592,365,210,155,46,30,24,12,622,344,278,80,77,68,36,0
46593,305,124,181,27,25,31,21,531,277,254,82,75,33,22,0
46594,338,172,166,59,30,39,18,137,78,59,22,16,17,4,0
46595,1007,353,654,277,147,70,26,326,169,157,51,41,41,12,0
46596,522,251,271,87,68,60,21,142,76,66,21,21,22,11,0
46597,604,239,365,124,63,84,37,664,350,314,86,90,82,36,0
46598,227,109,118,42,35,29,8,1352,602,750,166,185,81,70,0
46599,488,237,251,79,78,65,27,123,61,62,17,18,17,7,0
46600,159,105,54,22,9,14,25,341,170,171,41,66,27,10,0
46601,435,187,248,62,51,51,21,314,151,163,42,61,39,16,0
46602,1171,542,629,170,146,114,64,295,158,137,42,34,38,14,0
46603,536,237,299,116,87,42,17,292,155,137,50,34,29,13,0
46604,952,547,405,95,90,127,35,504,272,232,75,57,53,19,0
46605,335,183,152,40,26,54,22,103,50,53,19,10,7,5,0
46606,396,150,246,103,64,38,3,470,205,265,71,80,33,11,0
46607,588,300,288,100,57,65,27,106,54,52,12,9,7,6,0
46608,341,195,146,42,21,36,9,673,313,360,102,101,46,17,0
46609,388,209,179,46,24,31,28,305,161,144,39,40,44,17,0
46610,567,256,311,91,81,53,17,346,178,168,58,41,33,12,0
46611,76,42,34,12,8,5,7,547,295,252,81,65,57,23,0
46612,376,176,200,31,53,27,8,308,146,162,42,39,24,12,0
46613,364,172,192,55,57,32,15,173,90,83,21,36,12,15,0
46614,575,295,280,89,68,54,18,397,223,174,50,39,29,17,0
46615,257,148,109,28,20,21,14,507,270,237,89,59,57,22,0
46616,755,271,484,113,226,61,20,483,215,268,66,70,30,16,0
46617,953,421,532,131,131,70,37,104,46,58,15,17,9,5,0
46618,200,103,97,17,16,10,10,68,36,32,11,8,9,2,0
46619,463,250,213,56,45,73,25,299,140,159,49,44,26,11,0
46620,2063,1024,1039,175,117,80,97,326,149,177,51,51,28,10,0
46621,575,305,270,74,87,73,25,335,170,165,52,36,47,11,0
46622,283,172,111,39,31,29,8,1249,638,611,166,153,141,45,0
46623,654,344,310,80,69,57,15,1507,737,770,188,228,147,71,0
46624,1849,931,918,245,220,158,90,766,386,380,101,81,78,31,0
46625,1054,497,557,190,168,107,45,149,52,97,36,36,7,4,0
46626,559,217,342,105,86,42,16,166,102,64,19,14,17,2,0
46627,530,259,271,83,50,54,41,246,107,139,55,33,27,11,0
46628,519,245,274,58,61,34,22,260,131,129,42,31,40,9,0
46629,179,96,83,24,8,26,4,749,384,365,108,105,86,31,0
46630,535,217,318,87,106,41,14,536,222,314,101,100,34,22,0
46631,521,249,272,53,36,50,18,218,111,107,45,29,24,6,0
46632,480,232,248,73,40,44,30,316,159,157,38,48,30,11,0
46633,631,304,327,98,75,52,23,262,129,133,40,41,31,10,0
46634,496,209,287,112,55,71,14,72,32,40,8,2,1,14,0
46635,426,196,230,76,65,54,20,295,156,139,41,40,42,15,0
46636,828,368,460,118,98,59,38,462,251,211,74,53,41,18,0
46637,496,209,287,113,55,72,14,925,439,486,141,134,105,46,0
46638,129,70,59,29,9,7,2,403,185,218,67,62,63,19,0
46639,309,137,172,51,50,28,14,334,181,153,41,40,25,15,0
46640,815,356,459,128,125,82,26,1239,659,580,169,148,131,54,0
46641,276,149,127,45,34,39,9,367,199,168,62,44,34,8,0
46642,126,56,70,31,10,10,3,1101,626,475,145,122,120,50,0
46643,341,175,166,48,43,35,18,693,360,333,100,88,62,26,0
46644,613,303,310,70,28,28,18,373,181,192,54,35,44,20,0
46645,134,60,74,19,13,10,7,192,91,101,29,28,17,7,0
46646,649,304,345,99,80,67,40,138,69,69,28,7,10,10,0
46647,338,172,166,59,30,39,18,654,295,359,99,88,71,25,0
46648,157,62,95,41,18,10,11,475,251,224,67,49,48,23,0
46649,961,465,496,139,156,62,34,322,180,142,45,38,28,7,0
46650,130,70,60,30,9,8,1,775,407,368,122,100,97,32,0
46651,898,397,501,102,98,54,37,89,37,52,13,6,2,9,0
46652,341,177,164,57,42,40,18,1034,495,539,150,134,114,71,0
46653,76,30,46,7,15,1,5,584,249,335,80,96,22,13,0
46654,278,110,168,58,49,29,5,261,127,134,36,27,36,4,0
46655,1555,702,853,250,199,139,31,87,51,35,15,9,9,4,0
46656,381,146,235,74,48,47,34,285,146,139,41,41,48,13,0
46657,881,492,389,87,97,59,51,602,310,292,87,66,70,36,0
46658,727,426,301,79,71,64,32,467,240,227,65,65,51,23,0
46659,193,107,86,13,20,13,6,551,226,325,96,103,43,11,0
46660,1139,537,602,162,139,109,50,314,177,137,34,40,29,9,0
46661,420,248,172,64,30,43,17,332,180,152,46,36,28,14,0
46662,349,153,196,54,47,28,13,381,186,195,69,55,46,15,0
46663,869,489,380,110,77,79,29,200,89,111,26,25,17,7,0
46664,469,253,216,49,51,48,18,349,200,149,41,39,30,20,0
46665,280,156,124,36,19,20,13,403,192,211,102,39,49,15,0
46666,332,170,162,44,38,39,10,699,334,365,108,80,70,20,0
46667,1148,472,676,229,164,86,37,201,93,108,34,39,21,6,0
46668,567,266,301,139,46,76,37,392,155,237,68,61,34,16,0
46669,119,67,52,15,15,7,7,375,211,164,50,36,31,23,0
46670,567,256,311,91,81,53,17,572,305,267,74,72,58,21,0
46671,1105,544,561,165,167,99,40,138,69,69,28,7,10,10,0
46672,226,120,106,68,8,2,1,87,51,35,15,9,9,4,0
46673,342,185,157,42,27,31,14,463,259,204,62,55,34,22,0
46674,929,410,519,187,146,53,30,320,168,152,38,42,24,18,0
46675,763,354,409,101,90,63,26,277,145,132,41,32,22,10,0
46676,332,170,162,44,38,39,10,317,161,156,40,49,41,11,0
46677,684,353,331,95,98,77,38,188,101,87,20,18,20,14,0
46678,1068,434,634,173,160,61,29,662,373,289,89,80,77,29,0
46679,462,258,204,59,41,56,15,200,89,111,26,25,17,7,0
46680,629,338,291,92,57,64,22,134,55,79,22,24,16,6,0
46681,290,156,134,44,29,39,9,54,26,28,11,4,3,3,0
46682,106,43,63,28,13,8,1,763,418,345,113,84,59,32,0
46683,781,316,465,130,129,65,23,418,223,195,53,43,49,15,0
46684,224,101,123,45,32,21,3,723,363,360,107,106,52,14,0
46685,264,122,142,46,24,35,10,392,155,237,68,61,34,16,0
46686,349,153,196,54,47,28,13,419,233,186,54,53,55,17,0
46687,462,228,234,59,47,37,32,953,489,464,126,104,111,44,0
46688,144,57,87,38,26,10,4,325,159,166,59,46,30,12,0
46689,373,194,179,42,54,26,13,530,287,243,79,70,33,26,0
46690,221,75,146,68,21,16,5,862,409,453,149,125,86,29,0
46691,222,110,112,43,30,14,6,898,469,429,125,125,134,35,0
46692,215,80,135,54,56,21,9,621,273,348,104,102,48,19,0
46693,193,95,98,33,17,25,17,261,148,113,31,28,14,10,0
46694,2525,1232,1293,398,317,186,61,1062,522,540,151,147,105,66,0
46695,1098,519,579,182,159,79,42,632,360,272,75,65,36,19,0
46696,282,96,186,80,21,28,7,396,197,199,75,49,49,16,0
46697,489,253,236,73,36,62,17,1265,689,576,169,177,128,60,0
46698,546,265,281,101,64,38,16,334,181,153,56,31,28,18,0
46699,803,358,445,135,117,80,43,492,278,214,65,58,32,11,0
46700,221,114,107,65,7,2,1,244,143,101,31,29,26,8,0
46701,479,227,252,69,48,46,18,190,93,97,35,27,23,2,0
46702,57,24,33,11,3,5,3,194,106,88,33,10,15,6,0
46703,798,364,434,133,88,74,35,242,121,121,39,30,29,10,0
46704,453,240,213,53,33,44,16,662,373,289,89,80,77,29,0
46705,451,278,173,71,35,58,12,1214,475,739,177,250,89,49,0
46706,753,395,358,93,72,71,16,68,36,32,11,8,9,2,0
46707,2649,1431,1218,377,299,266,102,396,197,199,75,49,49,16,0
46708,471,221,250,87,68,42,25,516,245,271,82,84,70,26,0
46709,629,338,291,92,57,64,22,106,54,52,12,9,7,6,0
46710,314,178,136,42,32,30,17,242,124,118,39,32,28,22,0
46711,301,119,182,53,47,14,20,498,244,254,81,67,58,19,0
46712,502,236,266,66,66,58,17,335,170,165,52,36,47,11,0
46713,856,429,427,113,105,96,24,396,197,199,75,49,49,16,0
46714,4128,2104,2024,581,505,453,205,496,285,211,62,54,46,22,0
46715,500,245,255,66,57,52,27,250,119,131,58,26,29,7,0
46716,255,136,119,39,20,32,10,439,231,208,65,51,55,17,0
46717,1464,693,771,153,136,91,86,296,140,156,49,40,42,19,0
46718,704,342,362,113,91,85,33,87,51,35,15,9,9,4,0
46719,485,183,302,79,81,73,33,127,58,69,18,17,10,5,0
46720,532,291,241,83,36,79,25,277,152,125,31,35,22,19,0
46721,275,125,150,37,48,27,7,107,77,30,7,2,9,5,0
46722,509,246,263,84,71,56,22,296,151,145,45,42,32,11,0
46723,1365,590,775,257,168,136,93,199,92,107,34,30,18,9,0
46724,629,338,291,92,57,64,22,344,190,154,34,31,36,10,0
46725,1711,865,846,204,176,105,60,232,111,121,23,29,17,9,0
46726,756,265,491,129,127,51,17,330,166,164,55,51,36,16,0
46727,196,107,89,20,31,17,4,89,51,38,15,15,5,4,0
46728,139,64,75,18,17,18,4,654,295,359,99,88,71,25,0
46729,1867,973,894,256,222,194,65,481,223,258,71,70,49,26,0
46730,219,100,119,40,29,21,3,134,55,79,22,24,16,6,0
46731,126,56,70,31,10,10,3,935,515,420,126,107,73,32,0
46732,233,107,126,40,40,20,16,261,127,134,36,27,36,4,0
46733,203,97,106,30,22,18,10,1248,584,664,184,164,155,67,0
46734,292,102,190,71,27,51,21,535,311,224,66,52,49,24,0
46735,330,182,148,47,27,40,11,303,137,166,54,54,31,15,0
46736,764,277,487,158,162,64,31,178,69,109,29,25,21,13,0
46737,574,269,305,91,63,54,27,1230,644,586,198,125,123,61,0
46738,492,253,239,73,67,77,29,289,140,149,33,42,30,15,0
46739,340,169,171,40,39,36,22,495,217,278,79,64,44,22,0
46740,210,84,126,44,43,9,4,1382,508,874,334,320,98,36,0
46741,836,370,466,126,96,72,30,671,306,365,114,76,49,19,0
46742,371,143,228,77,48,29,26,163,79,84,22,24,13,5,0
46743,494,242,252,67,47,25,21,277,145,132,41,32,22,10,0
46744,1872,837,1035,280,338,169,80,65,32,33,16,4,8,3,0
46745,802,430,372,65,102,87,23,1034,495,539,150,134,114,71,0
46746,629,374,255,74,53,87,27,178,99,79,31,19,26,8,0
46747,2286,1154,1132,338,314,278,103,188,88,100,53,12,15,6,0
46748,310,141,169,36,38,20,8,602,310,292,87,66,70,36,0
46749,404,197,207,60,48,47,20,354,188,166,46,40,34,10,0
46750,560,279,281,113,64,58,15,452,254,198,72,57,38,18,0
46751,411,211,200,61,46,35,18,137,63,74,20,22,14,6,0
46752,169,64,105,23,37,11,3,260,131,129,42,31,40,9,0
46753,423,247,176,58,55,29,20,152,71,81,41,16,14,2,0
46754,376,171,205,45,45,34,12,621,310,311,100,106,77,27,0
46755,1214,612,602,169,173,98,35,196,105,91,40,13,19,10,0
46756,983,449,534,95,77,55,36,1061,543,518,146,123,109,67,0
46757,667,366,301,96,55,84,25,277,145,132,41,32,22,10,0
46758,320,163,157,44,44,26,15,778,391,387,94,77,41,33,0
46759,412,208,204,54,47,42,17,418,246,172,52,39,57,10,0
46760,330,77,253,86,52,20,12,266,150,116,28,28,24,12,0
46761,99,35,64,25,18,0,1,4646,2328,2318,674,639,475,170,0
46762,249,114,135,47,33,25,4,926,340,586,133,119,60,40,0
46763,1085,646,439,108,65,36,19,727,388,339,102,87,70,29,0
46764,395,219,176,47,41,50,18,925,439,486,141,134,105,46,0
46765,330,77,253,86,52,20,12,2547,1280,1267,331,335,293,118,0
46766,465,240,225,50,54,24,14,778,391,387,94,77,41,33,0
46767,260,138,122,44,30,28,6,455,229,226,66,62,63,29,0
46768,1068,434,634,173,160,61,29,368,200,168,54,49,43,9,0
46769,2000,965,1035,357,313,198,75,319,185,134,42,31,22,13,0
46770,426,214,212,63,47,53,20,209,119,90,28,24,27,9,0
46771,269,156,113,37,32,17,7,2346,1231,1115,316,292,266,105,0
46772,3703,1708,1995,456,428,305,162,414,203,211,58,56,48,14,0
46773,261,130,131,27,41,19,16,538,274,264,84,67,52,35,0
46774,508,136,372,157,91,22,9,2202,1121,1081,338,274,269,81,0
46775,963,477,486,134,143,123,38,374,202,172,50,39,31,24,0
46776,509,246,263,84,71,56,22,557,281,276,80,59,43,21,0
46777,2136,1063,1073,317,308,223,90,597,300,297,96,89,68,29,0
46778,298,141,157,51,33,21,22,1279,669,610,164,162,104,55,0
46779,309,137,172,51,50,28,14,288,156,132,36,36,24,15,0
46780,526,268,258,54,37,55,12,316,166,150,45,38,37,13,0
46781,176,74,102,20,29,7,7,516,245,271,82,84,70,26,0
46782,427,191,236,67,60,41,34,392,214,178,48,40,53,22,0
46783,390,199,191,72,42,35,12,481,223,258,71,70,49,26,0
46784,746,312,434,129,115,77,47,975,475,500,139,140,119,28,0
46785,341,175,166,48,43,35,18,368,204,164,43,35,30,24,0
46786,117,57,60,17,14,11,10,415,189,226,68,54,50,21,0
46787,887,439,448,137,99,91,38,601,278,323,124,87,65,21,0
46788,538,263,275,71,85,44,18,350,196,154,52,37,21,14,0
46789,457,228,229,64,36,52,21,305,161,144,39,40,44,17,0
46790,650,330,320,97,77,65,28,708,328,380,113,100,82,34,0
46791,932,575,357,94,69,76,40,223,113,110,31,33,22,12,0
46792,530,259,271,83,50,54,41,331,180,151,46,35,47,17,0
46793,107,53,54,15,15,13,4,344,190,154,34,31,36,10,0
46794,446,195,251,56,53,31,15,166,90,76,27,18,21,5,0
46795,2136,1063,1073,317,308,223,90,400,187,213,56,59,42,20,0
46796,474,250,224,58,47,37,12,264,138,126,33,34,29,12,0
46797,710,352,358,104,86,84,41,98,49,49,14,15,9,2,0
46798,929,410,519,187,146,53,30,418,223,195,53,43,49,15,0
46799,533,300,233,74,50,74,17,935,515,420,126,107,73,32,0
46800,527,276,251,64,60,70,20,166,78,88,27,25,19,7,0
46801,1051,429,622,179,148,125,54,225,111,114,32,34,32,16,0
46802,325,152,173,43,47,28,17,1606,753,853,215,227,182,48,0
46803,126,58,68,31,10,10,3,1395,627,768,172,263,141,59,0
46804,412,193,219,69,57,43,14,972,471,501,152,138,112,40,0
46805,603,311,292,102,71,66,23,104,46,58,15,17,9,5,0
46806,196,107,89,20,31,17,4,317,161,156,40,49,41,11,0
46807,1214,498,716,197,180,121,65,629,317,312,80,87,51,22,0
46808,1112,457,655,180,164,99,39,630,321,309,86,90,57,26,0
46809,1336,724,612,209,141,133,60,178,69,109,29,25,21,13,0
46810,640,279,361,102,83,69,21,453,255,198,62,49,29,19,0
46811,458,210,248,39,38,25,16,198,86,112,36,27,23,9,0
46812,426,214,212,63,47,53,20,551,226,325,96,103,43,11,0
46813,794,322,472,122,108,79,34,395,198,197,55,55,36,10,0
46814,367,167,200,63,42,60,17,91,42,49,21,9,8,3,0
46815,704,342,362,113,91,85,33,142,65,77,30,17,22,9,0
46816,320,163,157,44,44,26,15,452,231,221,74,53,56,20,0
46817,257,122,135,44,19,21,16,406,202,204,54,51,63,21,0
46818,243,100,143,58,50,24,5,180,90,90,31,19,20,8,0
46819,306,172,134,35,31,37,18,260,131,129,42,31,40,9,0
46820,1718,735,983,266,225,130,68,173,86,87,30,22,19,12,0
46821,385,179,206,58,56,38,19,429,187,242,79,72,28,19,0
46822,781,316,465,130,129,65,23,1537,701,836,209,187,129,58,0
46823,446,195,251,56,53,31,15,647,350,297,95,79,77,29,0
46824,680,308,372,82,72,71,40,1606,753,853,215,227,182,48,0
46825,588,267,321,99,79,87,28,629,317,312,80,87,51,22,0
46826,432,190,242,85,82,28,11,334,181,153,56,31,28,18,0
46827,458,210,248,39,38,25,16,422,202,220,80,52,57,18,0
46828,235,100,135,36,25,30,8,169,74,95,33,26,22,3,0
46829,238,91,147,68,19,22,7,188,90,98,44,7,21,7,0
46830,763,371,392,104,88,52,23,579,285,294,78,72,64,32,0
46831,329,165,164,61,44,29,17,749,384,365,108,105,86,31,0
46832,328,156,172,44,37,44,15,385,188,197,57,42,36,16,0
46833,561,282,279,68,62,36,14,180,108,72,22,22,15,5,0
46834,291,146,145,39,45,22,16,160,67,93,32,37,15,9,0
46835,952,547,405,95,90,127,35,266,146,120,41,28,31,7,0
46836,1001,422,579,185,180,51,32,541,279,262,79,82,31,32,0
46837,756,265,491,129,127,51,17,175,91,84,19,21,21,10,0
46838,2236,1195,1041,227,187,186,118,780,337,443,112,116,77,28,0
46839,279,129,150,43,34,17,13,729,358,371,116,99,89,33,0
46840,250,123,127,40,28,29,8,381,186,195,69,55,46,15,0
46841,395,189,206,63,50,49,28,384,204,180,53,47,49,17,0
46842,837,443,394,129,89,87,38,858,461,397,125,114,79,45,0
46843,335,148,187,52,26,51,12,101,59,42,11,17,10,1,0
46844,1365,590,775,257,168,136,93,605,283,322,94,72,64,39,0
46845,610,249,361,107,69,72,33,536,251,285,75,79,60,23,0
46846,456,214,242,76,62,52,22,194,109,85,23,24,21,9,0
46847,852,461,391,109,102,72,24,398,200,198,68,43,51,14,0
46848,700,305,395,111,99,54,18,858,398,460,126,138,75,39,0
46849,505,226,279,68,51,30,15,501,274,227,63,58,53,20,0
46850,772,332,440,136,104,72,28,926,340,586,133,119,60,40,0
46851,149,78,71,20,20,19,5,387,193,194,60,53,57,15,0
46852,1339,494,845,216,298,92,37,299,140,159,49,44,26,11,0
46853,270,131,139,47,37,41,11,215,115,100,27,19,16,7,0
46854,753,395,358,93,72,71,16,4646,2328,2318,674,639,475,170,0
46855,410,200,210,60,54,46,19,516,245,271,82,84,70,26,0
46856,325,177,148,40,24,23,13,218,111,107,45,29,24,6,0
46857,376,249,127,47,23,43,16,137,78,59,22,16,17,4,0
46858,371,209,162,46,17,36,19,689,343,346,105,102,81,35,0
46859,458,210,248,39,38,25,16,1040,564,476,134,110,114,51,0
46860,616,304,312,75,71,55,25,663,360,303,87,82,80,35,0
46861,1143,574,569,176,151,123,59,106,46,60,27,18,12,3,0
46862,340,181,159,44,39,35,21,547,295,252,81,65,57,23,0
46863,494,242,252,67,47,25,21,376,189,187,47,53,44,26,0
46864,259,119,140,48,28,29,19,373,189,184,54,46,50,23,0
46865,437,212,225,66,44,44,11,392,155,237,68,61,34,16,0
46866,308,163,145,38,33,30,20,780,337,443,112,116,77,28,0
46867,584,340,244,77,60,47,25,292,143,149,38,42,36,16,0
46868,815,356,459,128,125,82,26,654,295,359,99,88,71,25,0
46869,1499,864,635,141,99,76,110,107,77,30,7,2,9,5,0
46870,733,438,295,95,79,67,32,142,65,77,30,17,22,9,0
46871,516,210,306,113,53,81,33,231,126,105,37,26,29,6,0
46872,1872,837,1035,280,338,169,80,1698,875,823,222,219,173,64,0
46873,210,101,109,33,33,19,9,222,119,103,37,32,24,8,0
46874,126,58,68,31,10,10,3,199,105,94,27,27,28,9,0
46875,1284,511,773,227,166,169,107,798,385,413,120,115,79,30,0
46876,391,203,188,49,34,36,9,487,252,235,79,58,55,26,0
46877,118,56,62,24,12,6,9,1279,669,610,164,162,104,55,0
46878,164,81,83,37,8,14,10,715,345,370,110,97,64,25,0
46879,258,144,114,33,22,19,9,375,211,164,50,36,31,23,0
46880,361,177,184,59,51,24,15,1113,480,633,170,173,81,34,0
46881,798,287,511,126,125,77,26,536,222,314,101,100,34,22,0
46882,317,167,150,45,21,30,26,328,199,129,39,29,27,14,0
46883,1221,597,624,201,152,83,31,866,397,469,117,153,95,48,0
46884,1030,438,592,184,104,108,30,207,114,93,33,20,31,13,0
46885,211,92,119,33,44,11,7,225,129,96,32,33,20,8,0
46886,314,158,156,39,28,30,17,277,163,114,33,24,21,16,0
46887,529,290,239,54,63,85,15,133,61,72,21,19,13,4,0
46888,813,412,401,114,93,112,26,429,187,242,79,72,28,19,0
46889,126,58,68,31,10,10,3,708,328,380,113,100,82,34,0
46890,261,148,113,23,29,26,21,501,274,227,63,58,53,20,0
46891,900,434,466,134,97,86,36,289,140,149,33,42,30,15,0
46892,330,151,179,68,36,56,9,309,164,145,35,47,30,11,0
46893,729,351,378,111,98,58,18,240,141,99,34,28,29,8,0
46894,755,271,484,113,226,61,20,464,236,228,64,56,53,28,0
46895,390,199,191,72,42,35,12,325,159,166,59,46,30,12,0
46896,747,360,387,125,92,69,32,204,80,124,29,51,10,5,0
46897,1257,464,793,221,264,75,37,166,102,64,19,14,17,2,0
46898,461,257,204,63,49,50,29,283,142,141,41,33,26,18,0
46899,411,236,175,39,45,50,30,565,237,328,75,88,32,11,0
46900,315,111,204,82,66,46,11,128,63,65,30,11,13,8,0
46901,281,125,156,44,47,17,7,309,159,150,47,43,43,13,0
46902,329,165,164,61,44,29,17,508,253,255,73,60,50,13,0
46903,257,122,135,44,19,21,16,424,179,245,65,67,29,11,0
46904,415,217,198,50,31,42,17,555,292,263,75,63,67,27,0
46905,639,368,271,72,51,38,38,457,242,215,39,46,53,10,0
46906,517,245,272,92,77,46,24,326,169,157,51,41,41,12,0
46907,677,361,316,81,61,42,22,403,192,211,102,39,49,15,0
46908,509,251,258,69,49,55,17,222,127,95,23,28,22,7,0
46909,381,146,235,74,48,47,34,87,38,49,23,10,10,9,0
46910,1143,574,569,176,151,123,59,194,109,85,23,24,21,9,0
46911,571,298,273,81,72,57,25,663,360,303,87,82,80,35,0
46912,422,196,226,52,35,33,20,201,98,103,28,25,19,13,0
46913,395,219,176,47,41,50,18,294,146,148,50,45,51,15,0
46914,348,198,150,57,25,37,18,1698,875,823,222,219,173,64,0
46915,178,89,89,40,12,18,7,978,536,442,132,107,67,32,0
46916,272,94,178,76,33,19,4,169,74,95,33,26,22,3,0
46917,360,175,185,73,36,27,7,89,38,51,14,6,3,9,0
46918,399,220,179,48,37,68,18,1249,638,611,166,153,141,45,0
46919,494,233,261,87,57,46,18,320,168,152,38,42,24,18,0
46920,391,204,187,47,48,38,18,173,90,83,21,36,12,15,0
46921,426,213,213,60,56,46,24,866,478,388,121,101,101,26,0
46922,341,175,166,48,43,35,18,664,350,314,86,90,82,36,0
46923,256,152,104,18,23,23,8,963,525,438,119,102,102,34,0
46924,1174,594,580,175,155,126,66,497,257,240,71,63,62,16,0
46925,631,304,327,98,75,52,23,154,78,76,23,21,13,5,0
46926,456,223,233,77,54,47,20,367,199,168,62,44,34,8,0
46927,332,172,160,50,33,35,9,963,525,438,119,102,102,34,0
46928,420,189,231,79,67,33,17,196,105,91,40,13,19,10,0
46929,443,226,217,67,34,53,10,408,221,187,55,51,57,14,0
46930,607,294,313,94,95,62,14,149,68,81,15,38,11,10,0
46931,605,277,328,99,54,63,43,1338,720,618,179,145,141,85,0
46932,415,133,282,114,65,27,7,276,149,127,34,31,32,10,0
46933,136,65,71,33,11,9,6,2038,1059,979,262,237,208,100,0
46934,305,124,181,27,25,32,21,517,295,222,69,62,40,28,0
46935,226,120,106,68,8,2,1,261,162,99,24,21,14,10,0
46936,339,170,169,32,17,24,13,316,159,157,38,48,30,11,0
46937,272,94,178,76,33,19,4,180,108,72,22,22,15,5,0
46938,447,225,222,76,35,75,21,584,249,335,80,96,22,13,0
46939,221,80,141,48,37,14,10,780,337,443,112,116,77,28,0
46940,193,105,88,33,16,9,4,373,189,184,54,46,50,23,0
46941,960,409,551,166,134,77,44,337,170,167,59,33,47,17,0
46942,336,134,202,51,64,27,12,169,84,85,29,19,21,7,0
46943,625,283,342,93,89,67,25,103,50,53,19,10,7,5,0
46944,2525,1232,1293,398,317,186,61,135,65,70,21,25,15,9,0
46945,650,330,320,97,77,65,28,397,234,163,44,38,23,21,0
46946,71,28,43,15,9,5,2,528,276,252,86,78,49,17,0
46947,115,62,53,13,10,9,7,514,248,266,86,82,52,22,0
46948,344,168,176,50,39,30,20,1382,508,874,334,320,98,36,0
46949,824,391,433,106,90,88,32,303,137,166,54,54,31,15,0
46950,479,227,252,69,48,46,18,137,72,65,27,13,15,8,0
46951,677,361,316,81,61,42,22,415,226,189,51,40,40,29,0
46952,150,64,86,22,12,29,12,381,196,185,55,57,43,16,0
46953,736,353,383,117,83,71,18,360,185,175,51,43,36,16,0
46954,746,312,434,129,115,77,47,319,185,134,42,31,22,13,0
46955,1339,494,845,216,298,92,37,319,185,134,42,31,22,13,0
46956,168,67,101,37,17,13,13,1117,422,695,182,134,88,32,0
46957,338,139,199,54,54,18,11,317,161,156,50,36,47,12,0
46958,308,129,179,44,60,19,8,386,181,205,55,51,57,31,0
46959,243,100,143,58,50,24,5,213,129,84,32,14,21,15,0
46960,200,94,106,33,22,18,8,1101,626,475,145,122,120,50,0
46961,553,276,277,88,61,45,27,188,105,83,25,17,24,7,0
46962,1143,574,569,176,151,123,59,1004,457,547,150,150,74,52,0
46963,852,461,391,109,102,72,24,89,37,52,13,6,2,9,0
46964,391,203,188,49,34,36,9,374,212,162,48,40,32,23,0
46965,443,206,237,76,68,52,28,461,223,238,45,62,18,35,0
46966,840,411,429,122,101,79,34,222,127,95,23,28,22,7,0
46967,666,204,462,110,194,42,14,316,159,157,38,48,30,11,0
46968,457,261,196,55,27,57,34,445,202,243,70,73,51,15,0
46969,142,60,82,20,28,13,5,363,180,183,60,34,10,6,0
46970,304,149,155,46,32,39,14,188,88,100,53,12,15,6,0
46971,282,96,186,80,21,28,7,231,126,105,37,26,29,6,0
46972,57,24,33,11,3,5,3,144,67,77,28,14,9,8,0
46973,181,75,106,35,26,11,9,647,350,297,95,79,77,29,0
46974,733,438,295,95,79,67,32,188,93,95,33,18,16,10,0
46975,184,93,91,26,25,14,11,204,96,108,31,37,20,5,0
46976,860,348,512,121,136,75,35,128,63,65,30,11,13,8,0
46977,200,103,97,17,16,10,10,125,66,59,24,16,11,5,0
46978,479,228,251,71,57,60,14,736,388,348,88,85,67,28,0
46979,224,108,116,33,26,32,10,325,172,153,44,34,27,14,0
46980,199,113,86,27,17,10,7,1034,495,539,150,134,114,71,0
46981,2285,1219,1066,207,180,178,106,153,65,88,28,21,20,8,0
46982,550,304,246,60,64,77,16,316,159,157,38,48,30,11,0
46983,631,316,315,64,57,49,15,260,131,129,42,31,40,9,0
46984,764,277,487,158,162,64,31,336,200,136,34,29,25,24,0
46985,1107,601,506,155,138,103,49,1314,693,621,174,155,140,58,0
46986,466,199,267,86,59,32,17,403,185,218,67,62,63,19,0
46987,302,160,142,35,35,37,10,471,238,233,66,63,62,19,0
46988,1970,978,992,245,206,198,80,106,41,65,36,6,11,7,0
46989,258,130,128,44,37,29,10,953,489,464,126,104,111,44,0
46990,358,206,152,45,38,67,16,295,156,139,41,40,42,15,0
46991,493,208,285,75,77,70,40,1543,794,749,182,152,132,55,0
46992,316,157,159,45,38,22,19,222,119,103,37,32,24,8,0
46993,627,237,390,137,57,108,44,266,146,120,41,28,31,7,0
46994,152,74,78,16,20,16,5,101,41,60,18,19,10,5,0
46995,977,462,515,185,119,76,12,452,231,221,74,53,56,20,0
46996,613,303,310,70,28,28,18,277,124,153,44,40,35,18,0
46997,346,174,172,36,43,21,9,593,289,304,85,69,48,19,0
46998,55,16,39,24,2,5,2,483,287,196,71,50,54,17,0
46999,425,210,215,56,43,52,25,1273,592,681,199,164,139,39,0
47000,338,164,174,45,32,37,13,536,222,314,101,100,34,22,0
47001,546,265,281,101,64,38,16,535,288,247,79,72,35,21,0
47002,421,219,202,68,57,56,13,463,170,293,115,54,75,32,0
47003,240,98,142,49,42,23,17,485,244,241,80,55,59,20,0
47004,305,124,181,27,25,31,21,133,61,72,21,19,13,4,0
47005,423,247,176,58,55,29,20,562,273,289,76,92,45,24,0
47006,641,349,292,92,60,39,24,906,455,451,116,105,87,46,0
47007,859,411,448,118,100,95,49,501,274,227,63,58,53,20,0
47008,494,242,252,67,47,25,21,749,384,365,108,105,86,31,0
47009,309,137,172,51,50,28,14,309,164,145,35,47,30,11,0
47010,270,128,142,36,43,15,11,810,310,500,164,162,42,26,0
47011,451,225,226,69,57,64,22,89,51,38,15,15,5,4,0
47012,1174,594,580,175,155,126,66,300,148,152,45,43,40,8,0
47013,1439,713,726,195,180,110,34,218,118,100,33,30,25,11,0
47014,330,77,253,86,52,20,12,415,226,189,51,40,40,29,0
47015,802,375,427,133,103,81,41,227,130,97,32,25,22,12,0
47016,437,225,212,61,57,66,12,1117,422,695,182,134,88,32,0
47017,279,127,152,50,36,28,8,96,45,51,13,12,6,4,0
47018,1121,458,663,158,210,76,47,188,90,98,44,7,21,7,0
47019,264,122,142,33,29,13,13,405,214,191,53,42,49,20,0
47020,452,202,250,83,60,56,19,222,125,97,34,27,27,7,0
47021,416,222,194,58,38,38,20,545,269,276,80,76,27,32,0
47022,284,128,156,48,29,34,8,535,301,234,63,48,47,27,0
47023,318,164,154,52,43,34,10,536,222,314,101,100,34,22,0
47024,450,227,223,53,36,48,12,515,276,239,62,59,43,31,0
47025,391,204,187,47,48,38,18,405,214,191,53,42,49,20,0
47026,380,148,232,81,69,24,8,1698,875,823,222,219,173,64,0
47027,288,104,184,80,30,39,6,445,264,181,35,35,34,14,0
47028,282,160,122,36,28,27,7,439,231,208,65,51,55,17,0
47029,517,196,321,103,98,33,12,935,515,420,126,107,73,32,0
47030,1284,511,773,227,166,169,107,516,245,271,82,84,70,26,0
47031,126,57,69,31,10,10,3,295,160,135,44,36,46,16,0
47032,406,207,199,56,46,68,19,1114,539,575,145,131,94,56,0
47033,131,69,62,29,9,9,1,320,168,152,38,42,24,18,0
47034,330,151,179,68,36,56,9,966,478,488,108,144,74,43,0
47035,338,208,130,39,30,35,12,125,66,59,24,16,11,5,0
47036,434,216,218,72,58,40,20,715,348,367,109,84,68,30,0
47037,927,457,470,130,99,118,42,465,252,213,73,58,60,18,0
47038,471,221,250,87,68,42,25,380,178,202,69,53,37,10,0
47039,1336,724,612,209,141,133,60,218,114,104,32,31,33,11,0
47040,411,211,200,61,46,35,18,671,321,350,95,87,75,34,0
47041,82,36,46,17,10,5,1,175,82,93,33,26,17,5,0
47042,2442,1193,1249,278,183,170,145,309,164,145,35,47,30,11,0
47043,629,338,291,92,57,64,22,693,360,333,100,88,62,26,0
47044,1098,519,579,182,159,79,42,375,211,164,50,36,31,23,0
47045,103,56,47,27,7,8,2,483,215,268,66,70,30,16,0
47046,622,354,268,89,60,64,18,373,181,192,54,35,44,20,0
47047,305,124,181,27,25,32,21,134,72,62,14,28,8,4,0
47048,426,214,212,63,47,53,20,265,134,131,48,34,33,15,0
47049,426,213,213,60,56,46,24,107,77,30,7,2,9,5,0
47050,308,163,145,38,33,30,20,348,212,136,53,31,25,18,0
47051,1849,931,918,245,220,158,90,251,143,108,47,25,29,11,0
47052,412,193,219,69,57,43,14,535,311,224,66,52,49,24,0
47053,236,120,116,32,28,21,11,660,332,328,84,73,47,19,0
47054,524,262,262,62,72,39,49,320,168,152,38,42,24,18,0
47055,580,265,315,97,89,79,17,1698,875,823,222,219,173,64,0
47056,629,374,255,74,53,87,27,398,200,198,68,43,51,14,0
47057,470,163,307,99,68,73,30,72,32,40,8,2,1,14,0
47058,184,93,91,26,25,14,11,1922,923,999,267,275,215,90,0
47059,130,71,59,30,9,8,1,384,204,180,53,47,49,17,0
47060,485,237,248,83,35,52,24,180,90,90,31,19,20,8,0
47061,441,216,225,57,66,57,19,1696,771,925,257,225,149,63,0
47062,156,64,92,31,19,5,4,203,98,105,34,29,19,10,0
47063,508,251,257,74,53,51,18,1265,689,576,169,177,128,60,0
47064,367,199,168,41,41,33,16,641,309,332,98,85,87,30,0
47065,236,120,116,32,28,21,11,501,249,252,77,70,55,22,0
47066,271,136,135,37,30,18,10,557,281,276,80,59,43,21,0
47067,126,58,68,31,10,10,3,149,52,97,36,36,7,4,0
47068,417,176,241,75,61,51,20,556,290,266,75,74,29,24,0
47069,1447,698,749,214,180,116,46,91,42,49,21,9,8,3,0
47070,179,96,83,24,8,26,4,761,351,410,117,73,103,45,0
47071,640,308,332,91,102,49,21,287,151,136,51,42,36,7,0
47072,473,265,208,47,26,50,30,548,296,252,71,74,43,28,0
47073,479,228,251,71,57,60,14,245,121,124,37,35,36,12,0
47074,222,110,112,43,30,14,6,332,180,152,44,36,27,13,0
47075,1098,519,579,182,159,79,42,341,170,171,41,66,27,10,0
47076,292,102,190,71,27,51,21,1700,731,969,198,233,110,87,0
47077,211,92,119,33,44,11,7,326,169,157,51,41,41,12,0
47078,249,104,145,47,41,24,17,481,223,258,71,70,49,26,0
47079,1096,563,533,158,136,120,53,373,189,184,54,46,50,23,0
47080,1009,487,522,177,121,103,51,72,32,40,8,2,2,13,0
47081,431,245,186,50,23,46,17,180,115,65,17,12,9,9,0
47082,241,122,119,27,34,17,16,531,277,254,82,75,33,22,0
47083,595,339,256,64,36,54,24,501,240,261,80,62,49,42,0
47084,213,114,99,62,7,2,1,256,141,115,32,22,32,8,0
47085,454,230,224,63,56,38,33,296,151,145,45,42,32,11,0
47086,895,388,507,130,84,90,31,475,251,224,67,49,48,23,0
47087,584,340,244,77,60,47,25,611,314,297,79,75,78,22,0
47088,215,104,111,61,7,2,1,201,93,108,34,39,21,6,0
47089,243,70,173,54,65,8,6,260,133,127,43,32,39,3,0
47090,2236,1195,1041,227,187,186,118,773,389,384,119,91,79,26,0
47091,127,62,65,13,33,7,6,296,159,137,49,28,38,13,0
47092,186,56,130,46,50,16,7,535,288,247,79,72,35,21,0
47093,269,127,142,43,24,34,26,262,129,133,40,41,31,10,0
47094,420,202,218,67,43,51,15,328,199,129,39,29,27,14,0
47095,391,203,188,49,34,36,9,276,149,127,34,31,32,10,0
47096,82,36,46,17,10,5,1,583,321,262,73,67,45,25,0
47097,213,88,125,21,54,14,15,300,148,152,45,43,40,8,0
47098,261,126,135,41,36,24,11,360,180,180,57,48,39,12,0
47099,758,378,380,89,64,37,31,165,87,78,24,19,22,9,0
47100,253,133,120,44,31,22,8,335,170,165,52,36,47,11,0
47101,396,150,246,103,64,38,3,396,213,183,68,44,47,18,0
47102,169,64,105,23,37,11,3,222,122,100,39,32,24,9,0
47103,1163,417,746,209,145,87,28,222,119,103,37,32,24,8,0
47104,76,42,34,12,8,5,7,410,197,213,67,43,56,18,0
47105,622,354,268,89,60,64,18,399,190,209,61,41,39,18,0
47106,507,314,193,49,45,59,25,385,212,173,57,40,39,21,0
47107,241,122,119,27,34,17,16,262,129,133,40,41,31,10,0
47108,747,469,278,60,41,53,23,335,186,149,40,28,29,13,0
47109,257,122,135,44,19,21,16,124,69,55,14,7,9,4,0
47110,480,267,213,49,44,70,21,621,273,348,104,102,48,19,0
47111,224,108,116,33,26,32,10,485,244,241,80,55,59,20,0
47112,556,306,250,69,60,80,18,403,221,182,62,50,42,12,0
47113,347,212,135,35,32,17,6,390,190,200,66,50,43,12,0
47114,1872,837,1035,280,338,169,80,627,289,338,101,73,62,43,0
47115,758,378,380,89,64,37,31,189,105,84,25,26,21,9,0
47116,1085,646,439,108,65,36,19,87,51,35,15,9,9,4,0
47117,556,306,250,69,60,80,18,256,141,115,32,22,32,8,0
47118,435,222,213,67,49,67,12,427,251,176,51,39,25,22,0
47119,548,250,298,85,64,56,21,187,89,98,36,24,20,6,0
47120,288,104,184,80,30,39,6,215,115,100,27,19,16,7,0
47121,631,316,315,64,57,49,15,452,252,200,55,49,61,16,0
47122,469,253,216,49,51,48,18,928,440,488,111,157,82,35,0
47123,451,225,226,69,57,64,22,415,205,210,77,52,55,17,0
47124,267,146,121,40,24,25,7,535,288,247,79,72,35,21,0
47125,261,137,124,34,23,13,8,135,57,78,21,20,9,11,0
47126,474,250,224,58,47,37,12,925,439,486,141,134,105,46,0
47127,500,257,243,60,55,27,22,402,186,216,64,47,38,20,0
47128,142,60,82,20,28,13,5,192,110,82,33,21,10,3,0
47129,396,150,246,103,64,38,3,88,50,38,13,8,16,4,0
47130,335,171,164,51,38,38,10,367,199,168,62,44,34,8,0
47131,302,178,124,34,29,50,13,137,63,74,20,22,14,6,0
47132,234,110,124,39,29,23,2,103,59,44,25,2,13,6,0
47133,271,136,135,37,30,18,10,234,129,105,31,22,19,17,0
47134,425,199,226,54,71,56,11,547,295,252,81,65,57,23,0
47135,308,163,145,38,33,30,20,485,244,241,80,55,59,20,0
47136,213,113,100,26,21,26,12,633,311,322,94,82,45,20,0
47137,489,253,236,73,36,62,17,1034,495,539,150,134,114,71,0
47138,753,395,358,93,72,71,16,462,251,211,74,53,41,18,0
47139,800,416,384,102,105,83,22,1537,701,836,209,187,129,58,0
47140,282,160,122,36,28,27,7,953,489,464,126,104,111,44,0
47141,309,137,172,51,50,28,14,106,46,60,29,13,14,5,0
47142,886,440,446,116,140,95,45,344,190,154,34,31,36,10,0
47143,443,212,231,74,24,60,24,245,131,114,30,27,18,13,0
47144,553,276,277,88,61,45,27,410,197,213,67,43,56,18,0
47145,449,179,270,80,77,49,29,201,99,102,34,26,23,6,0
47146,484,264,220,59,62,68,15,297,175,122,46,30,31,6,0
47147,338,208,130,39,30,35,12,629,317,312,80,87,51,22,0
47148,560,279,281,113,64,58,15,430,212,218,88,43,40,20,0
47149,852,461,391,109,102,72,24,290,142,148,41,37,43,11,0
47150,270,147,123,34,17,39,21,290,142,148,41,37,43,11,0
47151,533,297,236,74,57,39,28,290,142,148,41,37,43,11,0
47152,121,69,52,15,18,14,8,673,313,360,102,101,46,17,0
47153,795,384,411,133,109,85,38,209,119,90,28,24,27,9,0
47154,131,69,62,29,9,9,1,421,222,199,69,50,60,18,0
47155,331,165,166,52,34,48,22,245,131,114,30,27,18,13,0
47156,1498,731,767,220,175,148,68,322,180,142,45,38,28,7,0
47157,243,70,173,54,65,8,6,250,119,131,58,26,29,7,0
47158,396,150,246,103,64,38,3,723,353,370,120,109,96,33,0
47159,505,282,223,60,57,66,23,375,210,165,49,37,29,27,0
47160,303,147,156,49,49,20,8,1262,653,609,169,165,152,50,0
47161,368,154,214,80,52,41,16,199,92,107,34,30,18,9,0
47162,132,66,66,21,18,11,7,72,32,40,8,2,2,13,0
47163,217,98,119,38,35,18,9,103,59,44,25,2,13,6,0
47164,358,206,152,45,38,67,16,381,186,195,69,55,46,15,0
47165,411,236,175,39,45,50,30,389,207,182,53,58,52,18,0
47166,447,232,215,55,65,50,25,173,90,83,30,19,19,11,0
47167,206,100,106,34,26,11,7,405,195,210,57,74,24,17,0
47168,753,395,358,93,72,71,16,198,115,83,30,22,8,8,0
47169,261,126,135,41,36,24,11,225,114,111,32,29,26,6,0
47170,529,290,239,54,63,85,15,252,130,122,45,23,32,11,0
47171,132,66,66,21,18,11,7,367,218,149,45,43,42,16,0
47172,1189,653,536,152,118,109,56,94,45,49,11,20,10,4,0
47173,258,130,128,44,37,29,10,329,194,135,45,32,33,9,0
47174,474,250,224,58,47,37,12,928,440,488,111,157,82,35,0
47175,437,212,225,66,44,44,11,751,394,357,107,96,73,35,0
47176,545,221,324,101,72,55,30,593,289,304,85,69,48,19,0
47177,297,161,136,36,35,24,9,497,257,240,71,63,62,16,0
47178,344,109,235,100,39,26,5,439,227,212,60,55,58,8,0
47179,411,236,175,39,45,50,30,148,69,79,26,18,16,3,0
47180,919,444,475,141,148,62,20,119,61,58,17,12,10,6,0
47181,1052,492,560,184,163,103,44,373,213,160,44,33,26,17,0
47182,567,256,311,91,81,53,17,671,321,350,95,87,75,34,0
47183,310,141,169,36,38,20,8,483,258,225,70,53,54,20,0
47184,616,304,312,75,71,55,25,218,115,103,32,32,34,11,0
47185,156,64,92,31,19,5,4,501,274,227,63,58,53,20,0
47186,522,302,220,61,49,75,19,222,119,103,37,32,24,8,0
47187,803,358,445,135,117,80,43,926,340,586,133,119,60,40,0
47188,311,154,157,47,29,34,13,727,362,365,123,107,63,23,0
47189,1058,497,561,194,142,87,63,902,499,403,118,117,92,35,0
47190,331,177,154,54,38,27,11,453,255,198,62,49,29,19,0
47191,441,218,223,69,55,50,27,520,272,248,60,65,58,22,0
47192,577,251,326,92,84,60,11,107,77,30,7,2,9,5,0
47193,473,265,208,47,26,50,30,1262,653,609,169,165,152,50,0
47194,119,57,62,18,16,17,4,338,164,174,45,32,37,13,0
47195,763,354,409,101,90,63,26,287,151,136,51,42,36,7,0
47196,347,181,166,27,20,12,12,375,176,199,48,61,40,12,0
47197,580,308,272,82,79,58,25,1500,804,696,190,172,144,60,0
47198,688,310,378,130,82,78,47,723,353,370,120,109,96,33,0
47199,450,227,223,53,36,48,12,437,224,213,40,29,42,25,0
47200,128,70,58,29,9,8,1,297,175,122,46,30,31,6,0
47201,1759,838,921,269,212,191,92,362,156,206,74,42,36,22,0
47202,129,70,59,29,9,7,2,974,457,517,133,117,69,26,0
47203,126,58,68,31,10,10,3,514,248,266,86,82,52,22,0
47204,317,140,177,43,26,31,16,68,23,45,12,9,3,9,0
47205,257,122,135,44,19,21,16,349,200,149,41,39,30,20,0
47206,755,271,484,113,226,61,20,528,276,252,86,78,49,17,0
47207,234,108,126,42,40,15,9,508,262,246,66,67,51,20,0
47208,350,172,178,61,45,32,13,588,286,302,78,99,53,25,0
47209,315,111,204,82,66,46,11,375,211,164,50,36,31,23,0
47210,297,182,115,41,22,23,8,312,165,147,41,39,29,16,0
47211,508,251,257,74,53,51,18,295,160,135,44,36,46,16,0
47212,674,318,356,86,139,50,11,145,77,68,26,7,15,8,0
47213,3230,1724,1506,361,358,157,75,307,132,175,48,53,26,10,0
47214,303,147,156,49,49,20,8,622,344,278,80,77,68,36,0
47215,1161,514,647,159,138,122,37,398,200,198,68,43,51,14,0
47216,172,82,90,21,35,21,5,1034,495,539,150,134,114,71,0
47217,577,251,326,92,84,60,11,54,26,28,11,4,3,3,0
47218,238,158,80,28,15,31,7,846,425,421,125,97,98,38,0
47219,439,241,198,67,40,40,13,192,110,82,33,21,10,3,0
47220,233,107,126,40,40,20,16,536,267,269,60,70,41,22,0
47221,714,260,454,140,97,120,54,341,170,171,41,66,27,10,0
47222,453,240,213,53,33,44,16,474,268,206,66,42,45,24,0
47223,309,137,172,51,50,28,14,339,175,164,51,49,37,9,0
47224,867,415,452,123,87,62,27,403,184,219,75,51,47,20,0
47225,1341,481,860,275,264,57,21,461,223,238,45,62,18,35,0
47226,312,173,139,43,47,28,6,501,274,227,63,58,53,20,0
47227,330,182,148,47,27,40,11,452,252,200,55,49,61,16,0
47228,560,279,281,113,64,58,15,290,147,143,34,34,39,13,0
47229,1009,478,531,166,126,96,42,1004,457,547,150,150,74,52,0
47230,107,36,71,27,15,0,1,332,180,152,46,36,28,14,0
47231,231,105,126,56,10,24,10,530,287,243,79,70,33,26,0
47232,471,221,250,87,68,42,25,592,249,343,91,90,50,42,0
47233,389,176,213,81,59,24,7,309,164,145,35,47,30,11,0
47234,786,378,408,106,98,77,39,421,222,199,69,50,60,18,0
47235,349,131,218,66,76,22,9,425,177,248,60,62,33,16,0
47236,579,281,298,91,78,74,27,775,407,368,122,100,97,32,0
47237,2285,1219,1066,207,180,178,106,148,69,79,26,18,16,3,0
47238,624,222,402,92,81,39,15,1101,626,475,145,122,120,50,0
47239,470,163,307,99,68,73,30,142,65,77,30,17,22,9,0
47240,528,273,255,67,53,29,20,866,397,469,117,153,95,48,0
47241,1214,498,716,197,180,121,65,348,212,136,53,31,25,18,0
47242,548,310,238,72,62,54,13,200,99,101,31,24,26,6,0
47243,288,142,146,52,32,26,8,1113,480,633,170,173,81,34,0
47244,71,28,43,15,9,5,2,415,226,189,51,40,40,29,0
47245,861,393,468,150,101,69,35,386,207,179,43,48,44,19,0
47246,341,195,146,42,21,36,9,422,202,220,80,52,57,18,0
47247,257,122,135,44,19,21,16,485,244,241,80,55,59,20,0
47248,265,165,100,32,19,27,5,144,67,77,28,14,9,8,0
47249,392,205,187,83,49,38,10,396,213,183,68,44,47,18,0
47250,732,355,377,108,109,79,27,218,117,101,35,32,34,12,0
47251,512,254,258,70,48,37,32,664,350,314,86,90,82,36,0
47252,461,257,204,63,49,50,29,309,164,145,35,47,30,11,0
47253,496,210,286,111,55,74,13,633,311,322,94,82,45,20,0
47254,426,213,213,60,56,46,24,756,348,408,101,103,60,40,0
47255,172,82,90,21,35,21,5,671,306,365,114,76,49,19,0
47256,132,66,66,21,18,11,7,737,397,340,87,104,90,14,0
47257,956,450,506,122,117,82,36,661,325,336,81,75,65,28,0
47258,436,209,227,66,47,52,22,227,130,97,32,25,22,12,0
47259,531,284,247,66,42,49,15,332,180,152,46,36,28,14,0
47260,416,207,209,63,47,56,15,693,360,333,100,88,62,26,0
47261,1112,457,655,180,164,99,39,424,179,245,65,67,29,11,0
47262,181,92,89,34,22,17,9,336,200,136,34,29,25,24,0
47263,879,457,422,93,98,143,32,231,126,105,37,26,29,6,0
47264,714,260,454,140,97,120,54,323,162,161,52,41,39,13,0
47265,636,288,348,94,77,65,30,481,223,258,71,70,49,26,0
47266,142,60,82,20,28,13,5,103,59,44,25,2,13,6,0
47267,480,257,223,74,26,60,27,798,385,413,120,115,79,30,0
47268,338,173,165,31,42,22,10,359,171,188,49,74,45,11,0
47269,1124,442,682,148,189,72,43,149,52,97,36,36,7,4,0
47270,494,242,252,67,47,25,21,406,234,172,63,35,43,10,0
47271,82,36,46,17,10,5,1,403,225,178,56,38,33,25,0
47272,531,284,247,66,42,49,15,158,71,87,23,21,17,12,0
47273,317,153,164,34,52,30,14,391,165,226,67,64,36,27,0
47274,473,265,208,47,26,50,30,373,213,160,44,33,26,17,0
47275,760,322,438,81,130,57,19,133,61,72,21,19,13,4,0
47276,636,288,348,94,77,65,30,91,42,49,21,9,8,3,0
47277,692,305,387,100,97,78,30,507,270,237,89,59,57,22,0
47278,336,199,137,46,22,51,13,308,146,162,42,39,24,12,0
47279,514,226,288,71,66,63,32,73,35,38,14,10,9,4,0
47280,136,66,70,33,11,9,4,212,127,85,28,21,26,6,0
47281,2696,1169,1527,432,347,193,146,277,138,139,40,39,20,14,0
47282,140,77,63,16,24,7,4,574,347,227,61,55,46,34,0
47283,5890,3314,2576,970,956,293,265,54,26,28,11,4,3,3,0
47284,466,259,207,59,50,83,12,225,114,111,32,29,26,6,0
47285,130,71,59,30,9,8,1,660,303,357,97,89,85,33,0
47286,126,66,60,24,10,7,9,607,293,314,98,71,62,32,0
47287,867,415,452,123,87,62,27,419,233,186,54,53,55,17,0
47288,359,167,192,49,37,27,19,163,79,84,22,24,13,5,0
47289,176,74,102,20,29,7,7,453,255,198,62,49,29,19,0
47290,476,276,200,57,34,43,16,415,226,189,51,40,40,29,0
47291,349,153,196,54,47,28,13,1700,731,969,198,233,110,87,0
47292,802,430,372,65,102,87,23,290,142,148,41,37,43,11,0
47293,609,292,317,102,96,64,21,375,209,166,50,37,29,23,0
47294,1054,497,557,190,168,107,45,127,54,73,11,33,15,6,0
47295,752,313,439,121,106,68,27,423,234,189,66,44,57,12,0
47296,1161,514,647,159,138,122,37,406,202,204,54,51,63,21,0
47297,979,534,445,83,77,80,24,1873,935,938,233,225,203,79,0
47298,179,78,101,29,22,10,8,485,244,241,80,55,59,20,0
47299,629,374,255,74,53,87,27,479,215,264,67,80,46,28,0
47300,279,127,152,50,36,28,8,520,244,276,91,60,68,20,0
47301,434,221,213,58,47,54,15,87,38,49,23,10,10,9,0
47302,615,308,307,83,75,58,32,190,93,97,35,27,23,2,0
47303,339,170,169,32,17,24,13,373,189,184,54,46,50,23,0
47304,369,207,162,67,35,16,14,125,66,59,24,16,11,5,0
47305,181,75,106,35,26,11,9,207,113,94,33,18,30,9,0
47306,654,384,270,92,56,43,37,379,167,212,54,49,32,33,0
47307,859,411,448,118,100,95,49,405,214,191,53,42,49,20,0
47308,772,417,355,118,92,80,23,301,168,133,49,37,34,11,0
47309,336,199,137,46,22,51,13,548,273,275,84,81,64,30,0
47310,203,97,106,30,22,18,10,166,90,76,27,18,21,5,0
47311,346,208,138,46,39,51,18,153,65,88,28,21,20,8,0
47312,260,136,124,24,41,19,4,374,212,162,48,40,32,23,0
47313,283,112,171,48,39,34,15,375,209,166,50,37,29,23,0
47314,283,172,111,39,31,29,8,229,120,109,31,30,22,9,0
47315,288,104,184,80,30,39,6,267,141,126,53,27,23,7,0
47316,929,410,519,187,146,53,30,390,223,167,58,36,45,18,0
47317,622,354,268,89,60,64,18,322,180,142,45,38,28,7,0
47318,228,82,146,45,37,18,8,588,286,302,78,99,53,25,0
47319,584,340,244,77,60,47,25,479,215,264,67,80,46,28,0
47320,524,361,163,41,8,28,16,106,41,65,36,6,11,7,0
47321,346,209,137,46,37,44,10,530,287,243,79,70,33,26,0
47322,428,248,180,44,39,28,9,326,149,177,51,51,28,10,0
47323,785,374,411,56,42,38,25,396,199,197,54,50,45,14,0
47324,334,190,144,42,42,16,5,395,198,197,55,55,36,10,0
47325,665,341,324,109,79,38,22,354,183,171,54,43,49,8,0
47326,784,353,431,56,47,26,18,169,85,84,21,14,9,9,0
47327,837,443,394,129,89,87,38,898,469,429,125,125,134,35,0
47328,941,459,482,167,140,82,38,225,114,111,32,29,26,6,0
47329,210,84,126,44,43,9,4,1698,875,823,222,219,173,64,0
47330,213,104,109,56,14,9,2,4646,2328,2318,674,639,475,170,0
47331,310,141,169,36,38,20,8,415,189,226,68,54,50,21,0
47332,517,245,272,92,77,46,24,902,499,403,118,117,92,35,0
47333,380,148,232,81,69,24,8,1543,794,749,182,152,132,55,0
47334,554,217,337,112,72,90,38,408,221,187,55,51,57,14,0
47335,57,24,33,11,3,5,3,437,224,213,40,29,42,25,0
47336,302,178,124,34,29,50,13,277,138,139,40,39,20,14,0
47337,414,216,198,51,32,42,28,720,361,359,98,98,70,37,0
47338,665,341,324,109,79,38,22,775,407,368,122,100,97,32,0
47339,130,71,59,30,9,8,1,547,295,252,81,65,57,23,0
47340,264,122,142,33,29,13,13,228,130,98,35,29,30,10,0
47341,2414,1189,1225,277,178,170,169,866,478,388,121,101,101,26,0
47342,278,110,168,58,49,29,5,410,197,213,67,43,56,18,0
47343,92,46,46,14,9,8,6,87,38,49,23,10,10,9,0
47344,496,210,286,111,55,74,13,723,353,370,120,109,96,33,0
47345,238,158,80,28,15,31,7,198,113,85,19,20,26,12,0
47346,193,90,103,44,9,19,13,555,292,263,75,63,67,27,0
47347,399,220,179,48,37,68,18,222,119,103,37,32,24,8,0
47348,317,167,150,45,21,30,26,441,189,252,73,50,47,23,0
47349,454,214,240,56,71,35,16,227,130,97,32,25,22,12,0
47350,949,466,483,125,126,101,50,136,65,71,26,11,7,5,0
47351,410,188,222,53,52,31,14,102,51,51,12,15,12,3,0
47352,1030,438,592,184,104,108,30,188,88,100,53,12,15,6,0
47353,862,384,478,127,110,75,42,629,317,312,80,87,51,22,0
47354,869,489,380,110,77,79,29,975,475,500,139,140,119,28,0
47355,385,203,182,47,43,51,21,1113,480,633,170,173,81,34,0
47356,439,183,256,60,64,36,14,756,348,408,101,103,60,40,0
47357,561,282,279,68,62,36,14,455,191,264,68,86,21,19,0
47358,1390,585,805,241,230,118,46,287,151,136,51,42,36,7,0
47359,209,75,134,53,48,20,9,334,181,153,41,40,25,15,0
47360,417,176,241,75,61,51,20,180,90,90,31,19,20,8,0
47361,485,246,239,74,48,47,22,497,257,240,71,63,62,16,0
47362,630,231,399,150,83,84,50,303,138,165,47,46,35,18,0
47363,282,96,186,80,21,28,7,501,240,261,80,62,49,42,0
47364,465,220,245,88,34,61,23,481,223,258,71,70,49,26,0
47365,181,75,106,35,26,11,9,607,294,313,94,95,62,14,0
47366,299,128,171,57,40,13,25,360,185,175,51,43,36,16,0
47367,729,351,378,111,98,58,18,349,200,149,41,39,30,20,0
47368,126,57,69,31,10,10,3,277,138,139,40,39,20,14,0
47369,375,201,174,52,56,39,15,119,61,58,17,12,10,6,0
47370,593,282,311,75,70,29,25,386,207,179,43,48,44,19,0
47371,1580,742,838,208,146,144,71,629,317,312,80,87,51,22,0
47372,428,226,202,52,60,75,20,279,161,118,37,32,7,7,0
47373,763,371,392,104,88,52,23,1395,627,768,172,263,141,59,0
47374,2624,999,1625,415,495,109,84,127,54,73,11,33,15,6,0
47375,380,187,193,38,51,30,18,207,114,93,33,20,31,13,0
47376,1009,478,531,166,126,96,42,792,398,394,109,96,90,39,0
47377,781,316,465,130,129,65,23,247,128,119,34,14,16,14,0
47378,269,127,142,43,24,34,26,297,175,122,46,30,31,6,0
47379,157,62,95,41,18,10,11,485,244,241,80,55,59,20,0
47380,456,223,233,77,54,47,20,205,94,111,48,31,15,6,0
47381,218,133,85,20,19,13,6,464,236,228,64,56,53,28,0
47382,349,153,196,54,47,28,13,376,189,187,47,53,44,26,0
47383,240,166,74,32,12,8,15,303,137,166,54,54,31,15,0
47384,343,162,181,65,38,29,12,397,234,163,44,38,23,21,0
47385,446,195,251,56,53,31,15,367,199,168,62,44,34,8,0
47386,126,66,60,24,10,7,9,332,155,177,55,51,44,13,0
47387,398,186,212,76,70,18,13,640,364,276,84,68,69,33,0
47388,437,228,209,47,61,26,11,103,50,53,19,10,7,5,0
47389,911,489,422,121,98,97,36,663,360,303,87,82,80,35,0
47390,181,75,106,35,26,11,9,124,69,55,14,7,9,4,0
47391,789,362,427,90,82,70,35,373,181,192,54,35,44,20,0
47392,167,70,97,32,20,15,7,430,212,218,88,43,40,20,0
47393,509,251,258,69,49,55,17,518,292,226,60,60,52,21,0
47394,364,172,192,55,57,32,15,2202,1121,1081,338,274,269,81,0
47395,474,250,224,58,47,37,12,149,52,97,36,36,7,4,0
47396,437,228,209,47,61,26,11,230,125,105,29,40,20,6,0
47397,479,228,251,71,57,60,14,662,312,350,103,104,59,20,0
47398,1872,837,1035,280,338,169,80,434,213,221,77,62,53,12,0
47399,636,288,348,94,77,65,30,403,221,182,62,50,42,12,0
47400,484,194,290,70,93,47,16,633,311,322,94,82,45,20,0
47401,1755,849,906,245,226,148,56,975,400,575,160,162,62,31,0
47402,410,208,202,59,58,43,26,137,85,52,15,11,11,2,0
47403,236,141,95,36,32,14,6,661,325,336,81,75,65,28,0
47404,1463,521,942,252,204,105,52,609,335,274,79,57,45,22,0
47405,717,381,336,118,103,85,29,105,51,54,13,17,12,8,0
47406,259,119,140,48,28,29,19,392,214,178,48,40,53,22,0
47407,746,312,434,129,115,77,47,418,246,172,52,39,57,10,0
47408,315,111,204,82,66,46,11,207,113,94,33,18,30,9,0
47409,773,383,390,108,76,79,30,240,141,99,34,28,29,8,0
47410,485,237,248,83,35,52,24,148,69,79,26,18,16,3,0
47411,801,331,470,151,139,99,55,352,207,145,40,33,25,21,0
47412,411,236,175,39,45,50,30,526,266,260,76,75,53,22,0
47413,258,144,114,33,22,19,9,843,391,452,139,104,91,35,0
47414,260,136,124,24,41,19,4,792,398,394,109,96,90,39,0
47415,760,322,438,81,130,57,19,966,478,488,108,144,74,43,0
47416,202,103,99,28,20,12,8,250,116,134,41,30,33,19,0
47417,1214,612,602,169,173,98,35,396,199,197,54,50,45,14,0
47418,323,156,167,52,45,39,18,261,148,113,31,28,14,10,0
47419,199,113,86,27,17,10,7,627,289,338,101,73,62,43,0
47420,347,198,149,45,29,29,8,963,455,508,127,130,115,48,0
47421,332,173,159,48,42,42,9,111,60,51,17,23,10,7,0
47422,334,155,179,47,34,38,11,597,269,328,102,84,69,24,0
47423,1105,544,561,165,167,99,40,129,60,69,21,15,8,5,0
47424,1186,495,691,182,208,88,32,439,231,208,65,51,55,17,0
47425,629,338,291,92,57,64,22,928,440,488,111,157,82,35,0
47426,1360,644,716,213,194,136,62,565,237,328,75,88,32,11,0
47427,367,167,200,63,42,60,17,368,200,168,54,49,43,9,0
47428,412,208,204,54,47,42,17,306,157,149,52,35,39,16,0
47429,449,179,270,80,77,49,29,810,310,500,164,162,42,26,0
47430,820,333,487,202,152,59,23,368,200,168,54,49,43,9,0
47431,928,442,486,139,118,91,43,266,150,116,28,28,24,12,0
47432,431,202,229,57,50,50,25,902,499,403,118,117,92,35,0
47433,567,266,301,139,46,76,37,266,146,120,41,28,31,7,0
47434,162,73,89,32,19,4,4,218,115,103,32,32,34,11,0
47435,496,210,286,111,55,74,13,649,307,342,71,134,45,17,0
47436,1023,449,574,141,174,76,43,467,240,227,65,65,51,23,0
47437,259,119,140,48,28,29,19,264,138,126,33,34,29,12,0
47438,118,56,62,24,12,6,9,504,272,232,75,57,53,19,0
47439,739,389,350,129,61,69,25,396,223,173,57,37,44,19,0
47440,1390,705,685,219,164,129,74,441,189,252,73,50,47,23,0
47441,1339,494,845,216,298,92,37,220,107,113,36,35,28,9,0
47442,764,277,487,158,162,64,31,514,248,266,86,82,52,22,0
47443,887,439,448,137,99,91,38,1230,644,586,198,125,123,61,0
47444,258,126,132,38,22,29,8,279,142,137,43,39,28,7,0
47445,122,56,66,26,13,11,5,187,89,98,36,24,20,6,0
47446,71,28,43,15,9,5,2,218,115,103,32,32,34,11,0
47447,1214,612,602,169,173,98,35,317,161,156,50,36,47,12,0
47448,624,222,402,92,81,39,15,415,226,189,51,40,40,29,0
47449,856,429,427,113,105,96,24,338,169,169,53,44,39,21,0
47450,270,128,142,36,43,15,11,337,152,185,49,54,42,21,0
47451,360,205,155,35,24,52,14,1755,905,850,214,196,183,79,0
47452,1009,478,531,166,126,96,42,592,249,343,91,90,50,42,0
47453,401,236,165,53,38,34,9,621,310,311,100,106,77,27,0
47454,524,262,262,62,72,39,49,218,115,103,32,32,34,11,0
47455,493,281,212,56,61,30,13,780,337,443,112,116,77,28,0
47456,484,264,220,59,62,68,15,862,409,453,149,125,86,29,0
47457,232,134,98,28,20,20,5,274,157,117,40,29,40,8,0
47458,1417,598,819,223,188,135,58,261,127,134,36,27,36,4,0
47459,413,206,207,38,55,19,10,378,154,224,74,84,35,22,0
47460,161,94,67,23,13,8,10,421,222,199,69,50,60,18,0
47461,453,240,213,53,33,44,16,422,237,185,53,47,62,20,0
47462,327,174,153,42,35,16,12,292,155,137,50,34,29,13,0
47463,410,188,222,53,52,31,14,469,225,244,64,68,25,11,0
47464,258,130,128,44,37,29,10,748,359,389,125,113,86,31,0
47465,57,24,33,11,3,5,3,301,168,133,49,37,34,11,0
47466,960,409,551,166,134,77,44,222,119,103,37,32,24,8,0
47467,805,338,467,153,138,99,55,453,255,198,62,49,29,19,0
47468,76,42,34,12,8,5,7,514,262,252,78,58,54,26,0
47469,613,303,310,70,28,28,18,127,66,61,13,14,19,8,0
47470,548,250,298,85,64,56,21,332,180,152,46,36,28,14,0
47471,317,153,164,34,52,30,14,119,67,52,15,15,7,7,0
47472,708,344,364,106,98,66,33,270,162,108,26,26,16,11,0
47473,350,172,178,61,45,32,13,720,361,359,98,98,70,37,0
47474,594,248,346,104,109,53,5,65,32,33,16,4,8,3,0
47475,520,231,289,89,59,58,26,309,164,145,35,47,30,11,0
47476,126,56,70,31,10,10,3,250,119,131,58,26,29,7,0
47477,480,257,223,74,26,60,27,147,74,73,28,20,24,4,0
47478,1556,718,838,280,182,161,49,579,285,294,78,72,64,32,0
47479,595,316,279,86,60,65,40,166,102,64,19,14,17,2,0
47480,320,183,137,51,18,38,8,241,127,114,34,33,29,12,0
47481,574,284,290,64,50,65,20,139,68,71,14,26,14,9,0
47482,222,108,114,37,20,25,12,404,190,214,55,55,35,27,0
47483,210,84,126,44,43,9,4,96,45,51,13,12,6,4,0
47484,71,28,43,15,9,5,2,557,281,276,80,59,43,21,0
47485,421,237,184,47,54,45,10,432,244,188,51,51,27,14,0
47486,288,142,146,52,32,26,8,165,90,75,36,18,20,6,0
47487,681,367,314,83,74,78,31,572,305,267,74,72,58,21,0
47488,504,222,282,71,64,53,29,201,99,102,34,26,23,6,0
47489,801,331,470,151,139,99,55,200,89,111,26,25,17,7,0
47490,859,411,448,118,100,95,49,798,385,413,120,115,79,30,0
47491,142,60,82,20,28,13,5,555,282,273,82,69,65,21,0
47492,341,154,187,34,36,11,11,302,150,152,56,40,52,15,0
47493,336,199,137,46,22,51,13,337,170,167,59,33,47,17,0
47494,161,75,86,24,20,10,7,597,269,328,102,84,69,24,0
47495,390,199,191,72,42,35,12,283,142,141,41,33,26,18,0
47496,561,282,279,68,62,36,14,1166,514,652,150,159,107,70,0
47497,123,58,65,22,14,13,3,452,231,221,74,53,56,20,0
47498,179,96,83,24,8,26,4,201,117,83,22,21,19,9,0
47499,520,240,280,87,63,67,16,536,267,269,60,70,41,22,0
47500,257,122,135,44,19,21,16,2542,1245,1297,285,287,170,84,0
47501,334,155,179,47,34,38,11,54,26,28,11,4,3,3,0
47502,340,145,195,46,38,26,23,127,66,61,13,14,19,8,0
47503,493,208,285,75,77,70,40,377,184,193,50,43,33,17,0
47504,550,304,246,60,64,77,16,245,131,114,30,27,18,13,0
47505,242,104,138,41,33,37,8,474,268,206,66,42,45,24,0
47506,959,496,463,144,132,75,35,516,245,271,82,84,70,26,0
47507,772,417,355,118,92,80,23,332,155,177,55,51,44,13,0
47508,1276,607,669,192,178,136,63,142,73,69,27,9,15,11,0
47509,224,108,116,31,32,22,8,485,244,241,80,55,59,20,0
47510,840,411,429,122,101,79,34,579,285,294,78,72,64,32,0
47511,350,172,178,61,45,32,13,1101,626,475,145,122,120,50,0
47512,588,317,271,78,49,54,17,508,261,247,65,53,58,23,0
47513,510,288,222,44,36,24,7,296,151,145,45,42,32,11,0
47514,127,55,72,25,18,5,7,467,231,236,71,65,58,18,0
47515,1148,472,676,229,164,86,37,531,277,254,82,75,33,22,0
47516,332,173,159,48,42,42,9,260,131,129,42,31,40,9,0
47517,539,283,256,75,73,53,26,457,242,215,39,46,53,10,0
47518,1342,640,702,187,163,123,57,622,344,278,80,77,68,36,0
47519,411,202,209,60,67,57,24,621,310,311,100,106,77,27,0
47520,251,131,120,49,35,25,5,322,180,142,45,38,28,7,0
47521,388,244,144,46,25,42,16,314,151,163,42,61,39,16,0
47522,193,110,83,18,20,15,12,172,79,93,34,27,23,10,0
47523,553,319,234,56,37,54,18,453,247,206,58,53,45,20,0
47524,364,204,160,65,35,15,13,386,181,205,55,51,57,31,0
47525,258,126,132,38,22,29,8,439,227,212,60,55,58,8,0
47526,406,208,198,41,26,43,21,228,130,98,35,29,30,10,0
47527,1257,464,793,221,264,75,37,744,385,359,105,96,57,31,0
47528,111,29,82,10,54,0,1,166,88,78,23,18,13,7,0
47529,631,316,315,64,57,49,15,1065,581,484,134,97,76,46,0
47530,431,245,186,50,23,46,17,551,226,325,96,103,43,11,0
47531,431,199,232,59,54,40,17,947,482,465,143,107,89,37,0
47532,692,305,387,100,97,78,30,457,253,204,67,51,48,13,0
47533,102,22,80,48,8,18,6,374,191,183,40,52,40,16,0
47534,822,416,406,111,97,88,42,766,386,380,101,81,78,31,0
47535,412,208,204,54,47,42,17,963,525,438,119,102,102,34,0
47536,526,228,298,69,64,32,30,413,223,190,52,45,53,10,0
47537,1257,464,793,221,264,75,37,137,85,52,15,11,11,2,0
47538,127,48,79,27,20,6,5,583,280,303,95,66,76,25,0
47539,648,376,272,70,60,73,24,679,338,341,96,95,40,23,0
47540,567,266,301,139,46,76,37,189,105,84,25,26,21,9,0
47541,781,367,414,60,67,43,17,338,169,169,53,44,39,21,0
47542,252,121,131,42,34,12,16,509,267,242,79,81,38,20,0
47543,119,59,60,29,10,6,4,1922,923,999,267,275,215,90,0
47544,789,362,427,90,82,70,35,392,155,237,68,61,34,16,0
47545,873,366,507,127,125,75,21,492,278,214,65,58,32,11,0
47546,919,493,426,100,92,88,49,654,295,359,99,88,71,25,0
47547,240,166,74,32,12,8,15,467,240,227,65,65,51,23,0
47548,276,149,127,45,34,39,9,583,321,262,73,67,45,25,0
47549,131,69,62,29,9,9,1,207,86,121,34,39,11,13,0
47550,372,189,183,60,44,41,18,439,231,208,65,51,55,17,0
47551,438,185,253,71,64,52,28,485,244,241,80,55,59,20,0
47552,256,152,104,18,23,23,8,317,161,156,50,36,47,12,0
47553,1912,880,1032,331,334,180,84,262,129,133,40,41,31,10,0
47554,785,351,434,136,93,71,37,943,463,480,91,144,70,30,0
47555,128,69,59,29,9,8,1,292,143,149,38,42,36,16,0
47556,253,133,120,44,31,22,8,374,202,172,50,39,31,24,0
47557,256,152,104,18,23,23,8,441,189,252,73,50,47,23,0
47558,301,157,144,31,28,34,9,264,138,126,33,34,29,12,0
47559,213,104,109,56,14,9,2,350,196,154,52,37,21,14,0
47560,331,169,162,40,28,22,14,662,373,289,89,80,77,29,0
47561,313,158,155,43,35,43,16,346,196,150,43,26,27,14,0
47562,168,67,101,37,17,13,13,758,361,397,114,107,51,19,0
47563,473,217,256,59,44,34,21,137,63,74,20,22,14,6,0
47564,805,338,467,153,138,99,55,225,114,111,32,29,26,6,0
47565,135,64,71,31,11,8,4,196,105,91,40,13,19,10,0
47566,332,172,160,50,33,35,9,2547,1280,1267,331,335,293,118,0
47567,886,440,446,116,140,95,45,1182,591,591,155,139,83,46,0
47568,178,87,91,20,32,13,10,531,261,270,73,80,68,26,0
47569,533,297,236,74,57,39,28,230,125,105,29,40,20,6,0
47570,535,315,220,57,55,71,19,225,111,114,32,34,32,16,0
47571,348,198,150,57,25,37,18,348,194,154,57,31,43,12,0
47572,900,434,466,134,97,86,36,898,469,429,125,125,134,35,0
47573,420,202,218,67,43,51,15,900,441,459,125,127,110,32,0
47574,730,298,432,128,69,86,26,715,345,370,110,97,64,25,0
47575,411,202,209,60,67,57,24,1047,562,485,141,127,114,41,0
47576,86,50,36,9,14,8,7,332,180,152,44,36,27,13,0
47577,150,60,90,27,16,6,3,188,93,95,33,18,16,10,0
47578,326,180,146,62,26,41,13,373,183,190,49,37,33,18,0
47579,711,330,381,111,86,86,34,671,306,365,114,76,49,19,0
47580,320,163,157,44,44,26,15,222,127,95,23,28,22,7,0
47581,106,43,63,28,13,8,1,308,146,162,42,39,24,12,0
47582,385,203,182,47,43,51,21,862,426,436,113,115,84,37,0
47583,516,224,292,79,29,45,33,1606,753,853,215,227,182,48,0
47584,264,122,142,33,29,13,13,337,152,185,49,54,42,21,0
47585,879,457,422,93,98,143,32,483,287,196,71,50,54,17,0
47586,397,180,217,61,59,39,13,227,130,97,32,25,22,12,0
47587,344,109,235,100,39,26,5,385,212,173,57,40,39,21,0
47588,310,141,169,36,38,20,8,406,202,204,54,51,63,21,0
47589,527,254,273,67,66,70,31,557,281,276,80,59,43,21,0
47590,443,250,193,52,23,49,13,98,49,49,14,15,9,2,0
47591,146,73,73,18,24,17,9,222,124,98,37,29,22,9,0
47592,895,388,507,130,84,90,31,492,278,214,65,58,32,11,0
47593,395,189,206,63,50,49,28,403,184,219,75,51,47,20,0
47594,126,57,69,31,10,10,3,548,273,275,84,81,64,30,0
47595,431,216,215,46,40,33,9,169,85,84,21,14,9,9,0
47596,674,268,406,118,96,70,21,928,440,488,111,157,82,35,0
47597,1124,442,682,148,189,72,43,2038,1059,979,262,237,208,100,0
47598,361,171,190,44,40,18,13,363,180,183,60,34,10,6,0
47599,594,321,273,98,59,57,23,285,143,142,45,32,21,17,0
47600,271,136,135,37,30,18,10,1047,562,485,141,127,114,41,0
47601,219,116,103,66,7,2,1,497,227,270,70,63,66,30,0
47602,206,96,110,33,25,8,6,366,204,162,47,41,31,23,0
47603,595,208,387,157,60,91,48,171,94,77,24,28,30,11,0
47604,290,156,134,44,29,39,9,402,186,216,64,47,38,20,0
47605,447,225,222,76,35,75,21,414,203,211,58,56,48,14,0
47606,213,88,125,21,54,14,15,258,129,129,45,24,31,10,0
47607,303,161,142,38,31,42,17,541,279,262,79,82,31,32,0
47608,443,206,237,76,68,52,28,437,221,216,62,64,47,13,0
47609,425,220,205,60,55,45,18,1065,581,484,134,97,76,46,0
47610,119,59,60,29,10,6,4,105,51,54,13,17,12,8,0
47611,1711,865,846,204,176,105,60,335,186,149,40,28,29,13,0
47612,444,250,194,58,21,60,23,283,142,141,41,33,26,18,0
47613,588,300,288,100,57,65,27,325,172,153,44,34,27,14,0
47614,763,354,409,101,90,63,26,601,279,322,81,65,27,12,0
47615,362,181,181,67,46,43,8,392,214,178,48,40,53,22,0
47616,852,461,391,109,102,72,24,439,227,212,60,55,58,8,0
47617,401,236,165,53,38,34,9,267,141,126,53,27,23,7,0
47618,463,250,213,56,45,73,25,373,189,184,54,46,50,23,0
47619,176,74,102,20,29,7,7,377,184,193,50,43,33,17,0
47620,504,222,282,71,64,53,29,123,61,62,17,18,17,7,0
47621,496,210,286,112,55,72,13,212,127,85,28,21,26,6,0
47622,747,360,387,125,92,69,32,225,129,96,32,33,20,8,0
47623,959,496,463,144,132,75,35,415,203,212,77,44,49,18,0
47624,529,290,239,54,63,85,15,368,200,168,54,49,43,9,0
47625,193,105,88,33,16,9,4,207,114,93,33,20,31,13,0
47626,234,110,124,39,29,23,2,389,210,179,51,37,43,9,0
47627,193,110,83,18,20,15,12,314,177,137,34,40,29,9,0
47628,815,356,459,128,125,82,26,199,92,107,34,30,18,9,0
47629,331,169,162,40,28,22,14,201,93,108,34,39,21,6,0
47630,290,156,134,44,29,39,9,111,60,51,17,23,10,7,0
47631,410,200,210,60,54,46,19,257,139,118,64,17,24,7,0
47632,125,46,79,24,16,12,2,366,204,162,47,41,31,23,0
47633,164,81,83,37,8,14,10,572,305,267,74,72,58,21,0
47634,342,150,192,52,43,31,17,360,180,180,57,48,39,12,0
47635,860,348,512,121,136,75,35,1061,543,518,146,123,109,67,0
47636,546,278,268,94,60,32,22,230,113,117,31,40,28,10,0
47637,616,304,312,75,71,55,25,266,146,120,41,28,31,7,0
47638,1200,602,598,145,116,110,50,199,92,107,34,30,18,9,0
47639,524,361,163,41,8,28,16,188,90,98,44,7,21,7,0
47640,361,177,184,59,51,24,15,403,185,218,67,62,63,19,0
47641,963,477,486,134,143,123,38,1922,923,999,267,275,215,90,0
47642,852,461,391,109,102,72,24,479,215,264,67,80,46,28,0
47643,336,134,202,51,64,27,12,137,72,65,27,13,15,8,0
47644,517,196,321,103,98,33,12,404,190,214,55,55,35,27,0
47645,575,295,280,89,68,54,18,336,200,136,34,29,25,24,0
47646,281,154,127,45,31,24,9,462,229,233,63,49,42,18,0
47647,420,248,172,64,30,43,17,137,63,74,20,22,14,6,0
47648,3859,2011,1848,535,391,422,207,133,61,72,21,19,13,4,0
47649,306,172,134,35,31,37,18,270,162,108,26,26,16,11,0
47650,598,322,276,67,57,63,26,367,218,149,45,43,42,16,0
47651,330,182,148,47,27,40,11,415,189,226,68,54,50,21,0
47652,2136,1063,1073,317,308,223,90,972,501,471,125,156,106,39,0
47653,972,501,471,125,156,106,39,1698,875,823,222,219,173,64,0
47654,595,339,256,64,36,54,24,166,90,76,27,18,21,5,0
47655,502,229,273,63,66,40,31,402,186,216,64,47,38,20,0
47656,654,344,310,80,69,57,15,660,332,328,84,73,47,19,0
47657,414,206,208,56,68,35,19,218,118,100,33,30,25,11,0
47658,401,236,165,53,38,34,9,103,50,53,19,10,7,5,0
47659,420,248,172,64,30,43,17,926,425,501,159,147,77,35,0
47660,3859,2011,1848,535,391,422,207,1696,771,925,257,225,149,63,0
47661,282,105,177,77,28,39,6,87,38,49,23,10,10,9,0
47662,2062,706,1356,414,368,158,63,261,127,134,36,27,36,4,0
47663,106,43,63,28,13,8,1,597,300,297,96,89,68,29,0
47664,837,443,394,129,89,87,38,727,362,365,123,107,63,23,0
47665,356,199,157,36,43,28,12,264,138,126,33,34,29,12,0
47666,417,222,195,53,39,43,10,441,189,252,73,50,47,23,0
47667,202,103,99,28,20,12,8,189,95,94,25,33,16,8,0
47668,798,287,511,126,125,77,26,374,174,200,54,52,42,21,0
47669,546,278,268,94,60,32,22,492,278,214,65,58,32,11,0
47670,220,121,99,28,26,17,6,699,334,365,108,80,70,20,0
47671,516,210,306,113,53,81,33,647,350,297,95,79,77,29,0
47672,125,46,79,24,16,12,2,508,253,255,73,60,50,13,0
47673,255,136,119,39,20,32,10,158,71,87,23,21,17,12,0
47674,411,202,209,60,67,57,24,326,149,177,51,51,28,10,0
47675,364,172,192,55,57,32,15,293,142,151,49,40,42,17,0
47676,498,274,224,58,59,50,18,1755,905,850,214,196,183,79,0
47677,708,344,364,106,98,66,33,520,272,248,60,65,58,22,0
47678,2663,1073,1590,548,499,192,64,710,375,335,95,94,110,28,0
47679,746,312,434,129,115,77,47,300,148,152,45,43,40,8,0
47680,733,438,295,95,79,67,32,432,244,188,51,51,27,14,0
47681,531,259,272,75,81,39,13,152,71,81,41,16,14,2,0
47682,393,223,170,44,36,32,14,1020,538,482,145,115,111,58,0
47683,805,338,467,153,138,99,55,404,190,214,55,55,35,27,0
47684,1241,650,591,161,151,106,49,245,112,133,32,45,20,10,0
47685,179,78,101,29,22,10,8,403,184,219,75,51,47,20,0
47686,476,276,200,57,34,43,16,133,61,72,21,19,13,4,0
47687,629,374,255,74,53,87,27,137,72,65,27,13,15,8,0
47688,284,160,124,37,23,32,11,405,195,210,57,74,24,17,0
47689,135,64,71,31,11,8,4,663,360,303,87,82,80,35,0
47690,271,136,135,37,30,18,10,270,162,108,26,26,16,11,0
47691,794,322,472,122,108,79,34,389,210,179,51,37,43,9,0
47692,139,64,75,18,17,18,4,953,489,464,126,104,111,44,0
47693,368,201,167,61,38,38,12,98,49,49,14,15,9,2,0
47694,1189,653,536,152,118,109,56,445,202,243,70,73,51,15,0
47695,2136,1063,1073,317,308,223,90,732,402,330,81,86,87,33,0
47696,736,353,383,117,83,71,18,925,439,486,141,134,105,46,0
47697,447,236,211,56,52,49,14,180,108,72,22,22,15,5,0
47698,392,221,171,53,30,25,8,414,203,211,58,56,48,14,0
47699,336,199,137,46,22,51,13,246,125,121,38,36,30,11,0
47700,436,209,227,66,47,52,22,818,357,461,122,136,54,25,0
47701,128,67,61,29,9,9,1,975,475,500,139,140,119,28,0
47702,312,173,139,43,47,28,6,600,254,346,104,100,44,17,0
47703,427,191,236,67,60,41,34,483,258,225,70,53,54,20,0
47704,261,137,124,34,23,13,8,395,169,226,73,55,38,9,0
47705,545,221,324,101,72,55,30,399,190,209,61,41,39,18,0
47706,1341,481,860,275,264,57,21,720,361,359,98,98,70,37,0
47707,149,78,71,20,20,19,5,1755,905,850,214,196,183,79,0
47708,1867,973,894,256,222,194,65,387,193,194,60,53,57,15,0
47709,521,249,272,53,36,50,18,227,130,97,32,25,22,12,0
47710,276,149,127,45,34,39,9,148,69,79,26,18,16,3,0
47711,219,100,119,40,29,21,3,399,190,209,61,41,39,18,0
47712,159,105,54,22,9,14,25,149,52,97,36,36,7,4,0
47713,172,82,90,21,35,21,5,131,55,76,28,9,14,12,0
47714,680,308,372,82,72,71,40,843,391,452,139,104,91,35,0
47715,641,349,292,92,60,39,24,166,78,88,27,25,19,7,0
47716,496,210,286,111,55,74,13,452,231,221,74,53,56,20,0
47717,315,174,141,46,38,47,16,531,261,270,73,80,68,26,0
47718,598,300,298,68,77,59,21,663,354,309,91,84,79,31,0
47719,343,162,181,65,38,29,12,455,229,226,66,62,63,29,0
47720,356,199,157,36,43,28,12,346,196,150,43,26,27,14,0
47721,685,393,292,75,66,113,16,821,394,427,122,117,109,38,0
47722,531,260,271,97,68,47,11,671,306,365,114,76,49,19,0
47723,326,148,178,55,42,31,12,359,171,188,49,74,45,11,0
47724,302,178,124,34,29,50,13,368,200,168,54,49,43,9,0
47725,380,148,232,81,69,24,8,405,195,210,57,74,24,17,0
47726,222,110,112,43,30,14,6,462,251,211,74,53,41,18,0
47727,237,127,110,34,30,16,9,536,251,285,75,79,60,23,0
47728,255,136,119,39,20,32,10,335,170,165,52,36,47,11,0
47729,130,71,59,30,9,8,2,282,134,148,38,45,29,10,0
47730,139,64,75,18,17,18,4,1537,701,836,209,187,129,58,0
47731,420,248,172,64,30,43,17,96,46,50,16,12,7,5,0
47732,453,240,213,53,33,44,16,514,262,252,78,58,54,26,0
47733,264,122,142,46,24,35,10,620,324,296,81,68,66,31,0
47734,308,163,145,38,33,30,20,704,355,349,113,94,71,24,0
47735,429,238,191,47,49,56,29,926,340,586,133,119,60,40,0
47736,895,388,507,130,84,90,31,441,189,252,73,50,47,23,0
47737,908,324,584,181,162,81,29,2547,1280,1267,331,335,293,118,0
47738,107,56,51,18,16,12,5,422,202,220,80,52,57,18,0
47739,1041,497,544,180,167,98,34,229,120,109,31,30,22,9,0
47740,275,160,115,40,31,34,17,483,258,225,70,53,54,20,0
47741,246,111,135,64,47,27,3,203,98,105,34,29,19,10,0
47742,474,243,231,66,54,41,29,483,258,225,70,53,54,20,0
47743,1041,497,544,180,167,98,34,1696,771,925,257,225,149,63,0
47744,392,221,171,53,30,25,8,690,345,345,96,83,73,42,0
47745,316,157,159,45,38,22,19,199,105,94,27,27,28,9,0
47746,126,57,69,31,10,10,3,418,246,172,52,39,57,10,0
47747,345,208,137,44,27,33,8,386,181,205,55,51,57,31,0
47748,579,281,298,91,78,74,27,137,72,65,27,13,15,8,0
47749,161,99,62,15,22,9,7,241,127,114,34,33,29,12,0
47750,756,265,491,129,127,51,17,627,289,338,101,73,62,43,0
47751,275,125,150,37,48,27,7,749,384,365,108,105,86,31,0
47752,801,331,470,151,139,99,55,441,189,252,73,50,47,23,0
47753,447,236,211,56,52,49,14,673,313,360,102,101,46,17,0
47754,1336,724,612,209,141,133,60,541,279,262,79,82,31,32,0
47755,316,157,159,45,38,22,19,194,106,88,33,10,15,6,0
47756,1365,590,775,257,168,136,93,370,190,180,60,52,37,13,0
47757,125,46,79,24,16,12,2,171,94,77,24,28,30,11,0
47758,109,50,59,12,12,9,3,106,46,60,27,18,12,3,0
47759,1276,607,669,192,178,136,63,373,189,184,54,46,50,23,0
47760,1235,584,651,140,226,82,52,449,252,197,61,52,36,18,0
47761,580,281,299,95,60,74,29,346,196,150,43,26,27,14,0
47762,161,94,67,23,13,8,10,352,207,145,40,33,25,21,0
47763,466,259,207,59,50,83,12,332,155,177,55,51,44,13,0
47764,428,226,202,52,60,75,20,452,254,198,72,57,38,18,0
47765,272,94,178,76,33,19,4,250,119,131,58,26,29,7,0
47766,350,172,178,61,45,32,13,471,238,233,66,63,62,19,0
47767,410,211,199,55,42,34,27,386,207,179,43,48,44,19,0
47768,577,251,326,92,84,60,11,381,196,185,55,57,43,16,0
47769,317,140,177,43,26,31,16,664,350,314,86,90,82,36,0
47770,342,185,157,42,27,31,14,392,214,178,48,40,53,22,0
47771,411,202,209,60,67,57,24,292,155,137,50,34,29,13,0
47772,1098,519,579,182,159,79,42,531,277,254,82,75,33,22,0
47773,502,229,273,63,66,40,31,406,223,183,61,53,46,17,0
47774,474,250,224,58,47,37,12,376,183,193,50,50,43,21,0
47775,258,130,128,44,37,29,10,846,425,421,125,97,98,38,0
47776,798,364,434,133,88,74,35,267,141,126,53,27,23,7,0
47777,149,78,71,20,20,19,5,381,186,195,69,55,46,15,0
47778,496,272,224,70,58,42,18,222,122,100,39,32,24,9,0
47779,419,210,209,54,44,31,23,583,280,303,95,66,76,25,0
47780,170,82,88,32,23,22,8,406,223,183,61,53,46,17,0
47781,380,185,195,68,54,32,16,1378,692,686,194,174,105,56,0
47782,815,356,459,128,125,82,26,564,264,300,79,84,65,26,0
47783,128,69,59,29,9,8,1,225,129,96,32,33,20,8,0
47784,158,85,73,24,18,18,8,91,44,47,9,12,4,7,0
47785,102,22,80,48,8,18,6,172,88,84,24,31,20,12,0
47786,119,57,62,18,16,17,4,242,140,102,31,24,24,13,0
47787,350,190,160,48,25,27,18,163,79,84,22,24,13,5,0
47788,504,222,282,71,64,53,29,437,221,216,62,64,47,13,0
47789,418,163,255,57,54,38,24,406,223,183,61,53,46,17,0
47790,2663,1073,1590,548,499,192,64,104,46,58,15,17,9,5,0
47791,341,175,166,48,43,35,18,701,380,321,94,84,96,34,0
47792,235,100,135,36,25,30,8,274,142,132,33,34,18,14,0
47793,136,66,70,33,11,9,5,386,181,205,55,51,57,31,0
47794,450,231,219,77,50,76,16,362,156,206,74,42,36,22,0
47795,700,305,395,111,99,54,18,303,137,166,54,54,31,15,0
47796,469,221,248,49,60,55,21,247,128,119,34,14,16,14,0
47797,1542,682,860,290,158,120,47,1395,627,768,172,263,141,59,0
47798,403,176,227,71,56,51,11,187,89,98,36,24,20,6,0
47799,188,84,104,35,36,18,9,175,82,93,33,26,17,5,0
47800,501,230,271,63,90,50,18,172,79,93,34,27,23,10,0
47801,490,198,292,65,81,39,27,763,418,345,113,84,59,32,0
47802,374,187,187,51,52,40,27,439,231,208,65,51,55,17,0
47803,423,247,176,58,55,29,20,330,166,164,55,51,36,16,0
47804,507,314,193,49,45,59,25,504,272,232,75,57,53,19,0
47805,397,180,217,61,59,39,13,276,149,127,34,31,32,10,0
47806,589,282,307,68,67,70,23,244,143,101,31,29,26,8,0
47807,429,238,191,47,49,56,29,437,221,216,62,64,47,13,0
47808,600,324,276,89,73,45,39,352,207,145,40,33,25,21,0
47809,1001,422,579,185,180,51,32,234,116,118,34,35,23,9,0
47810,437,212,225,66,44,44,11,395,198,197,55,55,36,10,0
47811,582,328,254,78,48,35,9,1065,581,484,134,97,76,46,0
47812,365,210,155,46,30,24,12,660,303,357,97,89,85,33,0
47813,242,111,131,35,35,17,13,242,121,121,39,30,29,10,0
47814,1912,880,1032,331,334,180,84,410,197,213,67,43,56,18,0
47815,179,96,83,24,8,26,4,811,361,450,124,107,80,31,0
47816,1043,479,564,200,131,123,62,246,107,139,55,33,27,11,0
47817,118,56,62,24,12,6,9,72,33,39,8,2,3,12,0
47818,246,123,123,40,31,27,7,403,184,219,75,51,47,20,0
47819,752,313,439,121,106,68,27,471,238,233,66,63,62,19,0
47820,126,57,69,31,10,10,3,654,295,359,99,88,71,25,0
47821,334,155,179,47,34,38,11,127,64,63,26,8,12,8,0
47822,341,175,166,48,43,35,18,536,267,269,60,70,41,22,0
47823,90,54,36,20,4,14,5,647,350,297,95,79,77,29,0
47824,258,130,128,44,37,29,10,1249,638,611,166,153,141,45,0
47825,586,298,288,80,75,64,37,328,195,133,39,40,27,13,0
47826,240,167,73,32,12,8,21,457,253,204,67,51,48,13,0
47827,109,50,59,12,12,9,3,289,140,149,33,42,30,15,0
47828,139,81,58,17,14,24,9,445,264,181,35,35,34,14,0
47829,301,156,145,32,25,15,5,662,312,350,103,104,59,20,0
47830,798,287,511,126,125,77,26,336,200,136,34,29,25,24,0
47831,283,112,171,48,39,34,15,430,212,218,88,43,40,20,0
47832,222,108,114,37,20,25,12,328,199,129,39,29,27,14,0
47833,600,324,276,89,73,45,39,127,54,73,11,33,15,6,0
47834,392,205,187,83,49,38,10,483,258,225,70,53,54,20,0
47835,1284,511,773,227,166,169,107,943,463,480,91,144,70,30,0
47836,90,54,36,20,4,14,5,148,84,64,30,7,17,4,0
47837,128,67,61,29,9,9,1,727,362,365,123,107,63,23,0
47838,236,120,116,32,28,21,11,419,233,186,54,53,55,17,0
47839,261,126,135,41,36,24,11,556,290,266,75,74,29,24,0
47840,207,89,118,56,8,4,3,966,478,488,108,144,74,43,0
47841,1107,601,506,155,138,103,49,536,267,269,60,70,41,22,0
47842,237,127,110,34,30,16,9,1230,644,586,198,125,123,61,0
47843,861,393,468,150,101,69,35,647,350,297,95,79,77,29,0
47844,473,265,208,47,26,50,30,131,55,76,28,9,14,12,0
47845,303,147,156,49,49,20,8,929,459,470,140,120,94,45,0
47846,181,75,106,35,26,11,9,306,157,149,52,35,39,16,0
47847,711,330,381,111,86,86,34,374,212,162,48,40,32,23,0
47848,1107,601,506,155,138,103,49,1182,591,591,155,139,83,46,0
47849,272,94,178,76,33,19,4,91,42,49,21,9,8,3,0
47850,781,367,414,60,67,43,17,169,85,84,21,14,9,9,0
47851,1030,567,463,118,106,94,49,708,328,380,113,100,82,34,0
47852,446,174,272,84,61,57,23,181,75,106,35,26,11,9,0
47853,420,248,172,64,30,43,17,535,311,224,66,52,49,24,0
47854,117,57,60,17,14,11,10,172,79,93,34,27,23,10,0
47855,505,201,304,116,58,75,31,701,380,321,94,84,96,34,0
47856,505,226,279,68,51,30,15,144,67,77,28,14,9,8,0
47857,1912,880,1032,331,334,180,84,218,117,101,35,32,34,12,0
47858,238,158,80,28,15,31,7,180,95,85,22,21,17,8,0
47859,911,489,422,121,98,97,36,336,200,136,34,29,25,24,0
47860,258,130,128,44,37,29,10,274,157,117,40,29,40,8,0
47861,161,75,86,24,20,10,7,279,161,118,37,32,7,7,0
47862,369,207,162,67,35,16,14,463,259,204,62,55,34,22,0
47863,414,216,198,51,32,42,28,1922,923,999,267,275,215,90,0
47864,322,164,158,46,44,29,7,724,353,371,94,95,71,31,0
47865,301,156,145,32,25,15,5,518,292,226,60,60,52,21,0
47866,161,94,67,23,13,8,10,483,258,225,70,53,54,20,0
47867,135,64,71,31,11,8,4,373,213,160,44,33,26,17,0
47868,176,74,102,20,29,7,7,439,227,212,60,55,58,8,0
47869,215,117,98,28,19,15,8,609,335,274,79,57,45,22,0
47870,315,170,145,48,56,22,11,508,253,255,73,60,50,13,0
47871,758,378,380,89,64,37,31,1352,602,750,166,185,81,70,0
47872,1199,589,610,189,128,167,65,261,127,134,36,27,36,4,0
47873,496,209,287,112,55,71,14,810,310,500,164,162,42,26,0
47874,1139,537,602,162,139,109,50,422,237,185,53,47,62,20,0
47875,130,71,59,30,9,8,1,160,60,100,23,40,19,11,0
47876,238,91,147,68,19,22,7,277,138,139,40,39,20,14,0
47877,949,467,482,126,127,102,51,354,188,166,46,40,34,10,0
47878,461,207,254,82,66,55,33,622,344,278,80,77,68,36,0
47879,375,201,174,52,56,39,15,974,457,517,133,117,69,26,0
47880,444,250,194,58,21,60,23,108,59,49,17,13,12,5,0
47881,609,292,317,102,96,64,21,926,425,501,159,147,77,35,0
47882,553,319,234,56,37,54,18,303,138,165,47,46,35,18,0
47883,283,112,171,48,39,34,15,154,78,76,23,21,13,5,0
47884,772,332,440,136,104,72,28,175,91,84,19,21,21,10,0
47885,462,258,204,59,41,56,15,447,212,235,86,55,58,21,0
47886,428,226,202,52,60,75,20,1696,771,925,257,225,149,63,0
47887,312,173,139,43,47,28,6,222,125,97,34,27,27,7,0
47888,331,177,154,54,38,27,11,135,65,70,21,25,15,9,0
47889,801,331,470,151,139,99,55,2346,1231,1115,316,292,266,105,0
47890,186,56,130,46,50,16,7,403,184,219,75,51,47,20,0
47891,629,338,291,92,57,64,22,375,210,165,49,37,29,27,0
47892,867,415,452,123,87,62,27,346,178,168,58,41,33,12,0
47893,552,295,257,67,49,70,30,180,95,85,22,21,17,8,0
47894,1276,607,669,192,178,136,63,422,202,220,80,52,57,18,0
47895,1867,973,894,256,222,194,65,386,207,179,43,48,44,19,0
47896,260,133,127,43,29,34,11,390,223,167,58,36,45,18,0
47897,510,288,222,44,36,24,7,395,169,226,73,55,38,9,0
47898,288,140,148,59,33,27,12,929,459,470,140,120,94,45,0
47899,450,227,223,53,36,48,12,207,113,94,33,18,30,9,0
47900,130,71,59,30,9,8,1,415,226,189,51,40,40,29,0
47901,466,199,267,86,59,32,17,963,455,508,127,130,115,48,0
47902,144,57,87,38,26,10,4,551,226,325,96,103,43,11,0
47903,853,400,453,137,109,88,42,557,281,276,80,59,43,21,0
47904,588,300,288,100,57,65,27,535,288,247,79,72,35,21,0
47905,115,62,53,13,10,9,7,203,98,105,34,29,19,10,0
47906,161,94,67,23,13,8,10,432,244,188,51,51,27,14,0
47907,423,247,176,58,55,29,20,497,227,270,70,63,66,30,0
47908,193,107,86,13,20,13,6,496,251,245,78,62,61,23,0
47909,496,272,224,70,58,42,18,375,176,199,48,61,40,12,0
47910,144,67,77,28,14,9,8,86,40,46,16,13,9,7,0
47911,330,151,179,68,36,56,9,2038,1059,979,262,237,208,100,0
47912,92,46,46,14,9,8,6,1537,701,836,209,187,129,58,0
47913,429,238,191,47,49,56,29,447,212,235,86,55,58,21,0
47914,2236,1195,1041,227,187,186,118,189,105,84,25,26,21,9,0
47915,257,148,109,28,20,21,14,403,221,182,62,50,42,12,0
47916,808,366,442,130,133,66,31,172,88,84,24,31,20,12,0
47917,115,62,53,13,10,9,7,137,72,65,27,13,15,8,0
47918,2649,1431,1218,377,299,266,102,258,129,129,45,24,31,10,0
47919,127,62,65,13,33,7,6,524,300,223,70,54,51,25,0
47920,700,305,395,111,99,54,18,239,113,126,36,49,20,8,0
47921,340,181,159,44,39,35,21,902,499,403,118,117,92,35,0
47922,911,445,466,154,121,108,48,393,210,183,58,37,34,20,0
47923,1051,429,622,179,148,125,54,547,295,252,81,65,57,23,0
47924,479,228,251,71,57,60,14,536,251,285,75,79,60,23,0
47925,357,182,175,49,36,39,15,597,300,297,96,89,68,29,0
47926,374,187,187,51,52,40,27,866,478,388,121,101,101,26,0
47927,172,98,74,20,21,22,8,1873,935,938,233,225,203,79,0
47928,1718,735,983,266,225,130,68,375,210,165,49,37,29,27,0
47929,281,154,127,45,31,24,9,775,407,368,122,100,97,32,0
47930,727,426,301,79,71,64,32,73,35,38,14,10,9,4,0
47931,692,305,387,100,97,78,30,410,197,213,67,43,56,18,0
47932,427,191,236,67,60,41,34,821,394,427,122,117,109,38,0
47933,184,93,91,26,25,14,11,392,186,206,62,56,29,15,0
47934,415,133,282,114,65,27,7,103,50,53,19,10,7,5,0
47935,249,104,145,47,41,24,17,346,178,168,58,41,33,12,0
47936,733,382,351,126,92,93,27,508,253,255,73,60,50,13,0
47937,257,132,125,39,27,26,10,701,380,321,94,84,96,34,0
47938,313,148,165,45,33,36,11,398,200,198,68,43,51,14,0
47939,372,189,183,60,44,41,18,290,142,148,41,37,43,11,0
47940,320,163,157,44,44,26,15,452,252,200,55,49,61,16,0
47941,259,119,140,48,28,29,19,592,249,343,91,90,50,42,0
47942,414,195,219,51,60,40,17,531,261,270,73,80,68,26,0
47943,297,161,136,36,35,24,9,307,132,175,48,53,26,10,0
47944,557,250,307,70,47,51,22,620,324,296,81,68,66,31,0
47945,314,158,156,39,28,30,17,218,118,100,33,30,25,11,0
47946,159,105,54,22,9,14,25,251,143,108,47,25,29,11,0
47947,1064,495,569,157,159,124,58,106,46,60,27,18,12,3,0
47948,407,164,243,88,42,40,22,427,251,176,51,39,25,22,0
47949,431,216,215,46,40,33,9,107,77,30,7,2,9,5,0
47950,729,351,378,111,98,58,18,261,148,113,31,28,14,10,0
47951,258,144,114,33,22,19,9,245,121,124,37,35,36,12,0
47952,1030,438,592,184,104,108,30,483,258,225,70,53,54,20,0
47953,616,323,293,98,71,31,15,344,190,154,34,31,36,10,0
47954,756,362,394,102,104,73,25,266,146,120,41,28,31,7,0
47955,162,73,89,32,19,4,4,301,168,133,49,37,34,11,0
47956,507,314,193,49,45,59,25,385,188,197,57,42,36,16,0
47957,600,324,276,89,73,45,39,953,489,464,126,104,111,44,0
47958,106,43,63,28,13,8,1,87,51,35,15,9,9,4,0
47959,813,412,401,114,93,112,26,432,244,188,51,51,27,14,0
47960,473,217,256,59,44,34,21,1922,923,999,267,275,215,90,0
47961,373,194,179,42,54,26,13,101,59,42,11,17,10,1,0
47962,192,91,101,28,21,18,8,498,244,254,81,67,58,19,0
47963,1121,458,663,158,210,76,47,332,180,152,44,36,27,13,0
47964,636,288,348,94,77,65,30,455,229,226,66,62,63,29,0
47965,288,104,184,80,30,39,6,474,268,206,66,42,45,24,0
47966,1009,478,531,166,126,96,42,190,93,97,35,27,23,2,0
47967,431,216,215,46,40,33,9,240,141,99,34,28,29,8,0
47968,227,120,107,31,28,28,13,557,281,276,80,59,43,21,0
47969,1464,693,771,153,136,91,86,130,67,63,24,10,12,4,0
47970,553,276,277,88,61,45,27,270,162,108,26,26,16,11,0
47971,362,174,188,46,55,35,23,149,52,97,36,36,7,4,0
47972,486,243,243,65,48,63,22,395,169,226,73,55,38,9,0
47973,290,156,134,44,29,39,9,729,358,371,116,99,89,33,0
47974,800,416,384,102,105,83,22,149,52,97,36,36,7,4,0
47975,158,85,73,24,18,18,8,1698,875,823,222,219,173,64,0
47976,331,144,187,57,46,33,19,1352,602,750,166,185,81,70,0
47977,820,333,487,202,152,59,23,821,394,427,122,117,109,38,0
47978,128,69,59,29,9,8,1,481,223,258,71,70,49,26,0
47979,260,120,140,34,39,36,12,386,207,179,43,48,44,19,0
47980,813,412,401,114,93,112,26,180,89,91,28,27,18,7,0
47981,345,203,142,47,35,31,11,974,457,517,133,117,69,26,0
47982,485,237,248,83,35,52,24,526,266,260,76,75,53,22,0
47983,420,248,172,64,30,43,17,190,93,97,35,27,23,2,0
47984,282,135,147,27,37,30,19,929,459,470,140,120,94,45,0
47985,580,240,340,108,81,59,22,277,163,114,33,24,21,16,0
47986,429,227,202,49,51,46,26,111,60,51,17,23,10,7,0
47987,292,102,190,71,27,51,21,792,398,394,109,96,90,39,0
47988,373,194,179,42,54,26,13,108,59,49,17,13,12,5,0
47989,505,226,279,68,51,30,15,1700,731,969,198,233,110,87,0
47990,574,284,290,64,50,65,20,531,277,254,82,75,33,22,0
47991,666,204,462,110,194,42,14,943,463,480,91,144,70,30,0
47992,739,389,350,129,61,69,25,292,143,149,38,42,36,16,0
47993,439,183,256,60,64,36,14,218,114,104,32,31,33,11,0
47994,450,231,219,77,50,76,16,334,181,153,56,31,28,18,0
47995,193,110,83,18,20,15,12,1001,417,584,186,147,96,47,0
47996,150,60,90,27,16,6,3,415,203,212,77,44,49,18,0
47997,961,465,496,139,156,62,34,572,305,267,74,72,58,21,0
47998,439,205,234,64,88,41,21,194,109,85,23,24,21,9,0
47999,251,131,120,49,35,25,5,1241,619,622,183,169,155,59,0
48000,1004,498,506,94,59,46,33,1061,543,518,146,123,109,67,0
48001,527,254,273,67,66,70,31,127,64,63,26,8,12,8,0
48002,627,237,390,137,57,108,44,1543,794,749,182,152,132,55,0
48003,213,114,99,62,7,2,1,715,348,367,109,84,68,30,0
48004,347,154,193,48,51,25,11,1047,562,485,141,127,114,41,0
48005,126,57,69,31,10,10,3,376,189,187,47,53,44,26,0
48006,509,251,258,69,49,55,17,192,110,82,33,21,10,3,0
48007,631,304,327,98,75,52,23,485,244,241,80,55,59,20,0
48008,1041,497,544,180,167,98,34,72,32,40,8,2,1,14,0
48009,416,207,209,63,47,56,15,422,202,220,80,52,57,18,0
48010,734,339,395,135,89,78,36,555,292,263,75,63,67,27,0
48011,299,128,171,57,40,13,25,445,202,243,70,73,51,15,0
48012,1054,453,601,183,183,107,35,417,232,185,58,50,29,21,0
48013,502,236,266,66,66,58,17,607,293,314,98,71,62,32,0
48014,333,171,162,41,44,48,23,704,355,349,113,94,71,24,0
48015,781,316,465,130,129,65,23,582,264,318,84,60,58,23,0
48016,336,134,202,51,64,27,12,710,375,335,95,94,110,28,0
48017,514,226,288,71,66,63,32,212,127,85,28,21,26,6,0
48018,567,266,301,139,46,76,37,775,407,368,122,100,97,32,0
48019,613,303,310,70,28,28,18,316,166,150,45,38,37,13,0
48020,249,114,135,47,33,25,4,149,52,97,36,36,7,4,0
48021,626,308,318,105,89,77,25,583,280,303,95,66,76,25,0
48022,562,214,348,120,86,69,42,54,26,28,11,4,3,3,0
48023,265,165,100,32,19,27,5,445,202,243,70,73,51,15,0
48024,306,172,134,35,31,37,18,274,142,132,33,34,18,14,0
48025,426,213,213,60,56,46,24,2542,1245,1297,285,287,170,84,0
48026,465,240,225,50,54,24,14,720,361,359,98,98,70,37,0
48027,361,183,178,50,54,51,22,846,425,421,125,97,98,38,0
48028,374,187,187,51,52,40,27,1698,875,823,222,219,173,64,0
48029,465,305,160,40,47,34,9,1113,480,633,170,173,81,34,0
48030,346,191,155,52,38,40,13,326,169,157,51,41,41,12,0
48031,928,442,486,139,118,91,43,514,248,266,86,82,52,22,0
48032,772,332,440,136,104,72,28,232,111,121,23,29,17,9,0
48033,484,194,290,70,93,47,16,1047,562,485,141,127,114,41,0
48034,867,415,452,123,87,62,27,584,249,335,80,96,22,13,0
48035,1447,698,749,214,180,116,46,72,32,40,8,2,1,14,0
48036,130,70,60,30,9,8,1,257,126,131,61,24,22,8,0
48037,261,148,113,23,29,26,21,471,238,233,66,63,62,19,0
48038,2525,1232,1293,398,317,186,61,469,225,244,64,68,25,11,0
48039,1214,612,602,169,173,98,35,1062,522,540,151,147,105,66,0
48040,580,240,340,108,81,59,22,926,425,501,159,147,77,35,0
48041,364,204,160,65,35,15,13,479,215,264,67,80,46,28,0
48042,524,361,163,41,8,28,16,135,65,70,21,25,15,9,0
48043,1709,650,1059,338,286,185,46,1230,644,586,198,125,123,61,0
48044,107,56,51,18,16,12,5,106,46,60,29,13,14,5,0
48045,299,151,148,35,34,26,16,536,222,314,101,100,34,22,0
48046,1004,464,540,143,104,78,55,483,287,196,71,50,54,17,0
48047,584,297,287,89,80,65,17,292,155,137,50,34,29,13,0
48048,1447,698,749,214,180,116,46,4646,2328,2318,674,639,475,170,0
48049,325,152,173,43,47,28,17,290,142,148,41,37,43,11,0
48050,665,341,324,109,79,38,22,452,252,200,55,49,61,16,0
48051,500,245,255,66,57,52,27,427,251,176,51,39,25,22,0
48052,439,211,228,65,73,26,21,276,143,133,34,38,20,15,0
48053,911,441,470,123,108,60,21,105,51,54,13,17,12,8,0
48054,126,56,70,31,10,10,3,1241,619,622,183,169,155,59,0
48055,456,223,233,77,54,47,20,153,65,88,28,21,20,8,0
48056,134,60,74,19,13,10,7,507,270,237,89,59,57,22,0
48057,260,120,140,34,39,36,12,403,225,178,56,38,33,25,0
48058,119,59,60,29,10,6,4,761,351,410,117,73,103,45,0
48059,2062,706,1356,414,368,158,63,1001,417,584,186,147,96,47,0
48060,708,344,364,106,98,66,33,866,478,388,121,101,101,26,0
48061,413,206,207,38,55,19,10,265,134,131,48,34,33,15,0
48062,450,231,219,77,50,76,16,257,139,118,64,17,24,7,0
48063,600,324,276,89,73,45,39,429,187,242,79,72,28,19,0
48064,347,154,193,48,51,25,11,732,402,330,81,86,87,33,0
48065,584,340,244,77,60,47,25,385,188,197,57,42,36,16,0
48066,2446,1099,1347,363,294,233,100,475,251,224,67,49,48,23,0
48067,220,113,107,37,24,16,7,149,77,72,37,10,20,5,0
48068,457,228,229,64,36,52,21,501,240,261,80,62,49,42,0
48069,583,279,304,99,71,59,31,501,274,227,63,58,53,20,0
48070,476,276,200,57,34,43,16,403,184,219,75,51,47,20,0
48071,710,352,358,104,86,84,41,732,402,330,81,86,87,33,0
48072,422,207,215,79,38,53,23,422,202,220,80,52,57,18,0
48073,677,361,316,81,61,42,22,564,264,300,79,84,65,26,0
48074,673,317,356,101,85,76,49,508,253,255,73,60,50,13,0
48075,600,324,276,89,73,45,39,584,249,335,80,96,22,13,0
48076,584,340,244,77,60,47,25,943,463,480,91,144,70,30,0
48077,155,85,70,17,16,4,8,467,231,236,71,65,58,18,0
48078,785,325,460,114,123,61,28,178,99,79,31,19,26,8,0
48079,1342,640,702,187,163,123,57,467,231,236,71,65,58,18,0
48080,1711,865,846,204,176,105,60,723,353,370,120,109,96,33,0
48081,1163,417,746,209,145,87,28,978,536,442,132,107,67,32,0
48082,524,270,254,84,72,70,23,780,337,443,112,116,77,28,0
48083,369,207,162,67,35,16,14,660,303,357,97,89,85,33,0
48084,588,300,288,100,57,65,27,2202,1121,1081,338,274,269,81,0
48085,469,253,216,49,51,48,18,665,361,304,87,91,84,31,0
48086,333,171,162,50,34,19,8,900,441,459,125,127,110,32,0
48087,290,156,134,44,29,39,9,199,92,107,34,30,18,9,0
48088,498,274,224,58,59,50,18,222,127,95,23,28,22,7,0
48089,1555,702,853,250,199,139,31,611,314,297,79,75,78,22,0
48090,520,261,259,74,52,49,22,142,65,77,30,17,22,9,0
48091,760,405,355,112,95,92,29,873,411,462,132,107,84,40,0
48092,1214,498,716,197,180,121,65,621,273,348,104,102,48,19,0
48093,527,276,251,64,60,70,20,1065,581,484,134,97,76,46,0
48094,2136,1063,1073,317,308,223,90,421,222,199,69,50,60,18,0
48095,1208,575,633,187,204,117,41,137,78,59,22,16,17,4,0
48096,181,92,89,34,22,17,9,194,94,100,33,28,14,7,0
48097,414,216,198,51,32,42,28,418,223,195,53,43,49,15,0
48098,341,175,166,48,43,35,18,417,232,185,58,50,29,21,0
48099,350,190,160,48,25,27,18,975,475,500,139,140,119,28,0
48100,704,342,362,113,91,85,33,199,105,94,27,27,28,9,0
48101,519,259,260,86,78,59,22,368,200,168,54,49,43,9,0
48102,130,70,60,30,9,8,1,320,168,152,38,42,24,18,0
48103,358,212,146,51,36,33,9,367,218,149,45,43,42,16,0
48104,392,205,187,83,49,38,10,274,157,117,40,29,40,8,0
48105,682,260,422,153,78,109,46,434,213,221,77,62,53,12,0
48106,1058,497,561,194,142,87,63,194,109,85,23,24,21,9,0
48107,489,253,236,73,36,62,17,256,141,115,32,22,32,8,0
48108,314,158,156,39,28,30,17,633,311,322,94,82,45,20,0
48109,507,242,265,53,44,31,22,429,187,242,79,72,28,19,0
48110,440,267,173,52,29,42,12,588,286,302,78,99,53,25,0
48111,388,244,144,46,25,42,16,277,152,125,31,35,22,19,0
48112,279,106,173,48,35,41,39,715,345,370,110,97,64,25,0
48113,303,147,156,49,49,20,8,430,212,218,88,43,40,20,0
48114,595,339,256,64,36,54,24,153,80,73,26,18,19,4,0
48115,234,108,126,42,40,15,9,413,223,190,52,45,53,10,0
48116,2220,1085,1135,312,304,202,91,366,204,162,47,41,31,23,0
48117,798,364,434,133,88,74,35,173,86,87,30,22,19,12,0
48118,288,142,146,52,32,26,8,108,59,49,17,13,12,5,0
48119,548,250,298,85,64,56,21,389,210,179,51,37,43,9,0
48120,1087,523,564,146,177,103,33,194,94,100,33,28,14,7,0
48121,119,67,52,15,15,7,7,362,156,206,74,42,36,22,0
48122,681,367,314,83,74,78,31,535,301,234,63,48,47,27,0
48123,1235,584,651,140,226,82,52,520,244,276,91,60,68,20,0
48124,312,173,139,43,47,28,6,192,110,82,33,21,10,3,0
48125,956,450,506,122,117,82,36,283,142,141,41,33,26,18,0
48126,1580,742,838,208,146,144,71,501,249,252,77,70,55,22,0
48127,743,377,366,87,74,68,30,751,394,357,107,96,73,35,0
48128,1047,443,604,162,156,78,52,437,224,213,40,29,42,25,0
48129,627,237,390,137,57,108,44,317,161,156,50,36,47,12,0
48130,439,183,256,60,64,36,14,72,34,38,8,2,3,12,0
48131,117,57,60,17,14,11,10,496,251,245,78,62,61,23,0
48132,919,444,475,141,148,62,20,773,389,384,119,91,79,26,0
48133,339,118,221,77,68,33,13,732,366,366,108,86,74,41,0
48134,2220,1085,1135,312,304,202,91,421,222,199,69,50,60,18,0
48135,291,142,149,50,29,35,7,378,154,224,74,84,35,22,0
48136,3859,2011,1848,535,391,422,207,2202,1121,1081,338,274,269,81,0
48137,483,236,247,82,60,43,18,250,119,131,58,26,29,7,0
48138,130,70,60,30,9,8,1,429,187,242,79,72,28,19,0
48139,1755,849,906,245,226,148,56,149,52,97,36,36,7,4,0
48140,1508,733,775,216,186,172,60,131,74,57,17,14,12,4,0
48141,513,276,237,73,43,57,24,520,272,248,60,65,58,22,0
48142,1439,713,726,195,180,110,34,415,203,212,77,44,49,18,0
48143,320,163,157,44,44,26,15,536,222,314,101,100,34,22,0
48144,1464,693,771,153,136,91,86,555,282,273,82,69,65,21,0
48145,616,304,312,75,71,55,25,261,127,134,36,27,36,4,0
48146,441,218,223,69,55,50,27,127,66,61,13,14,19,8,0
48147,261,137,124,34,23,13,8,106,46,60,27,18,12,3,0
48148,325,181,144,46,31,48,9,180,95,85,22,21,17,8,0
48149,516,224,292,79,29,45,33,481,223,258,71,70,49,26,0
48150,347,198,149,45,29,29,8,649,307,342,71,134,45,17,0
48151,358,212,146,51,36,33,9,139,68,71,14,26,14,9,0
48152,717,381,336,118,103,85,29,425,177,248,60,62,33,16,0
48153,204,103,101,16,32,22,8,344,190,154,34,31,36,10,0
48154,164,77,87,33,19,6,7,492,278,214,65,58,32,11,0
48155,464,237,227,64,66,33,12,153,65,88,28,21,20,8,0
48156,557,250,307,70,47,51,22,452,254,198,72,57,38,18,0
48157,536,237,299,116,87,42,17,660,333,327,102,95,69,31,0
48158,733,438,295,95,79,67,32,607,293,314,98,71,62,32,0
48159,714,260,454,140,97,120,54,1241,619,622,183,169,155,59,0
48160,300,136,164,45,35,45,14,402,186,216,64,47,38,20,0
48161,368,201,167,61,38,38,12,334,182,152,45,41,27,13,0
48162,1107,601,506,155,138,103,49,758,319,439,101,123,78,25,0
48163,203,80,123,40,37,20,3,335,186,149,40,28,29,13,0
48164,502,274,228,64,49,75,17,323,162,161,52,41,39,13,0
48165,163,70,93,28,21,17,6,278,154,124,42,32,38,7,0
48166,236,120,116,32,28,21,11,584,249,335,80,96,22,13,0
48167,138,35,103,38,2,15,9,169,85,84,21,14,9,9,0
48168,983,449,534,95,77,55,36,715,348,367,109,84,68,30,0
48169,146,73,73,18,24,17,9,1696,771,925,257,225,149,63,0
48170,861,393,468,150,101,69,35,289,140,149,33,42,30,15,0
48171,422,207,215,79,38,53,23,96,45,51,13,12,6,4,0
48172,446,174,272,84,61,57,23,585,277,308,92,73,61,32,0
48173,417,176,241,75,61,51,20,240,141,99,34,28,29,8,0
48174,109,50,59,12,12,9,3,285,143,142,45,32,21,17,0
48175,952,547,405,95,90,127,35,536,222,314,101,100,34,22,0
48176,284,160,124,37,23,32,11,296,159,137,49,28,38,13,0
48177,707,250,457,171,84,117,61,229,120,109,31,30,22,9,0
48178,304,149,155,46,32,39,14,461,223,238,45,62,18,35,0
48179,109,50,59,12,12,9,3,975,400,575,160,162,62,31,0
48180,1130,614,516,129,138,98,42,953,489,464,126,104,111,44,0
48181,126,58,68,31,10,10,3,381,186,195,69,55,46,15,0
48182,674,268,406,118,96,70,21,727,362,365,123,107,63,23,0
48183,211,92,119,33,44,11,7,135,65,70,21,25,15,9,0
48184,626,300,326,91,82,68,26,1214,475,739,177,250,89,49,0
48185,346,174,172,36,43,21,9,662,373,289,89,80,77,29,0
48186,766,336,430,133,97,79,21,437,224,213,40,29,42,25,0
48187,1011,559,452,121,97,132,33,501,257,244,75,57,48,29,0
48188,430,218,212,58,47,34,20,1328,648,680,220,151,109,40,0
48189,488,237,251,79,78,65,27,188,90,98,44,7,21,7,0
48190,508,136,372,157,91,22,9,756,348,408,101,103,60,40,0
48191,502,229,273,63,66,40,31,467,231,236,71,65,58,18,0
48192,419,210,209,54,44,31,23,127,58,69,18,17,10,5,0
48193,2048,855,1193,297,287,191,93,252,130,122,45,23,32,11,0
48194,1007,353,654,277,147,70,26,475,251,224,67,49,48,23,0
48195,180,92,88,29,20,26,8,137,78,59,22,16,17,4,0
48196,1043,479,564,200,131,123,62,902,499,403,118,117,92,35,0
48197,236,120,116,32,28,21,11,582,264,318,84,60,58,23,0
48198,280,156,124,36,19,20,13,106,54,52,12,9,7,6,0
48199,320,163,157,44,44,26,15,360,180,180,57,48,39,12,0
48200,503,260,243,46,56,33,16,152,71,81,41,16,14,2,0
48201,1087,523,564,146,177,103,33,482,232,250,77,81,44,13,0
48202,251,131,120,49,35,25,5,204,80,124,29,51,10,5,0
48203,346,174,172,36,43,21,9,399,190,209,61,41,39,18,0
48204,756,265,491,129,127,51,17,592,249,343,91,90,50,42,0
48205,1872,837,1035,280,338,169,80,106,46,60,27,18,12,3,0
48206,325,152,173,43,47,28,17,316,166,150,45,38,37,13,0
48207,1068,434,634,173,160,61,29,296,151,145,45,42,32,11,0
48208,428,248,180,44,39,28,9,647,350,297,95,79,77,29,0
48209,1085,646,439,108,65,36,19,288,156,132,36,36,24,15,0
48210,203,97,106,30,22,18,10,169,84,85,29,19,21,7,0
48211,305,124,181,27,25,32,21,403,192,211,102,39,49,15,0
48212,462,233,229,66,49,43,30,459,260,199,56,42,47,21,0
48213,862,384,478,127,110,75,42,283,142,141,41,33,26,18,0
48214,425,220,205,60,55,45,18,926,340,586,133,119,60,40,0
48215,949,467,482,126,127,102,51,346,178,168,58,41,33,12,0
48216,364,168,196,64,61,27,6,404,190,214,55,55,35,27,0
48217,115,62,53,13,10,9,7,545,269,276,80,76,27,32,0
48218,417,222,195,53,39,43,10,132,77,55,20,9,13,10,0
48219,734,339,395,135,89,78,36,124,69,55,14,7,9,4,0
48220,150,60,90,27,16,6,3,963,525,438,119,102,102,34,0
48221,476,199,277,82,80,49,24,516,245,271,82,84,70,26,0
48222,282,105,177,77,28,39,6,445,202,243,70,73,51,15,0
48223,684,353,331,95,98,77,38,325,159,166,59,46,30,12,0
48224,350,212,138,32,26,40,13,478,254,224,67,74,56,28,0
48225,1107,601,506,155,138,103,49,741,383,358,92,63,79,36,0
48226,281,125,156,44,47,17,7,415,226,189,51,40,40,29,0
48227,181,75,106,35,26,11,9,329,196,133,41,36,31,15,0
48228,887,439,448,137,99,91,38,392,186,206,62,56,29,15,0
48229,803,358,445,135,117,80,43,1700,731,969,198,233,110,87,0
48230,624,222,402,92,81,39,15,483,258,225,70,53,54,20,0
48231,2442,1193,1249,278,183,170,145,367,218,149,45,43,42,16,0
48232,504,222,282,71,64,53,29,464,236,228,64,56,53,28,0
48233,278,104,174,46,34,23,14,88,50,38,13,8,16,4,0
48234,505,201,304,116,58,75,31,297,164,133,45,39,40,9,0
48235,4128,2104,2024,581,505,453,205,332,173,159,48,40,31,11,0
48236,411,171,240,61,81,30,15,405,195,210,57,74,24,17,0
48237,401,183,218,72,73,28,10,384,212,172,44,43,34,14,0
48238,235,100,135,36,25,30,8,627,289,338,101,73,62,43,0
48239,288,142,146,52,32,26,8,1062,522,540,151,147,105,66,0
48240,375,201,174,52,56,39,15,633,311,322,94,82,45,20,0
48241,517,196,321,103,98,33,12,1425,670,755,153,189,122,85,0
48242,202,113,89,16,27,21,11,101,59,42,11,17,10,1,0
48243,335,155,180,64,48,36,10,294,146,148,50,45,51,15,0
48244,411,171,240,61,81,30,15,286,152,134,38,38,32,11,0
48245,285,148,137,31,42,42,16,515,276,239,62,59,43,31,0
48246,437,230,207,41,55,27,13,265,134,131,48,34,33,15,0
48247,371,143,228,77,48,29,26,128,63,65,30,11,13,8,0
48248,106,43,63,28,13,8,1,124,69,55,14,7,9,4,0
48249,425,198,227,57,69,59,13,392,214,178,48,40,53,22,0
48250,181,75,106,35,26,11,9,421,219,202,68,57,56,13,0
48251,649,304,345,99,80,67,40,127,64,63,26,8,12,8,0
48252,972,501,471,125,156,106,39,323,171,152,48,41,40,16,0
48253,1462,711,751,219,222,148,65,376,183,193,50,50,43,21,0
48254,202,113,89,16,27,21,11,548,296,252,71,74,43,28,0
48255,467,233,234,83,37,77,22,325,172,153,44,34,27,14,0
48256,419,210,209,54,44,31,23,588,286,302,78,99,53,25,0
48257,270,130,140,43,24,36,10,172,79,93,34,27,23,10,0
48258,1105,544,561,165,167,99,40,200,99,101,31,24,26,6,0
48259,536,287,249,64,73,21,27,103,44,59,16,17,9,5,0
48260,136,66,70,33,11,9,3,350,196,154,52,37,21,14,0
48261,956,450,506,122,117,82,36,4646,2328,2318,674,639,475,170,0
48262,431,216,215,46,40,33,9,530,287,243,79,70,33,26,0
48263,1284,511,773,227,166,169,107,220,107,113,36,35,28,9,0
48264,236,141,95,36,32,14,6,309,164,145,35,47,30,11,0
48265,736,353,383,117,83,71,18,295,158,137,42,34,38,14,0
48266,376,249,127,47,23,43,16,535,288,247,79,72,35,21,0
48267,420,248,172,64,30,43,17,535,288,247,79,72,35,21,0
48268,347,212,135,35,32,17,6,265,134,131,48,34,33,15,0
48269,366,190,176,39,62,55,14,368,183,185,40,42,40,15,0
48270,473,212,261,72,64,45,28,594,312,282,72,67,73,31,0
48271,452,217,235,59,47,60,20,188,105,83,25,17,24,7,0
48272,331,144,187,57,46,33,19,319,185,134,42,31,22,13,0
48273,380,187,193,38,51,30,18,422,202,220,80,52,57,18,0
48274,932,575,357,94,69,76,40,405,195,210,57,74,24,17,0
48275,433,188,245,63,45,26,14,953,489,464,126,104,111,44,0
48276,356,199,157,36,43,28,12,663,360,303,87,82,80,35,0
48277,438,185,253,71,64,52,28,535,288,247,79,72,35,21,0
48278,785,374,411,56,42,38,25,231,126,105,28,26,34,9,0
48279,338,172,166,59,30,39,18,630,321,309,86,90,57,26,0
48280,575,305,270,74,87,73,25,307,132,175,48,53,26,10,0
48281,524,270,254,84,72,70,23,483,287,196,71,50,54,17,0
48282,275,125,150,37,48,27,7,536,267,269,60,70,41,22,0
48283,180,92,88,29,20,26,8,251,143,108,47,25,29,11,0
48284,453,240,213,53,33,44,16,261,162,99,24,21,14,10,0
48285,241,122,119,27,34,17,16,381,196,185,55,57,43,16,0
48286,126,56,70,31,10,10,3,199,92,107,34,30,18,9,0
48287,543,265,278,52,37,54,19,163,79,84,22,24,13,5,0
48288,828,355,473,126,134,77,37,660,333,327,102,95,69,31,0
48289,760,322,438,81,130,57,19,598,333,265,79,66,54,33,0
48290,1214,612,602,169,173,98,35,396,213,183,68,44,47,18,0
48291,427,218,209,61,53,45,26,553,276,277,88,61,45,27,0
48292,594,321,273,98,59,57,23,482,232,250,77,81,44,13,0
48293,130,71,59,30,9,8,2,744,385,359,105,96,57,31,0
48294,71,28,43,15,9,5,2,600,254,346,104,100,44,17,0
48295,1189,653,536,152,118,109,56,723,363,360,107,106,52,14,0
48296,211,92,119,33,44,11,7,374,174,200,54,52,42,21,0
48297,862,409,453,149,125,86,29,552,285,267,74,51,69,24,0
48298,193,105,88,33,16,9,4,175,82,93,33,26,17,5,0
48299,530,259,271,83,50,54,41,763,418,345,113,84,59,32,0
48300,1249,543,706,187,164,125,52,72,34,38,8,2,3,12,0
48301,640,308,332,91,102,49,21,127,58,69,18,17,10,5,0
48302,211,92,119,33,44,11,7,640,364,276,84,68,69,33,0
48303,717,281,436,165,81,112,49,245,131,114,30,27,18,13,0
48304,1014,488,526,178,137,94,39,699,334,365,108,80,70,20,0
48305,374,187,187,51,52,40,27,200,89,111,26,25,17,7,0
48306,300,136,164,45,35,45,14,149,77,72,37,10,20,5,0
48307,264,122,142,33,29,13,13,173,90,83,21,36,12,15,0
48308,431,199,232,59,54,40,17,1500,804,696,190,172,144,60,0
48309,237,127,110,34,30,16,9,424,179,245,65,67,29,11,0
48310,345,203,142,47,35,31,11,1922,923,999,267,275,215,90,0
48311,126,57,69,31,10,10,3,220,107,113,36,35,28,9,0
48312,509,246,263,84,71,56,22,1698,875,823,222,219,173,64,0
48313,1390,585,805,241,230,118,46,556,290,266,75,74,29,24,0
48314,513,276,237,73,43,57,24,600,254,346,104,100,44,17,0
48315,326,176,150,35,22,29,11,188,88,100,53,12,15,6,0
48316,586,298,288,80,75,64,37,1323,690,633,132,178,112,61,0
48317,238,158,80,28,15,31,7,736,388,348,88,85,67,28,0
48318,736,353,383,117,83,71,18,403,184,219,75,51,47,20,0
48319,227,120,107,31,28,28,13,904,436,468,143,118,108,32,0
48320,318,161,157,53,51,32,13,644,343,301,96,69,59,28,0
48321,425,199,226,54,71,56,11,158,71,87,23,21,17,12,0
48322,319,222,97,36,23,28,8,453,247,206,58,53,45,20,0
48323,219,116,103,66,7,2,1,338,169,169,53,44,39,21,0
48324,456,223,233,77,54,47,20,395,169,226,73,55,38,9,0
48325,503,260,243,46,56,33,16,975,475,500,139,140,119,28,0
48326,2525,1232,1293,398,317,186,61,296,140,156,49,40,42,19,0
48327,1023,449,574,141,174,76,43,133,61,72,21,19,13,4,0
48328,1542,682,860,290,158,120,47,455,191,264,68,86,21,19,0
48329,873,366,507,127,125,75,21,427,251,176,51,39,25,22,0
48330,338,164,174,45,32,37,13,131,55,76,28,9,14,12,0
48331,490,224,266,80,70,39,32,370,173,197,65,57,42,10,0
48332,1143,574,569,176,151,123,59,723,363,360,107,106,52,14,0
48333,468,233,235,65,61,49,34,1241,619,622,183,169,155,59,0
48334,734,366,368,121,99,63,39,139,68,71,14,26,14,9,0
48335,595,316,279,86,60,65,40,403,192,211,102,39,49,15,0
48336,193,110,83,18,20,15,12,374,181,193,55,58,48,23,0
48337,261,148,113,23,29,26,21,592,249,343,91,90,50,42,0
48338,1555,702,853,250,199,139,31,737,397,340,87,104,90,14,0
48339,126,57,69,31,10,10,3,622,344,278,80,77,68,36,0
48340,894,420,474,136,146,93,39,358,166,192,50,57,27,26,0
48341,330,141,189,65,29,51,19,54,26,28,11,4,3,3,0
48342,288,140,148,59,33,27,12,679,338,341,96,95,40,23,0
48343,199,107,92,41,15,14,8,134,55,79,22,24,16,6,0
48344,436,201,235,54,37,35,18,137,72,65,27,13,15,8,0
48345,142,60,82,20,28,13,5,572,305,267,74,72,58,21,0
48346,1051,429,622,179,148,125,54,1543,794,749,182,152,132,55,0
48347,478,177,301,109,66,59,25,664,350,314,86,90,82,36,0
48348,374,187,187,51,52,40,27,749,384,365,108,105,86,31,0
48349,401,183,218,72,73,28,10,227,130,97,32,25,22,12,0
48350,605,277,328,99,54,63,43,530,287,243,79,70,33,26,0
48351,107,56,51,18,16,12,5,555,282,273,82,69,65,21,0
48352,764,277,487,158,162,64,31,89,37,52,13,6,2,9,0
48353,346,168,178,36,43,20,9,282,134,148,38,45,29,10,0
48354,1709,650,1059,338,286,185,46,132,67,65,24,21,8,10,0
48355,1085,646,439,108,65,36,19,160,76,84,19,24,8,5,0
48356,342,150,192,52,43,31,17,325,159,166,59,46,30,12,0
48357,335,148,187,52,26,51,12,234,116,118,34,35,23,9,0
48358,160,67,93,32,37,15,9,235,119,116,31,26,15,13,0
48359,550,304,246,60,64,77,16,1323,690,633,132,178,112,61,0
48360,521,249,272,53,36,50,18,283,142,141,41,33,26,18,0
48361,346,209,137,46,37,44,10,127,58,69,18,17,10,5,0
48362,193,90,103,44,9,19,13,288,156,132,36,36,24,15,0
48363,828,368,460,118,98,59,38,418,223,195,51,45,49,14,0
48364,136,66,70,33,11,9,5,593,289,304,85,69,48,19,0
48365,282,163,119,40,23,25,17,404,190,214,55,55,35,27,0
48366,770,394,376,90,96,78,34,828,394,434,105,110,81,33,0
48367,904,436,468,138,146,82,39,1248,584,664,184,164,155,67,0
48368,280,128,152,39,37,38,18,778,391,387,94,77,41,33,0
48369,232,108,124,33,27,19,16,308,129,179,44,60,19,8,0
48370,236,141,95,36,32,14,6,201,93,108,34,39,21,6,0
48371,704,342,362,113,91,85,33,250,116,134,41,30,33,19,0
48372,437,212,225,66,44,44,11,925,439,486,141,134,105,46,0
48373,462,258,204,59,41,56,15,172,79,93,34,27,23,10,0
48374,717,381,336,118,103,85,29,334,181,153,56,31,28,18,0
48375,410,208,202,59,58,43,26,101,59,42,11,17,10,1,0
48376,766,336,430,133,97,79,21,598,333,265,79,66,54,33,0
48377,240,98,142,49,42,23,17,498,244,254,81,67,58,19,0
48378,579,321,258,74,70,47,22,663,360,303,87,82,80,35,0
48379,258,126,132,38,22,29,8,296,151,145,45,42,32,11,0
48380,1542,682,860,290,158,120,47,723,363,360,107,106,52,14,0
48381,329,168,161,48,34,41,16,189,105,84,25,26,21,9,0
48382,381,146,235,74,48,47,34,207,86,121,34,39,11,13,0
48383,580,265,315,97,89,79,17,252,130,122,45,23,32,11,0
48384,833,295,538,146,139,65,34,225,129,96,32,33,20,8,0
48385,734,339,395,135,89,78,36,1248,584,664,184,164,155,67,0
48386,83,45,38,11,8,8,3,441,189,252,73,50,47,23,0
48387,258,144,114,33,22,19,9,328,199,129,39,29,27,14,0
48388,815,356,459,128,125,82,26,562,273,289,76,92,45,24,0
48389,583,279,304,99,71,59,31,201,98,103,28,25,19,13,0
48390,873,366,507,127,125,75,21,89,38,51,14,6,3,9,0
48391,1121,458,663,158,210,76,47,507,270,237,89,59,57,22,0
48392,342,185,157,42,27,31,14,258,129,129,45,24,31,10,0
48393,794,322,472,122,108,79,34,403,233,170,38,29,21,14,0
48394,595,208,387,157,60,91,48,322,180,142,45,38,28,7,0
48395,648,376,272,70,60,73,24,457,242,215,39,46,53,10,0
48396,510,288,222,44,36,24,7,1182,591,591,155,139,83,46,0
48397,502,236,266,66,66,58,17,242,121,121,39,30,29,10,0
48398,732,355,377,108,109,79,27,128,63,65,30,11,13,8,0
48399,310,141,169,36,38,20,8,266,146,120,41,28,31,7,0
48400,446,195,251,56,53,31,15,724,353,371,94,95,71,31,0
48401,603,311,292,102,71,66,23,179,101,78,25,15,13,13,0
48402,435,225,210,58,46,50,14,328,199,129,39,29,27,14,0
48403,484,264,220,59,62,68,15,381,186,195,69,55,46,15,0
48404,315,111,204,82,66,46,11,594,312,282,72,67,73,31,0
48405,439,205,234,64,88,41,21,1378,692,686,194,174,105,56,0
48406,565,264,301,101,73,72,15,1755,905,850,214,196,183,79,0
48407,282,96,186,80,21,28,7,508,261,247,65,53,58,23,0
48408,302,178,124,34,29,50,13,156,90,66,17,22,11,10,0
48409,443,250,193,52,23,49,13,519,287,232,68,58,45,21,0
48410,136,66,70,33,11,9,5,199,105,94,27,27,28,9,0
48411,520,261,259,74,52,49,22,541,279,262,79,82,31,32,0
48412,464,237,227,64,66,33,12,773,389,384,119,91,79,26,0
48413,436,201,235,54,37,35,18,975,475,500,139,140,119,28,0
48414,335,155,180,64,48,36,10,393,210,183,58,37,34,20,0
48415,527,276,251,64,60,70,20,621,310,311,100,106,77,27,0
48416,251,131,120,49,35,25,5,453,247,206,58,53,45,20,0
48417,520,240,280,87,63,67,16,328,199,129,39,29,27,14,0
48418,417,222,195,53,39,43,10,1241,619,622,183,169,155,59,0
48419,435,230,205,51,37,55,18,129,60,69,21,15,8,5,0
48420,2624,999,1625,415,495,109,84,375,210,165,49,37,29,27,0
48421,739,389,350,129,61,69,25,320,168,152,38,42,24,18,0
48422,402,169,233,70,36,34,18,332,173,159,48,40,31,11,0
48423,126,58,68,31,10,10,3,425,177,248,60,62,33,16,0
48424,421,237,184,47,54,45,10,665,361,304,87,91,84,31,0
48425,127,62,65,13,33,7,6,609,335,274,79,57,45,22,0
48426,261,148,113,23,29,26,21,222,124,98,37,29,22,9,0
48427,782,372,410,127,111,89,36,390,190,200,66,50,43,12,0
48428,473,217,256,59,44,34,21,189,105,84,25,26,21,9,0
48429,121,69,52,15,18,14,8,723,353,370,120,109,96,33,0
48430,588,300,288,100,57,65,27,393,210,183,58,37,34,20,0
48431,126,56,70,31,10,10,3,160,76,84,19,24,8,5,0
48432,493,281,212,56,61,30,13,330,166,164,55,51,36,16,0
48433,127,48,79,27,20,6,5,209,119,90,28,24,27,9,0
48434,109,42,67,25,13,1,1,362,156,206,74,42,36,22,0
48435,1096,563,533,158,136,120,53,2038,1059,979,262,237,208,100,0
48436,856,429,427,113,105,96,24,535,301,234,63,48,47,27,0
48437,478,177,301,109,66,59,25,165,90,75,36,18,20,6,0
48438,733,382,351,126,92,93,27,647,350,297,95,79,77,29,0
48439,261,130,131,27,41,19,16,225,129,96,32,33,20,8,0
48440,852,461,391,109,102,72,24,360,180,180,57,48,39,12,0
48441,164,61,103,47,19,14,5,385,188,197,57,42,36,16,0
48442,1054,453,601,183,183,107,35,464,236,228,64,56,53,28,0
48443,648,376,272,70,60,73,24,239,113,126,36,49,20,8,0
48444,304,149,155,46,32,39,14,609,335,274,79,57,45,22,0
48445,292,102,190,71,27,51,21,2382,1162,1220,237,220,140,49,0
48446,520,231,289,89,59,58,26,415,189,226,68,54,50,21,0
48447,475,208,267,84,67,50,20,354,183,171,54,43,49,8,0
48448,406,207,199,56,46,68,19,368,204,164,43,35,30,24,0
48449,245,111,134,36,27,18,6,242,121,121,39,30,29,10,0
48450,650,330,320,97,77,65,28,549,273,276,74,68,72,24,0
48451,261,130,131,27,41,19,16,218,115,103,32,32,34,11,0
48452,631,316,315,64,57,49,15,154,78,76,23,21,13,5,0
48453,683,304,379,140,101,48,19,820,333,487,202,152,59,23,0
48454,202,113,89,16,27,21,11,218,111,107,45,29,24,6,0
48455,1098,519,579,182,159,79,42,650,330,320,93,93,51,28,0
48456,861,393,468,150,101,69,35,105,51,54,13,17,12,8,0
48457,546,278,268,94,60,32,22,1500,804,696,190,172,144,60,0
48458,365,222,143,44,24,35,11,583,280,303,95,66,76,25,0
48459,146,75,71,13,32,15,11,710,375,335,95,94,110,28,0
48460,202,103,99,28,20,12,8,617,314,303,96,68,68,37,0
48461,613,303,310,70,28,28,18,287,151,136,51,42,36,7,0
48462,381,146,235,74,48,47,34,1239,659,580,169,148,131,54,0
48463,399,196,203,62,45,38,19,555,292,263,75,63,67,27,0
48464,474,243,231,66,54,41,29,295,158,137,42,34,38,14,0
48465,221,114,107,65,7,2,1,1154,489,665,200,196,95,54,0
48466,251,131,120,49,35,25,5,403,233,170,38,29,21,14,0
48467,588,300,288,100,57,65,27,260,133,127,43,32,39,3,0
48468,1174,594,580,175,155,126,66,194,106,88,33,10,15,6,0
48469,333,171,162,41,44,48,23,926,340,586,133,119,60,40,0
48470,407,230,177,44,39,34,19,277,124,153,44,40,35,18,0
48471,129,70,59,29,9,7,2,699,334,365,108,80,70,20,0
48472,1755,849,906,245,226,148,56,439,227,212,60,55,58,8,0
48473,415,133,282,114,65,27,7,415,189,226,68,54,50,21,0
48474,328,156,172,44,37,44,15,245,121,124,37,35,36,12,0
48475,560,279,281,113,64,58,15,225,114,111,32,29,26,6,0
48476,202,103,99,28,20,12,8,293,142,151,49,40,42,17,0
48477,275,160,115,40,31,34,17,673,313,360,102,101,46,17,0
48478,854,435,419,118,91,95,42,403,192,211,102,39,49,15,0
48479,828,394,434,105,110,81,33,839,446,393,103,94,76,27,0
48480,1009,487,522,177,121,103,51,4646,2328,2318,674,639,475,170,0
48481,164,77,87,33,19,6,7,335,170,165,52,36,47,11,0
48482,1970,978,992,245,206,198,80,662,373,289,89,80,77,29,0
48483,276,149,127,45,34,39,9,250,119,131,58,26,29,7,0
48484,911,441,470,123,108,60,21,165,87,78,24,19,22,9,0
48485,332,172,160,50,33,35,9,232,111,121,23,29,17,9,0
48486,461,257,204,63,49,50,29,260,131,129,42,31,40,9,0
48487,365,210,155,46,30,24,12,531,261,270,73,80,68,26,0
48488,1120,436,684,208,120,101,115,200,99,101,31,24,26,6,0
48489,753,395,358,93,72,71,16,376,183,193,50,50,43,21,0
48490,1009,487,522,177,121,103,51,198,113,85,19,20,26,12,0
48491,464,237,227,64,66,33,12,329,196,133,41,36,31,15,0
48492,136,65,71,33,11,9,6,457,245,212,62,58,57,21,0
48493,255,126,129,41,37,13,5,390,190,200,66,50,43,12,0
48494,333,171,162,50,34,19,8,131,55,76,28,9,14,12,0
48495,722,390,332,125,69,67,25,780,337,443,112,116,77,28,0
48496,213,113,100,26,21,26,12,1114,539,575,145,131,94,56,0
48497,177,100,77,22,17,20,11,820,333,487,202,152,59,23,0
48498,392,205,187,83,49,38,10,391,189,202,55,56,56,12,0
48499,315,174,141,46,38,47,16,720,361,359,98,98,70,37,0
48500,467,233,234,83,37,77,22,381,196,185,55,57,43,16,0
48501,1327,520,807,241,174,141,60,171,94,77,24,28,30,11,0
48502,299,128,171,57,40,13,25,892,475,417,130,108,68,38,0
48503,318,161,157,53,51,32,13,322,180,142,45,38,28,7,0
48504,856,429,427,113,105,96,24,277,138,139,40,39,20,14,0
48505,371,143,228,77,48,29,26,647,350,297,95,79,77,29,0
48506,1085,646,439,108,65,36,19,330,166,164,55,51,36,16,0
48507,270,131,139,47,37,41,11,189,95,94,25,33,16,8,0
48508,335,148,187,52,26,51,12,966,478,488,108,144,74,43,0
48509,326,176,150,35,22,29,11,925,439,486,141,134,105,46,0
48510,784,351,433,118,87,73,41,391,189,202,55,56,56,12,0
48511,1148,472,676,229,164,86,37,270,162,108,26,26,16,11,0
48512,529,290,239,54,63,85,15,1040,564,476,134,110,114,51,0
48513,446,265,181,51,35,27,17,341,170,171,41,66,27,10,0
48514,673,317,356,101,85,76,49,105,51,54,13,17,12,8,0
48515,1043,479,564,200,131,123,62,375,176,199,48,61,40,12,0
48516,860,348,512,121,136,75,35,892,475,417,130,108,68,38,0
48517,1390,585,805,241,230,118,46,1537,701,836,209,187,129,58,0
48518,130,70,60,30,9,8,1,866,397,469,117,153,95,48,0
48519,571,298,273,81,72,57,25,518,292,226,60,60,52,21,0
48520,276,143,133,34,38,20,15,160,67,93,32,37,15,9,0
48521,498,274,224,58,59,50,18,256,141,115,32,22,32,8,0
48522,2446,1099,1347,363,294,233,100,1279,669,610,164,162,104,55,0
48523,972,501,471,125,156,106,39,727,388,339,102,87,70,29,0
48524,577,251,326,92,84,60,11,172,79,93,34,27,23,10,0
48525,714,260,454,140,97,120,54,274,142,132,33,34,18,14,0
48526,756,362,394,102,104,73,25,736,388,348,88,85,67,28,0
48527,585,277,308,92,73,61,32,294,146,148,50,45,51,15,0
48528,260,138,122,44,30,28,6,147,74,73,28,20,24,4,0
48529,288,104,184,80,30,39,6,397,223,174,50,39,29,17,0
48530,521,249,272,53,36,50,18,173,90,83,21,36,12,15,0
48531,1531,649,882,108,122,93,72,453,247,206,58,53,45,20,0
48532,417,176,241,75,61,51,20,172,79,93,34,27,23,10,0
48533,204,103,101,16,32,22,8,256,141,115,32,22,32,8,0
48534,1042,529,513,161,151,103,52,958,451,507,165,135,97,41,0
48535,1439,713,726,195,180,110,34,708,328,380,113,100,82,34,0
48536,482,231,251,76,81,64,26,439,231,208,65,51,55,17,0
48537,414,206,208,56,68,35,19,68,23,45,12,9,3,9,0
48538,393,223,170,44,36,32,14,715,348,367,109,84,68,30,0
48539,449,179,270,80,77,49,29,128,63,65,30,11,13,8,0
48540,646,304,342,104,93,58,26,392,155,237,68,61,34,16,0
48541,270,158,112,35,20,23,7,619,305,314,85,93,71,29,0
48542,309,137,172,51,50,28,14,662,312,350,103,104,59,20,0
48543,371,143,228,77,48,29,26,496,251,245,78,62,61,23,0
48544,664,269,395,117,107,36,15,262,129,133,40,41,31,10,0
48545,736,320,416,113,97,61,36,974,457,517,133,117,69,26,0
48546,2109,999,1110,332,294,187,89,397,234,163,44,38,23,21,0
48547,933,456,477,123,108,83,29,701,380,321,94,84,96,34,0
48548,163,70,93,28,21,17,6,690,345,345,96,83,73,42,0
48549,1336,724,612,209,141,133,60,148,69,79,26,18,16,3,0
48550,653,379,274,89,56,86,13,660,333,327,102,95,69,31,0
48551,364,204,160,65,35,15,13,561,279,282,85,81,88,24,0
48552,374,187,187,51,52,40,27,600,254,346,104,100,44,17,0
48553,202,113,89,16,27,21,11,201,99,102,34,26,23,6,0
48554,298,141,157,51,33,21,22,4646,2328,2318,674,639,475,170,0
48555,1235,584,651,140,226,82,52,297,164,133,45,39,40,9,0
48556,852,461,391,109,102,72,24,317,161,156,50,36,47,12,0
48557,952,547,405,95,90,127,35,240,141,99,34,28,29,8,0
48558,159,105,54,22,9,14,25,1323,690,633,132,178,112,61,0
48559,415,217,198,50,31,42,17,422,237,185,53,47,62,20,0
48560,440,267,173,52,29,42,12,370,190,180,60,52,37,13,0
48561,828,368,460,118,98,59,38,403,192,211,102,39,49,15,0
48562,755,271,484,113,226,61,20,640,364,276,84,68,69,33,0
48563,595,208,387,157,60,91,48,101,59,42,11,17,10,1,0
48564,1051,429,622,179,148,125,54,783,406,377,102,91,57,29,0
48565,71,28,43,15,9,5,2,561,279,282,85,81,88,24,0
48566,256,152,104,18,23,23,8,380,211,169,47,37,33,21,0
48567,631,304,327,98,75,52,23,744,385,359,105,96,57,31,0
48568,217,109,108,30,23,28,10,418,223,195,53,43,49,15,0
48569,172,82,90,21,35,21,5,374,191,183,40,52,40,16,0
48570,426,196,230,76,65,54,20,179,101,78,25,15,13,13,0
48571,456,214,242,76,62,52,22,370,190,180,60,52,37,13,0
48572,142,60,82,20,28,13,5,627,289,338,101,73,62,43,0
48573,496,210,286,112,55,72,13,380,211,169,47,37,33,21,0
48574,336,134,202,51,64,27,12,459,260,199,56,42,47,21,0
48575,134,60,74,19,13,10,7,305,161,144,39,40,44,17,0
48576,172,82,90,21,35,21,5,258,129,129,45,24,31,10,0
48577,199,107,92,41,15,14,8,427,251,176,51,39,25,22,0
48578,136,66,70,33,11,9,4,337,152,185,49,54,42,21,0
48579,485,246,239,74,48,47,22,133,61,72,21,19,13,4,0
48580,764,277,487,158,162,64,31,621,273,348,104,102,48,19,0
48581,207,89,118,56,8,4,3,496,251,245,78,62,61,23,0
48582,464,237,227,64,66,33,12,386,181,205,55,51,57,31,0
48583,320,183,137,51,18,38,8,348,194,154,57,31,43,12,0
48584,431,245,186,50,23,46,17,373,213,160,44,33,26,17,0
48585,210,84,126,44,43,9,4,270,130,140,48,44,37,12,0
48586,242,111,131,35,35,17,13,373,189,184,54,46,50,23,0
48587,575,295,280,89,68,54,18,125,66,59,24,16,11,5,0
48588,766,336,430,133,97,79,21,963,455,508,127,130,115,48,0
48589,342,150,192,52,43,31,17,736,388,348,88,85,67,28,0
48590,410,188,222,53,52,31,14,374,202,172,50,39,31,24,0
48591,452,202,250,83,60,56,19,810,310,500,164,162,42,26,0
48592,215,117,98,28,19,15,8,445,192,253,86,58,53,18,0
48593,426,213,213,60,56,46,24,228,130,98,35,29,30,10,0
48594,654,344,310,80,69,57,15,605,283,322,94,72,64,39,0
48595,1257,464,793,221,264,75,37,452,254,198,72,57,38,18,0
48596,346,174,172,36,43,21,9,339,175,164,51,49,37,9,0
48597,650,330,320,97,77,65,28,344,190,154,34,31,36,10,0
48598,150,64,86,22,12,29,12,1922,923,999,267,275,215,90,0
48599,743,377,366,87,74,68,30,179,101,78,25,15,13,13,0
48600,609,292,317,102,96,64,21,299,140,159,49,44,26,11,0
48601,431,202,229,57,50,50,25,665,361,304,87,91,84,31,0
48602,341,183,158,36,34,36,15,282,134,148,38,45,29,10,0
48603,279,127,152,50,36,28,8,98,49,49,14,15,9,2,0
48604,908,324,584,181,162,81,29,1248,584,664,184,164,155,67,0
48605,1199,589,610,189,128,167,65,445,264,181,35,35,34,14,0
48606,380,185,195,68,54,32,16,846,425,421,125,97,98,38,0
48607,463,250,213,56,45,73,25,902,499,403,118,117,92,35,0
48608,468,233,235,65,61,49,34,592,249,343,91,90,50,42,0
48609,548,250,298,85,64,56,21,148,69,79,26,18,16,3,0
48610,308,129,179,44,60,19,8,292,143,149,38,42,36,16,0
48611,193,95,98,33,17,25,17,86,40,46,16,13,9,7,0
48612,143,81,62,28,9,8,1,125,66,59,24,16,11,5,0
48613,350,212,138,32,26,40,13,377,184,193,50,43,33,17,0
48614,887,439,448,137,99,91,38,73,35,38,14,10,9,4,0
48615,443,206,237,76,68,52,28,180,115,65,17,12,9,9,0
48616,452,217,235,59,47,60,20,508,253,255,73,60,50,13,0
48617,411,211,200,61,46,35,18,139,68,71,14,26,14,9,0
48618,479,228,251,71,57,60,14,715,348,367,109,84,68,30,0
48619,860,348,512,121,136,75,35,94,45,49,11,20,10,4,0
48620,1023,449,574,141,174,76,43,1537,701,836,209,187,129,58,0
48621,636,288,348,94,77,65,30,231,126,105,28,26,34,9,0
48622,368,154,214,80,52,41,16,200,99,101,31,24,26,6,0
48623,271,136,135,37,30,18,10,509,267,242,79,81,38,20,0
48624,546,265,281,101,64,38,16,607,293,314,98,71,62,32,0
48625,213,113,100,26,21,26,12,518,292,226,60,60,52,21,0
48626,270,131,139,47,37,41,11,364,189,175,58,41,35,17,0
48627,330,141,189,65,29,51,19,180,90,90,31,19,20,8,0
48628,1068,434,634,173,160,61,29,91,44,47,9,12,4,7,0
48629,1163,417,746,209,145,87,28,551,226,325,96,103,43,11,0
48630,262,133,129,44,38,31,12,218,117,101,35,32,34,12,0
48631,785,351,434,136,93,71,37,86,40,46,16,13,9,7,0
48632,320,163,157,44,44,26,15,1700,731,969,198,233,110,87,0
48633,181,75,106,35,26,11,9,293,142,151,49,40,42,17,0
48634,610,249,361,107,69,72,33,73,35,38,14,10,9,4,0
48635,763,371,392,104,88,52,23,270,130,140,48,44,37,12,0
48636,126,66,60,24,10,7,9,415,189,226,68,54,50,21,0
48637,395,195,200,41,55,23,10,154,78,76,23,21,13,5,0
48638,426,213,213,60,56,46,24,548,296,252,71,74,43,28,0
48639,331,169,162,40,28,22,14,427,236,191,49,54,46,13,0
48640,399,196,203,62,45,38,19,715,348,367,109,84,68,30,0
48641,1068,434,634,173,160,61,29,424,179,245,65,67,29,11,0
48642,643,284,359,129,71,84,43,583,280,303,95,66,76,25,0
48643,476,276,200,57,34,43,16,1230,644,586,198,125,123,61,0
48644,394,207,187,52,42,37,24,377,184,193,50,43,33,17,0
48645,873,366,507,127,125,75,21,306,157,149,52,35,39,16,0
48646,595,339,256,64,36,54,24,190,93,97,35,27,23,2,0
48647,546,285,261,71,49,47,24,418,223,195,51,45,49,14,0
48648,441,216,225,57,66,57,19,252,130,122,45,23,32,11,0
48649,308,129,179,44,60,19,8,230,125,105,29,40,20,6,0
48650,357,182,175,49,36,39,15,928,440,488,111,157,82,35,0
48651,2109,999,1110,332,294,187,89,303,138,165,47,46,35,18,0
48652,250,123,127,40,28,29,8,619,305,314,85,93,71,29,0
48653,427,191,236,67,60,41,34,607,293,314,98,71,62,32,0
48654,206,100,106,34,26,11,7,1922,923,999,267,275,215,90,0
48655,92,46,46,14,9,8,6,963,525,438,119,102,102,34,0
48656,374,202,172,58,40,41,7,520,272,248,60,65,58,22,0
48657,413,169,244,66,94,28,19,132,77,55,20,9,13,10,0
48658,707,250,457,171,84,117,61,251,143,108,47,25,29,11,0
48659,535,217,318,87,106,41,14,564,264,300,79,84,65,26,0
48660,317,153,164,34,52,30,14,232,108,124,33,27,19,16,0
48661,126,58,68,31,10,10,3,246,125,121,38,36,30,11,0
48662,545,221,324,101,72,55,30,665,361,304,87,91,84,31,0
48663,135,64,71,31,11,8,4,230,113,117,31,40,28,10,0
48664,622,354,268,89,60,64,18,374,174,200,54,52,42,21,0
48665,798,287,511,126,125,77,26,889,505,384,107,97,99,30,0
48666,172,98,74,20,21,22,8,425,177,248,60,62,33,16,0
48667,411,171,240,61,81,30,15,290,142,148,41,37,43,11,0
48668,861,393,468,150,101,69,35,2346,1231,1115,316,292,266,105,0
48669,335,171,164,51,38,38,10,375,210,165,49,37,29,27,0
48670,485,183,302,79,81,73,33,1279,669,610,164,162,104,55,0
48671,580,240,340,108,81,59,22,323,168,155,51,41,38,12,0
48672,680,308,372,82,72,71,40,1323,690,633,132,178,112,61,0
48673,413,206,207,38,55,19,10,1378,692,686,194,174,105,56,0
48674,584,340,244,77,60,47,25,400,187,213,56,59,42,20,0
48675,255,136,119,39,20,32,10,277,138,139,40,39,20,14,0
48676,486,243,243,65,48,63,22,715,348,367,109,84,68,30,0
48677,447,236,211,56,52,49,14,339,175,164,51,49,37,9,0
48678,204,109,95,21,35,27,7,133,61,72,21,19,13,4,0
48679,249,104,145,47,41,24,17,2202,1121,1081,338,274,269,81,0
48680,361,177,184,59,51,24,15,846,425,421,125,97,98,38,0
48681,772,383,389,105,76,82,33,780,337,443,112,116,77,28,0
48682,209,75,134,53,48,20,9,328,199,129,39,29,27,14,0
48683,802,430,372,65,102,87,23,439,227,212,60,55,58,8,0
48684,313,178,135,43,18,35,6,1065,581,484,134,97,76,46,0
48685,407,207,200,53,36,38,8,903,436,467,128,116,83,33,0
48686,580,281,299,95,60,74,29,2547,1280,1267,331,335,293,118,0
48687,206,100,106,34,26,11,7,671,321,350,95,87,75,34,0
48688,255,126,129,41,37,13,5,228,130,98,35,29,30,10,0
48689,452,202,250,83,60,56,19,96,46,50,16,12,7,5,0
48690,619,289,330,67,77,36,19,1101,626,475,145,122,120,50,0
48691,288,140,148,59,33,27,12,378,154,224,74,84,35,22,0
48692,1124,442,682,148,189,72,43,535,301,234,63,48,47,27,0
48693,490,198,292,65,81,39,27,395,198,197,55,55,36,10,0
48694,1148,472,676,229,164,86,37,465,252,213,73,58,60,18,0
48695,98,32,66,15,25,5,4,323,171,152,48,41,40,16,0
48696,359,204,155,39,36,34,13,943,463,480,91,144,70,30,0
48697,535,217,318,87,106,41,14,317,161,156,50,36,47,12,0
48698,1556,718,838,280,182,161,49,627,289,338,101,73,62,43,0
48699,462,233,229,66,49,43,30,308,146,162,42,39,24,12,0
48700,434,221,213,58,47,54,15,548,273,275,84,81,64,30,0
48701,426,213,213,60,56,46,24,415,226,189,51,40,40,29,0
48702,756,265,491,129,127,51,17,402,186,216,64,47,38,20,0
48703,919,493,426,100,92,88,49,943,463,480,91,144,70,30,0
48704,331,177,154,54,38,27,11,671,306,365,114,76,49,19,0
48705,1174,594,580,175,155,126,66,198,110,88,27,27,24,4,0
48706,107,53,54,15,15,13,4,103,50,53,19,10,7,5,0
48707,155,85,70,17,16,4,8,2547,1280,1267,331,335,293,118,0
48708,364,204,160,65,35,15,13,736,388,348,88,85,67,28,0
48709,330,182,148,47,27,40,11,2225,1244,981,271,243,217,93,0
48710,538,263,275,71,85,44,18,447,212,235,86,55,58,21,0
48711,356,199,157,36,43,28,12,172,88,84,24,31,20,12,0
48712,496,210,286,112,55,71,14,296,151,145,45,42,32,11,0
48713,273,126,147,54,49,25,18,1279,669,610,164,162,104,55,0
48714,473,212,261,72,64,45,28,252,130,122,45,23,32,11,0
48715,582,328,254,78,48,35,9,137,72,65,27,13,15,8,0
48716,2048,855,1193,297,287,191,93,165,90,75,36,18,20,6,0
48717,284,128,156,48,29,34,8,266,146,120,41,28,31,7,0
48718,265,165,100,32,19,27,5,389,207,182,53,58,52,18,0
48719,119,59,60,29,10,6,4,328,195,133,39,40,27,13,0
48720,242,104,138,41,33,37,8,215,115,100,27,19,16,7,0
48721,314,158,156,39,28,30,17,136,65,71,26,11,7,5,0
48722,167,70,97,32,20,15,7,147,74,73,28,20,24,4,0
48723,451,278,173,71,35,58,12,480,255,225,67,64,50,22,0
48724,67,40,27,10,8,7,6,384,212,172,44,43,34,14,0
48725,435,225,210,58,46,50,14,172,79,93,34,27,23,10,0
48726,357,182,175,49,36,39,15,756,348,408,101,103,60,40,0
48727,436,201,235,54,37,35,18,286,160,126,37,27,23,10,0
48728,111,29,82,10,54,0,1,654,295,359,99,88,71,25,0
48729,1390,705,685,219,164,129,74,518,292,226,60,60,52,21,0
48730,579,281,298,91,78,74,27,148,84,64,30,7,17,4,0
48731,424,170,254,69,56,47,28,103,50,53,19,10,7,5,0
48732,155,85,70,17,16,4,8,133,61,72,21,19,13,4,0
48733,417,176,241,75,61,51,20,1265,689,576,169,177,128,60,0
48734,478,177,301,109,66,59,25,662,373,289,89,80,77,29,0
48735,340,181,159,44,39,35,21,106,46,60,27,18,12,3,0
48736,609,292,317,102,96,64,21,622,344,278,80,77,68,36,0
48737,275,125,150,37,48,27,7,127,58,69,18,17,10,5,0
48738,1098,519,579,182,159,79,42,286,152,134,38,38,32,11,0
48739,422,196,226,52,35,33,20,654,295,359,99,88,71,25,0
48740,1004,498,506,94,59,46,33,708,328,380,113,100,82,34,0
48741,341,183,158,36,34,36,15,520,244,276,91,60,68,20,0
48742,500,257,243,60,55,27,22,1500,804,696,190,172,144,60,0
48743,149,68,81,15,38,11,10,308,129,179,44,60,19,8,0
48744,410,208,202,59,58,43,26,423,234,189,66,44,57,12,0
48745,639,368,271,72,51,38,38,555,292,263,75,63,67,27,0
48746,625,283,342,93,89,67,25,583,321,262,73,67,45,25,0
48747,1463,521,942,252,204,105,52,285,143,142,45,32,21,17,0
48748,1709,650,1059,338,286,185,46,594,312,282,72,67,73,31,0
48749,213,104,109,56,14,9,2,597,300,297,96,89,68,29,0
48750,739,323,416,127,89,76,33,671,306,365,114,76,49,19,0
48751,886,440,446,116,140,95,45,429,187,242,79,72,28,19,0
48752,859,411,448,118,100,95,49,132,67,65,24,21,8,10,0
48753,219,100,119,40,29,21,3,497,227,270,70,63,66,30,0
48754,886,440,446,116,140,95,45,479,215,264,67,80,46,28,0
48755,270,128,142,36,43,15,11,462,251,211,74,53,41,18,0
48756,282,135,147,27,37,30,19,485,244,241,80,55,59,20,0
48757,619,289,330,67,77,36,19,467,231,236,71,65,58,18,0
48758,565,264,301,101,73,72,15,389,210,179,51,37,43,9,0
48759,257,148,109,28,20,21,14,947,482,465,143,107,89,37,0
48760,478,220,258,47,70,41,10,773,389,384,119,91,79,26,0
48761,393,185,208,59,50,36,22,169,99,70,26,21,20,7,0
48762,681,367,314,83,74,78,31,329,196,133,41,36,31,15,0
48763,98,32,66,15,25,5,4,810,310,500,164,162,42,26,0
48764,784,353,431,56,47,26,18,316,159,157,38,48,30,11,0
48765,206,96,110,33,25,8,6,928,440,488,111,157,82,35,0
48766,1130,614,516,129,138,98,42,389,207,182,53,58,52,18,0
48767,394,207,187,52,42,37,24,375,209,166,50,37,29,23,0
48768,674,268,406,118,96,70,21,169,85,84,21,14,9,9,0
48769,346,174,172,36,43,21,9,501,249,252,77,70,55,22,0
48770,470,163,307,99,68,73,30,410,197,213,67,43,56,18,0
48771,291,142,149,50,29,35,7,246,125,121,38,36,30,11,0
48772,837,381,456,123,109,65,25,317,161,156,40,49,41,11,0
48773,443,212,231,74,24,60,24,541,279,262,79,82,31,32,0
48774,489,253,236,73,36,62,17,640,364,276,84,68,69,33,0
48775,447,225,222,76,35,75,21,169,74,95,33,26,22,3,0
48776,317,167,150,45,21,30,26,756,348,408,101,103,60,40,0
48777,92,46,46,14,9,8,6,455,191,264,68,86,21,19,0
48778,76,30,46,7,15,1,5,497,227,270,70,63,66,30,0
48779,575,290,285,67,70,28,9,148,84,64,30,7,17,4,0
48780,508,136,372,157,91,22,9,285,143,142,45,32,21,17,0
48781,456,223,233,77,54,47,20,1034,495,539,150,134,114,71,0
48782,598,300,298,68,77,59,21,360,185,175,51,43,36,16,0
48783,258,130,128,44,37,29,10,132,61,71,19,20,14,6,0
48784,785,351,434,136,93,71,37,149,77,72,37,10,20,5,0
48785,395,189,206,63,50,49,28,508,261,247,65,53,58,23,0
48786,200,94,106,33,22,18,8,583,280,303,95,66,76,25,0
48787,447,225,222,76,35,75,21,250,119,131,58,26,29,7,0
48788,435,187,248,62,51,51,21,630,321,309,86,90,57,26,0
48789,1120,436,684,208,120,101,115,368,200,168,54,49,43,9,0
48790,685,393,292,75,66,113,16,319,185,134,42,31,22,13,0
48791,533,300,233,74,50,74,17,515,276,239,62,59,43,31,0
48792,1616,735,881,285,248,153,72,520,244,276,91,60,68,20,0
48793,204,109,95,21,35,27,7,178,99,79,31,19,26,8,0
48794,977,462,515,185,119,76,12,978,536,442,132,107,67,32,0
48795,193,110,83,18,20,15,12,257,126,131,61,24,22,8,0
48796,653,379,274,89,56,86,13,1696,771,925,257,225,149,63,0
48797,454,230,224,63,56,38,33,89,38,51,14,6,3,9,0
48798,453,240,213,53,33,44,16,1279,669,610,164,162,104,55,0
48799,454,214,240,56,71,35,16,661,325,336,81,75,65,28,0
48800,165,66,99,28,32,16,3,480,255,225,67,64,50,22,0
48801,520,261,259,74,52,49,22,200,89,111,26,25,17,7,0
48802,1480,789,691,195,151,173,55,988,571,417,107,103,115,46,0
48803,312,173,139,43,47,28,6,136,65,71,26,11,7,5,0
48804,280,128,152,39,37,38,18,166,78,88,27,25,19,7,0
48805,427,218,209,61,53,45,26,465,230,235,68,64,48,24,0
48806,661,370,291,50,52,50,27,119,57,62,18,16,17,4,0
48807,308,163,145,38,33,30,20,261,127,134,36,27,36,4,0
48808,526,228,298,69,64,32,30,152,71,81,41,16,14,2,0
48809,906,437,469,135,132,49,40,734,340,394,108,99,52,32,0
48810,203,97,106,30,22,18,10,380,178,202,69,53,37,10,0
48811,446,265,181,51,35,27,17,368,204,164,43,35,30,24,0
48812,941,459,482,167,140,82,38,1279,669,610,164,162,104,55,0
48813,255,136,119,39,20,32,10,536,251,285,75,79,60,23,0
48814,586,309,277,81,64,76,25,423,192,231,60,45,32,35,0
48815,338,164,174,45,32,37,13,302,150,152,56,40,52,15,0
48816,492,253,239,73,67,77,29,257,126,131,61,24,22,8,0
48817,357,182,175,49,36,39,15,429,187,242,79,72,28,19,0
48818,454,230,224,63,56,38,33,316,166,150,45,38,37,13,0
48819,952,547,405,95,90,127,35,312,165,147,41,39,29,16,0
48820,836,370,466,126,96,72,30,166,102,64,19,14,17,2,0
48821,424,170,254,69,56,47,28,749,384,365,108,105,86,31,0
48822,288,140,148,59,33,27,12,715,345,370,110,97,64,25,0
48823,107,36,71,27,15,0,1,346,178,168,58,41,33,12,0
48824,474,243,231,66,54,41,29,775,407,368,122,100,97,32,0
48825,303,161,142,38,31,42,17,72,32,40,8,2,1,14,0
48826,474,243,231,66,54,41,29,415,226,189,51,40,40,29,0
48827,291,142,149,50,29,35,7,196,105,91,40,13,19,10,0
48828,550,304,246,60,64,77,16,317,161,156,40,49,41,11,0
48829,476,199,277,82,80,49,24,332,173,159,48,40,31,11,0
48830,493,208,285,75,77,70,40,1378,692,686,194,174,105,56,0
48831,325,177,148,40,24,23,13,377,184,193,50,43,33,17,0
48832,335,155,180,64,48,36,10,215,115,100,27,19,16,7,0
48833,801,331,470,151,139,99,55,465,252,213,73,58,60,18,0
48834,290,156,134,44,29,39,9,128,63,65,30,11,13,8,0
48835,328,156,172,44,37,44,15,125,66,59,24,16,11,5,0
48836,563,255,308,91,111,42,30,103,44,59,16,17,9,5,0
48837,463,250,213,56,45,73,25,244,143,101,31,29,26,8,0
48838,1221,597,624,201,152,83,31,727,388,339,102,87,70,29,0
48839,546,285,261,71,49,47,24,663,360,303,87,82,80,35,0
48840,963,477,486,134,143,123,38,225,129,96,32,33,20,8,0
48841,160,67,93,32,37,15,9,245,137,108,34,30,19,10,0
48842,376,249,127,47,23,43,16,662,312,350,103,104,59,20,0
48843,651,357,294,81,67,103,18,654,295,359,99,88,71,25,0
48844,213,88,125,21,54,14,15,455,191,264,68,86,21,19,0
48845,505,247,258,72,71,60,27,531,277,254,82,75,33,22,0
48846,1011,559,452,121,97,132,33,427,251,176,51,39,25,22,0
48847,410,211,199,55,42,34,27,457,253,204,67,51,48,13,0
48848,658,349,309,77,70,73,35,1020,538,482,145,115,111,58,0
48849,1030,438,592,184,104,108,30,218,111,107,45,29,24,6,0
48850,824,391,433,106,90,88,32,171,94,77,24,28,30,11,0
48851,415,133,282,114,65,27,7,536,267,269,60,70,41,22,0
48852,473,265,208,47,26,50,30,418,223,195,51,45,49,14,0
48853,1365,590,775,257,168,136,93,497,257,240,71,63,62,16,0
48854,2048,855,1193,297,287,191,93,556,290,266,75,74,29,24,0
48855,753,395,358,93,72,71,16,497,227,270,70,63,66,30,0
48856,109,42,67,25,13,1,1,417,232,185,58,50,29,21,0
48857,207,89,118,56,8,4,3,647,350,297,95,79,77,29,0
48858,331,144,187,57,46,33,19,508,261,247,65,53,58,23,0
48859,1004,464,540,143,104,78,55,1606,753,853,215,227,182,48,0
48860,493,281,212,56,61,30,13,1154,489,665,200,196,95,54,0
48861,622,354,268,89,60,64,18,207,113,94,33,18,30,9,0
48862,1087,523,564,146,177,103,33,166,78,88,27,25,19,7,0
48863,244,104,140,52,31,30,14,404,190,214,55,55,35,27,0
48864,315,174,141,46,38,47,16,693,360,333,100,88,62,26,0
48865,130,71,59,30,9,8,2,1323,690,633,132,178,112,61,0
48866,772,332,440,136,104,72,28,485,244,241,80,55,59,20,0
48867,343,189,154,44,24,39,12,509,267,242,79,81,38,20,0
48868,286,111,175,51,47,21,12,201,93,108,34,39,21,6,0
48869,502,229,273,63,66,40,31,386,207,179,43,48,44,19,0
48870,1441,504,937,264,329,69,46,597,269,328,102,84,69,24,0
48871,385,203,182,47,43,51,21,225,129,96,32,33,20,8,0
48872,496,209,287,113,55,72,14,862,426,436,113,115,84,37,0
48873,1276,607,669,192,178,136,63,199,105,94,27,27,28,9,0
48874,329,165,164,61,44,29,17,661,325,336,81,75,65,28,0
48875,739,389,350,129,61,69,25,562,273,289,76,92,45,24,0
48876,156,64,92,31,19,5,4,866,478,388,121,101,101,26,0
48877,398,186,212,76,70,18,13,295,156,139,41,40,42,15,0
48878,500,245,255,66,57,52,27,286,160,126,37,27,23,10,0
48879,450,231,219,77,50,76,16,461,223,238,45,62,18,35,0
48880,422,207,215,79,38,53,23,622,344,278,80,77,68,36,0
48881,862,384,478,127,110,75,42,732,402,330,81,86,87,33,0
48882,434,221,213,58,47,54,15,262,129,133,40,41,31,10,0
48883,535,315,220,57,55,71,19,928,440,488,111,157,82,35,0
48884,346,174,172,36,43,21,9,509,267,242,79,81,38,20,0
48885,785,374,411,56,42,38,25,843,391,452,139,104,91,35,0
48886,319,153,166,61,52,26,12,378,154,224,74,84,35,22,0
48887,149,68,81,15,38,11,10,279,106,173,48,35,41,39,0
48888,388,244,144,46,25,42,16,406,202,204,54,51,63,21,0
48889,256,152,104,18,23,23,8,1061,543,518,146,123,109,67,0
48890,474,243,231,66,54,41,29,389,207,182,53,58,52,18,0
48891,199,113,86,27,17,10,7,410,197,213,67,43,56,18,0
48892,531,259,272,75,81,39,13,245,131,114,30,27,18,13,0
48893,379,217,162,47,20,50,23,106,41,65,36,6,11,7,0
48894,927,457,470,130,99,118,42,316,159,157,38,48,30,11,0
48895,246,111,135,64,47,27,3,135,65,70,21,25,15,9,0
48896,338,208,130,39,30,35,12,91,44,47,9,12,4,7,0
48897,434,216,218,72,58,40,20,148,69,79,26,18,16,3,0
48898,412,146,266,106,38,67,35,520,244,276,91,60,68,20,0
48899,646,304,342,104,93,58,26,363,180,183,60,34,10,6,0
48900,431,216,215,46,40,33,9,130,67,63,24,10,12,4,0
48901,346,186,160,40,37,34,21,245,131,114,30,27,18,13,0
48902,222,110,112,43,30,14,6,169,84,85,29,19,21,7,0
48903,577,342,235,63,57,23,37,277,124,153,44,40,35,18,0
48904,350,212,138,32,26,40,13,818,357,461,122,136,54,25,0
48905,618,289,329,97,86,70,17,171,94,77,24,28,30,11,0
48906,252,121,131,42,34,12,16,1382,508,874,334,320,98,36,0
48907,270,147,123,34,17,39,21,405,181,224,71,57,31,12,0
48908,217,109,108,30,23,28,10,294,146,148,50,45,51,15,0
48909,933,456,477,123,108,83,29,389,210,179,51,37,43,9,0
48910,213,88,125,21,54,14,15,374,202,172,50,39,31,24,0
48911,552,295,257,67,49,70,30,105,51,54,13,17,12,8,0
48912,181,75,106,35,26,11,9,391,189,202,55,56,56,12,0
48913,350,172,178,61,45,32,13,565,237,328,75,88,32,11,0
48914,396,150,246,103,64,38,3,792,398,394,109,96,90,39,0
48915,126,57,69,31,10,10,3,199,105,94,27,27,28,9,0
48916,979,534,445,83,77,80,24,475,251,224,67,49,48,23,0
48917,556,306,250,69,60,80,18,106,41,65,36,6,11,7,0
48918,349,153,196,54,47,28,13,660,303,357,97,89,85,33,0
48919,501,230,271,63,90,50,18,629,317,312,80,87,51,22,0
48920,682,292,390,89,69,58,20,199,105,94,27,27,28,9,0
48921,785,351,434,136,93,71,37,198,110,88,27,27,24,4,0
48922,419,210,209,54,44,31,23,463,259,204,62,55,34,22,0
48923,332,172,160,50,33,35,9,545,269,276,80,76,27,32,0
48924,837,381,456,123,109,65,25,396,223,173,57,37,44,19,0
48925,378,202,176,34,32,44,13,370,173,197,65,57,42,10,0
48926,284,160,124,37,23,32,11,277,144,133,42,30,41,8,0
48927,727,426,301,79,71,64,32,737,397,340,87,104,90,14,0
48928,320,163,157,44,44,26,15,305,163,142,38,27,47,11,0
48929,646,304,342,104,93,58,26,300,148,152,45,43,40,8,0
48930,157,62,95,41,18,10,11,662,373,289,89,80,77,29,0
48931,305,164,141,43,23,47,18,373,183,190,49,37,33,18,0
48932,957,381,576,184,158,86,48,103,44,59,16,17,9,5,0
48933,734,366,368,121,99,63,39,400,187,213,56,59,42,20,0
48934,367,167,200,63,42,60,17,288,156,132,36,36,24,15,0
48935,1217,647,570,142,160,129,45,741,383,358,92,63,79,36,0
48936,798,364,434,133,88,74,35,250,119,131,58,26,29,7,0
48937,836,370,466,126,96,72,30,199,92,107,34,30,18,9,0
48938,193,95,98,33,17,25,17,234,116,118,34,35,23,9,0
48939,517,245,272,92,77,46,24,418,223,195,53,43,49,15,0
48940,360,175,185,73,36,27,7,188,88,100,53,12,15,6,0
48941,313,134,179,58,37,43,19,403,225,178,56,38,33,25,0
48942,609,292,317,102,96,64,21,889,505,384,107,97,99,30,0
48943,126,56,70,31,10,10,3,555,292,263,75,63,67,27,0
48944,1099,491,608,163,141,107,62,198,86,112,36,27,23,9,0
48945,517,245,272,92,77,46,24,715,348,367,109,84,68,30,0
48946,213,113,100,26,21,26,12,172,79,93,34,27,23,10,0
48947,1030,438,592,184,104,108,30,266,150,116,28,28,24,12,0
48948,319,153,166,61,52,26,12,332,155,177,55,51,44,13,0
48949,519,245,274,58,61,34,22,408,221,187,55,51,57,14,0
48950,343,162,181,65,38,29,12,103,44,59,16,17,9,5,0
48951,1849,931,918,245,220,158,90,305,163,142,38,27,47,11,0
48952,288,104,184,80,30,39,6,187,89,98,36,24,20,6,0
48953,482,231,251,76,81,64,26,715,345,370,110,97,64,25,0
48954,734,339,395,135,89,78,36,410,197,213,67,43,56,18,0
48955,388,244,144,46,25,42,16,363,180,183,60,34,10,6,0
48956,435,230,205,51,37,55,18,354,188,166,46,40,34,10,0
48957,286,111,175,51,47,21,12,103,44,59,16,17,9,5,0
48958,126,66,60,24,10,7,9,91,44,47,9,12,4,7,0
48959,395,219,176,47,41,50,18,215,115,100,27,19,16,7,0
48960,469,221,248,49,60,55,21,374,212,162,48,40,32,23,0
48961,364,172,192,55,57,32,15,218,118,100,33,30,25,11,0
48962,341,177,164,57,42,40,18,483,258,225,70,53,54,20,0
48963,313,134,179,58,37,43,19,251,143,108,47,25,29,11,0
48964,136,66,70,33,11,9,4,335,186,149,40,28,29,13,0
48965,501,230,271,63,90,50,18,297,164,133,45,39,40,9,0
48966,1257,464,793,221,264,75,37,555,282,273,82,69,65,21,0
48967,124,58,66,20,28,11,7,198,110,88,27,27,24,4,0
48968,246,123,123,40,31,27,7,218,115,103,32,32,34,11,0
48969,1341,481,860,275,264,57,21,763,418,345,113,84,59,32,0
48970,666,204,462,110,194,42,14,222,125,97,34,27,27,7,0
48971,469,253,216,49,51,48,18,199,105,94,27,27,28,9,0
48972,92,46,46,14,9,8,6,1922,923,999,267,275,215,90,0
48973,411,211,200,61,46,35,18,234,116,118,34,35,23,9,0
48974,484,261,223,59,48,49,24,134,72,62,14,28,8,4,0
48975,492,253,239,73,67,77,29,1922,923,999,267,275,215,90,0
48976,665,341,324,109,79,38,22,605,283,322,94,72,64,39,0
48977,507,314,193,49,45,59,25,367,218,149,45,43,42,16,0
48978,3230,1724,1506,361,358,157,75,654,295,359,99,88,71,25,0
48979,553,276,277,88,61,45,27,54,26,28,11,4,3,3,0
48980,401,236,165,53,38,34,9,392,155,237,68,61,34,16,0
48981,368,201,167,61,38,38,12,368,200,168,54,49,43,9,0
48982,1464,693,771,153,136,91,86,975,400,575,160,162,62,31,0
48983,157,62,95,41,18,10,11,1500,804,696,190,172,144,60,0
48984,126,57,69,31,10,10,3,609,335,274,79,57,45,22,0
48985,580,265,315,97,89,79,17,127,54,73,11,33,15,6,0
48986,736,353,383,117,83,71,18,277,124,153,44,40,35,18,0
48987,163,70,93,28,21,17,6,354,188,166,46,40,34,10,0
48988,1336,724,612,209,141,133,60,1873,935,938,233,225,203,79,0
48989,441,216,225,57,66,57,19,376,189,187,47,53,44,26,0
48990,314,178,136,42,32,30,17,335,170,165,52,36,47,11,0
48991,932,575,357,94,69,76,40,250,116,134,41,30,33,19,0
48992,4128,2104,2024,581,505,453,205,367,218,149,45,43,42,16,0
48993,598,322,276,67,57,63,26,2225,1244,981,271,243,217,93,0
48994,215,117,98,28,19,15,8,228,130,98,35,29,30,10,0
48995,898,397,501,102,98,54,37,432,244,188,51,51,27,14,0
48996,785,325,460,114,123,61,28,406,202,204,54,51,63,21,0
48997,230,114,116,30,33,29,8,189,105,84,25,26,21,9,0
48998,407,230,177,44,39,34,19,565,237,328,75,88,32,11,0
48999,559,217,342,105,86,42,16,452,252,200,55,49,61,16,0
49000,900,434,466,134,97,86,36,398,200,198,68,43,51,14,0
49001,510,288,222,44,36,24,7,508,262,246,66,67,51,20,0
49002,261,126,135,41,36,24,11,504,272,232,75,57,53,19,0
49003,2279,996,1283,375,328,158,60,215,115,100,27,19,16,7,0
49004,1208,575,633,187,204,117,41,207,114,93,33,20,31,13,0
49005,381,146,235,74,48,47,34,188,105,83,25,17,24,7,0
49006,131,69,62,29,9,9,1,198,110,88,27,27,24,4,0
49007,800,416,384,102,105,83,22,565,237,328,75,88,32,11,0
49008,313,178,135,43,18,35,6,818,357,461,122,136,54,25,0
49009,772,383,389,105,76,82,33,294,146,148,50,45,51,15,0
49010,297,182,115,41,22,23,8,583,321,262,73,67,45,25,0
49011,2442,1193,1249,278,183,170,145,230,125,105,29,40,20,6,0
49012,427,191,236,67,60,41,34,247,128,119,34,14,16,14,0
49013,1148,472,676,229,164,86,37,410,197,213,67,43,56,18,0
49014,1505,680,825,202,204,73,32,360,180,180,57,48,39,12,0
49015,310,141,169,36,38,20,8,325,172,153,44,34,27,14,0
49016,267,146,121,40,24,25,7,480,255,225,67,64,50,22,0
49017,747,469,278,60,41,53,23,213,129,84,32,14,21,15,0
49018,339,170,169,32,17,24,13,556,290,266,75,74,29,24,0
49019,525,302,223,56,48,67,19,270,162,108,26,26,16,11,0
49020,103,56,47,27,7,8,2,229,120,109,31,30,22,9,0
49021,401,204,197,49,33,29,17,749,384,365,108,105,86,31,0
49022,756,265,491,129,127,51,17,96,45,51,13,12,6,4,0
49023,349,167,182,54,38,30,28,395,169,226,73,55,38,9,0
49024,306,172,134,35,31,37,18,290,147,143,34,34,39,13,0
49025,624,222,402,92,81,39,15,399,190,209,61,41,39,18,0
49026,479,227,252,69,48,46,18,189,105,84,25,26,21,9,0
49027,343,189,154,44,24,39,12,231,126,105,37,26,29,6,0
49028,335,183,152,40,26,54,22,72,32,40,8,2,2,13,0
49029,470,163,307,99,68,73,30,889,505,384,107,97,99,30,0
49030,443,212,231,74,24,60,24,526,266,260,76,75,53,22,0
49031,1004,498,506,94,59,46,33,335,186,149,40,28,29,13,0
49032,616,323,293,98,71,31,15,715,348,367,109,84,68,30,0
49033,1052,492,560,184,163,103,44,455,191,264,68,86,21,19,0
49034,301,156,145,32,25,15,5,644,343,301,96,69,59,28,0
49035,480,232,248,73,40,44,30,1537,701,836,209,187,129,58,0
49036,237,127,110,34,30,16,9,627,289,338,101,73,62,43,0
49037,1872,837,1035,280,338,169,80,180,95,85,22,21,17,8,0
49038,193,105,88,33,16,9,4,1279,669,610,164,162,104,55,0
49039,527,254,273,67,66,70,31,437,224,213,40,29,42,25,0
49040,328,195,133,36,23,35,9,418,223,195,53,43,49,15,0
49041,1098,519,579,182,159,79,42,1117,422,695,182,134,88,32,0
49042,772,417,355,118,92,80,23,111,60,51,17,23,10,7,0
49043,273,126,147,54,49,25,18,583,321,262,73,67,45,25,0
49044,291,131,160,49,35,32,15,299,140,159,49,44,26,11,0
49045,184,93,91,26,25,14,11,972,471,501,152,138,112,40,0
49046,373,194,179,42,54,26,13,368,183,185,40,42,40,15,0
49047,358,212,146,51,36,33,9,1378,692,686,194,174,105,56,0
49048,1835,904,931,192,144,135,63,105,51,54,13,17,12,8,0
49049,510,269,241,66,67,71,26,230,113,117,31,40,28,10,0
49050,126,56,70,31,10,10,3,978,536,442,132,107,67,32,0
49051,331,169,162,40,28,22,14,398,200,198,68,43,51,14,0
49052,1030,567,463,118,106,94,49,72,32,40,8,2,1,14,0
49053,1043,479,564,200,131,123,62,405,181,224,71,57,31,12,0
49054,494,233,261,87,57,46,18,88,50,38,13,8,16,4,0
49055,434,216,218,72,58,40,20,301,168,133,49,37,34,11,0
49056,580,240,340,108,81,59,22,1214,475,739,177,250,89,49,0
49057,258,130,128,44,37,29,10,187,89,98,36,24,20,6,0
49058,346,173,173,50,56,31,14,2517,1275,1242,304,324,245,135,0
49059,1085,646,439,108,65,36,19,294,146,148,50,45,51,15,0
49060,407,164,243,88,42,40,22,296,140,156,49,40,42,19,0
49061,1463,521,942,252,204,105,52,467,240,227,65,65,51,23,0
49062,331,165,166,52,34,48,22,583,321,262,73,67,45,25,0
49063,505,201,304,116,58,75,31,387,193,194,60,53,57,15,0
49064,412,146,266,106,38,67,35,307,132,175,48,53,26,10,0
49065,519,245,274,58,61,34,22,406,202,204,54,51,63,21,0
49066,288,140,148,59,33,27,12,547,295,252,81,65,57,23,0
49067,595,208,387,157,60,91,48,223,113,110,31,33,22,12,0
49068,457,228,229,64,36,52,21,231,126,105,37,26,29,6,0
49069,1052,492,560,184,163,103,44,395,169,226,73,55,38,9,0
49070,67,40,27,10,8,7,6,218,117,101,35,32,34,12,0
49071,351,166,185,48,61,24,15,715,345,370,110,97,64,25,0
49072,207,89,118,56,8,4,3,73,35,38,14,10,9,4,0
49073,172,82,90,21,35,21,5,501,240,261,80,62,49,42,0
49074,887,439,448,137,99,91,38,225,114,111,32,29,26,6,0
49075,374,187,187,51,52,40,27,1230,644,586,198,125,123,61,0
49076,341,154,187,34,36,11,11,103,59,44,25,2,13,6,0
49077,502,274,228,64,49,75,17,134,72,62,14,28,8,4,0
49078,960,409,551,166,134,77,44,518,292,226,60,60,52,21,0
49079,395,219,176,47,41,50,18,384,204,180,53,47,49,17,0
49080,589,282,307,68,67,70,23,519,287,232,68,58,45,21,0
49081,302,178,124,34,29,50,13,425,177,248,60,62,33,16,0
49082,478,220,258,47,70,41,10,858,461,397,125,114,79,45,0
49083,413,169,244,66,94,28,19,262,129,133,40,41,31,10,0
49084,164,81,83,37,8,14,10,278,154,124,42,32,38,7,0
49085,2663,1073,1590,548,499,192,64,518,292,226,60,60,52,21,0
49086,344,109,235,100,39,26,5,427,251,176,51,39,25,22,0
49087,320,163,157,44,44,26,15,2547,1280,1267,331,335,293,118,0
49088,414,216,198,51,32,42,28,334,181,153,56,31,28,18,0
49089,869,489,380,110,77,79,29,408,221,187,55,51,57,14,0
49090,1835,904,931,192,144,135,63,1698,875,823,222,219,173,64,0
49091,760,405,355,112,95,92,29,2724,1157,1567,269,518,239,77,0
49092,828,368,460,118,98,59,38,1543,794,749,182,152,132,55,0
49093,728,358,370,118,100,55,29,1395,627,768,172,263,141,59,0
49094,1096,563,533,158,136,120,53,947,482,465,143,107,89,37,0
49095,210,84,126,44,43,9,4,640,364,276,84,68,69,33,0
49096,130,72,58,28,9,7,1,963,455,508,127,130,115,48,0
49097,449,179,270,80,77,49,29,501,240,261,80,62,49,42,0
49098,435,230,205,51,37,55,18,630,321,309,86,90,57,26,0
49099,283,172,111,39,31,29,8,414,203,211,58,56,48,14,0
49100,313,148,165,45,33,36,11,276,149,127,34,31,32,10,0
49101,873,366,507,127,125,75,21,597,300,297,96,89,68,29,0
49102,474,250,224,58,47,37,12,403,225,178,56,38,33,25,0
49103,784,353,431,56,47,26,18,452,252,200,55,49,61,16,0
49104,531,260,271,97,68,47,11,314,151,163,42,61,39,16,0
49105,272,141,131,45,29,36,9,555,282,273,82,69,65,21,0
49106,489,253,236,73,36,62,17,225,111,114,32,34,32,16,0
49107,649,304,345,99,80,67,40,418,223,195,51,45,49,14,0
49108,733,382,351,126,92,93,27,405,195,210,57,74,24,17,0
49109,496,272,224,70,58,42,18,498,244,254,81,67,58,19,0
49110,322,164,158,46,44,29,7,619,305,314,85,93,71,29,0
49111,328,195,133,36,23,35,9,736,388,348,88,85,67,28,0
49112,330,182,148,47,27,40,11,452,254,198,72,57,38,18,0
49113,407,207,200,53,36,38,8,283,160,123,25,20,37,9,0
49114,288,142,146,52,32,26,8,449,252,197,61,52,36,18,0
49115,803,358,445,135,117,80,43,137,72,65,27,13,15,8,0
49116,567,266,301,139,46,76,37,301,168,133,49,37,34,11,0
49117,798,287,511,126,125,77,26,144,67,77,28,14,9,8,0
49118,260,120,140,34,39,36,12,545,269,276,80,76,27,32,0
49119,450,241,209,67,58,54,23,364,192,172,49,36,39,14,0
49120,1447,698,749,214,180,116,46,437,224,213,40,29,42,25,0
49121,163,70,93,28,21,17,6,260,133,127,43,32,39,3,0
49122,1112,457,655,180,164,99,39,629,317,312,80,87,51,22,0
49123,270,128,142,36,43,15,11,508,261,247,65,53,58,23,0
49124,452,202,250,83,60,56,19,439,231,208,65,51,55,17,0
49125,498,274,224,58,59,50,18,508,261,247,65,53,58,23,0
49126,421,237,184,47,54,45,10,218,117,101,35,32,34,12,0
49127,793,355,438,134,117,77,43,276,149,127,34,31,32,10,0
49128,414,195,219,51,60,40,17,234,129,105,31,22,19,17,0
49129,2062,706,1356,414,368,158,63,798,385,413,120,115,79,30,0
49130,179,96,83,24,8,26,4,598,333,265,79,66,54,33,0
49131,350,190,160,48,25,27,18,222,122,100,39,32,24,9,0
49132,246,123,123,40,31,27,7,1922,923,999,267,275,215,90,0
49133,2488,1085,1403,346,253,162,76,247,128,119,34,14,16,14,0
49134,417,176,241,75,61,51,20,758,319,439,101,123,78,25,0
49135,531,259,272,75,81,39,13,277,144,133,42,30,41,8,0
49136,298,141,157,51,33,21,22,135,57,78,21,20,9,11,0
49137,949,467,482,126,127,102,51,225,129,96,32,33,20,8,0
49138,500,297,203,66,33,53,15,198,110,88,27,27,24,4,0
49139,502,274,228,64,49,75,17,487,252,235,79,58,55,26,0
49140,300,136,164,45,35,45,14,1279,669,610,164,162,104,55,0
49141,489,253,236,73,36,62,17,234,129,105,31,22,19,17,0
49142,957,381,576,184,158,86,48,758,361,397,114,107,51,19,0
49143,210,84,126,44,43,9,4,326,149,177,51,51,28,10,0
49144,560,279,281,113,64,58,15,188,101,87,20,18,20,14,0
49145,456,214,242,76,62,52,22,373,189,184,54,46,50,23,0
49146,435,225,210,58,46,50,14,178,99,79,31,19,26,8,0
49147,1360,644,716,213,194,136,62,132,61,71,19,20,14,6,0
49148,579,281,298,91,78,74,27,654,295,359,99,88,71,25,0
49149,4640,2231,2409,660,549,437,245,1537,701,836,209,187,129,58,0
49150,126,58,68,31,10,10,3,102,51,51,12,15,12,3,0
49151,374,187,187,51,52,40,27,330,166,164,55,51,36,16,0
49152,245,111,134,36,27,18,6,501,257,244,75,57,48,29,0
49153,181,75,106,35,26,11,9,314,177,137,34,40,29,9,0
49154,570,238,332,112,95,39,23,231,126,105,37,26,29,6,0
49155,911,445,466,154,121,108,48,429,187,242,79,72,28,19,0
49156,315,111,204,82,66,46,11,501,249,252,77,70,55,22,0
49157,505,282,223,60,57,66,23,419,233,186,54,53,55,17,0
49158,493,208,285,75,77,70,40,326,149,177,51,51,28,10,0
49159,1214,498,716,197,180,121,65,481,223,258,71,70,49,26,0
49160,445,231,214,45,64,53,23,515,276,239,62,59,43,31,0
49161,238,158,80,28,15,31,7,129,60,69,21,15,8,5,0
49162,556,306,250,69,60,80,18,665,361,304,87,91,84,31,0
49163,538,263,275,71,85,44,18,108,59,49,17,13,12,5,0
49164,237,127,110,34,30,16,9,138,69,69,28,7,10,10,0
49165,376,171,205,45,45,34,12,536,267,269,60,70,41,22,0
49166,401,236,165,53,38,34,9,328,199,129,39,29,27,14,0
49167,859,411,448,118,100,95,49,704,355,349,113,94,71,24,0
49168,692,305,387,100,97,78,30,434,213,221,77,62,53,12,0
49169,543,265,278,52,37,54,19,207,113,94,33,18,30,9,0
49170,486,243,243,65,48,63,22,189,105,84,25,26,21,9,0
49171,654,344,310,80,69,57,15,111,60,51,17,23,10,7,0
49172,1041,497,544,180,167,98,34,561,279,282,85,81,88,24,0
49173,340,169,171,40,39,36,22,720,357,363,113,85,62,39,0
49174,384,198,186,58,48,37,12,277,124,153,44,40,35,18,0
49175,318,164,154,52,43,34,10,547,295,252,81,65,57,23,0
49176,300,136,164,45,35,45,14,858,398,460,126,138,75,39,0
49177,332,170,162,44,38,39,10,549,273,276,74,68,72,24,0
49178,330,151,179,68,36,56,9,326,169,157,51,41,41,12,0
49179,325,186,139,49,36,20,5,188,101,87,20,18,20,14,0
49180,441,216,225,57,66,57,19,279,142,137,43,39,28,7,0
49181,577,251,326,92,84,60,11,337,152,185,49,54,42,21,0
49182,275,125,150,37,48,27,7,548,296,252,71,74,43,28,0
49183,1336,724,612,209,141,133,60,395,169,226,73,55,38,9,0
49184,1390,705,685,219,164,129,74,88,50,38,13,8,16,4,0
49185,763,354,409,101,90,63,26,132,61,71,19,20,14,6,0
49186,1711,865,846,204,176,105,60,663,360,303,87,82,80,35,0
49187,126,56,70,31,10,10,3,704,355,349,113,94,71,24,0
49188,927,457,470,130,99,118,42,2225,1244,981,271,243,217,93,0
49189,533,300,233,74,50,74,17,978,536,442,132,107,67,32,0
49190,305,124,181,27,25,32,21,547,295,252,81,65,57,23,0
49191,435,230,205,51,37,55,18,305,163,142,38,27,47,11,0
49192,1221,597,624,201,152,83,31,137,72,65,27,13,15,8,0
49193,539,283,256,75,73,53,26,496,285,211,62,54,46,22,0
49194,421,237,184,47,54,45,10,556,290,266,75,74,29,24,0
49195,336,134,202,51,64,27,12,144,67,77,28,14,9,8,0
49196,177,100,77,22,17,20,11,972,501,471,125,156,106,39,0
49197,952,547,405,95,90,127,35,385,212,173,57,40,39,21,0
49198,242,111,131,35,35,17,13,761,351,410,117,73,103,45,0
49199,671,327,344,110,95,91,41,536,278,258,72,63,62,20,0
49200,440,267,173,52,29,42,12,526,266,260,76,75,53,22,0
49201,462,233,229,66,49,43,30,904,436,468,143,118,108,32,0
49202,722,390,332,125,69,67,25,545,269,276,80,76,27,32,0
49203,1689,821,868,277,250,177,78,792,398,394,109,96,90,39,0
49204,1210,592,618,157,138,116,85,665,297,368,111,107,34,12,0
49205,488,237,251,79,78,65,27,1241,619,622,183,169,155,59,0
49206,316,157,159,45,38,22,19,163,79,84,22,24,13,5,0
49207,51,10,41,25,0,5,8,556,290,266,75,74,29,24,0
49208,207,93,114,20,33,19,10,463,268,195,59,46,46,21,0
49209,496,274,222,57,43,75,22,621,310,311,100,106,77,27,0
49210,687,351,336,106,67,70,41,91,42,49,21,9,8,3,0
49211,71,39,32,7,11,6,4,127,66,61,13,14,19,8,0
49212,795,384,411,133,109,85,38,344,190,154,34,31,36,10,0
49213,406,207,199,56,46,68,19,354,188,166,46,40,34,10,0
49214,531,260,271,97,68,47,11,108,59,49,17,13,12,5,0
49215,126,66,60,24,10,7,9,2202,1121,1081,338,274,269,81,0
49216,418,163,255,57,54,38,24,434,213,221,77,62,53,12,0
49217,393,223,170,44,36,32,14,406,234,172,63,35,43,10,0
49218,130,71,59,30,9,8,1,89,51,38,15,15,5,4,0
49219,395,189,206,63,50,49,28,397,223,174,50,39,29,17,0
49220,828,355,473,126,134,77,37,975,475,500,139,140,119,28,0
49221,122,56,66,26,13,11,5,975,400,575,160,162,62,31,0
49222,1186,495,691,182,208,88,32,690,345,345,96,83,73,42,0
49223,215,104,111,61,7,2,1,108,59,49,17,13,12,5,0
49224,318,161,157,53,51,32,13,229,120,109,31,30,22,9,0
49225,108,51,57,16,12,16,11,1140,586,554,130,146,117,49,0
49226,977,462,515,185,119,76,12,1040,564,476,134,110,114,51,0
49227,219,116,103,66,7,2,1,346,178,168,58,41,33,12,0
49228,272,173,99,32,32,11,8,160,67,93,32,37,15,9,0
49229,603,311,292,102,71,66,23,393,210,183,58,37,34,20,0
49230,505,226,279,68,51,30,15,866,397,469,117,153,95,48,0
49231,226,120,106,68,8,2,1,192,110,82,33,21,10,3,0
49232,510,269,241,66,67,71,26,405,214,191,53,42,49,20,0
49233,562,214,348,120,86,69,42,501,240,261,80,62,49,42,0
49234,828,368,460,118,98,59,38,1248,584,664,184,164,155,67,0
49235,650,330,320,97,77,65,28,387,193,194,60,53,57,15,0
49236,380,187,193,38,51,30,18,551,226,325,96,103,43,11,0
49237,650,330,320,97,77,65,28,1001,417,584,186,147,96,47,0
49238,785,351,434,136,93,71,37,204,80,124,29,51,10,5,0
49239,1616,735,881,285,248,153,72,320,168,152,38,42,24,18,0
49240,485,237,248,83,35,52,24,602,310,292,87,66,70,36,0
49241,616,304,312,75,71,55,25,349,200,149,41,39,30,20,0
49242,126,56,70,31,10,10,3,390,223,167,58,36,45,18,0
49243,326,148,178,55,42,31,12,153,80,73,26,18,19,4,0
49244,2446,1099,1347,363,294,233,100,135,57,78,21,20,9,11,0
49245,364,172,192,55,57,32,15,403,233,170,38,29,21,14,0
49246,483,236,247,82,60,43,18,258,129,129,45,24,31,10,0
49247,556,306,250,69,60,80,18,293,142,151,49,40,42,17,0
49248,329,168,161,48,34,41,16,673,313,360,102,101,46,17,0
49249,211,92,119,33,44,11,7,715,345,370,110,97,64,25,0
49250,508,267,241,43,35,25,17,297,175,122,46,30,31,6,0
49251,335,171,164,51,38,38,10,457,245,212,62,58,57,21,0
49252,1417,598,819,223,188,135,58,242,121,121,39,30,29,10,0
49253,472,222,250,46,61,33,23,536,251,285,75,79,60,23,0
49254,463,225,238,76,36,59,26,469,225,244,64,68,25,11,0
49255,681,367,314,83,74,78,31,518,292,226,60,60,52,21,0
49256,512,254,258,70,48,37,32,963,455,508,127,130,115,48,0
49257,338,172,166,59,30,39,18,245,121,124,37,35,36,12,0
49258,358,206,152,45,38,67,16,194,94,100,33,28,14,7,0
49259,458,226,232,77,59,61,14,149,52,97,36,36,7,4,0
49260,130,71,59,30,9,8,1,198,115,83,30,22,8,8,0
49261,1171,542,629,170,146,114,64,417,232,185,58,50,29,21,0
49262,525,302,223,56,48,67,19,266,146,120,41,28,31,7,0
49263,282,160,122,36,28,27,7,778,391,387,94,77,41,33,0
49264,493,281,212,56,61,30,13,317,161,156,50,36,47,12,0
49265,589,282,307,68,67,70,23,481,223,258,71,70,49,26,0
49266,415,217,198,50,31,42,17,368,200,168,54,49,43,9,0
49267,252,121,131,42,34,12,16,457,242,215,39,46,53,10,0
49268,193,110,83,18,20,15,12,1025,549,476,118,109,88,61,0
49269,365,222,143,44,24,35,11,415,203,212,77,44,49,18,0
49270,666,204,462,110,194,42,14,504,272,232,75,57,53,19,0
49271,313,158,155,43,35,43,16,314,151,163,42,61,39,16,0
49272,484,192,292,118,68,83,22,397,223,174,50,39,29,17,0
49273,117,57,60,17,14,11,10,621,310,311,100,106,77,27,0
49274,302,178,124,34,29,50,13,147,74,73,28,20,24,4,0
49275,288,140,148,59,33,27,12,423,234,189,66,44,57,12,0
49276,546,285,261,71,49,47,24,1239,659,580,169,148,131,54,0
49277,496,209,287,113,55,72,14,173,86,87,30,22,19,12,0
49278,1362,633,729,220,150,93,43,261,130,131,27,41,19,16,0
49279,1501,679,822,251,196,174,67,277,124,153,44,40,35,18,0
49280,480,232,248,73,40,44,30,517,295,222,69,62,40,28,0
49281,531,284,247,66,42,49,15,101,59,42,11,17,10,1,0
49282,425,220,205,60,55,45,18,303,137,166,54,54,31,15,0
49283,404,197,207,60,48,47,20,295,156,139,41,40,42,15,0
49284,1087,523,564,146,177,103,33,520,244,276,91,60,68,20,0
49285,446,195,251,56,53,31,15,172,79,93,34,27,23,10,0
49286,365,210,155,46,30,24,12,223,113,110,31,33,22,12,0
49287,474,243,231,66,54,41,29,928,440,488,111,157,82,35,0
49288,439,211,228,65,73,26,21,275,155,120,37,31,16,14,0
49289,717,381,336,118,103,85,29,963,455,508,127,130,115,48,0
49290,1499,864,635,141,99,76,110,54,26,28,11,4,3,3,0
49291,213,104,109,56,14,9,2,1543,794,749,182,152,132,55,0
49292,492,253,239,73,67,77,29,524,300,223,70,54,51,25,0
49293,240,98,142,49,42,23,17,166,90,76,27,18,21,5,0
49294,136,66,70,33,11,9,4,661,325,336,81,75,65,28,0
49295,328,156,172,44,37,44,15,192,91,101,29,28,17,7,0
49296,478,177,301,109,66,59,25,1249,638,611,166,153,141,45,0
49297,202,103,99,28,20,12,8,130,67,63,24,10,12,4,0
49298,136,66,70,33,11,9,3,278,154,124,42,32,38,7,0
49299,471,221,250,87,68,42,25,818,357,461,122,136,54,25,0
49300,886,440,446,116,140,95,45,1755,905,850,214,196,183,79,0
49301,856,429,427,113,105,96,24,514,262,252,78,58,54,26,0
49302,631,304,327,98,75,52,23,526,266,260,76,75,53,22,0
49303,279,127,152,50,36,28,8,270,130,140,48,44,37,12,0
49304,350,178,172,49,62,29,16,220,107,113,36,35,28,9,0
49305,3859,2011,1848,535,391,422,207,498,244,254,81,67,58,19,0
49306,346,209,137,46,37,44,10,474,268,206,66,42,45,24,0
49307,595,339,256,64,36,54,24,518,292,226,60,60,52,21,0
49308,565,264,301,101,73,72,15,323,171,152,48,41,40,16,0
49309,365,148,217,86,37,51,28,1230,644,586,198,125,123,61,0
49310,365,210,155,46,30,24,12,374,181,193,55,58,48,23,0
49311,129,70,59,29,9,7,2,246,125,121,38,36,30,11,0
49312,509,246,263,84,71,56,22,418,246,172,52,39,57,10,0
49313,666,204,462,110,194,42,14,620,324,296,81,68,66,31,0
49314,395,195,200,41,55,23,10,354,183,171,54,43,49,8,0
49315,496,210,286,112,55,72,13,267,141,126,53,27,23,7,0
49316,343,162,181,65,38,29,12,843,391,452,139,104,91,35,0
49317,911,489,422,121,98,97,36,481,223,258,71,70,49,26,0
49318,552,295,257,67,49,70,30,583,321,262,73,67,45,25,0
49319,117,58,59,17,17,12,2,346,178,168,58,41,33,12,0
49320,510,264,246,67,66,38,29,1117,422,695,182,134,88,32,0
49321,330,141,189,65,29,51,19,4646,2328,2318,674,639,475,170,0
49322,127,48,79,27,20,6,5,87,38,49,23,10,10,9,0
49323,624,222,402,92,81,39,15,467,231,236,71,65,58,18,0
49324,161,94,67,23,13,8,10,556,290,266,75,74,29,24,0
49325,126,58,68,31,10,10,3,266,146,120,41,28,31,7,0
49326,557,250,307,70,47,51,22,308,146,162,42,39,24,12,0
49327,199,113,86,27,17,10,7,138,69,69,28,7,10,10,0
49328,347,181,166,27,20,12,12,403,221,182,62,50,42,12,0
49329,181,92,89,34,22,17,9,447,212,235,86,55,58,21,0
49330,372,189,183,60,44,41,18,408,221,187,55,51,57,14,0
49331,760,322,438,81,130,57,19,218,114,104,32,31,33,11,0
49332,1327,520,807,241,174,141,60,609,335,274,79,57,45,22,0
49333,338,172,166,59,30,39,18,862,409,453,149,125,86,29,0
49334,600,324,276,89,73,45,39,453,255,198,62,49,29,19,0
49335,186,56,130,46,50,16,7,461,223,238,45,62,18,35,0
49336,240,167,73,32,12,8,21,381,196,185,55,57,43,16,0
49337,2442,1193,1249,278,183,170,145,220,107,113,36,35,28,9,0
49338,213,113,100,26,21,26,12,390,223,167,58,36,45,18,0
49339,532,291,241,83,36,79,25,265,134,131,48,34,33,15,0
49340,410,200,210,60,54,46,19,536,251,285,75,79,60,23,0
49341,411,236,175,39,45,50,30,305,161,144,39,40,44,17,0
49342,1105,544,561,165,167,99,40,258,129,129,45,24,31,10,0
49343,207,128,79,26,17,19,9,330,166,164,55,51,36,16,0
49344,350,190,160,48,25,27,18,277,163,114,33,24,21,16,0
49345,588,267,321,99,79,87,28,289,140,149,33,42,30,15,0
49346,580,240,340,108,81,59,22,199,105,94,27,27,28,9,0
49347,1849,931,918,245,220,158,90,232,111,121,23,29,17,9,0
49348,432,233,199,52,28,47,18,1314,693,621,174,155,140,58,0
49349,412,203,209,65,47,37,18,127,64,63,26,8,12,8,0
49350,508,136,372,157,91,22,9,496,251,245,78,62,61,23,0
49351,798,364,434,133,88,74,35,201,104,97,36,32,24,7,0
49352,244,104,140,52,31,30,14,555,282,273,82,69,65,21,0
49353,341,177,164,57,42,40,18,2547,1280,1267,331,335,293,118,0
49354,717,381,336,118,103,85,29,332,155,177,55,51,44,13,0
49355,627,237,390,137,57,108,44,338,169,169,53,44,39,21,0
49356,160,67,93,32,37,15,9,275,155,120,37,31,16,14,0
49357,391,165,226,67,64,36,27,715,345,370,110,97,64,25,0
49358,756,362,394,102,104,73,25,689,343,346,105,102,81,35,0
49359,166,59,107,36,41,10,4,270,130,140,48,44,37,12,0
49360,300,136,164,45,35,45,14,508,253,255,73,60,50,13,0
49361,426,231,195,51,52,45,24,179,101,78,25,15,13,13,0
49362,202,103,99,28,20,12,8,607,293,314,98,71,62,32,0
49363,251,139,112,41,18,27,11,497,257,240,71,63,62,16,0
49364,977,462,515,185,119,76,12,374,212,162,48,40,32,23,0
49365,607,294,313,94,95,62,14,308,129,179,44,60,19,8,0
49366,127,62,65,13,33,7,6,455,191,264,68,86,21,19,0
49367,176,74,102,20,29,7,7,68,23,45,12,9,3,9,0
49368,412,208,204,54,47,42,17,515,276,239,62,59,43,31,0
49369,743,377,366,87,74,68,30,72,34,38,8,2,3,12,0
49370,961,465,496,139,156,62,34,622,344,278,80,77,68,36,0
49371,305,124,181,27,25,31,21,285,143,142,45,32,21,17,0
49372,215,117,98,28,19,15,8,501,257,244,75,57,48,29,0
49373,369,207,162,67,35,16,14,215,115,100,27,19,16,7,0
49374,431,199,232,59,54,40,17,164,79,85,28,28,16,7,0
49375,447,236,211,56,52,49,14,549,273,276,74,68,72,24,0
49376,519,245,274,58,61,34,22,239,113,126,36,49,20,8,0
49377,605,277,328,99,54,63,43,337,152,185,49,54,42,21,0
49378,164,81,83,37,8,14,10,1182,591,591,155,139,83,46,0
49379,462,233,229,66,49,43,30,225,129,96,32,33,20,8,0
49380,1107,601,506,155,138,103,49,462,251,211,74,53,41,18,0
49381,107,36,71,27,15,0,1,171,94,77,24,28,30,11,0
49382,204,103,101,16,32,22,8,270,130,140,48,44,37,12,0
49383,781,367,414,60,67,43,17,374,212,162,48,40,32,23,0
49384,1849,931,918,245,220,158,90,665,361,304,87,91,84,31,0
49385,164,77,87,33,19,6,7,65,32,33,16,4,8,3,0
49386,150,64,86,22,12,29,12,89,37,52,13,6,2,9,0
49387,270,131,139,47,37,41,11,662,312,350,103,104,59,20,0
49388,619,289,330,67,77,36,19,601,278,323,124,87,65,21,0
49389,245,111,134,36,27,18,6,1061,543,518,146,123,109,67,0
49390,575,295,280,89,68,54,18,2547,1280,1267,331,335,293,118,0
49391,887,439,448,137,99,91,38,296,151,145,45,42,32,11,0
49392,414,206,208,56,68,35,19,662,373,289,89,80,77,29,0
49393,361,171,190,44,40,18,13,212,127,85,28,21,26,6,0
49394,666,204,462,110,194,42,14,463,259,204,62,55,34,22,0
49395,2062,706,1356,414,368,158,63,354,188,166,46,40,34,10,0
49396,2285,1219,1066,207,180,178,106,627,289,338,101,73,62,43,0
49397,164,81,83,37,8,14,10,136,65,71,26,11,7,5,0
49398,215,117,98,28,19,15,8,166,88,78,23,18,13,7,0
49399,364,172,192,55,57,32,15,904,436,468,143,118,108,32,0
49400,1023,449,574,141,174,76,43,200,89,111,26,25,17,7,0
49401,238,158,80,28,15,31,7,621,310,311,100,106,77,27,0
49402,852,472,380,99,79,70,27,266,150,116,28,28,24,12,0
49403,956,450,506,122,117,82,36,496,251,245,78,62,61,23,0
49404,228,82,146,45,37,18,8,396,223,173,57,37,44,19,0
49405,1041,497,544,180,167,98,34,966,478,488,108,144,74,43,0
49406,431,245,186,50,23,46,17,331,180,151,46,35,47,17,0
49407,345,208,137,44,27,33,8,188,93,95,33,18,16,10,0
49408,798,364,434,133,88,74,35,257,139,118,64,17,24,7,0
49409,915,336,579,185,199,56,29,160,76,84,19,24,8,5,0
49410,332,170,162,44,38,39,10,204,80,124,29,51,10,5,0
49411,330,151,179,68,36,56,9,323,162,161,52,41,39,13,0
49412,1004,464,540,143,104,78,55,497,257,240,71,63,62,16,0
49413,900,434,466,134,97,86,36,276,149,127,34,31,32,10,0
49414,299,151,148,35,34,26,16,792,398,394,109,96,90,39,0
49415,331,165,166,52,34,48,22,906,455,451,116,105,87,46,0
49416,502,229,273,63,66,40,31,89,37,52,13,6,2,9,0
49417,347,181,166,27,20,12,12,179,101,78,25,15,13,13,0
49418,233,107,126,40,40,20,16,1113,480,633,170,173,81,34,0
49419,682,292,390,89,69,58,20,406,234,172,63,35,43,10,0
49420,304,149,155,46,32,39,14,758,319,439,101,123,78,25,0
49421,119,59,60,29,10,6,4,326,169,157,51,41,41,12,0
49422,341,175,166,48,43,35,18,89,51,38,15,15,5,4,0
49423,1417,598,819,223,188,135,58,165,90,75,36,18,20,6,0
49424,373,194,179,42,54,26,13,424,179,245,65,67,29,11,0
49425,342,185,157,42,27,31,14,1114,539,575,145,131,94,56,0
49426,852,472,380,99,79,70,27,101,59,42,11,17,10,1,0
49427,553,319,234,56,37,54,18,417,232,185,58,50,29,21,0
49428,584,297,287,89,80,65,17,68,23,45,12,9,3,9,0
49429,437,230,207,41,55,27,13,452,254,198,72,57,38,18,0
49430,103,56,47,27,7,8,2,94,45,49,11,20,10,4,0
49431,2136,1063,1073,317,308,223,90,406,234,172,63,35,43,10,0
49432,800,416,384,102,105,83,22,1004,457,547,150,150,74,52,0
49433,327,174,153,42,35,16,12,389,210,179,51,37,43,9,0
49434,595,208,387,157,60,91,48,536,251,285,75,79,60,23,0
49435,329,171,158,49,41,31,10,975,400,575,160,162,62,31,0
49436,574,269,305,91,63,54,27,423,234,189,66,44,57,12,0
49437,413,169,244,66,94,28,19,103,59,44,25,2,13,6,0
49438,361,177,184,59,51,24,15,367,218,149,45,43,42,16,0
49439,927,457,470,130,99,118,42,166,78,88,27,25,19,7,0
49440,532,254,278,91,48,23,17,457,245,212,62,58,57,21,0
49441,361,177,184,59,51,24,15,270,162,108,26,26,16,11,0
49442,519,259,260,86,78,59,22,223,113,110,31,33,22,12,0
49443,301,119,182,53,47,14,20,136,65,71,26,11,7,5,0
49444,786,378,408,106,98,77,39,175,91,84,19,21,21,10,0
49445,1161,514,647,159,138,122,37,556,290,266,75,74,29,24,0
49446,403,176,227,71,56,51,11,630,321,309,86,90,57,26,0
49447,959,496,463,144,132,75,35,1114,539,575,145,131,94,56,0
49448,928,442,486,139,118,91,43,257,126,131,61,24,22,8,0
49449,227,120,107,31,28,28,13,810,310,500,164,162,42,26,0
49450,629,374,255,74,53,87,27,1500,804,696,190,172,144,60,0
49451,431,216,215,46,40,33,9,396,213,183,68,44,47,18,0
49452,136,65,71,33,11,9,6,201,93,108,34,39,21,6,0
49453,257,132,125,39,27,26,10,312,165,147,41,39,29,16,0
49454,508,251,257,74,53,51,18,535,288,247,79,72,35,21,0
49455,781,367,414,60,67,43,17,278,154,124,42,32,38,7,0
49456,311,154,157,47,29,34,13,305,161,144,39,40,44,17,0
49457,1336,724,612,209,141,133,60,1154,489,665,200,196,95,54,0
49458,794,322,472,122,108,79,34,213,129,84,32,14,21,15,0
49459,465,240,225,50,54,24,14,212,127,85,28,21,26,6,0
49460,929,410,519,187,146,53,30,535,311,224,66,52,49,24,0
49461,1544,738,806,239,217,145,91,360,185,175,51,43,36,16,0
49462,952,547,405,95,90,127,35,1755,905,850,214,196,183,79,0
49463,332,172,160,50,33,35,9,279,161,118,37,32,7,7,0
49464,136,66,70,33,11,9,4,239,113,126,36,49,20,8,0
49465,308,129,179,44,60,19,8,94,45,49,11,20,10,4,0
49466,446,174,272,84,61,57,23,308,129,179,44,60,19,8,0
49467,512,254,258,70,48,37,32,172,79,93,34,27,23,10,0
49468,246,123,123,40,31,27,7,136,65,71,26,11,7,5,0
49469,648,376,272,70,60,73,24,367,218,149,45,43,42,16,0
49470,1912,880,1032,331,334,180,84,430,212,218,88,43,40,20,0
49471,553,319,234,56,37,54,18,277,152,125,31,35,22,19,0
49472,320,183,137,51,18,38,8,1214,475,739,177,250,89,49,0
49473,500,245,255,66,57,52,27,374,181,193,55,58,48,23,0
49474,271,110,161,33,27,11,8,508,262,246,66,67,51,20,0
49475,342,150,192,52,43,31,17,164,79,85,28,28,16,7,0
49476,127,55,72,25,18,5,7,621,273,348,104,102,48,19,0
49477,2279,996,1283,375,328,158,60,127,58,69,18,17,10,5,0
49478,824,391,433,106,90,88,32,517,295,222,69,62,40,28,0
49479,929,410,519,187,146,53,30,323,168,155,51,41,38,12,0
49480,1163,417,746,209,145,87,28,373,189,184,54,46,50,23,0
49481,419,210,209,54,44,31,23,467,231,236,71,65,58,18,0
49482,128,69,59,29,9,8,1,392,186,206,62,56,29,15,0
49483,631,304,327,98,75,52,23,783,406,377,102,91,57,29,0
49484,822,416,406,111,97,88,42,166,102,64,19,14,17,2,0
49485,227,120,107,31,28,28,13,778,391,387,94,77,41,33,0
49486,156,64,92,31,19,5,4,142,65,77,30,17,22,9,0
49487,207,93,114,20,33,19,10,375,210,165,49,37,29,27,0
49488,900,434,466,134,97,86,36,314,177,137,34,40,29,9,0
49489,4640,2231,2409,660,549,437,245,132,61,71,22,21,15,3,0
49490,687,351,336,106,67,70,41,373,189,184,54,46,50,23,0
49491,245,111,134,31,44,20,11,480,234,246,79,77,65,23,0
49492,146,75,71,13,32,15,11,160,60,100,23,40,19,11,0
49493,346,186,160,40,37,34,21,665,361,304,87,91,84,31,0
49494,396,150,246,103,64,38,3,690,345,345,96,83,73,42,0
49495,422,196,226,52,35,33,20,402,186,216,64,47,38,20,0
49496,1464,693,771,153,136,91,86,1004,457,547,150,150,74,52,0
49497,505,247,258,72,71,60,27,621,310,311,100,106,77,27,0
49498,406,207,199,56,46,68,19,906,455,451,116,105,87,46,0
49499,136,66,70,33,11,9,4,309,159,150,47,43,43,13,0
49500,199,107,92,41,15,14,8,514,262,252,78,58,54,26,0
49501,207,128,79,26,17,19,9,305,163,142,38,27,47,11,0
49502,557,211,346,129,125,48,19,453,247,206,58,53,45,20,0
49503,979,534,445,83,77,80,24,215,115,100,27,19,16,7,0
49504,470,163,307,99,68,73,30,334,182,152,45,41,27,13,0
49505,540,252,288,73,67,57,20,404,190,214,55,55,35,27,0
49506,224,108,116,33,26,32,10,270,130,140,48,44,37,12,0
49507,860,348,512,121,136,75,35,297,164,133,45,39,40,9,0
49508,502,250,252,70,47,57,15,2202,1121,1081,338,274,269,81,0
49509,369,166,203,59,55,41,14,374,181,193,55,58,48,23,0
49510,186,56,130,46,50,16,7,483,287,196,71,50,54,17,0
49511,407,230,177,44,39,34,19,102,51,51,12,15,12,3,0
49512,477,300,177,53,35,45,24,427,164,263,61,80,14,10,0
49513,496,272,224,70,58,42,18,390,223,167,58,36,45,18,0
49514,627,237,390,137,57,108,44,152,71,81,41,16,14,2,0
49515,92,46,46,14,9,8,6,89,42,47,16,12,15,6,0
49516,126,57,69,31,10,10,3,2038,1059,979,262,237,208,100,0
49517,130,70,60,30,9,8,1,179,101,78,25,15,13,13,0
49518,344,109,235,100,39,26,5,373,189,184,54,46,50,23,0
49519,342,185,157,42,27,31,14,892,475,417,130,108,68,38,0
49520,2279,996,1283,375,328,158,60,200,99,101,31,24,26,6,0
49521,1365,590,775,257,168,136,93,508,262,246,66,67,51,20,0
49522,407,230,177,44,39,34,19,261,127,134,36,27,36,4,0
49523,347,212,135,35,32,17,6,129,60,69,21,15,8,5,0
49524,169,64,105,23,37,11,3,398,200,198,68,43,51,14,0
49525,833,295,538,146,139,65,34,452,254,198,72,57,38,18,0
49526,193,107,86,13,20,13,6,723,353,370,120,109,96,33,0
49527,288,140,148,59,33,27,12,536,267,269,60,70,41,22,0
49528,207,128,79,26,17,19,9,664,350,314,86,90,82,36,0
49529,575,290,285,67,70,28,9,1338,720,618,179,145,141,85,0
49530,424,198,226,57,46,41,19,586,309,277,81,64,76,25,0
49531,271,110,161,33,27,11,8,452,231,221,74,53,56,20,0
49532,369,207,162,67,35,16,14,662,312,350,103,104,59,20,0
49533,202,86,116,33,29,26,10,520,300,220,66,36,57,23,0
49534,280,156,124,36,19,20,13,405,181,224,71,57,31,12,0
49535,297,182,115,41,22,23,8,175,82,93,33,26,17,5,0
49536,406,208,198,41,26,43,21,1025,549,476,118,109,88,61,0
49537,820,333,487,202,152,59,23,396,199,197,54,50,45,14,0
49538,359,198,161,51,28,54,13,259,151,108,39,18,23,11,0
49539,1441,504,937,264,329,69,46,376,183,193,50,50,43,21,0
49540,730,298,432,128,69,86,26,295,160,135,44,36,46,16,0
49541,345,208,137,44,27,33,8,326,169,157,51,41,41,12,0
49542,463,225,238,76,36,59,26,462,251,211,74,53,41,18,0
49543,313,148,165,45,33,36,11,301,168,133,49,37,34,11,0
49544,164,61,103,47,19,14,5,279,161,118,37,32,7,7,0
49545,522,302,220,61,49,75,19,54,26,28,11,4,3,3,0
49546,139,81,58,17,14,24,9,462,251,211,74,53,41,18,0
49547,1054,497,557,190,168,107,45,798,385,413,120,115,79,30,0
49548,220,113,107,37,24,16,7,153,65,88,28,21,20,8,0
49549,820,333,487,202,152,59,23,373,189,184,54,46,50,23,0
49550,362,181,181,67,46,43,8,245,131,114,30,27,18,13,0
49551,595,208,387,157,60,91,48,723,363,360,107,106,52,14,0
49552,465,220,245,88,34,61,23,483,258,225,70,53,54,20,0
49553,533,297,236,74,57,39,28,149,77,72,37,10,20,5,0
49554,457,261,196,55,27,57,34,260,133,127,43,32,39,3,0
49555,313,134,179,58,37,43,19,975,400,575,160,162,62,31,0
49556,258,130,128,44,37,29,10,332,180,152,44,36,27,13,0
49557,323,156,167,52,45,39,18,524,300,223,70,54,51,25,0
49558,221,75,146,68,21,16,5,295,160,135,44,36,46,16,0
49559,67,40,27,10,8,7,6,326,169,157,51,41,41,12,0
49560,117,57,60,17,14,11,10,285,143,142,45,32,21,17,0
49561,763,354,409,101,90,63,26,1873,935,938,233,225,203,79,0
49562,425,199,226,54,71,56,11,192,110,82,33,21,10,3,0
49563,136,66,70,33,11,9,4,699,334,365,108,80,70,20,0
49564,1214,612,602,169,173,98,35,173,94,79,18,24,12,7,0
49565,600,324,276,89,73,45,39,172,88,84,24,31,20,12,0
49566,584,297,287,89,80,65,17,811,361,450,124,107,80,31,0
49567,585,277,308,92,73,61,32,334,182,152,45,41,27,13,0
49568,313,178,135,43,18,35,6,305,163,142,38,27,47,11,0
49569,1023,449,574,141,174,76,43,963,525,438,119,102,102,34,0
49570,338,164,174,45,32,37,13,289,140,149,33,42,30,15,0
49571,413,169,244,66,94,28,19,439,227,212,60,55,58,8,0
49572,432,190,242,85,82,28,11,406,223,183,61,53,46,17,0
49573,347,212,135,35,32,17,6,267,141,126,53,27,23,7,0
49574,416,222,194,58,38,38,20,104,46,58,15,17,9,5,0
49575,435,222,213,67,49,67,12,108,59,49,17,13,12,5,0
49576,928,442,486,139,118,91,43,178,69,109,29,25,21,13,0
49577,574,269,305,91,63,54,27,338,169,169,53,44,39,21,0
49578,299,128,171,57,40,13,25,225,129,96,32,33,20,8,0
49579,164,61,103,47,19,14,5,201,117,83,22,21,19,9,0
49580,375,201,174,52,56,39,15,283,142,141,41,33,26,18,0
49581,451,278,173,71,35,58,12,662,373,289,89,80,77,29,0
49582,67,40,27,10,8,7,6,278,154,124,42,32,38,7,0
49583,329,171,158,49,41,31,10,1230,644,586,198,125,123,61,0
49584,415,189,226,68,54,50,21,246,108,138,32,44,21,10,0
49585,90,54,36,20,4,14,5,843,391,452,139,104,91,35,0
49586,181,75,106,35,26,11,9,386,207,179,43,48,44,19,0
49587,210,84,126,44,43,9,4,501,249,252,77,70,55,22,0
49588,488,237,251,79,78,65,27,320,168,152,38,42,24,18,0
49589,375,167,208,55,83,44,9,257,139,118,64,17,24,7,0
49590,125,57,68,31,10,10,3,166,90,76,27,18,21,5,0
49591,494,242,252,67,47,25,21,144,67,77,28,14,9,8,0
49592,242,111,131,35,35,17,13,1241,619,622,183,169,155,59,0
49593,283,172,111,39,31,29,8,699,334,365,108,80,70,20,0
49594,333,171,162,41,44,48,23,749,384,365,108,105,86,31,0
49595,743,377,366,87,74,68,30,1696,771,925,257,225,149,63,0
49596,479,228,251,71,57,60,14,396,199,197,54,50,45,14,0
49597,373,164,209,51,45,44,21,415,226,189,51,40,40,29,0
49598,245,111,134,36,27,18,6,179,101,78,25,15,13,13,0
49599,351,166,185,48,61,24,15,298,129,169,51,40,29,8,0
49600,1590,726,864,270,237,126,59,1606,753,853,215,227,182,48,0
49601,282,105,177,77,28,39,6,276,149,127,34,31,32,10,0
49602,128,70,58,29,9,8,1,396,197,199,75,49,49,16,0
49603,209,75,134,53,48,20,9,129,60,69,21,15,8,5,0
49604,219,100,119,40,29,21,3,165,87,78,24,19,22,9,0
49605,1208,575,633,187,204,117,41,130,67,63,24,10,12,4,0
49606,1395,595,800,223,206,113,61,91,44,47,9,12,4,7,0
49607,479,228,251,71,57,60,14,242,124,118,39,32,28,22,0
49608,514,226,288,71,66,63,32,270,162,108,26,26,16,11,0
49609,1007,353,654,277,147,70,26,384,212,172,44,43,34,14,0
49610,391,203,188,49,34,36,9,282,134,148,38,45,29,10,0
49611,588,317,271,78,49,54,17,384,212,172,44,43,34,14,0
49612,457,261,196,55,27,57,34,128,63,65,30,11,13,8,0
49613,510,269,241,66,67,71,26,348,194,154,57,31,43,12,0
49614,1462,711,751,219,222,148,65,463,259,204,62,55,34,22,0
49615,1395,595,800,223,206,113,61,332,155,177,55,51,44,13,0
49616,291,120,171,63,39,26,6,334,181,153,41,40,25,15,0
49617,326,154,172,45,39,20,10,192,91,101,29,28,17,7,0
49618,1276,607,669,192,178,136,63,528,276,252,86,78,49,17,0
49619,344,109,235,100,39,26,5,403,192,211,102,39,49,15,0
49620,607,294,313,94,95,62,14,421,219,202,68,57,56,13,0
49621,1220,575,645,208,179,99,56,198,113,85,19,20,26,12,0
49622,438,185,253,71,64,52,28,289,140,149,33,42,30,15,0
49623,249,114,135,47,33,25,4,244,143,101,31,29,26,8,0
49624,271,136,135,37,30,18,10,866,397,469,117,153,95,48,0
49625,802,375,427,133,103,81,41,222,127,95,23,28,22,7,0
49626,385,179,206,58,56,38,19,780,337,443,112,116,77,28,0
49627,71,39,32,7,11,6,4,528,276,252,86,78,49,17,0
49628,338,173,165,31,42,22,10,309,164,145,35,47,30,11,0
49629,482,245,237,69,64,66,24,204,96,108,31,37,20,5,0
49630,313,178,135,43,18,35,6,519,287,232,68,58,45,21,0
49631,298,141,157,51,33,21,22,123,61,62,17,18,17,7,0
49632,258,126,132,38,22,29,8,334,182,152,45,41,27,13,0
49633,193,95,98,33,17,25,17,405,195,210,57,74,24,17,0
49634,739,323,416,127,89,76,33,504,272,232,75,57,53,19,0
49635,82,36,46,17,10,5,1,286,152,134,38,38,32,11,0
49636,956,450,506,122,117,82,36,928,440,488,111,157,82,35,0
49637,500,245,255,66,57,52,27,153,65,88,28,21,20,8,0
49638,135,64,71,31,11,8,4,348,194,154,57,31,43,12,0
49639,3703,1708,1995,456,428,305,162,373,189,184,54,46,50,23,0
49640,630,231,399,150,83,84,50,398,200,198,68,43,51,14,0
49641,449,179,270,80,77,49,29,423,234,189,66,44,57,12,0
49642,711,330,381,111,86,86,34,309,159,150,47,43,43,13,0
49643,627,237,390,137,57,108,44,131,55,76,28,9,14,12,0
49644,86,50,36,9,14,8,7,415,203,212,77,44,49,18,0
49645,505,201,304,116,58,75,31,87,38,49,23,10,10,9,0
49646,1014,488,526,178,137,94,39,312,165,147,41,39,29,16,0
49647,240,98,142,49,42,23,17,106,46,60,29,13,14,5,0
49648,927,457,470,130,99,118,42,152,71,81,41,16,14,2,0
49649,272,141,131,45,29,36,9,201,93,108,34,39,21,6,0
49650,1499,864,635,141,99,76,110,135,65,70,21,25,15,9,0
49651,1098,519,579,182,159,79,42,173,86,87,30,22,19,12,0
49652,431,199,232,59,54,40,17,198,86,112,36,27,23,9,0
49653,213,113,100,26,21,26,12,148,84,64,30,7,17,4,0
49654,234,108,126,42,40,15,9,188,93,95,33,18,16,10,0
49655,186,56,130,46,50,16,7,392,155,237,68,61,34,16,0
49656,434,221,213,58,47,54,15,482,232,250,77,81,44,13,0
49657,2624,999,1625,415,495,109,84,405,181,224,71,57,31,12,0
49658,219,116,103,66,7,2,1,496,251,245,78,62,61,23,0
49659,364,172,192,55,57,32,15,108,59,49,17,13,12,5,0
49660,837,381,456,123,109,65,25,135,57,78,21,20,9,11,0
49661,270,131,139,47,37,41,11,335,170,165,52,36,47,11,0
49662,243,100,143,58,50,24,5,780,337,443,112,116,77,28,0
49663,468,233,235,65,61,49,34,380,211,169,47,37,33,21,0
49664,345,203,142,47,35,31,11,72,34,38,8,2,3,12,0
49665,456,214,242,76,62,52,22,858,398,460,126,138,75,39,0
49666,236,141,95,36,32,14,6,166,88,78,23,18,13,7,0
49667,494,233,261,87,57,46,18,165,90,75,36,18,20,6,0
49668,626,308,318,105,89,77,25,271,150,121,39,36,37,5,0
49669,732,355,377,108,109,79,27,295,156,139,41,40,42,15,0
49670,784,353,431,56,47,26,18,370,190,180,60,52,37,13,0
49671,1139,537,602,162,139,109,50,536,251,285,75,79,60,23,0
49672,416,207,209,63,47,56,15,621,310,311,100,106,77,27,0
49673,304,149,155,46,32,39,14,136,65,71,26,11,7,5,0
49674,261,137,124,34,23,13,8,283,160,123,25,20,37,9,0
49675,341,177,164,57,42,40,18,148,84,64,30,7,17,4,0
49676,414,206,208,56,68,35,19,531,277,254,82,75,33,22,0
49677,1365,590,775,257,168,136,93,547,295,252,81,65,57,23,0
49678,150,60,90,27,16,6,3,68,23,45,12,9,3,9,0
49679,342,150,192,52,43,31,17,108,59,49,17,13,12,5,0
49680,509,251,258,69,49,55,17,250,116,134,41,30,33,19,0
49681,782,372,410,127,111,89,36,190,93,97,35,27,23,2,0
49682,472,222,250,46,61,33,23,463,259,204,62,55,34,22,0
49683,1217,647,570,142,160,129,45,518,292,226,60,60,52,21,0
49684,432,233,199,52,28,47,18,290,147,143,34,34,39,13,0
49685,323,156,167,52,45,39,18,370,190,180,60,52,37,13,0
49686,126,58,68,31,10,10,3,134,55,79,22,24,16,6,0
49687,407,207,200,53,36,38,8,906,455,451,116,105,87,46,0
49688,310,141,169,36,38,20,8,297,164,133,45,39,40,9,0
49689,1112,457,655,180,164,99,39,408,221,187,55,51,57,14,0
49690,172,98,74,20,21,22,8,180,90,90,31,19,20,8,0
49691,373,164,209,51,45,44,21,471,238,233,66,63,62,19,0
49692,1501,679,822,251,196,174,67,230,113,117,31,40,28,10,0
49693,454,214,240,56,71,35,16,375,209,166,50,37,29,23,0
49694,333,171,162,41,44,48,23,190,93,97,35,27,23,2,0
49695,526,268,258,54,37,55,12,663,354,309,91,84,79,31,0
49696,210,84,126,44,43,9,4,1922,923,999,267,275,215,90,0
49697,959,496,463,144,132,75,35,89,37,52,13,6,2,9,0
49698,539,283,256,75,73,53,26,1700,731,969,198,233,110,87,0
49699,522,302,220,61,49,75,19,302,150,152,56,40,52,15,0
49700,119,59,60,29,10,6,4,246,107,139,55,33,27,11,0
49701,1835,904,931,192,144,135,63,132,77,55,20,9,13,10,0
49702,651,357,294,81,67,103,18,463,259,204,62,55,34,22,0
49703,380,148,232,81,69,24,8,1230,644,586,198,125,123,61,0
49704,927,457,470,130,99,118,42,904,436,468,143,118,108,32,0
49705,1755,849,906,245,226,148,56,137,63,74,20,22,14,6,0
49706,199,107,92,41,15,14,8,374,202,172,50,39,31,24,0
49707,391,204,187,47,48,38,18,180,108,72,22,22,15,5,0
49708,340,145,195,46,38,26,23,332,155,177,55,51,44,13,0
49709,580,308,272,82,79,58,25,334,181,153,41,40,25,15,0
49710,476,254,222,58,33,46,23,1101,626,475,145,122,120,50,0
49711,528,273,255,67,53,29,20,1040,564,476,134,110,114,51,0
49712,257,132,125,39,27,26,10,127,58,69,18,17,10,5,0
49713,595,316,279,86,60,65,40,406,234,172,63,35,43,10,0
49714,785,374,411,56,42,38,25,572,305,267,74,72,58,21,0
49715,362,174,188,46,55,35,23,1230,644,586,198,125,123,61,0
49716,213,88,125,21,54,14,15,234,116,118,34,35,23,9,0
49717,276,149,127,45,34,39,9,323,171,152,48,41,40,16,0
49718,180,92,88,29,20,26,8,584,249,335,80,96,22,13,0
49719,927,457,470,130,99,118,42,818,357,461,122,136,54,25,0
49720,217,109,108,30,23,28,10,1755,905,850,214,196,183,79,0
49721,1327,520,807,241,174,141,60,196,105,91,40,13,19,10,0
49722,126,57,69,31,10,10,3,308,146,162,42,39,24,12,0
49723,330,77,253,86,52,20,12,225,111,114,32,34,32,16,0
49724,412,208,204,54,47,42,17,415,203,212,77,44,49,18,0
49725,255,136,119,39,20,32,10,619,305,314,85,93,71,29,0
49726,257,132,125,39,27,26,10,354,188,166,46,40,34,10,0
49727,1143,574,569,176,151,123,59,900,441,459,125,127,110,32,0
49728,323,156,167,52,45,39,18,947,482,465,143,107,89,37,0
49729,627,237,390,137,57,108,44,630,321,309,86,90,57,26,0
49730,1200,602,598,145,116,110,50,277,124,153,44,40,35,18,0
49731,3969,1703,2266,619,432,259,144,149,52,97,36,36,7,4,0
49732,398,186,212,76,70,18,13,763,418,345,113,84,59,32,0
49733,402,169,233,70,36,34,18,239,113,126,36,49,20,8,0
49734,801,331,470,151,139,99,55,385,188,197,57,42,36,16,0
49735,530,259,271,83,50,54,41,200,89,111,26,25,17,7,0
49736,215,104,111,61,7,2,1,368,183,185,40,42,40,15,0
49737,2000,965,1035,357,313,198,75,283,160,123,25,20,37,9,0
49738,236,141,95,36,32,14,6,572,305,267,74,72,58,21,0
49739,439,205,234,64,88,41,21,374,212,162,48,40,32,23,0
49740,665,341,324,109,79,38,22,189,95,94,25,33,16,8,0
49741,338,208,130,39,30,35,12,215,115,100,27,19,16,7,0
49742,450,231,219,77,50,76,16,508,261,247,65,53,58,23,0
49743,345,203,142,47,35,31,11,173,90,83,21,36,12,15,0
49744,522,302,220,61,49,75,19,326,149,177,51,51,28,10,0
49745,126,56,70,31,10,10,3,903,436,467,128,116,83,33,0
49746,125,53,72,18,21,18,12,286,152,134,38,38,32,11,0
49747,325,177,148,40,24,23,13,1004,457,547,150,150,74,52,0
49748,186,56,130,46,50,16,7,89,42,47,16,12,15,6,0
49749,413,206,207,38,55,19,10,418,223,195,53,43,49,15,0
49750,210,84,126,44,43,9,4,65,32,33,16,4,8,3,0
49751,574,269,305,91,63,54,27,123,61,62,17,18,17,7,0
49752,410,200,210,60,54,46,19,660,333,327,102,95,69,31,0
49753,413,206,207,38,55,19,10,498,244,254,81,67,58,19,0
49754,271,110,161,33,27,11,8,218,117,101,35,32,34,12,0
49755,852,461,391,109,102,72,24,73,35,38,14,10,9,4,0
49756,473,217,256,59,44,34,21,265,134,131,48,34,33,15,0
49757,1163,417,746,209,145,87,28,381,196,185,55,57,43,16,0
49758,462,258,204,59,41,56,15,286,160,126,37,27,23,10,0
49759,1464,693,771,153,136,91,86,775,407,368,122,100,97,32,0
49760,426,231,195,51,52,45,24,693,360,333,100,88,62,26,0
49761,521,289,232,71,58,49,16,267,141,126,53,27,23,7,0
49762,440,267,173,52,29,42,12,299,140,159,49,44,26,11,0
49763,502,250,252,70,47,57,15,148,84,64,30,7,17,4,0
49764,381,187,194,37,49,36,17,298,129,169,51,40,29,8,0
49765,2285,1219,1066,207,180,178,106,375,210,165,49,37,29,27,0
49766,395,219,176,47,41,50,18,198,86,112,36,27,23,9,0
49767,711,330,381,111,86,86,34,218,115,103,32,32,34,11,0
49768,1341,481,860,275,264,57,21,481,223,258,71,70,49,26,0
49769,580,281,299,95,60,74,29,287,151,136,51,42,36,7,0
49770,395,189,206,63,50,49,28,108,59,49,17,13,12,5,0
49771,411,236,175,39,45,50,30,374,181,193,55,58,48,23,0
49772,461,257,204,63,49,50,29,91,44,47,9,12,4,7,0
49773,2136,1063,1073,317,308,223,90,330,166,164,55,51,36,16,0
49774,417,176,241,75,61,51,20,501,257,244,75,57,48,29,0
49775,577,342,235,63,57,23,37,1543,794,749,182,152,132,55,0
49776,743,377,366,87,74,68,30,1249,638,611,166,153,141,45,0
49777,338,164,174,45,32,37,13,169,74,95,33,26,22,3,0
49778,340,181,159,44,39,35,21,660,303,357,97,89,85,33,0
49779,221,80,141,48,37,14,10,630,321,309,86,90,57,26,0
49780,579,281,298,91,78,74,27,593,289,304,85,69,48,19,0
49781,1390,585,805,241,230,118,46,704,355,349,113,94,71,24,0
49782,1239,537,702,221,188,113,35,184,86,98,26,26,14,11,0
49783,118,56,62,24,12,6,9,142,65,77,30,17,22,9,0
49784,221,114,107,65,7,2,1,320,168,152,38,42,24,18,0
49785,639,368,271,72,51,38,38,341,170,171,41,66,27,10,0
49786,773,383,390,108,76,79,30,975,400,575,160,162,62,31,0
49787,1214,498,716,197,180,121,65,242,124,118,39,32,28,22,0
49788,385,179,206,58,56,38,19,483,215,268,66,70,30,16,0
49789,1214,612,602,169,173,98,35,396,223,173,57,37,44,19,0
49790,605,277,328,99,54,63,43,137,85,52,15,11,11,2,0
49791,604,239,365,124,63,84,37,131,55,76,28,9,14,12,0
49792,852,472,380,99,79,70,27,73,35,38,14,10,9,4,0
49793,219,116,103,66,7,2,1,572,305,267,74,72,58,21,0
49794,232,134,98,28,20,20,5,715,345,370,110,97,64,25,0
49795,341,177,164,57,42,40,18,173,86,87,30,22,19,12,0
49796,126,56,70,31,10,10,3,418,223,195,53,43,49,15,0
49797,170,82,88,32,23,22,8,296,140,156,49,40,42,19,0
49798,1544,738,806,239,217,145,91,192,91,101,29,28,17,7,0
49799,335,148,187,52,26,51,12,260,131,129,42,31,40,9,0
49800,431,245,186,50,23,46,17,399,190,209,61,41,39,18,0
49801,782,372,410,127,111,89,36,396,199,197,54,50,45,14,0
49802,781,316,465,130,129,65,23,72,32,40,8,2,1,14,0
49803,193,90,103,44,9,19,13,72,33,39,8,2,3,12,0
49804,879,457,422,93,98,143,32,207,114,93,33,20,31,13,0
49805,822,416,406,111,97,88,42,405,214,191,53,42,49,20,0
49806,505,247,258,72,71,60,27,1338,720,618,179,145,141,85,0
49807,139,81,58,17,14,24,9,204,96,108,31,37,20,5,0
49808,929,410,519,187,146,53,30,290,142,148,41,37,43,11,0
49809,322,164,158,46,44,29,7,277,124,153,44,40,35,18,0
49810,808,366,442,130,133,66,31,548,296,252,71,74,43,28,0
49811,582,328,254,78,48,35,9,374,212,162,48,40,32,23,0
49812,126,58,68,31,10,10,3,592,249,343,91,90,50,42,0
49813,126,58,68,31,10,10,3,556,290,266,75,74,29,24,0
49814,270,128,142,36,43,15,11,222,124,98,37,29,22,9,0
49815,646,304,342,104,93,58,26,198,86,112,36,27,23,9,0
49816,490,198,292,65,81,39,27,332,173,159,48,40,31,11,0
49817,929,410,519,187,146,53,30,332,155,177,55,51,44,13,0
49818,1052,492,560,184,163,103,44,72,32,40,8,2,2,13,0
49819,275,160,115,40,31,34,17,963,455,508,127,130,115,48,0
49820,155,85,70,17,16,4,8,798,385,413,120,115,79,30,0
49821,519,259,260,86,78,59,22,531,261,270,73,80,68,26,0
49822,330,151,179,68,36,56,9,763,418,345,113,84,59,32,0
49823,502,229,273,63,66,40,31,350,196,154,52,37,21,14,0
49824,462,228,234,59,47,37,32,399,190,209,61,41,39,18,0
49825,1174,594,580,175,155,126,66,415,226,189,51,40,40,29,0
49826,904,436,468,138,146,82,39,497,227,270,70,63,66,30,0
49827,960,409,551,166,134,77,44,127,54,73,11,33,15,6,0
49828,537,276,261,75,68,68,22,672,334,338,110,93,91,41,0
49829,440,267,173,52,29,42,12,381,187,194,37,49,36,17,0
49830,344,168,176,50,39,30,20,250,116,134,41,30,33,19,0
49831,426,231,195,51,52,45,24,218,115,103,32,32,34,11,0
49832,1390,585,805,241,230,118,46,144,67,77,28,14,9,8,0
49833,335,148,187,52,26,51,12,180,90,90,31,19,20,8,0
49834,485,183,302,79,81,73,33,928,440,488,111,157,82,35,0
49835,908,324,584,181,162,81,29,107,77,30,7,2,9,5,0
49836,715,345,370,110,97,64,25,308,129,179,44,60,19,8,0
49837,414,216,198,51,32,42,28,173,94,79,18,24,12,7,0
49838,336,199,137,46,22,51,13,376,189,187,47,53,44,26,0
49839,983,449,534,95,77,55,36,376,189,187,47,53,44,26,0
49840,979,534,445,83,77,80,24,744,385,359,105,96,57,31,0
49841,747,469,278,60,41,53,23,1395,627,768,172,263,141,59,0
49842,213,88,125,21,54,14,15,201,98,103,28,25,19,13,0
49843,452,202,250,83,60,56,19,2202,1121,1081,338,274,269,81,0
49844,773,383,390,108,76,79,30,565,237,328,75,88,32,11,0
49845,128,67,61,29,9,9,1,270,162,108,26,26,16,11,0
49846,616,304,312,75,71,55,25,72,32,40,8,2,2,13,0
49847,1014,488,526,178,137,94,39,748,359,389,125,113,86,31,0
49848,426,231,195,51,52,45,24,65,32,33,16,4,8,3,0
49849,401,183,218,72,73,28,10,1241,619,622,183,169,155,59,0
49850,381,187,194,37,49,36,17,463,170,293,115,54,75,32,0
49851,648,376,272,70,60,73,24,1378,692,686,194,174,105,56,0
49852,517,196,321,103,98,33,12,187,89,98,36,24,20,6,0
49853,640,271,369,111,79,57,17,555,282,273,82,69,65,21,0
49854,467,233,234,83,37,77,22,664,350,314,86,90,82,36,0
49855,328,156,172,44,37,44,15,418,246,172,52,39,57,10,0
49856,575,305,270,74,87,73,25,447,212,235,86,55,58,21,0
49857,772,383,389,105,76,82,33,212,127,85,28,21,26,6,0
49858,130,70,60,30,9,8,1,479,215,264,67,80,46,28,0
49859,717,381,336,118,103,85,29,381,187,194,37,49,36,17,0
49860,560,279,281,113,64,58,15,406,234,172,63,35,43,10,0
49861,179,96,83,24,8,26,4,405,181,224,71,57,31,12,0
49862,305,124,181,27,25,31,21,889,505,384,107,97,99,30,0
49863,415,217,198,50,31,42,17,374,181,193,55,58,48,23,0
49864,565,264,301,101,73,72,15,274,157,117,40,29,40,8,0
49865,164,81,83,37,8,14,10,594,312,282,72,67,73,31,0
49866,465,305,160,40,47,34,9,904,436,468,143,118,108,32,0
49867,226,120,106,68,8,2,1,483,258,225,70,53,54,20,0
49868,911,489,422,121,98,97,36,758,319,439,101,123,78,25,0
49869,1161,514,647,159,138,122,37,111,60,51,17,23,10,7,0
49870,1174,594,580,175,155,126,66,198,86,112,36,27,23,9,0
49871,452,202,250,83,60,56,19,260,133,127,43,32,39,3,0
49872,435,230,205,51,37,55,18,584,249,335,80,96,22,13,0
49873,333,171,162,50,34,19,8,348,212,136,53,31,25,18,0
49874,301,156,145,32,25,15,5,403,192,211,102,39,49,15,0
49875,478,220,258,47,70,41,10,729,358,371,116,99,89,33,0
49876,282,160,122,36,28,27,7,205,94,111,48,31,15,6,0
49877,514,226,288,71,66,63,32,175,91,84,19,21,21,10,0
49878,458,226,232,77,59,61,14,1230,644,586,198,125,123,61,0
49879,341,175,166,48,43,35,18,471,238,233,66,63,62,19,0
49880,127,62,65,13,33,7,6,592,249,343,91,90,50,42,0
49881,501,230,271,63,90,50,18,192,91,101,29,28,17,7,0
49882,520,240,280,87,63,67,16,549,273,276,74,68,72,24,0
49883,240,98,142,49,42,23,17,187,89,98,36,24,20,6,0
49884,522,302,220,61,49,75,19,496,285,211,62,54,46,22,0
49885,302,160,142,35,35,37,10,2038,1059,979,262,237,208,100,0
49886,469,221,248,49,60,55,21,222,125,97,34,27,27,7,0
49887,325,186,139,49,36,20,5,399,190,209,61,41,39,18,0
49888,563,255,308,91,111,42,30,294,146,148,50,45,51,15,0
49889,90,54,36,20,4,14,5,1352,602,750,166,185,81,70,0
49890,594,248,346,104,109,53,5,354,188,166,46,40,34,10,0
49891,301,150,151,45,47,33,13,370,190,180,60,52,37,13,0
49892,746,312,434,129,115,77,47,282,134,148,38,45,29,10,0
49893,496,274,222,57,43,75,22,1314,693,621,174,155,140,58,0
49894,522,302,220,61,49,75,19,536,267,269,60,70,41,22,0
49895,2649,1431,1218,377,299,266,102,135,65,70,21,25,15,9,0
49896,413,169,244,66,94,28,19,459,260,199,56,42,47,21,0
49897,71,28,43,15,9,5,2,906,455,451,116,105,87,46,0
49898,416,201,215,54,52,39,25,298,159,139,39,40,33,15,0
49899,369,166,203,59,55,41,14,528,276,252,86,78,49,17,0
49900,898,397,501,102,98,54,37,225,111,114,32,34,32,16,0
49901,736,320,416,113,97,61,36,131,55,76,28,9,14,12,0
49902,502,229,273,63,66,40,31,376,183,193,50,50,43,21,0
49903,138,35,103,38,2,15,9,374,191,183,40,52,40,16,0
49904,127,62,65,13,33,7,6,222,122,100,39,32,24,9,0
49905,435,187,248,62,51,51,21,256,141,115,32,22,32,8,0
49906,319,153,166,61,52,26,12,314,177,137,34,40,29,9,0
49907,739,389,350,129,61,69,25,673,313,360,102,101,46,17,0
49908,546,278,268,94,60,32,22,344,190,154,34,31,36,10,0
49909,437,167,270,126,95,34,10,497,227,270,70,63,66,30,0
49910,469,253,216,49,51,48,18,89,38,51,14,6,3,9,0
49911,531,260,271,97,68,47,11,1113,480,633,170,173,81,34,0
49912,243,70,173,54,65,8,6,231,126,105,37,26,29,6,0
49913,1505,680,825,202,204,73,32,1755,905,850,214,196,183,79,0
49914,704,342,362,113,91,85,33,266,146,120,41,28,31,7,0
49915,777,367,410,89,85,64,43,321,187,134,59,29,32,8,0
49916,398,186,212,76,70,18,13,387,193,194,60,53,57,15,0
49917,330,151,179,68,36,56,9,474,268,206,66,42,45,24,0
49918,648,376,272,70,60,73,24,763,418,345,113,84,59,32,0
49919,531,259,272,75,81,39,13,376,189,187,47,53,44,26,0
49920,376,171,205,45,45,34,12,218,111,107,45,29,24,6,0
49921,150,64,86,22,12,29,12,467,240,227,65,65,51,23,0
49922,213,88,125,21,54,14,15,926,340,586,133,119,60,40,0
49923,360,205,155,35,24,52,14,1265,689,576,169,177,128,60,0
49924,688,310,378,130,82,78,47,148,84,64,30,7,17,4,0
49925,292,102,190,71,27,51,21,1208,565,643,182,162,120,57,0
49926,1439,713,726,195,180,110,34,180,115,65,17,12,9,9,0
49927,1390,705,685,219,164,129,74,251,143,108,47,25,29,11,0
49928,1064,495,569,157,159,124,58,344,190,154,34,31,36,10,0
49929,236,120,116,32,28,21,11,257,139,118,64,17,24,7,0
49930,580,265,315,97,89,79,17,391,189,202,55,56,56,12,0
49931,1276,607,669,192,178,136,63,535,301,234,63,48,47,27,0
49932,243,100,143,58,50,24,5,541,279,262,79,82,31,32,0
49933,180,92,88,29,20,26,8,421,222,199,69,50,60,18,0
49934,508,136,372,157,91,22,9,1321,653,668,186,195,70,35,0
49935,227,109,118,42,35,29,8,180,108,72,22,22,15,5,0
49936,556,306,250,69,60,80,18,399,190,209,61,41,39,18,0
49937,517,196,321,103,98,33,12,266,150,116,28,28,24,12,0
49938,508,136,372,157,91,22,9,362,156,206,74,42,36,22,0
49939,640,279,361,102,83,69,21,234,129,105,31,22,19,17,0
49940,435,225,210,58,46,50,14,239,113,126,36,49,20,8,0
49941,580,308,272,82,79,58,25,94,45,49,11,20,10,4,0
49942,431,245,186,50,23,46,17,326,169,157,51,41,41,12,0
49943,1531,649,882,108,122,93,72,396,199,197,54,50,45,14,0
49944,270,130,140,43,24,36,10,413,223,190,52,45,53,10,0
49945,484,264,220,59,62,68,15,261,162,99,24,21,14,10,0
49946,1009,478,531,166,126,96,42,1113,480,633,170,173,81,34,0
49947,209,75,134,53,48,20,9,250,119,131,58,26,29,7,0
49948,472,222,250,46,61,33,23,461,223,238,45,62,18,35,0
49949,221,114,107,65,7,2,1,619,305,314,85,93,71,29,0
49950,261,126,135,41,36,24,11,584,249,335,80,96,22,13,0
49951,859,411,448,118,100,95,49,517,295,222,69,62,40,28,0
49952,470,163,307,99,68,73,30,403,184,219,75,51,47,20,0
49953,548,250,298,85,64,56,21,1500,804,696,190,172,144,60,0
49954,51,10,41,25,0,5,8,322,180,142,45,38,28,7,0
49955,618,289,329,97,86,70,17,283,142,141,41,33,26,18,0
49956,136,66,70,33,11,9,5,415,205,210,77,52,55,17,0
49957,532,254,278,91,48,23,17,866,478,388,121,101,101,26,0
49958,123,58,65,22,14,13,3,605,283,322,94,72,64,39,0
49959,231,105,126,56,10,24,10,194,94,100,33,28,14,7,0
49960,1505,680,825,202,204,73,32,72,32,40,8,2,2,13,0
49961,340,181,159,44,39,35,21,346,178,168,58,41,33,12,0
49962,163,70,93,28,21,17,6,308,146,162,42,39,24,12,0
49963,345,203,142,47,35,31,11,391,189,202,55,56,56,12,0
49964,1054,453,601,183,183,107,35,396,223,173,57,37,44,19,0
49965,425,199,226,54,71,56,11,423,234,189,66,44,57,12,0
49966,278,104,174,46,34,23,14,89,38,51,14,6,3,9,0
49967,2446,1099,1347,363,294,233,100,111,60,51,17,23,10,7,0
49968,503,260,243,46,56,33,16,198,110,88,27,27,24,4,0
49969,164,81,83,37,8,14,10,325,159,166,59,46,30,12,0
49970,128,70,58,29,9,8,1,312,165,147,41,39,29,16,0
49971,852,472,380,99,79,70,27,396,213,183,68,44,47,18,0
49972,270,130,140,43,24,36,10,189,105,84,25,26,21,9,0
49973,496,274,222,57,43,75,22,1034,495,539,150,134,114,71,0
49974,346,174,172,36,43,21,9,535,301,234,63,48,47,27,0
49975,802,375,427,133,103,81,41,111,60,51,17,23,10,7,0
49976,480,257,223,74,26,60,27,366,204,162,47,41,31,23,0
49977,233,107,126,40,40,20,16,462,229,233,63,49,42,18,0
49978,772,332,440,136,104,72,28,423,234,189,66,44,57,12,0
49979,793,355,438,134,117,77,43,160,60,100,23,40,19,11,0
49980,249,114,135,47,33,25,4,555,292,263,75,63,67,27,0
49981,438,185,253,71,64,52,28,175,91,84,19,21,21,10,0
49982,225,111,114,38,22,25,10,173,94,79,18,24,12,7,0
49983,224,108,116,31,32,22,8,283,142,141,41,33,26,18,0
49984,361,171,190,44,40,18,13,453,255,198,62,49,29,19,0
49985,2624,999,1625,415,495,109,84,900,441,459,125,127,110,32,0
49986,546,265,281,101,64,38,16,524,300,223,70,54,51,25,0
49987,345,208,137,44,27,33,8,693,360,333,100,88,62,26,0
49988,320,183,137,51,18,38,8,562,273,289,76,92,45,24,0
49989,215,117,98,28,19,15,8,89,38,51,14,6,3,9,0
49990,207,128,79,26,17,19,9,535,311,224,66,52,49,24,0
49991,290,156,134,44,29,39,9,362,156,206,74,42,36,22,0
49992,76,30,46,7,15,1,5,314,177,137,34,40,29,9,0
49993,1030,567,463,118,106,94,49,415,189,226,68,54,50,21,0
49994,130,71,59,30,9,8,2,689,343,346,105,102,81,35,0
49995,317,140,177,43,26,31,16,1239,659,580,169,148,131,54,0
49996,524,270,254,84,72,70,23,213,129,84,32,14,21,15,0
49997,473,217,256,59,44,34,21,352,207,145,40,33,25,21,0
49998,106,43,63,28,13,8,1,386,181,205,55,51,57,31,0
49999,1001,422,579,185,180,51,32,929,459,470,140,120,94,45,0
50000,649,304,345,99,80,67,40,277,152,125,31,35,22,19,0
50001,326,154,172,45,39,20,10,453,255,198,62,49,29,19,0
50002,240,167,73,32,12,8,21,334,181,153,41,40,25,15,0
50003,220,113,107,37,24,16,7,252,130,122,45,23,32,11,0
50004,1148,472,676,229,164,86,37,462,251,211,74,53,41,18,0
50005,404,197,207,60,48,47,20,180,89,91,28,27,18,7,0
50006,338,172,166,59,30,39,18,384,204,180,53,47,49,17,0
50007,350,190,160,48,25,27,18,455,191,264,68,86,21,19,0
50008,209,75,134,53,48,20,9,368,200,168,54,49,43,9,0
50009,465,240,225,50,54,24,14,508,253,255,73,60,50,13,0
50010,282,96,186,80,21,28,7,102,51,51,12,15,12,3,0
50011,580,308,272,82,79,58,25,501,240,261,80,62,49,42,0
50012,667,366,301,96,55,84,25,242,121,121,39,30,29,10,0
50013,482,245,237,69,64,66,24,199,92,107,34,30,18,9,0
50014,500,257,243,60,55,27,22,475,251,224,67,49,48,23,0
50015,505,201,304,116,58,75,31,246,107,139,55,33,27,11,0
50016,193,95,98,33,17,25,17,194,109,85,23,24,21,9,0
50017,179,96,83,24,8,26,4,332,173,159,48,40,31,11,0
50018,1041,497,544,180,167,98,34,783,406,377,102,91,57,29,0
50019,126,56,70,31,10,10,3,535,311,224,66,52,49,24,0
50020,109,42,67,25,13,1,1,756,348,408,101,103,60,40,0
50021,439,205,234,64,88,41,21,286,160,126,37,27,23,10,0
50022,378,202,176,34,32,44,13,483,215,268,66,70,30,16,0
50023,155,85,70,17,16,4,8,549,273,276,74,68,72,24,0
50024,264,122,142,33,29,13,13,1040,564,476,134,110,114,51,0
50025,314,178,136,42,32,30,17,262,129,133,40,41,31,10,0
50026,258,144,114,33,22,19,9,329,194,135,45,32,33,9,0
50027,76,42,34,12,8,5,7,2542,1245,1297,285,287,170,84,0
50028,83,45,38,11,8,8,3,622,344,278,80,77,68,36,0
50029,332,172,160,50,33,35,9,783,406,377,102,91,57,29,0
50030,261,126,135,41,36,24,11,418,223,195,51,45,49,14,0
50031,450,241,209,67,58,54,23,463,170,293,115,54,75,32,0
50032,727,426,301,79,71,64,32,87,38,49,23,10,10,9,0
50033,240,99,141,53,38,29,15,724,353,371,94,95,71,31,0
50034,604,239,365,124,63,84,37,611,314,297,79,75,78,22,0
50035,3969,1703,2266,619,432,259,144,434,213,221,77,62,53,12,0
50036,253,133,120,44,31,22,8,96,45,51,13,12,6,4,0
50037,1098,519,579,182,159,79,42,465,252,213,73,58,60,18,0
50038,1054,453,601,183,183,107,35,296,151,145,45,42,32,11,0
50039,828,355,473,126,134,77,37,649,307,342,71,134,45,17,0
50040,528,188,340,130,58,77,41,421,219,202,68,57,56,13,0
50041,1616,735,881,285,248,153,72,1114,539,575,145,131,94,56,0
50042,626,300,326,91,82,68,26,231,126,105,37,26,29,6,0
50043,480,257,223,74,26,60,27,207,114,93,33,20,31,13,0
50044,369,207,162,67,35,16,14,295,158,137,42,34,38,14,0
50045,288,140,148,59,33,27,12,283,142,141,41,33,26,18,0
50046,5890,3314,2576,970,956,293,265,261,162,99,24,21,14,10,0
50047,328,156,172,44,37,44,15,305,161,144,39,40,44,17,0
50048,192,91,101,28,21,18,8,172,79,93,34,27,23,10,0
50049,344,109,235,100,39,26,5,360,185,175,51,43,36,16,0
50050,1121,458,663,158,210,76,47,349,200,149,41,39,30,20,0
50051,646,304,342,104,93,58,26,360,180,180,57,48,39,12,0
50052,202,113,89,16,27,21,11,430,212,218,88,43,40,20,0
50053,380,185,195,68,54,32,16,584,249,335,80,96,22,13,0
50054,314,178,136,42,32,30,17,101,59,42,11,17,10,1,0
50055,1339,494,845,216,298,92,37,452,231,221,74,53,56,20,0
50056,766,336,430,133,97,79,21,496,251,245,78,62,61,23,0
50057,388,209,179,46,24,31,28,1323,690,633,132,178,112,61,0
50058,284,160,124,37,23,32,11,663,360,303,87,82,80,35,0
50059,498,274,224,58,59,50,18,390,223,167,58,36,45,18,0
50060,516,210,306,113,53,81,33,377,184,193,50,43,33,17,0
50061,508,267,241,43,35,25,17,373,189,184,54,46,50,23,0
50062,2063,1024,1039,175,117,80,97,166,88,78,23,18,13,7,0
50063,126,56,70,31,10,10,3,307,132,175,48,53,26,10,0
50064,135,64,71,31,11,8,4,173,90,83,21,36,12,15,0
50065,399,196,203,62,45,38,19,258,129,129,45,24,31,10,0
50066,181,92,89,34,22,17,9,501,249,252,77,70,55,22,0
50067,1235,584,651,140,226,82,52,225,111,114,32,34,32,16,0
50068,204,103,101,16,32,22,8,1208,565,643,182,162,120,57,0
50069,516,224,292,79,29,45,33,274,142,132,33,34,18,14,0
50070,150,64,86,22,12,29,12,215,115,100,27,19,16,7,0
50071,218,133,85,20,19,13,6,169,84,85,29,19,21,7,0
50072,241,122,119,27,34,17,16,792,398,394,109,96,90,39,0
50073,898,397,501,102,98,54,37,103,50,53,19,10,7,5,0
50074,3969,1703,2266,619,432,259,144,483,215,268,66,70,30,16,0
50075,394,207,187,52,42,37,24,65,32,33,16,4,8,3,0
50076,466,259,207,59,50,83,12,583,321,262,73,67,45,25,0
50077,192,91,101,28,21,18,8,514,248,266,86,82,52,22,0
50078,1124,442,682,148,189,72,43,173,86,87,30,22,19,12,0
50079,282,163,119,40,23,25,17,482,232,250,77,81,44,13,0
50080,640,279,361,102,83,69,21,218,117,101,35,32,34,12,0
50081,341,183,158,36,34,36,15,818,357,461,122,136,54,25,0
50082,473,212,261,72,64,45,28,660,303,357,97,89,85,33,0
50083,314,158,156,39,28,30,17,196,105,91,40,13,19,10,0
50084,1417,598,819,223,188,135,58,134,72,62,14,28,8,4,0
50085,291,120,171,63,39,26,6,297,164,133,45,39,40,9,0
50086,434,221,213,58,47,54,15,142,65,77,30,17,22,9,0
50087,368,201,167,61,38,38,12,201,117,83,22,21,19,9,0
50088,322,164,158,46,44,29,7,309,164,145,35,47,30,11,0
50089,1011,559,452,121,97,132,33,531,261,270,73,80,68,26,0
50090,640,308,332,91,102,49,21,483,258,225,70,53,54,20,0
50091,196,107,89,20,31,17,4,337,170,167,59,33,47,17,0
50092,435,222,213,67,49,67,12,299,140,159,49,44,26,11,0
50093,410,211,199,55,42,34,27,261,148,113,31,28,14,10,0
50094,162,73,89,32,19,4,4,96,46,50,16,12,7,5,0
50095,488,237,251,79,78,65,27,139,68,71,14,26,14,9,0
50096,359,167,192,49,37,27,19,622,344,278,80,77,68,36,0
50097,349,131,218,66,76,22,9,690,345,345,96,83,73,42,0
50098,490,224,266,80,70,39,32,205,94,111,48,31,15,6,0
50099,664,269,395,117,107,36,15,88,50,38,13,8,16,4,0
50100,126,56,70,31,10,10,3,192,91,101,29,28,17,7,0
50101,444,250,194,58,21,60,23,843,391,452,139,104,91,35,0
50102,126,57,69,31,10,10,3,147,74,73,28,20,24,4,0
50103,1647,794,853,279,235,128,65,1114,539,575,145,131,94,56,0
50104,473,265,208,47,26,50,30,94,45,49,11,20,10,4,0
50105,1498,731,767,220,175,148,68,699,334,365,108,80,70,20,0
50106,860,348,512,121,136,75,35,492,278,214,65,58,32,11,0
50107,756,362,394,102,104,73,25,633,311,322,94,82,45,20,0
50108,401,183,218,72,73,28,10,160,60,100,23,40,19,11,0
50109,496,210,286,112,55,71,14,609,335,274,79,57,45,22,0
50110,684,353,331,95,98,77,38,201,93,108,34,39,21,6,0
50111,580,265,315,97,89,79,17,230,125,105,29,40,20,6,0
50112,2136,1063,1073,317,308,223,90,398,200,198,68,43,51,14,0
50113,193,90,103,44,9,19,13,132,67,65,24,21,8,10,0
50114,3703,1708,1995,456,428,305,162,339,180,159,36,29,16,16,0
50115,246,111,135,64,47,27,3,106,41,65,36,6,11,7,0
50116,595,316,279,86,60,65,40,399,190,209,61,41,39,18,0
50117,673,317,356,101,85,76,49,225,114,111,32,29,26,6,0
50118,545,221,324,101,72,55,30,422,237,185,53,47,62,20,0
50119,435,187,248,62,51,51,21,390,190,200,66,50,43,12,0
50120,524,361,163,41,8,28,16,972,471,501,152,138,112,40,0
50121,303,161,142,38,31,42,17,381,186,195,69,55,46,15,0
50122,325,152,173,43,47,28,17,106,41,65,36,6,11,7,0
50123,333,171,162,50,34,19,8,323,168,155,51,41,38,12,0
50124,207,93,114,20,33,19,10,246,107,139,55,33,27,11,0
50125,815,356,459,128,125,82,26,509,267,242,79,81,38,20,0
50126,1390,705,685,219,164,129,74,201,98,103,28,25,19,13,0
50127,180,57,123,39,22,10,8,548,273,275,84,81,64,30,0
50128,436,209,227,66,47,52,22,584,249,335,80,96,22,13,0
50129,587,318,269,76,50,38,21,132,61,71,22,21,15,3,0
50130,303,161,142,38,31,42,17,501,249,252,77,70,55,22,0
50131,199,107,92,41,15,14,8,1352,602,750,166,185,81,70,0
50132,166,59,107,36,41,10,4,1321,653,668,186,195,70,35,0
50133,454,230,224,63,56,38,33,107,77,30,7,2,9,5,0
50134,887,439,448,137,99,91,38,392,155,237,68,61,34,16,0
50135,794,322,472,122,108,79,34,565,237,328,75,88,32,11,0
50136,346,173,173,50,56,31,14,592,249,343,91,90,50,42,0
50137,496,274,222,57,43,75,22,335,170,165,52,36,47,11,0
50138,71,28,43,15,9,5,2,332,180,152,46,36,28,14,0
50139,919,444,475,141,148,62,20,572,305,267,74,72,58,21,0
50140,682,260,422,98,83,42,31,392,155,237,68,61,34,16,0
50141,733,382,351,126,92,93,27,286,160,126,37,27,23,10,0
50142,557,211,346,129,125,48,19,662,312,350,103,104,59,20,0
50143,505,226,279,68,51,30,15,541,279,262,79,82,31,32,0
50144,258,126,132,38,22,29,8,572,305,267,74,72,58,21,0
50145,465,220,245,88,34,61,23,1239,659,580,169,148,131,54,0
50146,76,42,34,12,8,5,7,485,244,241,80,55,59,20,0
50147,465,240,225,50,54,24,14,283,142,141,41,33,26,18,0
50148,413,206,207,38,55,19,10,873,411,462,132,107,84,40,0
50149,315,170,145,48,56,22,11,704,355,349,113,94,71,24,0
50150,221,114,107,65,7,2,1,106,46,60,27,18,12,3,0
50151,500,245,255,66,57,52,27,732,402,330,81,86,87,33,0
50152,894,448,446,123,100,82,30,68,23,45,12,9,3,9,0
50153,548,250,298,85,64,56,21,445,192,253,86,58,53,18,0
50154,867,415,452,123,87,62,27,205,94,111,48,31,15,6,0
50155,473,212,261,72,64,45,28,562,273,289,76,92,45,24,0
50156,508,251,257,74,53,51,18,531,277,254,82,75,33,22,0
50157,329,165,164,61,44,29,17,598,333,265,79,66,54,33,0
50158,446,174,272,84,61,57,23,351,166,185,48,61,24,15,0
50159,330,141,189,65,29,51,19,1352,602,750,166,185,81,70,0
50160,646,304,342,104,93,58,26,483,258,225,70,53,54,20,0
50161,1226,513,713,184,147,87,43,583,280,303,95,66,76,25,0
50162,609,292,317,102,96,64,21,671,306,365,114,76,49,19,0
50163,139,64,75,18,17,18,4,1114,539,575,145,131,94,56,0
50164,532,291,241,83,36,79,25,240,141,99,34,28,29,8,0
50165,856,429,427,113,105,96,24,501,274,227,63,58,53,20,0
50166,332,170,162,44,38,39,10,846,425,421,125,97,98,38,0
50167,462,228,234,59,47,37,32,660,332,328,84,73,47,19,0
50168,505,247,258,72,71,60,27,483,258,225,70,53,54,20,0
50169,426,213,213,60,56,46,24,282,134,148,38,45,29,10,0
50170,372,171,201,47,53,39,18,228,130,98,35,29,30,10,0
50171,519,259,260,86,78,59,22,649,307,342,71,134,45,17,0
50172,206,100,106,34,26,11,7,4646,2328,2318,674,639,475,170,0
50173,313,158,155,43,35,43,16,307,132,175,48,53,26,10,0
50174,465,240,225,50,54,24,14,448,217,231,56,63,29,10,0
50175,443,250,193,52,23,49,13,277,144,133,42,30,41,8,0
50176,342,150,192,52,43,31,17,297,175,122,46,30,31,6,0
50177,421,237,184,47,54,45,10,583,280,303,95,66,76,25,0
50178,380,185,195,68,54,32,16,483,287,196,71,50,54,17,0
50179,1970,978,992,245,206,198,80,258,129,129,45,24,31,10,0
50180,166,59,107,36,41,10,4,387,193,194,60,53,57,15,0
50181,2446,1099,1347,363,294,233,100,380,211,169,47,37,33,21,0
50182,1051,429,622,179,148,125,54,2547,1280,1267,331,335,293,118,0
50183,785,325,460,114,123,61,28,180,90,90,31,19,20,8,0
50184,312,173,139,43,47,28,6,370,173,197,65,57,42,10,0
50185,928,442,486,139,118,91,43,325,172,153,44,34,27,14,0
50186,323,156,167,52,45,39,18,322,180,142,45,38,28,7,0
50187,376,176,200,31,53,27,8,455,229,226,66,62,63,29,0
50188,130,71,59,30,9,8,2,481,223,258,71,70,49,26,0
50189,439,241,198,67,40,40,13,341,170,171,41,66,27,10,0
50190,509,251,258,69,49,55,17,633,311,322,94,82,45,20,0
50191,1505,680,825,202,204,73,32,245,121,124,37,35,36,12,0
50192,1711,865,846,204,176,105,60,504,272,232,75,57,53,19,0
50193,758,361,397,114,107,51,19,873,366,507,127,125,75,21,0
50194,583,279,304,99,71,59,31,256,141,115,32,22,32,8,0
50195,764,277,487,158,162,64,31,380,178,202,69,53,37,10,0
50196,465,305,160,40,47,34,9,1208,565,643,182,162,120,57,0
50197,710,352,358,104,86,84,41,277,124,153,44,40,35,18,0
50198,533,297,236,74,57,39,28,1114,539,575,145,131,94,56,0
50199,193,105,88,33,16,9,4,354,183,171,54,43,49,8,0
50200,335,183,152,40,26,54,22,467,240,227,65,65,51,23,0
50201,781,316,465,130,129,65,23,498,244,254,81,67,58,19,0
50202,406,208,198,41,26,43,21,257,126,131,61,24,22,8,0
50203,425,220,205,60,55,45,18,198,110,88,27,27,24,4,0
50204,1052,492,560,184,163,103,44,91,42,49,21,9,8,3,0
50205,463,225,238,76,36,59,26,607,293,314,98,71,62,32,0
50206,520,240,280,87,63,67,16,89,42,47,16,12,15,6,0
50207,204,93,111,35,35,16,11,403,184,219,75,51,47,20,0
50208,435,225,210,58,46,50,14,1166,514,652,150,159,107,70,0
50209,873,366,507,127,125,75,21,336,200,136,34,29,25,24,0
50210,466,259,207,59,50,83,12,926,340,586,133,119,60,40,0
50211,109,42,67,25,13,1,1,294,146,148,50,45,51,15,0
50212,1064,495,569,157,159,124,58,180,90,90,31,19,20,8,0
50213,478,220,258,47,70,41,10,1537,701,836,209,187,129,58,0
50214,1014,488,526,178,137,94,39,496,285,211,62,54,46,22,0
50215,428,248,180,44,39,28,9,547,295,252,81,65,57,23,0
50216,170,82,88,32,23,22,8,418,223,195,51,45,49,14,0
50217,785,325,460,114,123,61,28,134,72,62,14,28,8,4,0
50218,245,111,134,36,27,18,6,689,343,346,105,102,81,35,0
50219,361,171,190,44,40,18,13,481,223,258,71,70,49,26,0
50220,242,111,131,35,35,17,13,283,142,141,41,33,26,18,0
50221,772,417,355,118,92,80,23,1265,689,576,169,177,128,60,0
50222,1007,353,654,277,147,70,26,264,138,126,33,34,29,12,0
50223,126,57,69,31,10,10,3,903,436,467,128,116,83,33,0
50224,490,224,266,80,70,39,32,1025,549,476,118,109,88,61,0
50225,574,284,290,64,50,65,20,359,171,188,49,74,45,11,0
50226,625,283,342,93,89,67,25,501,274,227,63,58,53,20,0
50227,2799,1324,1475,369,371,215,124,904,436,468,143,118,108,32,0
50228,346,209,137,46,37,44,10,741,383,358,92,63,79,36,0
50229,220,113,107,37,24,16,7,91,44,47,9,12,4,7,0
50230,1009,487,522,177,121,103,51,199,92,107,34,30,18,9,0
50231,452,202,250,83,60,56,19,119,61,58,17,12,10,6,0
50232,616,323,293,98,71,31,15,166,90,76,27,18,21,5,0
50233,420,248,172,64,30,43,17,858,398,460,126,138,75,39,0
50234,278,110,168,58,49,29,5,223,113,110,31,33,22,12,0
50235,261,148,113,23,29,26,21,295,160,135,44,36,46,16,0
50236,471,221,250,87,68,42,25,230,113,117,31,40,28,10,0
50237,579,281,298,91,78,74,27,1378,692,686,194,174,105,56,0
50238,786,378,408,106,98,77,39,843,391,452,139,104,91,35,0
50239,1417,598,819,223,188,135,58,843,391,452,139,104,91,35,0
50240,199,107,92,41,15,14,8,457,253,204,67,51,48,13,0
50241,410,208,202,59,58,43,26,332,180,152,44,36,27,13,0
50242,270,130,140,43,24,36,10,325,159,166,59,46,30,12,0
50243,134,60,74,19,13,10,7,200,89,111,26,25,17,7,0
50244,309,137,172,51,50,28,14,314,151,163,42,61,39,16,0
50245,496,209,287,112,55,71,14,530,287,243,79,70,33,26,0
50246,142,76,66,21,21,22,11,452,254,198,72,57,38,18,0
50247,739,323,416,127,89,76,33,620,324,296,81,68,66,31,0
50248,1054,497,557,190,168,107,45,323,171,152,48,41,40,16,0
50249,279,127,152,50,36,28,8,326,169,157,51,41,41,12,0
50250,402,169,233,70,36,34,18,902,499,403,118,117,92,35,0
50251,904,436,468,138,146,82,39,137,78,59,22,16,17,4,0
50252,1594,660,934,251,272,117,77,227,130,97,32,25,22,12,0
50253,130,71,59,30,9,8,1,396,223,173,57,37,44,19,0
50254,1580,742,838,208,146,144,71,418,223,195,51,45,49,14,0
50255,240,99,141,53,38,29,15,395,169,226,73,55,38,9,0
50256,326,154,172,45,39,20,10,293,142,151,49,40,42,17,0
50257,516,210,306,113,53,81,33,364,189,175,58,41,35,17,0
50258,124,58,66,20,28,11,7,1338,720,618,179,145,141,85,0
50259,435,225,210,58,46,50,14,250,119,131,58,26,29,7,0
50260,435,187,248,62,51,51,21,514,248,266,86,82,52,22,0
50261,1594,660,934,251,272,117,77,1265,689,576,169,177,128,60,0
50262,420,248,172,64,30,43,17,218,114,104,32,31,33,11,0
50263,224,101,123,45,32,21,3,1241,619,622,183,169,155,59,0
50264,130,70,60,30,9,8,1,127,58,69,18,17,10,5,0
50265,406,207,199,56,46,68,19,514,248,266,86,82,52,22,0
50266,420,189,231,79,67,33,17,245,131,114,30,27,18,13,0
50267,312,164,148,54,29,25,15,671,306,365,114,76,49,19,0
50268,828,368,460,118,98,59,38,664,350,314,86,90,82,36,0
50269,1284,511,773,227,166,169,107,229,120,109,31,30,22,9,0
50270,490,198,292,65,81,39,27,1061,543,518,146,123,109,67,0
50271,949,467,482,126,127,102,51,328,199,129,39,29,27,14,0
50272,828,368,460,118,98,59,38,392,214,178,48,40,53,22,0
50273,463,250,213,56,45,73,25,132,61,71,22,21,15,3,0
50274,235,100,135,36,25,30,8,480,255,225,67,64,50,22,0
50275,785,325,460,114,123,61,28,775,407,368,122,100,97,32,0
50276,318,164,154,52,43,34,10,561,279,282,85,81,88,24,0
50277,314,178,136,42,32,30,17,250,116,134,41,30,33,19,0
50278,781,367,414,60,67,43,17,283,160,123,25,20,37,9,0
50279,1647,794,853,279,235,128,65,647,324,323,101,80,76,43,0
50280,557,250,307,70,47,51,22,374,212,162,48,40,32,23,0
50281,220,121,99,28,26,17,6,294,146,148,50,45,51,15,0
50282,436,209,227,66,47,52,22,132,77,55,20,9,13,10,0
50283,125,53,72,18,21,18,12,741,383,358,92,63,79,36,0
50284,272,141,131,45,29,36,9,617,314,303,96,68,68,37,0
50285,385,203,182,47,43,51,21,198,115,83,30,22,8,8,0
50286,161,75,86,24,20,10,7,858,398,460,126,138,75,39,0
50287,439,205,234,64,88,41,21,179,101,78,25,15,13,13,0
50288,271,136,135,37,30,18,10,265,134,131,48,34,33,15,0
50289,622,354,268,89,60,64,18,579,285,294,78,72,64,32,0
50290,548,250,298,85,64,56,21,325,172,153,44,34,27,14,0
50291,1462,711,751,219,222,148,65,316,159,157,38,48,30,11,0
50292,86,50,36,9,14,8,7,399,190,209,61,41,39,18,0
50293,287,124,163,52,48,24,16,323,142,181,67,26,45,33,0
50294,230,114,116,30,33,29,8,323,171,152,48,41,40,16,0
50295,567,266,301,139,46,76,37,338,169,169,53,44,39,21,0
50296,536,237,299,116,87,42,17,218,117,101,35,32,34,12,0
50297,313,158,155,43,35,43,16,1922,923,999,267,275,215,90,0
50298,159,105,54,22,9,14,25,464,236,228,64,56,53,28,0
50299,160,53,107,31,29,13,3,395,169,226,73,55,38,9,0
50300,478,177,301,109,66,59,25,1047,562,485,141,127,114,41,0
50301,1689,821,868,277,250,177,78,1239,659,580,169,148,131,54,0
50302,361,183,178,50,54,51,22,1537,701,836,209,187,129,58,0
50303,270,130,140,43,24,36,10,323,168,155,51,41,38,12,0
50304,260,120,140,34,39,36,12,245,121,124,37,35,36,12,0
50305,283,172,111,39,31,29,8,654,295,359,99,88,71,25,0
50306,508,267,241,43,35,25,17,374,212,162,48,40,32,23,0
50307,318,164,154,52,43,34,10,377,184,193,50,43,33,17,0
50308,313,148,165,45,33,36,11,130,67,63,24,10,12,4,0
50309,279,106,173,48,35,41,39,421,219,202,68,57,56,13,0
50310,732,355,377,108,109,79,27,391,189,202,55,56,56,12,0
50311,594,248,346,104,109,53,5,737,397,340,87,104,90,14,0
50312,150,60,90,27,16,6,3,231,126,105,28,26,34,9,0
50313,1043,479,564,200,131,123,62,1314,693,621,174,155,140,58,0
50314,350,190,160,48,25,27,18,218,111,107,45,29,24,6,0
50315,734,366,368,121,99,63,39,627,289,338,101,73,62,43,0
50316,126,57,69,31,10,10,3,257,126,131,61,24,22,8,0
50317,404,197,207,60,48,47,20,213,129,84,32,14,21,15,0
50318,371,209,162,46,17,36,19,520,272,248,60,65,58,22,0
50319,584,340,244,77,60,47,25,398,200,198,68,43,51,14,0
50320,272,136,136,32,34,12,12,127,64,63,26,8,12,8,0
50321,1580,742,838,208,146,144,71,1382,508,874,334,320,98,36,0
50322,687,351,336,106,67,70,41,1755,905,850,214,196,183,79,0
50323,346,174,172,36,43,21,9,270,162,108,26,26,16,11,0
50324,1560,778,782,224,235,132,78,393,210,183,58,37,34,20,0
50325,107,36,71,27,15,0,1,2724,1157,1567,269,518,239,77,0
50326,310,141,169,36,38,20,8,196,105,91,40,13,19,10,0
50327,919,444,475,141,148,62,20,818,357,461,122,136,54,25,0
50328,801,331,470,151,139,99,55,1061,543,518,146,123,109,67,0
50329,343,189,154,44,24,39,12,264,138,126,33,34,29,12,0
50330,390,199,191,72,42,35,12,124,69,55,14,7,9,4,0
50331,391,203,188,49,34,36,9,531,277,254,82,75,33,22,0
50332,514,226,288,71,66,63,32,257,139,118,64,17,24,7,0
50333,269,156,113,37,32,17,7,403,184,219,75,51,47,20,0
50334,627,237,390,137,57,108,44,222,127,95,23,28,22,7,0
50335,414,206,208,56,68,35,19,72,34,38,8,2,3,12,0
50336,538,263,275,71,85,44,18,536,251,285,75,79,60,23,0
50337,666,204,462,110,194,42,14,660,332,328,84,73,47,19,0
50338,941,459,482,167,140,82,38,404,190,214,55,55,35,27,0
50339,450,227,223,53,36,48,12,404,190,214,55,55,35,27,0
50340,288,104,184,80,30,39,6,87,51,35,15,9,9,4,0
50341,467,233,234,83,37,77,22,408,221,187,55,51,57,14,0
50342,246,111,135,64,47,27,3,393,210,183,58,37,34,20,0
50343,734,339,395,135,89,78,36,352,207,145,40,33,25,21,0
50344,867,415,452,123,87,62,27,337,152,185,49,54,42,21,0
50345,213,104,109,56,14,9,2,175,91,84,19,21,21,10,0
50346,867,415,452,123,87,62,27,461,223,238,45,62,18,35,0
50347,1499,864,635,141,99,76,110,241,127,114,34,33,29,12,0
50348,746,312,434,129,115,77,47,279,142,137,43,39,28,7,0
50349,584,340,244,77,60,47,25,376,189,187,47,53,44,26,0
50350,249,114,135,47,33,25,4,229,120,109,31,30,22,9,0
50351,525,302,223,56,48,67,19,154,78,76,23,21,13,5,0
50352,458,210,248,39,38,25,16,349,200,149,41,39,30,20,0
50353,2063,1024,1039,175,117,80,97,123,61,62,17,18,17,7,0
50354,435,187,248,62,51,51,21,354,188,166,46,40,34,10,0
50355,500,297,203,66,33,53,15,459,260,199,56,42,47,21,0
50356,813,412,401,114,93,112,26,198,113,85,19,20,26,12,0
50357,264,122,142,46,24,35,10,751,394,357,107,96,73,35,0
50358,1030,567,463,118,106,94,49,465,252,213,73,58,60,18,0
50359,251,131,120,49,35,25,5,756,348,408,101,103,60,40,0
50360,513,276,237,73,43,57,24,1922,923,999,267,275,215,90,0
50361,93,55,38,13,8,9,7,360,219,141,33,26,65,22,0
50362,234,108,126,42,40,15,9,630,321,309,86,90,57,26,0
50363,361,177,184,59,51,24,15,277,138,139,40,39,20,14,0
50364,837,381,456,123,109,65,25,360,185,175,51,43,36,16,0
50365,418,163,255,57,54,38,24,381,186,195,69,55,46,15,0
50366,159,105,54,22,9,14,25,380,211,169,47,37,33,21,0
50367,531,259,272,75,81,39,13,277,152,125,31,35,22,19,0
50368,193,110,83,18,20,15,12,196,105,91,40,13,19,10,0
50369,651,357,294,81,67,103,18,283,160,123,25,20,37,9,0
50370,119,59,60,29,10,6,4,1061,543,518,146,123,109,67,0
50371,284,160,124,37,23,32,11,928,440,488,111,157,82,35,0
50372,442,254,188,46,22,40,19,354,183,171,54,43,49,8,0
50373,496,272,224,70,58,42,18,282,134,148,38,45,29,10,0
50374,1004,498,506,94,59,46,33,406,223,183,61,53,46,17,0
50375,365,222,143,44,24,35,11,308,146,162,42,39,24,12,0
50376,251,131,120,49,35,25,5,724,353,371,94,95,71,31,0
50377,412,193,219,69,57,43,14,572,305,267,74,72,58,21,0
50378,161,99,62,15,22,9,7,1425,670,755,153,189,122,85,0
50379,746,312,434,129,115,77,47,165,87,78,24,19,22,9,0
50380,237,127,110,34,30,16,9,447,212,235,86,55,58,21,0
50381,519,245,274,58,61,34,22,127,66,61,13,14,19,8,0
50382,443,250,193,52,23,49,13,465,252,213,73,58,60,18,0
50383,580,240,340,108,81,59,22,375,176,199,48,61,40,12,0
50384,728,358,370,118,100,55,29,424,179,245,65,67,29,11,0
50385,714,260,454,140,97,120,54,286,160,126,37,27,23,10,0
50386,820,333,487,202,152,59,23,286,152,134,38,38,32,11,0
50387,577,342,235,63,57,23,37,630,321,309,86,90,57,26,0
50388,636,288,348,94,77,65,30,282,134,148,38,45,29,10,0
50389,607,294,313,94,95,62,14,720,357,363,113,85,62,39,0
50390,1709,650,1059,338,286,185,46,305,163,142,38,27,47,11,0
50391,388,244,144,46,25,42,16,164,79,85,28,28,16,7,0
50392,535,217,318,87,106,41,14,866,478,388,121,101,101,26,0
50393,574,269,305,91,63,54,27,929,459,470,140,120,94,45,0
50394,184,88,96,15,40,17,8,561,279,282,85,81,88,24,0
50395,403,176,227,71,56,51,11,127,64,63,26,8,12,8,0
50396,371,209,162,46,17,36,19,65,32,33,16,4,8,3,0
50397,813,412,401,114,93,112,26,548,296,252,71,74,43,28,0
50398,493,281,212,56,61,30,13,331,180,151,46,35,47,17,0
50399,431,202,229,57,50,50,25,225,111,114,32,34,32,16,0
50400,531,284,247,66,42,49,15,579,285,294,78,72,64,32,0
50401,340,181,159,44,39,35,21,266,146,120,41,28,31,7,0
50402,426,196,230,76,65,54,20,188,93,95,33,18,16,10,0
50403,350,190,160,48,25,27,18,538,274,264,84,67,52,35,0
50404,2062,706,1356,414,368,158,63,102,51,51,12,15,12,3,0
50405,345,208,137,44,27,33,8,1338,720,618,179,145,141,85,0
50406,462,233,229,66,49,43,30,166,102,64,19,14,17,2,0
50407,473,212,261,72,64,45,28,348,212,136,53,31,25,18,0
50408,629,374,255,74,53,87,27,555,292,263,75,63,67,27,0
50409,417,176,241,75,61,51,20,582,264,318,84,60,58,23,0
50410,193,107,86,13,20,13,6,649,307,342,71,134,45,17,0
50411,1872,837,1035,280,338,169,80,748,359,389,125,113,86,31,0
50412,244,104,140,52,31,30,14,106,46,60,29,13,14,5,0
50413,631,304,327,98,75,52,23,748,359,389,125,113,86,31,0
50414,126,57,69,31,10,10,3,194,106,88,33,10,15,6,0
50415,126,66,60,24,10,7,9,592,249,343,91,90,50,42,0
50416,750,347,403,105,103,83,29,222,110,112,43,30,14,6,0
50417,502,250,252,70,47,57,15,169,84,85,29,19,21,7,0
50418,454,230,224,63,56,38,33,425,177,248,60,62,33,16,0
50419,862,384,478,127,110,75,42,277,163,114,33,24,21,16,0
50420,802,375,427,133,103,81,41,403,192,211,102,39,49,15,0
50421,218,133,85,20,19,13,6,277,124,153,44,40,35,18,0
50422,682,260,422,153,78,109,46,501,249,252,77,70,55,22,0
50423,743,366,377,41,37,26,14,452,231,221,74,53,56,20,0
50424,963,477,486,134,143,123,38,223,113,110,31,33,22,12,0
50425,480,267,213,49,44,70,21,588,286,302,78,99,53,25,0
50426,333,171,162,41,44,48,23,373,189,184,54,46,50,23,0
50427,651,357,294,81,67,103,18,392,214,178,48,40,53,22,0
50428,447,232,215,55,65,50,25,720,357,363,113,85,62,39,0
50429,629,338,291,92,57,64,22,447,212,235,86,55,58,21,0
50430,563,255,308,91,111,42,30,972,471,501,152,138,112,40,0
50431,1064,495,569,157,159,124,58,192,91,101,29,28,17,7,0
50432,755,271,484,113,226,61,20,323,171,152,48,41,40,16,0
50433,1755,849,906,245,226,148,56,142,73,69,27,9,15,11,0
50434,346,208,138,46,39,51,18,414,203,211,58,56,48,14,0
50435,412,146,266,106,38,67,35,452,254,198,72,57,38,18,0
50436,1556,718,838,280,182,161,49,190,93,97,35,27,23,2,0
50437,2279,996,1283,375,328,158,60,465,252,213,73,58,60,18,0
50438,313,134,179,58,37,43,19,374,212,162,48,40,32,23,0
50439,218,108,110,25,33,25,13,215,114,101,21,32,26,12,0
50440,786,378,408,106,98,77,39,671,306,365,114,76,49,19,0
50441,106,43,63,28,13,8,1,862,409,453,149,125,86,29,0
50442,270,131,139,47,37,41,11,283,142,141,41,33,26,18,0
50443,279,129,150,43,34,17,13,267,141,126,53,27,23,7,0
50444,454,230,224,63,56,38,33,153,80,73,26,18,19,4,0
50445,398,186,212,76,70,18,13,123,61,62,17,18,17,7,0
50446,502,229,273,63,66,40,31,463,259,204,62,55,34,22,0
50447,443,250,193,52,23,49,13,579,285,294,78,72,64,32,0
50448,186,56,130,46,50,16,7,751,394,357,107,96,73,35,0
50449,1970,978,992,245,206,198,80,329,196,133,41,36,31,15,0
50450,898,397,501,102,98,54,37,621,273,348,104,102,48,19,0
50451,165,66,99,28,32,16,3,1025,549,476,118,109,88,61,0
50452,446,195,251,56,53,31,15,331,180,151,46,35,47,17,0
50453,206,100,106,34,26,11,7,673,313,360,102,101,46,17,0
50454,331,144,187,57,46,33,19,548,296,252,71,74,43,28,0
50455,732,355,377,108,109,79,27,478,254,224,67,74,56,28,0
50456,557,250,307,70,47,51,22,201,117,83,22,21,19,9,0
50457,822,416,406,111,97,88,42,1061,543,518,146,123,109,67,0
50458,284,160,124,37,23,32,11,131,55,76,28,9,14,12,0
50459,1161,514,647,159,138,122,37,524,300,223,70,54,51,25,0
50460,242,111,131,35,35,17,13,485,244,241,80,55,59,20,0
50461,313,158,155,43,35,43,16,331,180,151,46,35,47,17,0
50462,772,417,355,118,92,80,23,926,340,586,133,119,60,40,0
50463,2136,1063,1073,317,308,223,90,104,46,58,15,17,9,5,0
50464,375,201,174,52,56,39,15,1395,627,768,172,263,141,59,0
50465,411,211,200,61,46,35,18,630,321,309,86,90,57,26,0
50466,138,35,103,38,2,15,9,277,144,133,42,30,41,8,0
50467,312,173,139,43,47,28,6,72,34,38,8,2,3,12,0
50468,456,223,233,77,54,47,20,125,66,59,24,16,11,5,0
50469,1395,595,800,223,206,113,61,134,55,79,22,24,16,6,0
50470,246,111,135,64,47,27,3,295,160,135,44,36,46,16,0
50471,102,22,80,48,8,18,6,515,276,239,62,59,43,31,0
50472,474,243,231,66,54,41,29,501,240,261,80,62,49,42,0
50473,260,133,127,43,29,34,11,107,77,30,7,2,9,5,0
50474,2048,855,1193,297,287,191,93,245,121,124,37,35,36,12,0
50475,362,181,181,67,46,43,8,1113,480,633,170,173,81,34,0
50476,302,160,142,35,35,37,10,242,121,121,39,30,29,10,0
50477,125,46,79,24,16,12,2,374,191,183,40,52,40,16,0
50478,164,81,83,37,8,14,10,607,293,314,98,71,62,32,0
50479,2446,1099,1347,363,294,233,100,201,104,97,36,32,24,7,0
50480,302,178,124,34,29,50,13,424,179,245,65,67,29,11,0
50481,269,127,142,43,24,34,26,175,82,93,33,26,17,5,0
50482,306,172,134,35,31,37,18,862,426,436,113,115,84,37,0
50483,786,378,408,106,98,77,39,627,289,338,101,73,62,43,0
50484,2286,1154,1132,338,314,278,103,222,119,103,37,32,24,8,0
50485,275,160,115,40,31,34,17,277,124,153,44,40,35,18,0
50486,898,397,501,102,98,54,37,404,190,214,55,55,35,27,0
50487,328,195,133,36,23,35,9,396,223,173,57,37,44,19,0
50488,743,377,366,87,74,68,30,457,253,204,67,51,48,13,0
50489,594,321,273,98,59,57,23,106,54,52,12,9,7,6,0
50490,960,409,551,166,134,77,44,483,287,196,71,50,54,17,0
50491,251,139,112,41,18,27,11,247,128,119,34,14,16,14,0
50492,571,298,273,81,72,57,25,582,264,318,84,60,58,23,0
50493,335,155,180,64,48,36,10,482,232,250,77,81,44,13,0
50494,360,205,155,35,24,52,14,295,158,137,42,34,38,14,0
50495,282,105,177,77,28,39,6,212,127,85,28,21,26,6,0
50496,117,58,59,17,17,12,2,194,109,85,23,24,21,9,0
50497,377,171,206,46,59,22,6,336,190,146,52,30,41,6,0
50498,432,233,199,52,28,47,18,621,273,348,104,102,48,19,0
50499,1161,514,647,159,138,122,37,305,163,142,38,27,47,11,0
50500,361,177,184,59,51,24,15,1020,538,482,145,115,111,58,0
50501,1009,478,531,166,126,96,42,417,232,185,58,50,29,21,0
50502,501,230,271,63,90,50,18,463,259,204,62,55,34,22,0
50503,291,142,149,50,29,35,7,278,154,124,42,32,38,7,0
50504,726,312,414,121,73,82,23,501,240,261,80,62,49,42,0
50505,458,210,248,39,38,25,16,323,162,161,52,41,39,13,0
50506,607,305,302,92,89,74,23,524,300,223,70,54,51,25,0
50507,444,250,194,58,21,60,23,337,152,185,49,54,42,21,0
50508,862,384,478,127,110,75,42,602,310,292,87,66,70,36,0
50509,856,429,427,113,105,96,24,163,79,84,22,24,13,5,0
50510,505,282,223,60,57,66,23,337,152,185,49,54,42,21,0
50511,224,108,116,31,32,22,8,309,164,145,35,47,30,11,0
50512,852,472,380,99,79,70,27,295,156,139,41,40,42,15,0
50513,2220,1085,1135,312,304,202,91,334,182,152,45,41,27,13,0
50514,136,65,71,33,11,9,6,699,334,365,108,80,70,20,0
50515,166,59,107,36,41,10,4,900,441,459,125,127,110,32,0
50516,107,53,54,15,15,13,4,86,40,46,16,13,9,7,0
50517,146,75,71,13,32,15,11,392,186,206,62,56,29,15,0
50518,425,220,205,60,55,45,18,501,257,244,75,57,48,29,0
50519,126,57,69,31,10,10,3,461,223,238,45,62,18,35,0
50520,225,111,114,38,22,25,10,640,364,276,84,68,69,33,0
50521,172,98,74,20,21,22,8,520,272,248,60,65,58,22,0
50522,238,91,147,68,19,22,7,496,285,211,62,54,46,22,0
50523,559,217,342,105,86,42,16,173,94,79,18,24,12,7,0
50524,2649,1431,1218,377,299,266,102,127,66,61,13,14,19,8,0
50525,399,220,179,48,37,68,18,73,35,38,14,10,9,4,0
50526,238,91,147,68,19,22,7,620,324,296,81,68,66,31,0
50527,406,208,198,41,26,43,21,375,211,164,50,36,31,23,0
50528,281,125,156,44,47,17,7,1101,626,475,145,122,120,50,0
50529,527,254,273,67,66,70,31,271,150,121,39,36,37,5,0
50530,595,316,279,86,60,65,40,276,149,127,34,31,32,10,0
50531,575,290,285,67,70,28,9,778,391,387,94,77,41,33,0
50532,1339,494,845,216,298,92,37,975,475,500,139,140,119,28,0
50533,911,489,422,121,98,97,36,111,60,51,17,23,10,7,0
50534,135,64,71,31,11,8,4,392,214,178,48,40,53,22,0
50535,579,321,258,74,70,47,22,663,354,309,91,84,79,31,0
50536,588,317,271,78,49,54,17,188,88,100,53,12,15,6,0
50537,595,339,256,64,36,54,24,1034,495,539,150,134,114,71,0
50538,1580,742,838,208,146,144,71,173,94,79,18,24,12,7,0
50539,531,284,247,66,42,49,15,337,152,185,49,54,42,21,0
50540,454,214,240,56,71,35,16,403,184,219,75,51,47,20,0
50541,179,96,83,24,8,26,4,101,59,42,11,17,10,1,0
50542,685,393,292,75,66,113,16,1537,701,836,209,187,129,58,0
50543,255,136,119,39,20,32,10,437,224,213,40,29,42,25,0
50544,1058,497,561,194,142,87,63,368,200,168,54,49,43,9,0
50545,299,151,148,35,34,26,16,673,313,360,102,101,46,17,0
50546,262,133,129,44,38,31,12,260,133,127,43,32,39,3,0
50547,155,85,70,17,16,4,8,260,131,129,42,31,40,9,0
50548,122,56,66,26,13,11,5,386,181,205,55,51,57,31,0
50549,649,304,345,99,80,67,40,1034,495,539,150,134,114,71,0
50550,490,198,292,65,81,39,27,673,313,360,102,101,46,17,0
50551,2488,1085,1403,346,253,162,76,250,119,131,58,26,29,7,0
50552,450,231,219,77,50,76,16,339,180,159,36,29,16,16,0
50553,1872,837,1035,280,338,169,80,257,126,131,61,24,22,8,0
50554,798,364,434,133,88,74,35,497,257,240,71,63,62,16,0
50555,276,149,127,45,34,39,9,295,160,135,42,37,46,16,0
50556,456,223,233,77,54,47,20,147,74,73,28,20,24,4,0
50557,127,54,73,31,10,11,3,296,159,137,49,28,38,13,0
50558,1030,567,463,118,106,94,49,531,277,254,82,75,33,22,0
50559,575,295,280,89,68,54,18,218,115,103,32,32,34,11,0
50560,320,183,137,51,18,38,8,305,161,144,39,40,44,17,0
50561,425,199,226,54,71,56,11,2525,1232,1293,398,317,186,61,0
50562,618,289,329,97,86,70,17,758,319,439,101,123,78,25,0
50563,494,233,261,87,57,46,18,415,226,189,51,40,40,29,0
50564,1051,429,622,179,148,125,54,144,67,77,28,14,9,8,0
50565,284,108,176,54,80,9,8,165,85,80,29,25,16,13,0
50566,350,172,178,61,45,32,13,241,127,114,34,33,29,12,0
50567,412,208,204,54,47,42,17,292,155,137,50,34,29,13,0
50568,727,426,301,79,71,64,32,392,214,178,48,40,53,22,0
50569,588,317,271,78,49,54,17,305,163,142,38,27,47,11,0
50570,1051,429,622,179,148,125,54,332,173,159,48,40,31,11,0
50571,458,226,232,77,59,61,14,212,127,85,28,21,26,6,0
50572,111,29,82,10,54,0,1,627,323,304,81,90,53,27,0
50573,282,84,198,60,102,1,6,689,343,346,105,102,81,35,0
50574,941,459,482,167,140,82,38,132,67,65,24,21,8,10,0
50575,336,134,202,51,64,27,12,218,111,107,45,29,24,6,0
50576,898,397,501,102,98,54,37,188,93,95,33,18,16,10,0
50577,260,120,140,34,39,36,12,201,117,83,22,21,19,9,0
50578,328,195,133,36,23,35,9,629,317,312,80,87,51,22,0
50579,904,436,468,138,146,82,39,334,182,152,45,41,27,13,0
50580,338,172,166,59,30,39,18,165,87,78,24,19,22,9,0
50581,828,355,473,126,134,77,37,904,436,468,143,118,108,32,0
50582,329,168,161,48,34,41,16,396,197,199,75,49,49,16,0
50583,244,104,140,52,31,30,14,497,257,240,71,63,62,16,0
50584,325,152,173,43,47,28,17,188,93,95,33,18,16,10,0
50585,365,222,143,44,24,35,11,389,210,179,51,37,43,9,0
50586,232,108,124,33,27,19,16,391,165,226,67,64,36,27,0
50587,230,114,116,30,33,29,8,348,194,154,57,31,43,12,0
50588,772,383,389,105,76,82,33,392,186,206,62,56,29,15,0
50589,253,133,120,44,31,22,8,278,154,124,42,32,38,7,0
50590,2414,1189,1225,277,178,170,169,935,515,420,126,107,73,32,0
50591,1217,647,570,142,160,129,45,218,114,104,32,31,33,11,0
50592,348,198,150,57,25,37,18,516,245,271,82,84,70,26,0
50593,365,148,217,86,37,51,28,708,328,380,113,100,82,34,0
50594,278,104,174,46,34,23,14,427,251,176,51,39,25,22,0
50595,203,97,106,30,22,18,10,374,174,200,54,52,42,21,0
50596,240,166,74,32,12,8,15,376,183,193,50,50,43,21,0
50597,139,64,75,18,17,18,4,160,60,100,23,40,19,11,0
50598,1441,504,937,264,329,69,46,621,273,348,104,102,48,19,0
50599,304,149,155,46,32,39,14,169,85,84,21,14,9,9,0
50600,521,249,272,53,36,50,18,556,290,266,75,74,29,24,0
50601,320,163,157,44,44,26,15,535,311,224,66,52,49,24,0
50602,126,57,69,31,10,10,3,137,63,74,20,22,14,6,0
50603,326,154,172,45,39,20,10,509,267,242,79,81,38,20,0
50604,439,183,256,60,64,36,14,316,166,150,45,38,37,13,0
50605,728,358,370,118,100,55,29,1065,581,484,134,97,76,46,0
50606,1336,724,612,209,141,133,60,334,181,153,56,31,28,18,0
50607,1501,679,822,251,196,174,67,1873,935,938,233,225,203,79,0
50608,588,317,271,78,49,54,17,132,77,55,20,9,13,10,0
50609,1007,353,654,277,147,70,26,821,394,427,122,117,109,38,0
50610,136,66,70,33,11,9,3,391,189,202,55,56,56,12,0
50611,299,151,148,35,34,26,16,597,269,328,102,84,69,24,0
50612,303,161,142,38,31,42,17,430,212,218,88,43,40,20,0
50613,178,87,91,20,32,13,10,4646,2328,2318,674,639,475,170,0
50614,437,228,209,47,61,26,11,222,127,95,23,28,22,7,0
50615,516,224,292,79,29,45,33,501,240,261,80,62,49,42,0
50616,314,158,156,39,28,30,17,727,388,339,102,87,70,29,0
50617,629,374,255,74,53,87,27,378,154,224,74,84,35,22,0
50618,1849,931,918,245,220,158,90,319,185,134,42,31,22,13,0
50619,1004,464,540,143,104,78,55,203,98,105,34,29,19,10,0
50620,513,276,237,73,43,57,24,338,169,169,53,44,39,21,0
50621,380,185,195,68,54,32,16,232,111,121,23,29,17,9,0
50622,404,197,207,60,48,47,20,374,202,172,50,39,31,24,0
50623,119,67,52,15,15,7,7,91,42,49,21,9,8,3,0
50624,840,411,429,122,101,79,34,538,274,264,84,67,52,35,0
50625,244,104,140,52,31,30,14,198,115,83,30,22,8,8,0
50626,67,40,27,10,8,7,6,605,283,322,94,72,64,39,0
50627,204,109,95,21,35,27,7,278,154,124,42,32,38,7,0
50628,1499,864,635,141,99,76,110,247,128,119,34,14,16,14,0
50629,161,94,67,23,13,8,10,873,411,462,132,107,84,40,0
50630,346,168,178,36,43,20,9,111,60,51,17,23,10,7,0
50631,496,209,287,113,55,72,14,1606,753,853,215,227,182,48,0
50632,1647,794,853,279,235,128,65,445,264,181,35,35,34,14,0
50633,362,174,188,46,55,35,23,152,71,81,41,16,14,2,0
50634,402,169,233,70,36,34,18,517,295,222,69,62,40,28,0
50635,326,154,172,45,39,20,10,644,343,301,96,69,59,28,0
50636,1148,472,676,229,164,86,37,260,131,129,42,31,40,9,0
50637,227,120,107,31,28,28,13,403,192,211,102,39,49,15,0
50638,270,166,104,30,26,28,14,148,69,79,26,18,16,3,0
50639,535,315,220,57,55,71,19,858,398,460,126,138,75,39,0
50640,704,342,362,113,91,85,33,276,149,127,34,31,32,10,0
50641,1221,597,624,201,152,83,31,415,205,210,77,52,55,17,0
50642,217,109,108,30,23,28,10,385,212,173,57,40,39,21,0
50643,956,450,506,122,117,82,36,231,126,105,37,26,29,6,0
50644,2624,999,1625,415,495,109,84,132,61,71,19,20,14,6,0
50645,361,183,178,50,54,51,22,274,157,117,40,29,40,8,0
50646,365,222,143,44,24,35,11,257,126,131,61,24,22,8,0
50647,284,128,156,48,29,34,8,1182,591,591,155,139,83,46,0
50648,139,81,58,17,14,24,9,427,251,176,51,39,25,22,0
50649,326,156,170,60,47,43,5,472,219,253,59,69,31,21,0
50650,119,59,60,29,10,6,4,1214,475,739,177,250,89,49,0
50651,127,48,79,27,20,6,5,660,303,357,97,89,85,33,0
50652,1200,602,598,145,116,110,50,338,169,169,53,44,39,21,0
50653,343,189,154,44,24,39,12,392,155,237,68,61,34,16,0
50654,739,323,416,127,89,76,33,483,215,268,66,70,30,16,0
50655,410,208,202,59,58,43,26,402,186,216,64,47,38,20,0
50656,1365,590,775,257,168,136,93,556,290,266,75,74,29,24,0
50657,441,218,223,69,55,50,27,312,165,147,41,39,29,16,0
50658,911,441,470,123,108,60,21,445,264,181,35,35,34,14,0
50659,220,121,99,28,26,17,6,91,44,47,9,12,4,7,0
50660,335,171,164,51,38,38,10,166,102,64,19,14,17,2,0
50661,76,30,46,7,15,1,5,87,38,49,23,10,10,9,0
50662,142,76,66,21,21,22,11,247,128,119,34,14,16,14,0
50663,2663,1073,1590,548,499,192,64,277,144,133,42,30,41,8,0
50664,76,42,34,12,8,5,7,218,117,101,35,32,34,12,0
50665,311,154,157,47,29,34,13,178,69,109,29,25,21,13,0
50666,894,448,446,123,100,82,30,142,65,77,30,17,22,9,0
50667,887,439,448,137,99,91,38,1378,692,686,194,174,105,56,0
50668,466,199,267,86,59,32,17,323,171,152,48,41,40,16,0
50669,260,136,124,24,41,19,4,319,185,134,42,31,22,13,0
50670,119,59,60,29,10,6,4,519,287,232,68,58,45,21,0
50671,373,164,209,51,45,44,21,530,287,243,79,70,33,26,0
50672,852,472,380,99,79,70,27,137,78,59,22,16,17,4,0
50673,640,308,332,91,102,49,21,445,202,243,70,73,51,15,0
50674,429,238,191,47,49,56,29,548,296,252,71,74,43,28,0
50675,653,379,274,89,56,86,13,160,60,100,23,40,19,11,0
50676,900,434,466,134,97,86,36,72,33,39,8,2,3,12,0
50677,243,100,143,58,50,24,5,290,147,143,34,34,39,13,0
50678,458,210,248,39,38,25,16,396,199,197,54,50,45,14,0
50679,231,105,126,56,10,24,10,617,314,303,96,68,68,37,0
50680,881,492,389,87,97,59,51,528,276,252,86,78,49,17,0
50681,155,85,70,17,16,4,8,498,244,254,81,67,58,19,0
50682,503,260,243,46,56,33,16,1249,638,611,166,153,141,45,0
50683,439,205,234,64,88,41,21,88,50,38,13,8,16,4,0
50684,310,141,169,36,38,20,8,332,155,177,55,51,44,13,0
50685,1531,649,882,108,122,93,72,317,161,156,40,49,41,11,0
50686,416,222,194,58,38,38,20,549,273,276,74,68,72,24,0
50687,1867,973,894,256,222,194,65,200,99,101,31,24,26,6,0
50688,648,376,272,70,60,73,24,341,170,171,41,66,27,10,0
50689,264,122,142,33,29,13,13,1507,737,770,188,228,147,71,0
50690,346,191,155,52,38,40,13,234,129,105,31,22,19,17,0
50691,956,450,506,122,117,82,36,328,199,129,39,29,27,14,0
50692,919,493,426,100,92,88,49,105,51,54,13,17,12,8,0
50693,213,113,100,26,21,26,12,178,69,109,29,25,21,13,0
50694,371,143,228,77,48,29,26,395,169,226,73,55,38,9,0
50695,815,356,459,128,125,82,26,528,276,252,86,78,49,17,0
50696,710,352,358,104,86,84,41,1040,564,476,134,110,114,51,0
50697,341,195,146,42,21,36,9,778,391,387,94,77,41,33,0
50698,179,96,83,24,8,26,4,289,140,149,33,42,30,15,0
50699,317,153,164,34,52,30,14,520,240,280,67,72,42,14,0
50700,543,221,322,78,122,37,12,103,44,59,16,17,9,5,0
50701,684,353,331,95,98,77,38,798,385,413,120,115,79,30,0
50702,270,130,140,43,24,36,10,127,58,69,18,17,10,5,0
50703,398,186,212,76,70,18,13,405,181,224,71,57,31,12,0
50704,261,137,124,34,23,13,8,258,129,129,45,24,31,10,0
50705,346,191,155,52,38,40,13,453,255,198,62,49,29,19,0
50706,221,75,146,68,21,16,5,106,54,52,12,9,7,6,0
50707,729,351,378,111,98,58,18,290,142,148,41,37,43,11,0
50708,126,57,69,31,10,10,3,91,42,49,21,9,8,3,0
50709,298,167,131,47,33,40,8,904,436,468,138,146,82,39,0
50710,485,183,302,79,81,73,33,366,204,162,47,41,31,23,0
50711,2063,1024,1039,175,117,80,97,207,113,94,33,18,30,9,0
50712,420,248,172,64,30,43,17,654,295,359,99,88,71,25,0
50713,626,308,318,105,89,77,25,579,285,294,78,72,64,32,0
50714,1276,607,669,192,178,136,63,220,107,113,36,35,28,9,0
50715,1463,521,942,252,204,105,52,536,267,269,60,70,41,22,0
50716,410,200,210,60,54,46,19,332,180,152,46,36,28,14,0
50717,919,444,475,141,148,62,20,418,246,172,52,39,57,10,0
50718,514,226,288,71,66,63,32,662,312,350,103,104,59,20,0
50719,553,319,234,56,37,54,18,395,198,197,55,55,36,10,0
50720,1214,612,602,169,173,98,35,292,155,137,50,34,29,13,0
50721,650,330,320,97,77,65,28,374,212,162,48,40,32,23,0
50722,228,82,146,45,37,18,8,172,88,84,24,31,20,12,0
50723,139,81,58,17,14,24,9,166,88,78,23,18,13,7,0
50724,856,429,427,113,105,96,24,303,138,165,47,46,35,18,0
50725,972,501,471,125,156,106,39,514,262,252,78,58,54,26,0
50726,334,155,179,47,34,38,11,415,205,210,77,52,55,17,0
50727,441,216,225,57,66,57,19,535,288,247,79,72,35,21,0
50728,109,42,67,25,13,1,1,222,122,100,39,32,24,9,0
50729,332,173,159,48,42,42,9,535,311,224,66,52,49,24,0
50730,463,225,238,76,36,59,26,339,180,159,36,29,16,16,0
50731,163,70,93,28,21,17,6,137,72,65,27,13,15,8,0
50732,805,338,467,153,138,99,55,103,50,53,19,10,7,5,0
50733,496,209,287,113,55,72,14,514,262,252,78,58,54,26,0
50734,546,265,281,101,64,38,16,403,225,178,56,38,33,25,0
50735,4128,2104,2024,581,505,453,205,213,129,84,32,14,21,15,0
50736,313,148,165,45,33,36,11,127,64,63,26,8,12,8,0
50737,1647,794,853,279,235,128,65,978,536,442,132,107,67,32,0
50738,474,243,231,66,54,41,29,975,400,575,160,162,62,31,0
50739,1099,491,608,163,141,107,62,530,287,243,79,70,33,26,0
50740,594,248,346,104,109,53,5,526,266,260,76,75,53,22,0
50741,362,181,181,67,46,43,8,139,68,71,14,26,14,9,0
50742,364,172,192,55,57,32,15,562,273,289,76,92,45,24,0
50743,257,148,109,28,20,21,14,727,362,365,123,107,63,23,0
50744,393,223,170,44,36,32,14,175,82,93,33,26,17,5,0
50745,452,217,235,59,47,60,20,267,141,126,53,27,23,7,0
50746,496,274,222,57,43,75,22,380,211,169,47,37,33,21,0
50747,798,287,511,126,125,77,26,429,187,242,79,72,28,19,0
50748,155,85,70,17,16,4,8,396,199,197,54,50,45,14,0
50749,733,382,351,126,92,93,27,514,262,252,78,58,54,26,0
50750,242,104,138,41,33,37,8,301,168,133,49,37,34,11,0
50751,365,210,155,46,30,24,12,1279,669,610,164,162,104,55,0
50752,234,108,126,42,40,15,9,287,151,136,51,42,36,7,0
50753,500,297,203,66,33,53,15,261,148,113,31,28,14,10,0
50754,379,217,162,47,20,50,23,1873,935,938,233,225,203,79,0
50755,117,58,59,17,17,12,2,410,197,213,67,43,56,18,0
50756,127,48,79,27,20,6,5,258,129,129,45,24,31,10,0
50757,367,167,200,63,42,60,17,773,389,384,119,91,79,26,0
50758,347,198,149,45,29,29,8,180,90,90,31,19,20,8,0
50759,335,171,164,51,38,38,10,660,303,357,97,89,85,33,0
50760,127,55,72,25,18,5,7,354,183,171,54,43,49,8,0
50761,881,492,389,87,97,59,51,194,109,85,23,24,21,9,0
50762,297,182,115,41,22,23,8,230,113,117,31,40,28,10,0
50763,535,217,318,87,106,41,14,1101,626,475,145,122,120,50,0
50764,625,283,342,93,89,67,25,277,163,114,33,24,21,16,0
50765,202,103,99,28,20,12,8,480,255,225,67,64,50,22,0
50766,202,103,99,28,20,12,8,501,257,244,75,57,48,29,0
50767,785,351,434,136,93,71,37,367,199,168,62,44,34,8,0
50768,71,39,32,7,11,6,4,556,290,266,75,74,29,24,0
50769,646,304,342,104,93,58,26,287,151,136,51,42,36,7,0
50770,443,206,237,76,68,52,28,148,69,79,26,18,16,3,0
50771,478,177,301,109,66,59,25,501,257,244,75,57,48,29,0
50772,395,219,176,47,41,50,18,593,289,304,85,69,48,19,0
50773,1052,492,560,184,163,103,44,902,499,403,118,117,92,35,0
50774,332,172,160,50,33,35,9,289,140,149,33,42,30,15,0
50775,1499,864,635,141,99,76,110,953,489,464,126,104,111,44,0
50776,1531,649,882,108,122,93,72,239,113,126,36,49,20,8,0
50777,1560,778,782,224,235,132,78,295,158,137,42,34,38,14,0
50778,478,177,301,109,66,59,25,601,278,323,124,87,65,21,0
50779,574,269,305,91,63,54,27,496,285,211,62,54,46,22,0
50780,184,88,96,15,40,17,8,2542,1245,1297,285,287,170,84,0
50781,270,158,112,35,20,23,7,1241,619,622,183,169,155,59,0
50782,410,211,199,55,42,34,27,367,199,168,62,44,34,8,0
50783,193,105,88,33,16,9,4,180,89,91,28,27,18,7,0
50784,443,206,237,76,68,52,28,1500,804,696,190,172,144,60,0
50785,522,302,220,61,49,75,19,445,192,253,86,58,53,18,0
50786,785,325,460,114,123,61,28,101,59,42,11,17,10,1,0
50787,427,191,236,67,60,41,34,406,223,183,61,53,46,17,0
50788,335,171,164,51,38,38,10,485,244,241,80,55,59,20,0
50789,146,75,71,13,32,15,11,2346,1231,1115,316,292,266,105,0
50790,259,119,140,48,28,29,19,1065,581,484,134,97,76,46,0
50791,359,204,155,39,36,34,13,332,173,159,48,40,31,11,0
50792,130,71,59,30,9,8,1,508,253,255,73,60,50,13,0
50793,1148,472,676,229,164,86,37,843,391,452,139,104,91,35,0
50794,301,157,144,31,28,34,9,218,115,103,32,32,34,11,0
50795,584,297,287,89,80,65,17,592,249,343,91,90,50,42,0
50796,415,217,198,50,31,42,17,425,177,248,60,62,33,16,0
50797,687,351,336,106,67,70,41,188,90,98,44,7,21,7,0
50798,412,203,209,65,47,37,18,1262,653,609,169,165,152,50,0
50799,255,110,145,34,32,23,17,207,113,94,33,18,30,9,0
50800,1590,726,864,270,237,126,59,207,113,94,33,18,30,9,0
50801,158,85,73,24,18,18,8,418,246,172,52,39,57,10,0
50802,394,207,187,52,42,37,24,459,260,199,56,42,47,21,0
50803,730,298,432,128,69,86,26,621,273,348,104,102,48,19,0
50804,269,156,113,37,32,17,7,166,88,78,23,18,13,7,0
50805,284,128,156,48,29,34,8,250,116,134,41,30,33,19,0
50806,1709,650,1059,338,286,185,46,209,119,90,28,24,27,9,0
50807,393,185,208,59,50,36,22,680,308,372,82,72,71,40,0
50808,684,353,331,95,98,77,38,1873,935,938,233,225,203,79,0
50809,401,204,197,49,33,29,17,778,391,387,94,77,41,33,0
50810,130,70,60,30,9,8,1,261,127,134,36,27,36,4,0
50811,493,281,212,56,61,30,13,166,90,76,27,18,21,5,0
50812,361,183,178,50,54,51,22,551,226,325,96,103,43,11,0
50813,605,277,328,99,54,63,43,132,67,65,24,21,8,10,0
50814,217,109,108,30,23,28,10,761,351,410,117,73,103,45,0
50815,270,131,139,47,37,41,11,397,234,163,44,38,23,21,0
50816,338,208,130,39,30,35,12,732,402,330,81,86,87,33,0
50817,215,80,135,54,56,21,9,564,264,300,79,84,65,26,0
50818,237,127,110,34,30,16,9,925,439,486,141,134,105,46,0
50819,342,185,157,42,27,31,14,572,305,267,74,72,58,21,0
50820,493,208,285,75,77,70,40,1265,689,576,169,177,128,60,0
50821,233,110,123,34,22,34,9,332,180,152,44,36,27,13,0
50822,207,89,118,56,8,4,3,439,231,208,65,51,55,17,0
50823,304,149,155,46,32,39,14,251,143,108,47,25,29,11,0
50824,426,214,212,63,47,53,20,256,141,115,32,22,32,8,0
50825,240,166,74,32,12,8,15,297,175,122,46,30,31,6,0
50826,270,130,140,43,24,36,10,392,155,237,68,61,34,16,0
50827,1085,646,439,108,65,36,19,247,128,119,34,14,16,14,0
50828,126,57,69,31,10,10,3,364,189,175,58,41,35,17,0
50829,500,245,255,66,57,52,27,72,33,39,8,2,3,12,0
50830,238,91,147,68,19,22,7,536,267,269,60,70,41,22,0
50831,457,228,229,64,36,52,21,1001,417,584,186,147,96,47,0
50832,392,205,187,83,49,38,10,119,61,58,17,12,10,6,0
50833,458,226,232,77,59,61,14,463,259,204,62,55,34,22,0
50834,1107,601,506,155,138,103,49,418,223,195,53,43,49,15,0
50835,522,302,220,61,49,75,19,1166,514,652,150,159,107,70,0
50836,869,489,380,110,77,79,29,137,63,74,20,22,14,6,0
50837,358,212,146,51,36,33,9,102,51,51,12,15,12,3,0
50838,579,246,333,102,79,41,19,701,380,321,94,84,96,34,0
50839,270,130,140,43,24,36,10,145,77,68,26,7,15,8,0
50840,949,467,482,126,127,102,51,201,117,83,22,21,19,9,0
50841,270,130,140,43,24,36,10,156,90,66,17,22,11,10,0
50842,193,107,86,13,20,13,6,756,348,408,101,103,60,40,0
50843,417,222,195,53,39,43,10,415,203,212,77,44,49,18,0
50844,188,84,104,35,36,18,9,611,314,297,79,75,78,22,0
50845,2286,1154,1132,338,314,278,103,858,461,397,125,114,79,45,0
50846,126,58,68,31,10,10,3,299,140,159,49,44,26,11,0
50847,784,353,431,56,47,26,18,520,272,248,60,65,58,22,0
50848,1390,705,685,219,164,129,74,402,186,216,64,47,38,20,0
50849,1105,544,561,165,167,99,40,445,192,253,86,58,53,18,0
50850,260,136,124,24,41,19,4,169,85,84,21,14,9,9,0
50851,361,177,184,59,51,24,15,137,85,52,15,11,11,2,0
50852,421,237,184,47,54,45,10,406,223,183,61,53,46,17,0
50853,579,281,298,91,78,74,27,858,398,460,126,138,75,39,0
50854,350,190,160,48,25,27,18,497,257,240,71,63,62,16,0
50855,450,231,219,77,50,76,16,462,229,233,63,49,42,18,0
50856,431,216,215,46,40,33,9,133,61,72,21,19,13,4,0
50857,960,409,551,166,134,77,44,662,373,289,89,80,77,29,0
50858,392,205,187,83,49,38,10,403,184,219,75,51,47,20,0
50859,447,236,211,56,52,49,14,225,111,114,32,34,32,16,0
50860,588,317,271,78,49,54,17,953,489,464,126,104,111,44,0
50861,347,181,166,27,20,12,12,135,65,70,21,25,15,9,0
50862,367,167,200,63,42,60,17,664,350,314,86,90,82,36,0
50863,131,69,62,29,9,9,1,536,251,285,75,79,60,23,0
50864,142,76,66,21,21,22,11,975,400,575,160,162,62,31,0
50865,582,328,254,78,48,35,9,617,314,303,96,68,68,37,0
50866,122,56,66,26,13,11,5,244,143,101,31,29,26,8,0
50867,1365,590,775,257,168,136,93,381,186,195,69,55,46,15,0
50868,139,64,75,18,17,18,4,188,93,95,33,18,16,10,0
50869,301,156,145,32,25,15,5,445,192,253,86,58,53,18,0
50870,801,331,470,151,139,99,55,373,189,184,54,46,50,23,0
50871,580,281,299,95,60,74,29,498,244,254,81,67,58,19,0
50872,454,214,240,56,71,35,16,160,76,84,19,24,8,5,0
50873,431,245,186,50,23,46,17,467,231,236,71,65,58,18,0
50874,793,355,438,134,117,77,43,556,290,266,75,74,29,24,0
50875,802,430,372,65,102,87,23,392,214,178,48,40,53,22,0
50876,118,56,62,24,12,6,9,396,213,183,68,44,47,18,0
50877,407,164,243,88,42,40,22,464,236,228,64,56,53,28,0
50878,1054,453,601,183,183,107,35,309,159,150,47,43,43,13,0
50879,854,435,419,118,91,95,42,239,113,126,36,49,20,8,0
50880,71,28,43,15,9,5,2,246,107,139,55,33,27,11,0
50881,127,55,72,25,18,5,7,234,129,105,31,22,19,17,0
50882,179,96,83,24,8,26,4,1248,584,664,184,164,155,67,0
50883,142,76,66,21,21,22,11,397,234,163,44,38,23,21,0
50884,1755,849,906,245,226,148,56,302,150,152,56,40,52,15,0
50885,1085,646,439,108,65,36,19,175,82,93,33,26,17,5,0
50886,420,248,172,64,30,43,17,277,145,132,41,32,22,10,0
50887,451,278,173,71,35,58,12,164,79,85,28,28,16,7,0
50888,763,371,392,104,88,52,23,276,149,127,34,31,32,10,0
50889,76,30,46,7,15,1,5,295,160,135,42,37,46,16,0
50890,773,383,390,108,76,79,30,699,334,365,108,80,70,20,0
50891,640,279,361,102,83,69,21,1425,670,755,153,189,122,85,0
50892,424,170,254,69,56,47,28,188,105,83,25,17,24,7,0
50893,436,201,235,54,37,35,18,332,173,159,48,40,31,11,0
50894,227,109,118,42,35,29,8,376,189,187,47,53,44,26,0
50895,824,391,433,106,90,88,32,2382,1162,1220,237,220,140,49,0
50896,130,71,59,30,9,8,2,135,65,70,21,25,15,9,0
50897,2220,1085,1135,312,304,202,91,200,89,111,26,25,17,7,0
50898,240,167,73,32,12,8,21,132,61,71,22,21,15,3,0
50899,282,105,177,77,28,39,6,166,102,64,19,14,17,2,0
50900,502,250,252,70,47,57,15,225,129,96,32,33,20,8,0
50901,107,53,54,15,15,13,4,761,351,410,117,73,103,45,0
50902,136,66,70,33,11,9,4,220,107,113,36,35,28,9,0
50903,347,198,149,45,29,29,8,773,389,384,119,91,79,26,0
50904,130,71,59,30,9,8,2,108,59,49,17,13,12,5,0
50905,385,179,206,58,56,38,19,256,141,115,32,22,32,8,0
50906,798,364,434,133,88,74,35,132,77,55,20,9,13,10,0
50907,278,104,174,46,34,23,14,925,439,486,141,134,105,46,0
50908,426,231,195,51,52,45,24,240,141,99,34,28,29,8,0
50909,1594,660,934,251,272,117,77,415,226,189,51,40,40,29,0
50910,361,177,184,59,51,24,15,138,69,69,28,7,10,10,0
50911,136,65,71,33,11,9,6,582,264,318,84,60,58,23,0
50912,500,297,203,66,33,53,15,375,176,199,48,61,40,12,0
50913,161,99,62,15,22,9,7,2547,1280,1267,331,335,293,118,0
50914,1064,495,569,157,159,124,58,414,203,211,58,56,48,14,0
50915,436,201,235,54,37,35,18,222,124,98,37,29,22,9,0
50916,2048,855,1193,297,287,191,93,496,251,245,78,62,61,23,0
50917,585,277,308,92,73,61,32,179,101,78,25,15,13,13,0
50918,1085,646,439,108,65,36,19,256,141,115,32,22,32,8,0
50919,315,111,204,82,66,46,11,374,191,183,40,52,40,16,0
50920,150,60,90,27,16,6,3,1537,701,836,209,187,129,58,0
50921,852,472,380,99,79,70,27,103,50,53,19,10,7,5,0
50922,107,56,51,18,16,12,5,708,328,380,113,100,82,34,0
50923,128,67,61,29,9,9,1,1182,591,591,155,139,83,46,0
50924,264,122,142,46,24,35,10,131,55,76,28,9,14,12,0
50925,414,206,208,56,68,35,19,453,247,206,58,53,45,20,0
50926,164,77,87,33,19,6,7,341,170,171,41,66,27,10,0
50927,270,130,140,43,24,36,10,218,114,104,32,31,33,11,0
50928,687,351,336,106,67,70,41,194,106,88,33,10,15,6,0
50929,726,312,414,121,73,82,23,737,397,340,87,104,90,14,0
50930,165,66,99,28,32,16,3,644,343,301,96,69,59,28,0
50931,463,250,213,56,45,73,25,1922,923,999,267,275,215,90,0
50932,403,176,227,71,56,51,11,866,478,388,121,101,101,26,0
50933,502,250,252,70,47,57,15,287,151,136,51,42,36,7,0
50934,743,377,366,87,74,68,30,362,156,206,74,42,36,22,0
50935,165,66,99,28,32,16,3,862,409,453,149,125,86,29,0
50936,684,353,331,95,98,77,38,417,232,185,58,50,29,21,0
50937,325,152,173,43,47,28,17,201,104,97,36,32,24,7,0
50938,380,187,193,38,51,30,18,1061,543,518,146,123,109,67,0
50939,793,355,438,134,117,77,43,516,245,271,82,84,70,26,0
50940,773,383,390,108,76,79,30,131,55,76,28,9,14,12,0
50941,651,357,294,81,67,103,18,240,141,99,34,28,29,8,0
50942,496,274,222,57,43,75,22,1323,690,633,132,178,112,61,0
50943,869,489,380,110,77,79,29,549,273,276,74,68,72,24,0
50944,403,176,227,71,56,51,11,386,181,205,55,51,57,31,0
50945,319,222,97,36,23,28,8,299,140,159,49,44,26,11,0
50946,282,84,198,60,102,1,6,252,130,122,45,23,32,11,0
50947,464,237,227,64,66,33,12,359,171,188,49,74,45,11,0
50948,389,176,213,81,59,24,7,323,162,161,52,41,39,13,0
50949,258,130,128,44,37,29,10,392,186,206,62,56,29,15,0
50950,204,93,111,35,35,16,11,1040,564,476,134,110,114,51,0
50951,401,204,197,49,33,29,17,285,146,139,41,41,48,13,0
50952,291,120,171,63,39,26,6,572,305,267,74,72,58,21,0
50953,340,145,195,46,38,26,23,296,140,156,49,40,42,19,0
50954,629,374,255,74,53,87,27,873,411,462,132,107,84,40,0
50955,543,265,278,52,37,54,19,1314,693,621,174,155,140,58,0
50956,556,306,250,69,60,80,18,332,173,159,48,40,31,11,0
50957,1171,542,629,170,146,114,64,314,151,163,42,61,39,16,0
50958,764,277,487,158,162,64,31,475,251,224,67,49,48,23,0
50959,580,265,315,97,89,79,17,374,191,183,40,52,40,16,0
50960,419,210,209,54,44,31,23,132,77,55,20,9,13,10,0
50961,763,354,409,101,90,63,26,422,237,185,53,47,62,20,0
50962,879,457,422,93,98,143,32,103,59,44,25,2,13,6,0
50963,700,305,395,111,99,54,18,102,51,51,12,15,12,3,0
50964,431,202,229,57,50,50,25,156,90,66,17,22,11,10,0
50965,516,210,306,113,53,81,33,317,161,156,50,36,47,12,0
50966,413,169,244,66,94,28,19,234,129,105,31,22,19,17,0
50967,130,71,59,30,9,8,2,283,160,123,25,20,37,9,0
50968,2236,1195,1041,227,187,186,118,679,338,341,96,95,40,23,0
50969,330,141,189,65,29,51,19,364,189,175,58,41,35,17,0
50970,335,171,164,51,38,38,10,370,190,180,60,52,37,13,0
50971,546,278,268,94,60,32,22,2225,1244,981,271,243,217,93,0
50972,411,236,175,39,45,50,30,629,317,312,80,87,51,22,0
50973,911,445,466,154,121,108,48,228,130,98,35,29,30,10,0
50974,1249,543,706,187,164,125,52,622,344,278,80,77,68,36,0
50975,475,235,240,77,58,43,22,102,51,51,12,15,12,3,0
50976,1759,838,921,269,212,191,92,332,180,152,44,36,27,13,0
50977,208,96,112,31,32,13,9,712,380,332,69,74,57,30,0
50978,184,93,91,26,25,14,11,375,210,165,49,37,29,27,0
50979,743,366,377,41,37,26,14,619,305,314,85,93,71,29,0
50980,282,105,177,77,28,39,6,400,187,213,56,59,42,20,0
50981,692,305,387,100,97,78,30,242,124,118,39,32,28,22,0
50982,138,35,103,38,2,15,9,240,141,99,34,28,29,8,0
50983,179,96,83,24,8,26,4,1352,602,750,166,185,81,70,0
50984,898,397,501,102,98,54,37,286,160,126,37,27,23,10,0
50985,437,212,225,66,44,44,11,87,38,49,23,10,10,9,0
50986,136,66,70,33,11,9,4,189,95,94,25,33,16,8,0
50987,342,150,192,52,43,31,17,843,391,452,139,104,91,35,0
50988,980,481,499,131,107,85,44,839,446,393,103,94,76,27,0
50989,425,199,226,54,71,56,11,139,68,71,14,26,14,9,0
50990,932,575,357,94,69,76,40,773,389,384,119,91,79,26,0
50991,625,283,342,93,89,67,25,106,46,60,29,13,14,5,0
50992,580,281,299,95,60,74,29,751,394,357,107,96,73,35,0
50993,451,225,226,69,57,64,22,180,115,65,17,12,9,9,0
50994,664,269,395,117,107,36,15,246,107,139,55,33,27,11,0
50995,126,57,69,31,10,10,3,295,160,135,44,36,46,16,0
50996,213,114,99,62,7,2,1,88,50,38,13,8,16,4,0
50997,362,174,188,46,55,35,23,463,268,195,59,46,46,21,0
50998,215,80,135,54,56,21,9,160,60,100,23,40,19,11,0
50999,752,313,439,121,106,68,27,405,181,224,71,57,31,12,0
51000,299,151,148,35,34,26,16,295,160,135,42,37,46,16,0
51001,228,105,123,34,43,20,10,317,161,156,50,36,47,12,0
51002,109,42,67,25,13,1,1,289,140,149,33,42,30,15,0
51003,1121,458,663,158,210,76,47,561,279,282,85,81,88,24,0
51004,548,250,298,85,64,56,21,406,223,183,61,53,46,17,0
51005,243,100,143,58,50,24,5,267,141,126,53,27,23,7,0
51006,528,273,255,67,53,29,20,399,190,209,61,41,39,18,0
51007,258,126,132,38,22,29,8,483,287,196,71,50,54,17,0
51008,322,164,158,46,44,29,7,501,249,252,77,70,55,22,0
51009,204,109,95,21,35,27,7,464,236,228,64,56,53,28,0
51010,282,163,119,40,23,25,17,111,60,51,17,23,10,7,0
51011,126,56,70,31,10,10,3,434,213,221,77,62,53,12,0
51012,196,107,89,20,31,17,4,91,42,49,21,9,8,3,0
51013,391,165,226,67,64,36,27,173,90,83,30,19,19,11,0
51014,139,81,58,17,14,24,9,199,105,94,27,27,28,9,0
51015,563,255,308,91,111,42,30,297,164,133,45,39,40,9,0
51016,341,195,146,42,21,36,9,925,439,486,141,134,105,46,0
51017,476,254,222,58,33,46,23,417,232,185,58,50,29,21,0
51018,410,188,222,53,52,31,14,405,195,210,57,74,24,17,0
51019,411,211,200,61,46,35,18,375,210,165,49,37,29,27,0
51020,381,187,194,37,49,36,17,520,240,280,67,72,42,14,0
51021,428,248,180,44,39,28,9,545,269,276,80,76,27,32,0
51022,92,46,46,14,9,8,6,87,51,35,15,9,9,4,0
51023,166,59,107,36,41,10,4,561,279,282,85,81,88,24,0
51024,127,55,72,25,18,5,7,601,278,323,124,87,65,21,0
51025,1221,597,624,201,152,83,31,89,38,51,14,6,3,9,0
51026,346,186,160,40,37,34,21,337,170,167,59,33,47,17,0
51027,474,250,224,58,47,37,12,741,383,358,92,63,79,36,0
51028,272,94,178,76,33,19,4,277,144,133,42,30,41,8,0
51029,504,222,282,71,64,53,29,501,274,227,63,58,53,20,0
51030,577,251,326,92,84,60,11,209,119,90,28,24,27,9,0
51031,312,173,139,43,47,28,6,432,244,188,51,51,27,14,0
51032,107,36,71,27,15,0,1,858,398,460,126,138,75,39,0
51033,911,489,422,121,98,97,36,1061,543,518,146,123,109,67,0
51034,1054,497,557,190,168,107,45,381,196,185,55,57,43,16,0
51035,374,187,187,51,52,40,27,415,205,210,77,52,55,17,0
51036,385,203,182,47,43,51,21,720,361,359,98,98,70,37,0
51037,553,319,234,56,37,54,18,124,69,55,14,7,9,4,0
51038,546,265,281,101,64,38,16,1321,653,668,186,195,70,35,0
51039,781,367,414,60,67,43,17,218,115,103,32,32,34,11,0
51040,919,444,475,141,148,62,20,230,113,117,31,40,28,10,0
51041,126,57,69,31,10,10,3,405,181,224,71,57,31,12,0
51042,390,199,191,72,42,35,12,103,50,53,19,10,7,5,0
51043,331,177,154,54,38,27,11,408,221,187,55,51,57,14,0
51044,331,165,166,52,34,48,22,368,183,185,40,42,40,15,0
51045,480,232,248,73,40,44,30,593,289,304,85,69,48,19,0
51046,247,128,119,40,21,27,11,259,151,108,39,18,23,11,0
51047,461,207,254,82,66,55,33,270,162,108,26,26,16,11,0
51048,466,259,207,59,50,83,12,425,177,248,60,62,33,16,0
51049,593,282,311,75,70,29,25,453,255,198,62,49,29,19,0
51050,136,66,70,33,11,9,5,1248,584,664,184,164,155,67,0
51051,434,221,213,58,47,54,15,261,148,113,31,28,14,10,0
51052,269,127,142,43,24,34,26,593,289,304,85,69,48,19,0
51053,562,214,348,120,86,69,42,106,54,52,12,9,7,6,0
51054,919,444,475,141,148,62,20,277,144,133,42,30,41,8,0
51055,1616,735,881,285,248,153,72,483,258,225,70,53,54,20,0
51056,213,106,107,28,28,22,9,343,219,124,32,15,37,17,0
51057,1647,794,853,279,235,128,65,415,189,226,68,54,50,21,0
51058,1171,542,629,170,146,114,64,906,455,451,116,105,87,46,0
51059,395,189,206,63,50,49,28,194,109,85,23,24,21,9,0
51060,257,132,125,39,27,26,10,129,60,69,21,15,8,5,0
51061,2663,1073,1590,548,499,192,64,282,134,148,38,45,29,10,0
51062,211,92,119,33,44,11,7,660,333,327,102,95,69,31,0
51063,204,103,101,16,32,22,8,403,184,219,75,51,47,20,0
51064,446,265,181,51,35,27,17,467,240,227,65,65,51,23,0
51065,674,268,406,118,96,70,21,131,55,76,28,9,14,12,0
51066,314,178,136,42,32,30,17,271,150,121,39,36,37,5,0
51067,413,236,177,41,25,35,19,334,182,152,45,41,27,13,0
51068,941,459,482,167,140,82,38,579,285,294,78,72,64,32,0
51069,350,190,160,48,25,27,18,406,234,172,63,35,43,10,0
51070,577,342,235,63,57,23,37,158,71,87,23,21,17,12,0
51071,803,358,445,135,117,80,43,418,223,195,51,45,49,14,0
51072,593,282,311,75,70,29,25,457,253,204,67,51,48,13,0
51073,1047,443,604,162,156,78,52,607,293,314,98,71,62,32,0
51074,373,194,179,42,54,26,13,381,187,194,37,49,36,17,0
51075,117,57,60,17,14,11,10,148,69,79,26,18,16,3,0
51076,517,245,272,92,77,46,24,798,385,413,120,115,79,30,0
51077,128,69,59,29,9,8,1,68,36,32,11,8,9,2,0
51078,1960,875,1085,287,189,162,66,1696,771,925,257,225,149,63,0
51079,217,98,119,38,35,18,9,798,385,413,120,115,79,30,0
51080,427,191,236,67,60,41,34,364,189,175,58,41,35,17,0
51081,530,259,271,83,50,54,41,649,307,342,71,134,45,17,0
51082,392,205,187,83,49,38,10,601,278,323,124,87,65,21,0
51083,186,56,130,46,50,16,7,54,26,28,11,4,3,3,0
51084,437,225,212,61,57,66,12,873,366,507,127,125,75,21,0
51085,928,442,486,139,118,91,43,487,252,235,79,58,55,26,0
51086,449,179,270,80,77,49,29,137,85,52,15,11,11,2,0
51087,1276,607,669,192,178,136,63,393,210,183,58,37,34,20,0
51088,474,250,224,58,47,37,12,384,204,180,53,47,49,17,0
51089,476,276,200,57,34,43,16,234,116,118,34,35,23,9,0
51090,246,111,135,64,47,27,3,508,253,255,73,60,50,13,0
51091,567,266,301,139,46,76,37,619,305,314,85,93,71,29,0
51092,474,243,231,66,54,41,29,136,65,71,26,11,7,5,0
51093,406,208,198,41,26,43,21,975,475,500,139,140,119,28,0
51094,711,330,381,111,86,86,34,317,161,156,40,49,41,11,0
51095,1365,590,775,257,168,136,93,265,134,131,48,34,33,15,0
51096,273,126,147,54,49,25,18,671,306,365,114,76,49,19,0
51097,332,172,160,50,33,35,9,201,99,102,34,26,23,6,0
51098,673,317,356,101,85,76,49,452,231,221,74,53,56,20,0
51099,365,222,143,44,24,35,11,459,260,199,56,42,47,21,0
51100,1214,498,716,197,180,121,65,218,114,104,32,31,33,11,0
51101,341,177,164,57,42,40,18,384,212,172,44,43,34,14,0
51102,664,269,395,117,107,36,15,296,145,151,42,37,27,13,0
51103,755,271,484,113,226,61,20,91,44,47,9,12,4,7,0
51104,181,75,106,35,26,11,9,196,105,91,40,13,19,10,0
51105,240,99,141,53,38,29,15,277,152,125,31,35,22,19,0
51106,443,212,231,74,24,60,24,467,231,236,71,65,58,18,0
51107,1052,492,560,184,163,103,44,900,441,459,125,127,110,32,0
51108,256,152,104,18,23,23,8,72,34,38,8,2,3,12,0
51109,1208,575,633,187,204,117,41,1262,653,609,169,165,152,50,0
51110,308,129,179,44,60,19,8,415,189,226,68,54,50,21,0
51111,747,360,387,125,92,69,32,1471,709,762,198,184,154,62,0
51112,319,222,97,36,23,28,8,180,115,65,17,12,9,9,0
51113,557,250,307,70,47,51,22,260,131,129,42,31,40,9,0
51114,425,198,227,57,69,59,13,376,183,193,50,50,43,21,0
51115,265,165,100,32,19,27,5,261,127,134,36,27,36,4,0
51116,932,575,357,94,69,76,40,737,397,340,87,104,90,14,0
51117,252,121,131,42,34,12,16,381,186,195,69,55,46,15,0
51118,126,66,60,24,10,7,9,732,402,330,81,86,87,33,0
51119,1439,713,726,195,180,110,34,175,91,84,19,21,21,10,0
51120,164,81,83,37,8,14,10,368,204,164,43,35,30,24,0
51121,350,172,178,61,45,32,13,662,373,289,89,80,77,29,0
51122,474,250,224,58,47,37,12,158,71,87,23,21,17,12,0
51123,886,440,446,116,140,95,45,405,181,224,71,57,31,12,0
51124,526,228,298,69,64,32,30,381,186,195,69,55,46,15,0
51125,55,16,39,24,2,5,2,497,257,240,71,63,62,16,0
51126,288,104,184,80,30,39,6,290,147,143,34,34,39,13,0
51127,526,268,258,54,37,55,12,727,388,339,102,87,70,29,0
51128,1912,880,1032,331,334,180,84,334,181,153,56,31,28,18,0
51129,134,60,74,19,13,10,7,775,407,368,122,100,97,32,0
51130,346,208,138,46,39,51,18,293,142,151,49,40,42,17,0
51131,1447,698,749,214,180,116,46,741,383,358,92,63,79,36,0
51132,510,288,222,44,36,24,7,671,306,365,114,76,49,19,0
51133,246,123,123,40,31,27,7,660,333,327,102,95,69,31,0
51134,258,126,132,38,22,29,8,640,364,276,84,68,69,33,0
51135,548,310,238,72,62,54,13,429,187,242,79,72,28,19,0
51136,803,358,445,135,117,80,43,135,65,70,21,25,15,9,0
51137,1051,429,622,179,148,125,54,974,457,517,133,117,69,26,0
51138,484,261,223,59,48,49,24,579,285,294,78,72,64,32,0
51139,927,457,470,130,99,118,42,179,101,78,25,15,13,13,0
51140,322,164,158,46,44,29,7,783,406,377,102,91,57,29,0
51141,557,250,307,70,47,51,22,374,202,172,50,39,31,24,0
51142,314,178,136,42,32,30,17,293,142,151,49,40,42,17,0
51143,466,199,267,86,59,32,17,862,409,453,149,125,86,29,0
51144,271,110,161,33,27,11,8,397,234,163,44,38,23,21,0
51145,959,496,463,144,132,75,35,180,90,90,31,19,20,8,0
51146,519,259,260,86,78,59,22,602,310,292,87,66,70,36,0
51147,253,133,120,44,31,22,8,325,159,166,59,46,30,12,0
51148,520,261,259,74,52,49,22,295,160,135,42,37,46,16,0
51149,439,241,198,67,40,40,13,418,223,195,51,45,49,14,0
51150,92,46,46,14,9,8,6,403,233,170,38,29,21,14,0
51151,282,105,177,77,28,39,6,415,226,189,51,40,40,29,0
51152,342,150,192,52,43,31,17,483,258,225,70,53,54,20,0
51153,881,492,389,87,97,59,51,194,94,100,33,28,14,7,0
51154,600,324,276,89,73,45,39,724,353,371,94,95,71,31,0
51155,1030,567,463,118,106,94,49,270,130,140,48,44,37,12,0
51156,242,111,131,35,35,17,13,422,237,185,53,47,62,20,0
51157,161,94,67,23,13,8,10,535,288,247,79,72,35,21,0
51158,651,357,294,81,67,103,18,418,246,172,52,39,57,10,0
51159,255,126,129,41,37,13,5,551,226,325,96,103,43,11,0
51160,479,228,251,71,57,60,14,403,192,211,102,39,49,15,0
51161,517,196,321,103,98,33,12,520,244,276,91,60,68,20,0
51162,325,186,139,49,36,20,5,621,273,348,104,102,48,19,0
51163,562,214,348,120,86,69,42,166,78,88,27,25,19,7,0
51164,130,70,60,30,9,8,1,189,105,84,25,26,21,9,0
51165,752,313,439,121,106,68,27,154,78,76,23,21,13,5,0
51166,453,240,213,53,33,44,16,414,203,211,58,56,48,14,0
51167,1217,647,570,142,160,129,45,123,61,62,17,18,17,7,0
51168,329,165,164,61,44,29,17,1040,564,476,134,110,114,51,0
51169,265,165,100,32,19,27,5,474,268,206,66,42,45,24,0
51170,384,198,186,58,48,37,12,282,134,148,38,45,29,10,0
51171,856,429,427,113,105,96,24,419,233,186,54,53,55,17,0
51172,200,94,106,33,22,18,8,485,244,241,80,55,59,20,0
51173,593,282,311,75,70,29,25,381,187,194,37,49,36,17,0
51174,4640,2231,2409,660,549,437,245,693,360,333,100,88,62,26,0
51175,361,171,190,44,40,18,13,262,129,133,40,41,31,10,0
51176,322,164,158,46,44,29,7,561,279,282,85,81,88,24,0
51177,291,120,171,63,39,26,6,285,143,142,45,32,21,17,0
51178,193,90,103,44,9,19,13,621,273,348,104,102,48,19,0
51179,341,195,146,42,21,36,9,374,212,162,48,40,32,23,0
51180,136,66,70,33,11,9,5,274,142,132,33,34,18,14,0
51181,330,151,179,68,36,56,9,818,357,461,122,136,54,25,0
51182,167,70,97,32,20,15,7,260,131,129,42,31,40,9,0
51183,326,148,178,55,42,31,12,392,186,206,62,56,29,15,0
51184,594,279,315,93,68,68,26,131,55,76,28,9,14,12,0
51185,288,140,148,59,33,27,12,1279,669,610,164,162,104,55,0
51186,528,188,340,130,58,77,41,391,165,226,67,64,36,27,0
51187,482,245,237,69,64,66,24,376,189,187,47,53,44,26,0
51188,1148,472,676,229,164,86,37,592,249,343,91,90,50,42,0
51189,836,370,466,126,96,72,30,125,66,59,24,16,11,5,0
51190,331,177,154,54,38,27,11,222,127,95,23,28,22,7,0
51191,941,459,482,167,140,82,38,376,183,193,50,50,43,21,0
51192,674,318,356,86,139,50,11,704,355,349,113,94,71,24,0
51193,471,221,250,87,68,42,25,1034,495,539,150,134,114,71,0
51194,206,100,106,34,26,11,7,773,389,384,119,91,79,26,0
51195,873,366,507,127,125,75,21,1338,720,618,179,145,141,85,0
51196,785,325,460,114,123,61,28,91,44,47,9,12,4,7,0
51197,401,204,197,49,33,29,17,225,111,114,32,34,32,16,0
51198,265,165,100,32,19,27,5,565,237,328,75,88,32,11,0
51199,618,289,329,97,86,70,17,664,350,314,86,90,82,36,0
51200,443,212,231,74,24,60,24,305,163,142,38,27,47,11,0
51201,437,167,270,126,95,34,10,798,385,413,120,115,79,30,0
51202,730,298,432,128,69,86,26,470,205,265,71,80,33,11,0
51203,170,82,88,32,23,22,8,277,163,114,33,24,21,16,0
51204,426,214,212,63,47,53,20,354,183,171,54,43,49,8,0
51205,215,80,135,54,56,21,9,498,244,254,81,67,58,19,0
51206,221,75,146,68,21,16,5,124,69,55,14,7,9,4,0
51207,2109,999,1110,332,294,187,89,1507,737,770,188,228,147,71,0
51208,264,122,142,46,24,35,10,403,192,211,102,39,49,15,0
51209,435,230,205,51,37,55,18,405,195,210,57,74,24,17,0
51210,82,36,46,17,10,5,1,397,234,163,44,38,23,21,0
51211,952,547,405,95,90,127,35,132,61,71,19,20,14,6,0
51212,473,217,256,59,44,34,21,464,236,228,64,56,53,28,0
51213,640,308,332,91,102,49,21,277,124,153,44,40,35,18,0
51214,833,295,538,146,139,65,34,256,141,115,32,22,32,8,0
51215,127,54,73,31,10,11,3,478,254,224,67,74,56,28,0
51216,451,225,226,69,57,64,22,384,204,180,53,47,49,17,0
51217,407,164,243,88,42,40,22,406,223,183,61,53,46,17,0
51218,282,84,198,60,102,1,6,1543,794,749,182,152,132,55,0
51219,512,254,258,70,48,37,32,370,190,180,60,52,37,13,0
51220,390,199,191,72,42,35,12,198,86,112,36,27,23,9,0
51221,111,29,82,10,54,0,1,530,287,243,79,70,33,26,0
51222,57,24,33,11,3,5,3,102,51,51,12,15,12,3,0
51223,341,183,158,36,34,36,15,483,258,225,70,53,54,20,0
51224,3230,1724,1506,361,358,157,75,445,192,253,86,58,53,18,0
51225,546,285,261,71,49,47,24,1873,935,938,233,225,203,79,0
51226,346,186,160,40,37,34,21,72,32,40,8,2,1,14,0
51227,1284,511,773,227,166,169,107,204,80,124,29,51,10,5,0
51228,1531,649,882,108,122,93,72,2517,1275,1242,304,324,245,135,0
51229,584,297,287,89,80,65,17,390,190,200,66,50,43,12,0
51230,700,305,395,111,99,54,18,452,231,221,74,53,56,20,0
51231,319,153,166,61,52,26,12,373,213,160,44,33,26,17,0
51232,577,342,235,63,57,23,37,972,471,501,152,138,112,40,0
51233,76,30,46,7,15,1,5,424,179,245,65,67,29,11,0
51234,245,111,134,36,27,18,6,299,140,159,49,44,26,11,0
51235,224,108,116,31,32,22,8,127,64,63,26,8,12,8,0
51236,416,207,209,63,47,56,15,160,76,84,19,24,8,5,0
51237,485,183,302,79,81,73,33,175,82,93,33,26,17,5,0
51238,204,103,101,16,32,22,8,200,99,101,31,24,26,6,0
51239,629,338,291,92,57,64,22,858,461,397,125,114,79,45,0
51240,179,96,83,24,8,26,4,2542,1245,1297,285,287,170,84,0
51241,341,177,164,57,42,40,18,199,92,107,34,30,18,9,0
51242,2279,996,1283,375,328,158,60,463,268,195,59,46,46,21,0
51243,570,238,332,112,95,39,23,501,257,244,75,57,48,29,0
51244,262,133,129,44,38,31,12,172,88,84,24,31,20,12,0
51245,193,107,86,13,20,13,6,374,212,162,48,40,32,23,0
51246,341,175,166,48,43,35,18,398,200,198,68,43,51,14,0
51247,161,99,62,15,22,9,7,374,181,193,55,58,48,23,0
51248,410,209,201,72,30,48,22,218,118,100,33,30,25,11,0
51249,674,268,406,118,96,70,21,671,306,365,114,76,49,19,0
51250,217,98,119,38,35,18,9,271,150,121,39,36,37,5,0
51251,207,93,114,20,33,19,10,561,279,282,85,81,88,24,0
51252,202,103,99,28,20,12,8,483,258,225,70,53,54,20,0
51253,159,105,54,22,9,14,25,975,475,500,139,140,119,28,0
51254,341,195,146,42,21,36,9,773,389,384,119,91,79,26,0
51255,258,130,128,44,37,29,10,302,150,152,56,40,52,15,0
51256,126,57,69,31,10,10,3,264,138,126,33,34,29,12,0
51257,270,166,104,30,26,28,14,405,181,224,71,57,31,12,0
51258,798,287,511,126,125,77,26,196,105,91,40,13,19,10,0
51259,533,300,233,74,50,74,17,1382,508,874,334,320,98,36,0
51260,520,240,280,87,63,67,16,277,145,132,41,32,22,10,0
51261,505,247,258,72,71,60,27,349,200,149,41,39,30,20,0
51262,210,101,109,33,33,19,9,654,295,359,99,88,71,25,0
51263,305,164,141,43,23,47,18,336,190,146,52,30,41,6,0
51264,474,250,224,58,47,37,12,480,255,225,67,64,50,22,0
51265,517,245,272,92,77,46,24,166,88,78,23,18,13,7,0
51266,591,288,303,72,68,68,35,364,181,183,63,55,36,11,0
51267,463,225,238,76,36,59,26,2346,1231,1115,316,292,266,105,0
51268,505,247,258,72,71,60,27,1755,905,850,214,196,183,79,0
51269,763,354,409,101,90,63,26,2517,1275,1242,304,324,245,135,0
51270,533,300,233,74,50,74,17,710,375,335,95,94,110,28,0
51271,649,304,345,99,80,67,40,142,73,69,27,9,15,11,0
51272,255,126,129,41,37,13,5,373,181,192,54,35,44,20,0
51273,329,171,158,49,41,31,10,240,141,99,34,28,29,8,0
51274,519,259,260,86,78,59,22,240,141,99,34,28,29,8,0
51275,433,188,245,63,45,26,14,1182,591,591,155,139,83,46,0
51276,412,193,219,69,57,43,14,288,156,132,36,36,24,15,0
51277,535,217,318,87,106,41,14,1239,659,580,169,148,131,54,0
51278,276,149,127,45,34,39,9,218,114,104,32,31,33,11,0
51279,401,183,218,72,73,28,10,478,254,224,67,74,56,28,0
51280,801,331,470,151,139,99,55,135,65,70,21,25,15,9,0
51281,410,209,201,72,30,48,22,1500,804,696,190,172,144,60,0
51282,708,344,364,106,98,66,33,1062,522,540,151,147,105,66,0
51283,427,191,236,67,60,41,34,422,237,185,53,47,62,20,0
51284,156,64,92,31,19,5,4,541,279,262,79,82,31,32,0
51285,431,202,229,57,50,50,25,609,335,274,79,57,45,22,0
51286,232,134,98,28,20,20,5,223,113,110,31,33,22,12,0
51287,446,174,272,84,61,57,23,149,68,81,15,38,11,10,0
51288,219,116,103,66,7,2,1,274,142,132,33,34,18,14,0
51289,130,71,59,30,9,8,1,218,114,104,32,31,33,11,0
51290,1163,417,746,209,145,87,28,966,478,488,108,144,74,43,0
51291,164,61,103,47,19,14,5,464,236,228,64,56,53,28,0
51292,349,131,218,66,76,22,9,288,156,132,36,36,24,15,0
51293,180,57,123,39,22,10,8,405,214,191,53,42,49,20,0
51294,711,330,381,111,86,86,34,866,478,388,121,101,101,26,0
51295,1257,464,793,221,264,75,37,528,276,252,86,78,49,17,0
51296,961,465,496,139,156,62,34,471,238,233,66,63,62,19,0
51297,1912,880,1032,331,334,180,84,598,333,265,79,66,54,33,0
51298,808,294,514,118,183,34,27,399,201,198,65,45,48,17,0
51299,82,36,46,17,10,5,1,132,61,71,22,21,15,3,0
51300,410,200,210,60,54,46,19,1537,701,836,209,187,129,58,0
51301,346,186,160,40,37,34,21,317,161,156,40,49,41,11,0
51302,397,180,217,61,59,39,13,89,38,51,14,6,3,9,0
51303,164,61,103,47,19,14,5,389,210,179,51,37,43,9,0
51304,505,282,223,60,57,66,23,306,157,149,52,35,39,16,0
51305,139,81,58,17,14,24,9,775,407,368,122,100,97,32,0
51306,331,144,187,57,46,33,19,132,61,71,22,21,15,3,0
51307,478,220,258,47,70,41,10,597,300,297,96,89,68,29,0
51308,312,173,139,43,47,28,6,96,45,51,13,12,6,4,0
51309,282,163,119,40,23,25,17,102,51,51,12,15,12,3,0
51310,318,164,154,52,43,34,10,323,168,155,51,41,38,12,0
51311,224,108,116,33,26,32,10,322,180,142,45,38,28,7,0
51312,301,156,145,32,25,15,5,334,181,153,41,40,25,15,0
51313,833,295,538,146,139,65,34,127,58,69,18,17,10,5,0
51314,2414,1189,1225,277,178,170,169,2724,1157,1567,269,518,239,77,0
51315,443,206,237,76,68,52,28,483,215,268,66,70,30,16,0
51316,126,56,70,31,10,10,3,242,124,118,39,32,28,22,0
51317,798,364,434,133,88,74,35,843,391,452,139,104,91,35,0
51318,341,195,146,42,21,36,9,975,475,500,139,140,119,28,0
51319,743,377,366,87,74,68,30,1020,538,482,145,115,111,58,0
51320,381,146,235,74,48,47,34,188,88,100,53,12,15,6,0
51321,346,205,141,47,34,30,7,1507,737,770,188,228,147,71,0
51322,1023,449,574,141,174,76,43,1061,543,518,146,123,109,67,0
51323,2663,1073,1590,548,499,192,64,425,177,248,60,62,33,16,0
51324,126,56,70,31,10,10,3,142,73,69,27,9,15,11,0
51325,76,42,34,12,8,5,7,629,317,312,80,87,51,22,0
51326,130,70,60,30,9,8,1,496,251,245,78,62,61,23,0
51327,1556,718,838,280,182,161,49,810,310,500,164,162,42,26,0
51328,301,156,145,32,25,15,5,192,91,101,29,28,17,7,0
51329,301,157,144,31,28,34,9,65,32,33,16,4,8,3,0
51330,3230,1724,1506,361,358,157,75,483,215,268,66,70,30,16,0
51331,1009,487,522,177,121,103,51,601,279,322,81,65,27,12,0
51332,282,84,198,60,102,1,6,421,222,199,69,50,60,18,0
51333,441,218,223,69,55,50,27,935,515,420,126,107,73,32,0
51334,441,218,223,69,55,50,27,423,234,189,66,44,57,12,0
51335,498,274,224,58,59,50,18,142,73,69,27,9,15,11,0
51336,478,220,258,47,70,41,10,320,168,152,38,42,24,18,0
51337,329,168,161,48,34,41,16,406,223,183,61,53,46,17,0
51338,119,59,60,29,10,6,4,671,306,365,114,76,49,19,0
51339,407,207,200,53,36,38,8,354,183,171,54,43,49,8,0
51340,733,382,351,126,92,93,27,341,170,171,41,66,27,10,0
51341,1058,497,561,194,142,87,63,514,248,266,86,82,52,22,0
51342,395,195,200,41,55,23,10,483,287,196,71,50,54,17,0
51343,502,229,273,63,66,40,31,1262,653,609,169,165,152,50,0
51344,107,53,54,15,15,13,4,247,128,119,34,14,16,14,0
51345,219,116,103,66,7,2,1,337,152,185,49,54,42,21,0
51346,815,356,459,128,125,82,26,144,67,77,28,14,9,8,0
51347,484,192,292,118,68,83,22,403,225,178,56,38,33,25,0
51348,332,172,160,50,33,35,9,105,51,54,13,17,12,8,0
51349,546,265,281,101,64,38,16,106,46,60,27,18,12,3,0
51350,727,426,301,79,71,64,32,445,202,243,70,73,51,15,0
51351,610,249,361,107,69,72,33,1537,701,836,209,187,129,58,0
51352,309,137,172,51,50,28,14,96,46,50,16,12,7,5,0
51353,449,179,270,80,77,49,29,87,51,35,15,9,9,4,0
51354,629,338,291,92,57,64,22,518,292,226,60,60,52,21,0
51355,580,308,272,82,79,58,25,1873,935,938,233,225,203,79,0
51356,433,188,245,63,45,26,14,368,183,185,40,42,40,15,0
51357,507,242,265,53,44,31,22,462,251,211,74,53,41,18,0
51358,428,248,180,44,39,28,9,223,113,110,31,33,22,12,0
51359,412,193,219,69,57,43,14,732,366,366,108,86,74,41,0
51360,330,151,179,68,36,56,9,285,143,142,45,32,21,17,0
51361,126,56,70,31,10,10,3,611,314,297,79,75,78,22,0
51362,2000,965,1035,357,313,198,75,245,131,114,30,27,18,13,0
51363,1139,537,602,162,139,109,50,751,394,357,107,96,73,35,0
51364,304,149,155,46,32,39,14,88,50,38,13,8,16,4,0
51365,895,388,507,130,84,90,31,175,91,84,19,21,21,10,0
51366,213,114,99,62,7,2,1,103,59,44,25,2,13,6,0
51367,371,143,228,77,48,29,26,368,204,164,43,35,30,24,0
51368,961,465,496,139,156,62,34,172,88,84,24,31,20,12,0
51369,786,378,408,106,98,77,39,228,130,98,35,29,30,10,0
51370,2279,996,1283,375,328,158,60,309,159,150,47,43,43,13,0
51371,556,306,250,69,60,80,18,373,181,192,54,35,44,20,0
51372,343,189,154,44,24,39,12,531,277,254,82,75,33,22,0
51373,350,190,160,48,25,27,18,367,218,149,45,43,42,16,0
51374,252,121,131,42,34,12,16,390,190,200,66,50,43,12,0
51375,243,114,129,37,30,32,8,465,252,213,73,58,60,18,0
51376,285,148,137,31,42,42,16,88,50,38,13,8,16,4,0
51377,756,362,394,102,104,73,25,904,436,468,143,118,108,32,0
51378,98,32,66,15,25,5,4,231,126,105,37,26,29,6,0
51379,480,232,248,73,40,44,30,292,155,137,50,34,29,13,0
51380,242,111,131,35,35,17,13,72,32,40,8,2,2,13,0
51381,237,127,110,34,30,16,9,761,351,410,117,73,103,45,0
51382,260,138,122,44,30,28,6,397,223,174,50,39,29,17,0
51383,142,60,82,20,28,13,5,96,46,50,16,12,7,5,0
51384,283,172,111,39,31,29,8,1378,692,686,194,174,105,56,0
51385,347,154,193,48,51,25,11,873,411,462,132,107,84,40,0
51386,388,244,144,46,25,42,16,189,105,84,25,26,21,9,0
51387,908,324,584,181,162,81,29,462,251,211,74,53,41,18,0
51388,172,98,74,20,21,22,8,133,61,72,21,19,13,4,0
51389,209,75,134,53,48,20,9,1382,508,874,334,320,98,36,0
51390,802,375,427,133,103,81,41,132,61,71,22,21,15,3,0
51391,349,131,218,66,76,22,9,437,224,213,40,29,42,25,0
51392,130,70,60,30,9,8,1,390,223,167,58,36,45,18,0
51393,560,279,281,113,64,58,15,270,162,108,26,26,16,11,0
51394,401,204,197,49,33,29,17,325,172,153,44,34,27,14,0
51395,269,127,142,43,24,34,26,410,197,213,67,43,56,18,0
51396,222,108,114,37,20,25,12,132,67,65,24,21,8,10,0
51397,282,96,186,80,21,28,7,975,400,575,160,162,62,31,0
51398,428,226,202,52,60,75,20,134,72,62,14,28,8,4,0
51399,139,81,58,17,14,24,9,756,348,408,101,103,60,40,0
51400,963,477,486,134,143,123,38,555,282,273,82,69,65,21,0
51401,983,449,534,95,77,55,36,520,272,248,60,65,58,22,0
51402,314,158,156,39,28,30,17,198,115,83,30,22,8,8,0
51403,107,56,51,18,16,12,5,447,212,235,86,55,58,21,0
51404,172,82,90,21,35,21,5,1154,489,665,200,196,95,54,0
51405,418,163,255,57,54,38,24,384,212,172,44,43,34,14,0
51406,240,166,74,32,12,8,15,158,71,87,23,21,17,12,0
51407,571,298,273,81,72,57,25,160,60,100,23,40,19,11,0
51408,346,205,141,47,34,30,7,294,146,148,50,45,51,15,0
51409,439,241,198,67,40,40,13,395,198,197,55,55,36,10,0
51410,128,69,59,29,9,8,1,225,111,114,32,34,32,16,0
51411,425,198,227,57,69,59,13,301,168,133,49,37,34,11,0
51412,1001,422,579,185,180,51,32,699,334,365,108,80,70,20,0
51413,629,338,291,92,57,64,22,286,152,134,38,38,32,11,0
51414,529,274,255,57,62,38,14,119,57,62,18,16,17,4,0
51415,126,58,68,31,10,10,3,230,125,105,29,40,20,6,0
51416,894,448,446,123,100,82,30,218,115,103,37,33,33,9,0
51417,55,16,39,24,2,5,2,305,163,142,38,27,47,11,0
51418,1555,702,853,250,199,139,31,149,52,97,36,36,7,4,0
51419,122,56,66,26,13,11,5,418,223,195,53,43,49,15,0
51420,200,94,106,33,22,18,8,348,194,154,57,31,43,12,0
51421,356,199,157,36,43,28,12,295,160,135,44,36,46,16,0
51422,412,146,266,106,38,67,35,134,72,62,14,28,8,4,0
51423,682,260,422,153,78,109,46,547,295,252,81,65,57,23,0
51424,375,167,208,55,83,44,9,647,350,297,95,79,77,29,0
51425,399,196,203,62,45,38,19,88,50,38,13,8,16,4,0
51426,4128,2104,2024,581,505,453,205,163,79,84,22,24,13,5,0
51427,956,450,506,122,117,82,36,293,142,151,49,40,42,17,0
51428,1221,597,624,201,152,83,31,127,54,73,11,33,15,6,0
51429,798,287,511,126,125,77,26,858,461,397,125,114,79,45,0
51430,507,314,193,49,45,59,25,316,166,150,45,38,37,13,0
51431,766,336,430,133,97,79,21,1698,875,823,222,219,173,64,0
51432,1139,537,602,162,139,109,50,376,183,193,50,50,43,21,0
51433,1594,660,934,251,272,117,77,279,142,137,43,39,28,7,0
51434,260,133,127,43,29,34,11,474,268,206,66,42,45,24,0
51435,209,75,134,53,48,20,9,303,137,166,54,54,31,15,0
51436,535,315,220,57,55,71,19,975,400,575,160,162,62,31,0
51437,126,57,69,31,10,10,3,457,245,212,62,58,57,21,0
51438,1041,497,544,180,167,98,34,266,146,120,41,28,31,7,0
51439,399,196,203,62,45,38,19,127,54,73,11,33,15,6,0
51440,271,110,161,33,27,11,8,798,385,413,120,115,79,30,0
51441,1867,973,894,256,222,194,65,207,86,121,34,39,11,13,0
51442,664,269,395,117,107,36,15,285,146,139,41,41,48,13,0
51443,1560,778,782,224,235,132,78,222,122,100,39,32,24,9,0
51444,443,226,217,67,34,53,10,597,269,328,102,84,69,24,0
51445,312,164,148,54,29,25,15,375,210,165,49,37,29,27,0
51446,364,172,192,55,57,32,15,419,233,186,54,53,55,17,0
51447,265,165,100,32,19,27,5,517,295,222,69,62,40,28,0
51448,196,107,89,20,31,17,4,338,169,169,53,44,39,21,0
51449,269,127,142,43,24,34,26,399,190,209,61,41,39,18,0
51450,426,196,230,76,65,54,20,222,122,100,39,32,24,9,0
51451,364,172,192,55,57,32,15,1755,905,850,214,196,183,79,0
51452,525,254,271,60,76,46,13,601,279,322,81,65,27,12,0
51453,325,177,148,40,24,23,13,715,348,367,109,84,68,30,0
51454,438,185,253,71,64,52,28,975,475,500,139,140,119,28,0
51455,213,88,125,21,54,14,15,699,334,365,108,80,70,20,0
51456,217,109,108,30,23,28,10,449,252,197,61,52,36,18,0
51457,162,73,89,32,19,4,4,601,278,323,124,87,65,21,0
51458,508,267,241,43,35,25,17,497,227,270,70,63,66,30,0
51459,184,93,91,26,25,14,11,218,115,103,37,33,33,9,0
51460,496,210,286,111,55,74,13,583,321,262,73,67,45,25,0
51461,436,201,235,54,37,35,18,1314,693,621,174,155,140,58,0
51462,260,138,122,44,30,28,6,704,355,349,113,94,71,24,0
51463,1054,497,557,190,168,107,45,953,489,464,126,104,111,44,0
51464,794,322,472,122,108,79,34,348,212,136,53,31,25,18,0
51465,436,209,227,66,47,52,22,205,94,111,48,31,15,6,0
51466,269,156,113,37,32,17,7,123,61,62,17,18,17,7,0
51467,161,75,86,24,20,10,7,467,231,236,71,65,58,18,0
51468,501,230,271,63,90,50,18,178,99,79,31,19,26,8,0
51469,432,190,242,85,82,28,11,165,90,75,36,18,20,6,0
51470,1148,472,676,229,164,86,37,441,189,252,73,50,47,23,0
51471,431,202,229,57,50,50,25,198,86,112,36,27,23,9,0
51472,1171,542,629,170,146,114,64,244,143,101,31,29,26,8,0
51473,1542,682,860,290,158,120,47,144,67,77,28,14,9,8,0
51474,685,393,292,75,66,113,16,367,199,168,62,44,34,8,0
51475,476,276,200,57,34,43,16,317,161,156,40,49,41,11,0
51476,520,240,280,87,63,67,16,1025,549,476,118,109,88,61,0
51477,385,179,206,58,56,38,19,188,101,87,20,18,20,14,0
51478,385,203,182,47,43,51,21,465,252,213,73,58,60,18,0
51479,457,261,196,55,27,57,34,1352,602,750,166,185,81,70,0
51480,332,172,160,50,33,35,9,332,155,177,55,51,44,13,0
51481,215,117,98,28,19,15,8,462,229,233,63,49,42,18,0
51482,640,271,369,111,79,57,17,935,515,420,126,107,73,32,0
51483,1105,544,561,165,167,99,40,368,200,168,54,49,43,9,0
51484,1505,680,825,202,204,73,32,723,353,370,120,109,96,33,0
51485,584,297,287,89,80,65,17,928,440,488,111,157,82,35,0
51486,833,295,538,146,139,65,34,293,142,151,49,40,42,17,0
51487,240,99,141,53,38,29,15,103,59,44,25,2,13,6,0
51488,1711,865,846,204,176,105,60,1113,480,633,170,173,81,34,0
51489,340,181,159,44,39,35,21,380,178,202,69,53,37,10,0
51490,451,225,226,69,57,64,22,375,211,164,50,36,31,23,0
51491,335,155,180,64,48,36,10,396,199,197,54,50,45,14,0
51492,439,205,234,64,88,41,21,821,394,427,122,117,109,38,0
51493,143,81,62,28,9,8,1,617,314,303,96,68,68,37,0
51494,2236,1195,1041,227,187,186,118,1425,670,755,153,189,122,85,0
51495,346,208,138,46,39,51,18,528,276,252,86,78,49,17,0
51496,291,142,149,50,29,35,7,134,55,79,22,24,16,6,0
51497,1555,702,853,250,199,139,31,699,334,365,108,80,70,20,0
51498,399,196,203,62,45,38,19,374,191,183,40,52,40,16,0
51499,417,222,195,53,39,43,10,339,175,164,51,49,37,9,0
51500,302,178,124,34,29,50,13,374,191,183,40,52,40,16,0
51501,474,250,224,58,47,37,12,531,277,254,82,75,33,22,0
51502,267,146,121,40,24,25,7,889,505,384,107,97,99,30,0
51503,335,183,152,40,26,54,22,773,389,384,119,91,79,26,0
51504,496,209,287,112,55,71,14,611,314,297,79,75,78,22,0
51505,1030,438,592,184,104,108,30,935,515,420,126,107,73,32,0
51506,243,114,129,37,30,32,8,367,199,168,62,44,34,8,0
51507,130,70,60,30,9,8,1,207,86,121,34,39,11,13,0
51508,1616,735,881,285,248,153,72,778,391,387,94,77,41,33,0
51509,1214,498,716,197,180,121,65,137,72,65,27,13,15,8,0
51510,346,205,141,47,34,30,7,234,116,118,34,35,23,9,0
51511,126,57,69,31,10,10,3,1698,875,823,222,219,173,64,0
51512,524,361,163,41,8,28,16,89,51,38,15,15,5,4,0
51513,496,210,286,111,55,74,13,103,59,44,25,2,13,6,0
51514,859,411,448,118,100,95,49,445,202,243,70,73,51,15,0
51515,815,356,459,128,125,82,26,376,189,187,47,53,44,26,0
51516,772,383,389,105,76,82,33,403,192,211,102,39,49,15,0
51517,618,289,329,97,86,70,17,148,84,64,30,7,17,4,0
51518,407,230,177,44,39,34,19,332,180,152,46,36,28,14,0
51519,743,366,377,41,37,26,14,422,237,185,53,47,62,20,0
51520,332,170,162,44,38,39,10,326,169,157,51,41,41,12,0
51521,1556,718,838,280,182,161,49,453,255,198,62,49,29,19,0
51522,388,244,144,46,25,42,16,492,278,214,65,58,32,11,0
51523,161,75,86,24,20,10,7,169,74,95,33,26,22,3,0
51524,346,174,172,36,43,21,9,212,127,85,28,21,26,6,0
51525,1759,838,921,269,212,191,92,662,312,350,103,104,59,20,0
51526,431,199,232,59,54,40,17,149,52,97,36,36,7,4,0
51527,760,322,438,81,130,57,19,296,140,156,49,40,42,19,0
51528,521,289,232,71,58,49,16,1378,692,686,194,174,105,56,0
51529,519,245,274,58,61,34,22,316,159,157,38,48,30,11,0
51530,650,330,320,97,77,65,28,393,210,183,58,37,34,20,0
51531,347,154,193,48,51,25,11,462,229,233,63,49,42,18,0
51532,207,93,114,20,33,19,10,1020,538,482,145,115,111,58,0
51533,2649,1431,1218,377,299,266,102,328,199,129,39,29,27,14,0
51534,579,246,333,102,79,41,19,481,223,258,71,70,49,26,0
51535,213,114,99,62,7,2,1,398,200,198,68,43,51,14,0
51536,575,290,285,67,70,28,9,375,176,199,48,61,40,12,0
51537,328,156,172,44,37,44,15,501,274,227,63,58,53,20,0
51538,688,310,378,130,82,78,47,178,69,109,29,25,21,13,0
51539,416,207,209,63,47,56,15,1279,669,610,164,162,104,55,0
51540,288,140,148,59,33,27,12,524,300,223,70,54,51,25,0
51541,476,254,222,58,33,46,23,453,247,206,58,53,45,20,0
51542,180,92,88,29,20,26,8,222,127,95,23,28,22,7,0
51543,446,283,163,51,26,33,19,178,69,109,29,25,21,13,0
51544,443,212,231,74,24,60,24,898,469,429,125,125,134,35,0
51545,361,177,184,59,51,24,15,611,314,297,79,75,78,22,0
51546,432,233,199,52,28,47,18,724,353,371,94,95,71,31,0
51547,613,303,310,70,28,28,18,381,186,195,69,55,46,15,0
51548,1390,585,805,241,230,118,46,504,272,232,75,57,53,19,0
51549,158,85,73,24,18,18,8,212,127,85,28,21,26,6,0
51550,458,226,232,77,59,61,14,402,186,216,64,47,38,20,0
51551,410,211,199,55,42,34,27,188,105,83,25,17,24,7,0
51552,1052,492,560,184,163,103,44,196,105,91,40,13,19,10,0
51553,395,219,176,47,41,50,18,132,67,65,24,21,8,10,0
51554,763,371,392,104,88,52,23,406,234,172,63,35,43,10,0
51555,257,122,135,44,19,21,16,720,361,359,98,98,70,37,0
51556,340,145,195,46,38,26,23,679,338,341,96,95,40,23,0
51557,414,206,208,56,68,35,19,464,236,228,64,56,53,28,0
51558,330,77,253,86,52,20,12,317,161,156,50,36,47,12,0
51559,283,172,111,39,31,29,8,2382,1162,1220,237,220,140,49,0
51560,346,186,160,40,37,34,21,763,418,345,113,84,59,32,0
51561,204,109,95,21,35,27,7,227,130,97,32,25,22,12,0
51562,328,156,172,44,37,44,15,583,321,262,73,67,45,25,0
51563,374,187,187,51,52,40,27,2724,1157,1567,269,518,239,77,0
51564,402,169,233,70,36,34,18,258,129,129,45,24,31,10,0
51565,732,355,377,108,109,79,27,194,109,85,23,24,21,9,0
51566,580,240,340,108,81,59,22,341,170,171,41,66,27,10,0
51567,207,93,114,20,33,19,10,664,350,314,86,90,82,36,0
51568,462,228,234,59,47,37,32,130,67,63,24,10,12,4,0
51569,2062,706,1356,414,368,158,63,862,409,453,149,125,86,29,0
51570,414,195,219,51,60,40,17,207,113,94,33,18,30,9,0
51571,155,85,70,17,16,4,8,303,138,165,47,46,35,18,0
51572,339,118,221,77,68,33,13,375,209,166,50,37,29,23,0
51573,350,172,178,61,45,32,13,756,348,408,101,103,60,40,0
51574,345,208,137,44,27,33,8,462,229,233,63,49,42,18,0
51575,109,50,59,12,12,9,3,547,295,252,81,65,57,23,0
51576,444,228,216,47,62,53,25,770,390,380,104,76,78,32,0
51577,278,110,168,58,49,29,5,467,231,236,71,65,58,18,0
51578,325,152,173,43,47,28,17,1025,549,476,118,109,88,61,0
51579,334,190,144,42,42,16,5,377,184,193,50,43,33,17,0
51580,111,29,82,10,54,0,1,415,203,212,77,44,49,18,0
51581,376,249,127,47,23,43,16,583,280,303,95,66,76,25,0
51582,421,237,184,47,54,45,10,478,254,224,67,74,56,28,0
51583,244,104,140,52,31,30,14,597,300,297,96,89,68,29,0
51584,840,411,429,122,101,79,34,139,68,71,14,26,14,9,0
51585,952,547,405,95,90,127,35,96,46,50,16,12,7,5,0
51586,291,120,171,63,39,26,6,295,160,135,44,36,46,16,0
51587,391,204,187,47,48,38,18,403,221,182,62,50,42,12,0
51588,107,36,71,27,15,0,1,690,345,345,96,83,73,42,0
51589,563,255,308,91,111,42,30,403,221,182,62,50,42,12,0
51590,358,206,152,45,38,67,16,169,74,95,33,26,22,3,0
51591,1590,726,864,270,237,126,59,198,110,88,27,27,24,4,0
51592,510,288,222,44,36,24,7,459,260,199,56,42,47,21,0
51593,507,242,265,53,44,31,22,1352,602,750,166,185,81,70,0
51594,582,328,254,78,48,35,9,430,212,218,88,43,40,20,0
51595,492,253,239,73,67,77,29,783,406,377,102,91,57,29,0
51596,414,206,208,56,68,35,19,2382,1162,1220,237,220,140,49,0
51597,1912,880,1032,331,334,180,84,393,210,183,58,37,34,20,0
51598,412,146,266,106,38,67,35,354,183,171,54,43,49,8,0
51599,435,222,213,67,49,67,12,89,51,38,15,15,5,4,0
51600,2649,1431,1218,377,299,266,102,593,289,304,85,69,48,19,0
51601,412,193,219,69,57,43,14,166,90,76,27,18,21,5,0
51602,496,210,286,112,55,72,13,1323,690,633,132,178,112,61,0
51603,138,35,103,38,2,15,9,427,251,176,51,39,25,22,0
51604,593,282,311,75,70,29,25,481,223,258,71,70,49,26,0
51605,338,139,199,54,54,18,11,54,26,28,11,4,3,3,0
51606,1087,523,564,146,177,103,33,368,204,164,43,35,30,24,0
51607,203,80,123,40,37,20,3,1182,591,591,155,139,83,46,0
51608,1395,595,800,223,206,113,61,376,189,187,47,53,44,26,0
51609,414,206,208,56,68,35,19,471,238,233,66,63,62,19,0
51610,570,238,332,112,95,39,23,1208,565,643,182,162,120,57,0
51611,330,182,148,47,27,40,11,188,101,87,20,18,20,14,0
51612,282,160,122,36,28,27,7,134,55,79,22,24,16,6,0
51613,399,196,203,62,45,38,19,425,177,248,60,62,33,16,0
51614,410,209,201,72,30,48,22,483,258,225,70,53,54,20,0
51615,303,161,142,38,31,42,17,338,169,169,53,44,39,21,0
51616,603,311,292,102,71,66,23,198,86,112,36,27,23,9,0
51617,756,362,394,102,104,73,25,132,77,55,20,9,13,10,0
51618,439,205,234,64,88,41,21,483,258,225,70,53,54,20,0
51619,333,171,162,50,34,19,8,231,126,105,37,26,29,6,0
51620,322,164,158,46,44,29,7,862,426,436,113,115,84,37,0
51621,225,111,114,38,22,25,10,710,375,335,95,94,110,28,0
51622,574,284,290,64,50,65,20,229,120,109,31,30,22,9,0
51623,722,390,332,125,69,67,25,314,151,163,42,61,39,16,0
51624,346,191,155,52,38,40,13,337,170,167,59,33,47,17,0
51625,609,292,317,102,96,64,21,741,383,358,92,63,79,36,0
51626,288,142,146,52,32,26,8,715,345,370,110,97,64,25,0
51627,115,62,53,13,10,9,7,396,223,173,57,37,44,19,0
51628,359,204,155,39,36,34,13,535,301,234,63,48,47,27,0
51629,260,133,127,43,29,34,11,144,67,77,28,14,9,8,0
51630,949,466,483,125,126,101,50,556,290,266,75,74,29,24,0
51631,772,417,355,118,92,80,23,437,224,213,40,29,42,25,0
51632,933,456,477,123,108,83,29,180,89,91,28,27,18,7,0
51633,365,210,155,46,30,24,12,780,337,443,112,116,77,28,0
51634,2624,999,1625,415,495,109,84,301,168,133,49,37,34,11,0
51635,1161,514,647,159,138,122,37,415,189,226,68,54,50,21,0
51636,392,205,187,83,49,38,10,266,150,116,28,28,24,12,0
51637,346,173,173,50,56,31,14,124,69,55,14,7,9,4,0
51638,520,261,259,74,52,49,22,701,380,321,94,84,96,34,0
51639,2488,1085,1403,346,253,162,76,478,254,224,67,74,56,28,0
51640,181,75,106,35,26,11,9,279,161,118,37,32,7,7,0
51641,401,204,197,49,33,29,17,405,181,224,71,57,31,12,0
51642,290,156,134,44,29,39,9,414,203,211,58,56,48,14,0
51643,338,172,166,59,30,39,18,437,224,213,40,29,42,25,0
51644,176,74,102,20,29,7,7,264,138,126,33,34,29,12,0
51645,181,92,89,34,22,17,9,517,295,222,69,62,40,28,0
51646,801,331,470,151,139,99,55,252,130,122,45,23,32,11,0
51647,325,186,139,49,36,20,5,173,86,87,30,22,19,12,0
51648,426,214,212,63,47,53,20,188,88,100,53,12,15,6,0
51649,2220,1085,1135,312,304,202,91,507,270,237,89,59,57,22,0
51650,126,57,69,31,10,10,3,165,90,75,36,18,20,6,0
51651,428,248,180,44,39,28,9,621,310,311,100,106,77,27,0
51652,345,203,142,47,35,31,11,362,156,206,74,42,36,22,0
51653,500,257,243,60,55,27,22,375,176,199,48,61,40,12,0
51654,348,198,150,57,25,37,18,127,54,73,11,33,15,6,0
51655,439,183,256,60,64,36,14,422,202,220,80,52,57,18,0
51656,83,45,38,11,8,8,3,758,319,439,101,123,78,25,0
51657,585,277,308,92,73,61,32,262,129,133,40,41,31,10,0
51658,915,336,579,185,199,56,29,541,279,262,79,82,31,32,0
51659,331,144,187,57,46,33,19,727,388,339,102,87,70,29,0
51660,502,229,273,63,66,40,31,251,143,108,47,25,29,11,0
51661,102,22,80,48,8,18,6,1700,731,969,198,233,110,87,0
51662,603,311,292,102,71,66,23,647,350,297,95,79,77,29,0
51663,132,66,66,21,18,11,7,467,231,236,71,65,58,18,0
51664,2048,855,1193,297,287,191,93,384,204,180,53,47,49,17,0
51665,1226,513,713,184,147,87,43,98,49,49,14,15,9,2,0
51666,1112,457,655,180,164,99,39,810,310,500,164,162,42,26,0
51667,911,489,422,121,98,97,36,647,324,323,101,80,76,43,0
51668,249,114,135,47,33,25,4,285,146,139,41,41,48,13,0
51669,109,50,59,12,12,9,3,381,196,185,55,57,43,16,0
51670,476,199,277,82,80,49,24,330,166,164,55,51,36,16,0
51671,311,154,157,47,29,34,13,414,203,211,58,56,48,14,0
51672,240,167,73,32,12,8,21,125,66,59,24,16,11,5,0
51673,1011,559,452,121,97,132,33,434,213,221,77,62,53,12,0
51674,210,101,109,33,33,19,9,381,186,195,69,55,46,15,0
51675,949,467,482,126,127,102,51,445,192,253,86,58,53,18,0
51676,565,264,301,101,73,72,15,337,152,185,49,54,42,21,0
51677,510,288,222,44,36,24,7,201,104,97,36,32,24,7,0
51678,406,208,198,41,26,43,21,1214,475,739,177,250,89,49,0
51679,1709,650,1059,338,286,185,46,432,244,188,51,51,27,14,0
51680,743,377,366,87,74,68,30,89,42,47,16,12,15,6,0
51681,784,351,433,118,87,73,41,1166,514,652,150,159,107,70,0
51682,733,382,351,126,92,93,27,201,104,97,36,32,24,7,0
51683,641,349,292,92,60,39,24,689,343,346,105,102,81,35,0
51684,784,351,433,118,87,73,41,756,348,408,101,103,60,40,0
51685,245,111,134,36,27,18,6,165,90,75,36,18,20,6,0
51686,859,411,448,118,100,95,49,373,189,184,54,46,50,23,0
51687,232,134,98,28,20,20,5,583,280,303,95,66,76,25,0
51688,1189,653,536,152,118,109,56,1922,923,999,267,275,215,90,0
51689,624,222,402,92,81,39,15,480,255,225,67,64,50,22,0
51690,1200,602,598,145,116,110,50,127,66,61,13,14,19,8,0
51691,505,282,223,60,57,66,23,528,276,252,86,78,49,17,0
51692,162,73,89,32,19,4,4,377,184,193,50,43,33,17,0
51693,1580,742,838,208,146,144,71,432,244,188,51,51,27,14,0
51694,588,267,321,99,79,87,28,763,418,345,113,84,59,32,0
51695,1124,577,547,149,127,122,61,460,199,261,72,63,60,9,0
51696,381,146,235,74,48,47,34,1922,923,999,267,275,215,90,0
51697,368,154,214,80,52,41,16,1004,457,547,150,150,74,52,0
51698,1235,584,651,140,226,82,52,89,51,38,15,15,5,4,0
51699,331,169,162,40,28,22,14,334,182,152,45,41,27,13,0
51700,384,198,186,58,48,37,12,230,125,105,29,40,20,6,0
51701,215,80,135,54,56,21,9,317,161,156,40,49,41,11,0
51702,432,190,242,85,82,28,11,846,425,421,125,97,98,38,0
51703,250,123,127,40,28,29,8,766,386,380,101,81,78,31,0
51704,820,333,487,202,152,59,23,1241,619,622,183,169,155,59,0
51705,234,110,124,39,29,23,2,1265,689,576,169,177,128,60,0
51706,466,259,207,59,50,83,12,132,61,71,19,20,14,6,0
51707,485,237,248,83,35,52,24,175,82,93,33,26,17,5,0
51708,609,292,317,102,96,64,21,1314,693,621,174,155,140,58,0
51709,837,381,456,123,109,65,25,467,240,227,65,65,51,23,0
51710,688,310,378,130,82,78,47,352,207,145,40,33,25,21,0
51711,898,397,501,102,98,54,37,452,252,200,55,49,61,16,0
51712,498,274,224,58,59,50,18,107,77,30,7,2,9,5,0
51713,861,393,468,150,101,69,35,144,67,77,28,14,9,8,0
51714,126,57,69,31,10,10,3,104,46,58,15,17,9,5,0
51715,125,46,79,24,16,12,2,172,88,84,24,31,20,12,0
51716,886,440,446,116,140,95,45,274,157,117,40,29,40,8,0
51717,480,267,213,49,44,70,21,413,223,190,52,45,53,10,0
51718,1580,742,838,208,146,144,71,201,117,83,22,21,19,9,0
51719,2488,1085,1403,346,253,162,76,123,61,62,17,18,17,7,0
51720,4640,2231,2409,660,549,437,245,72,33,39,8,2,3,12,0
51721,281,154,127,45,31,24,9,402,186,216,64,47,38,20,0
51722,221,75,146,68,21,16,5,199,92,107,34,30,18,9,0
51723,423,247,176,58,55,29,20,600,254,346,104,100,44,17,0
51724,1341,481,860,275,264,57,21,165,90,75,36,18,20,6,0
51725,350,212,138,32,26,40,13,758,319,439,101,123,78,25,0
51726,130,71,59,30,9,8,1,68,36,32,11,8,9,2,0
51727,291,131,160,49,35,32,15,360,180,180,57,48,39,12,0
51728,272,136,136,32,34,12,12,516,245,271,82,84,70,26,0
51729,283,172,111,39,31,29,8,663,354,309,91,84,79,31,0
51730,928,442,486,139,118,91,43,475,251,224,67,49,48,23,0
51731,320,183,137,51,18,38,8,132,67,65,24,21,8,10,0
51732,2109,999,1110,332,294,187,89,766,386,380,101,81,78,31,0
51733,643,284,359,129,71,84,43,199,105,94,27,27,28,9,0
51734,238,91,147,68,19,22,7,535,288,247,79,72,35,21,0
51735,473,212,261,72,64,45,28,354,183,171,54,43,49,8,0
51736,436,209,227,66,47,52,22,396,197,199,75,49,49,16,0
51737,465,305,160,40,47,34,9,306,157,149,52,35,39,16,0
51738,334,155,179,47,34,38,11,478,254,224,67,74,56,28,0
51739,441,218,223,69,55,50,27,199,105,94,27,27,28,9,0
51740,396,150,246,103,64,38,3,320,168,152,38,42,24,18,0
51741,270,147,123,34,17,39,21,354,183,171,54,43,49,8,0
51742,784,351,433,118,87,73,41,582,264,318,84,60,58,23,0
51743,323,171,152,36,36,47,15,326,180,146,62,26,41,13,0
51744,228,82,146,45,37,18,8,145,77,68,26,7,15,8,0
51745,126,57,69,31,10,10,3,135,57,78,21,20,9,11,0
51746,204,109,95,21,35,27,7,783,406,377,102,91,57,29,0
51747,238,158,80,28,15,31,7,190,93,97,35,27,23,2,0
51748,315,170,145,48,56,22,11,215,115,100,27,19,16,7,0
51749,1544,738,806,239,217,145,91,453,247,206,58,53,45,20,0
51750,332,173,159,48,42,42,9,452,231,221,74,53,56,20,0
51751,465,240,225,50,54,24,14,169,84,85,29,19,21,7,0
51752,490,198,292,65,81,39,27,810,310,500,164,162,42,26,0
51753,317,167,150,45,21,30,26,332,180,152,44,36,27,13,0
51754,414,216,198,51,32,42,28,972,471,501,152,138,112,40,0
51755,338,172,166,59,30,39,18,758,319,439,101,123,78,25,0
51756,972,501,471,125,156,106,39,374,212,162,48,40,32,23,0
51757,447,225,222,76,35,75,21,178,99,79,31,19,26,8,0
51758,312,164,148,54,29,25,15,463,259,204,62,55,34,22,0
51759,82,36,46,17,10,5,1,261,148,113,31,28,14,10,0
51760,275,160,115,40,31,34,17,2202,1121,1081,338,274,269,81,0
51761,411,202,209,60,67,57,24,346,178,168,58,41,33,12,0
51762,55,16,39,24,2,5,2,225,129,96,32,33,20,8,0
51763,447,225,222,76,35,75,21,309,164,145,35,47,30,11,0
51764,283,112,171,48,39,34,15,222,125,97,34,27,27,7,0
51765,130,71,59,30,9,8,2,285,146,139,41,41,48,13,0
51766,425,210,215,56,43,52,25,482,231,251,76,81,64,26,0
51767,5890,3314,2576,970,956,293,265,4646,2328,2318,674,639,475,170,0
51768,639,368,271,72,51,38,38,535,301,234,63,48,47,27,0
51769,412,203,209,65,47,37,18,437,224,213,40,29,42,25,0
51770,911,489,422,121,98,97,36,316,166,150,45,38,37,13,0
51771,490,224,266,80,70,39,32,72,34,38,8,2,3,12,0
51772,213,114,99,62,7,2,1,218,118,100,33,30,25,11,0
51773,406,208,198,41,26,43,21,346,178,168,58,41,33,12,0
51774,747,469,278,60,41,53,23,699,334,365,108,80,70,20,0
51775,260,133,127,43,29,34,11,135,65,70,21,25,15,9,0
51776,381,146,235,74,48,47,34,101,59,42,11,17,10,1,0
51777,677,361,316,81,61,42,22,583,280,303,95,66,76,25,0
51778,730,298,432,128,69,86,26,701,380,321,94,84,96,34,0
51779,159,105,54,22,9,14,25,601,279,322,81,65,27,12,0
51780,236,120,116,32,28,21,11,437,221,216,62,64,47,13,0
51781,828,394,434,105,110,81,33,785,375,410,100,116,66,39,0
51782,322,164,158,46,44,29,7,903,436,467,128,116,83,33,0
51783,220,121,99,28,26,17,6,1755,905,850,214,196,183,79,0
51784,468,233,235,65,61,49,34,323,162,161,52,41,39,13,0
51785,927,457,470,130,99,118,42,323,168,155,51,41,38,12,0
51786,485,246,239,74,48,47,22,509,267,242,79,81,38,20,0
51787,622,354,268,89,60,64,18,406,202,204,54,51,63,21,0
51788,1161,514,647,159,138,122,37,130,67,63,24,10,12,4,0
51789,605,277,328,99,54,63,43,597,300,297,96,89,68,29,0
51790,280,156,124,36,19,20,13,508,253,255,73,60,50,13,0
51791,82,36,46,17,10,5,1,866,478,388,121,101,101,26,0
51792,624,222,402,92,81,39,15,212,127,85,28,21,26,6,0
51793,1365,590,775,257,168,136,93,296,140,156,49,40,42,19,0
51794,630,231,399,150,83,84,50,481,223,258,71,70,49,26,0
51795,389,176,213,81,59,24,7,452,254,198,72,57,38,18,0
51796,350,172,178,61,45,32,13,165,90,75,36,18,20,6,0
51797,126,57,69,31,10,10,3,929,459,470,140,120,94,45,0
51798,410,209,201,72,30,48,22,257,139,118,64,17,24,7,0
51799,631,304,327,98,75,52,23,375,176,199,48,61,40,12,0
51800,756,362,394,102,104,73,25,200,99,101,31,24,26,6,0
51801,346,186,160,40,37,34,21,583,280,303,95,66,76,25,0
51802,496,209,287,113,55,72,14,403,221,182,62,50,42,12,0
51803,485,237,248,83,35,52,24,1698,875,823,222,219,173,64,0
51804,261,137,124,34,23,13,8,889,505,384,107,97,99,30,0
51805,565,264,301,101,73,72,15,131,55,76,28,9,14,12,0
51806,524,361,163,41,8,28,16,1101,626,475,145,122,120,50,0
51807,226,120,106,68,8,2,1,234,116,118,34,35,23,9,0
51808,123,58,65,22,14,13,3,647,324,323,101,80,76,43,0
51809,707,250,457,171,84,117,61,432,244,188,51,51,27,14,0
51810,1054,453,601,183,183,107,35,218,118,100,33,30,25,11,0
51811,374,187,187,51,52,40,27,516,245,271,82,84,70,26,0
51812,375,201,174,52,56,39,15,295,156,139,41,40,42,15,0
51813,468,233,235,65,61,49,34,107,77,30,7,2,9,5,0
51814,798,364,434,133,88,74,35,727,388,339,102,87,70,29,0
51815,500,245,255,66,57,52,27,4646,2328,2318,674,639,475,170,0
51816,793,355,438,134,117,77,43,904,436,468,143,118,108,32,0
51817,279,129,150,43,34,17,13,1208,565,643,182,162,120,57,0
51818,328,195,133,36,23,35,9,761,351,410,117,73,103,45,0
51819,595,339,256,64,36,54,24,619,305,314,85,93,71,29,0
51820,71,28,43,15,9,5,2,487,252,235,79,58,55,26,0
51821,509,246,263,84,71,56,22,180,95,85,22,21,17,8,0
51822,373,164,209,51,45,44,21,337,170,167,59,33,47,17,0
51823,181,75,106,35,26,11,9,396,197,199,75,49,49,16,0
51824,1043,479,564,200,131,123,62,137,85,52,15,11,11,2,0
51825,1342,640,702,187,163,123,57,368,183,185,40,42,40,15,0
51826,1590,726,864,270,237,126,59,301,168,133,49,37,34,11,0
51827,466,259,207,59,50,83,12,900,441,459,125,127,110,32,0
51828,490,198,292,65,81,39,27,270,162,108,26,26,16,11,0
51829,446,283,163,51,26,33,19,374,202,172,50,39,31,24,0
51830,911,445,466,154,121,108,48,290,142,148,41,37,43,11,0
51831,326,176,150,35,22,29,11,397,234,163,44,38,23,21,0
51832,437,230,207,41,55,27,13,96,46,50,16,12,7,5,0
51833,2488,1085,1403,346,253,162,76,124,69,55,14,7,9,4,0
51834,323,156,167,52,45,39,18,461,223,238,45,62,18,35,0
51835,339,170,169,32,17,24,13,107,77,30,7,2,9,5,0
51836,1023,449,574,141,174,76,43,966,478,488,108,144,74,43,0
51837,299,128,171,57,40,13,25,535,288,247,79,72,35,21,0
51838,734,366,368,121,99,63,39,154,78,76,23,21,13,5,0
51839,155,85,70,17,16,4,8,663,360,303,87,82,80,35,0
51840,412,193,219,69,57,43,14,72,32,40,8,2,2,13,0
51841,150,64,86,22,12,29,12,432,244,188,51,51,27,14,0
51842,332,172,160,50,33,35,9,68,23,45,12,9,3,9,0
51843,193,90,103,44,9,19,13,481,223,258,71,70,49,26,0
51844,395,189,206,63,50,49,28,723,363,360,107,106,52,14,0
51845,402,169,233,70,36,34,18,892,475,417,130,108,68,38,0
51846,186,56,130,46,50,16,7,335,186,149,40,28,29,13,0
51847,184,93,91,26,25,14,11,178,69,109,29,25,21,13,0
51848,837,381,456,123,109,65,25,622,344,278,80,77,68,36,0
51849,340,169,171,40,39,36,22,463,170,293,115,54,75,32,0
51850,161,75,86,24,20,10,7,530,287,243,79,70,33,26,0
51851,482,231,251,76,81,64,26,699,334,365,108,80,70,20,0
51852,215,80,135,54,56,21,9,364,189,175,58,41,35,17,0
51853,1096,563,533,158,136,120,53,389,210,179,51,37,43,9,0
51854,919,493,426,100,92,88,49,285,146,139,41,41,48,13,0
51855,700,305,395,111,99,54,18,277,163,114,33,24,21,16,0
51856,514,226,288,71,66,63,32,267,141,126,53,27,23,7,0
51857,365,222,143,44,24,35,11,1182,591,591,155,139,83,46,0
51858,1499,864,635,141,99,76,110,415,189,226,68,54,50,21,0
51859,443,250,193,52,23,49,13,597,300,297,96,89,68,29,0
51860,535,315,220,57,55,71,19,285,146,139,41,41,48,13,0
51861,142,60,82,20,28,13,5,396,213,183,68,44,47,18,0
51862,1148,472,676,229,164,86,37,773,389,384,119,91,79,26,0
51863,462,258,204,59,41,56,15,497,227,270,70,63,66,30,0
51864,631,304,327,98,75,52,23,132,61,71,22,21,15,3,0
51865,243,70,173,54,65,8,6,316,159,157,38,48,30,11,0
51866,1556,718,838,280,182,161,49,323,162,161,52,41,39,13,0
51867,1555,702,853,250,199,139,31,194,94,100,33,28,14,7,0
51868,505,226,279,68,51,30,15,783,406,377,102,91,57,29,0
51869,272,94,178,76,33,19,4,188,90,98,44,7,21,7,0
51870,118,56,62,24,12,6,9,583,280,303,95,66,76,25,0
51871,451,225,226,69,57,64,22,180,108,72,22,22,15,5,0
51872,425,220,205,60,55,45,18,727,388,339,102,87,70,29,0
51873,303,147,156,49,49,20,8,87,51,35,15,9,9,4,0
51874,407,164,243,88,42,40,22,240,141,99,34,28,29,8,0
51875,1912,880,1032,331,334,180,84,2724,1157,1567,269,518,239,77,0
51876,330,151,179,68,36,56,9,86,40,46,16,13,9,7,0
51877,318,161,157,53,51,32,13,180,90,90,31,19,20,8,0
51878,528,188,340,130,58,77,41,364,192,172,49,36,39,14,0
51879,952,547,405,95,90,127,35,87,51,35,15,9,9,4,0
51880,206,96,110,33,25,8,6,145,77,68,26,7,15,8,0
51881,168,67,101,37,17,13,13,769,329,440,116,66,55,22,0
51882,128,69,59,29,9,8,1,260,133,127,43,32,39,3,0
51883,1960,875,1085,287,189,162,66,564,264,300,79,84,65,26,0
51884,303,147,156,49,49,20,8,597,300,297,96,89,68,29,0
51885,1867,973,894,256,222,194,65,360,180,180,57,48,39,12,0
51886,1220,575,645,208,179,99,56,203,98,105,34,29,19,10,0
51887,401,183,218,72,73,28,10,142,65,77,30,17,22,9,0
51888,463,250,213,56,45,73,25,644,343,301,96,69,59,28,0
51889,179,96,83,24,8,26,4,708,328,380,113,100,82,34,0
51890,118,51,67,25,13,6,7,1062,522,540,151,147,105,66,0
51891,411,236,175,39,45,50,30,1873,935,938,233,225,203,79,0
51892,1098,519,579,182,159,79,42,758,361,397,114,107,51,19,0
51893,446,283,163,51,26,33,19,704,355,349,113,94,71,24,0
51894,360,205,155,35,24,52,14,222,125,97,34,27,27,7,0
51895,126,56,70,31,10,10,3,271,150,121,39,36,37,5,0
51896,304,149,155,46,32,39,14,660,303,357,97,89,85,33,0
51897,364,172,192,55,57,32,15,305,163,142,38,27,47,11,0
51898,357,182,175,49,36,39,15,73,35,38,14,10,9,4,0
51899,450,227,223,53,36,48,12,149,77,72,37,10,20,5,0
51900,480,232,248,73,40,44,30,188,93,95,33,18,16,10,0
51901,734,339,395,135,89,78,36,91,42,49,21,9,8,3,0
51902,178,87,91,20,32,13,10,188,105,83,25,17,24,7,0
51903,365,148,217,86,37,51,28,277,144,133,42,30,41,8,0
51904,373,164,209,51,45,44,21,104,46,58,15,17,9,5,0
51905,284,160,124,37,23,32,11,504,272,232,75,57,53,19,0
51906,127,48,79,27,20,6,5,898,469,429,125,125,134,35,0
51907,336,134,202,51,64,27,12,314,151,163,42,61,39,16,0
51908,471,221,250,87,68,42,25,1314,693,621,174,155,140,58,0
51909,800,416,384,102,105,83,22,160,60,100,23,40,19,11,0
51910,225,111,114,38,22,25,10,132,61,71,19,20,14,6,0
51911,567,266,301,139,46,76,37,514,262,252,78,58,54,26,0
51912,126,57,69,31,10,10,3,297,164,133,45,39,40,9,0
51913,640,279,361,102,83,69,21,530,287,243,79,70,33,26,0
51914,375,167,208,55,83,44,9,265,134,131,48,34,33,15,0
51915,318,164,154,52,43,34,10,415,205,210,77,52,55,17,0
51916,99,35,64,25,18,0,1,165,87,78,24,19,22,9,0
51917,1096,563,533,158,136,120,53,665,361,304,87,91,84,31,0
51918,522,302,220,61,49,75,19,432,244,188,51,51,27,14,0
51919,1689,821,868,277,250,177,78,741,383,358,92,63,79,36,0
51920,373,194,179,42,54,26,13,380,178,202,69,53,37,10,0
51921,338,173,165,31,42,22,10,225,129,96,32,33,20,8,0
51922,1214,612,602,169,173,98,35,188,88,100,53,12,15,6,0
51923,798,287,511,126,125,77,26,531,261,270,73,80,68,26,0
51924,164,81,83,37,8,14,10,497,257,240,71,63,62,16,0
51925,342,150,192,52,43,31,17,693,360,333,100,88,62,26,0
51926,733,438,295,95,79,67,32,404,190,214,55,55,35,27,0
51927,349,167,182,54,38,30,28,132,61,71,19,20,14,6,0
51928,1143,574,569,176,151,123,59,246,107,139,55,33,27,11,0
51929,1052,492,560,184,163,103,44,137,78,59,22,16,17,4,0
51930,204,109,95,21,35,27,7,661,325,336,81,75,65,28,0
51931,552,295,257,67,49,70,30,337,170,167,59,33,47,17,0
51932,2624,999,1625,415,495,109,84,2038,1059,979,262,237,208,100,0
51933,425,198,227,57,69,59,13,975,475,500,139,140,119,28,0
51934,365,222,143,44,24,35,11,597,300,297,96,89,68,29,0
51935,186,56,130,46,50,16,7,72,34,38,8,2,3,12,0
51936,362,174,188,46,55,35,23,299,140,159,49,44,26,11,0
51937,391,165,226,67,64,36,27,720,357,363,113,85,62,39,0
51938,176,74,102,20,29,7,7,480,255,225,67,64,50,22,0
51939,837,443,394,129,89,87,38,250,119,131,58,26,29,7,0
51940,242,111,131,35,35,17,13,147,74,73,28,20,24,4,0
51941,619,289,330,67,77,36,19,283,160,123,25,20,37,9,0
51942,772,332,440,136,104,72,28,328,199,129,39,29,27,14,0
51943,364,168,196,64,61,27,6,189,95,94,25,33,16,8,0
51944,356,199,157,36,43,28,12,1182,591,591,155,139,83,46,0
51945,613,303,310,70,28,28,18,309,164,145,35,47,30,11,0
51946,317,140,177,43,26,31,16,975,475,500,139,140,119,28,0
51947,1054,453,601,183,183,107,35,305,161,144,39,40,44,17,0
51948,106,43,63,28,13,8,1,179,101,78,25,15,13,13,0
51949,257,132,125,39,27,26,10,262,129,133,40,41,31,10,0
51950,349,167,182,54,38,30,28,475,251,224,67,49,48,23,0
51951,1047,443,604,162,156,78,52,166,78,88,27,25,19,7,0
51952,341,175,166,48,43,35,18,187,89,98,36,24,20,6,0
51953,1616,735,881,285,248,153,72,229,120,109,31,30,22,9,0
51954,345,203,142,47,35,31,11,588,286,302,78,99,53,25,0
51955,466,199,267,86,59,32,17,778,391,387,94,77,41,33,0
51956,496,272,224,70,58,42,18,699,334,365,108,80,70,20,0
51957,610,249,361,107,69,72,33,145,77,68,26,7,15,8,0
51958,334,155,179,47,34,38,11,201,117,83,22,21,19,9,0
51959,1047,443,604,162,156,78,52,926,340,586,133,119,60,40,0
51960,677,361,316,81,61,42,22,548,273,275,84,81,64,30,0
51961,347,212,135,35,32,17,6,124,69,55,14,7,9,4,0
51962,271,110,161,33,27,11,8,457,253,204,67,51,48,13,0
51963,504,222,282,71,64,53,29,928,440,488,111,157,82,35,0
51964,419,210,209,54,44,31,23,252,130,122,45,23,32,11,0
51965,2000,965,1035,357,313,198,75,928,440,488,111,157,82,35,0
51966,228,82,146,45,37,18,8,72,33,39,8,2,3,12,0
51967,439,205,234,64,88,41,21,165,87,78,24,19,22,9,0
51968,164,81,83,37,8,14,10,376,183,193,50,50,43,21,0
51969,595,339,256,64,36,54,24,457,242,215,39,46,53,10,0
51970,407,230,177,44,39,34,19,582,264,318,84,60,58,23,0
51971,313,134,179,58,37,43,19,303,137,166,54,54,31,15,0
51972,325,186,139,49,36,20,5,561,279,282,85,81,88,24,0
51973,1087,523,564,146,177,103,33,220,107,113,36,35,28,9,0
51974,444,250,194,58,21,60,23,1700,731,969,198,233,110,87,0
51975,127,54,73,31,10,11,3,227,130,97,32,25,22,12,0
51976,473,265,208,47,26,50,30,335,186,149,40,28,29,13,0
51977,271,136,135,37,30,18,10,366,204,162,47,41,31,23,0
51978,403,176,227,71,56,51,11,461,223,238,45,62,18,35,0
51979,315,174,141,46,38,47,16,617,314,303,96,68,68,37,0
51980,315,111,204,82,66,46,11,316,159,157,38,48,30,11,0
51981,562,214,348,120,86,69,42,720,361,359,98,98,70,37,0
51982,272,136,136,32,34,12,12,295,160,135,44,36,46,16,0
51983,331,169,162,40,28,22,14,153,80,73,26,18,19,4,0
51984,281,125,156,44,47,17,7,96,45,51,13,12,6,4,0
51985,282,96,186,80,21,28,7,520,244,276,91,60,68,20,0
51986,221,114,107,65,7,2,1,89,51,38,15,15,5,4,0
51987,1365,590,775,257,168,136,93,548,273,275,84,81,64,30,0
51988,126,56,70,31,10,10,3,136,65,71,26,11,7,5,0
51989,320,183,137,51,18,38,8,492,278,214,65,58,32,11,0
51990,344,109,235,100,39,26,5,498,244,254,81,67,58,19,0
51991,503,260,243,46,56,33,16,2542,1245,1297,285,287,170,84,0
51992,365,222,143,44,24,35,11,579,285,294,78,72,64,32,0
51993,1064,495,569,157,159,124,58,133,61,72,21,19,13,4,0
51994,666,204,462,110,194,42,14,737,397,340,87,104,90,14,0
51995,130,70,60,30,9,8,1,474,268,206,66,42,45,24,0
51996,341,183,158,36,34,36,15,103,50,53,19,10,7,5,0
51997,338,164,174,45,32,37,13,889,505,384,107,97,99,30,0
51998,330,141,189,65,29,51,19,1279,669,610,164,162,104,55,0
51999,575,295,280,89,68,54,18,749,384,365,108,105,86,31,0
52000,2236,1195,1041,227,187,186,118,430,212,218,88,43,40,20,0
52001,341,183,158,36,34,36,15,1537,701,836,209,187,129,58,0
52002,540,252,288,73,67,57,20,165,90,75,36,18,20,6,0
52003,682,292,390,89,69,58,20,579,285,294,78,72,64,32,0
52004,510,269,241,66,67,71,26,2346,1231,1115,316,292,266,105,0
52005,688,310,378,130,82,78,47,396,213,183,68,44,47,18,0
52006,772,332,440,136,104,72,28,689,343,346,105,102,81,35,0
52007,121,69,52,15,18,14,8,325,159,166,59,46,30,12,0
52008,361,167,194,55,35,41,11,368,204,164,43,35,30,24,0
52009,392,205,187,83,49,38,10,732,402,330,81,86,87,33,0
52010,1867,973,894,256,222,194,65,630,321,309,86,90,57,26,0
52011,350,190,160,48,25,27,18,332,180,152,44,36,27,13,0
52012,798,287,511,126,125,77,26,902,499,403,118,117,92,35,0
52013,484,192,292,118,68,83,22,194,94,100,33,28,14,7,0
52014,502,274,228,64,49,75,17,328,195,133,39,40,27,13,0
52015,338,164,174,45,32,37,13,903,436,467,128,116,83,33,0
52016,677,361,316,81,61,42,22,377,184,193,50,43,33,17,0
52017,1208,575,633,187,204,117,41,508,262,246,66,67,51,20,0
52018,251,131,120,49,35,25,5,73,35,38,14,10,9,4,0
52019,610,249,361,107,69,72,33,1425,670,755,153,189,122,85,0
52020,126,57,69,31,10,10,3,429,187,242,79,72,28,19,0
52021,1390,705,685,219,164,129,74,175,82,93,33,26,17,5,0
52022,772,383,389,105,76,82,33,627,323,304,81,90,53,27,0
52023,83,45,38,11,8,8,3,455,191,264,68,86,21,19,0
52024,452,202,250,83,60,56,19,866,478,388,121,101,101,26,0
52025,435,187,248,62,51,51,21,68,23,45,12,9,3,9,0
52026,306,172,134,35,31,37,18,239,113,126,36,49,20,8,0
52027,613,303,310,70,28,28,18,292,143,149,38,42,36,16,0
52028,303,147,156,49,49,20,8,124,69,55,14,7,9,4,0
52029,413,169,244,66,94,28,19,902,499,403,118,117,92,35,0
52030,335,155,180,64,48,36,10,296,140,156,49,40,42,19,0
52031,734,366,368,121,99,63,39,904,436,468,143,118,108,32,0
52032,410,188,222,53,52,31,14,252,130,122,45,23,32,11,0
52033,253,133,120,44,31,22,8,654,295,359,99,88,71,25,0
52034,803,358,445,135,117,80,43,474,268,206,66,42,45,24,0
52035,550,304,246,60,64,77,16,798,385,413,120,115,79,30,0
52036,424,170,254,69,56,47,28,720,361,359,98,98,70,37,0
52037,540,252,288,73,67,57,20,584,249,335,80,96,22,13,0
52038,1161,514,647,159,138,122,37,452,252,200,55,49,61,16,0
52039,193,105,88,33,16,9,4,332,155,177,55,51,44,13,0
52040,417,222,195,53,39,43,10,611,314,297,79,75,78,22,0
52041,284,160,124,37,23,32,11,445,264,181,35,35,34,14,0
52042,340,181,159,44,39,35,21,664,350,314,86,90,82,36,0
52043,588,267,321,99,79,87,28,348,194,154,57,31,43,12,0
52044,1041,497,544,180,167,98,34,583,321,262,73,67,45,25,0
52045,490,224,266,80,70,39,32,761,351,410,117,73,103,45,0
52046,789,362,427,90,82,70,35,386,207,179,43,48,44,19,0
52047,136,65,71,33,11,9,6,953,489,464,126,104,111,44,0
52048,522,251,271,87,68,60,21,2136,1063,1073,317,308,223,90,0
52049,332,170,162,44,38,39,10,452,254,198,72,57,38,18,0
52050,467,233,234,83,37,77,22,169,74,95,33,26,22,3,0
52051,281,154,127,45,31,24,9,744,385,359,105,96,57,31,0
52052,1276,607,669,192,178,136,63,1700,731,969,198,233,110,87,0
52053,500,297,203,66,33,53,15,72,34,38,8,2,3,12,0
52054,249,104,145,47,41,24,17,323,168,155,51,41,38,12,0
52055,301,119,182,53,47,14,20,397,223,174,50,39,29,17,0
52056,631,304,327,98,75,52,23,501,249,252,77,70,55,22,0
52057,121,69,52,15,18,14,8,234,116,118,34,35,23,9,0
52058,732,355,377,108,109,79,27,467,231,236,71,65,58,18,0
52059,496,210,286,112,55,71,14,354,188,166,46,40,34,10,0
52060,125,53,72,18,21,18,12,316,166,150,45,38,37,13,0
52061,641,349,292,92,60,39,24,277,144,133,42,30,41,8,0
52062,733,438,295,95,79,67,32,328,199,129,39,29,27,14,0
52063,418,163,255,57,54,38,24,180,115,65,17,12,9,9,0
52064,795,384,411,133,109,85,38,462,229,233,63,49,42,18,0
52065,501,240,261,80,62,49,42,691,241,450,151,139,24,20,0
52066,451,278,173,71,35,58,12,96,46,50,16,12,7,5,0
52067,461,257,204,63,49,50,29,158,71,87,23,21,17,12,0
52068,213,104,109,56,14,9,2,564,264,300,79,84,65,26,0
52069,743,366,377,41,37,26,14,286,152,134,38,38,32,11,0
52070,342,185,157,42,27,31,14,452,252,200,55,49,61,16,0
52071,2220,1085,1135,312,304,202,91,463,268,195,59,46,46,21,0
52072,118,56,62,24,12,6,9,928,440,488,111,157,82,35,0
52073,292,102,190,71,27,51,21,723,353,370,120,109,96,33,0
52074,4640,2231,2409,660,549,437,245,393,210,183,58,37,34,20,0
52075,613,303,310,70,28,28,18,386,181,205,55,51,57,31,0
52076,130,71,59,30,9,8,1,98,49,49,14,15,9,2,0
52077,270,158,112,35,20,23,7,1182,591,591,155,139,83,46,0
52078,322,164,158,46,44,29,7,188,90,98,44,7,21,7,0
52079,631,316,315,64,57,49,15,1230,644,586,198,125,123,61,0
52080,451,225,226,69,57,64,22,452,252,200,55,49,61,16,0
52081,332,173,159,48,42,42,9,225,111,114,32,34,32,16,0
52082,500,245,255,66,57,52,27,381,187,194,37,49,36,17,0
52083,125,57,68,31,10,10,3,225,114,111,32,29,26,6,0
52084,1068,434,634,173,160,61,29,465,252,213,73,58,60,18,0
52085,763,371,392,104,88,52,23,374,202,172,50,39,31,24,0
52086,452,217,235,59,47,60,20,481,223,258,71,70,49,26,0
52087,756,362,394,102,104,73,25,188,88,100,53,12,15,6,0
52088,502,236,266,66,66,58,17,166,78,88,27,25,19,7,0
52089,525,302,223,56,48,67,19,1265,689,576,169,177,128,60,0
52090,417,222,195,53,39,43,10,469,225,244,64,68,25,11,0
52091,242,111,131,35,35,17,13,798,385,413,120,115,79,30,0
52092,336,134,202,51,64,27,12,384,204,180,53,47,49,17,0
52093,136,66,70,33,11,9,5,218,115,103,37,33,33,9,0
52094,410,209,201,72,30,48,22,283,160,123,25,20,37,9,0
52095,653,379,274,89,56,86,13,222,119,103,37,32,24,8,0
52096,860,349,511,166,166,58,19,536,222,314,101,100,34,22,0
52097,361,171,190,44,40,18,13,380,178,202,69,53,37,10,0
52098,502,236,266,66,66,58,17,381,186,195,69,55,46,15,0
52099,2048,855,1193,297,287,191,93,437,224,213,40,29,42,25,0
52100,333,171,162,41,44,48,23,192,91,101,29,28,17,7,0
52101,170,82,88,32,23,22,8,349,200,149,41,39,30,20,0
52102,362,181,181,67,46,43,8,1001,417,584,186,147,96,47,0
52103,422,207,215,79,38,53,23,160,76,84,19,24,8,5,0
52104,808,366,442,130,133,66,31,250,119,131,58,26,29,7,0
52105,739,389,350,129,61,69,25,339,175,164,51,49,37,9,0
52106,200,94,106,33,22,18,8,139,68,71,14,26,14,9,0
52107,312,173,139,43,47,28,6,54,26,28,11,4,3,3,0
52108,798,364,434,133,88,74,35,200,99,101,31,24,26,6,0
52109,1709,650,1059,338,286,185,46,396,213,183,68,44,47,18,0
52110,2174,1057,1117,241,241,214,117,339,175,164,51,49,37,9,0
52111,332,173,159,48,42,42,9,286,160,126,37,27,23,10,0
52112,781,316,465,130,129,65,23,906,455,451,116,105,87,46,0
52113,261,137,124,34,23,13,8,375,211,164,50,36,31,23,0
52114,575,295,280,89,68,54,18,381,186,195,69,55,46,15,0
52115,126,58,68,31,10,10,3,866,478,388,121,101,101,26,0
52116,476,254,222,58,33,46,23,349,200,149,41,39,30,20,0
52117,227,120,107,31,28,28,13,225,111,114,32,34,32,16,0
52118,682,292,390,89,69,58,20,395,169,226,73,55,38,9,0
52119,2696,1169,1527,432,347,193,146,398,200,198,68,43,51,14,0
52120,249,114,135,47,33,25,4,508,261,247,65,53,58,23,0
52121,1872,837,1035,280,338,169,80,166,102,64,19,14,17,2,0
52122,594,279,315,93,68,68,26,453,247,206,58,53,45,20,0
52123,466,199,267,86,59,32,17,134,72,62,14,28,8,4,0
52124,393,223,170,44,36,32,14,297,175,122,46,30,31,6,0
52125,318,161,157,53,51,32,13,536,222,314,101,100,34,22,0
52126,509,246,263,84,71,56,22,1543,794,749,182,152,132,55,0
52127,313,134,179,58,37,43,19,1321,653,668,186,195,70,35,0
52128,484,261,223,59,48,49,24,277,124,153,44,40,35,18,0
52129,786,378,408,106,98,77,39,508,253,255,73,60,50,13,0
52130,107,56,51,18,16,12,5,307,132,175,48,53,26,10,0
52131,257,122,135,44,19,21,16,775,407,368,122,100,97,32,0
52132,533,300,233,74,50,74,17,374,181,193,55,58,48,23,0
52133,439,183,256,60,64,36,14,810,310,500,164,162,42,26,0
52134,438,185,253,71,64,52,28,1395,627,768,172,263,141,59,0
52135,90,54,36,20,4,14,5,290,142,148,41,37,43,11,0
52136,648,376,272,70,60,73,24,417,232,185,58,50,29,21,0
52137,126,58,68,31,10,10,3,354,183,171,54,43,49,8,0
52138,347,198,149,45,29,29,8,264,138,126,33,34,29,12,0
52139,309,137,172,51,50,28,14,223,113,110,31,33,22,12,0
52140,629,338,291,92,57,64,22,149,77,72,37,10,20,5,0
52141,224,101,123,45,32,21,3,482,232,250,77,81,44,13,0
52142,333,171,162,41,44,48,23,463,259,204,62,55,34,22,0
52143,328,156,172,44,37,44,15,501,257,244,75,57,48,29,0
52144,2285,1219,1066,207,180,178,106,373,189,184,54,46,50,23,0
52145,2174,1057,1117,241,241,214,117,72,32,40,8,2,2,13,0
52146,1390,585,805,241,230,118,46,136,65,71,26,11,7,5,0
52147,493,281,212,56,61,30,13,260,133,127,43,32,39,3,0
52148,824,391,433,106,90,88,32,564,264,300,79,84,65,26,0
52149,202,86,116,33,29,26,10,466,263,203,59,28,57,28,0
52150,270,166,104,30,26,28,14,1040,564,476,134,110,114,51,0
52151,344,168,176,50,39,30,20,260,133,127,43,32,39,3,0
52152,773,383,390,108,76,79,30,207,86,121,34,39,11,13,0
52153,199,113,86,27,17,10,7,188,101,87,20,18,20,14,0
52154,2799,1324,1475,369,371,215,124,2724,1157,1567,269,518,239,77,0
52155,862,384,478,127,110,75,42,199,105,94,27,27,28,9,0
52156,1163,417,746,209,145,87,28,487,252,235,79,58,55,26,0
52157,1023,449,574,141,174,76,43,427,251,176,51,39,25,22,0
52158,461,257,204,63,49,50,29,295,160,135,44,36,46,16,0
52159,475,235,240,77,58,43,22,218,114,104,32,31,33,11,0
52160,1054,497,557,190,168,107,45,935,515,420,126,107,73,32,0
52161,443,226,217,67,34,53,10,292,155,137,50,34,29,13,0
52162,257,122,135,44,19,21,16,156,90,66,17,22,11,10,0
52163,500,257,243,60,55,27,22,396,197,199,75,49,49,16,0
52164,828,394,434,105,110,81,33,612,341,271,66,76,57,23,0
52165,206,96,110,33,25,8,6,1047,562,485,141,127,114,41,0
52166,414,206,208,56,68,35,19,348,212,136,53,31,25,18,0
52167,860,348,512,121,136,75,35,744,385,359,105,96,57,31,0
52168,331,169,162,40,28,22,14,475,251,224,67,49,48,23,0
52169,1041,497,544,180,167,98,34,316,166,150,45,38,37,13,0
52170,529,290,239,54,63,85,15,427,251,176,51,39,25,22,0
52171,149,68,81,15,38,11,10,463,170,293,115,54,75,32,0
52172,410,211,199,55,42,34,27,378,154,224,74,84,35,22,0
52173,142,76,66,21,21,22,11,2335,1200,1135,374,268,340,83,0
52174,800,416,384,102,105,83,22,147,74,73,28,20,24,4,0
52175,437,228,209,47,61,26,11,137,63,74,20,22,14,6,0
52176,747,469,278,60,41,53,23,562,273,289,76,92,45,24,0
52177,682,260,422,153,78,109,46,978,536,442,132,107,67,32,0
52178,126,56,70,31,10,10,3,462,251,211,74,53,41,18,0
52179,317,140,177,43,26,31,16,517,295,222,69,62,40,28,0
52180,126,66,60,24,10,7,9,479,215,264,67,80,46,28,0
52181,498,274,224,58,59,50,18,314,177,137,34,40,29,9,0
52182,640,308,332,91,102,49,21,103,50,53,19,10,7,5,0
52183,283,112,171,48,39,34,15,1114,539,575,145,131,94,56,0
52184,463,250,213,56,45,73,25,1314,693,621,174,155,140,58,0
52185,457,228,229,64,36,52,21,400,187,213,56,59,42,20,0
52186,420,189,231,79,67,33,17,565,237,328,75,88,32,11,0
52187,739,323,416,127,89,76,33,630,321,309,86,90,57,26,0
52188,345,203,142,47,35,31,11,72,33,39,8,2,3,12,0
52189,404,197,207,60,48,47,20,732,366,366,108,86,74,41,0
52190,410,188,222,53,52,31,14,218,115,103,32,32,34,11,0
52191,303,161,142,38,31,42,17,277,163,114,33,24,21,16,0
52192,1004,498,506,94,59,46,33,482,232,250,77,81,44,13,0
52193,346,173,173,50,56,31,14,1873,935,938,233,225,203,79,0
52194,462,228,234,59,47,37,32,737,320,417,112,94,73,34,0
52195,417,176,241,75,61,51,20,555,292,263,75,63,67,27,0
52196,207,128,79,26,17,19,9,2542,1245,1297,285,287,170,84,0
52197,335,171,164,51,38,38,10,541,279,262,79,82,31,32,0
52198,4640,2231,2409,660,549,437,245,497,257,240,71,63,62,16,0
52199,314,158,156,39,28,30,17,178,99,79,31,19,26,8,0
52200,385,179,206,58,56,38,19,518,292,226,60,60,52,21,0
52201,760,405,355,112,95,92,29,330,166,164,55,51,36,16,0
52202,911,489,422,121,98,97,36,279,161,118,37,32,7,7,0
52203,595,208,387,157,60,91,48,400,187,213,56,59,42,20,0
52204,553,319,234,56,37,54,18,309,164,145,35,47,30,11,0
52205,127,55,72,25,18,5,7,975,400,575,160,162,62,31,0
52206,251,139,112,41,18,27,11,198,115,83,30,22,8,8,0
52207,126,57,69,31,10,10,3,192,110,82,33,21,10,3,0
52208,160,53,107,31,29,13,3,107,77,30,7,2,9,5,0
52209,446,265,181,51,35,27,17,72,32,40,8,2,2,13,0
52210,218,133,85,20,19,13,6,135,65,70,21,25,15,9,0
52211,739,389,350,129,61,69,25,455,229,226,66,62,63,29,0
52212,122,56,66,26,13,11,5,278,154,124,42,32,38,7,0
52213,309,137,172,51,50,28,14,305,161,144,39,40,44,17,0
52214,118,56,62,24,12,6,9,156,90,66,17,22,11,10,0
52215,1960,875,1085,287,189,162,66,514,248,266,86,82,52,22,0
52216,915,336,579,185,199,56,29,778,391,387,94,77,41,33,0
52217,426,214,212,63,47,53,20,404,190,214,55,55,35,27,0
52218,498,274,224,58,59,50,18,148,84,64,30,7,17,4,0
52219,103,56,47,27,7,8,2,399,190,209,61,41,39,18,0
52220,313,148,165,45,33,36,11,317,161,156,50,36,47,12,0
52221,508,251,257,74,53,51,18,246,107,139,55,33,27,11,0
52222,438,185,253,71,64,52,28,492,278,214,65,58,32,11,0
52223,470,163,307,99,68,73,30,1034,495,539,150,134,114,71,0
52224,730,298,432,128,69,86,26,277,152,125,31,35,22,19,0
52225,76,42,34,12,8,5,7,866,478,388,121,101,101,26,0
52226,503,260,243,46,56,33,16,2038,1059,979,262,237,208,100,0
52227,329,165,164,61,44,29,17,111,60,51,17,23,10,7,0
52228,439,241,198,67,40,40,13,671,306,365,114,76,49,19,0
52229,456,223,233,77,54,47,20,142,65,77,30,17,22,9,0
52230,552,295,257,67,49,70,30,1279,669,610,164,162,104,55,0
52231,560,279,281,113,64,58,15,408,221,187,55,51,57,14,0
52232,313,178,135,43,18,35,6,130,67,63,24,10,12,4,0
52233,681,367,314,83,74,78,31,583,321,262,73,67,45,25,0
52234,107,53,54,15,15,13,4,337,152,185,49,54,42,21,0
52235,412,203,209,65,47,37,18,209,119,90,28,24,27,9,0
52236,536,287,249,64,73,21,27,736,388,348,88,85,67,28,0
52237,358,212,146,51,36,33,9,601,278,323,124,87,65,21,0
52238,407,164,243,88,42,40,22,1352,602,750,166,185,81,70,0
52239,580,240,340,108,81,59,22,166,78,88,27,25,19,7,0
52240,520,231,289,89,59,58,26,201,117,83,22,21,19,9,0
52241,285,148,137,31,42,42,16,218,117,101,35,32,34,12,0
52242,310,141,169,36,38,20,8,277,163,114,33,24,21,16,0
52243,516,224,292,79,29,45,33,265,134,131,48,34,33,15,0
52244,232,134,98,28,20,20,5,1166,514,652,150,159,107,70,0
52245,302,178,124,34,29,50,13,415,205,210,77,52,55,17,0
52246,166,59,107,36,41,10,4,163,79,84,22,24,13,5,0
52247,360,205,155,35,24,52,14,375,210,165,49,37,29,27,0
52248,372,189,183,60,44,41,18,504,272,232,75,57,53,19,0
52249,1544,738,806,239,217,145,91,562,273,289,76,92,45,24,0
52250,314,178,136,42,32,30,17,137,78,59,22,16,17,4,0
52251,364,204,160,65,35,15,13,425,177,248,60,62,33,16,0
52252,640,271,369,111,79,57,17,708,328,380,113,100,82,34,0
52253,462,228,234,59,47,37,32,479,215,264,67,80,46,28,0
52254,179,78,101,29,22,10,8,261,162,99,24,21,14,10,0
52255,1257,464,793,221,264,75,37,180,95,85,22,21,17,8,0
52256,336,199,137,46,22,51,13,660,303,357,97,89,85,33,0
52257,519,259,260,86,78,59,22,405,214,191,53,42,49,20,0
52258,567,266,301,139,46,76,37,384,212,172,44,43,34,14,0
52259,615,308,307,83,75,58,32,445,192,253,86,58,53,18,0
52260,349,167,182,54,38,30,28,862,409,453,149,125,86,29,0
52261,658,349,309,77,70,73,35,322,180,142,45,38,28,7,0
52262,793,355,438,134,117,77,43,660,303,357,97,89,85,33,0
52263,536,237,299,116,87,42,17,200,99,101,31,24,26,6,0
52264,451,225,226,69,57,64,22,406,202,204,54,51,63,21,0
52265,439,241,198,67,40,40,13,164,79,85,28,28,16,7,0
52266,522,302,220,61,49,75,19,649,307,342,71,134,45,17,0
52267,681,367,314,83,74,78,31,135,57,78,21,20,9,11,0
52268,1276,607,669,192,178,136,63,978,536,442,132,107,67,32,0
52269,342,150,192,52,43,31,17,756,348,408,101,103,60,40,0
52270,226,120,106,68,8,2,1,524,300,223,70,54,51,25,0
52271,952,547,405,95,90,127,35,660,332,328,84,73,47,19,0
52272,856,429,427,113,105,96,24,403,225,178,56,38,33,25,0
52273,510,288,222,44,36,24,7,2517,1275,1242,304,324,245,135,0
52274,949,467,482,126,127,102,51,605,283,322,94,72,64,39,0
52275,583,279,304,99,71,59,31,283,160,123,25,20,37,9,0
52276,215,104,111,61,7,2,1,301,168,133,49,37,34,11,0
52277,368,154,214,80,52,41,16,205,94,111,48,31,15,6,0
52278,240,167,73,32,12,8,21,664,350,314,86,90,82,36,0
52279,707,250,457,171,84,117,61,1004,457,547,150,150,74,52,0
52280,629,338,291,92,57,64,22,287,151,136,51,42,36,7,0
52281,297,182,115,41,22,23,8,630,321,309,86,90,57,26,0
52282,466,259,207,59,50,83,12,455,229,226,66,62,63,29,0
52283,680,308,372,82,72,71,40,290,147,143,34,34,39,13,0
52284,577,342,235,63,57,23,37,334,182,152,45,41,27,13,0
52285,168,67,101,37,17,13,13,437,225,212,61,57,66,12,0
52286,255,136,119,39,20,32,10,846,425,421,125,97,98,38,0
52287,341,177,164,57,42,40,18,354,188,166,46,40,34,10,0
52288,150,60,90,27,16,6,3,430,212,218,88,43,40,20,0
52289,2442,1193,1249,278,183,170,145,165,90,75,36,18,20,6,0
52290,625,283,342,93,89,67,25,188,88,100,53,12,15,6,0
52291,630,231,399,150,83,84,50,346,178,168,58,41,33,12,0
52292,213,104,109,56,14,9,2,330,166,164,55,51,36,16,0
52293,911,441,470,123,108,60,21,1543,794,749,182,152,132,55,0
52294,261,130,131,27,41,19,16,1698,875,823,222,219,173,64,0
52295,291,131,160,49,35,32,15,593,289,304,85,69,48,19,0
52296,341,177,164,57,42,40,18,201,99,102,34,26,23,6,0
52297,1580,742,838,208,146,144,71,2346,1231,1115,316,292,266,105,0
52298,126,58,68,31,10,10,3,370,173,197,65,57,42,10,0
52299,454,214,240,56,71,35,16,1537,701,836,209,187,129,58,0
52300,820,333,487,202,152,59,23,593,289,304,85,69,48,19,0
52301,376,171,205,45,45,34,12,132,61,71,22,21,15,3,0
52302,219,105,114,36,29,19,8,1117,422,695,182,134,88,32,0
52303,299,151,148,35,34,26,16,220,107,113,36,35,28,9,0
52304,2799,1324,1475,369,371,215,124,2547,1280,1267,331,335,293,118,0
52305,178,87,91,20,32,13,10,205,94,111,48,31,15,6,0
52306,627,237,390,137,57,108,44,741,383,358,92,63,79,36,0
52307,941,459,482,167,140,82,38,130,67,63,24,10,12,4,0
52308,505,226,279,68,51,30,15,359,171,188,49,74,45,11,0
52309,529,290,239,54,63,85,15,737,397,340,87,104,90,14,0
52310,364,204,160,65,35,15,13,555,282,273,82,69,65,21,0
52311,747,360,387,125,92,69,32,1113,480,633,170,173,81,34,0
52312,207,128,79,26,17,19,9,445,202,243,70,73,51,15,0
52313,410,188,222,53,52,31,14,448,217,231,56,63,29,10,0
52314,376,176,200,31,53,27,8,2225,1244,981,271,243,217,93,0
52315,575,295,280,89,68,54,18,445,192,253,86,58,53,18,0
52316,127,62,65,13,33,7,6,296,140,156,49,40,42,19,0
52317,517,196,321,103,98,33,12,627,323,304,81,90,53,27,0
52318,627,237,390,137,57,108,44,108,59,49,17,13,12,5,0
52319,479,227,252,69,48,46,18,308,146,162,42,39,24,12,0
52320,667,366,301,96,55,84,25,464,236,228,64,56,53,28,0
52321,139,81,58,17,14,24,9,405,195,210,57,74,24,17,0
52322,1249,543,706,187,164,125,52,165,87,78,24,19,22,9,0
52323,466,199,267,86,59,32,17,400,187,213,56,59,42,20,0
52324,1107,601,506,155,138,103,49,464,236,228,64,56,53,28,0
52325,1139,537,602,162,139,109,50,463,259,204,62,55,34,22,0
52326,475,235,240,77,58,43,22,132,67,65,24,21,8,10,0
52327,144,57,87,38,26,10,4,775,407,368,122,100,97,32,0
52328,904,436,468,138,146,82,39,222,127,95,23,28,22,7,0
52329,329,168,161,48,34,41,16,306,157,149,52,35,39,16,0
52330,170,82,88,32,23,22,8,2225,1244,981,271,243,217,93,0
52331,427,191,236,67,60,41,34,579,285,294,78,72,64,32,0
52332,525,254,271,60,76,46,13,73,35,38,14,10,9,4,0
52333,346,174,172,36,43,21,9,130,67,63,24,10,12,4,0
52334,886,440,446,116,140,95,45,647,350,297,95,79,77,29,0
52335,682,260,422,153,78,109,46,611,314,297,79,75,78,22,0
52336,1580,742,838,208,146,144,71,530,287,243,79,70,33,26,0
52337,240,98,142,49,42,23,17,229,120,109,31,30,22,9,0
52338,203,80,123,40,37,20,3,594,312,282,72,67,73,31,0
52339,494,233,261,87,57,46,18,329,194,135,45,32,33,9,0
52340,1068,434,634,173,160,61,29,222,125,97,34,27,27,7,0
52341,480,232,248,73,40,44,30,485,244,241,80,55,59,20,0
52342,213,113,100,26,21,26,12,415,203,212,77,44,49,18,0
52343,1087,523,564,146,177,103,33,316,159,157,38,48,30,11,0
52344,533,300,233,74,50,74,17,425,177,248,60,62,33,16,0
52345,730,298,432,128,69,86,26,1113,480,633,170,173,81,34,0
52346,193,110,83,18,20,15,12,334,181,153,56,31,28,18,0
52347,313,178,135,43,18,35,6,704,355,349,113,94,71,24,0
52348,173,90,83,30,19,19,11,585,277,308,92,73,61,32,0
52349,323,171,152,36,36,47,15,247,128,119,40,21,27,11,0
52350,395,219,176,47,41,50,18,232,111,121,23,29,17,9,0
52351,559,217,342,105,86,42,16,102,51,51,12,15,12,3,0
52352,1161,514,647,159,138,122,37,627,289,338,101,73,62,43,0
52353,325,152,173,43,47,28,17,978,536,442,132,107,67,32,0
52354,598,322,276,67,57,63,26,148,69,79,26,18,16,3,0
52355,530,259,271,83,50,54,41,375,209,166,50,37,29,23,0
52356,494,233,261,87,57,46,18,1241,619,622,183,169,155,59,0
52357,443,212,231,74,24,60,24,229,120,109,31,30,22,9,0
52358,452,217,235,59,47,60,20,198,86,112,36,27,23,9,0
52359,1004,498,506,94,59,46,33,766,386,380,101,81,78,31,0
52360,345,208,137,44,27,33,8,314,151,163,42,61,39,16,0
52361,437,167,270,126,95,34,10,103,50,53,19,10,7,5,0
52362,264,122,142,46,24,35,10,105,51,54,13,17,12,8,0
52363,303,147,156,49,49,20,8,72,32,40,8,2,2,13,0
52364,2048,855,1193,297,287,191,93,119,61,58,17,12,10,6,0
52365,2062,706,1356,414,368,158,63,474,268,206,66,42,45,24,0
52366,421,237,184,47,54,45,10,530,287,243,79,70,33,26,0
52367,172,82,90,21,35,21,5,975,475,500,139,140,119,28,0
52368,51,10,41,25,0,5,8,866,478,388,121,101,101,26,0
52369,328,156,172,44,37,44,15,296,159,137,49,28,38,13,0
52370,708,344,364,106,98,66,33,137,78,59,22,16,17,4,0
52371,301,119,182,53,47,14,20,483,258,225,70,53,54,20,0
52372,308,163,145,38,33,30,20,325,159,166,59,46,30,12,0
52373,411,171,240,61,81,30,15,154,78,76,23,21,13,5,0
52374,341,154,187,34,36,11,11,169,74,95,33,26,22,3,0
52375,610,249,361,107,69,72,33,148,84,64,30,7,17,4,0
52376,1051,429,622,179,148,125,54,418,223,195,53,43,49,15,0
52377,473,217,256,59,44,34,21,892,475,417,130,108,68,38,0
52378,446,195,251,56,53,31,15,375,211,164,50,36,31,23,0
52379,155,85,70,17,16,4,8,1248,584,664,184,164,155,67,0
52380,406,208,198,41,26,43,21,963,455,508,127,130,115,48,0
52381,325,152,173,43,47,28,17,701,380,321,94,84,96,34,0
52382,756,362,394,102,104,73,25,218,115,103,32,32,34,11,0
52383,802,375,427,133,103,81,41,462,229,233,63,49,42,18,0
52384,341,175,166,48,43,35,18,228,130,98,35,29,30,10,0
52385,443,226,217,67,34,53,10,344,190,154,34,31,36,10,0
52386,1107,601,506,155,138,103,49,127,66,61,13,14,19,8,0
52387,685,393,292,75,66,113,16,323,162,161,52,41,39,13,0
52388,388,244,144,46,25,42,16,188,90,98,44,7,21,7,0
52389,616,323,293,98,71,31,15,463,259,204,62,55,34,22,0
52390,126,57,69,31,10,10,3,332,173,159,48,40,31,11,0
52391,745,402,343,95,71,69,40,323,171,152,48,41,40,16,0
52392,1148,472,676,229,164,86,37,220,107,113,36,35,28,9,0
52393,309,137,172,51,50,28,14,1208,565,643,182,162,120,57,0
52394,772,332,440,136,104,72,28,96,46,50,16,12,7,5,0
52395,275,160,115,40,31,34,17,87,51,35,15,9,9,4,0
52396,862,384,478,127,110,75,42,926,425,501,159,147,77,35,0
52397,794,322,472,122,108,79,34,1262,653,609,169,165,152,50,0
52398,480,232,248,73,40,44,30,323,168,155,51,41,38,12,0
52399,128,67,61,29,9,9,1,482,232,250,77,81,44,13,0
52400,446,195,251,56,53,31,15,267,141,126,53,27,23,7,0
52401,130,71,59,30,9,8,1,360,180,180,57,48,39,12,0
52402,853,400,453,137,109,88,42,338,169,169,53,44,39,21,0
52403,380,187,193,38,51,30,18,218,115,103,37,33,33,9,0
52404,123,58,65,22,14,13,3,107,77,30,7,2,9,5,0
52405,419,210,209,54,44,31,23,296,140,156,49,40,42,19,0
52406,323,156,167,52,45,39,18,665,361,304,87,91,84,31,0
52407,594,248,346,104,109,53,5,335,186,149,40,28,29,13,0
52408,420,202,218,67,43,51,15,231,126,105,28,26,34,9,0
52409,330,151,179,68,36,56,9,925,439,486,141,134,105,46,0
52410,173,90,83,30,19,19,11,715,345,370,110,97,64,25,0
52411,496,210,286,112,55,71,14,1182,591,591,155,139,83,46,0
52412,624,222,402,92,81,39,15,127,58,69,18,17,10,5,0
52413,494,233,261,87,57,46,18,328,199,129,39,29,27,14,0
52414,1130,614,516,129,138,98,42,198,113,85,19,20,26,12,0
52415,489,253,236,73,36,62,17,72,33,39,8,2,3,12,0
52416,221,114,107,65,7,2,1,336,200,136,34,29,25,24,0
52417,472,222,250,46,61,33,23,1696,771,925,257,225,149,63,0
52418,674,318,356,86,139,50,11,380,178,202,69,53,37,10,0
52419,317,167,150,45,21,30,26,203,98,105,34,29,19,10,0
52420,130,70,60,30,9,8,1,124,69,55,14,7,9,4,0
52421,485,237,248,83,35,52,24,565,237,328,75,88,32,11,0
52422,388,209,179,46,24,31,28,171,94,77,24,28,30,11,0
52423,124,58,66,20,28,11,7,218,114,104,32,31,33,11,0
52424,587,318,269,76,50,38,21,582,264,318,84,60,58,23,0
52425,119,59,60,29,10,6,4,332,173,159,48,40,31,11,0
52426,256,152,104,18,23,23,8,175,91,84,19,21,21,10,0
52427,51,10,41,25,0,5,8,166,78,88,27,25,19,7,0
52428,648,262,386,113,108,78,29,245,121,124,37,35,36,12,0
52429,431,202,229,57,50,50,25,1537,701,836,209,187,129,58,0
52430,126,66,60,24,10,7,9,452,231,221,74,53,56,20,0
52431,468,233,235,65,61,49,34,892,475,417,130,108,68,38,0
52432,416,222,194,58,38,38,20,1065,581,484,134,97,76,46,0
52433,146,73,73,18,24,17,9,160,60,100,23,40,19,11,0
52434,1161,514,647,159,138,122,37,138,69,69,28,7,10,10,0
52435,2136,1063,1073,317,308,223,90,621,310,311,100,106,77,27,0
52436,415,217,198,50,31,42,17,374,191,183,40,52,40,16,0
52437,593,282,311,75,70,29,25,2225,1244,981,271,243,217,93,0
52438,341,175,166,48,43,35,18,903,436,467,128,116,83,33,0
52439,163,70,93,28,21,17,6,305,161,144,39,40,44,17,0
52440,303,161,142,38,31,42,17,551,226,325,96,103,43,11,0
52441,852,472,380,99,79,70,27,335,170,165,52,36,47,11,0
52442,330,141,189,65,29,51,19,218,115,103,32,32,34,11,0
52443,407,164,243,88,42,40,22,135,57,78,21,20,9,11,0
52444,482,245,237,69,64,66,24,660,333,327,102,95,69,31,0
52445,359,204,155,39,36,34,13,239,113,126,36,49,20,8,0
52446,456,214,242,76,62,52,22,374,212,162,48,40,32,23,0
52447,1544,738,806,239,217,145,91,2724,1157,1567,269,518,239,77,0
52448,1463,521,942,252,204,105,52,403,184,219,75,51,47,20,0
52449,4128,2104,2024,581,505,453,205,218,111,107,45,29,24,6,0
52450,528,273,255,67,53,29,20,152,71,81,41,16,14,2,0
52451,380,148,232,81,69,24,8,336,200,136,34,29,25,24,0
52452,179,96,83,24,8,26,4,975,475,500,139,140,119,28,0
52453,808,366,442,130,133,66,31,187,89,98,36,24,20,6,0
52454,956,450,506,122,117,82,36,172,79,93,34,27,23,10,0
52455,457,228,229,64,36,52,21,1241,619,622,183,169,155,59,0
52456,496,210,286,111,55,74,13,303,137,166,54,54,31,15,0
52457,412,203,209,65,47,37,18,274,157,117,40,29,40,8,0
52458,820,333,487,202,152,59,23,1425,670,755,153,189,122,85,0
52459,665,341,324,109,79,38,22,199,92,107,34,30,18,9,0
52460,241,122,119,27,34,17,16,475,251,224,67,49,48,23,0
52461,127,62,65,13,33,7,6,1061,543,518,146,123,109,67,0
52462,233,107,126,40,40,20,16,201,98,103,28,25,19,13,0
52463,128,70,58,29,9,8,1,414,203,211,58,56,48,14,0
52464,379,217,162,47,20,50,23,166,78,88,27,25,19,7,0
52465,317,167,150,45,21,30,26,1166,514,652,150,159,107,70,0
52466,146,73,73,18,24,17,9,536,222,314,101,100,34,22,0
52467,310,141,169,36,38,20,8,360,185,175,51,43,36,16,0
52468,126,56,70,31,10,10,3,386,207,179,43,48,44,19,0
52469,221,114,107,65,7,2,1,429,187,242,79,72,28,19,0
52470,548,250,298,85,64,56,21,367,199,168,62,44,34,8,0
52471,402,169,233,70,36,34,18,251,143,108,47,25,29,11,0
52472,480,232,248,73,40,44,30,300,148,152,45,43,40,8,0
52473,915,336,579,185,199,56,29,497,257,240,71,63,62,16,0
52474,319,222,97,36,23,28,8,149,77,72,37,10,20,5,0
52475,121,69,52,15,18,14,8,926,425,501,159,147,77,35,0
52476,531,284,247,66,42,49,15,749,384,365,108,105,86,31,0
52477,507,242,265,53,44,31,22,1922,923,999,267,275,215,90,0
52478,505,247,258,72,71,60,27,621,273,348,104,102,48,19,0
52479,139,81,58,17,14,24,9,475,251,224,67,49,48,23,0
52480,548,250,298,85,64,56,21,367,218,149,45,43,42,16,0
52481,464,237,227,64,66,33,12,377,184,193,50,43,33,17,0
52482,217,98,119,38,35,18,9,892,475,417,130,108,68,38,0
52483,302,178,124,34,29,50,13,247,128,119,34,14,16,14,0
52484,1711,865,846,204,176,105,60,266,146,120,41,28,31,7,0
52485,313,178,135,43,18,35,6,89,42,47,16,12,15,6,0
52486,483,236,247,82,60,43,18,445,202,243,70,73,51,15,0
52487,664,269,395,117,107,36,15,148,69,79,26,18,16,3,0
52488,199,113,86,27,17,10,7,363,180,183,60,34,10,6,0
52489,463,225,238,76,36,59,26,600,254,346,104,100,44,17,0
52490,2624,999,1625,415,495,109,84,108,59,49,17,13,12,5,0
52491,415,133,282,114,65,27,7,1606,753,853,215,227,182,48,0
52492,130,70,60,30,9,8,1,609,335,274,79,57,45,22,0
52493,1395,595,800,223,206,113,61,1208,565,643,182,162,120,57,0
52494,417,222,195,53,39,43,10,1025,549,476,118,109,88,61,0
52495,334,155,179,47,34,38,11,297,175,122,46,30,31,6,0
52496,557,211,346,129,125,48,19,68,23,45,12,9,3,9,0
52497,260,136,124,24,41,19,4,1101,626,475,145,122,120,50,0
52498,297,182,115,41,22,23,8,218,111,107,45,29,24,6,0
52499,255,110,145,34,32,23,17,561,279,282,85,81,88,24,0
52500,1709,650,1059,338,286,185,46,328,195,133,39,40,27,13,0
52501,800,416,384,102,105,83,22,335,186,149,40,28,29,13,0
52502,1284,511,773,227,166,169,107,1065,581,484,134,97,76,46,0
52503,200,103,97,17,16,10,10,138,69,69,28,7,10,10,0
52504,99,35,64,25,18,0,1,2202,1121,1081,338,274,269,81,0
52505,411,211,200,61,46,35,18,1500,804,696,190,172,144,60,0
52506,492,253,239,73,67,77,29,953,489,464,126,104,111,44,0
52507,516,224,292,79,29,45,33,283,160,123,25,20,37,9,0
52508,465,220,245,88,34,61,23,424,179,245,65,67,29,11,0
52509,302,160,142,35,35,37,10,188,93,95,33,18,16,10,0
52510,164,61,103,47,19,14,5,858,461,397,125,114,79,45,0
52511,496,210,286,112,55,72,13,260,133,127,43,32,39,3,0
52512,781,367,414,60,67,43,17,723,363,360,107,106,52,14,0
52513,338,139,199,54,54,18,11,1113,480,633,170,173,81,34,0
52514,785,374,411,56,42,38,25,125,66,59,24,16,11,5,0
52515,368,154,214,80,52,41,16,536,267,269,60,70,41,22,0
52516,334,190,144,42,42,16,5,501,257,244,75,57,48,29,0
52517,1709,650,1059,338,286,185,46,507,270,237,89,59,57,22,0
52518,583,279,304,99,71,59,31,308,146,162,42,39,24,12,0
52519,562,214,348,120,86,69,42,277,144,133,42,30,41,8,0
52520,426,231,195,51,52,45,24,166,90,76,27,18,21,5,0
52521,156,64,92,31,19,5,4,227,130,97,32,25,22,12,0
52522,424,170,254,69,56,47,28,292,143,149,38,42,36,16,0
52523,178,89,89,40,12,18,7,142,65,77,30,17,22,9,0
52524,346,208,138,46,39,51,18,277,138,139,40,39,20,14,0
52525,1112,457,655,180,164,99,39,295,158,137,42,34,38,14,0
52526,502,229,273,63,66,40,31,487,252,235,79,58,55,26,0
52527,332,172,160,50,33,35,9,65,32,33,16,4,8,3,0
52528,478,220,258,47,70,41,10,926,340,586,133,119,60,40,0
52529,861,393,468,150,101,69,35,390,190,200,66,50,43,12,0
52530,282,105,177,77,28,39,6,138,69,69,28,7,10,10,0
52531,346,205,141,47,34,30,7,866,478,388,121,101,101,26,0
52532,795,384,411,133,109,85,38,548,296,252,71,74,43,28,0
52533,583,279,304,99,71,59,31,601,278,323,124,87,65,21,0
52534,786,378,408,106,98,77,39,925,439,486,141,134,105,46,0
52535,1161,514,647,159,138,122,37,518,292,226,60,60,52,21,0
52536,1171,542,629,170,146,114,64,192,91,101,29,28,17,7,0
52537,407,230,177,44,39,34,19,213,129,84,32,14,21,15,0
52538,286,111,175,51,47,21,12,399,190,209,61,41,39,18,0
52539,756,362,394,102,104,73,25,325,172,153,44,34,27,14,0
52540,1542,682,860,290,158,120,47,390,223,167,58,36,45,18,0
52541,496,210,286,112,55,71,14,172,79,93,34,27,23,10,0
52542,264,122,142,46,24,35,10,866,478,388,121,101,101,26,0
52543,983,449,534,95,77,55,36,124,69,55,14,7,9,4,0
52544,763,371,392,104,88,52,23,866,478,388,121,101,101,26,0
52545,648,376,272,70,60,73,24,526,266,260,76,75,53,22,0
52546,258,144,114,33,22,19,9,470,205,265,71,80,33,11,0
52547,785,374,411,56,42,38,25,154,78,76,23,21,13,5,0
52548,407,164,243,88,42,40,22,572,305,267,74,72,58,21,0
52549,427,191,236,67,60,41,34,127,66,61,13,14,19,8,0
52550,348,198,150,57,25,37,18,1500,804,696,190,172,144,60,0
52551,908,324,584,181,162,81,29,234,129,105,31,22,19,17,0
52552,745,402,343,95,71,69,40,285,143,142,45,32,21,17,0
52553,700,305,395,111,99,54,18,579,285,294,78,72,64,32,0
52554,743,377,366,87,74,68,30,283,160,123,25,20,37,9,0
52555,313,178,135,43,18,35,6,180,95,85,22,21,17,8,0
52556,273,126,147,54,49,25,18,139,68,71,14,26,14,9,0
52557,413,236,177,41,25,35,19,381,186,195,69,55,46,15,0
52558,328,156,172,44,37,44,15,935,515,420,126,107,73,32,0
52559,162,73,89,32,19,4,4,111,60,51,17,23,10,7,0
52560,640,279,361,102,83,69,21,149,52,97,36,36,7,4,0
52561,181,95,86,21,22,18,9,1583,556,1027,265,315,86,51,0
52562,163,70,93,28,21,17,6,761,351,410,117,73,103,45,0
52563,288,140,148,59,33,27,12,715,348,367,109,84,68,30,0
52564,118,51,67,25,13,6,7,2346,1231,1115,316,292,266,105,0
52565,176,74,102,20,29,7,7,234,116,118,34,35,23,9,0
52566,567,266,301,139,46,76,37,130,67,63,24,10,12,4,0
52567,332,170,162,44,38,39,10,483,215,268,66,70,30,16,0
52568,313,158,155,43,35,43,16,498,244,254,81,67,58,19,0
52569,833,295,538,146,139,65,34,377,184,193,50,43,33,17,0
52570,273,126,147,54,49,25,18,1873,935,938,233,225,203,79,0
52571,271,110,161,33,27,11,8,497,227,270,70,63,66,30,0
52572,224,108,116,31,32,22,8,295,156,139,41,40,42,15,0
52573,361,177,184,59,51,24,15,432,244,188,51,51,27,14,0
52574,463,225,238,76,36,59,26,736,388,348,88,85,67,28,0
52575,854,435,419,118,91,95,42,389,207,182,53,58,52,18,0
52576,76,30,46,7,15,1,5,403,225,178,56,38,33,25,0
52577,509,246,263,84,71,56,22,119,61,58,17,12,10,6,0
52578,466,259,207,59,50,83,12,285,146,139,41,41,48,13,0
52579,450,227,223,53,36,48,12,1262,653,609,169,165,152,50,0
52580,385,179,206,58,56,38,19,671,306,365,114,76,49,19,0
52581,548,250,298,85,64,56,21,106,54,52,12,9,7,6,0
52582,540,257,283,81,63,57,24,110,53,57,14,15,4,6,0
52583,276,149,127,45,34,39,9,396,213,183,68,44,47,18,0
52584,734,366,368,121,99,63,39,373,189,184,54,46,50,23,0
52585,203,97,106,30,22,18,10,427,251,176,51,39,25,22,0
52586,312,164,148,54,29,25,15,153,65,88,28,21,20,8,0
52587,300,136,164,45,35,45,14,279,142,137,43,39,28,7,0
52588,3703,1708,1995,456,428,305,162,354,188,166,46,40,34,10,0
52589,963,477,486,134,143,123,38,316,166,150,45,38,37,13,0
52590,280,128,152,39,37,38,18,223,113,110,31,33,22,12,0
52591,365,210,155,46,30,24,12,601,278,323,124,87,65,21,0
52592,413,169,244,66,94,28,19,286,152,134,38,38,32,11,0
52593,631,316,315,64,57,49,15,293,142,151,49,40,42,17,0
52594,170,82,88,32,23,22,8,194,106,88,33,10,15,6,0
52595,1718,735,983,266,225,130,68,536,222,314,101,100,34,22,0
52596,402,169,233,70,36,34,18,326,149,177,51,51,28,10,0
52597,431,199,232,59,54,40,17,158,71,87,23,21,17,12,0
52598,399,196,203,62,45,38,19,627,289,338,101,73,62,43,0
52599,233,110,123,34,22,34,9,531,261,270,73,80,68,26,0
52600,207,93,114,20,33,19,10,665,361,304,87,91,84,31,0
52601,1711,865,846,204,176,105,60,723,363,360,107,106,52,14,0
52602,435,230,205,51,37,55,18,137,72,65,27,13,15,8,0
52603,301,157,144,31,28,34,9,630,321,309,86,90,57,26,0
52604,368,201,167,61,38,38,12,362,156,206,74,42,36,22,0
52605,200,94,106,33,22,18,8,346,196,150,43,26,27,14,0
52606,224,108,116,31,32,22,8,96,46,50,16,12,7,5,0
52607,480,232,248,73,40,44,30,556,290,266,75,74,29,24,0
52608,126,56,70,31,10,10,3,164,79,85,28,28,16,7,0
52609,346,168,178,36,43,20,9,392,214,178,48,40,53,22,0
52610,451,278,173,71,35,58,12,316,159,157,38,48,30,11,0
52611,580,308,272,82,79,58,25,732,402,330,81,86,87,33,0
52612,117,57,60,17,14,11,10,434,213,221,77,62,53,12,0
52613,579,321,258,74,70,47,22,262,129,133,40,41,31,10,0
52614,233,107,126,40,40,20,16,564,264,300,79,84,65,26,0
52615,1043,479,564,200,131,123,62,234,129,105,31,22,19,17,0
52616,416,207,209,63,47,56,15,818,357,461,122,136,54,25,0
52617,478,177,301,109,66,59,25,247,128,119,34,14,16,14,0
52618,828,368,460,118,98,59,38,152,71,81,41,16,14,2,0
52619,215,104,111,61,7,2,1,516,245,271,82,84,70,26,0
52620,574,269,305,91,63,54,27,277,138,139,40,39,20,14,0
52621,193,90,103,44,9,19,13,179,101,78,25,15,13,13,0
52622,442,254,188,46,22,40,19,164,79,85,28,28,16,7,0
52623,732,355,377,108,109,79,27,798,385,413,120,115,79,30,0
52624,562,214,348,120,86,69,42,292,143,149,38,42,36,16,0
52625,496,272,224,70,58,42,18,104,46,58,15,17,9,5,0
52626,1199,589,610,189,128,167,65,384,212,172,44,43,34,14,0
52627,548,310,238,72,62,54,13,483,215,268,66,70,30,16,0
52628,2488,1085,1403,346,253,162,76,334,182,152,45,41,27,13,0
52629,619,289,330,67,77,36,19,389,210,179,51,37,43,9,0
52630,126,56,70,31,10,10,3,598,333,265,79,66,54,33,0
52631,961,465,496,139,156,62,34,137,63,74,20,22,14,6,0
52632,588,300,288,100,57,65,27,723,353,370,120,109,96,33,0
52633,1872,837,1035,280,338,169,80,1323,690,633,132,178,112,61,0
52634,379,217,162,47,20,50,23,198,113,85,19,20,26,12,0
52635,219,116,103,66,7,2,1,461,223,238,45,62,18,35,0
52636,125,57,68,31,10,10,3,188,88,100,53,12,15,6,0
52637,126,58,68,31,10,10,3,282,134,148,38,45,29,10,0
52638,257,132,125,39,27,26,10,538,274,264,84,67,52,35,0
52639,71,28,43,15,9,5,2,518,292,226,60,60,52,21,0
52640,376,249,127,47,23,43,16,2202,1121,1081,338,274,269,81,0
52641,1284,511,773,227,166,169,107,457,242,215,39,46,53,10,0
52642,282,163,119,40,23,25,17,925,439,486,141,134,105,46,0
52643,259,119,140,48,28,29,19,469,225,244,64,68,25,11,0
52644,473,217,256,59,44,34,21,303,137,166,54,54,31,15,0
52645,579,246,333,102,79,41,19,461,223,238,45,62,18,35,0
52646,314,158,156,39,28,30,17,296,151,145,45,42,32,11,0
52647,413,206,207,38,55,19,10,234,129,105,31,22,19,17,0
52648,343,189,154,44,24,39,12,137,63,74,20,22,14,6,0
52649,758,378,380,89,64,37,31,498,244,254,81,67,58,19,0
52650,186,56,130,46,50,16,7,230,125,105,29,40,20,6,0
52651,473,212,261,72,64,45,28,158,71,87,23,21,17,12,0
52652,2000,965,1035,357,313,198,75,348,194,154,57,31,43,12,0
52653,399,220,179,48,37,68,18,4646,2328,2318,674,639,475,170,0
52654,395,189,206,63,50,49,28,316,166,150,45,38,37,13,0
52655,284,160,124,37,23,32,11,325,172,153,44,34,27,14,0
52656,927,457,470,130,99,118,42,153,80,73,26,18,19,4,0
52657,1009,487,522,177,121,103,51,496,285,211,62,54,46,22,0
52658,240,167,73,32,12,8,21,748,359,389,125,113,86,31,0
52659,117,58,59,17,17,12,2,89,38,51,14,6,3,9,0
52660,560,279,281,113,64,58,15,1208,565,643,182,162,120,57,0
52661,598,322,276,67,57,63,26,308,146,162,42,39,24,12,0
52662,859,411,448,118,100,95,49,480,255,225,67,64,50,22,0
52663,371,209,162,46,17,36,19,329,196,133,41,36,31,15,0
52664,371,209,162,46,17,36,19,188,88,100,53,12,15,6,0
52665,220,113,107,37,24,16,7,439,227,212,60,55,58,8,0
52666,1390,705,685,219,164,129,74,234,116,118,34,35,23,9,0
52667,736,320,416,113,97,61,36,261,162,99,24,21,14,10,0
52668,315,174,141,46,38,47,16,647,350,297,95,79,77,29,0
52669,682,260,422,98,83,42,31,348,212,136,53,31,25,18,0
52670,316,157,159,45,38,22,19,136,65,71,26,11,7,5,0
52671,196,107,89,20,31,17,4,710,375,335,95,94,110,28,0
52672,1051,429,622,179,148,125,54,65,32,33,16,4,8,3,0
52673,335,183,152,40,26,54,22,127,54,73,11,33,15,6,0
52674,130,71,59,30,9,8,1,367,199,168,62,44,34,8,0
52675,708,344,364,106,98,66,33,621,310,311,100,106,77,27,0
52676,164,61,103,47,19,14,5,417,232,185,58,50,29,21,0
52677,536,287,249,64,73,21,27,1101,626,475,145,122,120,50,0
52678,733,382,351,126,92,93,27,582,264,318,84,60,58,23,0
52679,949,467,482,126,127,102,51,152,71,81,41,16,14,2,0
52680,486,243,243,65,48,63,22,364,189,175,58,41,35,17,0
52681,325,181,144,46,31,48,9,132,77,55,20,9,13,10,0
52682,574,269,305,91,63,54,27,474,268,206,66,42,45,24,0
52683,128,67,61,29,9,9,1,266,150,116,28,28,24,12,0
52684,362,181,181,67,46,43,8,947,482,465,143,107,89,37,0
52685,270,128,142,36,43,15,11,633,311,322,94,82,45,20,0
52686,130,70,60,30,9,8,1,242,124,118,39,32,28,22,0
52687,1689,821,868,277,250,177,78,2517,1275,1242,304,324,245,135,0
52688,134,60,74,19,13,10,7,1323,690,633,132,178,112,61,0
52689,519,259,260,86,78,59,22,601,279,322,81,65,27,12,0
52690,649,304,345,99,80,67,40,209,119,90,28,24,27,9,0
52691,624,222,402,92,81,39,15,201,104,97,36,32,24,7,0
52692,236,141,95,36,32,14,6,396,223,173,57,37,44,19,0
52693,440,267,173,52,29,42,12,1248,584,664,184,164,155,67,0
52694,1835,904,931,192,144,135,63,1755,905,850,214,196,183,79,0
52695,1498,731,767,220,175,148,68,452,252,200,55,49,61,16,0
52696,428,226,202,52,60,75,20,727,388,339,102,87,70,29,0
52697,446,195,251,56,53,31,15,154,78,76,23,21,13,5,0
52698,461,207,254,82,66,55,33,166,88,78,23,18,13,7,0
52699,227,120,107,31,28,28,13,223,113,110,31,33,22,12,0
52700,2285,1219,1066,207,180,178,106,761,351,410,117,73,103,45,0
52701,279,129,150,43,34,17,13,403,184,219,75,51,47,20,0
52702,643,284,359,129,71,84,43,403,185,218,67,62,63,19,0
52703,325,186,139,49,36,20,5,620,324,296,81,68,66,31,0
52704,502,229,273,63,66,40,31,105,51,54,13,17,12,8,0
52705,347,198,149,45,29,29,8,447,212,235,86,55,58,21,0
52706,639,368,271,72,51,38,38,354,183,171,54,43,49,8,0
52707,527,254,273,67,66,70,31,302,150,152,56,40,52,15,0
52708,109,42,67,25,13,1,1,308,146,162,42,39,24,12,0
52709,859,411,448,118,100,95,49,65,32,33,16,4,8,3,0
52710,3969,1703,2266,619,432,259,144,479,215,264,67,80,46,28,0
52711,150,60,90,27,16,6,3,335,186,149,40,28,29,13,0
52712,117,57,60,17,14,11,10,94,45,49,11,20,10,4,0
52713,335,148,187,52,26,51,12,242,124,118,39,32,28,22,0
52714,673,317,356,101,85,76,49,744,385,359,105,96,57,31,0
52715,338,173,165,31,42,22,10,104,46,58,15,17,9,5,0
52716,476,199,277,82,80,49,24,270,162,108,26,26,16,11,0
52717,330,141,189,65,29,51,19,320,168,152,38,42,24,18,0
52718,456,214,242,76,62,52,22,264,138,126,33,34,29,12,0
52719,1390,705,685,219,164,129,74,296,140,156,49,40,42,19,0
52720,517,196,321,103,98,33,12,381,196,185,55,57,43,16,0
52721,496,274,222,57,43,75,22,660,333,327,102,95,69,31,0
52722,1505,680,825,202,204,73,32,479,215,264,67,80,46,28,0
52723,161,99,62,15,22,9,7,139,68,71,14,26,14,9,0
52724,533,297,236,74,57,39,28,132,61,71,22,21,15,3,0
52725,202,103,99,28,20,12,8,935,515,420,126,107,73,32,0
52726,500,257,243,60,55,27,22,367,199,168,62,44,34,8,0
52727,162,73,89,32,19,4,4,348,212,136,53,31,25,18,0
52728,919,444,475,141,148,62,20,373,181,192,54,35,44,20,0
52729,465,305,160,40,47,34,9,164,79,85,28,28,16,7,0
52730,365,222,143,44,24,35,11,671,321,350,95,87,75,34,0
52731,207,93,114,20,33,19,10,1755,905,850,214,196,183,79,0
52732,4128,2104,2024,581,505,453,205,396,199,197,54,50,45,14,0
52733,1556,718,838,280,182,161,49,629,317,312,80,87,51,22,0
52734,270,130,140,43,24,36,10,633,311,322,94,82,45,20,0
52735,727,426,301,79,71,64,32,400,187,213,56,59,42,20,0
52736,404,197,207,60,48,47,20,374,174,200,54,52,42,21,0
52737,161,94,67,23,13,8,10,663,354,309,91,84,79,31,0
52738,371,143,228,77,48,29,26,124,69,55,14,7,9,4,0
52739,172,98,74,20,21,22,8,89,51,38,15,15,5,4,0
52740,308,163,145,38,33,30,20,289,140,149,33,42,30,15,0
52741,318,164,154,52,43,34,10,153,80,73,26,18,19,4,0
52742,393,223,170,44,36,32,14,1065,581,484,134,97,76,46,0
52743,348,198,150,57,25,37,18,172,79,93,34,27,23,10,0
52744,595,208,387,157,60,91,48,556,290,266,75,74,29,24,0
52745,122,56,66,26,13,11,5,403,221,182,62,50,42,12,0
52746,479,227,252,69,48,46,18,564,264,300,79,84,65,26,0
52747,680,308,372,82,72,71,40,309,164,145,35,47,30,11,0
52748,458,226,232,77,59,61,14,326,169,157,51,41,41,12,0
52749,162,73,89,32,19,4,4,904,436,468,143,118,108,32,0
52750,136,66,70,33,11,9,3,270,162,108,26,26,16,11,0
52751,231,105,126,56,10,24,10,158,71,87,23,21,17,12,0
52752,362,174,188,46,55,35,23,274,142,132,33,34,18,14,0
52753,2174,1057,1117,241,241,214,117,413,223,190,52,45,53,10,0
52754,800,416,384,102,105,83,22,222,127,95,23,28,22,7,0
52755,579,246,333,102,79,41,19,290,147,143,34,34,39,13,0
52756,251,131,120,49,35,25,5,701,380,321,94,84,96,34,0
52757,1124,442,682,148,189,72,43,106,41,65,36,6,11,7,0
52758,288,140,148,59,33,27,12,175,91,84,19,21,21,10,0
52759,435,187,248,62,51,51,21,405,214,191,53,42,49,20,0
52760,540,252,288,73,67,57,20,393,210,183,58,37,34,20,0
52761,2062,706,1356,414,368,158,63,145,77,68,26,7,15,8,0
52762,82,36,46,17,10,5,1,192,91,101,29,28,17,7,0
52763,2279,996,1283,375,328,158,60,335,186,149,40,28,29,13,0
52764,450,231,219,77,50,76,16,496,285,211,62,54,46,22,0
52765,524,270,254,84,72,70,23,223,113,110,31,33,22,12,0
52766,1616,735,881,285,248,153,72,54,26,28,11,4,3,3,0
52767,1531,649,882,108,122,93,72,724,353,371,94,95,71,31,0
52768,837,381,456,123,109,65,25,86,40,46,16,13,9,7,0
52769,456,214,242,76,62,52,22,220,107,113,36,35,28,9,0
52770,908,324,584,181,162,81,29,290,147,143,34,34,39,13,0
52771,55,16,39,24,2,5,2,204,96,108,31,37,20,5,0
52772,1395,595,800,223,206,113,61,584,249,335,80,96,22,13,0
52773,879,457,422,93,98,143,32,866,397,469,117,153,95,48,0
52774,2109,999,1110,332,294,187,89,251,143,108,47,25,29,11,0
52775,580,240,340,108,81,59,22,621,310,311,100,106,77,27,0
52776,302,160,142,35,35,37,10,415,189,226,68,54,50,21,0
52777,562,214,348,120,86,69,42,427,251,176,51,39,25,22,0
52778,398,186,212,76,70,18,13,741,383,358,92,63,79,36,0
52779,684,353,331,95,98,77,38,561,279,282,85,81,88,24,0
52780,338,172,166,59,30,39,18,172,79,93,34,27,23,10,0
52781,338,164,174,45,32,37,13,381,187,194,37,49,36,17,0
52782,650,330,320,97,77,65,28,424,179,245,65,67,29,11,0
52783,365,148,217,86,37,51,28,673,313,360,102,101,46,17,0
52784,753,395,358,93,72,71,16,627,323,304,81,90,53,27,0
52785,300,136,164,45,35,45,14,935,515,420,126,107,73,32,0
52786,2696,1169,1527,432,347,193,146,127,66,61,13,14,19,8,0
52787,226,120,106,68,8,2,1,192,91,101,29,28,17,7,0
52788,180,92,88,29,20,26,8,873,411,462,132,107,84,40,0
52789,365,210,155,46,30,24,12,452,254,198,72,57,38,18,0
52790,258,144,114,33,22,19,9,2547,1280,1267,331,335,293,118,0
52791,475,235,240,77,58,43,22,319,185,134,42,31,22,13,0
52792,550,304,246,60,64,77,16,689,343,346,105,102,81,35,0
52793,264,122,142,46,24,35,10,134,55,79,22,24,16,6,0
52794,260,136,124,24,41,19,4,335,186,149,40,28,29,13,0
52795,331,165,166,52,34,48,22,289,140,149,33,42,30,15,0
52796,1360,644,716,213,194,136,62,188,93,95,33,18,16,10,0
52797,380,148,232,81,69,24,8,134,72,62,14,28,8,4,0
52798,1689,821,868,277,250,177,78,387,193,194,60,53,57,15,0
52799,407,207,200,53,36,38,8,158,71,87,23,21,17,12,0
52800,397,180,217,61,59,39,13,212,127,85,28,21,26,6,0
52801,625,283,342,93,89,67,25,751,394,357,107,96,73,35,0
52802,664,269,395,117,107,36,15,866,397,469,117,153,95,48,0
52803,1235,584,651,140,226,82,52,396,223,173,57,37,44,19,0
52804,411,211,200,61,46,35,18,583,280,303,95,66,76,25,0
52805,328,195,133,36,23,35,9,139,68,71,14,26,14,9,0
52806,304,149,155,46,32,39,14,163,79,84,22,24,13,5,0
52807,207,89,118,56,8,4,3,89,42,47,16,12,15,6,0
52808,131,69,62,29,9,9,1,234,129,105,31,22,19,17,0
52809,983,449,534,95,77,55,36,501,240,261,80,62,49,42,0
52810,977,462,515,185,119,76,12,953,489,464,126,104,111,44,0
52811,420,248,172,64,30,43,17,541,279,262,79,82,31,32,0
52812,404,197,207,60,48,47,20,662,312,350,103,104,59,20,0
52813,224,101,123,45,32,21,3,1047,562,485,141,127,114,41,0
52814,1711,865,846,204,176,105,60,218,118,100,33,30,25,11,0
52815,626,300,326,91,82,68,26,222,125,97,34,27,27,7,0
52816,1709,650,1059,338,286,185,46,222,125,97,34,27,27,7,0
52817,526,268,258,54,37,55,12,323,168,155,51,41,38,12,0
52818,517,196,321,103,98,33,12,557,281,276,80,59,43,21,0
52819,202,103,99,28,20,12,8,166,90,76,27,18,21,5,0
52820,520,240,280,87,63,67,16,373,213,160,44,33,26,17,0
52821,184,93,91,26,25,14,11,545,269,276,80,76,27,32,0
52822,258,126,132,38,22,29,8,129,60,69,21,15,8,5,0
52823,516,224,292,79,29,45,33,124,69,55,14,7,9,4,0
52824,619,289,330,67,77,36,19,385,212,173,57,40,39,21,0
52825,410,208,202,59,58,43,26,2346,1231,1115,316,292,266,105,0
52826,314,158,156,39,28,30,17,348,212,136,53,31,25,18,0
52827,325,186,139,49,36,20,5,344,190,154,34,31,36,10,0
52828,282,96,186,80,21,28,7,222,127,95,23,28,22,7,0
52829,933,456,477,123,108,83,29,399,190,209,61,41,39,18,0
52830,338,173,165,31,42,22,10,630,321,309,86,90,57,26,0
52831,346,208,138,46,39,51,18,270,162,108,26,26,16,11,0
52832,193,90,103,44,9,19,13,367,199,168,62,44,34,8,0
52833,557,250,307,70,47,51,22,701,380,321,94,84,96,34,0
52834,808,366,442,130,133,66,31,519,287,232,68,58,45,21,0
52835,772,383,389,105,76,82,33,244,143,101,31,29,26,8,0
52836,2663,1073,1590,548,499,192,64,72,34,38,8,2,3,12,0
52837,508,267,241,43,35,25,17,386,181,205,55,51,57,31,0
52838,361,171,190,44,40,18,13,65,32,33,16,4,8,3,0
52839,412,203,209,65,47,37,18,1208,565,643,182,162,120,57,0
52840,446,265,181,51,35,27,17,307,132,175,48,53,26,10,0
52841,739,323,416,127,89,76,33,385,212,173,57,40,39,21,0
52842,708,344,364,106,98,66,33,370,190,180,60,52,37,13,0
52843,273,126,147,54,49,25,18,360,185,175,51,43,36,16,0
52844,401,204,197,49,33,29,17,611,314,297,79,75,78,22,0
52845,517,196,321,103,98,33,12,385,212,173,57,40,39,21,0
52846,798,364,434,133,88,74,35,445,192,253,86,58,53,18,0
52847,297,182,115,41,22,23,8,86,40,46,16,13,9,7,0
52848,738,358,380,106,99,62,25,839,446,393,103,94,76,27,0
52849,1030,438,592,184,104,108,30,399,190,209,61,41,39,18,0
52850,2799,1324,1475,369,371,215,124,465,252,213,73,58,60,18,0
52851,426,196,230,76,65,54,20,972,471,501,152,138,112,40,0
52852,852,472,380,99,79,70,27,222,125,97,34,27,27,7,0
52853,169,64,105,23,37,11,3,261,127,134,36,27,36,4,0
52854,3230,1724,1506,361,358,157,75,385,188,197,57,42,36,16,0
52855,476,276,200,57,34,43,16,846,425,421,125,97,98,38,0
52856,426,213,213,60,56,46,24,200,89,111,26,25,17,7,0
52857,411,202,209,60,67,57,24,862,409,453,149,125,86,29,0
52858,447,225,222,76,35,75,21,127,58,69,18,17,10,5,0
52859,328,156,172,44,37,44,15,1700,731,969,198,233,110,87,0
52860,1200,602,598,145,116,110,50,605,283,322,94,72,64,39,0
52861,530,259,271,83,50,54,41,137,72,65,27,13,15,8,0
52862,215,117,98,28,19,15,8,430,212,218,88,43,40,20,0
52863,341,183,158,36,34,36,15,374,202,172,50,39,31,24,0
52864,51,10,41,25,0,5,8,583,321,262,73,67,45,25,0
52865,399,220,179,48,37,68,18,362,156,206,74,42,36,22,0
52866,1030,438,592,184,104,108,30,485,244,241,80,55,59,20,0
52867,837,381,456,123,109,65,25,415,226,189,51,40,40,29,0
52868,217,98,119,38,35,18,9,96,45,51,13,12,6,4,0
52869,553,276,277,88,61,45,27,332,180,152,46,36,28,14,0
52870,1189,653,536,152,118,109,56,621,273,348,104,102,48,19,0
52871,109,50,59,12,12,9,3,96,46,50,16,12,7,5,0
52872,1217,647,570,142,160,129,45,277,163,114,33,24,21,16,0
52873,517,196,321,103,98,33,12,693,360,333,100,88,62,26,0
52874,181,75,106,35,26,11,9,585,277,308,92,73,61,32,0
52875,915,336,579,185,199,56,29,192,110,82,33,21,10,3,0
52876,415,217,198,50,31,42,17,605,283,322,94,72,64,39,0
52877,553,276,277,88,61,45,27,127,54,73,11,33,15,6,0
52878,520,261,259,74,52,49,22,465,252,213,73,58,60,18,0
52879,235,100,135,36,25,30,8,212,127,85,28,21,26,6,0
52880,755,271,484,113,226,61,20,481,223,258,71,70,49,26,0
52881,178,87,91,20,32,13,10,724,353,371,94,95,71,31,0
52882,126,57,69,31,10,10,3,87,51,35,15,9,9,4,0
52883,453,240,213,53,33,44,16,105,51,54,13,17,12,8,0
52884,700,305,395,111,99,54,18,207,86,121,34,39,11,13,0
52885,550,304,246,60,64,77,16,381,186,195,69,55,46,15,0
52886,332,173,159,48,42,42,9,766,386,380,101,81,78,31,0
52887,794,322,472,122,108,79,34,392,214,178,48,40,53,22,0
52888,441,216,225,57,66,57,19,821,394,427,122,117,109,38,0
52889,2063,1024,1039,175,117,80,97,478,254,224,67,74,56,28,0
52890,480,232,248,73,40,44,30,1265,689,576,169,177,128,60,0
52891,329,171,158,49,41,31,10,866,397,469,117,153,95,48,0
52892,739,389,350,129,61,69,25,336,200,136,34,29,25,24,0
52893,622,354,268,89,60,64,18,387,193,194,60,53,57,15,0
52894,1390,705,685,219,164,129,74,467,240,227,65,65,51,23,0
52895,508,136,372,157,91,22,9,278,154,124,42,32,38,7,0
52896,458,210,248,39,38,25,16,296,151,145,45,42,32,11,0
52897,577,342,235,63,57,23,37,963,455,508,127,130,115,48,0
52898,1544,738,806,239,217,145,91,108,59,49,17,13,12,5,0
52899,1390,705,685,219,164,129,74,308,146,162,42,39,24,12,0
52900,82,36,46,17,10,5,1,390,223,167,58,36,45,18,0
52901,399,196,203,62,45,38,19,160,60,100,23,40,19,11,0
52902,520,261,259,74,52,49,22,188,101,87,20,18,20,14,0
52903,317,140,177,43,26,31,16,514,248,266,86,82,52,22,0
52904,557,211,346,129,125,48,19,296,140,156,49,40,42,19,0
52905,407,230,177,44,39,34,19,322,180,142,45,38,28,7,0
52906,290,156,134,44,29,39,9,72,32,40,8,2,2,13,0
52907,496,274,222,57,43,75,22,234,129,105,31,22,19,17,0
52908,786,378,408,106,98,77,39,227,130,97,32,25,22,12,0
52909,407,207,200,53,36,38,8,286,160,126,37,27,23,10,0
52910,743,377,366,87,74,68,30,452,254,198,72,57,38,18,0
52911,584,297,287,89,80,65,17,693,360,333,100,88,62,26,0
52912,385,179,206,58,56,38,19,218,117,101,35,32,34,12,0
52913,1872,837,1035,280,338,169,80,619,305,314,85,93,71,29,0
52914,165,66,99,28,32,16,3,153,80,73,26,18,19,4,0
52915,119,59,60,29,10,6,4,2346,1231,1115,316,292,266,105,0
52916,425,198,227,57,69,59,13,160,76,84,19,24,8,5,0
52917,330,151,179,68,36,56,9,276,149,127,34,31,32,10,0
52918,464,237,227,64,66,33,12,497,227,270,70,63,66,30,0
52919,251,139,112,41,18,27,11,317,161,156,40,49,41,11,0
52920,121,69,52,15,18,14,8,514,262,252,78,58,54,26,0
52921,107,36,71,27,15,0,1,778,391,387,94,77,41,33,0
52922,126,57,69,31,10,10,3,792,398,394,109,96,90,39,0
52923,215,104,111,61,7,2,1,810,310,500,164,162,42,26,0
52924,520,261,259,74,52,49,22,312,165,147,41,39,29,16,0
52925,463,225,238,76,36,59,26,283,160,123,25,20,37,9,0
52926,2285,1219,1066,207,180,178,106,710,375,335,95,94,110,28,0
52927,619,289,330,67,77,36,19,418,246,172,52,39,57,10,0
52928,222,110,112,43,30,14,6,277,124,153,44,40,35,18,0
52929,179,78,101,29,22,10,8,501,274,227,63,58,53,20,0
52930,563,255,308,91,111,42,30,207,86,121,34,39,11,13,0
52931,640,279,361,102,83,69,21,360,180,180,57,48,39,12,0
52932,510,269,241,66,67,71,26,561,279,282,85,81,88,24,0
52933,395,195,200,41,55,23,10,134,72,62,14,28,8,4,0
52934,886,440,446,116,140,95,45,229,120,109,31,30,22,9,0
52935,126,58,68,31,10,10,3,406,223,183,61,53,46,17,0
52936,793,355,438,134,117,77,43,929,459,470,140,120,94,45,0
52937,837,381,456,123,109,65,25,225,129,96,32,33,20,8,0
52938,102,22,80,48,8,18,6,111,60,51,17,23,10,7,0
52939,138,35,103,38,2,15,9,415,226,189,51,40,40,29,0
52940,479,227,252,69,48,46,18,334,182,152,45,41,27,13,0
52941,452,202,250,83,60,56,19,339,180,159,36,29,16,16,0
52942,377,171,206,46,59,22,6,373,183,190,49,37,33,18,0
52943,356,199,157,36,43,28,12,149,77,72,37,10,20,5,0
52944,358,212,146,51,36,33,9,160,76,84,19,24,8,5,0
52945,257,132,125,39,27,26,10,247,128,119,34,14,16,14,0
52946,476,276,200,57,34,43,16,91,44,47,9,12,4,7,0
52947,341,195,146,42,21,36,9,225,129,96,32,33,20,8,0
52948,588,300,288,100,57,65,27,710,375,335,95,94,110,28,0
52949,983,449,534,95,77,55,36,373,189,184,54,46,50,23,0
52950,587,318,269,76,50,38,21,963,455,508,127,130,115,48,0
52951,908,324,584,181,162,81,29,98,49,49,14,15,9,2,0
52952,422,196,226,52,35,33,20,602,310,292,87,66,70,36,0
52953,222,108,114,37,20,25,12,256,141,115,32,22,32,8,0
52954,420,189,231,79,67,33,17,423,234,189,66,44,57,12,0
52955,824,391,433,106,90,88,32,89,51,38,15,15,5,4,0
52956,222,108,114,37,20,25,12,843,391,452,139,104,91,35,0
52957,388,209,179,46,24,31,28,292,143,149,38,42,36,16,0
52958,1186,495,691,182,208,88,32,504,272,232,75,57,53,19,0
52959,130,71,59,30,9,8,1,1241,619,622,183,169,155,59,0
52960,640,308,332,91,102,49,21,963,525,438,119,102,102,34,0
52961,261,130,131,27,41,19,16,68,23,45,12,9,3,9,0
52962,251,139,112,41,18,27,11,142,65,77,30,17,22,9,0
52963,485,246,239,74,48,47,22,584,249,335,80,96,22,13,0
52964,303,161,142,38,31,42,17,329,196,133,41,36,31,15,0
52965,347,181,166,27,20,12,12,1166,514,652,150,159,107,70,0
52966,282,135,147,27,37,30,19,483,258,225,70,53,54,20,0
52967,217,98,119,38,35,18,9,89,38,51,14,6,3,9,0
52968,574,269,305,91,63,54,27,287,151,136,51,42,36,7,0
52969,595,208,387,157,60,91,48,108,59,49,17,13,12,5,0
52970,322,164,158,46,44,29,7,392,186,206,62,56,29,15,0
52971,338,139,199,54,54,18,11,378,154,224,74,84,35,22,0
52972,1709,650,1059,338,286,185,46,404,190,214,55,55,35,27,0
52973,124,58,66,20,28,11,7,160,76,84,19,24,8,5,0
52974,1759,838,921,269,212,191,92,149,52,97,36,36,7,4,0
52975,206,96,110,33,25,8,6,163,79,84,22,24,13,5,0
52976,500,297,203,66,33,53,15,312,165,147,41,39,29,16,0
52977,398,186,212,76,70,18,13,323,171,152,48,41,40,16,0
52978,57,24,33,11,3,5,3,145,77,68,26,7,15,8,0
52979,139,81,58,17,14,24,9,153,80,73,26,18,19,4,0
52980,126,66,60,24,10,7,9,536,222,314,101,100,34,22,0
52981,1464,693,771,153,136,91,86,72,33,39,8,2,3,12,0
52982,317,153,164,34,52,30,14,447,232,215,55,65,50,25,0
52983,2279,996,1283,375,328,158,60,130,67,63,24,10,12,4,0
52984,435,187,248,62,51,51,21,689,343,346,105,102,81,35,0
52985,786,378,408,106,98,77,39,198,110,88,27,27,24,4,0
52986,588,300,288,100,57,65,27,326,149,177,51,51,28,10,0
52987,485,237,248,83,35,52,24,303,137,166,54,54,31,15,0
52988,126,57,69,31,10,10,3,562,273,289,76,92,45,24,0
52989,1464,693,771,153,136,91,86,536,251,285,75,79,60,23,0
52990,4640,2231,2409,660,549,437,245,2225,1244,981,271,243,217,93,0
52991,346,208,138,46,39,51,18,375,176,199,48,61,40,12,0
52992,1054,453,601,183,183,107,35,564,264,300,79,84,65,26,0
52993,654,344,310,80,69,57,15,611,314,297,79,75,78,22,0
52994,317,153,164,34,52,30,14,528,188,340,130,58,77,41,0
52995,412,146,266,106,38,67,35,710,375,335,95,94,110,28,0
52996,898,397,501,102,98,54,37,892,475,417,130,108,68,38,0
52997,126,57,69,31,10,10,3,297,175,122,46,30,31,6,0
52998,2488,1085,1403,346,253,162,76,557,281,276,80,59,43,21,0
52999,577,251,326,92,84,60,11,334,181,153,41,40,25,15,0
53000,424,170,254,69,56,47,28,260,133,127,43,32,39,3,0
53001,2000,965,1035,357,313,198,75,149,52,97,36,36,7,4,0
53002,178,89,89,40,12,18,7,354,188,166,46,40,34,10,0
53003,161,94,67,23,13,8,10,509,267,242,79,81,38,20,0
53004,1835,904,931,192,144,135,63,405,214,191,53,42,49,20,0
53005,204,103,101,16,32,22,8,498,244,254,81,67,58,19,0
53006,349,131,218,66,76,22,9,180,115,65,17,12,9,9,0
53007,206,100,106,34,26,11,7,601,278,323,124,87,65,21,0
53008,128,67,61,29,9,9,1,180,89,91,28,27,18,7,0
53009,461,257,204,63,49,50,29,223,113,110,31,33,22,12,0
53010,514,226,288,71,66,63,32,1507,737,770,188,228,147,71,0
53011,255,110,145,34,32,23,17,89,42,47,16,12,15,6,0
53012,422,196,226,52,35,33,20,329,194,135,45,32,33,9,0
53013,170,82,88,32,23,22,8,213,129,84,32,14,21,15,0
53014,949,467,482,126,127,102,51,925,439,486,141,134,105,46,0
53015,372,171,201,47,53,39,18,904,436,468,143,118,108,32,0
53016,330,182,148,47,27,40,11,376,183,193,50,50,43,21,0
53017,824,391,433,106,90,88,32,775,407,368,122,100,97,32,0
53018,1214,498,716,197,180,121,65,947,482,465,143,107,89,37,0
53019,527,276,251,64,60,70,20,1020,538,482,145,115,111,58,0
53020,527,254,273,67,66,70,31,296,151,145,45,42,32,11,0
53021,242,111,131,35,35,17,13,404,190,214,55,55,35,27,0
53022,3969,1703,2266,619,432,259,144,660,332,328,84,73,47,19,0
53023,479,228,251,71,57,60,14,215,115,100,27,19,16,7,0
53024,412,208,204,54,47,42,17,201,93,108,34,39,21,6,0
53025,447,225,222,76,35,75,21,175,91,84,19,21,21,10,0
53026,126,58,68,31,10,10,3,501,274,227,63,58,53,20,0
53027,736,353,383,117,83,71,18,565,237,328,75,88,32,11,0
53028,306,172,134,35,31,37,18,376,189,187,47,53,44,26,0
53029,102,22,80,48,8,18,6,2724,1157,1567,269,518,239,77,0
53030,443,250,193,52,23,49,13,199,92,107,34,30,18,9,0
53031,426,196,230,76,65,54,20,975,400,575,160,162,62,31,0
53032,584,297,287,89,80,65,17,593,289,304,85,69,48,19,0
53033,508,267,241,43,35,25,17,132,67,65,24,21,8,10,0
53034,253,133,120,44,31,22,8,397,234,163,44,38,23,21,0
53035,520,231,289,89,59,58,26,780,337,443,112,116,77,28,0
53036,1112,457,655,180,164,99,39,470,205,265,71,80,33,11,0
53037,340,145,195,46,38,26,23,89,37,52,13,6,2,9,0
53038,820,333,487,202,152,59,23,1020,538,482,145,115,111,58,0
53039,431,199,232,59,54,40,17,594,312,282,72,67,73,31,0
53040,249,104,145,47,41,24,17,218,118,100,33,30,25,11,0
53041,1105,544,561,165,167,99,40,325,159,166,59,46,30,12,0
53042,333,171,162,41,44,48,23,260,131,129,42,31,40,9,0
53043,560,279,281,113,64,58,15,258,129,129,45,24,31,10,0
53044,391,203,188,49,34,36,9,744,385,359,105,96,57,31,0
53045,128,67,61,29,9,9,1,415,203,212,77,44,49,18,0
53046,554,217,337,112,72,90,38,1062,522,540,151,147,105,66,0
53047,802,430,372,65,102,87,23,1873,935,938,233,225,203,79,0
53048,341,154,187,34,36,11,11,406,202,204,54,51,63,21,0
53049,895,388,507,130,84,90,31,326,169,157,51,41,41,12,0
53050,588,300,288,100,57,65,27,649,307,342,71,134,45,17,0
53051,529,290,239,54,63,85,15,418,223,195,53,43,49,15,0
53052,339,170,169,32,17,24,13,373,181,192,54,35,44,20,0
53053,911,489,422,121,98,97,36,425,177,248,60,62,33,16,0
53054,211,92,119,33,44,11,7,478,254,224,67,74,56,28,0
53055,312,173,139,43,47,28,6,699,334,365,108,80,70,20,0
53056,1447,698,749,214,180,116,46,1338,720,618,179,145,141,85,0
53057,420,202,218,67,43,51,15,1500,804,696,190,172,144,60,0
53058,533,297,236,74,57,39,28,250,119,131,58,26,29,7,0
53059,911,445,466,154,121,108,48,1352,602,750,166,185,81,70,0
53060,419,210,209,54,44,31,23,858,398,460,126,138,75,39,0
53061,1099,491,608,163,141,107,62,200,99,101,31,24,26,6,0
53062,207,128,79,26,17,19,9,846,425,421,125,97,98,38,0
53063,2109,999,1110,332,294,187,89,479,215,264,67,80,46,28,0
53064,2063,1024,1039,175,117,80,97,380,211,169,47,37,33,21,0
53065,580,281,299,95,60,74,29,579,285,294,78,72,64,32,0
53066,852,461,391,109,102,72,24,480,255,225,67,64,50,22,0
53067,626,300,326,91,82,68,26,295,160,135,42,37,46,16,0
53068,837,443,394,129,89,87,38,966,478,488,108,144,74,43,0
53069,1214,498,716,197,180,121,65,843,391,452,139,104,91,35,0
53070,474,250,224,58,47,37,12,1873,935,938,233,225,203,79,0
53071,458,210,248,39,38,25,16,1214,475,739,177,250,89,49,0
53072,310,141,169,36,38,20,8,380,211,169,47,37,33,21,0
53073,452,202,250,83,60,56,19,106,41,65,36,6,11,7,0
53074,1099,491,608,163,141,107,62,138,69,69,28,7,10,10,0
53075,127,48,79,27,20,6,5,2542,1245,1297,285,287,170,84,0
53076,282,135,147,27,37,30,19,103,44,59,16,17,9,5,0
53077,1161,514,647,159,138,122,37,307,132,175,48,53,26,10,0
53078,331,165,166,52,34,48,22,1537,701,836,209,187,129,58,0
53079,977,462,515,185,119,76,12,406,223,183,61,53,46,17,0
53080,426,231,195,51,52,45,24,207,114,93,33,20,31,13,0
53081,257,122,135,44,19,21,16,508,261,247,65,53,58,23,0
53082,743,366,377,41,37,26,14,732,402,330,81,86,87,33,0
53083,301,119,182,53,47,14,20,277,152,125,31,35,22,19,0
53084,860,349,511,166,166,58,19,172,88,84,24,31,20,12,0
53085,546,285,261,71,49,47,24,276,149,127,34,31,32,10,0
53086,222,110,112,43,30,14,6,312,165,147,41,39,29,16,0
53087,282,160,122,36,28,27,7,1265,689,576,169,177,128,60,0
53088,402,169,233,70,36,34,18,478,254,224,67,74,56,28,0
53089,272,94,178,76,33,19,4,227,130,97,32,25,22,12,0
53090,447,236,211,56,52,49,14,947,482,465,143,107,89,37,0
53091,482,231,251,76,81,64,26,424,179,245,65,67,29,11,0
53092,434,216,218,72,58,40,20,205,94,111,48,31,15,6,0
53093,442,254,188,46,22,40,19,373,181,192,54,35,44,20,0
53094,366,190,176,39,62,55,14,1378,692,686,194,174,105,56,0
53095,204,103,101,16,32,22,8,173,86,87,30,22,19,12,0
53096,362,174,188,46,55,35,23,222,124,98,37,29,22,9,0
53097,135,64,71,31,11,8,4,630,321,309,86,90,57,26,0
53098,1912,880,1032,331,334,180,84,811,361,450,124,107,80,31,0
53099,833,295,538,146,139,65,34,370,173,197,65,57,42,10,0
53100,1616,735,881,285,248,153,72,94,45,49,11,20,10,4,0
53101,919,493,426,100,92,88,49,601,279,322,81,65,27,12,0
53102,338,208,130,39,30,35,12,373,213,160,44,33,26,17,0
53103,956,450,506,122,117,82,36,593,289,304,85,69,48,19,0
53104,474,243,231,66,54,41,29,173,94,79,18,24,12,7,0
53105,502,250,252,70,47,57,15,201,117,83,22,21,19,9,0
53106,358,212,146,51,36,33,9,953,489,464,126,104,111,44,0
53107,828,355,473,126,134,77,37,723,353,370,120,109,96,33,0
53108,770,394,376,90,96,78,34,738,358,380,106,99,62,25,0
53109,346,208,138,46,39,51,18,201,93,108,34,39,21,6,0
53110,1365,590,775,257,168,136,93,230,113,117,31,40,28,10,0
53111,346,205,141,47,34,30,7,457,242,215,39,46,53,10,0
53112,439,205,234,64,88,41,21,220,107,113,36,35,28,9,0
53113,255,110,145,34,32,23,17,218,115,103,32,32,34,11,0
53114,507,314,193,49,45,59,25,417,232,185,58,50,29,21,0
53115,658,349,309,77,70,73,35,2517,1275,1242,304,324,245,135,0
53116,178,89,89,40,12,18,7,551,226,325,96,103,43,11,0
53117,521,289,232,71,58,49,16,720,361,359,98,98,70,37,0
53118,283,112,171,48,39,34,15,222,122,100,39,32,24,9,0
53119,103,56,47,27,7,8,2,741,383,358,92,63,79,36,0
53120,1590,726,864,270,237,126,59,274,157,117,40,29,40,8,0
53121,730,298,432,128,69,86,26,403,192,211,102,39,49,15,0
53122,681,367,314,83,74,78,31,166,88,78,23,18,13,7,0
53123,484,264,220,59,62,68,15,376,189,187,47,53,44,26,0
53124,170,82,88,32,23,22,8,153,65,88,28,21,20,8,0
53125,180,57,123,39,22,10,8,662,312,350,103,104,59,20,0
53126,160,53,107,31,29,13,3,397,223,174,50,39,29,17,0
53127,492,253,239,73,67,77,29,175,91,84,19,21,21,10,0
53128,836,370,466,126,96,72,30,452,254,198,72,57,38,18,0
53129,367,167,200,63,42,60,17,555,282,273,82,69,65,21,0
53130,496,272,224,70,58,42,18,783,406,377,102,91,57,29,0
53131,406,207,199,56,46,68,19,283,142,141,41,33,26,18,0
53132,626,308,318,105,89,77,25,536,267,269,60,70,41,22,0
53133,130,72,58,28,9,7,1,245,121,124,37,35,36,12,0
53134,502,229,273,63,66,40,31,403,221,182,62,50,42,12,0
53135,76,30,46,7,15,1,5,334,181,153,41,40,25,15,0
53136,472,222,250,46,61,33,23,649,307,342,71,134,45,17,0
53137,820,333,487,202,152,59,23,441,189,252,73,50,47,23,0
53138,362,174,188,46,55,35,23,303,138,165,47,46,35,18,0
53139,126,58,68,31,10,10,3,663,360,303,87,82,80,35,0
53140,526,228,298,69,64,32,30,72,32,40,8,2,1,14,0
53141,458,210,248,39,38,25,16,89,38,51,14,6,3,9,0
53142,772,383,389,105,76,82,33,663,354,309,91,84,79,31,0
53143,1542,682,860,290,158,120,47,1214,475,739,177,250,89,49,0
53144,734,339,395,135,89,78,36,266,146,120,41,28,31,7,0
53145,594,279,315,93,68,68,26,260,133,127,43,32,39,3,0
53146,629,338,291,92,57,64,22,470,205,265,71,80,33,11,0
53147,525,302,223,56,48,67,19,376,183,193,50,50,43,21,0
53148,667,366,301,96,55,84,25,453,255,198,62,49,29,19,0
53149,158,85,73,24,18,18,8,363,180,183,60,34,10,6,0
53150,364,172,192,55,57,32,15,541,279,262,79,82,31,32,0
53151,1647,794,853,279,235,128,65,194,109,85,23,24,21,9,0
53152,439,205,234,64,88,41,21,555,292,263,75,63,67,27,0
53153,126,56,70,31,10,10,3,156,90,66,17,22,11,10,0
53154,532,254,278,91,48,23,17,904,436,468,143,118,108,32,0
53155,102,22,80,48,8,18,6,1239,659,580,169,148,131,54,0
53156,125,53,72,18,21,18,12,972,471,501,152,138,112,40,0
53157,959,496,463,144,132,75,35,180,115,65,17,12,9,9,0
53158,684,353,331,95,98,77,38,654,295,359,99,88,71,25,0
53159,482,245,237,69,64,66,24,751,394,357,107,96,73,35,0
53160,1041,497,544,180,167,98,34,673,313,360,102,101,46,17,0
53161,210,84,126,44,43,9,4,953,489,464,126,104,111,44,0
53162,231,105,126,56,10,24,10,344,190,154,34,31,36,10,0
53163,103,56,47,27,7,8,2,501,249,252,77,70,55,22,0
53164,404,197,207,60,48,47,20,1239,659,580,169,148,131,54,0
53165,401,236,165,53,38,34,9,96,46,50,16,12,7,5,0
53166,134,60,74,19,13,10,7,262,129,133,40,41,31,10,0
53167,270,166,104,30,26,28,14,127,58,69,18,17,10,5,0
53168,484,192,292,118,68,83,22,234,129,105,31,22,19,17,0
53169,852,472,380,99,79,70,27,246,107,139,55,33,27,11,0
53170,2525,1232,1293,398,317,186,61,125,66,59,24,16,11,5,0
53171,249,114,135,47,33,25,4,73,35,38,14,10,9,4,0
53172,439,205,234,64,88,41,21,303,138,165,47,46,35,18,0
53173,117,57,60,17,14,11,10,474,268,206,66,42,45,24,0
53174,413,206,207,38,55,19,10,98,49,49,14,15,9,2,0
53175,130,71,59,30,9,8,1,417,232,185,58,50,29,21,0
53176,869,489,380,110,77,79,29,1065,581,484,134,97,76,46,0
53177,161,99,62,15,22,9,7,375,176,199,48,61,40,12,0
53178,1235,584,651,140,226,82,52,360,180,180,57,48,39,12,0
53179,469,253,216,49,51,48,18,392,155,237,68,61,34,16,0
53180,486,243,243,65,48,63,22,276,149,127,34,31,32,10,0
53181,532,254,278,91,48,23,17,135,65,70,21,25,15,9,0
53182,1121,458,663,158,210,76,47,147,74,73,28,20,24,4,0
53183,496,209,287,112,55,71,14,1248,584,664,184,164,155,67,0
53184,879,457,422,93,98,143,32,164,79,85,28,28,16,7,0
53185,629,338,291,92,57,64,22,218,115,103,37,33,33,9,0
53186,71,28,43,15,9,5,2,593,289,304,85,69,48,19,0
53187,682,260,422,153,78,109,46,179,101,78,25,15,13,13,0
53188,126,57,69,31,10,10,3,325,172,153,44,34,27,14,0
53189,502,274,228,64,49,75,17,403,221,182,62,50,42,12,0
53190,911,445,466,154,121,108,48,398,200,198,68,43,51,14,0
53191,616,304,312,75,71,55,25,514,262,252,78,58,54,26,0
53192,188,84,104,35,36,18,9,72,32,40,8,2,2,13,0
53193,395,195,200,41,55,23,10,316,159,157,38,48,30,11,0
53194,385,179,206,58,56,38,19,54,26,28,11,4,3,3,0
53195,574,269,305,91,63,54,27,974,457,517,133,117,69,26,0
53196,119,59,60,29,10,6,4,602,310,292,87,66,70,36,0
53197,911,489,422,121,98,97,36,303,138,165,47,46,35,18,0
53198,543,265,278,52,37,54,19,370,173,197,65,57,42,10,0
53199,346,209,137,46,37,44,10,346,196,150,43,26,27,14,0
53200,1058,497,561,194,142,87,63,943,463,480,91,144,70,30,0
53201,303,161,142,38,31,42,17,134,55,79,22,24,16,6,0
53202,206,96,110,33,25,8,6,504,272,232,75,57,53,19,0
53203,227,120,107,31,28,28,13,492,278,214,65,58,32,11,0
53204,2488,1085,1403,346,253,162,76,125,66,59,24,16,11,5,0
53205,772,332,440,136,104,72,28,478,254,224,67,74,56,28,0
53206,577,342,235,63,57,23,37,1004,457,547,150,150,74,52,0
53207,242,111,131,35,35,17,13,283,160,123,25,20,37,9,0
53208,317,167,150,45,21,30,26,200,99,101,31,24,26,6,0
53209,238,91,147,68,19,22,7,467,240,227,65,65,51,23,0
53210,411,171,240,61,81,30,15,975,400,575,160,162,62,31,0
53211,739,389,350,129,61,69,25,1248,584,664,184,164,155,67,0
53212,341,154,187,34,36,11,11,516,245,271,82,84,70,26,0
53213,500,257,243,60,55,27,22,205,94,111,48,31,15,6,0
53214,126,56,70,31,10,10,3,464,236,228,64,56,53,28,0
53215,238,91,147,68,19,22,7,198,115,83,30,22,8,8,0
53216,484,194,290,70,93,47,16,267,141,126,53,27,23,7,0
53217,1647,794,853,279,235,128,65,160,60,100,23,40,19,11,0
53218,562,214,348,120,86,69,42,188,105,83,25,17,24,7,0
53219,288,104,184,80,30,39,6,227,130,97,32,25,22,12,0
53220,1555,702,853,250,199,139,31,190,93,97,35,27,23,2,0
53221,760,322,438,81,130,57,19,98,49,49,14,15,9,2,0
53222,134,60,74,19,13,10,7,91,44,47,9,12,4,7,0
53223,439,241,198,67,40,40,13,507,270,237,89,59,57,22,0
53224,766,336,430,133,97,79,21,898,469,429,125,125,134,35,0
53225,720,357,363,113,85,62,39,559,317,242,58,65,37,23,0
53226,126,56,70,31,10,10,3,621,310,311,100,106,77,27,0
53227,222,110,112,43,30,14,6,292,143,149,38,42,36,16,0
53228,442,254,188,46,22,40,19,295,160,135,44,36,46,16,0
53229,238,91,147,68,19,22,7,396,213,183,68,44,47,18,0
53230,325,152,173,43,47,28,17,296,159,137,49,28,38,13,0
53231,556,306,250,69,60,80,18,137,72,65,27,13,15,8,0
53232,1124,442,682,148,189,72,43,640,364,276,84,68,69,33,0
53233,431,245,186,50,23,46,17,296,151,145,45,42,32,11,0
53234,682,260,422,98,83,42,31,640,364,276,84,68,69,33,0
53235,605,277,328,99,54,63,43,98,49,49,14,15,9,2,0
53236,368,154,214,80,52,41,16,72,32,40,8,2,2,13,0
53237,139,81,58,17,14,24,9,234,116,118,34,35,23,9,0
53238,243,100,143,58,50,24,5,334,181,153,41,40,25,15,0
53239,347,198,149,45,29,29,8,557,281,276,80,59,43,21,0
53240,224,108,116,33,26,32,10,201,99,102,34,26,23,6,0
53241,516,224,292,79,29,45,33,260,131,129,42,31,40,9,0
53242,454,230,224,63,56,38,33,338,169,169,53,44,39,21,0
53243,531,260,271,97,68,47,11,508,262,246,66,67,51,20,0
53244,412,146,266,106,38,67,35,1323,690,633,132,178,112,61,0
53245,344,168,176,50,39,30,20,277,163,114,33,24,21,16,0
53246,507,242,265,53,44,31,22,374,174,200,54,52,42,21,0
53247,1835,904,931,192,144,135,63,330,166,164,55,51,36,16,0
53248,385,203,182,47,43,51,21,111,60,51,17,23,10,7,0
53249,180,92,88,29,20,26,8,134,72,62,14,28,8,4,0
53250,389,176,213,81,59,24,7,439,227,212,60,55,58,8,0
53251,495,217,278,79,64,44,22,298,129,169,51,40,29,8,0
53252,235,100,135,36,25,30,8,373,189,184,54,46,50,23,0
53253,1098,519,579,182,159,79,42,133,61,72,21,19,13,4,0
53254,123,58,65,22,14,13,3,660,303,357,97,89,85,33,0
53255,271,110,161,33,27,11,8,663,360,303,87,82,80,35,0
53256,313,178,135,43,18,35,6,405,181,224,71,57,31,12,0
53257,374,202,172,58,40,41,7,665,361,304,87,91,84,31,0
53258,598,322,276,67,57,63,26,660,303,357,97,89,85,33,0
53259,1464,693,771,153,136,91,86,287,151,136,51,42,36,7,0
53260,126,57,69,31,10,10,3,201,98,103,28,25,19,13,0
53261,222,110,112,43,30,14,6,467,240,227,65,65,51,23,0
53262,213,114,99,62,7,2,1,389,207,182,53,58,52,18,0
53263,800,416,384,102,105,83,22,557,281,276,80,59,43,21,0
53264,413,236,177,41,25,35,19,106,46,60,29,13,14,5,0
53265,580,281,299,95,60,74,29,660,303,357,97,89,85,33,0
53266,425,220,205,60,55,45,18,621,273,348,104,102,48,19,0
53267,335,183,152,40,26,54,22,1395,627,768,172,263,141,59,0
53268,139,81,58,17,14,24,9,134,72,62,14,28,8,4,0
53269,1849,931,918,245,220,158,90,1001,417,584,186,147,96,47,0
53270,86,50,36,9,14,8,7,536,267,269,60,70,41,22,0
53271,785,325,460,114,123,61,28,277,152,125,31,35,22,19,0
53272,126,58,68,31,10,10,3,127,58,69,18,17,10,5,0
53273,125,57,68,31,10,10,3,218,111,107,45,29,24,6,0
53274,484,264,220,59,62,68,15,410,197,213,67,43,56,18,0
53275,236,120,116,32,28,21,11,363,180,183,60,34,10,6,0
53276,1051,429,622,179,148,125,54,1698,875,823,222,219,173,64,0
53277,927,457,470,130,99,118,42,308,146,162,42,39,24,12,0
53278,215,80,135,54,56,21,9,98,49,49,14,15,9,2,0
53279,136,66,70,33,11,9,5,245,121,124,37,35,36,12,0
53280,2236,1195,1041,227,187,186,118,423,234,189,66,44,57,12,0
53281,415,133,282,114,65,27,7,536,222,314,101,100,34,22,0
53282,125,57,68,31,10,10,3,277,163,114,33,24,21,16,0
53283,313,148,165,45,33,36,11,250,119,131,58,26,29,7,0
53284,540,252,288,73,67,57,20,665,361,304,87,91,84,31,0
53285,270,158,112,35,20,23,7,187,89,98,36,24,20,6,0
53286,335,155,180,64,48,36,10,323,168,155,51,41,38,12,0
53287,376,171,205,45,45,34,12,341,170,171,41,66,27,10,0
53288,509,246,263,84,71,56,22,526,266,260,76,75,53,22,0
53289,227,120,107,31,28,28,13,457,242,215,39,46,53,10,0
53290,422,196,226,52,35,33,20,198,86,112,36,27,23,9,0
53291,425,199,226,54,71,56,11,1061,543,518,146,123,109,67,0
53292,5890,3314,2576,970,956,293,265,278,154,124,42,32,38,7,0
53293,144,57,87,38,26,10,4,432,244,188,51,51,27,14,0
53294,624,222,402,92,81,39,15,227,130,97,32,25,22,12,0
53295,553,319,234,56,37,54,18,1101,626,475,145,122,120,50,0
53296,674,268,406,118,96,70,21,517,295,222,69,62,40,28,0
53297,164,81,83,37,8,14,10,467,231,236,71,65,58,18,0
53298,2446,1099,1347,363,294,233,100,821,394,427,122,117,109,38,0
53299,240,98,142,49,42,23,17,396,223,173,57,37,44,19,0
53300,772,383,389,105,76,82,33,1062,522,540,151,147,105,66,0
53301,264,122,142,33,29,13,13,354,188,166,46,40,34,10,0
53302,453,240,213,53,33,44,16,132,61,71,19,20,14,6,0
53303,281,154,127,45,31,24,9,262,129,133,40,41,31,10,0
53304,736,353,383,117,83,71,18,1208,565,643,182,162,120,57,0
53305,361,183,178,50,54,51,22,234,129,105,31,22,19,17,0
53306,410,188,222,53,52,31,14,462,229,233,63,49,42,18,0
53307,221,80,141,48,37,14,10,403,221,182,62,50,42,12,0
53308,575,290,285,67,70,28,9,475,251,224,67,49,48,23,0
53309,165,66,99,28,32,16,3,425,177,248,60,62,33,16,0
53310,286,111,175,51,47,21,12,660,303,357,97,89,85,33,0
53311,1336,724,612,209,141,133,60,103,44,59,16,17,9,5,0
53312,126,56,70,31,10,10,3,244,143,101,31,29,26,8,0
53313,1849,931,918,245,220,158,90,775,407,368,122,100,97,32,0
53314,479,227,252,69,48,46,18,926,425,501,159,147,77,35,0
53315,144,57,87,38,26,10,4,392,155,237,68,61,34,16,0
53316,3969,1703,2266,619,432,259,144,286,152,134,38,38,32,11,0
53317,1395,595,800,223,206,113,61,289,140,149,33,42,30,15,0
53318,359,204,155,39,36,34,13,148,84,64,30,7,17,4,0
53319,255,110,145,34,32,23,17,480,255,225,67,64,50,22,0
53320,264,122,142,46,24,35,10,368,200,168,54,49,43,9,0
53321,485,183,302,79,81,73,33,516,245,271,82,84,70,26,0
53322,579,321,258,74,70,47,22,270,162,108,26,26,16,11,0
53323,332,170,162,44,38,39,10,1114,539,575,145,131,94,56,0
53324,273,126,147,54,49,25,18,239,113,126,36,49,20,8,0
53325,552,295,257,67,49,70,30,1065,581,484,134,97,76,46,0
53326,465,217,248,64,51,50,42,1084,538,546,154,121,92,35,0
53327,526,268,258,54,37,55,12,693,360,333,100,88,62,26,0
53328,184,88,96,15,40,17,8,402,186,216,64,47,38,20,0
53329,2286,1154,1132,338,314,278,103,277,144,133,42,30,41,8,0
53330,802,375,427,133,103,81,41,293,142,151,49,40,42,17,0
53331,665,341,324,109,79,38,22,536,267,269,60,70,41,22,0
53332,442,254,188,46,22,40,19,647,350,297,95,79,77,29,0
53333,1499,864,635,141,99,76,110,375,211,164,50,36,31,23,0
53334,228,105,123,34,43,20,10,396,213,183,68,44,47,18,0
53335,482,245,237,69,64,66,24,286,152,134,38,38,32,11,0
53336,1531,649,882,108,122,93,72,649,307,342,71,134,45,17,0
53337,107,56,51,18,16,12,5,127,66,61,13,14,19,8,0
53338,260,120,140,34,39,36,12,368,200,168,54,49,43,9,0
53339,350,172,178,61,45,32,13,153,80,73,26,18,19,4,0
53340,375,167,208,55,83,44,9,329,194,135,45,32,33,9,0
53341,736,353,383,117,83,71,18,314,177,137,34,40,29,9,0
53342,598,300,298,68,77,59,21,201,93,108,34,39,21,6,0
53343,949,466,483,125,126,101,50,207,86,121,34,39,11,13,0
53344,881,492,389,87,97,59,51,462,229,233,63,49,42,18,0
53345,243,100,143,58,50,24,5,664,350,314,86,90,82,36,0
53346,103,56,47,27,7,8,2,277,144,133,42,30,41,8,0
53347,494,233,261,87,57,46,18,107,77,30,7,2,9,5,0
53348,262,133,129,44,38,31,12,207,86,121,34,39,11,13,0
53349,919,444,475,141,148,62,20,445,192,253,86,58,53,18,0
53350,798,364,434,133,88,74,35,1425,670,755,153,189,122,85,0
53351,613,303,310,70,28,28,18,106,54,52,12,9,7,6,0
53352,528,273,255,67,53,29,20,2038,1059,979,262,237,208,100,0
53353,126,56,70,31,10,10,3,203,98,105,34,29,19,10,0
53354,2063,1024,1039,175,117,80,97,470,205,265,71,80,33,11,0
53355,1447,698,749,214,180,116,46,350,196,154,52,37,21,14,0
53356,949,466,483,125,126,101,50,528,276,252,86,78,49,17,0
53357,317,167,150,45,21,30,26,966,478,488,108,144,74,43,0
53358,90,54,36,20,4,14,5,737,397,340,87,104,90,14,0
53359,76,30,46,7,15,1,5,205,94,111,48,31,15,6,0
53360,124,58,66,20,28,11,7,323,168,155,51,41,38,12,0
53361,222,110,112,43,30,14,6,297,175,122,46,30,31,6,0
53362,199,107,92,41,15,14,8,332,173,159,48,40,31,11,0
53363,349,153,196,54,47,28,13,457,242,215,39,46,53,10,0
53364,486,243,243,65,48,63,22,330,166,164,55,51,36,16,0
53365,800,416,384,102,105,83,22,972,471,501,152,138,112,40,0
53366,349,131,218,66,76,22,9,260,131,129,42,31,40,9,0
53367,867,415,452,123,87,62,27,104,46,58,15,17,9,5,0
53368,329,165,164,61,44,29,17,421,222,199,69,50,60,18,0
53369,118,51,67,25,13,6,7,178,99,79,31,19,26,8,0
53370,333,171,162,50,34,19,8,277,163,114,33,24,21,16,0
53371,745,402,343,95,71,69,40,87,38,49,23,10,10,9,0
53372,410,211,199,55,42,34,27,87,38,49,23,10,10,9,0
53373,684,353,331,95,98,77,38,866,478,388,121,101,101,26,0
53374,2048,855,1193,297,287,191,93,234,116,118,34,35,23,9,0
53375,128,70,58,29,9,8,1,270,162,108,26,26,16,11,0
53376,494,233,261,87,57,46,18,487,252,235,79,58,55,26,0
53377,303,147,156,49,49,20,8,422,202,220,80,52,57,18,0
53378,514,226,288,71,66,63,32,535,311,224,66,52,49,24,0
53379,457,228,229,64,36,52,21,294,146,148,50,45,51,15,0
53380,763,371,392,104,88,52,23,305,161,144,39,40,44,17,0
53381,1390,585,805,241,230,118,46,317,161,156,50,36,47,12,0
53382,188,84,104,35,36,18,9,535,301,234,63,48,47,27,0
53383,704,342,362,113,91,85,33,201,93,108,34,39,21,6,0
53384,372,171,201,47,53,39,18,354,183,171,54,43,49,8,0
53385,456,214,242,76,62,52,22,900,441,459,125,127,110,32,0
53386,478,220,258,47,70,41,10,297,175,122,46,30,31,6,0
53387,303,161,142,38,31,42,17,1113,480,633,170,173,81,34,0
53388,538,263,275,71,85,44,18,89,37,52,13,6,2,9,0
53389,594,279,315,93,68,68,26,592,249,343,91,90,50,42,0
53390,403,176,227,71,56,51,11,129,60,69,21,15,8,5,0
53391,225,111,114,38,22,25,10,661,325,336,81,75,65,28,0
53392,411,211,200,61,46,35,18,296,140,156,49,40,42,19,0
53393,454,214,240,56,71,35,16,332,155,177,55,51,44,13,0
53394,144,57,87,38,26,10,4,131,55,76,28,9,14,12,0
53395,631,304,327,98,75,52,23,218,118,100,33,30,25,11,0
53396,2696,1169,1527,432,347,193,146,234,129,105,31,22,19,17,0
53397,1087,523,564,146,177,103,33,1248,584,664,184,164,155,67,0
53398,446,174,272,84,61,57,23,447,232,215,55,65,50,25,0
53399,648,262,386,113,108,78,29,903,436,467,128,116,83,33,0
53400,2279,996,1283,375,328,158,60,73,35,38,14,10,9,4,0
53401,594,321,273,98,59,57,23,250,119,131,58,26,29,7,0
53402,682,292,390,89,69,58,20,598,333,265,79,66,54,33,0
53403,928,442,486,139,118,91,43,508,262,246,66,67,51,20,0
53404,794,322,472,122,108,79,34,453,255,198,62,49,29,19,0
53405,426,196,230,76,65,54,20,390,190,200,66,50,43,12,0
53406,426,196,230,76,65,54,20,415,203,212,77,44,49,18,0
53407,243,100,143,58,50,24,5,660,333,327,102,95,69,31,0
53408,1594,660,934,251,272,117,77,360,180,180,57,48,39,12,0
53409,269,124,145,36,24,32,11,362,156,206,74,42,36,22,0
53410,435,222,213,67,49,67,12,397,234,163,44,38,23,21,0
53411,747,469,278,60,41,53,23,374,174,200,54,52,42,21,0
53412,533,300,233,74,50,74,17,1700,731,969,198,233,110,87,0
53413,1047,443,604,162,156,78,52,467,240,227,65,65,51,23,0
53414,800,416,384,102,105,83,22,866,397,469,117,153,95,48,0
53415,538,263,275,71,85,44,18,445,192,253,86,58,53,18,0
53416,373,164,209,51,45,44,21,103,44,59,16,17,9,5,0
53417,972,501,471,125,156,106,39,417,232,185,58,50,29,21,0
53418,1709,650,1059,338,286,185,46,68,36,32,11,8,9,2,0
53419,836,370,466,126,96,72,30,149,52,97,36,36,7,4,0
53420,261,126,135,41,36,24,11,296,140,156,49,40,42,19,0
53421,793,355,438,134,117,77,43,508,262,246,66,67,51,20,0
53422,588,267,321,99,79,87,28,607,293,314,98,71,62,32,0
53423,438,185,253,71,64,52,28,180,115,65,17,12,9,9,0
53424,420,202,218,67,43,51,15,96,46,50,16,12,7,5,0
53425,347,154,193,48,51,25,11,1249,638,611,166,153,141,45,0
53426,554,217,337,112,72,90,38,72,32,40,8,2,2,13,0
53427,374,187,187,51,52,40,27,323,168,155,51,41,38,12,0
53428,717,281,436,165,81,112,49,1101,626,475,145,122,120,50,0
53429,243,70,173,54,65,8,6,91,42,49,21,9,8,3,0
53430,772,383,389,105,76,82,33,262,129,133,40,41,31,10,0
53431,181,92,89,34,22,17,9,415,203,212,77,44,49,18,0
53432,210,101,109,33,33,19,9,198,86,112,36,27,23,9,0
53433,357,182,175,49,36,39,15,1755,905,850,214,196,183,79,0
53434,502,274,228,64,49,75,17,317,161,156,50,36,47,12,0
53435,465,240,225,50,54,24,14,200,99,101,31,24,26,6,0
53436,859,411,448,118,100,95,49,267,141,126,53,27,23,7,0
53437,350,212,138,32,26,40,13,480,255,225,67,64,50,22,0
53438,4128,2104,2024,581,505,453,205,741,383,358,92,63,79,36,0
53439,341,183,158,36,34,36,15,1047,562,485,141,127,114,41,0
53440,303,161,142,38,31,42,17,286,152,134,38,38,32,11,0
53441,563,255,308,91,111,42,30,285,146,139,41,41,48,13,0
53442,193,110,83,18,20,15,12,404,190,214,55,55,35,27,0
53443,170,82,88,32,23,22,8,900,441,459,125,127,110,32,0
53444,2236,1195,1041,227,187,186,118,194,106,88,33,10,15,6,0
53445,136,66,70,33,11,9,3,843,391,452,139,104,91,35,0
53446,407,207,200,53,36,38,8,418,223,195,51,45,49,14,0
53447,1054,497,557,190,168,107,45,620,324,296,81,68,66,31,0
53448,431,245,186,50,23,46,17,218,114,104,32,31,33,11,0
53449,253,133,120,44,31,22,8,588,286,302,78,99,53,25,0
53450,361,167,194,55,35,41,11,188,101,87,20,18,20,14,0
53451,484,192,292,118,68,83,22,1323,690,633,132,178,112,61,0
53452,502,236,266,66,66,58,17,1230,644,586,198,125,123,61,0
53453,90,54,36,20,4,14,5,424,179,245,65,67,29,11,0
53454,92,46,46,14,9,8,6,277,144,133,42,30,41,8,0
53455,417,222,195,53,39,43,10,271,150,121,39,36,37,5,0
53456,2000,965,1035,357,313,198,75,106,46,60,27,18,12,3,0
53457,350,178,172,49,62,29,16,594,312,282,72,67,73,31,0
53458,362,174,188,46,55,35,23,439,227,212,60,55,58,8,0
53459,359,167,192,49,37,27,19,307,132,175,48,53,26,10,0
53460,1560,778,782,224,235,132,78,536,267,269,60,70,41,22,0
53461,407,230,177,44,39,34,19,312,165,147,41,39,29,16,0
53462,1755,849,906,245,226,148,56,180,89,91,28,27,18,7,0
53463,422,196,226,52,35,33,20,756,348,408,101,103,60,40,0
53464,410,211,199,55,42,34,27,758,319,439,101,123,78,25,0
53465,275,125,150,37,48,27,7,900,441,459,125,127,110,32,0
53466,1555,702,853,250,199,139,31,381,186,195,69,55,46,15,0
53467,421,219,202,68,57,56,13,495,217,278,79,64,44,22,0
53468,1542,682,860,290,158,120,47,664,350,314,86,90,82,36,0
53469,687,351,336,106,67,70,41,403,185,218,67,62,63,19,0
53470,1327,520,807,241,174,141,60,257,139,118,64,17,24,7,0
53471,648,376,272,70,60,73,24,535,311,224,66,52,49,24,0
53472,203,97,106,30,22,18,10,892,475,417,130,108,68,38,0
53473,565,264,301,101,73,72,15,555,292,263,75,63,67,27,0
53474,162,73,89,32,19,4,4,256,141,115,32,22,32,8,0
53475,435,222,213,67,49,67,12,422,202,220,80,52,57,18,0
53476,385,179,206,58,56,38,19,418,246,172,52,39,57,10,0
53477,417,176,241,75,61,51,20,274,157,117,40,29,40,8,0
53478,753,395,358,93,72,71,16,101,59,42,11,17,10,1,0
53479,270,158,112,35,20,23,7,148,69,79,26,18,16,3,0
53480,426,231,195,51,52,45,24,229,120,109,31,30,22,9,0
53481,270,166,104,30,26,28,14,316,159,157,38,48,30,11,0
53482,439,183,256,60,64,36,14,149,52,97,36,36,7,4,0
53483,446,265,181,51,35,27,17,381,187,194,37,49,36,17,0
53484,412,146,266,106,38,67,35,723,353,370,120,109,96,33,0
53485,235,100,135,36,25,30,8,403,221,182,62,50,42,12,0
53486,411,171,240,61,81,30,15,227,130,97,32,25,22,12,0
53487,495,217,278,79,64,44,22,559,317,242,58,65,37,23,0
53488,126,57,69,31,10,10,3,192,91,101,29,28,17,7,0
53489,306,172,134,35,31,37,18,600,254,346,104,100,44,17,0
53490,739,323,416,127,89,76,33,736,388,348,88,85,67,28,0
53491,531,260,271,97,68,47,11,904,436,468,143,118,108,32,0
53492,854,435,419,118,91,95,42,137,72,65,27,13,15,8,0
53493,473,212,261,72,64,45,28,405,214,191,53,42,49,20,0
53494,1221,597,624,201,152,83,31,91,42,49,21,9,8,3,0
53495,478,177,301,109,66,59,25,348,194,154,57,31,43,12,0
53496,734,339,395,135,89,78,36,699,334,365,108,80,70,20,0
53497,594,321,273,98,59,57,23,147,74,73,28,20,24,4,0
53498,193,90,103,44,9,19,13,277,138,139,40,39,20,14,0
53499,531,259,272,75,81,39,13,295,160,135,42,37,46,16,0
53500,860,348,512,121,136,75,35,947,482,465,143,107,89,37,0
53501,456,214,242,76,62,52,22,720,361,359,98,98,70,37,0
53502,609,292,317,102,96,64,21,178,99,79,31,19,26,8,0
53503,271,136,135,37,30,18,10,133,61,72,21,19,13,4,0
53504,622,354,268,89,60,64,18,250,119,131,58,26,29,7,0
53505,428,248,180,44,39,28,9,1065,581,484,134,97,76,46,0
53506,260,120,140,34,39,36,12,129,60,69,21,15,8,5,0
53507,341,175,166,48,43,35,18,1239,659,580,169,148,131,54,0
53508,358,212,146,51,36,33,9,1114,539,575,145,131,94,56,0
53509,260,136,124,24,41,19,4,541,279,262,79,82,31,32,0
53510,361,167,194,55,35,41,11,410,197,213,67,43,56,18,0
53511,267,146,121,40,24,25,7,127,54,73,11,33,15,6,0
53512,325,177,148,40,24,23,13,501,257,244,75,57,48,29,0
53513,432,233,199,52,28,47,18,449,252,197,61,52,36,18,0
53514,412,193,219,69,57,43,14,368,200,168,54,49,43,9,0
53515,119,59,60,29,10,6,4,406,223,183,61,53,46,17,0
53516,674,318,356,86,139,50,11,403,221,182,62,50,42,12,0
53517,375,201,174,52,56,39,15,164,79,85,28,28,16,7,0
53518,213,114,99,62,7,2,1,376,189,187,47,53,44,26,0
53519,160,53,107,31,29,13,3,763,418,345,113,84,59,32,0
53520,360,175,185,73,36,27,7,943,463,480,91,144,70,30,0
53521,345,203,142,47,35,31,11,330,166,164,55,51,36,16,0
53522,1718,735,983,266,225,130,68,154,78,76,23,21,13,5,0
53523,313,158,155,43,35,43,16,127,64,63,26,8,12,8,0
53524,240,166,74,32,12,8,15,600,254,346,104,100,44,17,0
53525,2000,965,1035,357,313,198,75,119,61,58,17,12,10,6,0
53526,376,176,200,31,53,27,8,241,127,114,34,33,29,12,0
53527,347,181,166,27,20,12,12,654,295,359,99,88,71,25,0
53528,449,179,270,80,77,49,29,708,328,380,113,100,82,34,0
53529,332,173,159,48,42,42,9,396,197,199,75,49,49,16,0
53530,154,74,80,18,19,7,2,256,141,115,32,22,32,8,0
53531,772,383,389,105,76,82,33,690,345,345,96,83,73,42,0
53532,331,165,166,52,34,48,22,282,134,148,38,45,29,10,0
53533,149,68,81,15,38,11,10,173,90,83,30,19,19,11,0
53534,217,109,108,30,23,28,10,582,264,318,84,60,58,23,0
53535,393,223,170,44,36,32,14,727,388,339,102,87,70,29,0
53536,1087,523,564,146,177,103,33,452,231,221,74,53,56,20,0
53537,175,91,84,22,18,11,20,364,216,148,36,20,50,30,0
53538,1051,429,622,179,148,125,54,241,127,114,34,33,29,12,0
53539,343,189,154,44,24,39,12,508,253,255,73,60,50,13,0
53540,219,116,103,66,7,2,1,1352,602,750,166,185,81,70,0
53541,837,381,456,123,109,65,25,127,54,73,11,33,15,6,0
53542,837,443,394,129,89,87,38,325,172,153,44,34,27,14,0
53543,837,381,456,123,109,65,25,592,249,343,91,90,50,42,0
53544,228,82,146,45,37,18,8,329,194,135,45,32,33,9,0
53545,526,228,298,69,64,32,30,360,185,175,51,43,36,16,0
53546,123,58,65,22,14,13,3,492,278,214,65,58,32,11,0
53547,128,70,58,29,9,8,1,86,40,46,16,13,9,7,0
53548,1849,931,918,245,220,158,90,196,105,91,40,13,19,10,0
53549,2174,1057,1117,241,241,214,117,166,78,88,27,25,19,7,0
53550,496,209,287,113,55,72,14,381,186,195,69,55,46,15,0
53551,722,390,332,125,69,67,25,137,72,65,27,13,15,8,0
53552,473,217,256,59,44,34,21,156,90,66,17,22,11,10,0
53553,2696,1169,1527,432,347,193,146,1279,669,610,164,162,104,55,0
53554,1064,495,569,157,159,124,58,390,223,167,58,36,45,18,0
53555,326,148,178,55,42,31,12,419,233,186,54,53,55,17,0
53556,414,206,208,56,68,35,19,898,469,429,125,125,134,35,0
53557,228,82,146,45,37,18,8,708,328,380,113,100,82,34,0
53558,128,69,59,29,9,8,1,175,82,93,33,26,17,5,0
53559,595,208,387,157,60,91,48,261,127,134,36,27,36,4,0
53560,598,300,298,68,77,59,21,504,272,232,75,57,53,19,0
53561,170,82,88,32,23,22,8,474,268,206,66,42,45,24,0
53562,416,222,194,58,38,38,20,384,212,172,44,43,34,14,0
53563,361,171,190,44,40,18,13,602,310,292,87,66,70,36,0
53564,553,276,277,88,61,45,27,1047,562,485,141,127,114,41,0
53565,532,254,278,91,48,23,17,455,229,226,66,62,63,29,0
53566,385,179,206,58,56,38,19,415,205,210,77,52,55,17,0
53567,870,436,434,131,114,72,25,847,402,445,137,119,102,41,0
53568,390,199,191,72,42,35,12,463,268,195,59,46,46,21,0
53569,480,267,213,49,44,70,21,189,95,94,25,33,16,8,0
53570,911,489,422,121,98,97,36,204,96,108,31,37,20,5,0
53571,441,218,223,69,55,50,27,276,149,127,34,31,32,10,0
53572,342,150,192,52,43,31,17,455,229,226,66,62,63,29,0
53573,393,223,170,44,36,32,14,200,99,101,31,24,26,6,0
53574,535,315,220,57,55,71,19,106,54,52,12,9,7,6,0
53575,784,351,433,118,87,73,41,215,115,100,27,19,16,7,0
53576,243,100,143,58,50,24,5,579,285,294,78,72,64,32,0
53577,103,44,59,16,17,9,5,769,329,440,116,66,55,22,0
53578,312,164,148,54,29,25,15,1323,690,633,132,178,112,61,0
53579,545,221,324,101,72,55,30,437,224,213,40,29,42,25,0
53580,2048,855,1193,297,287,191,93,73,35,38,14,10,9,4,0
53581,465,240,225,50,54,24,14,127,54,73,11,33,15,6,0
53582,451,225,226,69,57,64,22,329,194,135,45,32,33,9,0
53583,527,254,273,67,66,70,31,761,351,410,117,73,103,45,0
53584,415,217,198,50,31,42,17,1113,480,633,170,173,81,34,0
53585,802,430,372,65,102,87,23,316,166,150,45,38,37,13,0
53586,413,236,177,41,25,35,19,478,254,224,67,74,56,28,0
53587,215,117,98,28,19,15,8,607,293,314,98,71,62,32,0
53588,347,212,135,35,32,17,6,188,88,100,53,12,15,6,0
53589,704,342,362,113,91,85,33,124,69,55,14,7,9,4,0
53590,270,131,139,47,37,41,11,89,51,38,15,15,5,4,0
53591,531,259,272,75,81,39,13,89,38,51,14,6,3,9,0
53592,180,57,123,39,22,10,8,727,362,365,123,107,63,23,0
53593,681,367,314,83,74,78,31,375,209,166,50,37,29,23,0
53594,275,125,150,37,48,27,7,943,463,480,91,144,70,30,0
53595,524,262,262,62,72,39,49,904,436,468,143,118,108,32,0
53596,417,222,195,53,39,43,10,775,407,368,122,100,97,32,0
53597,531,260,271,97,68,47,11,189,95,94,25,33,16,8,0
53598,358,206,152,45,38,67,16,102,51,51,12,15,12,3,0
53599,674,268,406,118,96,70,21,462,229,233,63,49,42,18,0
53600,860,349,511,166,166,58,19,266,146,120,41,28,31,7,0
53601,785,374,411,56,42,38,25,390,223,167,58,36,45,18,0
53602,318,164,154,52,43,34,10,798,385,413,120,115,79,30,0
53603,467,233,234,83,37,77,22,192,110,82,33,21,10,3,0
53604,368,154,214,80,52,41,16,903,436,467,128,116,83,33,0
53605,480,257,223,74,26,60,27,395,198,197,55,55,36,10,0
53606,684,353,331,95,98,77,38,2346,1231,1115,316,292,266,105,0
53607,2525,1232,1293,398,317,186,61,462,229,233,63,49,42,18,0
53608,346,186,160,40,37,34,21,331,180,151,46,35,47,17,0
53609,1849,931,918,245,220,158,90,225,129,96,32,33,20,8,0
53610,1098,519,579,182,159,79,42,2542,1245,1297,285,287,170,84,0
53611,1417,598,819,223,188,135,58,562,273,289,76,92,45,24,0
53612,365,210,155,46,30,24,12,270,162,108,26,26,16,11,0
53613,288,142,146,52,32,26,8,297,164,133,45,39,40,9,0
53614,290,156,134,44,29,39,9,132,67,65,24,21,8,10,0
53615,234,110,124,39,29,23,2,1113,480,633,170,173,81,34,0
53616,381,187,194,37,49,36,17,232,108,124,33,27,19,16,0
53617,219,100,119,40,29,21,3,279,142,137,43,39,28,7,0
53618,181,75,106,35,26,11,9,679,338,341,96,95,40,23,0
53619,301,150,151,45,47,33,13,376,183,193,50,50,43,21,0
53620,688,310,378,130,82,78,47,312,165,147,41,39,29,16,0
53621,83,45,38,11,8,8,3,535,311,224,66,52,49,24,0
53622,651,357,294,81,67,103,18,89,38,51,14,6,3,9,0
53623,186,56,130,46,50,16,7,501,240,261,80,62,49,42,0
53624,527,254,273,67,66,70,31,592,249,343,91,90,50,42,0
53625,1284,511,773,227,166,169,107,73,35,38,14,10,9,4,0
53626,162,73,89,32,19,4,4,396,223,173,57,37,44,19,0
53627,328,195,133,36,23,35,9,1323,690,633,132,178,112,61,0
53628,1068,434,634,173,160,61,29,189,95,94,25,33,16,8,0
53629,468,233,235,65,61,49,34,135,57,78,21,20,9,11,0
53630,869,489,380,110,77,79,29,332,180,152,44,36,27,13,0
53631,433,188,245,63,45,26,14,654,295,359,99,88,71,25,0
53632,106,43,63,28,13,8,1,317,161,156,40,49,41,11,0
53633,98,32,66,15,25,5,4,277,145,132,41,32,22,10,0
53634,270,166,104,30,26,28,14,207,86,121,34,39,11,13,0
53635,376,171,205,45,45,34,12,929,459,470,140,120,94,45,0
53636,125,46,79,24,16,12,2,732,402,330,81,86,87,33,0
53637,406,208,198,41,26,43,21,106,46,60,29,13,14,5,0
53638,462,258,204,59,41,56,15,96,45,51,13,12,6,4,0
53639,361,177,184,59,51,24,15,597,300,297,96,89,68,29,0
53640,349,131,218,66,76,22,9,192,110,82,33,21,10,3,0
53641,911,441,470,123,108,60,21,290,147,143,34,34,39,13,0
53642,315,174,141,46,38,47,16,602,310,292,87,66,70,36,0
53643,450,227,223,53,36,48,12,370,173,197,65,57,42,10,0
53644,574,269,305,91,63,54,27,103,50,53,19,10,7,5,0
53645,747,360,387,125,92,69,32,172,88,84,24,31,20,12,0
53646,546,265,281,101,64,38,16,166,88,78,23,18,13,7,0
53647,502,274,228,64,49,75,17,592,249,343,91,90,50,42,0
53648,126,66,60,24,10,7,9,375,209,166,50,37,29,23,0
53649,510,269,241,66,67,71,26,87,38,49,23,10,10,9,0
53650,200,94,106,33,22,18,8,166,88,78,23,18,13,7,0
53651,512,254,258,70,48,37,32,583,321,262,73,67,45,25,0
53652,251,139,112,41,18,27,11,364,189,175,58,41,35,17,0
53653,259,119,140,48,28,29,19,242,121,121,39,30,29,10,0
53654,281,125,156,44,47,17,7,227,130,97,32,25,22,12,0
53655,434,221,213,58,47,54,15,453,255,198,62,49,29,19,0
53656,473,217,256,59,44,34,21,535,288,247,79,72,35,21,0
53657,502,236,266,66,66,58,17,748,359,389,125,113,86,31,0
53658,180,57,123,39,22,10,8,137,85,52,15,11,11,2,0
53659,856,429,427,113,105,96,24,329,196,133,41,36,31,15,0
53660,369,207,162,67,35,16,14,588,286,302,78,99,53,25,0
53661,420,202,218,67,43,51,15,187,89,98,36,24,20,6,0
53662,509,251,258,69,49,55,17,354,188,166,46,40,34,10,0
53663,130,71,59,30,9,8,1,367,218,149,45,43,42,16,0
53664,256,152,104,18,23,23,8,758,319,439,101,123,78,25,0
53665,126,57,69,31,10,10,3,180,95,85,22,21,17,8,0
53666,416,207,209,63,47,56,15,517,295,222,69,62,40,28,0
53667,365,148,217,86,37,51,28,452,252,200,55,49,61,16,0
53668,432,190,242,85,82,28,11,975,475,500,139,140,119,28,0
53669,125,53,72,18,21,18,12,370,190,180,60,52,37,13,0
53670,130,70,60,30,9,8,1,94,45,49,11,20,10,4,0
53671,258,144,114,33,22,19,9,4646,2328,2318,674,639,475,170,0
53672,325,181,144,46,31,48,9,180,115,65,17,12,9,9,0
53673,473,217,256,59,44,34,21,198,113,85,19,20,26,12,0
53674,368,154,214,80,52,41,16,396,213,183,68,44,47,18,0
53675,139,81,58,17,14,24,9,111,60,51,17,23,10,7,0
53676,640,271,369,111,79,57,17,660,303,357,97,89,85,33,0
53677,781,316,465,130,129,65,23,663,360,303,87,82,80,35,0
53678,1235,584,651,140,226,82,52,594,312,282,72,67,73,31,0
53679,136,65,71,33,11,9,6,1378,692,686,194,174,105,56,0
53680,805,338,467,153,138,99,55,329,194,135,45,32,33,9,0
53681,616,323,293,98,71,31,15,548,296,252,71,74,43,28,0
53682,2525,1232,1293,398,317,186,61,737,397,340,87,104,90,14,0
53683,126,66,60,24,10,7,9,551,226,325,96,103,43,11,0
53684,1463,521,942,252,204,105,52,290,147,143,34,34,39,13,0
53685,126,57,69,31,10,10,3,792,398,394,109,96,90,39,0
53686,1365,590,775,257,168,136,93,1696,771,925,257,225,149,63,0
53687,1105,544,561,165,167,99,40,252,130,122,45,23,32,11,0
53688,508,136,372,157,91,22,9,169,84,85,29,19,21,7,0
53689,579,246,333,102,79,41,19,274,157,117,40,29,40,8,0
53690,605,277,328,99,54,63,43,430,212,218,88,43,40,20,0
53691,959,496,463,144,132,75,35,295,158,137,42,34,38,14,0
53692,125,53,72,18,21,18,12,346,178,168,58,41,33,12,0
53693,594,321,273,98,59,57,23,364,189,175,58,41,35,17,0
53694,587,318,269,76,50,38,21,892,475,417,130,108,68,38,0
53695,143,81,62,28,9,8,1,708,328,380,113,100,82,34,0
53696,1011,559,452,121,97,132,33,818,357,461,122,136,54,25,0
53697,577,342,235,63,57,23,37,1500,804,696,190,172,144,60,0
53698,207,89,118,56,8,4,3,246,125,121,38,36,30,11,0
53699,560,279,281,113,64,58,15,729,358,371,116,99,89,33,0
53700,179,78,101,29,22,10,8,531,261,270,73,80,68,26,0
53701,452,217,235,59,47,60,20,201,93,108,34,39,21,6,0
53702,1139,537,602,162,139,109,50,737,397,340,87,104,90,14,0
53703,1163,417,746,209,145,87,28,135,57,78,21,20,9,11,0
53704,181,92,89,34,22,17,9,430,212,218,88,43,40,20,0
53705,107,53,54,15,15,13,4,306,157,149,52,35,39,16,0
53706,319,153,166,61,52,26,12,654,295,359,99,88,71,25,0
53707,794,322,472,122,108,79,34,283,160,123,25,20,37,9,0
53708,237,127,110,34,30,16,9,386,181,205,55,51,57,31,0
53709,680,308,372,82,72,71,40,278,154,124,42,32,38,7,0
53710,251,131,120,49,35,25,5,72,32,40,8,2,1,14,0
53711,1835,904,931,192,144,135,63,594,312,282,72,67,73,31,0
53712,301,150,151,45,47,33,13,189,105,84,25,26,21,9,0
53713,318,161,157,53,51,32,13,549,273,276,74,68,72,24,0
53714,435,225,210,58,46,50,14,149,77,72,37,10,20,5,0
53715,826,362,464,107,118,71,43,419,175,244,71,73,23,23,0
53716,739,389,350,129,61,69,25,565,237,328,75,88,32,11,0
53717,484,194,290,70,93,47,16,1101,626,475,145,122,120,50,0
53718,308,163,145,38,33,30,20,246,125,121,38,36,30,11,0
53719,264,122,142,33,29,13,13,274,157,117,40,29,40,8,0
53720,1121,458,663,158,210,76,47,96,46,50,16,12,7,5,0
53721,420,189,231,79,67,33,17,974,457,517,133,117,69,26,0
53722,315,111,204,82,66,46,11,457,245,212,62,58,57,21,0
53723,898,397,501,102,98,54,37,724,353,371,94,95,71,31,0
53724,557,211,346,129,125,48,19,508,262,246,66,67,51,20,0
53725,503,260,243,46,56,33,16,469,225,244,64,68,25,11,0
53726,517,245,272,92,77,46,24,289,140,149,33,42,30,15,0
53727,126,57,69,31,10,10,3,287,151,136,51,42,36,7,0
53728,867,415,452,123,87,62,27,497,257,240,71,63,62,16,0
53729,960,409,551,166,134,77,44,690,345,345,96,83,73,42,0
53730,486,243,243,65,48,63,22,332,173,159,48,40,31,11,0
53731,130,70,60,30,9,8,1,72,34,38,8,2,3,12,0
53732,803,358,445,135,117,80,43,471,238,233,66,63,62,19,0
53733,124,58,66,20,28,11,7,445,202,243,70,73,51,15,0
53734,161,99,62,15,22,9,7,1034,495,539,150,134,114,71,0
53735,727,426,301,79,71,64,32,2724,1157,1567,269,518,239,77,0
53736,256,152,104,18,23,23,8,201,117,83,22,21,19,9,0
53737,270,130,140,43,24,36,10,295,156,139,41,40,42,15,0
53738,125,57,68,31,10,10,3,445,264,181,35,35,34,14,0
53739,1130,614,516,129,138,98,42,285,146,139,41,41,48,13,0
53740,447,225,222,76,35,75,21,467,240,227,65,65,51,23,0
53741,1085,646,439,108,65,36,19,729,358,371,116,99,89,33,0
53742,683,304,379,140,101,48,19,177,100,77,22,17,20,11,0
53743,111,29,82,10,54,0,1,452,254,198,72,57,38,18,0
53744,2136,1063,1073,317,308,223,90,483,258,225,70,53,54,20,0
53745,434,221,213,58,47,54,15,133,61,72,21,19,13,4,0
53746,221,75,146,68,21,16,5,452,254,198,72,57,38,18,0
53747,244,104,140,52,31,30,14,292,143,149,38,42,36,16,0
53748,717,381,336,118,103,85,29,395,169,226,73,55,38,9,0
53749,213,114,99,62,7,2,1,332,155,177,55,51,44,13,0
53750,674,268,406,118,96,70,21,264,138,126,33,34,29,12,0
53751,155,85,70,17,16,4,8,482,232,250,77,81,44,13,0
53752,127,55,72,25,18,5,7,72,33,39,8,2,3,12,0
53753,259,151,108,39,18,23,11,336,190,146,52,30,41,6,0
53754,505,201,304,116,58,75,31,257,126,131,61,24,22,8,0
53755,425,198,227,57,69,59,13,453,247,206,58,53,45,20,0
53756,1047,443,604,162,156,78,52,132,77,55,20,9,13,10,0
53757,330,141,189,65,29,51,19,72,33,39,8,2,3,12,0
53758,227,120,107,31,28,28,13,102,51,51,12,15,12,3,0
53759,575,295,280,89,68,54,18,402,186,216,64,47,38,20,0
53760,193,107,86,13,20,13,6,173,94,79,18,24,12,7,0
53761,760,322,438,81,130,57,19,1182,591,591,155,139,83,46,0
53762,484,194,290,70,93,47,16,660,333,327,102,95,69,31,0
53763,139,81,58,17,14,24,9,519,287,232,68,58,45,21,0
53764,624,222,402,92,81,39,15,498,244,254,81,67,58,19,0
53765,915,336,579,185,199,56,29,405,195,210,57,74,24,17,0
53766,527,276,251,64,60,70,20,295,160,135,44,36,46,16,0
53767,300,136,164,45,35,45,14,671,306,365,114,76,49,19,0
53768,427,191,236,67,60,41,34,644,343,301,96,69,59,28,0
53769,478,177,301,109,66,59,25,792,398,394,109,96,90,39,0
53770,4128,2104,2024,581,505,453,205,649,307,342,71,134,45,17,0
53771,895,388,507,130,84,90,31,244,143,101,31,29,26,8,0
53772,772,383,389,105,76,82,33,316,166,150,45,38,37,13,0
53773,336,199,137,46,22,51,13,376,183,193,50,50,43,21,0
53774,341,183,158,36,34,36,15,317,161,156,50,36,47,12,0
53775,340,145,195,46,38,26,23,744,385,359,105,96,57,31,0
53776,595,316,279,86,60,65,40,509,267,242,79,81,38,20,0
53777,453,240,213,53,33,44,16,102,51,51,12,15,12,3,0
53778,484,192,292,118,68,83,22,445,202,243,70,73,51,15,0
53779,496,209,287,112,55,71,14,134,72,62,14,28,8,4,0
53780,278,110,168,58,49,29,5,350,196,154,52,37,21,14,0
53781,667,366,301,96,55,84,25,723,353,370,120,109,96,33,0
53782,760,405,355,112,95,92,29,360,180,180,57,48,39,12,0
53783,798,287,511,126,125,77,26,483,287,196,71,50,54,17,0
53784,342,185,157,42,27,31,14,346,178,168,58,41,33,12,0
53785,594,321,273,98,59,57,23,266,150,116,28,28,24,12,0
53786,1867,973,894,256,222,194,65,98,49,49,14,15,9,2,0
53787,380,185,195,68,54,32,16,89,51,38,15,15,5,4,0
53788,952,547,405,95,90,127,35,246,125,121,38,36,30,11,0
53789,410,208,202,59,58,43,26,188,93,95,33,18,16,10,0
53790,496,274,222,57,43,75,22,265,134,131,48,34,33,15,0
53791,305,168,137,48,35,40,9,711,330,381,111,86,86,34,0
53792,1220,575,645,208,179,99,56,397,223,174,50,39,29,17,0
53793,180,92,88,29,20,26,8,1425,670,755,153,189,122,85,0
53794,293,153,140,45,38,22,15,275,155,120,37,31,16,14,0
53795,121,69,52,15,18,14,8,389,210,179,51,37,43,9,0
53796,423,247,176,58,55,29,20,418,246,172,52,39,57,10,0
53797,472,222,250,46,61,33,23,1182,591,591,155,139,83,46,0
53798,732,355,377,108,109,79,27,715,345,370,110,97,64,25,0
53799,610,249,361,107,69,72,33,536,267,269,60,70,41,22,0
53800,350,212,138,32,26,40,13,929,459,470,140,120,94,45,0
53801,729,351,378,111,98,58,18,352,207,145,40,33,25,21,0
53802,280,156,124,36,19,20,13,449,252,197,61,52,36,18,0
53803,193,110,83,18,20,15,12,763,418,345,113,84,59,32,0
53804,446,195,251,56,53,31,15,134,55,79,22,24,16,6,0
53805,221,75,146,68,21,16,5,91,44,47,9,12,4,7,0
53806,533,297,236,74,57,39,28,332,180,152,46,36,28,14,0
53807,336,199,137,46,22,51,13,664,350,314,86,90,82,36,0
53808,473,212,261,72,64,45,28,194,106,88,33,10,15,6,0
53809,682,260,422,153,78,109,46,292,143,149,38,42,36,16,0
53810,598,300,298,68,77,59,21,405,181,224,71,57,31,12,0
53811,585,277,308,92,73,61,32,547,295,252,81,65,57,23,0
53812,376,249,127,47,23,43,16,1262,653,609,169,165,152,50,0
53813,782,372,410,127,111,89,36,103,50,53,19,10,7,5,0
53814,283,112,171,48,39,34,15,974,457,517,133,117,69,26,0
53815,149,68,81,15,38,11,10,720,357,363,113,85,62,39,0
53816,218,133,85,20,19,13,6,335,170,165,52,36,47,11,0
53817,514,226,288,71,66,63,32,385,212,173,57,40,39,21,0
53818,284,128,156,48,29,34,8,215,115,100,27,19,16,7,0
53819,474,250,224,58,47,37,12,723,363,360,107,106,52,14,0
53820,682,260,422,98,83,42,31,89,37,52,13,6,2,9,0
53821,258,130,128,44,37,29,10,148,84,64,30,7,17,4,0
53822,313,158,155,43,35,43,16,348,194,154,57,31,43,12,0
53823,404,197,207,60,48,47,20,465,252,213,73,58,60,18,0
53824,129,70,59,29,9,7,2,619,305,314,85,93,71,29,0
53825,109,42,67,25,13,1,1,218,114,104,32,31,33,11,0
53826,1087,523,564,146,177,103,33,260,133,127,43,32,39,3,0
53827,1342,640,702,187,163,123,57,128,63,65,30,11,13,8,0
53828,280,156,124,36,19,20,13,406,202,204,54,51,63,21,0
53829,728,358,370,118,100,55,29,189,105,84,25,26,21,9,0
53830,117,58,59,17,17,12,2,87,38,49,23,10,10,9,0
53831,446,265,181,51,35,27,17,374,212,162,48,40,32,23,0
53832,332,173,159,48,42,42,9,68,23,45,12,9,3,9,0
53833,1096,563,533,158,136,120,53,367,199,168,62,44,34,8,0
53834,224,101,123,45,32,21,3,1543,794,749,182,152,132,55,0
53835,373,194,179,42,54,26,13,264,138,126,33,34,29,12,0
53836,552,295,257,67,49,70,30,565,237,328,75,88,32,11,0
53837,155,85,70,17,16,4,8,300,148,152,45,43,40,8,0
53838,302,178,124,34,29,50,13,68,23,45,12,9,3,9,0
53839,369,166,203,59,55,41,14,583,321,262,73,67,45,25,0
53840,348,198,150,57,25,37,18,562,273,289,76,92,45,24,0
53841,1054,497,557,190,168,107,45,89,42,47,16,12,15,6,0
53842,224,101,123,45,32,21,3,620,324,296,81,68,66,31,0
53843,364,172,192,55,57,32,15,262,129,133,40,41,31,10,0
53844,318,164,154,52,43,34,10,447,212,235,86,55,58,21,0
53845,429,227,202,49,51,46,26,330,166,164,55,51,36,16,0
53846,421,219,202,68,57,56,13,308,129,179,44,60,19,8,0
53847,527,276,251,64,60,70,20,261,162,99,24,21,14,10,0
53848,384,198,186,58,48,37,12,482,232,250,77,81,44,13,0
53849,1051,429,622,179,148,125,54,279,142,137,43,39,28,7,0
53850,340,145,195,46,38,26,23,349,200,149,41,39,30,20,0
53851,545,221,324,101,72,55,30,173,94,79,18,24,12,7,0
53852,224,108,116,33,26,32,10,381,196,185,55,57,43,16,0
53853,526,228,298,69,64,32,30,264,138,126,33,34,29,12,0
53854,297,182,115,41,22,23,8,205,94,111,48,31,15,6,0
53855,245,111,134,36,27,18,6,439,231,208,65,51,55,17,0
53856,118,51,67,25,13,6,7,309,159,150,47,43,43,13,0
53857,283,172,111,39,31,29,8,138,69,69,28,7,10,10,0
53858,610,249,361,107,69,72,33,531,261,270,73,80,68,26,0
53859,466,259,207,59,50,83,12,325,159,166,59,46,30,12,0
53860,166,59,107,36,41,10,4,320,168,152,38,42,24,18,0
53861,867,415,452,123,87,62,27,811,361,450,124,107,80,31,0
53862,856,429,427,113,105,96,24,72,32,40,8,2,1,14,0
53863,524,270,254,84,72,70,23,387,193,194,60,53,57,15,0
53864,881,492,389,87,97,59,51,396,197,199,75,49,49,16,0
53865,639,368,271,72,51,38,38,65,32,33,16,4,8,3,0
53866,513,276,237,73,43,57,24,103,44,59,16,17,9,5,0
53867,527,254,273,67,66,70,31,317,161,156,50,36,47,12,0
53868,502,229,273,63,66,40,31,620,324,296,81,68,66,31,0
53869,434,221,213,58,47,54,15,701,380,321,94,84,96,34,0
53870,265,165,100,32,19,27,5,452,254,198,72,57,38,18,0
53871,367,167,200,63,42,60,17,282,134,148,38,45,29,10,0
53872,453,240,213,53,33,44,16,1239,659,580,169,148,131,54,0
53873,164,77,87,33,19,6,7,519,287,232,68,58,45,21,0
53874,833,295,538,146,139,65,34,292,143,149,38,42,36,16,0
53875,1759,838,921,269,212,191,92,293,142,151,49,40,42,17,0
53876,329,165,164,61,44,29,17,418,223,195,53,43,49,15,0
53877,420,202,218,67,43,51,15,354,188,166,46,40,34,10,0
53878,468,233,235,65,61,49,34,363,180,183,60,34,10,6,0
53879,342,185,157,42,27,31,14,290,142,148,41,37,43,11,0
53880,316,157,159,45,38,22,19,404,190,214,55,55,35,27,0
53881,2696,1169,1527,432,347,193,146,1182,591,591,155,139,83,46,0
53882,211,92,119,33,44,11,7,1025,549,476,118,109,88,61,0
53883,200,103,97,17,16,10,10,564,264,300,79,84,65,26,0
53884,391,203,188,49,34,36,9,430,212,218,88,43,40,20,0
53885,2525,1232,1293,398,317,186,61,201,98,103,28,25,19,13,0
53886,213,88,125,21,54,14,15,101,59,42,11,17,10,1,0
53887,415,217,198,50,31,42,17,400,187,213,56,59,42,20,0
53888,674,268,406,118,96,70,21,1700,731,969,198,233,110,87,0
53889,154,74,80,18,19,7,2,671,321,350,95,87,75,34,0
53890,593,282,311,75,70,29,25,317,161,156,40,49,41,11,0
53891,1970,978,992,245,206,198,80,201,99,102,34,26,23,6,0
53892,479,228,251,71,57,60,14,223,113,110,31,33,22,12,0
53893,540,252,288,73,67,57,20,487,252,235,79,58,55,26,0
53894,753,361,392,99,94,66,16,232,108,124,33,27,19,16,0
53895,126,57,69,31,10,10,3,593,289,304,85,69,48,19,0
53896,1255,666,589,145,142,120,82,119,57,62,18,16,17,4,0
53897,407,164,243,88,42,40,22,325,172,153,44,34,27,14,0
53898,1226,513,713,184,147,87,43,846,425,421,125,97,98,38,0
53899,329,168,161,48,34,41,16,607,293,314,98,71,62,32,0
53900,220,113,107,37,24,16,7,198,110,88,27,27,24,4,0
53901,550,304,246,60,64,77,16,242,124,118,39,32,28,22,0
53902,465,240,225,50,54,24,14,496,285,211,62,54,46,22,0
53903,1052,492,560,184,163,103,44,605,283,322,94,72,64,39,0
53904,412,208,204,54,47,42,17,530,287,243,79,70,33,26,0
53905,732,355,377,108,109,79,27,487,252,235,79,58,55,26,0
53906,643,284,359,129,71,84,43,389,207,182,53,58,52,18,0
53907,429,227,202,49,51,46,26,773,389,384,119,91,79,26,0
53908,393,223,170,44,36,32,14,265,134,131,48,34,33,15,0
53909,654,344,310,80,69,57,15,485,244,241,80,55,59,20,0
53910,338,139,199,54,54,18,11,326,149,177,51,51,28,10,0
53911,519,259,260,86,78,59,22,376,189,187,47,53,44,26,0
53912,610,249,361,107,69,72,33,422,202,220,80,52,57,18,0
53913,98,32,66,15,25,5,4,250,119,131,58,26,29,7,0
53914,213,113,100,26,21,26,12,169,84,85,29,19,21,7,0
53915,514,226,288,71,66,63,32,498,244,254,81,67,58,19,0
53916,420,202,218,67,43,51,15,906,455,451,116,105,87,46,0
53917,886,440,446,116,140,95,45,621,273,348,104,102,48,19,0
53918,142,76,66,21,21,22,11,385,188,197,57,42,36,16,0
53919,439,241,198,67,40,40,13,1040,564,476,134,110,114,51,0
53920,641,349,292,92,60,39,24,111,60,51,17,23,10,7,0
53921,1214,498,716,197,180,121,65,222,122,100,39,32,24,9,0
53922,496,210,286,112,55,71,14,316,166,150,45,38,37,13,0
53923,325,181,144,46,31,48,9,108,59,49,17,13,12,5,0
53924,193,90,103,44,9,19,13,1004,457,547,150,150,74,52,0
53925,435,225,210,58,46,50,14,334,181,153,56,31,28,18,0
53926,126,57,69,31,10,10,3,270,130,140,48,44,37,12,0
53927,156,64,92,31,19,5,4,323,171,152,48,41,40,16,0
53928,393,223,170,44,36,32,14,277,163,114,33,24,21,16,0
53929,677,361,316,81,61,42,22,261,148,113,31,28,14,10,0
53930,130,71,59,30,9,8,2,397,234,163,44,38,23,21,0
53931,798,364,434,133,88,74,35,154,78,76,23,21,13,5,0
53932,302,160,142,35,35,37,10,461,223,238,45,62,18,35,0
53933,365,222,143,44,24,35,11,509,267,242,79,81,38,20,0
53934,207,128,79,26,17,19,9,2382,1162,1220,237,220,140,49,0
53935,210,101,109,33,33,19,9,317,161,156,40,49,41,11,0
53936,328,195,133,36,23,35,9,373,213,160,44,33,26,17,0
53937,271,136,135,37,30,18,10,360,180,180,57,48,39,12,0
53938,2799,1324,1475,369,371,215,124,132,67,65,24,21,8,10,0
53939,107,53,54,15,15,13,4,464,236,228,64,56,53,28,0
53940,1105,544,561,165,167,99,40,173,86,87,30,22,19,12,0
53941,1462,711,751,219,222,148,65,107,77,30,7,2,9,5,0
53942,571,298,273,81,72,57,25,906,455,451,116,105,87,46,0
53943,500,297,203,66,33,53,15,392,214,178,48,40,53,22,0
53944,496,210,286,112,55,71,14,1500,804,696,190,172,144,60,0
53945,919,493,426,100,92,88,49,252,130,122,45,23,32,11,0
53946,546,278,268,94,60,32,22,660,303,357,97,89,85,33,0
53947,528,188,340,130,58,77,41,520,240,280,67,72,42,14,0
53948,111,29,82,10,54,0,1,661,325,336,81,75,65,28,0
53949,396,150,246,103,64,38,3,605,283,322,94,72,64,39,0
53950,629,374,255,74,53,87,27,1061,543,518,146,123,109,67,0
53951,365,222,143,44,24,35,11,187,89,98,36,24,20,6,0
53952,76,42,34,12,8,5,7,926,340,586,133,119,60,40,0
53953,446,283,163,51,26,33,19,758,319,439,101,123,78,25,0
53954,785,374,411,56,42,38,25,497,257,240,71,63,62,16,0
53955,415,133,282,114,65,27,7,242,121,121,39,30,29,10,0
53956,135,64,71,31,11,8,4,1279,669,610,164,162,104,55,0
53957,356,199,157,36,43,28,12,406,202,204,54,51,63,21,0
53958,732,355,377,108,109,79,27,1700,731,969,198,233,110,87,0
53959,143,81,62,28,9,8,1,452,231,221,74,53,56,20,0
53960,546,278,268,94,60,32,22,418,223,195,53,43,49,15,0
53961,217,109,108,30,23,28,10,524,300,223,70,54,51,25,0
53962,609,292,317,102,96,64,21,415,203,212,77,44,49,18,0
53963,225,111,114,38,22,25,10,264,138,126,33,34,29,12,0
53964,282,84,198,60,102,1,6,601,279,322,81,65,27,12,0
53965,338,173,165,31,42,22,10,251,143,108,47,25,29,11,0
53966,291,120,171,63,39,26,6,390,223,167,58,36,45,18,0
53967,374,202,172,58,40,41,7,320,168,152,38,42,24,18,0
53968,373,164,209,51,45,44,21,422,237,185,53,47,62,20,0
53969,222,108,114,37,20,25,12,481,223,258,71,70,49,26,0
53970,319,153,166,61,52,26,12,517,295,222,69,62,40,28,0
53971,496,274,222,57,43,75,22,582,264,318,84,60,58,23,0
53972,270,166,104,30,26,28,14,295,160,135,42,37,46,16,0
53973,2442,1193,1249,278,183,170,145,68,36,32,11,8,9,2,0
53974,658,349,309,77,70,73,35,693,360,333,100,88,62,26,0
53975,161,75,86,24,20,10,7,761,351,410,117,73,103,45,0
53976,520,261,259,74,52,49,22,134,55,79,22,24,16,6,0
53977,1755,849,906,245,226,148,56,290,147,143,34,34,39,13,0
53978,336,134,202,51,64,27,12,485,244,241,80,55,59,20,0
53979,512,254,258,70,48,37,32,132,61,71,19,20,14,6,0
53980,727,426,301,79,71,64,32,858,398,460,126,138,75,39,0
53981,303,161,142,38,31,42,17,297,164,133,45,39,40,9,0
53982,410,208,202,59,58,43,26,384,212,172,44,43,34,14,0
53983,640,271,369,111,79,57,17,449,252,197,61,52,36,18,0
53984,772,383,389,105,76,82,33,1154,489,665,200,196,95,54,0
53985,325,181,144,46,31,48,9,399,190,209,61,41,39,18,0
53986,2279,996,1283,375,328,158,60,4646,2328,2318,674,639,475,170,0
53987,443,212,231,74,24,60,24,257,139,118,64,17,24,7,0
53988,733,438,295,95,79,67,32,663,354,309,91,84,79,31,0
53989,425,199,226,54,71,56,11,715,345,370,110,97,64,25,0
53990,303,161,142,38,31,42,17,517,295,222,69,62,40,28,0
53991,574,269,305,91,63,54,27,392,186,206,62,56,29,15,0
53992,457,261,196,55,27,57,34,173,90,83,21,36,12,15,0
53993,953,421,532,131,131,70,37,132,61,71,19,20,14,6,0
53994,342,185,157,42,27,31,14,846,425,421,125,97,98,38,0
53995,279,127,152,50,36,28,8,367,218,149,45,43,42,16,0
53996,525,254,271,60,76,46,13,562,273,289,76,92,45,24,0
53997,107,53,54,15,15,13,4,283,142,141,41,33,26,18,0
53998,736,320,416,113,97,61,36,621,310,311,100,106,77,27,0
53999,235,100,135,36,25,30,8,198,115,83,30,22,8,8,0
54000,328,156,172,44,37,44,15,173,94,79,18,24,12,7,0
54001,545,221,324,101,72,55,30,385,212,173,57,40,39,21,0
54002,126,56,70,31,10,10,3,564,264,300,79,84,65,26,0
54003,1544,738,806,239,217,145,91,858,398,460,126,138,75,39,0
54004,232,134,98,28,20,20,5,323,168,155,51,41,38,12,0
54005,338,208,130,39,30,35,12,127,64,63,26,8,12,8,0
54006,544,291,253,63,53,35,25,399,184,215,55,81,29,10,0
54007,115,62,53,13,10,9,7,601,278,323,124,87,65,21,0
54008,1872,837,1035,280,338,169,80,524,300,223,70,54,51,25,0
54009,1189,653,536,152,118,109,56,256,141,115,32,22,32,8,0
54010,423,247,176,58,55,29,20,555,292,263,75,63,67,27,0
54011,317,140,177,43,26,31,16,474,268,206,66,42,45,24,0
54012,2525,1232,1293,398,317,186,61,274,142,132,33,34,18,14,0
54013,220,113,107,37,24,16,7,180,89,91,28,27,18,7,0
54014,379,217,162,47,20,50,23,285,146,139,41,41,48,13,0
54015,414,206,208,56,68,35,19,766,386,380,101,81,78,31,0
54016,184,88,96,15,40,17,8,975,400,575,160,162,62,31,0
54017,594,279,315,93,68,68,26,415,226,189,51,40,40,29,0
54018,1689,821,868,277,250,177,78,403,184,219,75,51,47,20,0
54019,1047,443,604,162,156,78,52,551,226,325,96,103,43,11,0
54020,1007,353,654,277,147,70,26,205,94,111,48,31,15,6,0
54021,1867,973,894,256,222,194,65,188,101,87,20,18,20,14,0
54022,2286,1154,1132,338,314,278,103,300,148,152,45,43,40,8,0
54023,371,209,162,46,17,36,19,524,300,223,70,54,51,25,0
54024,1163,417,746,209,145,87,28,153,65,88,28,21,20,8,0
54025,482,231,251,76,81,64,26,367,199,168,62,44,34,8,0
54026,4640,2231,2409,660,549,437,245,103,44,59,16,17,9,5,0
54027,570,238,332,112,95,39,23,381,196,185,55,57,43,16,0
54028,381,146,235,74,48,47,34,352,207,145,40,33,25,21,0
54029,388,209,179,46,24,31,28,364,189,175,58,41,35,17,0
54030,128,69,59,29,9,8,1,1065,581,484,134,97,76,46,0
54031,640,279,361,102,83,69,21,98,49,49,14,15,9,2,0
54032,300,136,164,45,35,45,14,334,181,153,56,31,28,18,0
54033,150,60,90,27,16,6,3,283,142,141,41,33,26,18,0
54034,764,277,487,158,162,64,31,188,101,87,20,18,20,14,0
54035,178,89,89,40,12,18,7,452,231,221,74,53,56,20,0
54036,378,202,176,34,32,44,13,621,273,348,104,102,48,19,0
54037,516,224,292,79,29,45,33,749,384,365,108,105,86,31,0
54038,331,165,166,52,34,48,22,145,77,68,26,7,15,8,0
54039,726,312,414,121,73,82,23,225,111,114,32,34,32,16,0
54040,439,183,256,60,64,36,14,169,84,85,29,19,21,7,0
54041,526,228,298,69,64,32,30,279,142,137,43,39,28,7,0
54042,717,381,336,118,103,85,29,862,426,436,113,115,84,37,0
54043,431,202,229,57,50,50,25,106,54,52,12,9,7,6,0
54044,172,98,74,20,21,22,8,660,303,357,97,89,85,33,0
54045,2696,1169,1527,432,347,193,146,727,362,365,123,107,63,23,0
54046,2236,1195,1041,227,187,186,118,323,171,152,48,41,40,16,0
54047,873,366,507,127,125,75,21,514,262,252,78,58,54,26,0
54048,604,239,365,124,63,84,37,663,354,309,91,84,79,31,0
54049,243,70,173,54,65,8,6,330,166,164,55,51,36,16,0
54050,546,265,281,101,64,38,16,173,94,79,18,24,12,7,0
54051,453,240,213,53,33,44,16,119,61,58,17,12,10,6,0
54052,325,181,144,46,31,48,9,163,79,84,22,24,13,5,0
54053,375,167,208,55,83,44,9,1922,923,999,267,275,215,90,0
54054,261,148,113,23,29,26,21,396,213,183,68,44,47,18,0
54055,443,226,217,67,34,53,10,501,249,252,77,70,55,22,0
54056,299,151,148,35,34,26,16,389,207,182,53,58,52,18,0
54057,1041,497,544,180,167,98,34,201,98,103,28,25,19,13,0
54058,320,183,137,51,18,38,8,132,61,71,19,20,14,6,0
54059,629,374,255,74,53,87,27,270,130,140,48,44,37,12,0
54060,2062,706,1356,414,368,158,63,242,124,118,39,32,28,22,0
54061,422,207,215,79,38,53,23,89,42,47,16,12,15,6,0
54062,243,70,173,54,65,8,6,470,205,265,71,80,33,11,0
54063,434,216,218,72,58,40,20,207,114,93,33,20,31,13,0
54064,2286,1154,1132,338,314,278,103,180,89,91,28,27,18,7,0
54065,469,253,216,49,51,48,18,283,160,123,25,20,37,9,0
54066,580,308,272,82,79,58,25,579,285,294,78,72,64,32,0
54067,1498,731,767,220,175,148,68,609,335,274,79,57,45,22,0
54068,631,304,327,98,75,52,23,362,156,206,74,42,36,22,0
54069,318,161,157,53,51,32,13,515,276,239,62,59,43,31,0
54070,463,250,213,56,45,73,25,218,111,107,45,29,24,6,0
54071,1464,693,771,153,136,91,86,662,312,350,103,104,59,20,0
54072,346,209,137,46,37,44,10,134,55,79,22,24,16,6,0
54073,366,190,176,39,62,55,14,160,60,100,23,40,19,11,0
54074,426,214,212,63,47,53,20,322,180,142,45,38,28,7,0
54075,240,99,141,53,38,29,15,530,287,243,79,70,33,26,0
54076,292,102,190,71,27,51,21,354,188,166,46,40,34,10,0
54077,673,317,356,101,85,76,49,602,310,292,87,66,70,36,0
54078,225,111,114,38,22,25,10,194,94,100,33,28,14,7,0
54079,1835,904,931,192,144,135,63,452,252,200,55,49,61,16,0
54080,469,221,248,49,60,55,21,497,257,240,71,63,62,16,0
54081,626,300,326,91,82,68,26,926,340,586,133,119,60,40,0
54082,1161,514,647,159,138,122,37,485,244,241,80,55,59,20,0
54083,143,81,62,28,9,8,1,136,65,71,26,11,7,5,0
54084,374,187,187,51,52,40,27,457,242,215,39,46,53,10,0
54085,1365,590,775,257,168,136,93,145,77,68,26,7,15,8,0
54086,856,429,427,113,105,96,24,178,99,79,31,19,26,8,0
54087,255,136,119,39,20,32,10,679,338,341,96,95,40,23,0
54088,444,250,194,58,21,60,23,415,205,210,77,52,55,17,0
54089,577,251,326,92,84,60,11,375,176,199,48,61,40,12,0
54090,502,274,228,64,49,75,17,597,269,328,102,84,69,24,0
54091,2696,1169,1527,432,347,193,146,405,214,191,53,42,49,20,0
54092,164,81,83,37,8,14,10,1279,669,610,164,162,104,55,0
54093,317,140,177,43,26,31,16,376,183,193,50,50,43,21,0
54094,772,383,389,105,76,82,33,164,79,85,28,28,16,7,0
54095,435,225,210,58,46,50,14,403,192,211,102,39,49,15,0
54096,407,164,243,88,42,40,22,65,32,33,16,4,8,3,0
54097,2109,999,1110,332,294,187,89,403,233,170,38,29,21,14,0
54098,2799,1324,1475,369,371,215,124,445,264,181,35,35,34,14,0
54099,257,132,125,39,27,26,10,373,213,160,44,33,26,17,0
54100,282,105,177,77,28,39,6,68,36,32,11,8,9,2,0
54101,365,148,217,86,37,51,28,1382,508,874,334,320,98,36,0
54102,255,126,129,41,37,13,5,250,116,134,41,30,33,19,0
54103,319,153,166,61,52,26,12,86,40,46,16,13,9,7,0
54104,546,265,281,101,64,38,16,457,253,204,67,51,48,13,0
54105,739,323,416,127,89,76,33,963,525,438,119,102,102,34,0
54106,469,253,216,49,51,48,18,305,163,142,38,27,47,11,0
54107,1531,649,882,108,122,93,72,198,113,85,19,20,26,12,0
54108,502,250,252,70,47,57,15,323,171,152,48,41,40,16,0
54109,458,210,248,39,38,25,16,362,156,206,74,42,36,22,0
54110,1365,590,775,257,168,136,93,858,398,460,126,138,75,39,0
54111,130,71,59,30,9,8,1,478,254,224,67,74,56,28,0
54112,2136,1063,1073,317,308,223,90,222,127,95,23,28,22,7,0
54113,510,288,222,44,36,24,7,873,411,462,132,107,84,40,0
54114,434,221,213,58,47,54,15,354,188,166,46,40,34,10,0
54115,193,107,86,13,20,13,6,588,286,302,78,99,53,25,0
54116,99,35,64,25,18,0,1,598,333,265,79,66,54,33,0
54117,385,203,182,47,43,51,21,898,469,429,125,125,134,35,0
54118,550,304,246,60,64,77,16,583,321,262,73,67,45,25,0
54119,3859,2011,1848,535,391,422,207,572,305,267,74,72,58,21,0
54120,500,297,203,66,33,53,15,524,300,223,70,54,51,25,0
54121,362,181,181,67,46,43,8,189,95,94,25,33,16,8,0
54122,217,109,108,30,23,28,10,381,196,185,55,57,43,16,0
54123,441,216,225,57,66,57,19,256,141,115,32,22,32,8,0
54124,410,188,222,53,52,31,14,611,314,297,79,75,78,22,0
54125,407,230,177,44,39,34,19,723,353,370,120,109,96,33,0
54126,1096,563,533,158,136,120,53,418,223,195,53,43,49,15,0
54127,464,237,227,64,66,33,12,227,130,97,32,25,22,12,0
54128,401,183,218,72,73,28,10,630,321,309,86,90,57,26,0
54129,246,123,123,40,31,27,7,775,407,368,122,100,97,32,0
54130,270,147,123,34,17,39,21,704,355,349,113,94,71,24,0
54131,315,170,145,48,56,22,11,509,267,242,79,81,38,20,0
54132,482,231,251,76,81,64,26,662,312,350,103,104,59,20,0
54133,428,248,180,44,39,28,9,415,205,210,77,52,55,17,0
54134,368,154,214,80,52,41,16,199,105,94,27,27,28,9,0
54135,80,42,38,12,7,7,4,139,73,66,26,13,9,9,0
54136,203,97,106,30,22,18,10,218,115,103,37,33,33,9,0
54137,734,339,395,135,89,78,36,337,170,167,59,33,47,17,0
54138,186,56,130,46,50,16,7,374,174,200,54,52,42,21,0
54139,196,107,89,20,31,17,4,483,258,225,70,53,54,20,0
54140,532,254,278,91,48,23,17,198,115,83,30,22,8,8,0
54141,1096,563,533,158,136,120,53,671,321,350,95,87,75,34,0
54142,543,265,278,52,37,54,19,220,107,113,36,35,28,9,0
54143,445,219,226,61,60,60,21,442,211,231,57,67,47,14,0
54144,341,154,187,34,36,11,11,252,130,122,45,23,32,11,0
54145,410,208,202,59,58,43,26,201,104,97,36,32,24,7,0
54146,309,137,172,51,50,28,14,375,176,199,48,61,40,12,0
54147,425,220,205,60,55,45,18,142,65,77,30,17,22,9,0
54148,199,113,86,27,17,10,7,309,159,150,47,43,43,13,0
54149,288,104,184,80,30,39,6,515,276,239,62,59,43,31,0
54150,911,445,466,154,121,108,48,247,128,119,34,14,16,14,0
54151,595,316,279,86,60,65,40,773,389,384,119,91,79,26,0
54152,710,352,358,104,86,84,41,405,181,224,71,57,31,12,0
54153,1217,647,570,142,160,129,45,296,140,156,49,40,42,19,0
54154,313,158,155,43,35,43,16,515,276,239,62,59,43,31,0
54155,270,130,140,43,24,36,10,520,244,276,91,60,68,20,0
54156,941,459,482,167,140,82,38,485,244,241,80,55,59,20,0
54157,594,279,315,93,68,68,26,926,340,586,133,119,60,40,0
54158,415,133,282,114,65,27,7,469,225,244,64,68,25,11,0
54159,688,310,378,130,82,78,47,251,143,108,47,25,29,11,0
54160,524,262,262,62,72,39,49,270,162,108,26,26,16,11,0
54161,340,145,195,46,38,26,23,536,251,285,75,79,60,23,0
54162,314,178,136,42,32,30,17,715,348,367,109,84,68,30,0
54163,327,174,153,42,35,16,12,134,72,62,14,28,8,4,0
54164,640,271,369,111,79,57,17,264,138,126,33,34,29,12,0
54165,240,98,142,49,42,23,17,225,129,96,32,33,20,8,0
54166,1441,504,937,264,329,69,46,366,204,162,47,41,31,23,0
54167,139,64,75,18,17,18,4,398,200,198,68,43,51,14,0
54168,128,70,58,29,9,8,1,582,264,318,84,60,58,23,0
54169,836,370,466,126,96,72,30,579,285,294,78,72,64,32,0
54170,126,56,70,31,10,10,3,474,268,206,66,42,45,24,0
54171,565,264,301,101,73,72,15,1047,562,485,141,127,114,41,0
54172,342,150,192,52,43,31,17,1241,619,622,183,169,155,59,0
54173,1085,646,439,108,65,36,19,963,525,438,119,102,102,34,0
54174,372,171,201,47,53,39,18,132,67,65,24,21,8,10,0
54175,221,114,107,65,7,2,1,459,260,199,56,42,47,21,0
54176,952,547,405,95,90,127,35,297,175,122,46,30,31,6,0
54177,302,178,124,34,29,50,13,858,398,460,126,138,75,39,0
54178,485,246,239,74,48,47,22,1241,619,622,183,169,155,59,0
54179,341,177,164,57,42,40,18,1061,543,518,146,123,109,67,0
54180,514,226,288,71,66,63,32,295,156,139,41,40,42,15,0
54181,626,308,318,105,89,77,25,335,170,165,52,36,47,11,0
54182,1221,597,624,201,152,83,31,297,164,133,45,39,40,9,0
54183,156,64,92,31,19,5,4,538,274,264,84,67,52,35,0
54184,303,161,142,38,31,42,17,1696,771,925,257,225,149,63,0
54185,5890,3314,2576,970,956,293,265,312,165,147,41,39,29,16,0
54186,261,148,113,23,29,26,21,1004,457,547,150,150,74,52,0
54187,639,368,271,72,51,38,38,245,121,124,37,35,36,12,0
54188,435,222,213,67,49,67,12,165,87,78,24,19,22,9,0
54189,127,48,79,27,20,6,5,373,213,160,44,33,26,17,0
54190,258,130,128,44,37,29,10,397,223,174,50,39,29,17,0
54191,325,177,148,40,24,23,13,148,69,79,26,18,16,3,0
54192,126,56,70,31,10,10,3,180,115,65,17,12,9,9,0
54193,1171,542,629,170,146,114,64,354,183,171,54,43,49,8,0
54194,282,105,177,77,28,39,6,422,237,185,53,47,62,20,0
54195,240,166,74,32,12,8,15,335,186,149,40,28,29,13,0
54196,1043,479,564,200,131,123,62,299,140,159,49,44,26,11,0
54197,1390,585,805,241,230,118,46,277,124,153,44,40,35,18,0
54198,879,457,422,93,98,143,32,478,254,224,67,74,56,28,0
54199,278,110,168,58,49,29,5,278,154,124,42,32,38,7,0
54200,525,254,271,60,76,46,13,693,360,333,100,88,62,26,0
54201,760,322,438,81,130,57,19,127,66,61,13,14,19,8,0
54202,687,351,336,106,67,70,41,1230,644,586,198,125,123,61,0
54203,233,110,123,34,22,34,9,434,213,221,77,62,53,12,0
54204,244,104,140,52,31,30,14,312,165,147,41,39,29,16,0
54205,344,168,176,50,39,30,20,352,207,145,40,33,25,21,0
54206,852,472,380,99,79,70,27,748,359,389,125,113,86,31,0
54207,204,103,101,16,32,22,8,1338,720,618,179,145,141,85,0
54208,764,277,487,158,162,64,31,461,223,238,45,62,18,35,0
54209,535,217,318,87,106,41,14,297,175,122,46,30,31,6,0
54210,536,287,249,64,73,21,27,597,300,297,96,89,68,29,0
54211,753,395,358,93,72,71,16,572,305,267,74,72,58,21,0
54212,437,167,270,126,95,34,10,302,150,152,56,40,52,15,0
54213,181,75,106,35,26,11,9,710,375,335,95,94,110,28,0
54214,413,206,207,38,55,19,10,1062,522,540,151,147,105,66,0
54215,272,141,131,45,29,36,9,935,515,420,126,107,73,32,0
54216,465,240,225,50,54,24,14,152,71,81,41,16,14,2,0
54217,1447,751,696,161,143,131,46,426,235,191,52,35,42,21,0
54218,3703,1708,1995,456,428,305,162,619,305,314,85,93,71,29,0
54219,395,195,200,41,55,23,10,91,42,49,21,9,8,3,0
54220,2279,996,1283,375,328,158,60,295,158,137,42,34,38,14,0
54221,457,228,229,64,36,52,21,396,223,173,57,37,44,19,0
54222,356,199,157,36,43,28,12,528,276,252,86,78,49,17,0
54223,605,277,328,99,54,63,43,163,79,84,22,24,13,5,0
54224,484,192,292,118,68,83,22,386,181,205,55,51,57,31,0
54225,280,128,152,39,37,38,18,2382,1162,1220,237,220,140,49,0
54226,729,351,378,111,98,58,18,91,44,47,9,12,4,7,0
54227,688,310,378,130,82,78,47,701,380,321,94,84,96,34,0
54228,463,225,238,76,36,59,26,163,79,84,22,24,13,5,0
54229,1501,679,822,251,196,174,67,469,225,244,64,68,25,11,0
54230,270,158,112,35,20,23,7,314,151,163,42,61,39,16,0
54231,326,180,146,62,26,41,13,247,128,119,40,21,27,11,0
54232,577,251,326,92,84,60,11,904,436,468,143,118,108,32,0
54233,388,209,179,46,24,31,28,418,223,195,53,43,49,15,0
54234,772,417,355,118,92,80,23,1182,591,591,155,139,83,46,0
54235,2525,1232,1293,398,317,186,61,387,193,194,60,53,57,15,0
54236,639,368,271,72,51,38,38,1065,581,484,134,97,76,46,0
54237,252,121,131,42,34,12,16,395,169,226,73,55,38,9,0
54238,350,172,178,61,45,32,13,135,65,70,21,25,15,9,0
54239,527,254,273,67,66,70,31,399,190,209,61,41,39,18,0
54240,245,111,134,36,27,18,6,133,61,72,21,19,13,4,0
54241,836,370,466,126,96,72,30,262,129,133,40,41,31,10,0
54242,270,128,142,36,43,15,11,205,94,111,48,31,15,6,0
54243,577,342,235,63,57,23,37,780,337,443,112,116,77,28,0
54244,374,187,187,51,52,40,27,314,177,137,34,40,29,9,0
54245,349,131,218,66,76,22,9,279,161,118,37,32,7,7,0
54246,276,149,127,45,34,39,9,199,105,94,27,27,28,9,0
54247,726,312,414,121,73,82,23,455,191,264,68,86,21,19,0
54248,217,98,119,38,35,18,9,2517,1275,1242,304,324,245,135,0
54249,3969,1703,2266,619,432,259,144,178,99,79,31,19,26,8,0
54250,785,351,434,136,93,71,37,387,193,194,60,53,57,15,0
54251,117,58,59,17,17,12,2,274,157,117,40,29,40,8,0
54252,245,111,134,36,27,18,6,187,89,98,36,24,20,6,0
54253,828,355,473,126,134,77,37,147,74,73,28,20,24,4,0
54254,1544,738,806,239,217,145,91,285,143,142,45,32,21,17,0
54255,319,222,97,36,23,28,8,123,61,62,17,18,17,7,0
54256,480,232,248,73,40,44,30,265,134,131,48,34,33,15,0
54257,654,344,310,80,69,57,15,359,171,188,49,74,45,11,0
54258,410,209,201,72,30,48,22,903,436,467,128,116,83,33,0
54259,685,393,292,75,66,113,16,229,120,109,31,30,22,9,0
54260,335,155,180,64,48,36,10,758,319,439,101,123,78,25,0
54261,1327,520,807,241,174,141,60,200,99,101,31,24,26,6,0
54262,327,174,153,42,35,16,12,218,114,104,32,31,33,11,0
54263,886,440,446,116,140,95,45,381,186,195,69,55,46,15,0
54264,202,86,116,33,29,26,10,572,353,219,70,42,57,25,0
54265,802,375,427,133,103,81,41,469,225,244,64,68,25,11,0
54266,259,119,140,48,28,29,19,424,179,245,65,67,29,11,0
54267,399,220,179,48,37,68,18,194,106,88,33,10,15,6,0
54268,365,222,143,44,24,35,11,647,350,297,95,79,77,29,0
54269,1120,436,684,208,120,101,115,285,143,142,45,32,21,17,0
54270,261,130,131,27,41,19,16,741,383,358,92,63,79,36,0
54271,836,370,466,126,96,72,30,123,61,62,17,18,17,7,0
54272,417,176,241,75,61,51,20,978,536,442,132,107,67,32,0
54273,509,246,263,84,71,56,22,207,113,94,33,18,30,9,0
54274,233,107,126,40,40,20,16,403,221,182,62,50,42,12,0
54275,251,131,120,49,35,25,5,294,146,148,50,45,51,15,0
54276,469,221,248,49,60,55,21,405,195,210,57,74,24,17,0
54277,368,201,167,61,38,38,12,447,212,235,86,55,58,21,0
54278,979,534,445,83,77,80,24,507,270,237,89,59,57,22,0
54279,305,124,181,27,25,31,21,213,129,84,32,14,21,15,0
54280,1052,492,560,184,163,103,44,663,360,303,87,82,80,35,0
54281,303,147,156,49,49,20,8,629,317,312,80,87,51,22,0
54282,335,155,180,64,48,36,10,326,149,177,51,51,28,10,0
54283,319,153,166,61,52,26,12,218,111,107,45,29,24,6,0
54284,437,230,207,41,55,27,13,1873,935,938,233,225,203,79,0
54285,392,205,187,83,49,38,10,305,163,142,38,27,47,11,0
54286,640,271,369,111,79,57,17,209,119,90,28,24,27,9,0
54287,83,45,38,11,8,8,3,2202,1121,1081,338,274,269,81,0
54288,451,225,226,69,57,64,22,247,128,119,34,14,16,14,0
54289,480,257,223,74,26,60,27,429,187,242,79,72,28,19,0
54290,203,80,123,40,37,20,3,449,252,197,61,52,36,18,0
54291,536,237,299,116,87,42,17,1696,771,925,257,225,149,63,0
54292,99,35,64,25,18,0,1,729,358,371,116,99,89,33,0
54293,531,284,247,66,42,49,15,316,159,157,38,48,30,11,0
54294,432,190,242,85,82,28,11,462,251,211,74,53,41,18,0
54295,243,100,143,58,50,24,5,679,338,341,96,95,40,23,0
54296,301,156,145,32,25,15,5,1166,514,652,150,159,107,70,0
54297,1755,849,906,245,226,148,56,461,223,238,45,62,18,35,0
54298,280,128,152,39,37,38,18,732,402,330,81,86,87,33,0
54299,758,378,380,89,64,37,31,1034,495,539,150,134,114,71,0
54300,496,210,286,111,55,74,13,514,262,252,78,58,54,26,0
54301,346,168,178,36,43,20,9,250,119,131,58,26,29,7,0
54302,496,209,287,113,55,72,14,497,257,240,71,63,62,16,0
54303,322,164,158,46,44,29,7,579,285,294,78,72,64,32,0
54304,898,397,501,102,98,54,37,172,79,93,34,27,23,10,0
54305,461,257,204,63,49,50,29,1241,619,622,183,169,155,59,0
54306,1709,650,1059,338,286,185,46,601,279,322,81,65,27,12,0
54307,733,438,295,95,79,67,32,1101,626,475,145,122,120,50,0
54308,228,82,146,45,37,18,8,125,66,59,24,16,11,5,0
54309,364,204,160,65,35,15,13,1395,627,768,172,263,141,59,0
54310,282,160,122,36,28,27,7,164,79,85,28,28,16,7,0
54311,179,96,83,24,8,26,4,373,181,192,54,35,44,20,0
54312,276,149,127,45,34,39,9,1040,564,476,134,110,114,51,0
54313,802,430,372,65,102,87,23,947,482,465,143,107,89,37,0
54314,1139,537,602,162,139,109,50,467,226,241,55,48,54,23,0
54315,431,202,229,57,50,50,25,469,225,244,64,68,25,11,0
54316,789,362,427,90,82,70,35,368,200,168,54,49,43,9,0
54317,364,168,196,64,61,27,6,156,90,66,17,22,11,10,0
54318,350,212,138,32,26,40,13,87,51,35,15,9,9,4,0
54319,325,152,173,43,47,28,17,297,164,133,45,39,40,9,0
54320,1689,821,868,277,250,177,78,137,72,65,27,13,15,8,0
54321,480,267,213,49,44,70,21,417,232,185,58,50,29,21,0
54322,586,298,288,80,75,64,37,467,231,236,71,65,58,18,0
54323,469,221,248,49,60,55,21,368,200,168,54,49,43,9,0
54324,1143,574,569,176,151,123,59,1001,417,584,186,147,96,47,0
54325,2488,1085,1403,346,253,162,76,501,257,244,75,57,48,29,0
54326,2649,1431,1218,377,299,266,102,138,69,69,28,7,10,10,0
54327,674,318,356,86,139,50,11,286,152,134,38,38,32,11,0
54328,440,267,173,52,29,42,12,1265,689,576,169,177,128,60,0
54329,441,218,223,69,55,50,27,2202,1121,1081,338,274,269,81,0
54330,204,109,95,21,35,27,7,463,259,204,62,55,34,22,0
54331,181,92,89,34,22,17,9,660,333,327,102,95,69,31,0
54332,521,289,232,71,58,49,16,1230,644,586,198,125,123,61,0
54333,443,250,193,52,23,49,13,898,469,429,125,125,134,35,0
54334,261,126,135,41,36,24,11,749,384,365,108,105,86,31,0
54335,772,332,440,136,104,72,28,91,42,49,21,9,8,3,0
54336,276,149,127,45,34,39,9,201,117,83,22,21,19,9,0
54337,553,276,277,88,61,45,27,2382,1162,1220,237,220,140,49,0
54338,1417,598,819,223,188,135,58,396,197,199,75,49,49,16,0
54339,1542,682,860,290,158,120,47,1182,591,591,155,139,83,46,0
54340,379,217,162,47,20,50,23,1500,804,696,190,172,144,60,0
54341,82,36,46,17,10,5,1,405,214,191,53,42,49,20,0
54342,1130,614,516,129,138,98,42,267,141,126,53,27,23,7,0
54343,410,211,199,55,42,34,27,579,285,294,78,72,64,32,0
54344,51,10,41,25,0,5,8,459,260,199,56,42,47,21,0
54345,115,62,53,13,10,9,7,375,176,199,48,61,40,12,0
54346,246,111,135,64,47,27,3,261,162,99,24,21,14,10,0
54347,1689,821,868,277,250,177,78,199,105,94,27,27,28,9,0
54348,125,57,68,31,10,10,3,277,145,132,41,32,22,10,0
54349,365,210,155,46,30,24,12,178,99,79,31,19,26,8,0
54350,146,73,73,18,24,17,9,364,189,175,58,41,35,17,0
54351,126,57,69,31,10,10,3,265,134,131,48,34,33,15,0
54352,371,143,228,77,48,29,26,2225,1244,981,271,243,217,93,0
54353,624,222,402,92,81,39,15,644,343,301,96,69,59,28,0
54354,67,40,27,10,8,7,6,549,273,276,74,68,72,24,0
54355,553,276,277,88,61,45,27,397,223,174,50,39,29,17,0
54356,798,364,434,133,88,74,35,2547,1280,1267,331,335,293,118,0
54357,238,91,147,68,19,22,7,134,55,79,22,24,16,6,0
54358,664,269,395,117,107,36,15,541,279,262,79,82,31,32,0
54359,347,212,135,35,32,17,6,360,180,180,57,48,39,12,0
54360,531,260,271,97,68,47,11,201,98,103,28,25,19,13,0
54361,257,148,109,28,20,21,14,483,258,225,70,53,54,20,0
54362,498,274,224,58,59,50,18,72,33,39,8,2,3,12,0
54363,473,217,256,59,44,34,21,72,34,38,8,2,3,12,0
54364,236,120,116,32,28,21,11,1352,602,750,166,185,81,70,0
54365,1221,597,624,201,152,83,31,701,380,321,94,84,96,34,0
54366,941,459,482,167,140,82,38,1239,659,580,169,148,131,54,0
54367,682,292,390,89,69,58,20,821,394,427,122,117,109,38,0
54368,302,160,142,35,35,37,10,536,222,314,101,100,34,22,0
54369,508,136,372,157,91,22,9,2547,1280,1267,331,335,293,118,0
54370,126,58,68,31,10,10,3,690,345,345,96,83,73,42,0
54371,350,212,138,32,26,40,13,374,191,183,40,52,40,16,0
54372,1417,598,819,223,188,135,58,619,305,314,85,93,71,29,0
54373,290,156,134,44,29,39,9,564,264,300,79,84,65,26,0
54374,1249,543,706,187,164,125,52,201,104,97,36,32,24,7,0
54375,261,148,113,23,29,26,21,344,190,154,34,31,36,10,0
54376,1709,650,1059,338,286,185,46,744,385,359,105,96,57,31,0
54377,527,254,273,67,66,70,31,389,210,179,51,37,43,9,0
54378,233,110,123,34,22,34,9,538,274,264,84,67,52,35,0
54379,264,122,142,33,29,13,13,261,162,99,24,21,14,10,0
54380,313,134,179,58,37,43,19,218,114,104,32,31,33,11,0
54381,546,285,261,71,49,47,24,89,38,51,14,6,3,9,0
54382,956,450,506,122,117,82,36,138,69,69,28,7,10,10,0
54383,1200,602,598,145,116,110,50,862,426,436,113,115,84,37,0
54384,560,279,281,113,64,58,15,974,457,517,133,117,69,26,0
54385,1030,438,592,184,104,108,30,316,166,150,45,38,37,13,0
54386,802,430,372,65,102,87,23,545,269,276,80,76,27,32,0
54387,886,440,446,116,140,95,45,514,248,266,86,82,52,22,0
54388,1112,457,655,180,164,99,39,282,134,148,38,45,29,10,0
54389,326,148,178,55,42,31,12,482,232,250,77,81,44,13,0
54390,630,231,399,150,83,84,50,1230,644,586,198,125,123,61,0
54391,629,374,255,74,53,87,27,250,119,131,58,26,29,7,0
54392,348,198,150,57,25,37,18,671,321,350,95,87,75,34,0
54393,346,174,172,36,43,21,9,798,385,413,120,115,79,30,0
54394,200,103,97,17,16,10,10,481,223,258,71,70,49,26,0
54395,685,393,292,75,66,113,16,1065,581,484,134,97,76,46,0
54396,279,127,152,50,36,28,8,262,129,133,40,41,31,10,0
54397,118,51,67,25,13,6,7,607,293,314,98,71,62,32,0
54398,707,250,457,171,84,117,61,68,36,32,11,8,9,2,0
54399,280,128,152,39,37,38,18,607,293,314,98,71,62,32,0
54400,218,133,85,20,19,13,6,295,156,139,41,40,42,15,0
54401,1912,880,1032,331,334,180,84,2346,1231,1115,316,292,266,105,0
54402,312,173,139,43,47,28,6,270,130,140,48,44,37,12,0
54403,565,264,301,101,73,72,15,392,155,237,68,61,34,16,0
54404,651,357,294,81,67,103,18,783,406,377,102,91,57,29,0
54405,789,362,427,90,82,70,35,1395,627,768,172,263,141,59,0
54406,649,304,345,99,80,67,40,147,74,73,28,20,24,4,0
54407,1912,880,1032,331,334,180,84,199,105,94,27,27,28,9,0
54408,346,168,178,36,43,20,9,459,260,199,56,42,47,21,0
54409,260,136,124,24,41,19,4,715,348,367,109,84,68,30,0
54410,445,231,214,45,64,53,23,406,223,183,61,53,46,17,0
54411,279,127,152,50,36,28,8,457,242,215,39,46,53,10,0
54412,178,89,89,40,12,18,7,902,499,403,118,117,92,35,0
54413,424,170,254,69,56,47,28,348,194,154,57,31,43,12,0
54414,575,295,280,89,68,54,18,430,212,218,88,43,40,20,0
54415,1221,597,624,201,152,83,31,286,152,134,38,38,32,11,0
54416,1498,731,767,220,175,148,68,242,124,118,39,32,28,22,0
54417,358,212,146,51,36,33,9,323,171,152,48,41,40,16,0
54418,414,216,198,51,32,42,28,627,323,304,81,90,53,27,0
54419,490,224,266,80,70,39,32,295,156,139,41,40,42,15,0
54420,1186,495,691,182,208,88,32,744,385,359,105,96,57,31,0
54421,385,203,182,47,43,51,21,406,234,172,63,35,43,10,0
54422,130,72,58,28,9,7,1,1922,923,999,267,275,215,90,0
54423,1208,575,633,187,204,117,41,376,183,193,50,50,43,21,0
54424,118,51,67,25,13,6,7,336,200,136,34,29,25,24,0
54425,639,368,271,72,51,38,38,662,312,350,103,104,59,20,0
54426,1556,718,838,280,182,161,49,693,360,333,100,88,62,26,0
54427,315,170,145,48,56,22,11,665,361,304,87,91,84,31,0
54428,726,312,414,121,73,82,23,601,279,322,81,65,27,12,0
54429,199,113,86,27,17,10,7,392,186,206,62,56,29,15,0
54430,561,282,279,68,62,36,14,508,253,255,73,60,50,13,0
54431,717,281,436,165,81,112,49,173,90,83,21,36,12,15,0
54432,344,109,235,100,39,26,5,903,436,467,128,116,83,33,0
54433,745,402,343,95,71,69,40,509,267,242,79,81,38,20,0
54434,2236,1195,1041,227,187,186,118,906,455,451,116,105,87,46,0
54435,508,251,257,74,53,51,18,169,85,84,21,14,9,9,0
54436,340,145,195,46,38,26,23,439,231,208,65,51,55,17,0
54437,184,93,91,26,25,14,11,584,249,335,80,96,22,13,0
54438,130,70,60,30,9,8,1,1047,562,485,141,127,114,41,0
54439,233,110,123,34,22,34,9,415,226,189,51,40,40,29,0
54440,244,104,140,52,31,30,14,452,254,198,72,57,38,18,0
54441,1130,614,516,129,138,98,42,530,287,243,79,70,33,26,0
54442,358,212,146,51,36,33,9,710,375,335,95,94,110,28,0
54443,784,351,433,118,87,73,41,630,321,309,86,90,57,26,0
54444,126,57,69,31,10,10,3,405,214,191,53,42,49,20,0
54445,279,127,152,50,36,28,8,332,180,152,46,36,28,14,0
54446,288,142,146,52,32,26,8,218,115,103,37,33,33,9,0
54447,869,489,380,110,77,79,29,415,205,210,77,52,55,17,0
54448,394,207,187,52,42,37,24,1279,669,610,164,162,104,55,0
54449,479,228,251,71,57,60,14,579,285,294,78,72,64,32,0
54450,516,210,306,113,53,81,33,374,174,200,54,52,42,21,0
54451,283,172,111,39,31,29,8,497,227,270,70,63,66,30,0
54452,640,271,369,111,79,57,17,374,181,193,55,58,48,23,0
54453,454,230,224,63,56,38,33,296,140,156,49,40,42,19,0
54454,1542,682,860,290,158,120,47,267,141,126,53,27,23,7,0
54455,181,92,89,34,22,17,9,301,168,133,49,37,34,11,0
54456,881,492,389,87,97,59,51,423,234,189,66,44,57,12,0
54457,2220,1085,1135,312,304,202,91,138,69,69,28,7,10,10,0
54458,629,374,255,74,53,87,27,341,170,171,41,66,27,10,0
54459,446,195,251,56,53,31,15,344,190,154,34,31,36,10,0
54460,443,206,237,76,68,52,28,732,402,330,81,86,87,33,0
54461,711,330,381,111,86,86,34,287,151,136,51,42,36,7,0
54462,169,64,105,23,37,11,3,736,388,348,88,85,67,28,0
54463,402,169,233,70,36,34,18,1034,495,539,150,134,114,71,0
54464,629,338,291,92,57,64,22,415,226,189,51,40,40,29,0
54465,1395,595,800,223,206,113,61,331,180,151,46,35,47,17,0
54466,228,82,146,45,37,18,8,132,67,65,24,21,8,10,0
54467,746,312,434,129,115,77,47,207,86,121,34,39,11,13,0
54468,211,92,119,33,44,11,7,966,478,488,108,144,74,43,0
54469,392,205,187,83,49,38,10,474,268,206,66,42,45,24,0
54470,119,59,60,29,10,6,4,419,233,186,54,53,55,17,0
54471,730,298,432,128,69,86,26,732,402,330,81,86,87,33,0
54472,242,104,138,41,33,37,8,320,168,152,38,42,24,18,0
54473,270,166,104,30,26,28,14,200,99,101,31,24,26,6,0
54474,344,109,235,100,39,26,5,87,51,35,15,9,9,4,0
54475,959,496,463,144,132,75,35,519,287,232,68,58,45,21,0
54476,117,58,59,17,17,12,2,286,152,134,38,38,32,11,0
54477,258,130,128,44,37,29,10,366,204,162,47,41,31,23,0
54478,262,133,129,44,38,31,12,153,80,73,26,18,19,4,0
54479,1004,498,506,94,59,46,33,392,186,206,62,56,29,15,0
54480,763,354,409,101,90,63,26,135,65,70,21,25,15,9,0
54481,473,265,208,47,26,50,30,258,129,129,45,24,31,10,0
54482,624,222,402,92,81,39,15,132,77,55,20,9,13,10,0
54483,332,172,160,50,33,35,9,609,335,274,79,57,45,22,0
54484,556,306,250,69,60,80,18,332,180,152,44,36,27,13,0
54485,272,136,136,32,34,12,12,274,142,132,33,34,18,14,0
54486,335,183,152,40,26,54,22,903,436,467,128,116,83,33,0
54487,464,237,227,64,66,33,12,148,69,79,26,18,16,3,0
54488,496,209,287,113,55,72,14,1698,875,823,222,219,173,64,0
54489,369,166,203,59,55,41,14,98,49,49,14,15,9,2,0
54490,107,56,51,18,16,12,5,583,280,303,95,66,76,25,0
54491,219,116,103,66,7,2,1,130,67,63,24,10,12,4,0
54492,524,361,163,41,8,28,16,317,161,156,50,36,47,12,0
54493,729,351,378,111,98,58,18,91,42,49,21,9,8,3,0
54494,384,198,186,58,48,37,12,1154,489,665,200,196,95,54,0
54495,203,80,123,40,37,20,3,305,161,144,39,40,44,17,0
54496,462,258,204,59,41,56,15,630,321,309,86,90,57,26,0
54497,692,305,387,100,97,78,30,605,283,322,94,72,64,39,0
54498,301,156,145,32,25,15,5,866,478,388,121,101,101,26,0
54499,313,158,155,43,35,43,16,244,143,101,31,29,26,8,0
54500,264,122,142,33,29,13,13,212,127,85,28,21,26,6,0
54501,1200,602,598,145,116,110,50,531,261,270,73,80,68,26,0
54502,1498,731,767,220,175,148,68,274,157,117,40,29,40,8,0
54503,142,76,66,21,21,22,11,565,264,301,101,73,72,15,0
54504,434,221,213,58,47,54,15,142,73,69,27,9,15,11,0
54505,317,167,150,45,21,30,26,602,310,292,87,66,70,36,0
54506,154,74,80,18,19,7,2,277,124,153,44,40,35,18,0
54507,546,278,268,94,60,32,22,169,84,85,29,19,21,7,0
54508,1004,498,506,94,59,46,33,218,114,104,32,31,33,11,0
54509,5890,3314,2576,970,956,293,265,1321,653,668,186,195,70,35,0
54510,1594,660,934,251,272,117,77,198,110,88,27,27,24,4,0
54511,1121,458,663,158,210,76,47,1249,638,611,166,153,141,45,0
54512,242,104,138,41,33,37,8,132,61,71,19,20,14,6,0
54513,414,206,208,56,68,35,19,530,287,243,79,70,33,26,0
54514,200,94,106,33,22,18,8,205,94,111,48,31,15,6,0
54515,312,164,148,54,29,25,15,410,197,213,67,43,56,18,0
54516,879,457,422,93,98,143,32,572,305,267,74,72,58,21,0
54517,411,211,200,61,46,35,18,194,109,85,23,24,21,9,0
54518,563,255,308,91,111,42,30,660,332,328,84,73,47,19,0
54519,553,319,234,56,37,54,18,332,173,159,48,40,31,11,0
54520,425,199,226,54,71,56,11,501,274,227,63,58,53,20,0
54521,366,190,176,39,62,55,14,225,111,114,32,34,32,16,0
54522,624,222,402,92,81,39,15,457,242,215,39,46,53,10,0
54523,344,109,235,100,39,26,5,1698,875,823,222,219,173,64,0
54524,508,267,241,43,35,25,17,276,149,127,34,31,32,10,0
54525,616,323,293,98,71,31,15,455,229,226,66,62,63,29,0
54526,589,282,307,68,67,70,23,188,105,83,25,17,24,7,0
54527,55,16,39,24,2,5,2,423,234,189,66,44,57,12,0
54528,651,357,294,81,67,103,18,101,59,42,11,17,10,1,0
54529,347,181,166,27,20,12,12,335,186,149,40,28,29,13,0
54530,1161,514,647,159,138,122,37,621,273,348,104,102,48,19,0
54531,631,316,315,64,57,49,15,364,189,175,58,41,35,17,0
54532,508,251,257,74,53,51,18,403,184,219,75,51,47,20,0
54533,682,292,390,89,69,58,20,88,50,38,13,8,16,4,0
54534,722,390,332,125,69,67,25,557,281,276,80,59,43,21,0
54535,364,204,160,65,35,15,13,555,292,263,75,63,67,27,0
54536,130,70,60,30,9,8,1,671,321,350,95,87,75,34,0
54537,1001,422,579,185,180,51,32,178,69,109,29,25,21,13,0
54538,292,102,190,71,27,51,21,246,107,139,55,33,27,11,0
54539,128,69,59,29,9,8,1,325,172,153,44,34,27,14,0
54540,476,199,277,82,80,49,24,320,168,152,38,42,24,18,0
54541,76,30,46,7,15,1,5,309,159,150,47,43,43,13,0
54542,401,183,218,72,73,28,10,524,300,223,70,54,51,25,0
54543,125,57,68,31,10,10,3,88,50,38,13,8,16,4,0
54544,374,202,172,58,40,41,7,316,159,157,38,48,30,11,0
54545,546,278,268,94,60,32,22,312,165,147,41,39,29,16,0
54546,270,128,142,36,43,15,11,377,184,193,50,43,33,17,0
54547,2446,1099,1347,363,294,233,100,1543,794,749,182,152,132,55,0
54548,734,366,368,121,99,63,39,551,226,325,96,103,43,11,0
54549,786,378,408,106,98,77,39,169,74,95,33,26,22,3,0
54550,574,284,290,64,50,65,20,277,124,153,44,40,35,18,0
54551,209,75,134,53,48,20,9,188,90,98,44,7,21,7,0
54552,467,233,234,83,37,77,22,405,181,224,71,57,31,12,0
54553,904,436,468,138,146,82,39,660,332,328,84,73,47,19,0
54554,125,53,72,18,21,18,12,501,257,244,75,57,48,29,0
54555,861,393,468,150,101,69,35,1208,565,643,182,162,120,57,0
54556,500,297,203,66,33,53,15,538,274,264,84,67,52,35,0
54557,571,298,273,81,72,57,25,198,86,112,36,27,23,9,0
54558,165,66,99,28,32,16,3,242,124,118,39,32,28,22,0
54559,508,136,372,157,91,22,9,866,397,469,117,153,95,48,0
54560,867,415,452,123,87,62,27,108,59,49,17,13,12,5,0
54561,625,283,342,93,89,67,25,73,35,38,14,10,9,4,0
54562,306,172,134,35,31,37,18,380,211,169,47,37,33,21,0
54563,169,64,105,23,37,11,3,301,168,133,49,37,34,11,0
54564,509,251,258,69,49,55,17,106,54,52,12,9,7,6,0
54565,730,298,432,128,69,86,26,389,210,179,51,37,43,9,0
54566,364,172,192,55,57,32,15,188,93,95,33,18,16,10,0
54567,911,445,466,154,121,108,48,978,536,442,132,107,67,32,0
54568,860,348,512,121,136,75,35,336,200,136,34,29,25,24,0
54569,415,217,198,50,31,42,17,390,223,167,58,36,45,18,0
54570,695,343,352,96,78,62,22,781,418,363,92,90,64,41,0
54571,404,197,207,60,48,47,20,811,361,450,124,107,80,31,0
54572,687,351,336,106,67,70,41,380,211,169,47,37,33,21,0
54573,582,328,254,78,48,35,9,187,89,98,36,24,20,6,0
54574,411,171,240,61,81,30,15,457,242,215,39,46,53,10,0
54575,350,178,172,49,62,29,16,481,223,258,71,70,49,26,0
54576,160,86,74,21,11,16,16,470,211,259,95,60,52,11,0
54577,126,57,69,31,10,10,3,166,88,78,23,18,13,7,0
54578,414,195,219,51,60,40,17,336,200,136,34,29,25,24,0
54579,1161,514,647,159,138,122,37,519,287,232,68,58,45,21,0
54580,529,290,239,54,63,85,15,462,229,233,63,49,42,18,0
54581,1249,543,706,187,164,125,52,928,440,488,111,157,82,35,0
54582,504,222,282,71,64,53,29,406,223,183,61,53,46,17,0
54583,426,231,195,51,52,45,24,198,86,112,36,27,23,9,0
54584,347,181,166,27,20,12,12,260,133,127,43,32,39,3,0
54585,139,81,58,17,14,24,9,246,107,139,55,33,27,11,0
54586,251,139,112,41,18,27,11,346,196,150,43,26,27,14,0
54587,415,133,282,114,65,27,7,741,383,358,92,63,79,36,0
54588,207,128,79,26,17,19,9,295,156,139,41,40,42,15,0
54589,238,158,80,28,15,31,7,1606,753,853,215,227,182,48,0
54590,413,236,177,41,25,35,19,818,357,461,122,136,54,25,0
54591,109,42,67,25,13,1,1,715,345,370,110,97,64,25,0
54592,204,103,101,16,32,22,8,622,344,278,80,77,68,36,0
54593,784,353,431,56,47,26,18,594,312,282,72,67,73,31,0
54594,478,177,301,109,66,59,25,384,212,172,44,43,34,14,0
54595,1439,713,726,195,180,110,34,277,145,132,41,32,22,10,0
54596,224,101,123,45,32,21,3,492,278,214,65,58,32,11,0
54597,604,239,365,124,63,84,37,169,74,95,33,26,22,3,0
54598,335,183,152,40,26,54,22,963,455,508,127,130,115,48,0
54599,330,141,189,65,29,51,19,285,146,139,41,41,48,13,0
54600,161,75,86,24,20,10,7,953,489,464,126,104,111,44,0
54601,3969,1703,2266,619,432,259,144,201,104,97,36,32,24,7,0
54602,235,100,135,36,25,30,8,507,270,237,89,59,57,22,0
54603,593,282,311,75,70,29,25,173,94,79,18,24,12,7,0
54604,378,202,176,34,32,44,13,1020,538,482,145,115,111,58,0
54605,219,100,119,40,29,21,3,926,340,586,133,119,60,40,0
54606,360,175,185,73,36,27,7,337,152,185,49,54,42,21,0
54607,983,449,534,95,77,55,36,621,310,311,100,106,77,27,0
54608,575,290,285,67,70,28,9,207,113,94,33,18,30,9,0
54609,630,231,399,150,83,84,50,415,226,189,51,40,40,29,0
54610,461,257,204,63,49,50,29,292,143,149,38,42,36,16,0
54611,641,349,292,92,60,39,24,535,301,234,63,48,47,27,0
54612,726,312,414,121,73,82,23,175,91,84,19,21,21,10,0
54613,502,236,266,66,66,58,17,360,185,175,51,43,36,16,0
54614,270,130,140,43,24,36,10,153,80,73,26,18,19,4,0
54615,461,257,204,63,49,50,29,390,190,200,66,50,43,12,0
54616,165,66,99,28,32,16,3,592,249,343,91,90,50,42,0
54617,314,178,136,42,32,30,17,483,215,268,66,70,30,16,0
54618,270,131,139,47,37,41,11,904,436,468,143,118,108,32,0
54619,394,207,187,52,42,37,24,207,114,93,33,20,31,13,0
54620,280,156,124,36,19,20,13,229,120,109,31,30,22,9,0
54621,297,161,136,36,35,24,9,516,245,271,82,84,70,26,0
54622,808,366,442,130,133,66,31,775,407,368,122,100,97,32,0
54623,438,185,253,71,64,52,28,325,159,166,59,46,30,12,0
54624,465,220,245,88,34,61,23,427,251,176,51,39,25,22,0
54625,282,105,177,77,28,39,6,148,69,79,26,18,16,3,0
54626,366,190,176,39,62,55,14,374,174,200,54,52,42,21,0
54627,451,278,173,71,35,58,12,127,58,69,18,17,10,5,0
54628,439,241,198,67,40,40,13,89,37,52,13,6,2,9,0
54629,574,284,290,64,50,65,20,508,262,246,66,67,51,20,0
54630,346,205,141,47,34,30,7,715,348,367,109,84,68,30,0
54631,325,152,173,43,47,28,17,201,93,108,34,39,21,6,0
54632,380,187,193,38,51,30,18,173,90,83,21,36,12,15,0
54633,164,77,87,33,19,6,7,325,159,166,59,46,30,12,0
54634,1004,464,540,143,104,78,55,778,391,387,94,77,41,33,0
54635,972,501,471,125,156,106,39,517,295,222,69,62,40,28,0
54636,526,228,298,69,64,32,30,203,98,105,34,29,19,10,0
54637,252,121,131,42,34,12,16,73,35,38,14,10,9,4,0
54638,561,282,279,68,62,36,14,447,212,235,86,55,58,21,0
54639,83,45,38,11,8,8,3,200,99,101,31,24,26,6,0
54640,261,126,135,41,36,24,11,368,204,164,43,35,30,24,0
54641,391,204,187,47,48,38,18,201,98,103,28,25,19,13,0
54642,1531,649,882,108,122,93,72,302,150,152,56,40,52,15,0
54643,2285,1219,1066,207,180,178,106,526,266,260,76,75,53,22,0
54644,564,264,300,79,84,65,26,195,109,86,25,24,17,6,0
54645,188,84,104,35,36,18,9,366,204,162,47,41,31,23,0
54646,565,264,301,101,73,72,15,820,333,487,202,152,59,23,0
54647,1849,931,918,245,220,158,90,414,203,211,58,56,48,14,0
54648,315,111,204,82,66,46,11,664,350,314,86,90,82,36,0
54649,1417,598,819,223,188,135,58,403,192,211,102,39,49,15,0
54650,802,430,372,65,102,87,23,561,279,282,85,81,88,24,0
54651,240,98,142,49,42,23,17,617,314,303,96,68,68,37,0
54652,1139,537,602,162,139,109,50,514,262,252,78,58,54,26,0
54653,521,289,232,71,58,49,16,332,173,159,48,40,31,11,0
54654,1718,735,983,266,225,130,68,374,202,172,50,39,31,24,0
54655,501,230,271,63,90,50,18,535,311,224,66,52,49,24,0
54656,485,183,302,79,81,73,33,690,345,345,96,83,73,42,0
54657,291,120,171,63,39,26,6,149,77,72,37,10,20,5,0
54658,949,466,483,125,126,101,50,373,181,192,54,35,44,20,0
54659,531,259,272,75,81,39,13,2225,1244,981,271,243,217,93,0
54660,443,250,193,52,23,49,13,2225,1244,981,271,243,217,93,0
54661,180,92,88,29,20,26,8,363,180,183,60,34,10,6,0
54662,111,29,82,10,54,0,1,393,210,183,58,37,34,20,0
54663,562,214,348,120,86,69,42,723,353,370,120,109,96,33,0
54664,323,156,167,52,45,39,18,1425,670,755,153,189,122,85,0
54665,326,148,178,55,42,31,12,172,88,84,24,31,20,12,0
54666,553,319,234,56,37,54,18,403,184,219,75,51,47,20,0
54667,340,145,195,46,38,26,23,447,212,235,86,55,58,21,0
54668,392,205,187,83,49,38,10,297,164,133,45,39,40,9,0
54669,1186,495,691,182,208,88,32,479,215,264,67,80,46,28,0
54670,424,170,254,69,56,47,28,622,344,278,80,77,68,36,0
54671,302,160,142,35,35,37,10,798,385,413,120,115,79,30,0
54672,763,354,409,101,90,63,26,501,240,261,80,62,49,42,0
54673,469,253,216,49,51,48,18,149,77,72,37,10,20,5,0
54674,371,143,228,77,48,29,26,564,264,300,79,84,65,26,0
54675,710,352,358,104,86,84,41,189,105,84,25,26,21,9,0
54676,436,209,227,66,47,52,22,474,268,206,66,42,45,24,0
54677,478,220,258,47,70,41,10,72,33,39,8,2,3,12,0
54678,288,104,184,80,30,39,6,228,130,98,35,29,30,10,0
54679,1235,584,651,140,226,82,52,163,79,84,22,24,13,5,0
54680,299,128,171,57,40,13,25,367,199,168,62,44,34,8,0
54681,571,298,273,81,72,57,25,392,214,178,48,40,53,22,0
54682,413,236,177,41,25,35,19,526,266,260,76,75,53,22,0
54683,4128,2104,2024,581,505,453,205,156,90,66,17,22,11,10,0
54684,772,417,355,118,92,80,23,173,94,79,18,24,12,7,0
54685,159,105,54,22,9,14,25,404,190,214,55,55,35,27,0
54686,98,32,66,15,25,5,4,96,45,51,13,12,6,4,0
54687,1186,495,691,182,208,88,32,430,212,218,88,43,40,20,0
54688,442,254,188,46,22,40,19,289,140,149,33,42,30,15,0
54689,919,493,426,100,92,88,49,134,72,62,14,28,8,4,0
54690,219,116,103,66,7,2,1,134,72,62,14,28,8,4,0
54691,227,120,107,31,28,28,13,471,238,233,66,63,62,19,0
54692,860,348,512,121,136,75,35,465,252,213,73,58,60,18,0
54693,156,64,92,31,19,5,4,903,436,467,128,116,83,33,0
54694,424,170,254,69,56,47,28,187,89,98,36,24,20,6,0
54695,391,204,187,47,48,38,18,302,150,152,56,40,52,15,0
54696,650,330,320,97,77,65,28,665,361,304,87,91,84,31,0
54697,595,339,256,64,36,54,24,588,286,302,78,99,53,25,0
54698,457,261,196,55,27,57,34,295,160,135,42,37,46,16,0
54699,2442,1193,1249,278,183,170,145,453,247,206,58,53,45,20,0
54700,2649,1431,1218,377,299,266,102,496,285,211,62,54,46,22,0
54701,282,163,119,40,23,25,17,396,213,183,68,44,47,18,0
54702,552,295,257,67,49,70,30,396,223,173,57,37,44,19,0
54703,326,154,172,45,39,20,10,132,77,55,20,9,13,10,0
54704,2414,1189,1225,277,178,170,169,222,124,98,37,29,22,9,0
54705,490,224,266,80,70,39,32,441,189,252,73,50,47,23,0
54706,745,402,343,95,71,69,40,975,400,575,160,162,62,31,0
54707,502,236,266,66,66,58,17,198,115,83,30,22,8,8,0
54708,368,201,167,61,38,38,12,531,261,270,73,80,68,26,0
54709,473,265,208,47,26,50,30,633,311,322,94,82,45,20,0
54710,332,172,160,50,33,35,9,128,63,65,30,11,13,8,0
54711,680,308,372,82,72,71,40,873,411,462,132,107,84,40,0
54712,1214,612,602,169,173,98,35,154,78,76,23,21,13,5,0
54713,126,58,68,31,10,10,3,437,221,216,62,64,47,13,0
54714,747,469,278,60,41,53,23,866,397,469,117,153,95,48,0
54715,186,56,130,46,50,16,7,1382,508,874,334,320,98,36,0
54716,403,176,227,71,56,51,11,453,247,206,58,53,45,20,0
54717,217,109,108,30,23,28,10,664,350,314,86,90,82,36,0
54718,317,140,177,43,26,31,16,91,44,47,9,12,4,7,0
54719,131,69,62,29,9,9,1,292,155,137,50,34,29,13,0
54720,2285,1219,1066,207,180,178,106,188,105,83,25,17,24,7,0
54721,763,354,409,101,90,63,26,242,124,118,39,32,28,22,0
54722,1051,429,622,179,148,125,54,741,383,358,92,63,79,36,0
54723,446,195,251,56,53,31,15,231,126,105,28,26,34,9,0
54724,437,228,209,47,61,26,11,395,195,200,41,55,23,10,0
54725,373,194,179,42,54,26,13,375,210,165,49,37,29,27,0
54726,391,204,187,47,48,38,18,611,314,297,79,75,78,22,0
54727,149,78,71,20,20,19,5,240,141,99,34,28,29,8,0
54728,164,61,103,47,19,14,5,207,113,94,33,18,30,9,0
54729,424,170,254,69,56,47,28,106,54,52,12,9,7,6,0
54730,532,291,241,83,36,79,25,798,385,413,120,115,79,30,0
54731,172,82,90,21,35,21,5,422,202,220,80,52,57,18,0
54732,463,170,293,115,54,75,32,298,129,169,51,40,29,8,0
54733,1555,702,853,250,199,139,31,548,296,252,71,74,43,28,0
54734,368,201,167,61,38,38,12,295,158,137,42,34,38,14,0
54735,204,93,111,35,35,16,11,267,141,126,53,27,23,7,0
54736,350,172,178,61,45,32,13,541,279,262,79,82,31,32,0
54737,346,208,138,46,39,51,18,457,253,204,67,51,48,13,0
54738,463,225,238,76,36,59,26,398,200,198,68,43,51,14,0
54739,739,323,416,127,89,76,33,508,261,247,65,53,58,23,0
54740,388,244,144,46,25,42,16,780,337,443,112,116,77,28,0
54741,552,295,257,67,49,70,30,798,385,413,120,115,79,30,0
54742,291,120,171,63,39,26,6,196,105,91,40,13,19,10,0
54743,2663,1073,1590,548,499,192,64,898,469,429,125,125,134,35,0
54744,1220,575,645,208,179,99,56,335,170,165,52,36,47,11,0
54745,1849,931,918,245,220,158,90,418,223,195,53,43,49,15,0
54746,207,93,114,20,33,19,10,467,231,236,71,65,58,18,0
54747,508,267,241,43,35,25,17,335,170,165,52,36,47,11,0
54748,282,96,186,80,21,28,7,778,391,387,94,77,41,33,0
54749,494,242,252,67,47,25,21,715,348,367,109,84,68,30,0
54750,228,105,123,34,43,20,10,189,105,84,25,26,21,9,0
54751,510,269,241,66,67,71,26,392,214,178,48,40,53,22,0
54752,1499,864,635,141,99,76,110,496,285,211,62,54,46,22,0
54753,234,110,124,39,29,23,2,107,77,30,7,2,9,5,0
54754,574,269,305,91,63,54,27,405,214,191,53,42,49,20,0
54755,539,283,256,75,73,53,26,2225,1244,981,271,243,217,93,0
54756,102,22,80,48,8,18,6,461,223,238,45,62,18,35,0
54757,553,276,277,88,61,45,27,165,87,78,24,19,22,9,0
54758,331,177,154,54,38,27,11,1230,644,586,198,125,123,61,0
54759,432,233,199,52,28,47,18,455,229,226,66,62,63,29,0
54760,425,220,205,60,55,45,18,199,105,94,27,27,28,9,0
54761,273,126,147,54,49,25,18,260,133,127,43,32,39,3,0
54762,540,252,288,73,67,57,20,889,505,384,107,97,99,30,0
54763,319,222,97,36,23,28,8,392,155,237,68,61,34,16,0
54764,1463,521,942,252,204,105,52,175,91,84,19,21,21,10,0
54765,344,168,176,50,39,30,20,334,182,152,45,41,27,13,0
54766,456,223,233,77,54,47,20,541,279,262,79,82,31,32,0
54767,269,156,113,37,32,17,7,2724,1157,1567,269,518,239,77,0
54768,575,295,280,89,68,54,18,368,200,168,54,49,43,9,0
54769,286,111,175,51,47,21,12,1047,562,485,141,127,114,41,0
54770,1199,589,610,189,128,167,65,720,361,359,98,98,70,37,0
54771,533,300,233,74,50,74,17,1249,638,611,166,153,141,45,0
54772,429,227,202,49,51,46,26,137,63,74,20,22,14,6,0
54773,546,265,281,101,64,38,16,300,148,152,45,43,40,8,0
54774,496,210,286,111,55,74,13,2038,1059,979,262,237,208,100,0
54775,233,110,123,34,22,34,9,1279,669,610,164,162,104,55,0
54776,563,255,308,91,111,42,30,421,222,199,69,50,60,18,0
54777,176,74,102,20,29,7,7,200,89,111,26,25,17,7,0
54778,574,269,305,91,63,54,27,201,93,108,34,39,21,6,0
54779,828,368,460,118,98,59,38,469,225,244,64,68,25,11,0
54780,279,129,150,43,34,17,13,810,310,500,164,162,42,26,0
54781,594,279,315,93,68,68,26,518,292,226,60,60,52,21,0
54782,852,461,391,109,102,72,24,384,212,172,44,43,34,14,0
54783,284,128,156,48,29,34,8,406,202,204,54,51,63,21,0
54784,303,147,156,49,49,20,8,156,90,66,17,22,11,10,0
54785,332,173,159,48,42,42,9,609,335,274,79,57,45,22,0
54786,412,193,219,69,57,43,14,780,337,443,112,116,77,28,0
54787,543,265,278,52,37,54,19,1101,626,475,145,122,120,50,0
54788,1970,978,992,245,206,198,80,139,68,71,14,26,14,9,0
54789,803,358,445,135,117,80,43,137,63,74,20,22,14,6,0
54790,270,147,123,34,17,39,21,1922,923,999,267,275,215,90,0
54791,359,167,192,49,37,27,19,104,46,58,15,17,9,5,0
54792,747,360,387,125,92,69,32,1352,602,750,166,185,81,70,0
54793,1047,443,604,162,156,78,52,123,61,62,17,18,17,7,0
54794,135,64,71,31,11,8,4,418,223,195,51,45,49,14,0
54795,410,209,201,72,30,48,22,375,176,199,48,61,40,12,0
54796,227,120,107,31,28,28,13,821,394,427,122,117,109,38,0
54797,3969,1703,2266,619,432,259,144,780,337,443,112,116,77,28,0
54798,282,163,119,40,23,25,17,314,177,137,34,40,29,9,0
54799,1098,519,579,182,159,79,42,384,212,172,44,43,34,14,0
54800,2048,855,1193,297,287,191,93,928,440,488,111,157,82,35,0
54801,326,176,150,35,22,29,11,332,155,177,55,51,44,13,0
54802,643,284,359,129,71,84,43,166,102,64,19,14,17,2,0
54803,977,462,515,185,119,76,12,584,249,335,80,96,22,13,0
54804,297,161,136,36,35,24,9,393,210,183,58,37,34,20,0
54805,700,305,395,111,99,54,18,352,207,145,40,33,25,21,0
54806,434,221,213,58,47,54,15,520,272,248,60,65,58,22,0
54807,257,122,135,44,19,21,16,194,94,100,33,28,14,7,0
54808,977,462,515,185,119,76,12,397,234,163,44,38,23,21,0
54809,199,113,86,27,17,10,7,137,63,74,20,22,14,6,0
54810,527,276,251,64,60,70,20,339,175,164,51,49,37,9,0
54811,341,195,146,42,21,36,9,329,196,133,41,36,31,15,0
54812,345,208,137,44,27,33,8,464,236,228,64,56,53,28,0
54813,426,213,213,60,56,46,24,1338,720,618,179,145,141,85,0
54814,211,92,119,33,44,11,7,555,292,263,75,63,67,27,0
54815,204,103,101,16,32,22,8,592,249,343,91,90,50,42,0
54816,361,167,194,55,35,41,11,935,515,420,126,107,73,32,0
54817,488,237,251,79,78,65,27,396,213,183,68,44,47,18,0
54818,283,172,111,39,31,29,8,198,115,83,30,22,8,8,0
54819,246,123,123,40,31,27,7,422,237,185,53,47,62,20,0
54820,929,410,519,187,146,53,30,374,202,172,50,39,31,24,0
54821,760,405,355,112,95,92,29,277,138,139,40,39,20,14,0
54822,364,172,192,55,57,32,15,889,505,384,107,97,99,30,0
54823,291,120,171,63,39,26,6,437,221,216,62,64,47,13,0
54824,1849,931,918,245,220,158,90,741,383,358,92,63,79,36,0
54825,380,187,193,38,51,30,18,337,170,167,59,33,47,17,0
54826,301,150,151,45,47,33,13,928,440,488,111,157,82,35,0
54827,435,187,248,62,51,51,21,720,361,359,98,98,70,37,0
54828,314,178,136,42,32,30,17,127,58,69,18,17,10,5,0
54829,375,167,208,55,83,44,9,378,154,224,74,84,35,22,0
54830,126,57,69,31,10,10,3,332,155,177,55,51,44,13,0
54831,339,170,169,32,17,24,13,1338,720,618,179,145,141,85,0
54832,292,102,190,71,27,51,21,257,126,131,61,24,22,8,0
54833,384,196,188,42,43,32,20,346,186,160,50,33,27,12,0
54834,496,272,224,70,58,42,18,201,99,102,34,26,23,6,0
54835,1531,649,882,108,122,93,72,904,436,468,143,118,108,32,0
54836,1718,735,983,266,225,130,68,173,90,83,21,36,12,15,0
54837,584,340,244,77,60,47,25,925,439,486,141,134,105,46,0
54838,1594,660,934,251,272,117,77,201,93,108,34,39,21,6,0
54839,793,355,438,134,117,77,43,727,388,339,102,87,70,29,0
54840,763,354,409,101,90,63,26,289,140,149,33,42,30,15,0
54841,898,397,501,102,98,54,37,536,251,285,75,79,60,23,0
54842,730,298,432,128,69,86,26,250,116,134,41,30,33,19,0
54843,319,153,166,61,52,26,12,611,314,297,79,75,78,22,0
54844,82,36,46,17,10,5,1,359,171,188,49,74,45,11,0
54845,346,209,137,46,37,44,10,483,287,196,71,50,54,17,0
54846,1341,481,860,275,264,57,21,283,160,123,25,20,37,9,0
54847,325,186,139,49,36,20,5,375,210,165,49,37,29,27,0
54848,126,58,68,31,10,10,3,1425,670,755,153,189,122,85,0
54849,118,51,67,25,13,6,7,373,181,192,54,35,44,20,0
54850,766,336,430,133,97,79,21,166,78,88,27,25,19,7,0
54851,598,300,298,68,77,59,21,187,89,98,36,24,20,6,0
54852,485,237,248,83,35,52,24,271,150,121,39,36,37,5,0
54853,267,146,121,40,24,25,7,323,162,161,52,41,39,13,0
54854,613,303,310,70,28,28,18,266,146,120,41,28,31,7,0
54855,1098,519,579,182,159,79,42,317,161,156,50,36,47,12,0
54856,493,281,212,56,61,30,13,229,120,109,31,30,22,9,0
54857,301,150,151,45,47,33,13,519,287,232,68,58,45,21,0
54858,580,265,315,97,89,79,17,278,154,124,42,32,38,7,0
54859,193,107,86,13,20,13,6,1239,659,580,169,148,131,54,0
54860,359,204,155,39,36,34,13,285,143,142,45,32,21,17,0
54861,472,222,250,46,61,33,23,663,354,309,91,84,79,31,0
54862,688,310,378,130,82,78,47,346,178,168,58,41,33,12,0
54863,736,320,416,113,97,61,36,296,159,137,49,28,38,13,0
54864,325,177,148,40,24,23,13,261,148,113,31,28,14,10,0
54865,764,277,487,158,162,64,31,673,313,360,102,101,46,17,0
54866,447,236,211,56,52,49,14,508,262,246,66,67,51,20,0
54867,1107,601,506,155,138,103,49,250,116,134,41,30,33,19,0
54868,553,319,234,56,37,54,18,91,42,49,21,9,8,3,0
54869,192,91,101,28,21,18,8,483,215,268,66,70,30,16,0
54870,1441,504,937,264,329,69,46,418,223,195,53,43,49,15,0
54871,462,258,204,59,41,56,15,1034,495,539,150,134,114,71,0
54872,480,267,213,49,44,70,21,264,138,126,33,34,29,12,0
54873,927,457,470,130,99,118,42,277,144,133,42,30,41,8,0
54874,450,241,209,67,58,54,23,381,187,194,37,49,36,17,0
54875,444,250,194,58,21,60,23,223,113,110,31,33,22,12,0
54876,338,172,166,59,30,39,18,1248,584,664,184,164,155,67,0
54877,562,214,348,120,86,69,42,203,98,105,34,29,19,10,0
54878,2335,1200,1135,374,268,340,83,820,333,487,202,152,59,23,0
54879,338,173,165,31,42,22,10,257,126,131,61,24,22,8,0
54880,391,204,187,47,48,38,18,320,168,152,38,42,24,18,0
54881,269,124,145,36,24,32,11,414,203,211,58,56,48,14,0
54882,342,185,157,42,27,31,14,926,425,501,159,147,77,35,0
54883,536,287,249,64,73,21,27,207,86,121,34,39,11,13,0
54884,107,36,71,27,15,0,1,149,52,97,36,36,7,4,0
54885,305,124,181,27,25,31,21,137,63,74,20,22,14,6,0
54886,1235,584,651,140,226,82,52,773,389,384,119,91,79,26,0
54887,303,147,156,49,49,20,8,584,249,335,80,96,22,13,0
54888,479,228,251,71,57,60,14,673,313,360,102,101,46,17,0
54889,932,575,357,94,69,76,40,386,181,205,55,51,57,31,0
54890,1463,521,942,252,204,105,52,975,400,575,160,162,62,31,0
54891,275,160,115,40,31,34,17,271,150,121,39,36,37,5,0
54892,410,211,199,55,42,34,27,929,459,470,140,120,94,45,0
54893,204,93,111,35,35,16,11,501,249,252,77,70,55,22,0
54894,369,166,203,59,55,41,14,609,335,274,79,57,45,22,0
54895,315,111,204,82,66,46,11,396,199,197,54,50,45,14,0
54896,1395,595,800,223,206,113,61,485,244,241,80,55,59,20,0
54897,237,127,110,34,30,16,9,192,110,82,33,21,10,3,0
54898,360,175,185,73,36,27,7,225,129,96,32,33,20,8,0
54899,258,144,114,33,22,19,9,106,46,60,27,18,12,3,0
54900,443,250,193,52,23,49,13,862,409,453,149,125,86,29,0
54901,479,228,251,71,57,60,14,609,335,274,79,57,45,22,0
54902,927,457,470,130,99,118,42,339,180,159,36,29,16,16,0
54903,533,300,233,74,50,74,17,395,198,197,55,55,36,10,0
54904,86,50,36,9,14,8,7,54,26,28,11,4,3,3,0
54905,136,66,70,33,11,9,5,380,211,169,47,37,33,21,0
54906,331,165,166,52,34,48,22,507,270,237,89,59,57,22,0
54907,509,246,263,84,71,56,22,289,140,149,33,42,30,15,0
54908,361,171,190,44,40,18,13,370,190,180,60,52,37,13,0
54909,476,276,200,57,34,43,16,1382,508,874,334,320,98,36,0
54910,269,124,145,36,24,32,11,437,221,216,62,64,47,13,0
54911,128,70,58,29,9,8,1,148,69,79,26,18,16,3,0
54912,415,217,198,50,31,42,17,402,186,216,64,47,38,20,0
54913,682,292,390,89,69,58,20,482,232,250,77,81,44,13,0
54914,164,77,87,33,19,6,7,773,389,384,119,91,79,26,0
54915,467,233,234,83,37,77,22,562,273,289,76,92,45,24,0
54916,582,328,254,78,48,35,9,415,203,212,77,44,49,18,0
54917,368,154,214,80,52,41,16,271,150,121,39,36,37,5,0
54918,390,199,191,72,42,35,12,975,400,575,160,162,62,31,0
54919,315,174,141,46,38,47,16,295,160,135,42,37,46,16,0
54920,119,57,62,18,16,17,4,404,177,227,75,68,45,13,0
54921,540,252,288,73,67,57,20,331,180,151,46,35,47,17,0
54922,736,320,416,113,97,61,36,609,335,274,79,57,45,22,0
54923,420,248,172,64,30,43,17,497,227,270,70,63,66,30,0
54924,278,110,168,58,49,29,5,218,111,107,45,29,24,6,0
54925,1336,724,612,209,141,133,60,266,150,116,28,28,24,12,0
54926,626,300,326,91,82,68,26,344,190,154,34,31,36,10,0
54927,257,122,135,44,19,21,16,334,182,152,45,41,27,13,0
54928,301,150,151,45,47,33,13,496,251,245,78,62,61,23,0
54929,406,207,199,56,46,68,19,136,65,71,26,11,7,5,0
54930,886,440,446,116,140,95,45,368,183,185,40,42,40,15,0
54931,416,222,194,58,38,38,20,1321,653,668,186,195,70,35,0
54932,557,250,307,70,47,51,22,1873,935,938,233,225,203,79,0
54933,2000,965,1035,357,313,198,75,601,279,322,81,65,27,12,0
54934,217,98,119,38,35,18,9,405,181,224,71,57,31,12,0
54935,2000,965,1035,357,313,198,75,975,475,500,139,140,119,28,0
54936,919,493,426,100,92,88,49,307,132,175,48,53,26,10,0
54937,438,185,253,71,64,52,28,531,277,254,82,75,33,22,0
54938,1463,521,942,252,204,105,52,562,273,289,76,92,45,24,0
54939,423,247,176,58,55,29,20,531,277,254,82,75,33,22,0
54940,300,136,164,45,35,45,14,452,231,221,74,53,56,20,0
54941,1544,738,806,239,217,145,91,483,287,196,71,50,54,17,0
54942,1064,495,569,157,159,124,58,392,214,178,48,40,53,22,0
54943,717,281,436,165,81,112,49,103,59,44,25,2,13,6,0
54944,502,250,252,70,47,57,15,541,279,262,79,82,31,32,0
54945,123,58,65,22,14,13,3,751,394,357,107,96,73,35,0
54946,437,212,225,66,44,44,11,231,126,105,37,26,29,6,0
54947,349,153,196,54,47,28,13,903,436,467,128,116,83,33,0
54948,730,298,432,128,69,86,26,307,132,175,48,53,26,10,0
54949,349,167,182,54,38,30,28,127,64,63,26,8,12,8,0
54950,242,104,138,41,33,37,8,152,71,81,41,16,14,2,0
54951,76,30,46,7,15,1,5,501,274,227,63,58,53,20,0
54952,255,110,145,34,32,23,17,439,227,212,60,55,58,8,0
54953,167,70,97,32,20,15,7,335,186,149,40,28,29,13,0
54954,117,58,59,17,17,12,2,106,46,60,27,18,12,3,0
54955,316,157,159,45,38,22,19,207,86,121,34,39,11,13,0
54956,330,141,189,65,29,51,19,445,264,181,35,35,34,14,0
54957,379,217,162,47,20,50,23,296,151,145,45,42,32,11,0
54958,1226,513,713,184,147,87,43,386,207,179,43,48,44,19,0
54959,473,265,208,47,26,50,30,403,233,170,38,29,21,14,0
54960,2048,855,1193,297,287,191,93,1352,602,750,166,185,81,70,0
54961,437,212,225,66,44,44,11,286,160,126,37,27,23,10,0
54962,291,120,171,63,39,26,6,188,93,95,33,18,16,10,0
54963,3859,2011,1848,535,391,422,207,457,253,204,67,51,48,13,0
54964,346,173,173,50,56,31,14,660,303,357,97,89,85,33,0
54965,207,93,114,20,33,19,10,601,279,322,81,65,27,12,0
54966,161,99,62,15,22,9,7,497,257,240,71,63,62,16,0
54967,734,339,395,135,89,78,36,242,121,121,39,30,29,10,0
54968,745,402,343,95,71,69,40,107,77,30,7,2,9,5,0
54969,242,111,131,35,35,17,13,514,248,266,86,82,52,22,0
54970,380,187,193,38,51,30,18,271,150,121,39,36,37,5,0
54971,598,322,276,67,57,63,26,295,160,135,44,36,46,16,0
54972,1217,647,570,142,160,129,45,384,204,180,53,47,49,17,0
54973,1711,865,846,204,176,105,60,198,110,88,27,27,24,4,0
54974,138,35,103,38,2,15,9,267,141,126,53,27,23,7,0
54975,1390,585,805,241,230,118,46,1425,670,755,153,189,122,85,0
54976,764,277,487,158,162,64,31,290,147,143,34,34,39,13,0
54977,800,416,384,102,105,83,22,418,223,195,51,45,49,14,0
54978,485,246,239,74,48,47,22,232,111,121,23,29,17,9,0
54979,649,304,345,99,80,67,40,810,310,500,164,162,42,26,0
54980,227,120,107,31,28,28,13,234,116,118,34,35,23,9,0
54981,107,56,51,18,16,12,5,125,66,59,24,16,11,5,0
54982,682,292,390,89,69,58,20,873,411,462,132,107,84,40,0
54983,2174,1057,1117,241,241,214,117,240,141,99,34,28,29,8,0
54984,401,236,165,53,38,34,9,319,185,134,42,31,22,13,0
54985,451,278,173,71,35,58,12,403,233,170,38,29,21,14,0
54986,559,217,342,105,86,42,16,260,133,127,43,32,39,3,0
54987,260,138,122,44,30,28,6,173,86,87,30,22,19,12,0
54988,299,128,171,57,40,13,25,1382,508,874,334,320,98,36,0
54989,130,70,60,30,9,8,1,389,210,179,51,37,43,9,0
54990,489,253,236,73,36,62,17,166,90,76,27,18,21,5,0
54991,279,106,173,48,35,41,39,520,240,280,67,72,42,14,0
54992,755,271,484,113,226,61,20,395,198,197,55,55,36,10,0
54993,226,120,106,68,8,2,1,773,389,384,119,91,79,26,0
54994,446,265,181,51,35,27,17,644,343,301,96,69,59,28,0
54995,919,444,475,141,148,62,20,203,98,105,34,29,19,10,0
54996,125,57,68,31,10,10,3,87,38,49,23,10,10,9,0
54997,911,445,466,154,121,108,48,68,36,32,11,8,9,2,0
54998,1711,865,846,204,176,105,60,756,348,408,101,103,60,40,0
54999,203,80,123,40,37,20,3,374,212,162,48,40,32,23,0
55000,1501,679,822,251,196,174,67,649,307,342,71,134,45,17,0
55001,550,304,246,60,64,77,16,306,157,149,52,35,39,16,0
55002,346,209,137,46,37,44,10,620,324,296,81,68,66,31,0
55003,51,10,41,25,0,5,8,660,303,357,97,89,85,33,0
55004,1616,735,881,285,248,153,72,222,122,100,39,32,24,9,0
55005,285,148,137,31,42,42,16,430,212,218,88,43,40,20,0
55006,399,196,203,62,45,38,19,386,207,179,43,48,44,19,0
55007,530,259,271,83,50,54,41,452,231,221,74,53,56,20,0
55008,496,210,286,112,55,71,14,133,61,72,21,19,13,4,0
55009,519,245,274,58,61,34,22,434,213,221,77,62,53,12,0
55010,1590,726,864,270,237,126,59,198,86,112,36,27,23,9,0
55011,756,265,491,129,127,51,17,277,145,132,41,32,22,10,0
55012,526,228,298,69,64,32,30,708,328,380,113,100,82,34,0
55013,640,308,332,91,102,49,21,222,125,97,34,27,27,7,0
55014,240,166,74,32,12,8,15,627,289,338,101,73,62,43,0
55015,531,284,247,66,42,49,15,517,295,222,69,62,40,28,0
55016,407,230,177,44,39,34,19,180,89,91,28,27,18,7,0
55017,1098,519,579,182,159,79,42,783,406,377,102,91,57,29,0
55018,490,198,292,65,81,39,27,227,130,97,32,25,22,12,0
55019,272,141,131,45,29,36,9,201,99,102,34,26,23,6,0
55020,484,194,290,70,93,47,16,1113,480,633,170,173,81,34,0
55021,510,288,222,44,36,24,7,165,90,75,36,18,20,6,0
55022,1186,495,691,182,208,88,32,1248,584,664,184,164,155,67,0
55023,443,206,237,76,68,52,28,629,317,312,80,87,51,22,0
55024,490,224,266,80,70,39,32,173,86,87,30,22,19,12,0
55025,90,54,36,20,4,14,5,207,114,93,33,20,31,13,0
55026,330,77,253,86,52,20,12,132,61,71,22,21,15,3,0
55027,328,156,172,44,37,44,15,751,394,357,107,96,73,35,0
55028,240,167,73,32,12,8,21,218,111,107,45,29,24,6,0
55029,335,148,187,52,26,51,12,452,252,200,55,49,61,16,0
55030,1171,542,629,170,146,114,64,929,459,470,140,120,94,45,0
55031,142,60,82,20,28,13,5,1047,562,485,141,127,114,41,0
55032,252,121,131,42,34,12,16,434,213,221,77,62,53,12,0
55033,915,336,579,185,199,56,29,536,222,314,101,100,34,22,0
55034,437,228,209,47,61,26,11,328,195,133,39,40,27,13,0
55035,649,304,345,99,80,67,40,322,180,142,45,38,28,7,0
55036,752,313,439,121,106,68,27,679,338,341,96,95,40,23,0
55037,319,222,97,36,23,28,8,467,231,236,71,65,58,18,0
55038,646,304,342,104,93,58,26,165,90,75,36,18,20,6,0
55039,76,42,34,12,8,5,7,368,204,164,43,35,30,24,0
55040,126,56,70,31,10,10,3,1230,644,586,198,125,123,61,0
55041,949,467,482,126,127,102,51,751,394,357,107,96,73,35,0
55042,539,283,256,75,73,53,26,414,203,211,58,56,48,14,0
55043,211,92,119,33,44,11,7,331,180,151,46,35,47,17,0
55044,262,133,129,44,38,31,12,403,221,182,62,50,42,12,0
55045,508,267,241,43,35,25,17,165,90,75,36,18,20,6,0
55046,1555,702,853,250,199,139,31,701,380,321,94,84,96,34,0
55047,1556,718,838,280,182,161,49,366,204,162,47,41,31,23,0
55048,743,377,366,87,74,68,30,858,398,460,126,138,75,39,0
55049,904,436,468,138,146,82,39,699,334,365,108,80,70,20,0
55050,1105,544,561,165,167,99,40,201,104,97,36,32,24,7,0
55051,227,109,118,42,35,29,8,374,202,172,50,39,31,24,0
55052,362,174,188,46,55,35,23,244,143,101,31,29,26,8,0
55053,297,161,136,36,35,24,9,222,125,97,34,27,27,7,0
55054,467,233,234,83,37,77,22,200,99,101,31,24,26,6,0
55055,763,354,409,101,90,63,26,326,149,177,51,51,28,10,0
55056,813,412,401,114,93,112,26,406,234,172,63,35,43,10,0
55057,279,127,152,50,36,28,8,480,255,225,67,64,50,22,0
55058,956,450,506,122,117,82,36,270,130,140,48,44,37,12,0
55059,413,236,177,41,25,35,19,325,172,153,44,34,27,14,0
55060,403,176,227,71,56,51,11,352,207,145,40,33,25,21,0
55061,772,417,355,118,92,80,23,536,251,285,75,79,60,23,0
55062,330,151,179,68,36,56,9,338,169,169,53,44,39,21,0
55063,616,323,293,98,71,31,15,232,111,121,23,29,17,9,0
55064,326,176,150,35,22,29,11,528,276,252,86,78,49,17,0
55065,446,283,163,51,26,33,19,535,288,247,79,72,35,21,0
55066,583,279,304,99,71,59,31,283,142,141,41,33,26,18,0
55067,2649,1431,1218,377,299,266,102,331,180,151,46,35,47,17,0
55068,607,305,302,92,89,74,23,123,61,62,17,18,17,7,0
55069,531,284,247,66,42,49,15,274,157,117,40,29,40,8,0
55070,496,210,286,111,55,74,13,132,77,55,20,9,13,10,0
55071,879,457,422,93,98,143,32,158,71,87,23,21,17,12,0
55072,378,202,176,34,32,44,13,455,191,264,68,86,21,19,0
55073,286,111,175,51,47,21,12,562,273,289,76,92,45,24,0
55074,764,277,487,158,162,64,31,241,127,114,34,33,29,12,0
55075,149,68,81,15,38,11,10,559,317,242,58,65,37,23,0
55076,474,243,231,66,54,41,29,334,181,153,56,31,28,18,0
55077,401,204,197,49,33,29,17,277,152,125,31,35,22,19,0
55078,1058,497,561,194,142,87,63,1314,693,621,174,155,140,58,0
55079,1030,438,592,184,104,108,30,583,321,262,73,67,45,25,0
55080,743,366,377,41,37,26,14,180,115,65,17,12,9,9,0
55081,438,185,253,71,64,52,28,218,115,103,32,32,34,11,0
55082,478,177,301,109,66,59,25,536,267,269,60,70,41,22,0
55083,785,374,411,56,42,38,25,430,212,218,88,43,40,20,0
55084,130,72,58,28,9,7,1,312,165,147,41,39,29,16,0
55085,331,144,187,57,46,33,19,392,186,206,62,56,29,15,0
55086,1718,735,983,266,225,130,68,88,50,38,13,8,16,4,0
55087,1759,838,921,269,212,191,92,257,139,118,64,17,24,7,0
55088,181,75,106,35,26,11,9,298,129,169,51,40,29,8,0
55089,619,289,330,67,77,36,19,943,463,480,91,144,70,30,0
55090,260,136,124,24,41,19,4,175,91,84,19,21,21,10,0
55091,2279,996,1283,375,328,158,60,258,129,129,45,24,31,10,0
55092,746,312,434,129,115,77,47,260,131,129,42,31,40,9,0
55093,398,186,212,76,70,18,13,415,205,210,77,52,55,17,0
55094,242,104,138,41,33,37,8,231,126,105,37,26,29,6,0
55095,434,216,218,72,58,40,20,285,146,139,41,41,48,13,0
55096,528,273,255,67,53,29,20,1241,619,622,183,169,155,59,0
55097,350,178,172,49,62,29,16,130,67,63,24,10,12,4,0
55098,273,126,147,54,49,25,18,200,89,111,26,25,17,7,0
55099,561,282,279,68,62,36,14,403,185,218,67,62,63,19,0
55100,860,349,511,166,166,58,19,403,221,182,62,50,42,12,0
55101,929,410,519,187,146,53,30,582,264,318,84,60,58,23,0
55102,535,217,318,87,106,41,14,322,180,142,45,38,28,7,0
55103,654,344,310,80,69,57,15,629,317,312,80,87,51,22,0
55104,853,400,453,137,109,88,42,256,141,115,32,22,32,8,0
55105,666,204,462,110,194,42,14,1040,564,476,134,110,114,51,0
55106,288,140,148,59,33,27,12,198,113,85,19,20,26,12,0
55107,509,251,258,69,49,55,17,1507,737,770,188,228,147,71,0
55108,1221,597,624,201,152,83,31,564,264,300,79,84,65,26,0
55109,303,175,128,43,36,34,12,711,330,381,111,86,86,34,0
55110,251,131,120,49,35,25,5,555,282,273,82,69,65,21,0
55111,165,66,99,28,32,16,3,303,137,166,54,54,31,15,0
55112,492,253,239,73,67,77,29,149,52,97,36,36,7,4,0
55113,392,221,171,53,30,25,8,218,111,107,45,29,24,6,0
55114,852,461,391,109,102,72,24,660,332,328,84,73,47,19,0
55115,202,103,99,28,20,12,8,322,180,142,45,38,28,7,0
55116,288,142,146,52,32,26,8,286,160,126,37,27,23,10,0
55117,1214,612,602,169,173,98,35,252,130,122,45,23,32,11,0
55118,407,164,243,88,42,40,22,485,244,241,80,55,59,20,0
55119,264,122,142,46,24,35,10,902,499,403,118,117,92,35,0
55120,389,176,213,81,59,24,7,723,363,360,107,106,52,14,0
55121,242,104,138,41,33,37,8,334,182,152,45,41,27,13,0
55122,338,208,130,39,30,35,12,501,249,252,77,70,55,22,0
55123,521,249,272,53,36,50,18,132,67,65,24,21,8,10,0
55124,485,246,239,74,48,47,22,368,204,164,43,35,30,24,0
55125,441,216,225,57,66,57,19,246,125,121,38,36,30,11,0
55126,392,221,171,53,30,25,8,1061,543,518,146,123,109,67,0
55127,795,384,411,133,109,85,38,225,129,96,32,33,20,8,0
55128,166,59,107,36,41,10,4,73,35,38,14,10,9,4,0
55129,422,196,226,52,35,33,20,240,141,99,34,28,29,8,0
55130,707,250,457,171,84,117,61,381,187,194,37,49,36,17,0
55131,507,242,265,53,44,31,22,516,245,271,82,84,70,26,0
55132,413,236,177,41,25,35,19,392,214,178,48,40,53,22,0
55133,328,195,133,36,23,35,9,375,211,164,50,36,31,23,0
55134,57,24,33,11,3,5,3,305,163,142,38,27,47,11,0
55135,531,259,272,75,81,39,13,474,268,206,66,42,45,24,0
55136,2488,1085,1403,346,253,162,76,531,277,254,82,75,33,22,0
55137,414,206,208,56,68,35,19,105,51,54,13,17,12,8,0
55138,335,155,180,64,48,36,10,463,268,195,59,46,46,21,0
55139,422,207,215,79,38,53,23,188,88,100,53,12,15,6,0
55140,730,298,432,128,69,86,26,344,190,154,34,31,36,10,0
55141,204,103,101,16,32,22,8,242,124,118,39,32,28,22,0
55142,595,208,387,157,60,91,48,201,104,97,36,32,24,7,0
55143,631,304,327,98,75,52,23,328,195,133,39,40,27,13,0
55144,1849,931,918,245,220,158,90,314,177,137,34,40,29,9,0
55145,431,216,215,46,40,33,9,519,287,232,68,58,45,21,0
55146,1342,640,702,187,163,123,57,557,281,276,80,59,43,21,0
55147,234,108,126,42,40,15,9,242,124,118,39,32,28,22,0
55148,1395,595,800,223,206,113,61,453,255,198,62,49,29,19,0
55149,527,276,251,64,60,70,20,439,231,208,65,51,55,17,0
55150,594,248,346,104,109,53,5,429,187,242,79,72,28,19,0
55151,833,295,538,146,139,65,34,535,301,234,63,48,47,27,0
55152,282,105,177,77,28,39,6,514,248,266,86,82,52,22,0
55153,784,351,433,118,87,73,41,811,361,450,124,107,80,31,0
55154,726,312,414,121,73,82,23,277,152,125,31,35,22,19,0
55155,219,116,103,66,7,2,1,1001,417,584,186,147,96,47,0
55156,122,56,66,26,13,11,5,164,79,85,28,28,16,7,0
55157,414,206,208,56,68,35,19,395,198,197,55,55,36,10,0
55158,521,249,272,53,36,50,18,727,388,339,102,87,70,29,0
55159,1001,422,579,185,180,51,32,266,150,116,28,28,24,12,0
55160,560,279,281,113,64,58,15,699,334,365,108,80,70,20,0
55161,1054,453,601,183,183,107,35,153,80,73,26,18,19,4,0
55162,213,88,125,21,54,14,15,132,61,71,22,21,15,3,0
55163,98,32,66,15,25,5,4,395,198,197,55,55,36,10,0
55164,2063,1024,1039,175,117,80,97,699,334,365,108,80,70,20,0
55165,440,267,173,52,29,42,12,723,353,370,120,109,96,33,0
55166,280,156,124,36,19,20,13,241,127,114,34,33,29,12,0
55167,329,171,158,49,41,31,10,200,89,111,26,25,17,7,0
55168,536,237,299,116,87,42,17,166,102,64,19,14,17,2,0
55169,339,118,221,77,68,33,13,173,94,79,18,24,12,7,0
55170,207,89,118,56,8,4,3,1543,794,749,182,152,132,55,0
55171,949,467,482,126,127,102,51,778,391,387,94,77,41,33,0
55172,364,204,160,65,35,15,13,572,305,267,74,72,58,21,0
55173,1531,649,882,108,122,93,72,1230,644,586,198,125,123,61,0
55174,756,265,491,129,127,51,17,257,139,118,64,17,24,7,0
55175,582,328,254,78,48,35,9,415,226,189,51,40,40,29,0
55176,163,70,93,28,21,17,6,295,160,135,42,37,46,16,0
55177,583,279,304,99,71,59,31,480,255,225,67,64,50,22,0
55178,360,175,185,73,36,27,7,89,51,38,15,15,5,4,0
55179,507,314,193,49,45,59,25,773,389,384,119,91,79,26,0
55180,752,313,439,121,106,68,27,381,187,194,37,49,36,17,0
55181,580,240,340,108,81,59,22,308,146,162,42,39,24,12,0
55182,340,145,195,46,38,26,23,463,259,204,62,55,34,22,0
55183,238,158,80,28,15,31,7,349,200,149,41,39,30,20,0
55184,154,74,80,18,19,7,2,381,196,185,55,57,43,16,0
55185,401,183,218,72,73,28,10,209,119,90,28,24,27,9,0
55186,179,78,101,29,22,10,8,375,210,165,49,37,29,27,0
55187,338,208,130,39,30,35,12,453,255,198,62,49,29,19,0
55188,443,206,237,76,68,52,28,205,94,111,48,31,15,6,0
55189,282,160,122,36,28,27,7,231,126,105,28,26,34,9,0
55190,1327,520,807,241,174,141,60,557,281,276,80,59,43,21,0
55191,368,201,167,61,38,38,12,332,155,177,55,51,44,13,0
55192,222,110,112,43,30,14,6,452,231,221,74,53,56,20,0
55193,304,149,155,46,32,39,14,715,348,367,109,84,68,30,0
55194,928,442,486,139,118,91,43,229,120,109,31,30,22,9,0
55195,1054,453,601,183,183,107,35,305,163,142,38,27,47,11,0
55196,123,58,65,22,14,13,3,178,69,109,29,25,21,13,0
55197,308,129,179,44,60,19,8,256,141,115,32,22,32,8,0
55198,575,305,270,74,87,73,25,370,190,180,60,52,37,13,0
55199,243,100,143,58,50,24,5,584,249,335,80,96,22,13,0
55200,3859,2011,1848,535,391,422,207,1214,475,739,177,250,89,49,0
55201,415,133,282,114,65,27,7,349,200,149,41,39,30,20,0
55202,646,304,342,104,93,58,26,348,212,136,53,31,25,18,0
55203,335,148,187,52,26,51,12,501,257,244,75,57,48,29,0
55204,2414,1189,1225,277,178,170,169,445,202,243,70,73,51,15,0
55205,898,397,501,102,98,54,37,319,185,134,42,31,22,13,0
55206,900,434,466,134,97,86,36,105,51,54,13,17,12,8,0
55207,465,305,160,40,47,34,9,410,197,213,67,43,56,18,0
55208,417,176,241,75,61,51,20,134,55,79,22,24,16,6,0
55209,739,389,350,129,61,69,25,720,361,359,98,98,70,37,0
55210,172,82,90,21,35,21,5,289,140,149,33,42,30,15,0
55211,275,160,115,40,31,34,17,175,91,84,19,21,21,10,0
55212,522,302,220,61,49,75,19,1113,480,633,170,173,81,34,0
55213,508,251,257,74,53,51,18,354,188,166,46,40,34,10,0
55214,2285,1219,1066,207,180,178,106,366,204,162,47,41,31,23,0
55215,522,251,271,87,68,60,21,972,501,471,125,156,106,39,0
55216,158,85,73,24,18,18,8,295,156,139,41,40,42,15,0
55217,1214,498,716,197,180,121,65,749,384,365,108,105,86,31,0
55218,99,35,64,25,18,0,1,1352,602,750,166,185,81,70,0
55219,213,114,99,62,7,2,1,925,439,486,141,134,105,46,0
55220,411,236,175,39,45,50,30,528,276,252,86,78,49,17,0
55221,664,269,395,117,107,36,15,389,210,179,51,37,43,9,0
55222,781,316,465,130,129,65,23,317,161,156,40,49,41,11,0
55223,282,84,198,60,102,1,6,600,254,346,104,100,44,17,0
55224,911,445,466,154,121,108,48,403,221,182,62,50,42,12,0
55225,271,110,161,33,27,11,8,439,231,208,65,51,55,17,0
55226,1249,543,706,187,164,125,52,198,115,83,30,22,8,8,0
55227,381,187,194,37,49,36,17,528,188,340,130,58,77,41,0
55228,473,265,208,47,26,50,30,405,195,210,57,74,24,17,0
55229,366,190,176,39,62,55,14,2225,1244,981,271,243,217,93,0
55230,230,114,116,30,33,29,8,508,253,255,73,60,50,13,0
55231,302,160,142,35,35,37,10,303,138,165,47,46,35,18,0
55232,451,225,226,69,57,64,22,748,359,389,125,113,86,31,0
55233,1342,640,702,187,163,123,57,741,383,358,92,63,79,36,0
55234,567,256,311,91,81,53,17,360,180,180,57,48,39,12,0
55235,435,187,248,62,51,51,21,152,71,81,41,16,14,2,0
55236,622,354,268,89,60,64,18,386,207,179,43,48,44,19,0
55237,415,133,282,114,65,27,7,1507,737,770,188,228,147,71,0
55238,2624,999,1625,415,495,109,84,662,373,289,89,80,77,29,0
55239,524,361,163,41,8,28,16,403,184,219,75,51,47,20,0
55240,692,305,387,100,97,78,30,1239,659,580,169,148,131,54,0
55241,763,354,409,101,90,63,26,393,210,183,58,37,34,20,0
55242,452,202,250,83,60,56,19,72,32,40,8,2,1,14,0
55243,484,192,292,118,68,83,22,594,312,282,72,67,73,31,0
55244,559,217,342,105,86,42,16,201,99,102,34,26,23,6,0
55245,412,193,219,69,57,43,14,198,110,88,27,27,24,4,0
55246,410,188,222,53,52,31,14,326,149,177,51,51,28,10,0
55247,443,226,217,67,34,53,10,152,71,81,41,16,14,2,0
55248,210,101,109,33,33,19,9,555,292,263,75,63,67,27,0
55249,2236,1195,1041,227,187,186,118,475,251,224,67,49,48,23,0
55250,474,250,224,58,47,37,12,294,146,148,50,45,51,15,0
55251,238,91,147,68,19,22,7,153,65,88,28,21,20,8,0
55252,435,225,210,58,46,50,14,710,375,335,95,94,110,28,0
55253,130,72,58,28,9,7,1,906,455,451,116,105,87,46,0
55254,1054,453,601,183,183,107,35,336,200,136,34,29,25,24,0
55255,213,104,109,56,14,9,2,389,210,179,51,37,43,9,0
55256,1085,646,439,108,65,36,19,1352,602,750,166,185,81,70,0
55257,1098,519,579,182,159,79,42,769,329,440,116,66,55,22,0
55258,432,190,242,85,82,28,11,323,171,152,48,41,40,16,0
55259,339,170,169,32,17,24,13,1101,626,475,145,122,120,50,0
55260,684,353,331,95,98,77,38,276,149,127,34,31,32,10,0
55261,489,253,236,73,36,62,17,483,215,268,66,70,30,16,0
55262,469,221,248,49,60,55,21,974,457,517,133,117,69,26,0
55263,117,58,59,17,17,12,2,1382,508,874,334,320,98,36,0
55264,508,267,241,43,35,25,17,366,204,162,47,41,31,23,0
55265,371,209,162,46,17,36,19,671,321,350,95,87,75,34,0
55266,244,104,140,52,31,30,14,4646,2328,2318,674,639,475,170,0
55267,139,64,75,18,17,18,4,947,482,465,143,107,89,37,0
55268,402,169,233,70,36,34,18,903,436,467,128,116,83,33,0
55269,364,168,196,64,61,27,6,262,129,133,40,41,31,10,0
55270,700,305,395,111,99,54,18,285,143,142,45,32,21,17,0
55271,325,181,144,46,31,48,9,846,425,421,125,97,98,38,0
55272,510,288,222,44,36,24,7,274,157,117,40,29,40,8,0
55273,305,124,181,27,25,31,21,429,187,242,79,72,28,19,0
55274,443,226,217,67,34,53,10,367,199,168,62,44,34,8,0
55275,648,376,272,70,60,73,24,594,312,282,72,67,73,31,0
55276,584,297,287,89,80,65,17,396,223,173,57,37,44,19,0
55277,221,75,146,68,21,16,5,131,55,76,28,9,14,12,0
55278,710,352,358,104,86,84,41,415,189,226,68,54,50,21,0
55279,219,98,121,43,19,11,7,240,99,141,53,38,29,15,0
55280,361,174,187,63,56,38,16,437,190,247,82,66,39,20,0
55281,167,70,97,32,20,15,7,218,115,103,37,33,33,9,0
55282,579,321,258,74,70,47,22,413,223,190,52,45,53,10,0
55283,395,195,200,41,55,23,10,323,162,161,52,41,39,13,0
55284,1257,464,793,221,264,75,37,164,79,85,28,28,16,7,0
55285,410,188,222,53,52,31,14,279,161,118,37,32,7,7,0
55286,126,57,69,31,10,10,3,509,267,242,79,81,38,20,0
55287,384,198,186,58,48,37,12,266,146,120,41,28,31,7,0
55288,299,128,171,57,40,13,25,72,32,40,8,2,2,13,0
55289,615,308,307,83,75,58,32,164,79,85,28,28,16,7,0
55290,728,358,370,118,100,55,29,974,457,517,133,117,69,26,0
55291,240,166,74,32,12,8,15,1425,670,755,153,189,122,85,0
55292,206,96,110,33,25,8,6,425,177,248,60,62,33,16,0
55293,83,45,38,11,8,8,3,1214,475,739,177,250,89,49,0
55294,586,309,277,81,64,76,25,300,171,129,45,35,20,13,0
55295,349,153,196,54,47,28,13,292,155,137,50,34,29,13,0
55296,203,80,123,40,37,20,3,478,254,224,67,74,56,28,0
55297,399,220,179,48,37,68,18,518,292,226,60,60,52,21,0
55298,111,29,82,10,54,0,1,818,357,461,122,136,54,25,0
55299,474,250,224,58,47,37,12,1239,659,580,169,148,131,54,0
55300,260,120,140,34,39,36,12,400,187,213,56,59,42,20,0
55301,411,211,200,61,46,35,18,229,120,109,31,30,22,9,0
55302,640,271,369,111,79,57,17,309,164,145,35,47,30,11,0
55303,496,272,224,70,58,42,18,1062,522,540,151,147,105,66,0
55304,772,417,355,118,92,80,23,103,44,59,16,17,9,5,0
55305,763,371,392,104,88,52,23,756,348,408,101,103,60,40,0
55306,1912,880,1032,331,334,180,84,778,391,387,94,77,41,33,0
55307,434,216,218,72,58,40,20,188,93,95,33,18,16,10,0
55308,649,304,345,99,80,67,40,149,77,72,37,10,20,5,0
55309,594,248,346,104,109,53,5,341,170,171,41,66,27,10,0
55310,308,163,145,38,33,30,20,336,200,136,34,29,25,24,0
55311,726,312,414,121,73,82,23,496,251,245,78,62,61,23,0
55312,1556,718,838,280,182,161,49,935,515,420,126,107,73,32,0
55313,972,501,471,125,156,106,39,137,85,52,15,11,11,2,0
55314,1441,504,937,264,329,69,46,277,138,139,40,39,20,14,0
55315,546,265,281,101,64,38,16,283,160,123,25,20,37,9,0
55316,562,214,348,120,86,69,42,422,202,220,80,52,57,18,0
55317,251,131,120,49,35,25,5,135,65,70,21,25,15,9,0
55318,255,126,129,41,37,13,5,415,203,212,77,44,49,18,0
55319,291,142,149,50,29,35,7,514,262,252,78,58,54,26,0
55320,1711,865,846,204,176,105,60,175,91,84,19,21,21,10,0
55321,485,246,239,74,48,47,22,551,226,325,96,103,43,11,0
55322,128,67,61,29,9,9,1,535,311,224,66,52,49,24,0
55323,251,131,120,49,35,25,5,103,44,59,16,17,9,5,0
55324,1341,481,860,275,264,57,21,250,119,131,58,26,29,7,0
55325,333,171,162,41,44,48,23,483,215,268,66,70,30,16,0
55326,242,111,131,35,35,17,13,723,363,360,107,106,52,14,0
55327,457,228,229,64,36,52,21,374,212,162,48,40,32,23,0
55328,270,147,123,34,17,39,21,439,227,212,60,55,58,8,0
55329,983,449,534,95,77,55,36,866,397,469,117,153,95,48,0
55330,341,183,158,36,34,36,15,137,72,65,27,13,15,8,0
55331,164,61,103,47,19,14,5,541,279,262,79,82,31,32,0
55332,582,328,254,78,48,35,9,633,311,322,94,82,45,20,0
55333,747,469,278,60,41,53,23,149,52,97,36,36,7,4,0
55334,346,173,173,50,56,31,14,1249,638,611,166,153,141,45,0
55335,734,339,395,135,89,78,36,260,131,129,42,31,40,9,0
55336,449,179,270,80,77,49,29,862,409,453,149,125,86,29,0
55337,588,267,321,99,79,87,28,323,171,152,48,41,40,16,0
55338,636,288,348,94,77,65,30,325,159,166,59,46,30,12,0
55339,1226,513,713,184,147,87,43,630,321,309,86,90,57,26,0
55340,437,167,270,126,95,34,10,455,191,264,68,86,21,19,0
55341,291,131,160,49,35,32,15,145,77,68,26,7,15,8,0
55342,1220,575,645,208,179,99,56,246,107,139,55,33,27,11,0
55343,462,233,229,66,49,43,30,1873,935,938,233,225,203,79,0
55344,1365,590,775,257,168,136,93,127,64,63,26,8,12,8,0
55345,265,165,100,32,19,27,5,277,124,153,44,40,35,18,0
55346,325,186,139,49,36,20,5,207,114,93,33,20,31,13,0
55347,199,113,86,27,17,10,7,485,244,241,80,55,59,20,0
55348,437,167,270,126,95,34,10,437,224,213,40,29,42,25,0
55349,911,489,422,121,98,97,36,474,268,206,66,42,45,24,0
55350,582,328,254,78,48,35,9,225,114,111,32,29,26,6,0
55351,275,160,115,40,31,34,17,690,345,345,96,83,73,42,0
55352,242,111,131,35,35,17,13,526,266,260,76,75,53,22,0
55353,1030,438,592,184,104,108,30,180,89,91,28,27,18,7,0
55354,213,104,109,56,14,9,2,403,233,170,38,29,21,14,0
55355,340,169,171,40,39,36,22,364,192,172,49,36,39,14,0
55356,329,168,161,48,34,41,16,132,61,71,22,21,15,3,0
55357,496,210,286,112,55,72,13,376,189,187,47,53,44,26,0
55358,1174,594,580,175,155,126,66,593,289,304,85,69,48,19,0
55359,443,226,217,67,34,53,10,673,313,360,102,101,46,17,0
55360,2286,1154,1132,338,314,278,103,649,307,342,71,134,45,17,0
55361,218,133,85,20,19,13,6,555,292,263,75,63,67,27,0
55362,338,172,166,59,30,39,18,325,159,166,59,46,30,12,0
55363,416,207,209,63,47,56,15,283,160,123,25,20,37,9,0
55364,473,265,208,47,26,50,30,225,114,111,32,29,26,6,0
55365,411,171,240,61,81,30,15,125,66,59,24,16,11,5,0
55366,532,254,278,91,48,23,17,175,91,84,19,21,21,10,0
55367,230,114,116,30,33,29,8,260,133,127,43,32,39,3,0
55368,648,262,386,113,108,78,29,325,172,153,44,34,27,14,0
55369,711,330,381,111,86,86,34,662,373,289,89,80,77,29,0
55370,83,45,38,11,8,8,3,296,140,156,49,40,42,19,0
55371,598,322,276,67,57,63,26,536,222,314,101,100,34,22,0
55372,349,167,182,54,38,30,28,160,60,100,23,40,19,11,0
55373,438,185,253,71,64,52,28,375,210,165,49,37,29,27,0
55374,640,271,369,111,79,57,17,173,94,79,18,24,12,7,0
55375,410,208,202,59,58,43,26,943,463,480,91,144,70,30,0
55376,485,246,239,74,48,47,22,375,211,164,50,36,31,23,0
55377,2696,1169,1527,432,347,193,146,445,264,181,35,35,34,14,0
55378,298,141,157,51,33,21,22,180,90,90,31,19,20,8,0
55379,136,66,70,33,11,9,4,516,245,271,82,84,70,26,0
55380,347,198,149,45,29,29,8,780,337,443,112,116,77,28,0
55381,1709,650,1059,338,286,185,46,482,232,250,77,81,44,13,0
55382,333,171,162,41,44,48,23,818,357,461,122,136,54,25,0
55383,143,81,62,28,9,8,1,389,207,182,53,58,52,18,0
55384,413,169,244,66,94,28,19,326,149,177,51,51,28,10,0
55385,122,56,66,26,13,11,5,163,79,84,22,24,13,5,0
55386,692,305,387,100,97,78,30,557,281,276,80,59,43,21,0
55387,429,238,191,47,49,56,29,663,360,303,87,82,80,35,0
55388,651,357,294,81,67,103,18,149,52,97,36,36,7,4,0
55389,1439,713,726,195,180,110,34,387,193,194,60,53,57,15,0
55390,533,297,236,74,57,39,28,582,264,318,84,60,58,23,0
55391,340,181,159,44,39,35,21,588,286,302,78,99,53,25,0
55392,349,167,182,54,38,30,28,1061,543,518,146,123,109,67,0
55393,722,390,332,125,69,67,25,390,190,200,66,50,43,12,0
55394,269,124,145,36,24,32,11,277,152,125,31,35,22,19,0
55395,521,289,232,71,58,49,16,509,267,242,79,81,38,20,0
55396,739,389,350,129,61,69,25,277,163,114,33,24,21,16,0
55397,193,95,98,33,17,25,17,354,183,171,54,43,49,8,0
55398,449,179,270,80,77,49,29,192,91,101,29,28,17,7,0
55399,911,445,466,154,121,108,48,290,147,143,34,34,39,13,0
55400,747,469,278,60,41,53,23,811,361,450,124,107,80,31,0
55401,325,152,173,43,47,28,17,207,113,94,33,18,30,9,0
55402,734,366,368,121,99,63,39,708,328,380,113,100,82,34,0
55403,202,113,89,16,27,21,11,497,257,240,71,63,62,16,0
55404,2286,1154,1132,338,314,278,103,445,202,243,70,73,51,15,0
55405,588,267,321,99,79,87,28,673,313,360,102,101,46,17,0
55406,1098,519,579,182,159,79,42,889,505,384,107,97,99,30,0
55407,172,82,90,21,35,21,5,87,51,35,15,9,9,4,0
55408,341,177,164,57,42,40,18,330,166,164,55,51,36,16,0
55409,525,302,223,56,48,67,19,729,358,371,116,99,89,33,0
55410,1499,864,635,141,99,76,110,360,185,175,51,43,36,16,0
55411,178,87,91,20,32,13,10,415,203,212,77,44,49,18,0
55412,598,300,298,68,77,59,21,1323,690,633,132,178,112,61,0
55413,213,104,109,56,14,9,2,334,182,152,45,41,27,13,0
55414,1464,693,771,153,136,91,86,1338,720,618,179,145,141,85,0
55415,367,167,200,63,42,60,17,218,117,101,35,32,34,12,0
55416,122,56,66,26,13,11,5,455,229,226,66,62,63,29,0
55417,2442,1193,1249,278,183,170,145,449,252,197,61,52,36,18,0
55418,255,110,145,34,32,23,17,1004,457,547,150,150,74,52,0
55419,532,291,241,83,36,79,25,207,86,121,34,39,11,13,0
55420,437,230,207,41,55,27,13,360,180,180,57,48,39,12,0
55421,429,227,202,49,51,46,26,133,61,72,21,19,13,4,0
55422,413,206,207,38,55,19,10,483,287,196,71,50,54,17,0
55423,1226,513,713,184,147,87,43,737,397,340,87,104,90,14,0
55424,730,298,432,128,69,86,26,843,391,452,139,104,91,35,0
55425,218,133,85,20,19,13,6,314,151,163,42,61,39,16,0
55426,335,171,164,51,38,38,10,204,96,108,31,37,20,5,0
55427,115,62,53,13,10,9,7,715,348,367,109,84,68,30,0
55428,531,284,247,66,42,49,15,228,130,98,35,29,30,10,0
55429,1007,353,654,277,147,70,26,325,172,153,44,34,27,14,0
55430,1121,458,663,158,210,76,47,169,85,84,21,14,9,9,0
55431,335,155,180,64,48,36,10,1020,538,482,145,115,111,58,0
55432,90,54,36,20,4,14,5,222,127,95,23,28,22,7,0
55433,291,142,149,50,29,35,7,689,343,346,105,102,81,35,0
55434,282,84,198,60,102,1,6,200,99,101,31,24,26,6,0
55435,240,99,141,53,38,29,15,102,51,51,12,15,12,3,0
55436,390,199,191,72,42,35,12,663,360,303,87,82,80,35,0
55437,213,104,109,56,14,9,2,396,199,197,54,50,45,14,0
55438,161,75,86,24,20,10,7,242,124,118,39,32,28,22,0
55439,188,84,104,35,36,18,9,283,142,141,41,33,26,18,0
55440,426,196,230,76,65,54,20,1004,457,547,150,150,74,52,0
55441,443,226,217,67,34,53,10,627,323,304,81,90,53,27,0
55442,462,233,229,66,49,43,30,334,181,153,56,31,28,18,0
55443,130,71,59,30,9,8,2,1248,584,664,184,164,155,67,0
55444,243,70,173,54,65,8,6,368,200,168,54,49,43,9,0
55445,1849,931,918,245,220,158,90,266,146,120,41,28,31,7,0
55446,256,152,104,18,23,23,8,303,138,165,47,46,35,18,0
55447,873,366,507,127,125,75,21,180,90,90,31,19,20,8,0
55448,436,209,227,66,47,52,22,153,80,73,26,18,19,4,0
55449,260,120,140,34,39,36,12,531,261,270,73,80,68,26,0
55450,1542,682,860,290,158,120,47,474,268,206,66,42,45,24,0
55451,236,120,116,32,28,21,11,2517,1275,1242,304,324,245,135,0
55452,919,493,426,100,92,88,49,497,227,270,70,63,66,30,0
55453,535,217,318,87,106,41,14,136,65,71,26,11,7,5,0
55454,261,137,124,34,23,13,8,274,142,132,33,34,18,14,0
55455,202,113,89,16,27,21,11,538,274,264,84,67,52,35,0
55456,536,287,249,64,73,21,27,283,142,141,41,33,26,18,0
55457,161,94,67,23,13,8,10,598,333,265,79,66,54,33,0
55458,267,146,121,40,24,25,7,204,96,108,31,37,20,5,0
55459,379,217,162,47,20,50,23,548,296,252,71,74,43,28,0
55460,331,177,154,54,38,27,11,380,211,169,47,37,33,21,0
55461,240,99,141,53,38,29,15,389,207,182,53,58,52,18,0
55462,636,288,348,94,77,65,30,1239,659,580,169,148,131,54,0
55463,584,297,287,89,80,65,17,127,66,61,13,14,19,8,0
55464,520,240,280,87,63,67,16,447,212,235,86,55,58,21,0
55465,468,233,235,65,61,49,34,286,160,126,37,27,23,10,0
55466,225,111,114,38,22,25,10,139,68,71,14,26,14,9,0
55467,253,133,120,44,31,22,8,339,175,164,51,49,37,9,0
55468,282,160,122,36,28,27,7,258,129,129,45,24,31,10,0
55469,367,167,200,63,42,60,17,137,85,52,15,11,11,2,0
55470,103,56,47,27,7,8,2,389,207,182,53,58,52,18,0
55471,450,241,209,67,58,54,23,720,357,363,113,85,62,39,0
55472,1001,422,579,185,180,51,32,119,61,58,17,12,10,6,0
55473,536,237,299,116,87,42,17,397,234,163,44,38,23,21,0
55474,760,322,438,81,130,57,19,322,180,142,45,38,28,7,0
55475,613,303,310,70,28,28,18,1061,543,518,146,123,109,67,0
55476,371,143,228,77,48,29,26,679,338,341,96,95,40,23,0
55477,470,163,307,99,68,73,30,229,120,109,31,30,22,9,0
55478,1041,497,544,180,167,98,34,96,46,50,16,12,7,5,0
55479,1007,353,654,277,147,70,26,373,213,160,44,33,26,17,0
55480,1001,422,579,185,180,51,32,137,85,52,15,11,11,2,0
55481,349,153,196,54,47,28,13,359,171,188,49,74,45,11,0
55482,539,283,256,75,73,53,26,260,131,129,42,31,40,9,0
55483,410,211,199,55,42,34,27,405,214,191,53,42,49,20,0
55484,441,218,223,69,55,50,27,1606,753,853,215,227,182,48,0
55485,127,55,72,25,18,5,7,336,200,136,34,29,25,24,0
55486,1390,705,685,219,164,129,74,332,155,177,55,51,44,13,0
55487,451,278,173,71,35,58,12,592,249,343,91,90,50,42,0
55488,801,331,470,151,139,99,55,203,98,105,34,29,19,10,0
55489,431,199,232,59,54,40,17,481,223,258,71,70,49,26,0
55490,648,262,386,113,108,78,29,178,69,109,29,25,21,13,0
55491,410,188,222,53,52,31,14,201,99,102,34,26,23,6,0
55492,118,56,62,24,12,6,9,200,89,111,26,25,17,7,0
55493,286,111,175,51,47,21,12,322,180,142,45,38,28,7,0
55494,193,107,86,13,20,13,6,277,152,125,31,35,22,19,0
55495,500,245,255,66,57,52,27,1239,659,580,169,148,131,54,0
55496,177,100,77,22,17,20,11,941,459,482,167,140,82,38,0
55497,1555,702,853,250,199,139,31,166,78,88,27,25,19,7,0
55498,5890,3314,2576,970,956,293,265,380,178,202,69,53,37,10,0
55499,222,108,114,37,20,25,12,381,196,185,55,57,43,16,0
55500,228,105,123,34,43,20,10,1113,480,633,170,173,81,34,0
55501,278,110,168,58,49,29,5,966,478,488,108,144,74,43,0
55502,743,366,377,41,37,26,14,471,238,233,66,63,62,19,0
55503,1096,563,533,158,136,120,53,605,283,322,94,72,64,39,0
55504,364,204,160,65,35,15,13,194,109,85,23,24,21,9,0
55505,649,304,345,99,80,67,40,583,321,262,73,67,45,25,0
55506,480,257,223,74,26,60,27,556,290,266,75,74,29,24,0
55507,1462,711,751,219,222,148,65,158,71,87,23,21,17,12,0
55508,427,191,236,67,60,41,34,592,249,343,91,90,50,42,0
55509,1189,653,536,152,118,109,56,396,199,197,54,50,45,14,0
55510,67,40,27,10,8,7,6,1182,591,591,155,139,83,46,0
55511,403,176,227,71,56,51,11,528,276,252,86,78,49,17,0
55512,217,109,108,30,23,28,10,1061,543,518,146,123,109,67,0
55513,270,130,140,43,24,36,10,497,257,240,71,63,62,16,0
55514,199,113,86,27,17,10,7,461,223,238,45,62,18,35,0
55515,717,381,336,118,103,85,29,132,67,65,24,21,8,10,0
55516,309,137,172,51,50,28,14,336,200,136,34,29,25,24,0
55517,117,58,59,17,17,12,2,295,160,135,42,37,46,16,0
55518,447,225,222,76,35,75,21,464,236,228,64,56,53,28,0
55519,854,435,419,118,91,95,42,516,245,271,82,84,70,26,0
55520,442,254,188,46,22,40,19,127,54,73,11,33,15,6,0
55521,529,290,239,54,63,85,15,368,204,164,43,35,30,24,0
55522,202,113,89,16,27,21,11,165,87,78,24,19,22,9,0
55523,722,390,332,125,69,67,25,368,200,168,54,49,43,9,0
55524,1161,514,647,159,138,122,37,663,354,309,91,84,79,31,0
55525,1336,724,612,209,141,133,60,89,37,52,13,6,2,9,0
55526,956,450,506,122,117,82,36,453,255,198,62,49,29,19,0
55527,340,162,178,40,39,35,22,702,358,344,113,87,81,30,0
55528,302,160,142,35,35,37,10,218,115,103,37,33,33,9,0
55529,71,28,43,15,9,5,2,131,55,76,28,9,14,12,0
55530,121,69,52,15,18,14,8,392,155,237,68,61,34,16,0
55531,977,462,515,185,119,76,12,270,162,108,26,26,16,11,0
55532,272,94,178,76,33,19,4,127,66,61,13,14,19,8,0
55533,593,282,311,75,70,29,25,230,113,117,31,40,28,10,0
55534,461,207,254,82,66,55,33,375,211,164,50,36,31,23,0
55535,288,104,184,80,30,39,6,405,195,210,57,74,24,17,0
55536,130,72,58,28,9,7,1,207,86,121,34,39,11,13,0
55537,161,99,62,15,22,9,7,963,525,438,119,102,102,34,0
55538,356,199,157,36,43,28,12,188,88,100,53,12,15,6,0
55539,358,206,152,45,38,67,16,457,253,204,67,51,48,13,0
55540,83,45,38,11,8,8,3,508,261,247,65,53,58,23,0
55541,963,477,486,134,143,123,38,414,203,211,58,56,48,14,0
55542,465,305,160,40,47,34,9,172,88,84,24,31,20,12,0
55543,117,57,60,17,14,11,10,373,213,160,44,33,26,17,0
55544,57,24,33,11,3,5,3,2517,1275,1242,304,324,245,135,0
55545,717,281,436,165,81,112,49,198,113,85,19,20,26,12,0
55546,2174,1057,1117,241,241,214,117,617,314,303,96,68,68,37,0
55547,410,208,202,59,58,43,26,265,134,131,48,34,33,15,0
55548,369,166,203,59,55,41,14,974,457,517,133,117,69,26,0
55549,589,282,307,68,67,70,23,487,252,235,79,58,55,26,0
55550,344,109,235,100,39,26,5,1755,905,850,214,196,183,79,0
55551,403,221,182,47,41,47,8,336,190,146,52,30,41,6,0
55552,525,302,223,56,48,67,19,715,348,367,109,84,68,30,0
55553,136,66,70,33,11,9,5,350,196,154,52,37,21,14,0
55554,392,205,187,83,49,38,10,439,227,212,60,55,58,8,0
55555,588,300,288,100,57,65,27,561,279,282,85,81,88,24,0
55556,520,231,289,89,59,58,26,189,95,94,25,33,16,8,0
55557,494,242,252,67,47,25,21,693,360,333,100,88,62,26,0
55558,666,204,462,110,194,42,14,464,236,228,64,56,53,28,0
55559,249,114,135,47,33,25,4,873,411,462,132,107,84,40,0
55560,348,198,150,57,25,37,18,148,84,64,30,7,17,4,0
55561,664,269,395,117,107,36,15,339,180,159,36,29,16,16,0
55562,351,166,185,48,61,24,15,149,68,81,15,38,11,10,0
55563,507,242,265,53,44,31,22,251,143,108,47,25,29,11,0
55564,585,277,308,92,73,61,32,2517,1275,1242,304,324,245,135,0
55565,365,210,155,46,30,24,12,1700,731,969,198,233,110,87,0
55566,509,251,258,69,49,55,17,245,131,114,30,27,18,13,0
55567,338,172,166,59,30,39,18,756,348,408,101,103,60,40,0
55568,613,303,310,70,28,28,18,334,181,153,56,31,28,18,0
55569,285,148,137,31,42,42,16,463,268,195,59,46,46,21,0
55570,979,534,445,83,77,80,24,246,125,121,38,36,30,11,0
55571,1139,537,602,162,139,109,50,108,59,49,17,13,12,5,0
55572,410,188,222,53,52,31,14,368,183,185,40,42,40,15,0
55573,732,355,377,108,109,79,27,593,289,304,85,69,48,19,0
55574,1105,544,561,165,167,99,40,378,154,224,74,84,35,22,0
55575,1148,472,676,229,164,86,37,188,93,95,33,18,16,10,0
55576,292,102,190,71,27,51,21,526,266,260,76,75,53,22,0
55577,439,241,198,67,40,40,13,483,287,196,71,50,54,17,0
55578,351,166,185,48,61,24,15,559,317,242,58,65,37,23,0
55579,202,103,99,28,20,12,8,1114,539,575,145,131,94,56,0
55580,338,172,166,59,30,39,18,445,192,253,86,58,53,18,0
55581,224,108,116,33,26,32,10,673,313,360,102,101,46,17,0
55582,462,228,234,59,47,37,32,194,106,88,33,10,15,6,0
55583,278,104,174,46,34,23,14,541,279,262,79,82,31,32,0
55584,121,69,52,15,18,14,8,530,287,243,79,70,33,26,0
55585,234,108,126,42,40,15,9,963,455,508,127,130,115,48,0
55586,450,231,219,77,50,76,16,196,105,91,40,13,19,10,0
55587,480,257,223,74,26,60,27,277,163,114,33,24,21,16,0
55588,4640,2231,2409,660,549,437,245,766,386,380,101,81,78,31,0
55589,1960,875,1085,287,189,162,66,520,272,248,60,65,58,22,0
55590,309,137,172,51,50,28,14,605,283,322,94,72,64,39,0
55591,977,462,515,185,119,76,12,405,195,210,57,74,24,17,0
55592,130,71,59,30,9,8,2,504,272,232,75,57,53,19,0
55593,627,237,390,137,57,108,44,374,174,200,54,52,42,21,0
55594,2525,1232,1293,398,317,186,61,218,115,103,37,33,33,9,0
55595,302,160,142,35,35,37,10,548,296,252,71,74,43,28,0
55596,228,82,146,45,37,18,8,222,119,103,37,32,24,8,0
55597,665,341,324,109,79,38,22,339,175,164,51,49,37,9,0
55598,432,190,242,85,82,28,11,1873,935,938,233,225,203,79,0
55599,439,241,198,67,40,40,13,572,305,267,74,72,58,21,0
55600,119,59,60,29,10,6,4,715,345,370,110,97,64,25,0
55601,332,170,162,44,38,39,10,381,186,195,69,55,46,15,0
55602,372,189,183,60,44,41,18,605,283,322,94,72,64,39,0
55603,126,66,60,24,10,7,9,392,155,237,68,61,34,16,0
55604,496,209,287,113,55,72,14,600,254,346,104,100,44,17,0
55605,423,247,176,58,55,29,20,201,104,97,36,32,24,7,0
55606,451,225,226,69,57,64,22,242,121,121,39,30,29,10,0
55607,413,169,244,66,94,28,19,417,232,185,58,50,29,21,0
55608,451,278,173,71,35,58,12,245,131,114,30,27,18,13,0
55609,983,449,534,95,77,55,36,386,181,205,55,51,57,31,0
55610,457,228,229,64,36,52,21,278,154,124,42,32,38,7,0
55611,283,172,111,39,31,29,8,1338,720,618,179,145,141,85,0
55612,567,256,311,91,81,53,17,72,33,39,8,2,3,12,0
55613,102,22,80,48,8,18,6,744,385,359,105,96,57,31,0
55614,396,150,246,103,64,38,3,368,183,185,40,42,40,15,0
55615,285,148,137,31,42,42,16,609,335,274,79,57,45,22,0
55616,928,442,486,139,118,91,43,1273,592,681,199,164,139,39,0
55617,828,368,460,118,98,59,38,106,46,60,29,13,14,5,0
55618,1336,724,612,209,141,133,60,665,361,304,87,91,84,31,0
55619,360,175,185,73,36,27,7,647,324,323,101,80,76,43,0
55620,345,208,137,44,27,33,8,627,323,304,81,90,53,27,0
55621,338,164,174,45,32,37,13,514,248,266,86,82,52,22,0
55622,805,338,467,153,138,99,55,127,64,63,26,8,12,8,0
55623,475,235,240,77,58,43,22,147,74,73,28,20,24,4,0
55624,520,261,259,74,52,49,22,2724,1157,1567,269,518,239,77,0
55625,1143,574,569,176,151,123,59,194,94,100,33,28,14,7,0
55626,395,189,206,63,50,49,28,332,180,152,46,36,28,14,0
55627,822,416,406,111,97,88,42,419,233,186,54,53,55,17,0
55628,230,114,116,30,33,29,8,133,61,72,21,19,13,4,0
55629,798,364,434,133,88,74,35,257,126,131,61,24,22,8,0
55630,111,29,82,10,54,0,1,792,398,394,109,96,90,39,0
55631,193,110,83,18,20,15,12,403,221,182,62,50,42,12,0
55632,594,248,346,104,109,53,5,131,55,76,28,9,14,12,0
55633,643,284,359,129,71,84,43,4646,2328,2318,674,639,475,170,0
55634,739,323,416,127,89,76,33,89,38,51,14,6,3,9,0
55635,379,217,162,47,20,50,23,898,469,429,125,125,134,35,0
55636,436,209,227,66,47,52,22,701,380,321,94,84,96,34,0
55637,446,265,181,51,35,27,17,1425,670,755,153,189,122,85,0
55638,1121,458,663,158,210,76,47,935,515,420,126,107,73,32,0
55639,67,40,27,10,8,7,6,316,166,150,45,38,37,13,0
55640,852,472,380,99,79,70,27,166,78,88,27,25,19,7,0
55641,522,302,220,61,49,75,19,780,337,443,112,116,77,28,0
55642,2624,999,1625,415,495,109,84,397,223,174,50,39,29,17,0
55643,496,210,286,112,55,71,14,501,257,244,75,57,48,29,0
55644,301,150,151,45,47,33,13,127,66,61,13,14,19,8,0
55645,126,56,70,31,10,10,3,627,289,338,101,73,62,43,0
55646,450,241,209,67,58,54,23,298,129,169,51,40,29,8,0
55647,423,247,176,58,55,29,20,247,128,119,34,14,16,14,0
55648,364,168,196,64,61,27,6,392,186,206,62,56,29,15,0
55649,51,10,41,25,0,5,8,469,225,244,64,68,25,11,0
55650,485,246,239,74,48,47,22,1873,935,938,233,225,203,79,0
55651,172,98,74,20,21,22,8,593,289,304,85,69,48,19,0
55652,246,123,123,40,31,27,7,459,260,199,56,42,47,21,0
55653,420,202,218,67,43,51,15,843,391,452,139,104,91,35,0
55654,292,102,190,71,27,51,21,479,215,264,67,80,46,28,0
55655,837,381,456,123,109,65,25,1061,543,518,146,123,109,67,0
55656,107,53,54,15,15,13,4,1698,875,823,222,219,173,64,0
55657,1004,498,506,94,59,46,33,285,146,139,41,41,48,13,0
55658,154,74,80,18,19,7,2,846,425,421,125,97,98,38,0
55659,488,237,251,79,78,65,27,370,190,180,60,52,37,13,0
55660,836,370,466,126,96,72,30,601,278,323,124,87,65,21,0
55661,1042,529,513,161,151,103,52,275,155,120,37,31,16,14,0
55662,222,108,114,37,20,25,12,384,204,180,53,47,49,17,0
55663,395,195,200,41,55,23,10,1262,653,609,169,165,152,50,0
55664,4128,2104,2024,581,505,453,205,198,86,112,36,27,23,9,0
55665,915,336,579,185,199,56,29,153,65,88,28,21,20,8,0
55666,76,42,34,12,8,5,7,536,222,314,101,100,34,22,0
55667,356,199,157,36,43,28,12,367,218,149,45,43,42,16,0
55668,233,110,123,34,22,34,9,457,242,215,39,46,53,10,0
55669,490,198,292,65,81,39,27,180,95,85,22,21,17,8,0
55670,55,16,39,24,2,5,2,602,310,292,87,66,70,36,0
55671,170,82,88,32,23,22,8,463,268,195,59,46,46,21,0
55672,236,141,95,36,32,14,6,1700,731,969,198,233,110,87,0
55673,127,48,79,27,20,6,5,403,221,182,62,50,42,12,0
55674,219,105,114,36,29,19,8,873,366,507,127,125,75,21,0
55675,414,216,198,51,32,42,28,91,44,47,9,12,4,7,0
55676,733,438,295,95,79,67,32,173,94,79,18,24,12,7,0
55677,1501,679,822,251,196,174,67,629,317,312,80,87,51,22,0
55678,143,81,62,28,9,8,1,453,247,206,58,53,45,20,0
55679,142,76,66,21,21,22,11,405,195,210,57,74,24,17,0
55680,57,24,33,11,3,5,3,478,254,224,67,74,56,28,0
55681,327,174,153,42,35,16,12,265,134,131,48,34,33,15,0
55682,1214,498,716,197,180,121,65,384,204,180,53,47,49,17,0
55683,128,70,58,29,9,8,1,349,200,149,41,39,30,20,0
55684,391,203,188,49,34,36,9,1696,771,925,257,225,149,63,0
55685,303,147,156,49,49,20,8,447,212,235,86,55,58,21,0
55686,146,75,71,13,32,15,11,457,253,204,67,51,48,13,0
55687,178,89,89,40,12,18,7,423,234,189,66,44,57,12,0
55688,301,119,182,53,47,14,20,165,87,78,24,19,22,9,0
55689,531,260,271,97,68,47,11,341,170,171,41,66,27,10,0
55690,379,217,162,47,20,50,23,415,226,189,51,40,40,29,0
55691,1341,481,860,275,264,57,21,1382,508,874,334,320,98,36,0
55692,795,384,411,133,109,85,38,425,177,248,60,62,33,16,0
55693,410,188,222,53,52,31,14,463,259,204,62,55,34,22,0
55694,211,92,119,33,44,11,7,422,237,185,53,47,62,20,0
55695,260,136,124,24,41,19,4,748,359,389,125,113,86,31,0
55696,2174,1057,1117,241,241,214,117,621,273,348,104,102,48,19,0
55697,335,171,164,51,38,38,10,1113,480,633,170,173,81,34,0
55698,288,104,184,80,30,39,6,496,285,211,62,54,46,22,0
55699,361,167,194,55,35,41,11,925,439,486,141,134,105,46,0
55700,484,261,223,59,48,49,24,418,223,195,51,45,49,14,0
55701,462,228,234,59,47,37,32,406,234,172,63,35,43,10,0
55702,294,148,146,35,33,25,14,167,79,88,22,26,16,9,0
55703,758,378,380,89,64,37,31,207,113,94,33,18,30,9,0
55704,852,472,380,99,79,70,27,362,156,206,74,42,36,22,0
55705,1085,646,439,108,65,36,19,2202,1121,1081,338,274,269,81,0
55706,330,77,253,86,52,20,12,583,321,262,73,67,45,25,0
55707,109,50,59,12,12,9,3,130,67,63,24,10,12,4,0
55708,2109,999,1110,332,294,187,89,72,32,40,8,2,1,14,0
55709,559,217,342,105,86,42,16,400,187,213,56,59,42,20,0
55710,343,162,181,65,38,29,12,384,204,180,53,47,49,17,0
55711,410,211,199,55,42,34,27,127,54,73,11,33,15,6,0
55712,1120,436,684,208,120,101,115,89,51,38,15,15,5,4,0
55713,785,351,434,136,93,71,37,316,166,150,45,38,37,13,0
55714,178,87,91,20,32,13,10,862,409,453,149,125,86,29,0
55715,494,233,261,87,57,46,18,377,184,193,50,43,33,17,0
55716,521,289,232,71,58,49,16,1700,731,969,198,233,110,87,0
55717,406,207,199,56,46,68,19,858,461,397,125,114,79,45,0
55718,379,217,162,47,20,50,23,748,359,389,125,113,86,31,0
55719,583,279,304,99,71,59,31,1873,935,938,233,225,203,79,0
55720,490,198,292,65,81,39,27,232,111,121,23,29,17,9,0
55721,136,65,71,33,11,9,6,621,310,311,100,106,77,27,0
55722,281,154,127,45,31,24,9,434,213,221,77,62,53,12,0
55723,462,258,204,59,41,56,15,169,85,84,21,14,9,9,0
55724,2285,1219,1066,207,180,178,106,1698,875,823,222,219,173,64,0
55725,1390,705,685,219,164,129,74,516,245,271,82,84,70,26,0
55726,512,254,258,70,48,37,32,145,77,68,26,7,15,8,0
55727,2414,1189,1225,277,178,170,169,562,273,289,76,92,45,24,0
55728,76,35,41,12,11,4,1,862,335,527,136,169,47,28,0
55729,288,140,148,59,33,27,12,689,343,346,105,102,81,35,0
55730,437,167,270,126,95,34,10,337,152,185,49,54,42,21,0
55731,291,131,160,49,35,32,15,368,204,164,43,35,30,24,0
55732,1064,495,569,157,159,124,58,306,157,149,52,35,39,16,0
55733,193,90,103,44,9,19,13,926,425,501,159,147,77,35,0
55734,658,349,309,77,70,73,35,218,114,104,32,31,33,11,0
55735,364,204,160,65,35,15,13,647,324,323,101,80,76,43,0
55736,580,240,340,108,81,59,22,245,131,114,30,27,18,13,0
55737,401,183,218,72,73,28,10,218,114,104,32,31,33,11,0
55738,227,120,107,31,28,28,13,127,64,63,26,8,12,8,0
55739,585,277,308,92,73,61,32,751,394,357,107,96,73,35,0
55740,215,104,111,61,7,2,1,679,338,341,96,95,40,23,0
55741,475,235,240,77,58,43,22,1698,875,823,222,219,173,64,0
55742,927,457,470,130,99,118,42,312,165,147,41,39,29,16,0
55743,559,217,342,105,86,42,16,508,262,246,66,67,51,20,0
55744,292,102,190,71,27,51,21,1262,653,609,169,165,152,50,0
55745,164,81,83,37,8,14,10,234,116,118,34,35,23,9,0
55746,327,174,153,42,35,16,12,320,168,152,38,42,24,18,0
55747,500,297,203,66,33,53,15,690,345,345,96,83,73,42,0
55748,338,173,165,31,42,22,10,153,80,73,26,18,19,4,0
55749,126,57,69,31,10,10,3,222,127,95,23,28,22,7,0
55750,280,128,152,39,37,38,18,708,328,380,113,100,82,34,0
55751,784,353,431,56,47,26,18,551,226,325,96,103,43,11,0
55752,464,237,227,64,66,33,12,245,131,114,30,27,18,13,0
55753,434,221,213,58,47,54,15,1698,875,823,222,219,173,64,0
55754,505,247,258,72,71,60,27,245,121,124,37,35,36,12,0
55755,493,281,212,56,61,30,13,370,173,197,65,57,42,10,0
55756,282,160,122,36,28,27,7,662,312,350,103,104,59,20,0
55757,747,469,278,60,41,53,23,535,311,224,66,52,49,24,0
55758,415,133,282,114,65,27,7,323,162,161,52,41,39,13,0
55759,674,318,356,86,139,50,11,928,440,488,111,157,82,35,0
55760,2663,1073,1590,548,499,192,64,535,288,247,79,72,35,21,0
55761,1171,542,629,170,146,114,64,380,211,169,47,37,33,21,0
55762,688,310,378,130,82,78,47,898,469,429,125,125,134,35,0
55763,264,122,142,33,29,13,13,419,233,186,54,53,55,17,0
55764,873,366,507,127,125,75,21,429,187,242,79,72,28,19,0
55765,2174,1057,1117,241,241,214,117,403,185,218,67,62,63,19,0
55766,395,195,200,41,55,23,10,902,499,403,118,117,92,35,0
55767,2000,965,1035,357,313,198,75,303,137,166,54,54,31,15,0
55768,773,383,390,108,76,79,30,405,195,210,57,74,24,17,0
55769,314,158,156,39,28,30,17,665,361,304,87,91,84,31,0
55770,480,257,223,74,26,60,27,770,390,380,104,76,78,32,0
55771,246,111,135,64,47,27,3,301,168,133,49,37,34,11,0
55772,379,203,176,55,48,45,16,425,204,221,71,56,45,13,0
55773,330,141,189,65,29,51,19,462,229,233,63,49,42,18,0
55774,536,237,299,116,87,42,17,386,207,179,43,48,44,19,0
55775,335,148,187,52,26,51,12,277,144,133,42,30,41,8,0
55776,252,121,131,42,34,12,16,406,223,183,61,53,46,17,0
55777,136,66,70,33,11,9,5,123,61,62,17,18,17,7,0
55778,753,395,358,93,72,71,16,329,196,133,41,36,31,15,0
55779,416,222,194,58,38,38,20,515,276,239,62,59,43,31,0
55780,563,255,308,91,111,42,30,579,285,294,78,72,64,32,0
55781,361,183,178,50,54,51,22,508,262,246,66,67,51,20,0
55782,1085,646,439,108,65,36,19,483,287,196,71,50,54,17,0
55783,215,117,98,28,19,15,8,633,311,322,94,82,45,20,0
55784,485,183,302,79,81,73,33,429,187,242,79,72,28,19,0
55785,271,110,161,33,27,11,8,660,303,357,97,89,85,33,0
55786,953,421,532,131,131,70,37,72,33,39,8,2,3,12,0
55787,313,178,135,43,18,35,6,723,363,360,107,106,52,14,0
55788,449,179,270,80,77,49,29,194,109,85,23,24,21,9,0
55789,378,202,176,34,32,44,13,664,350,314,86,90,82,36,0
55790,519,245,274,58,61,34,22,497,257,240,71,63,62,16,0
55791,127,62,65,13,33,7,6,373,189,184,54,46,50,23,0
55792,330,77,253,86,52,20,12,455,229,226,66,62,63,29,0
55793,178,87,91,20,32,13,10,902,499,403,118,117,92,35,0
55794,1068,434,634,173,160,61,29,629,317,312,80,87,51,22,0
55795,513,276,237,73,43,57,24,536,222,314,101,100,34,22,0
55796,347,181,166,27,20,12,12,309,159,150,47,43,43,13,0
55797,150,64,86,22,12,29,12,597,269,328,102,84,69,24,0
55798,178,89,89,40,12,18,7,393,210,183,58,37,34,20,0
55799,1390,705,685,219,164,129,74,328,199,129,39,29,27,14,0
55800,378,202,176,34,32,44,13,173,94,79,18,24,12,7,0
55801,207,89,118,56,8,4,3,373,189,184,54,46,50,23,0
55802,388,209,179,46,24,31,28,103,44,59,16,17,9,5,0
55803,288,142,146,52,32,26,8,689,343,346,105,102,81,35,0
55804,224,108,116,33,26,32,10,766,386,380,101,81,78,31,0
55805,420,248,172,64,30,43,17,548,273,275,84,81,64,30,0
55806,282,105,177,77,28,39,6,974,457,517,133,117,69,26,0
55807,736,320,416,113,97,61,36,201,117,83,22,21,19,9,0
55808,318,164,154,52,43,34,10,481,223,258,71,70,49,26,0
55809,203,97,106,30,22,18,10,98,49,49,14,15,9,2,0
55810,246,111,135,64,47,27,3,389,210,179,51,37,43,9,0
55811,1505,680,825,202,204,73,32,322,180,142,45,38,28,7,0
55812,341,177,164,57,42,40,18,88,50,38,13,8,16,4,0
55813,595,208,387,157,60,91,48,419,233,186,54,53,55,17,0
55814,76,30,46,7,15,1,5,556,290,266,75,74,29,24,0
55815,1014,488,526,178,137,94,39,818,357,461,122,136,54,25,0
55816,527,276,251,64,60,70,20,89,51,38,15,15,5,4,0
55817,886,440,446,116,140,95,45,723,363,360,107,106,52,14,0
55818,1339,494,845,216,298,92,37,169,74,95,33,26,22,3,0
55819,525,254,271,60,76,46,13,142,73,69,27,9,15,11,0
55820,505,247,258,72,71,60,27,156,90,66,17,22,11,10,0
55821,929,410,519,187,146,53,30,134,72,62,14,28,8,4,0
55822,1531,649,882,108,122,93,72,418,246,172,52,39,57,10,0
55823,475,235,240,77,58,43,22,528,276,252,86,78,49,17,0
55824,119,67,52,15,15,7,7,2517,1275,1242,304,324,245,135,0
55825,598,322,276,67,57,63,26,72,34,38,8,2,3,12,0
55826,281,125,156,44,47,17,7,274,142,132,33,34,18,14,0
55827,480,267,213,49,44,70,21,201,99,102,34,26,23,6,0
55828,130,71,59,30,9,8,2,341,170,171,41,66,27,10,0
55829,309,137,172,51,50,28,14,242,121,121,39,30,29,10,0
55830,532,254,278,91,48,23,17,396,223,173,57,37,44,19,0
55831,1004,464,540,143,104,78,55,346,196,150,43,26,27,14,0
55832,607,294,313,94,95,62,14,279,106,173,48,35,41,39,0
55833,840,411,429,122,101,79,34,277,144,133,42,30,41,8,0
55834,579,246,333,102,79,41,19,445,264,181,35,35,34,14,0
55835,130,70,60,30,9,8,1,699,334,365,108,80,70,20,0
55836,682,292,390,89,69,58,20,649,307,342,71,134,45,17,0
55837,341,195,146,42,21,36,9,903,436,467,128,116,83,33,0
55838,237,127,110,34,30,16,9,136,65,71,26,11,7,5,0
55839,224,101,123,45,32,21,3,1113,480,633,170,173,81,34,0
55840,1464,693,771,153,136,91,86,370,190,180,60,52,37,13,0
55841,2136,1063,1073,317,308,223,90,368,200,168,54,49,43,9,0
55842,242,111,131,35,35,17,13,461,223,238,45,62,18,35,0
55843,330,151,179,68,36,56,9,928,440,488,111,157,82,35,0
55844,122,56,66,26,13,11,5,89,37,52,13,6,2,9,0
55845,193,105,88,33,16,9,4,65,32,33,16,4,8,3,0
55846,1220,575,645,208,179,99,56,1537,701,836,209,187,129,58,0
55847,443,206,237,76,68,52,28,332,180,152,46,36,28,14,0
55848,362,174,188,46,55,35,23,392,186,206,62,56,29,15,0
55849,302,178,124,34,29,50,13,222,122,100,39,32,24,9,0
55850,298,141,157,51,33,21,22,189,95,94,25,33,16,8,0
55851,588,267,321,99,79,87,28,276,149,127,34,31,32,10,0
55852,314,158,156,39,28,30,17,332,180,152,46,36,28,14,0
55853,442,254,188,46,22,40,19,302,150,152,56,40,52,15,0
55854,708,344,364,106,98,66,33,564,264,300,79,84,65,26,0
55855,262,133,129,44,38,31,12,509,267,242,79,81,38,20,0
55856,291,142,149,50,29,35,7,445,264,181,35,35,34,14,0
55857,217,109,108,30,23,28,10,873,411,462,132,107,84,40,0
55858,457,261,196,55,27,57,34,165,87,78,24,19,22,9,0
55859,684,353,331,95,98,77,38,469,225,244,64,68,25,11,0
55860,2136,1063,1073,317,308,223,90,820,333,487,202,152,59,23,0
55861,359,204,155,39,36,34,13,1507,737,770,188,228,147,71,0
55862,952,547,405,95,90,127,35,2225,1244,981,271,243,217,93,0
55863,217,109,108,30,23,28,10,192,91,101,29,28,17,7,0
55864,126,57,69,31,10,10,3,262,129,133,40,41,31,10,0
55865,284,128,156,48,29,34,8,423,234,189,66,44,57,12,0
55866,594,321,273,98,59,57,23,334,181,153,41,40,25,15,0
55867,167,70,97,32,20,15,7,966,478,488,108,144,74,43,0
55868,631,304,327,98,75,52,23,87,38,49,23,10,10,9,0
55869,169,64,105,23,37,11,3,127,58,69,18,17,10,5,0
55870,643,284,359,129,71,84,43,127,58,69,18,17,10,5,0
55871,236,141,95,36,32,14,6,287,151,136,51,42,36,7,0
55872,364,204,160,65,35,15,13,352,207,145,40,33,25,21,0
55873,681,367,314,83,74,78,31,399,190,209,61,41,39,18,0
55874,361,167,194,55,35,41,11,205,94,111,48,31,15,6,0
55875,376,176,200,31,53,27,8,393,210,183,58,37,34,20,0
55876,356,199,157,36,43,28,12,96,45,51,13,12,6,4,0
55877,1171,542,629,170,146,114,64,72,33,39,8,2,3,12,0
55878,403,176,227,71,56,51,11,509,267,242,79,81,38,20,0
55879,2286,1154,1132,338,314,278,103,602,310,292,87,66,70,36,0
55880,269,124,145,36,24,32,11,422,202,220,80,52,57,18,0
55881,480,267,213,49,44,70,21,332,180,152,46,36,28,14,0
55882,654,344,310,80,69,57,15,234,129,105,31,22,19,17,0
55883,414,216,198,51,32,42,28,583,280,303,95,66,76,25,0
55884,580,308,272,82,79,58,25,792,398,394,109,96,90,39,0
55885,233,110,123,34,22,34,9,381,187,194,37,49,36,17,0
55886,727,426,301,79,71,64,32,492,278,214,65,58,32,11,0
55887,236,141,95,36,32,14,6,376,189,187,47,53,44,26,0
55888,630,231,399,150,83,84,50,423,234,189,66,44,57,12,0
55889,204,93,111,35,35,16,11,325,172,153,44,34,27,14,0
55890,1148,472,676,229,164,86,37,545,269,276,80,76,27,32,0
55891,1257,464,793,221,264,75,37,405,195,210,57,74,24,17,0
55892,368,154,214,80,52,41,16,376,183,193,50,50,43,21,0
55893,747,360,387,125,92,69,32,501,249,252,77,70,55,22,0
55894,279,129,150,43,34,17,13,480,255,225,67,64,50,22,0
55895,631,316,315,64,57,49,15,498,244,254,81,67,58,19,0
55896,1189,653,536,152,118,109,56,132,77,55,20,9,13,10,0
55897,471,221,250,87,68,42,25,903,436,467,128,116,83,33,0
55898,1130,614,516,129,138,98,42,363,180,183,60,34,10,6,0
55899,502,229,273,63,66,40,31,715,345,370,110,97,64,25,0
55900,313,134,179,58,37,43,19,136,65,71,26,11,7,5,0
55901,158,85,73,24,18,18,8,89,38,51,14,6,3,9,0
55902,1499,864,635,141,99,76,110,2346,1231,1115,316,292,266,105,0
55903,579,281,298,91,78,74,27,72,34,38,8,2,3,12,0
55904,264,122,142,46,24,35,10,338,169,169,53,44,39,21,0
55905,186,56,130,46,50,16,7,1230,644,586,198,125,123,61,0
55906,824,391,433,106,90,88,32,453,255,198,62,49,29,19,0
55907,512,254,258,70,48,37,32,380,211,169,47,37,33,21,0
55908,509,246,263,84,71,56,22,403,192,211,102,39,49,15,0
55909,346,205,141,47,34,30,7,227,130,97,32,25,22,12,0
55910,308,129,179,44,60,19,8,430,212,218,88,43,40,20,0
55911,2109,999,1110,332,294,187,89,582,264,318,84,60,58,23,0
55912,267,146,121,40,24,25,7,303,138,165,47,46,35,18,0
55913,887,439,448,137,99,91,38,295,160,135,44,36,46,16,0
55914,128,69,59,29,9,8,1,303,137,166,54,54,31,15,0
55915,142,76,66,21,21,22,11,376,189,187,47,53,44,26,0
55916,71,39,32,7,11,6,4,101,59,42,11,17,10,1,0
55917,231,105,126,56,10,24,10,204,96,108,31,37,20,5,0
55918,234,108,126,42,40,15,9,518,292,226,60,60,52,21,0
55919,441,216,225,57,66,57,19,334,182,152,45,41,27,13,0
55920,126,57,69,31,10,10,3,475,251,224,67,49,48,23,0
55921,562,214,348,120,86,69,42,763,418,345,113,84,59,32,0
55922,238,158,80,28,15,31,7,727,362,365,123,107,63,23,0
55923,1249,543,706,187,164,125,52,89,51,38,15,15,5,4,0
55924,213,114,99,62,7,2,1,96,45,51,13,12,6,4,0
55925,1339,494,845,216,298,92,37,483,215,268,66,70,30,16,0
55926,443,226,217,67,34,53,10,1025,549,476,118,109,88,61,0
55927,813,412,401,114,93,112,26,286,152,134,38,38,32,11,0
55928,895,388,507,130,84,90,31,627,323,304,81,90,53,27,0
55929,563,255,308,91,111,42,30,974,457,517,133,117,69,26,0
55930,318,161,157,53,51,32,13,136,65,71,26,11,7,5,0
55931,283,172,111,39,31,29,8,330,166,164,55,51,36,16,0
55932,2048,855,1193,297,287,191,93,98,49,49,14,15,9,2,0
55933,510,269,241,66,67,71,26,418,223,195,53,43,49,15,0
55934,193,107,86,13,20,13,6,88,50,38,13,8,16,4,0
55935,401,204,197,49,33,29,17,792,398,394,109,96,90,39,0
55936,338,164,174,45,32,37,13,723,353,370,120,109,96,33,0
55937,453,240,213,53,33,44,16,396,223,173,57,37,44,19,0
55938,393,223,170,44,36,32,14,455,191,264,68,86,21,19,0
55939,3859,2011,1848,535,391,422,207,198,115,83,30,22,8,8,0
55940,626,308,318,105,89,77,25,308,146,162,42,39,24,12,0
55941,380,187,193,38,51,30,18,364,189,175,58,41,35,17,0
55942,682,260,422,98,83,42,31,244,143,101,31,29,26,8,0
55943,270,158,112,35,20,23,7,462,229,233,63,49,42,18,0
55944,384,198,186,58,48,37,12,727,388,339,102,87,70,29,0
55945,392,221,171,53,30,25,8,723,353,370,120,109,96,33,0
55946,567,266,301,139,46,76,37,265,134,131,48,34,33,15,0
55947,1711,865,846,204,176,105,60,334,181,153,56,31,28,18,0
55948,330,77,253,86,52,20,12,322,180,142,45,38,28,7,0
55949,1112,457,655,180,164,99,39,299,140,159,49,44,26,11,0
55950,1499,864,635,141,99,76,110,375,210,165,49,37,29,27,0
55951,126,58,68,31,10,10,3,89,51,38,15,15,5,4,0
55952,431,245,186,50,23,46,17,252,130,122,45,23,32,11,0
55953,1200,602,598,145,116,110,50,230,125,105,29,40,20,6,0
55954,215,80,135,54,56,21,9,480,255,225,67,64,50,22,0
55955,869,489,380,110,77,79,29,547,295,252,81,65,57,23,0
55956,267,146,121,40,24,25,7,798,385,413,120,115,79,30,0
55957,734,366,368,121,99,63,39,339,180,159,36,29,16,16,0
55958,4640,2231,2409,660,549,437,245,296,140,156,49,40,42,19,0
55959,727,426,301,79,71,64,32,381,187,194,37,49,36,17,0
55960,517,245,272,92,77,46,24,821,394,427,122,117,109,38,0
55961,426,213,213,60,56,46,24,736,388,348,88,85,67,28,0
55962,2488,1085,1403,346,253,162,76,137,72,65,27,13,15,8,0
55963,412,208,204,54,47,42,17,415,205,210,77,52,55,17,0
55964,369,166,203,59,55,41,14,323,168,155,51,41,38,12,0
55965,332,170,162,44,38,39,10,124,69,55,14,7,9,4,0
55966,281,154,127,45,31,24,9,455,191,264,68,86,21,19,0
55967,333,171,162,41,44,48,23,384,212,172,44,43,34,14,0
55968,598,322,276,67,57,63,26,723,353,370,120,109,96,33,0
55969,508,136,372,157,91,22,9,592,249,343,91,90,50,42,0
55970,1004,464,540,143,104,78,55,903,436,467,128,116,83,33,0
55971,681,367,314,83,74,78,31,480,255,225,67,64,50,22,0
55972,426,214,212,63,47,53,20,818,357,461,122,136,54,25,0
55973,439,211,228,65,73,26,21,291,146,145,39,45,22,16,0
55974,836,370,466,126,96,72,30,178,99,79,31,19,26,8,0
55975,319,153,166,61,52,26,12,943,463,480,91,144,70,30,0
55976,236,141,95,36,32,14,6,1698,875,823,222,219,173,64,0
55977,332,172,160,50,33,35,9,94,45,49,11,20,10,4,0
55978,109,50,59,12,12,9,3,277,124,153,44,40,35,18,0
55979,433,188,245,63,45,26,14,282,134,148,38,45,29,10,0
55980,1555,702,853,250,199,139,31,406,202,204,54,51,63,21,0
55981,281,154,127,45,31,24,9,515,276,239,62,59,43,31,0
55982,465,305,160,40,47,34,9,166,88,78,23,18,13,7,0
55983,346,173,173,50,56,31,14,387,193,194,60,53,57,15,0
55984,413,169,244,66,94,28,19,169,85,84,21,14,9,9,0
55985,528,273,255,67,53,29,20,1378,692,686,194,174,105,56,0
55986,315,170,145,48,56,22,11,106,46,60,27,18,12,3,0
55987,204,103,101,16,32,22,8,198,110,88,27,27,24,4,0
55988,532,254,278,91,48,23,17,256,141,115,32,22,32,8,0
55989,330,77,253,86,52,20,12,775,407,368,122,100,97,32,0
55990,446,174,272,84,61,57,23,340,169,171,40,39,36,22,0
55991,364,168,196,64,61,27,6,724,353,371,94,95,71,31,0
55992,803,358,445,135,117,80,43,403,225,178,56,38,33,25,0
55993,157,62,95,41,18,10,11,106,46,60,27,18,12,3,0
55994,376,249,127,47,23,43,16,180,95,85,22,21,17,8,0
55995,494,233,261,87,57,46,18,406,223,183,61,53,46,17,0
55996,853,400,453,137,109,88,42,594,312,282,72,67,73,31,0
55997,115,62,53,13,10,9,7,87,38,49,23,10,10,9,0
55998,743,377,366,87,74,68,30,111,60,51,17,23,10,7,0
55999,136,66,70,33,11,9,4,194,109,85,23,24,21,9,0
56000,593,325,268,84,66,73,24,300,171,129,45,35,20,13,0
56001,956,450,506,122,117,82,36,647,350,297,95,79,77,29,0
56002,303,161,142,38,31,42,17,171,94,77,24,28,30,11,0
56003,490,224,266,80,70,39,32,798,385,413,120,115,79,30,0
56004,627,237,390,137,57,108,44,1230,644,586,198,125,123,61,0
56005,429,227,202,49,51,46,26,609,335,274,79,57,45,22,0
56006,479,228,251,71,57,60,14,413,223,190,52,45,53,10,0
56007,149,78,71,20,20,19,5,437,221,216,62,64,47,13,0
56008,933,456,477,123,108,83,29,410,197,213,67,43,56,18,0
56009,167,70,97,32,20,15,7,399,190,209,61,41,39,18,0
56010,447,225,222,76,35,75,21,391,189,202,55,56,56,12,0
56011,856,429,427,113,105,96,24,300,148,152,45,43,40,8,0
56012,525,302,223,56,48,67,19,131,55,76,28,9,14,12,0
56013,475,235,240,77,58,43,22,858,398,460,126,138,75,39,0
56014,465,220,245,88,34,61,23,239,113,126,36,49,20,8,0
56015,155,85,70,17,16,4,8,478,254,224,67,74,56,28,0
56016,181,92,89,34,22,17,9,1700,731,969,198,233,110,87,0
56017,728,358,370,118,100,55,29,180,95,85,22,21,17,8,0
56018,206,96,110,33,25,8,6,381,187,194,37,49,36,17,0
56019,336,134,202,51,64,27,12,408,221,187,55,51,57,14,0
56020,1395,595,800,223,206,113,61,297,164,133,45,39,40,9,0
56021,320,163,157,44,44,26,15,422,202,220,80,52,57,18,0
56022,553,276,277,88,61,45,27,663,360,303,87,82,80,35,0
56023,412,193,219,69,57,43,14,390,190,200,66,50,43,12,0
56024,344,168,176,50,39,30,20,54,26,28,11,4,3,3,0
56025,361,171,190,44,40,18,13,975,475,500,139,140,119,28,0
56026,280,128,152,39,37,38,18,565,237,328,75,88,32,11,0
56027,343,162,181,65,38,29,12,339,180,159,36,29,16,16,0
56028,2663,1073,1590,548,499,192,64,362,156,206,74,42,36,22,0
56029,520,261,259,74,52,49,22,593,289,304,85,69,48,19,0
56030,209,75,134,53,48,20,9,386,207,179,43,48,44,19,0
56031,1064,495,569,157,159,124,58,1352,602,750,166,185,81,70,0
56032,376,249,127,47,23,43,16,335,170,165,52,36,47,11,0
56033,2000,965,1035,357,313,198,75,1117,422,695,182,134,88,32,0
56034,476,199,277,82,80,49,24,260,131,129,42,31,40,9,0
56035,682,260,422,153,78,109,46,447,212,235,86,55,58,21,0
56036,150,64,86,22,12,29,12,323,171,152,48,41,40,16,0
56037,524,270,254,84,72,70,23,1025,549,476,118,109,88,61,0
56038,420,202,218,67,43,51,15,403,221,182,62,50,42,12,0
56039,426,231,195,51,52,45,24,142,65,77,30,17,22,9,0
56040,2414,1189,1225,277,178,170,169,467,231,236,71,65,58,18,0
56041,528,188,340,130,58,77,41,559,317,242,58,65,37,23,0
56042,586,298,288,80,75,64,37,384,212,172,44,43,34,14,0
56043,1161,514,647,159,138,122,37,1543,794,749,182,152,132,55,0
56044,76,42,34,12,8,5,7,309,159,150,47,43,43,13,0
56045,286,111,175,51,47,21,12,1065,581,484,134,97,76,46,0
56046,130,70,60,30,9,8,1,312,165,147,41,39,29,16,0
56047,472,222,250,46,61,33,23,232,111,121,23,29,17,9,0
56048,1098,519,579,182,159,79,42,555,292,263,75,63,67,27,0
56049,71,28,43,15,9,5,2,437,221,216,62,64,47,13,0
56050,179,96,83,24,8,26,4,403,184,219,75,51,47,20,0
56051,426,196,230,76,65,54,20,244,143,101,31,29,26,8,0
56052,531,284,247,66,42,49,15,274,142,132,33,34,18,14,0
56053,238,91,147,68,19,22,7,536,222,314,101,100,34,22,0
56054,732,355,377,108,109,79,27,398,200,198,68,43,51,14,0
56055,369,207,162,67,35,16,14,597,300,297,96,89,68,29,0
56056,202,103,99,28,20,12,8,723,363,360,107,106,52,14,0
56057,886,440,446,116,140,95,45,201,104,97,36,32,24,7,0
56058,211,92,119,33,44,11,7,704,355,349,113,94,71,24,0
56059,598,322,276,67,57,63,26,106,46,60,29,13,14,5,0
56060,228,105,123,34,43,20,10,1040,564,476,134,110,114,51,0
56061,284,160,124,37,23,32,11,294,146,148,50,45,51,15,0
56062,421,219,202,68,57,56,13,391,165,226,67,64,36,27,0
56063,510,288,222,44,36,24,7,103,50,53,19,10,7,5,0
56064,854,435,419,118,91,95,42,251,143,108,47,25,29,11,0
56065,545,221,324,101,72,55,30,419,233,186,54,53,55,17,0
56066,283,112,171,48,39,34,15,462,251,211,74,53,41,18,0
56067,462,228,234,59,47,37,32,1338,720,618,179,145,141,85,0
56068,361,183,178,50,54,51,22,373,189,184,54,46,50,23,0
56069,347,212,135,35,32,17,6,1698,875,823,222,219,173,64,0
56070,303,147,156,49,49,20,8,266,146,120,41,28,31,7,0
56071,437,212,225,66,44,44,11,947,482,465,143,107,89,37,0
56072,478,220,258,47,70,41,10,354,188,166,46,40,34,10,0
56073,427,191,236,67,60,41,34,419,233,186,54,53,55,17,0
56074,261,148,113,23,29,26,21,462,251,211,74,53,41,18,0
56075,911,489,422,121,98,97,36,633,311,322,94,82,45,20,0
56076,411,236,175,39,45,50,30,133,61,72,21,19,13,4,0
56077,130,72,58,28,9,7,1,152,71,81,41,16,14,2,0
56078,873,366,507,127,125,75,21,274,157,117,40,29,40,8,0
56079,1560,778,782,224,235,132,78,846,425,421,125,97,98,38,0
56080,336,134,202,51,64,27,12,390,190,200,66,50,43,12,0
56081,349,131,218,66,76,22,9,200,99,101,31,24,26,6,0
56082,234,110,124,39,29,23,2,434,213,221,77,62,53,12,0
56083,543,265,278,52,37,54,19,720,361,359,98,98,70,37,0
56084,493,208,285,75,77,70,40,223,113,110,31,33,22,12,0
56085,338,164,174,45,32,37,13,94,45,49,11,20,10,4,0
56086,626,300,326,91,82,68,26,715,348,367,109,84,68,30,0
56087,130,71,59,30,9,8,1,165,87,78,24,19,22,9,0
56088,336,134,202,51,64,27,12,535,301,234,63,48,47,27,0
56089,418,163,255,57,54,38,24,337,170,167,59,33,47,17,0
56090,1143,574,569,176,151,123,59,548,296,252,71,74,43,28,0
56091,282,96,186,80,21,28,7,132,77,55,20,9,13,10,0
56092,1336,724,612,209,141,133,60,198,110,88,27,27,24,4,0
56093,536,237,299,116,87,42,17,403,225,178,56,38,33,25,0
56094,1009,487,522,177,121,103,51,1338,720,618,179,145,141,85,0
56095,682,260,422,98,83,42,31,203,98,105,34,29,19,10,0
56096,454,230,224,63,56,38,33,334,181,153,56,31,28,18,0
56097,426,214,212,63,47,53,20,130,67,63,24,10,12,4,0
56098,714,260,454,140,97,120,54,166,90,76,27,18,21,5,0
56099,407,207,200,53,36,38,8,332,155,177,55,51,44,13,0
56100,673,317,356,101,85,76,49,188,105,83,25,17,24,7,0
56101,426,231,195,51,52,45,24,1321,653,668,186,195,70,35,0
56102,710,352,358,104,86,84,41,462,229,233,63,49,42,18,0
56103,435,230,205,51,37,55,18,288,156,132,36,36,24,15,0
56104,1208,575,633,187,204,117,41,234,129,105,31,22,19,17,0
56105,785,325,460,114,123,61,28,98,49,49,14,15,9,2,0
56106,1835,904,931,192,144,135,63,415,205,210,77,52,55,17,0
56107,548,310,238,72,62,54,13,2724,1157,1567,269,518,239,77,0
56108,279,127,152,50,36,28,8,535,311,224,66,52,49,24,0
56109,144,57,87,38,26,10,4,724,353,371,94,95,71,31,0
56110,1221,597,624,201,152,83,31,222,127,95,23,28,22,7,0
56111,760,405,355,112,95,92,29,334,182,152,45,41,27,13,0
56112,365,222,143,44,24,35,11,91,44,47,9,12,4,7,0
56113,374,202,172,58,40,41,7,375,176,199,48,61,40,12,0
56114,928,442,486,139,118,91,43,338,169,169,53,44,39,21,0
56115,193,105,88,33,16,9,4,465,252,213,73,58,60,18,0
56116,1023,449,574,141,174,76,43,475,251,224,67,49,48,23,0
56117,346,186,160,40,37,34,21,135,57,78,21,20,9,11,0
56118,631,316,315,64,57,49,15,331,180,151,46,35,47,17,0
56119,372,189,183,60,44,41,18,403,192,211,102,39,49,15,0
56120,346,186,160,40,37,34,21,332,180,152,46,36,28,14,0
56121,2236,1195,1041,227,187,186,118,354,183,171,54,43,49,8,0
56122,291,131,160,49,35,32,15,601,279,322,81,65,27,12,0
56123,261,148,113,23,29,26,21,2202,1121,1081,338,274,269,81,0
56124,222,108,114,37,20,25,12,350,196,154,52,37,21,14,0
56125,196,107,89,20,31,17,4,204,96,108,31,37,20,5,0
56126,500,245,255,66,57,52,27,463,268,195,59,46,46,21,0
56127,531,284,247,66,42,49,15,222,122,100,39,32,24,9,0
56128,213,88,125,21,54,14,15,286,160,126,37,27,23,10,0
56129,261,130,131,27,41,19,16,376,183,193,50,50,43,21,0
56130,395,195,200,41,55,23,10,1061,543,518,146,123,109,67,0
56131,664,269,395,117,107,36,15,337,152,185,49,54,42,21,0
56132,302,178,124,34,29,50,13,251,143,108,47,25,29,11,0
56133,490,198,292,65,81,39,27,2517,1275,1242,304,324,245,135,0
56134,469,253,216,49,51,48,18,277,145,132,41,32,22,10,0
56135,414,216,198,51,32,42,28,661,325,336,81,75,65,28,0
56136,225,111,114,38,22,25,10,403,192,211,102,39,49,15,0
56137,136,66,70,33,11,9,5,296,159,137,49,28,38,13,0
56138,681,367,314,83,74,78,31,439,231,208,65,51,55,17,0
56139,193,105,88,33,16,9,4,485,244,241,80,55,59,20,0
56140,418,163,255,57,54,38,24,1061,543,518,146,123,109,67,0
56141,979,534,445,83,77,80,24,94,45,49,11,20,10,4,0
56142,413,206,207,38,55,19,10,390,190,200,66,50,43,12,0
56143,403,176,227,71,56,51,11,1241,619,622,183,169,155,59,0
56144,684,353,331,95,98,77,38,335,186,149,40,28,29,13,0
56145,186,56,130,46,50,16,7,386,181,205,55,51,57,31,0
56146,136,66,70,33,11,9,5,218,114,104,32,31,33,11,0
56147,895,388,507,130,84,90,31,332,180,152,44,36,27,13,0
56148,206,96,110,33,25,8,6,130,67,63,24,10,12,4,0
56149,753,361,392,99,94,66,16,181,75,106,35,26,11,9,0
56150,144,57,87,38,26,10,4,710,375,335,95,94,110,28,0
56151,766,336,430,133,97,79,21,1241,619,622,183,169,155,59,0
56152,365,148,217,86,37,51,28,188,93,95,33,18,16,10,0
56153,526,268,258,54,37,55,12,741,383,358,92,63,79,36,0
56154,861,393,468,150,101,69,35,1239,659,580,169,148,131,54,0
56155,784,353,431,56,47,26,18,352,207,145,40,33,25,21,0
56156,130,70,60,30,9,8,1,1034,495,539,150,134,114,71,0
56157,426,196,230,76,65,54,20,164,79,85,28,28,16,7,0
56158,583,279,304,99,71,59,31,241,127,114,34,33,29,12,0
56159,126,58,68,31,10,10,3,1239,659,580,169,148,131,54,0
56160,1249,543,706,187,164,125,52,380,211,169,47,37,33,21,0
56161,376,171,205,45,45,34,12,91,42,49,21,9,8,3,0
56162,340,181,159,44,39,35,21,133,61,72,21,19,13,4,0
56163,454,230,224,63,56,38,33,300,148,152,45,43,40,8,0
56164,57,24,33,11,3,5,3,328,199,129,39,29,27,14,0
56165,1647,794,853,279,235,128,65,405,214,191,53,42,49,20,0
56166,450,227,223,53,36,48,12,1352,602,750,166,185,81,70,0
56167,176,74,102,20,29,7,7,464,236,228,64,56,53,28,0
56168,350,212,138,32,26,40,13,406,223,183,61,53,46,17,0
56169,249,104,145,47,41,24,17,4646,2328,2318,674,639,475,170,0
56170,640,271,369,111,79,57,17,145,77,68,26,7,15,8,0
56171,622,354,268,89,60,64,18,199,105,94,27,27,28,9,0
56172,325,181,144,46,31,48,9,689,343,346,105,102,81,35,0
56173,350,178,172,49,62,29,16,338,169,169,53,44,39,21,0
56174,303,147,156,49,49,20,8,201,99,102,34,26,23,6,0
56175,1096,563,533,158,136,120,53,396,199,197,54,50,45,14,0
56176,419,210,209,54,44,31,23,441,189,252,73,50,47,23,0
56177,473,265,208,47,26,50,30,496,251,245,78,62,61,23,0
56178,589,282,307,68,67,70,23,375,176,199,48,61,40,12,0
56179,213,113,100,26,21,26,12,145,77,68,26,7,15,8,0
56180,338,173,165,31,42,22,10,432,244,188,51,51,27,14,0
56181,193,95,98,33,17,25,17,729,358,371,116,99,89,33,0
56182,83,45,38,11,8,8,3,234,116,118,34,35,23,9,0
56183,280,156,124,36,19,20,13,188,88,100,53,12,15,6,0
56184,341,183,158,36,34,36,15,169,84,85,29,19,21,7,0
56185,345,203,142,47,35,31,11,270,162,108,26,26,16,11,0
56186,1360,644,716,213,194,136,62,974,457,517,133,117,69,26,0
56187,473,217,256,59,44,34,21,447,212,235,86,55,58,21,0
56188,1867,973,894,256,222,194,65,317,161,156,50,36,47,12,0
56189,733,438,295,95,79,67,32,207,113,94,33,18,30,9,0
56190,313,158,155,43,35,43,16,286,160,126,37,27,23,10,0
56191,284,128,156,48,29,34,8,218,114,104,32,31,33,11,0
56192,340,145,195,46,38,26,23,96,45,51,13,12,6,4,0
56193,238,91,147,68,19,22,7,749,384,365,108,105,86,31,0
56194,119,67,52,15,15,7,7,421,219,202,68,57,56,13,0
56195,443,250,193,52,23,49,13,222,124,98,37,29,22,9,0
56196,1087,523,564,146,177,103,33,373,181,192,54,35,44,20,0
56197,246,111,135,64,47,27,3,601,279,322,81,65,27,12,0
56198,952,547,405,95,90,127,35,218,115,103,37,33,33,9,0
56199,1226,513,713,184,147,87,43,452,254,198,72,57,38,18,0
56200,286,111,175,51,47,21,12,662,312,350,103,104,59,20,0
56201,425,220,205,60,55,45,18,457,253,204,67,51,48,13,0
56202,496,274,222,57,43,75,22,1543,794,749,182,152,132,55,0
56203,1214,498,716,197,180,121,65,320,168,152,38,42,24,18,0
56204,447,225,222,76,35,75,21,72,34,38,8,2,3,12,0
56205,210,101,109,33,33,19,9,218,111,107,45,29,24,6,0
56206,794,322,472,122,108,79,34,360,185,175,51,43,36,16,0
56207,607,294,313,94,95,62,14,391,165,226,67,64,36,27,0
56208,583,279,304,99,71,59,31,374,191,183,40,52,40,16,0
56209,886,440,446,116,140,95,45,138,69,69,28,7,10,10,0
56210,313,158,155,43,35,43,16,514,262,252,78,58,54,26,0
56211,894,448,446,123,100,82,30,285,143,142,45,32,21,17,0
56212,496,210,286,112,55,71,14,290,147,143,34,34,39,13,0
56213,380,185,195,68,54,32,16,230,125,105,29,40,20,6,0
56214,752,313,439,121,106,68,27,704,355,349,113,94,71,24,0
56215,479,227,252,69,48,46,18,332,155,177,55,51,44,13,0
56216,683,304,379,140,101,48,19,499,239,260,73,75,34,19,0
56217,203,80,123,40,37,20,3,1352,602,750,166,185,81,70,0
56218,584,297,287,89,80,65,17,602,310,292,87,66,70,36,0
56219,584,340,244,77,60,47,25,274,142,132,33,34,18,14,0
56220,244,104,140,52,31,30,14,375,210,165,49,37,29,27,0
56221,468,233,235,65,61,49,34,296,140,156,49,40,42,19,0
56222,57,24,33,11,3,5,3,119,61,58,17,12,10,6,0
56223,184,93,91,26,25,14,11,370,190,180,60,52,37,13,0
56224,2285,1219,1066,207,180,178,106,335,170,165,52,36,47,11,0
56225,911,441,470,123,108,60,21,402,186,216,64,47,38,20,0
56226,840,411,429,122,101,79,34,395,198,197,55,55,36,10,0
56227,388,209,179,46,24,31,28,279,142,137,43,39,28,7,0
56228,255,110,145,34,32,23,17,439,231,208,65,51,55,17,0
56229,169,64,105,23,37,11,3,222,125,97,34,27,27,7,0
56230,292,102,190,71,27,51,21,222,124,98,37,29,22,9,0
56231,1390,705,685,219,164,129,74,758,319,439,101,123,78,25,0
56232,507,314,193,49,45,59,25,1321,653,668,186,195,70,35,0
56233,463,250,213,56,45,73,25,376,183,193,50,50,43,21,0
56234,380,148,232,81,69,24,8,201,98,103,28,25,19,13,0
56235,302,160,142,35,35,37,10,775,407,368,122,100,97,32,0
56236,574,284,290,64,50,65,20,661,325,336,81,75,65,28,0
56237,128,67,61,29,9,9,1,1047,562,485,141,127,114,41,0
56238,707,250,457,171,84,117,61,619,305,314,85,93,71,29,0
56239,665,341,324,109,79,38,22,445,202,243,70,73,51,15,0
56240,157,62,95,41,18,10,11,417,232,185,58,50,29,21,0
56241,362,181,181,67,46,43,8,367,199,168,62,44,34,8,0
56242,435,225,210,58,46,50,14,381,187,194,37,49,36,17,0
56243,1709,650,1059,338,286,185,46,660,303,357,97,89,85,33,0
56244,516,224,292,79,29,45,33,339,175,164,51,49,37,9,0
56245,415,217,198,50,31,42,17,373,189,184,54,46,50,23,0
56246,577,251,326,92,84,60,11,368,183,185,40,42,40,15,0
56247,291,131,160,49,35,32,15,148,84,64,30,7,17,4,0
56248,785,351,434,136,93,71,37,1262,653,609,169,165,152,50,0
56249,2000,965,1035,357,313,198,75,209,119,90,28,24,27,9,0
56250,210,84,126,44,43,9,4,1279,669,610,164,162,104,55,0
56251,1835,904,931,192,144,135,63,471,238,233,66,63,62,19,0
56252,330,141,189,65,29,51,19,173,90,83,21,36,12,15,0
56253,575,290,285,67,70,28,9,975,400,575,160,162,62,31,0
56254,107,53,54,15,15,13,4,647,324,323,101,80,76,43,0
56255,1447,698,749,214,180,116,46,127,54,73,11,33,15,6,0
56256,415,133,282,114,65,27,7,396,213,183,68,44,47,18,0
56257,275,125,150,37,48,27,7,359,171,188,49,74,45,11,0
56258,516,224,292,79,29,45,33,406,202,204,54,51,63,21,0
56259,204,93,111,35,35,16,11,462,229,233,63,49,42,18,0
56260,516,210,306,113,53,81,33,381,196,185,55,57,43,16,0
56261,284,160,124,37,23,32,11,818,357,461,122,136,54,25,0
56262,908,324,584,181,162,81,29,295,160,135,44,36,46,16,0
56263,431,202,229,57,50,50,25,654,295,359,99,88,71,25,0
56264,854,435,419,118,91,95,42,264,138,126,33,34,29,12,0
56265,603,311,292,102,71,66,23,154,78,76,23,21,13,5,0
56266,124,58,66,20,28,11,7,1500,804,696,190,172,144,60,0
56267,264,122,142,46,24,35,10,492,278,214,65,58,32,11,0
56268,1041,497,544,180,167,98,34,662,373,289,89,80,77,29,0
56269,299,128,171,57,40,13,25,374,181,193,55,58,48,23,0
56270,127,54,73,31,10,11,3,1425,670,755,153,189,122,85,0
56271,349,167,182,54,38,30,28,749,384,365,108,105,86,31,0
56272,411,236,175,39,45,50,30,508,262,246,66,67,51,20,0
56273,260,136,124,24,41,19,4,906,455,451,116,105,87,46,0
56274,365,148,217,86,37,51,28,783,406,377,102,91,57,29,0
56275,278,110,168,58,49,29,5,175,91,84,19,21,21,10,0
56276,71,28,43,15,9,5,2,317,161,156,50,36,47,12,0
56277,288,140,148,59,33,27,12,1113,480,633,170,173,81,34,0
56278,412,146,266,106,38,67,35,139,68,71,14,26,14,9,0
56279,440,267,173,52,29,42,12,1352,602,750,166,185,81,70,0
56280,507,314,193,49,45,59,25,507,270,237,89,59,57,22,0
56281,492,253,239,73,67,77,29,898,469,429,125,125,134,35,0
56282,176,74,102,20,29,7,7,866,478,388,121,101,101,26,0
56283,979,534,445,83,77,80,24,397,223,174,50,39,29,17,0
56284,801,331,470,151,139,99,55,2202,1121,1081,338,274,269,81,0
56285,474,243,231,66,54,41,29,374,191,183,40,52,40,16,0
56286,1058,497,561,194,142,87,63,866,397,469,117,153,95,48,0
56287,269,156,113,37,32,17,7,1378,692,686,194,174,105,56,0
56288,739,323,416,127,89,76,33,564,264,300,79,84,65,26,0
56289,536,237,299,116,87,42,17,662,312,350,103,104,59,20,0
56290,472,222,250,46,61,33,23,323,168,155,51,41,38,12,0
56291,708,344,364,106,98,66,33,1265,689,576,169,177,128,60,0
56292,213,113,100,26,21,26,12,396,199,197,54,50,45,14,0
56293,450,241,209,67,58,54,23,520,240,280,67,72,42,14,0
56294,273,126,147,54,49,25,18,501,249,252,77,70,55,22,0
56295,580,265,315,97,89,79,17,461,223,238,45,62,18,35,0
56296,552,295,257,67,49,70,30,262,129,133,40,41,31,10,0
56297,76,30,46,7,15,1,5,873,411,462,132,107,84,40,0
56298,165,66,99,28,32,16,3,270,162,108,26,26,16,11,0
56299,376,176,200,31,53,27,8,137,85,52,15,11,11,2,0
56300,484,261,223,59,48,49,24,601,278,323,124,87,65,21,0
56301,546,278,268,94,60,32,22,1378,692,686,194,174,105,56,0
56302,616,304,312,75,71,55,25,344,190,154,34,31,36,10,0
56303,598,300,298,68,77,59,21,410,197,213,67,43,56,18,0
56304,552,295,257,67,49,70,30,250,119,131,58,26,29,7,0
56305,325,186,139,49,36,20,5,312,165,147,41,39,29,16,0
56306,236,120,116,32,28,21,11,375,211,164,50,36,31,23,0
56307,648,376,272,70,60,73,24,749,384,365,108,105,86,31,0
56308,225,111,114,38,22,25,10,242,121,121,39,30,29,10,0
56309,399,220,179,48,37,68,18,520,272,248,60,65,58,22,0
56310,535,217,318,87,106,41,14,188,101,87,20,18,20,14,0
56311,411,236,175,39,45,50,30,1208,565,643,182,162,120,57,0
56312,326,154,172,45,39,20,10,201,93,108,34,39,21,6,0
56313,325,186,139,49,36,20,5,671,306,365,114,76,49,19,0
56314,494,233,261,87,57,46,18,198,86,112,36,27,23,9,0
56315,465,240,225,50,54,24,14,375,176,199,48,61,40,12,0
56316,1121,458,663,158,210,76,47,1040,564,476,134,110,114,51,0
56317,401,183,218,72,73,28,10,222,119,103,37,32,24,8,0
56318,388,209,179,46,24,31,28,363,180,183,60,34,10,6,0
56319,437,212,225,66,44,44,11,203,98,105,34,29,19,10,0
56320,915,336,579,185,199,56,29,332,173,159,48,40,31,11,0
56321,1501,679,822,251,196,174,67,621,310,311,100,106,77,27,0
56322,251,131,120,49,35,25,5,732,366,366,108,86,74,41,0
56323,674,318,356,86,139,50,11,277,138,139,40,39,20,14,0
56324,1594,660,934,251,272,117,77,541,279,262,79,82,31,32,0
56325,1041,497,544,180,167,98,34,337,170,167,59,33,47,17,0
56326,1759,838,921,269,212,191,92,127,54,73,11,33,15,6,0
56327,933,456,477,123,108,83,29,418,246,172,52,39,57,10,0
56328,334,155,179,47,34,38,11,111,60,51,17,23,10,7,0
56329,785,374,411,56,42,38,25,276,149,127,34,31,32,10,0
56330,785,374,411,56,42,38,25,507,270,237,89,59,57,22,0
56331,570,238,332,112,95,39,23,231,126,105,28,26,34,9,0
56332,854,435,419,118,91,95,42,247,128,119,34,14,16,14,0
56333,535,217,318,87,106,41,14,153,80,73,26,18,19,4,0
56334,280,128,152,39,37,38,18,164,79,85,28,28,16,7,0
56335,227,109,118,42,35,29,8,479,215,264,67,80,46,28,0
56336,873,366,507,127,125,75,21,276,149,127,34,31,32,10,0
56337,521,289,232,71,58,49,16,392,186,206,62,56,29,15,0
56338,128,69,59,29,9,8,1,246,125,121,38,36,30,11,0
56339,317,140,177,43,26,31,16,386,207,179,43,48,44,19,0
56340,879,457,422,93,98,143,32,399,190,209,61,41,39,18,0
56341,538,263,275,71,85,44,18,349,200,149,41,39,30,20,0
56342,452,202,250,83,60,56,19,424,179,245,65,67,29,11,0
56343,941,459,482,167,140,82,38,479,215,264,67,80,46,28,0
56344,335,148,187,52,26,51,12,309,159,150,47,43,43,13,0
56345,425,210,215,56,43,52,25,1139,537,602,162,139,109,50,0
56346,653,379,274,89,56,86,13,325,159,166,59,46,30,12,0
56347,772,332,440,136,104,72,28,701,380,321,94,84,96,34,0
56348,648,376,272,70,60,73,24,326,149,177,51,51,28,10,0
56349,446,265,181,51,35,27,17,1507,737,770,188,228,147,71,0
56350,895,388,507,130,84,90,31,1395,627,768,172,263,141,59,0
56351,128,67,61,29,9,9,1,418,223,195,53,43,49,15,0
56352,475,208,267,84,67,50,20,123,61,62,17,18,17,7,0
56353,222,108,114,37,20,25,12,299,140,159,49,44,26,11,0
56354,461,257,204,63,49,50,29,732,402,330,81,86,87,33,0
56355,465,240,225,50,54,24,14,96,46,50,16,12,7,5,0
56356,1009,478,531,166,126,96,42,821,394,427,122,117,109,38,0
56357,717,381,336,118,103,85,29,1382,508,874,334,320,98,36,0
56358,125,57,68,31,10,10,3,627,323,304,81,90,53,27,0
56359,580,308,272,82,79,58,25,457,245,212,62,58,57,21,0
56360,426,196,230,76,65,54,20,262,129,133,40,41,31,10,0
56361,595,339,256,64,36,54,24,723,353,370,120,109,96,33,0
56362,911,441,470,123,108,60,21,232,111,121,23,29,17,9,0
56363,331,144,187,57,46,33,19,368,200,168,54,49,43,9,0
56364,327,174,153,42,35,16,12,380,211,169,47,37,33,21,0
56365,512,254,258,70,48,37,32,308,146,162,42,39,24,12,0
56366,531,284,247,66,42,49,15,406,202,204,54,51,63,21,0
56367,813,412,401,114,93,112,26,535,301,234,63,48,47,27,0
56368,338,172,166,59,30,39,18,715,345,370,110,97,64,25,0
56369,760,405,355,112,95,92,29,1239,659,580,169,148,131,54,0
56370,125,46,79,24,16,12,2,326,169,157,51,41,41,12,0
56371,577,342,235,63,57,23,37,262,129,133,40,41,31,10,0
56372,1580,742,838,208,146,144,71,1214,475,739,177,250,89,49,0
56373,1200,602,598,145,116,110,50,145,77,68,26,7,15,8,0
56374,375,201,174,52,56,39,15,106,46,60,29,13,14,5,0
56375,172,98,74,20,21,22,8,132,61,71,19,20,14,6,0
56376,224,101,123,45,32,21,3,119,61,58,17,12,10,6,0
56377,443,206,237,76,68,52,28,1001,417,584,186,147,96,47,0
56378,431,216,215,46,40,33,9,137,78,59,22,16,17,4,0
56379,533,300,233,74,50,74,17,1004,457,547,150,150,74,52,0
56380,338,208,130,39,30,35,12,179,101,78,25,15,13,13,0
56381,107,53,54,15,15,13,4,2517,1275,1242,304,324,245,135,0
56382,127,48,79,27,20,6,5,403,184,219,75,51,47,20,0
56383,225,111,114,38,22,25,10,974,457,517,133,117,69,26,0
56384,760,405,355,112,95,92,29,422,237,185,53,47,62,20,0
56385,243,70,173,54,65,8,6,218,118,100,33,30,25,11,0
56386,251,139,112,41,18,27,11,360,185,175,51,43,36,16,0
56387,554,217,337,112,72,90,38,679,338,341,96,95,40,23,0
56388,488,237,251,79,78,65,27,556,290,266,75,74,29,24,0
56389,330,151,179,68,36,56,9,572,305,267,74,72,58,21,0
56390,364,168,196,64,61,27,6,230,113,117,31,40,28,10,0
56391,493,281,212,56,61,30,13,715,345,370,110,97,64,25,0
56392,463,170,293,115,54,75,32,308,129,179,44,60,19,8,0
56393,784,353,431,56,47,26,18,127,66,61,13,14,19,8,0
56394,180,57,123,39,22,10,8,679,338,341,96,95,40,23,0
56395,1009,487,522,177,121,103,51,1166,514,652,150,159,107,70,0
56396,55,16,39,24,2,5,2,2038,1059,979,262,237,208,100,0
56397,346,208,138,46,39,51,18,1047,562,485,141,127,114,41,0
56398,801,331,470,151,139,99,55,978,536,442,132,107,67,32,0
56399,1023,449,574,141,174,76,43,471,238,233,66,63,62,19,0
56400,458,210,248,39,38,25,16,602,310,292,87,66,70,36,0
56401,255,126,129,41,37,13,5,296,159,137,49,28,38,13,0
56402,959,496,463,144,132,75,35,547,295,252,81,65,57,23,0
56403,71,39,32,7,11,6,4,328,199,129,39,29,27,14,0
56404,237,127,110,34,30,16,9,179,101,78,25,15,13,13,0
56405,181,75,106,35,26,11,9,149,68,81,15,38,11,10,0
56406,763,354,409,101,90,63,26,693,360,333,100,88,62,26,0
56407,1835,904,931,192,144,135,63,89,42,47,16,12,15,6,0
56408,414,195,219,51,60,40,17,106,54,52,12,9,7,6,0
56409,107,53,54,15,15,13,4,562,273,289,76,92,45,24,0
56410,291,142,149,50,29,35,7,203,98,105,34,29,19,10,0
56411,366,190,176,39,62,55,14,906,455,451,116,105,87,46,0
56412,122,56,66,26,13,11,5,104,46,58,15,17,9,5,0
56413,364,168,196,64,61,27,6,290,142,148,41,37,43,11,0
56414,752,313,439,121,106,68,27,125,66,59,24,16,11,5,0
56415,494,233,261,87,57,46,18,583,280,303,95,66,76,25,0
56416,425,177,248,60,62,33,16,510,243,267,65,67,44,44,0
56417,1417,598,819,223,188,135,58,483,258,225,70,53,54,20,0
56418,1041,497,544,180,167,98,34,348,194,154,57,31,43,12,0
56419,262,133,129,44,38,31,12,303,137,166,54,54,31,15,0
56420,1616,735,881,285,248,153,72,1208,565,643,182,162,120,57,0
56421,1556,718,838,280,182,161,49,598,333,265,79,66,54,33,0
56422,401,204,197,49,33,29,17,296,140,156,49,40,42,19,0
56423,401,204,197,49,33,29,17,173,90,83,21,36,12,15,0
56424,636,288,348,94,77,65,30,198,110,88,27,27,24,4,0
56425,292,102,190,71,27,51,21,323,171,152,48,41,40,16,0
56426,334,190,144,42,42,16,5,1154,489,665,200,196,95,54,0
56427,805,338,467,153,138,99,55,261,148,113,31,28,14,10,0
56428,531,260,271,97,68,47,11,231,126,105,37,26,29,6,0
56429,236,141,95,36,32,14,6,562,273,289,76,92,45,24,0
56430,575,290,285,67,70,28,9,86,40,46,16,13,9,7,0
56431,330,182,148,47,27,40,11,405,214,191,53,42,49,20,0
56432,640,279,361,102,83,69,21,406,223,183,61,53,46,17,0
56433,798,287,511,126,125,77,26,693,360,333,100,88,62,26,0
56434,331,169,162,40,28,22,14,139,68,71,14,26,14,9,0
56435,163,70,93,28,21,17,6,497,227,270,70,63,66,30,0
56436,136,66,70,33,11,9,3,223,113,110,31,33,22,12,0
56437,213,114,99,62,7,2,1,972,471,501,152,138,112,40,0
56438,392,205,187,83,49,38,10,749,384,365,108,105,86,31,0
56439,802,375,427,133,103,81,41,602,310,292,87,66,70,36,0
56440,435,230,205,51,37,55,18,1265,689,576,169,177,128,60,0
56441,543,265,278,52,37,54,19,373,189,184,54,46,50,23,0
56442,218,133,85,20,19,13,6,173,86,87,30,22,19,12,0
56443,272,141,131,45,29,36,9,373,189,184,54,46,50,23,0
56444,301,150,151,45,47,33,13,1500,804,696,190,172,144,60,0
56445,521,289,232,71,58,49,16,314,151,163,42,61,39,16,0
56446,798,287,511,126,125,77,26,89,51,38,15,15,5,4,0
56447,682,292,390,89,69,58,20,234,129,105,31,22,19,17,0
56448,531,260,271,97,68,47,11,218,118,100,33,30,25,11,0
56449,330,151,179,68,36,56,9,204,96,108,31,37,20,5,0
56450,309,137,172,51,50,28,14,2724,1157,1567,269,518,239,77,0
56451,359,204,155,39,36,34,13,139,68,71,14,26,14,9,0
56452,476,199,277,82,80,49,24,375,176,199,48,61,40,12,0
56453,451,225,226,69,57,64,22,316,159,157,38,48,30,11,0
56454,264,122,142,33,29,13,13,241,127,114,34,33,29,12,0
56455,342,185,157,42,27,31,14,1182,591,591,155,139,83,46,0
56456,413,206,207,38,55,19,10,704,355,349,113,94,71,24,0
56457,98,32,66,15,25,5,4,601,279,322,81,65,27,12,0
56458,372,171,201,47,53,39,18,582,264,318,84,60,58,23,0
56459,338,164,174,45,32,37,13,329,196,133,41,36,31,15,0
56460,465,220,245,88,34,61,23,609,335,274,79,57,45,22,0
56461,631,304,327,98,75,52,23,294,146,148,50,45,51,15,0
56462,1051,429,622,179,148,125,54,464,236,228,64,56,53,28,0
56463,1849,931,918,245,220,158,90,332,180,152,46,36,28,14,0
56464,164,61,103,47,19,14,5,329,194,135,45,32,33,9,0
56465,2525,1232,1293,398,317,186,61,374,212,162,48,40,32,23,0
56466,1249,543,706,187,164,125,52,91,42,49,21,9,8,3,0
56467,347,198,149,45,29,29,8,326,169,157,51,41,41,12,0
56468,325,186,139,49,36,20,5,328,199,129,39,29,27,14,0
56469,894,448,446,123,100,82,30,86,40,46,16,13,9,7,0
56470,446,265,181,51,35,27,17,673,313,360,102,101,46,17,0
56471,156,64,92,31,19,5,4,201,93,108,34,39,21,6,0
56472,469,221,248,49,60,55,21,279,142,137,43,39,28,7,0
56473,677,361,316,81,61,42,22,462,229,233,63,49,42,18,0
56474,282,105,177,77,28,39,6,482,232,250,77,81,44,13,0
56475,126,58,68,31,10,10,3,375,176,199,48,61,40,12,0
56476,346,205,141,47,34,30,7,286,160,126,37,27,23,10,0
56477,911,441,470,123,108,60,21,132,77,55,20,9,13,10,0
56478,919,493,426,100,92,88,49,373,189,184,54,46,50,23,0
56479,426,196,230,76,65,54,20,535,288,247,79,72,35,21,0
56480,276,149,127,45,34,39,9,194,109,85,23,24,21,9,0
56481,484,192,292,118,68,83,22,323,168,155,51,41,38,12,0
56482,789,362,427,90,82,70,35,663,360,303,87,82,80,35,0
56483,867,415,452,123,87,62,27,524,300,223,70,54,51,25,0
56484,281,154,127,45,31,24,9,453,247,206,58,53,45,20,0
56485,227,109,118,42,35,29,8,295,156,139,41,40,42,15,0
56486,441,218,223,69,55,50,27,748,359,389,125,113,86,31,0
56487,956,450,506,122,117,82,36,251,143,108,47,25,29,11,0
56488,745,402,343,95,71,69,40,593,289,304,85,69,48,19,0
56489,270,166,104,30,26,28,14,132,61,71,22,21,15,3,0
56490,577,251,326,92,84,60,11,434,213,221,77,62,53,12,0
56491,786,378,408,106,98,77,39,137,78,59,22,16,17,4,0
56492,674,268,406,118,96,70,21,415,205,210,77,52,55,17,0
56493,367,167,200,63,42,60,17,188,90,98,44,7,21,7,0
56494,1341,481,860,275,264,57,21,485,244,241,80,55,59,20,0
56495,261,148,113,23,29,26,21,123,61,62,17,18,17,7,0
56496,557,211,346,129,125,48,19,373,189,184,54,46,50,23,0
56497,357,182,175,49,36,39,15,175,82,93,33,26,17,5,0
56498,629,374,255,74,53,87,27,480,255,225,67,64,50,22,0
56499,215,104,111,61,7,2,1,132,67,65,24,21,8,10,0
56500,687,351,336,106,67,70,41,201,98,103,28,25,19,13,0
56501,747,360,387,125,92,69,32,370,190,180,60,52,37,13,0
56502,1544,738,806,239,217,145,91,902,499,403,118,117,92,35,0
56503,317,167,150,45,21,30,26,452,254,198,72,57,38,18,0
56504,532,291,241,83,36,79,25,660,333,327,102,95,69,31,0
56505,234,110,124,39,29,23,2,374,202,172,50,39,31,24,0
56506,594,279,315,93,68,68,26,187,89,98,36,24,20,6,0
56507,548,310,238,72,62,54,13,622,344,278,80,77,68,36,0
56508,365,222,143,44,24,35,11,530,287,243,79,70,33,26,0
56509,225,111,114,38,22,25,10,736,388,348,88,85,67,28,0
56510,467,233,234,83,37,77,22,727,388,339,102,87,70,29,0
56511,2063,1024,1039,175,117,80,97,363,180,183,60,34,10,6,0
56512,509,251,258,69,49,55,17,189,105,84,25,26,21,9,0
56513,333,171,162,50,34,19,8,145,77,68,26,7,15,8,0
56514,755,271,484,113,226,61,20,148,84,64,30,7,17,4,0
56515,900,434,466,134,97,86,36,966,478,488,108,144,74,43,0
56516,327,174,153,42,35,16,12,180,89,91,28,27,18,7,0
56517,350,190,160,48,25,27,18,201,104,97,36,32,24,7,0
56518,577,277,300,71,59,64,24,1014,488,526,178,137,94,39,0
56519,336,199,137,46,22,51,13,515,276,239,62,59,43,31,0
56520,496,274,222,57,43,75,22,592,249,343,91,90,50,42,0
56521,960,409,551,166,134,77,44,132,77,55,20,9,13,10,0
56522,1835,904,931,192,144,135,63,461,223,238,45,62,18,35,0
56523,3703,1708,1995,456,428,305,162,339,175,164,51,49,37,9,0
56524,380,148,232,81,69,24,8,294,146,148,50,45,51,15,0
56525,1148,472,676,229,164,86,37,132,61,71,22,21,15,3,0
56526,162,73,89,32,19,4,4,278,154,124,42,32,38,7,0
56527,280,128,152,39,37,38,18,169,85,84,21,14,9,9,0
56528,338,173,165,31,42,22,10,953,489,464,126,104,111,44,0
56529,927,457,470,130,99,118,42,277,138,139,40,39,20,14,0
56530,561,282,279,68,62,36,14,68,36,32,11,8,9,2,0
56531,310,141,169,36,38,20,8,160,76,84,19,24,8,5,0
56532,667,366,301,96,55,84,25,593,289,304,85,69,48,19,0
56533,840,411,429,122,101,79,34,349,200,149,41,39,30,20,0
56534,1544,738,806,239,217,145,91,88,50,38,13,8,16,4,0
56535,178,89,89,40,12,18,7,72,33,39,8,2,3,12,0
56536,118,56,62,15,20,9,5,826,362,464,107,118,71,43,0
56537,456,223,233,77,54,47,20,398,200,198,68,43,51,14,0
56538,326,148,178,55,42,31,12,1101,626,475,145,122,120,50,0
56539,339,170,169,32,17,24,13,239,113,126,36,49,20,8,0
56540,496,209,287,113,55,72,14,810,310,500,164,162,42,26,0
56541,119,59,60,29,10,6,4,975,400,575,160,162,62,31,0
56542,580,281,299,95,60,74,29,101,59,42,11,17,10,1,0
56543,346,186,160,40,37,34,21,307,132,175,48,53,26,10,0
56544,136,66,70,33,11,9,3,662,373,289,89,80,77,29,0
56545,1217,647,570,142,160,129,45,166,78,88,27,25,19,7,0
56546,249,114,135,47,33,25,4,598,333,265,79,66,54,33,0
56547,433,188,245,63,45,26,14,455,229,226,66,62,63,29,0
56548,423,247,176,58,55,29,20,106,46,60,27,18,12,3,0
56549,428,226,202,52,60,75,20,480,255,225,67,64,50,22,0
56550,366,190,176,39,62,55,14,453,255,198,62,49,29,19,0
56551,533,300,233,74,50,74,17,504,272,232,75,57,53,19,0
56552,747,360,387,125,92,69,32,708,328,380,113,100,82,34,0
56553,261,130,131,27,41,19,16,201,104,97,36,32,24,7,0
56554,733,382,351,126,92,93,27,561,279,282,85,81,88,24,0
56555,756,362,394,102,104,73,25,173,90,83,21,36,12,15,0
56556,1835,904,931,192,144,135,63,323,162,161,52,41,39,13,0
56557,824,391,433,106,90,88,32,178,99,79,31,19,26,8,0
56558,368,201,167,61,38,38,12,192,91,101,29,28,17,7,0
56559,615,308,307,83,75,58,32,218,114,104,32,31,33,11,0
56560,391,204,187,47,48,38,18,137,72,65,27,13,15,8,0
56561,346,173,173,50,56,31,14,103,50,53,19,10,7,5,0
56562,249,104,145,47,41,24,17,582,264,318,84,60,58,23,0
56563,200,94,106,33,22,18,8,455,229,226,66,62,63,29,0
56564,1105,544,561,165,167,99,40,541,279,262,79,82,31,32,0
56565,1009,487,522,177,121,103,51,873,411,462,132,107,84,40,0
56566,472,222,250,46,61,33,23,485,244,241,80,55,59,20,0
56567,384,198,186,58,48,37,12,1025,549,476,118,109,88,61,0
56568,540,257,283,81,63,57,24,90,41,49,17,15,5,8,0
56569,301,119,182,53,47,14,20,153,80,73,26,18,19,4,0
56570,443,206,237,76,68,52,28,397,234,163,44,38,23,21,0
56571,1014,488,526,178,137,94,39,308,146,162,42,39,24,12,0
56572,785,351,434,136,93,71,37,862,409,453,149,125,86,29,0
56573,510,288,222,44,36,24,7,108,59,49,17,13,12,5,0
56574,407,164,243,88,42,40,22,455,191,264,68,86,21,19,0
56575,308,129,179,44,60,19,8,132,77,55,20,9,13,10,0
56576,452,217,235,59,47,60,20,166,78,88,27,25,19,7,0
56577,284,160,124,37,23,32,11,425,177,248,60,62,33,16,0
56578,203,80,123,40,37,20,3,966,478,488,108,144,74,43,0
56579,210,101,109,33,33,19,9,385,212,173,57,40,39,21,0
56580,1390,705,685,219,164,129,74,201,99,102,34,26,23,6,0
56581,546,278,268,94,60,32,22,328,195,133,39,40,27,13,0
56582,282,160,122,36,28,27,7,257,126,131,61,24,22,8,0
56583,527,254,273,67,66,70,31,364,189,175,58,41,35,17,0
56584,261,137,124,34,23,13,8,339,175,164,51,49,37,9,0
56585,398,186,212,76,70,18,13,149,52,97,36,36,7,4,0
56586,4640,2231,2409,660,549,437,245,300,148,152,45,43,40,8,0
56587,575,290,285,67,70,28,9,390,190,200,66,50,43,12,0
56588,500,257,243,60,55,27,22,963,525,438,119,102,102,34,0
56589,594,321,273,98,59,57,23,898,469,429,125,125,134,35,0
56590,446,265,181,51,35,27,17,234,116,118,34,35,23,9,0
56591,162,73,89,32,19,4,4,903,436,467,128,116,83,33,0
56592,385,203,182,47,43,51,21,439,231,208,65,51,55,17,0
56593,265,165,100,32,19,27,5,329,194,135,45,32,33,9,0
56594,446,283,163,51,26,33,19,367,218,149,45,43,42,16,0
56595,1718,735,983,266,225,130,68,326,169,157,51,41,41,12,0
56596,422,207,215,79,38,53,23,467,240,227,65,65,51,23,0
56597,416,207,209,63,47,56,15,198,86,112,36,27,23,9,0
56598,557,250,307,70,47,51,22,194,109,85,23,24,21,9,0
56599,1009,487,522,177,121,103,51,561,279,282,85,81,88,24,0
56600,502,250,252,70,47,57,15,166,102,64,19,14,17,2,0
56601,956,450,506,122,117,82,36,464,236,228,64,56,53,28,0
56602,772,332,440,136,104,72,28,314,151,163,42,61,39,16,0
56603,224,108,116,31,32,22,8,1425,670,755,153,189,122,85,0
56604,1718,735,983,266,225,130,68,455,229,226,66,62,63,29,0
56605,290,156,134,44,29,39,9,231,126,105,28,26,34,9,0
56606,1276,607,669,192,178,136,63,332,155,177,55,51,44,13,0
56607,756,362,394,102,104,73,25,266,150,116,28,28,24,12,0
56608,146,73,73,18,24,17,9,335,170,165,52,36,47,11,0
56609,802,430,372,65,102,87,23,509,267,242,79,81,38,20,0
56610,929,410,519,187,146,53,30,538,274,264,84,67,52,35,0
56611,369,207,162,67,35,16,14,239,113,126,36,49,20,8,0
56612,107,56,51,18,16,12,5,346,196,150,43,26,27,14,0
56613,86,50,36,9,14,8,7,270,162,108,26,26,16,11,0
56614,1226,513,713,184,147,87,43,344,190,154,34,31,36,10,0
56615,600,324,276,89,73,45,39,246,107,139,55,33,27,11,0
56616,278,104,174,46,34,23,14,751,394,357,107,96,73,35,0
56617,692,305,387,100,97,78,30,600,254,346,104,100,44,17,0
56618,331,165,166,52,34,48,22,2542,1245,1297,285,287,170,84,0
56619,347,198,149,45,29,29,8,103,59,44,25,2,13,6,0
56620,625,283,342,93,89,67,25,673,313,360,102,101,46,17,0
56621,615,308,307,83,75,58,32,277,163,114,33,24,21,16,0
56622,164,77,87,33,19,6,7,102,51,51,12,15,12,3,0
56623,1912,880,1032,331,334,180,84,204,80,124,29,51,10,5,0
56624,580,308,272,82,79,58,25,173,90,83,21,36,12,15,0
56625,270,158,112,35,20,23,7,1543,794,749,182,152,132,55,0
56626,221,80,141,48,37,14,10,404,190,214,55,55,35,27,0
56627,619,289,330,67,77,36,19,607,293,314,98,71,62,32,0
56628,840,411,429,122,101,79,34,602,310,292,87,66,70,36,0
56629,626,300,326,91,82,68,26,381,186,195,69,55,46,15,0
56630,349,131,218,66,76,22,9,96,46,50,16,12,7,5,0
56631,301,157,144,31,28,34,9,277,138,139,40,39,20,14,0
56632,361,177,184,59,51,24,15,188,93,95,33,18,16,10,0
56633,507,242,265,53,44,31,22,418,223,195,51,45,49,14,0
56634,315,170,145,48,56,22,11,601,279,322,81,65,27,12,0
56635,461,257,204,63,49,50,29,153,65,88,28,21,20,8,0
56636,452,217,235,59,47,60,20,166,90,76,27,18,21,5,0
56637,680,308,372,82,72,71,40,386,181,205,55,51,57,31,0
56638,388,244,144,46,25,42,16,508,261,247,65,53,58,23,0
56639,4128,2104,2024,581,505,453,205,294,146,148,50,45,51,15,0
56640,603,311,292,102,71,66,23,514,248,266,86,82,52,22,0
56641,106,43,63,28,13,8,1,404,190,214,55,55,35,27,0
56642,919,444,475,141,148,62,20,87,51,35,15,9,9,4,0
56643,773,383,390,108,76,79,30,257,139,118,64,17,24,7,0
56644,425,199,226,54,71,56,11,332,173,159,48,40,31,11,0
56645,410,211,199,55,42,34,27,134,55,79,22,24,16,6,0
56646,249,114,135,47,33,25,4,474,268,206,66,42,45,24,0
56647,458,226,232,77,59,61,14,727,362,365,123,107,63,23,0
56648,445,231,214,45,64,53,23,218,115,103,37,33,33,9,0
56649,2488,1085,1403,346,253,162,76,256,141,115,32,22,32,8,0
56650,126,57,69,31,10,10,3,633,311,322,94,82,45,20,0
56651,2440,1061,1379,377,326,172,62,737,320,417,112,94,73,34,0
56652,242,104,138,41,33,37,8,194,94,100,33,28,14,7,0
56653,561,282,279,68,62,36,14,317,161,156,40,49,41,11,0
56654,822,416,406,111,97,88,42,1101,626,475,145,122,120,50,0
56655,1960,875,1085,287,189,162,66,390,190,200,66,50,43,12,0
56656,271,110,161,33,27,11,8,229,120,109,31,30,22,9,0
56657,245,137,108,34,30,19,10,235,119,116,31,26,15,13,0
56658,636,288,348,94,77,65,30,926,425,501,159,147,77,35,0
56659,130,70,60,30,9,8,1,270,130,140,48,44,37,12,0
56660,127,55,72,25,18,5,7,432,244,188,51,51,27,14,0
56661,658,349,309,77,70,73,35,556,290,266,75,74,29,24,0
56662,238,158,80,28,15,31,7,222,124,98,37,29,22,9,0
56663,532,254,278,91,48,23,17,94,45,49,11,20,10,4,0
56664,2000,965,1035,357,313,198,75,404,190,214,55,55,35,27,0
56665,853,400,453,137,109,88,42,943,463,480,91,144,70,30,0
56666,107,56,51,18,16,12,5,200,99,101,31,24,26,6,0
56667,312,164,148,54,29,25,15,231,126,105,37,26,29,6,0
56668,437,230,207,41,55,27,13,448,217,231,56,63,29,10,0
56669,299,128,171,57,40,13,25,498,244,254,81,67,58,19,0
56670,365,148,217,86,37,51,28,180,90,90,31,19,20,8,0
56671,631,316,315,64,57,49,15,690,345,345,96,83,73,42,0
56672,92,46,46,14,9,8,6,1755,905,850,214,196,183,79,0
56673,785,351,434,136,93,71,37,565,237,328,75,88,32,11,0
56674,306,172,134,35,31,37,18,598,333,265,79,66,54,33,0
56675,126,58,68,31,10,10,3,367,218,149,45,43,42,16,0
56676,281,154,127,45,31,24,9,1065,581,484,134,97,76,46,0
56677,276,149,127,45,34,39,9,199,92,107,34,30,18,9,0
56678,2414,1189,1225,277,178,170,169,134,72,62,14,28,8,4,0
56679,528,273,255,67,53,29,20,218,111,107,45,29,24,6,0
56680,269,124,145,36,24,32,11,89,38,51,14,6,3,9,0
56681,583,279,304,99,71,59,31,422,202,220,80,52,57,18,0
56682,813,412,401,114,93,112,26,708,328,380,113,100,82,34,0
56683,528,273,255,67,53,29,20,402,186,216,64,47,38,20,0
56684,1718,735,983,266,225,130,68,300,148,152,45,43,40,8,0
56685,390,199,191,72,42,35,12,262,129,133,40,41,31,10,0
56686,484,192,292,118,68,83,22,517,295,222,69,62,40,28,0
56687,1007,353,654,277,147,70,26,605,283,322,94,72,64,39,0
56688,422,207,215,79,38,53,23,294,146,148,50,45,51,15,0
56689,256,152,104,18,23,23,8,536,267,269,60,70,41,22,0
56690,869,489,380,110,77,79,29,130,67,63,24,10,12,4,0
56691,420,202,218,67,43,51,15,320,168,152,38,42,24,18,0
56692,335,155,180,64,48,36,10,889,505,384,107,97,99,30,0
56693,269,127,142,43,24,34,26,192,110,82,33,21,10,3,0
56694,567,266,301,139,46,76,37,274,142,132,33,34,18,14,0
56695,932,575,357,94,69,76,40,188,93,95,33,18,16,10,0
56696,312,173,139,43,47,28,6,535,311,224,66,52,49,24,0
56697,483,236,247,82,60,43,18,862,426,436,113,115,84,37,0
56698,972,501,471,125,156,106,39,395,198,197,55,55,36,10,0
56699,933,456,477,123,108,83,29,240,141,99,34,28,29,8,0
56700,415,133,282,114,65,27,7,367,199,168,62,44,34,8,0
56701,380,187,193,38,51,30,18,535,288,247,79,72,35,21,0
56702,932,575,357,94,69,76,40,166,78,88,27,25,19,7,0
56703,236,141,95,36,32,14,6,392,155,237,68,61,34,16,0
56704,1341,481,860,275,264,57,21,339,175,164,51,49,37,9,0
56705,130,70,60,30,9,8,1,903,436,467,128,116,83,33,0
56706,457,261,196,55,27,57,34,536,251,285,75,79,60,23,0
56707,1835,904,931,192,144,135,63,665,361,304,87,91,84,31,0
56708,365,222,143,44,24,35,11,2382,1162,1220,237,220,140,49,0
56709,1148,472,676,229,164,86,37,519,287,232,68,58,45,21,0
56710,272,141,131,45,29,36,9,244,143,101,31,29,26,8,0
56711,468,233,235,65,61,49,34,974,457,517,133,117,69,26,0
56712,213,104,109,56,14,9,2,189,105,84,25,26,21,9,0
56713,51,10,41,25,0,5,8,91,44,47,9,12,4,7,0
56714,437,230,207,41,55,27,13,247,128,119,34,14,16,14,0
56715,1214,498,716,197,180,121,65,264,138,126,33,34,29,12,0
56716,146,73,73,18,24,17,9,704,355,349,113,94,71,24,0
56717,358,212,146,51,36,33,9,564,264,300,79,84,65,26,0
56718,833,295,538,146,139,65,34,423,234,189,66,44,57,12,0
56719,1220,575,645,208,179,99,56,160,60,100,23,40,19,11,0
56720,270,131,139,47,37,41,11,403,225,178,56,38,33,25,0
56721,476,276,200,57,34,43,16,455,191,264,68,86,21,19,0
56722,605,277,328,99,54,63,43,375,209,166,50,37,29,23,0
56723,1594,660,934,251,272,117,77,189,95,94,25,33,16,8,0
56724,158,85,73,24,18,18,8,387,193,194,60,53,57,15,0
56725,1174,594,580,175,155,126,66,1101,626,475,145,122,120,50,0
56726,426,231,195,51,52,45,24,425,177,248,60,62,33,16,0
56727,490,257,233,66,56,60,30,119,57,62,18,16,17,4,0
56728,126,56,70,31,10,10,3,398,200,198,68,43,51,14,0
56729,401,204,197,49,33,29,17,89,38,51,14,6,3,9,0
56730,414,216,198,51,32,42,28,271,150,121,39,36,37,5,0
56731,325,152,173,43,47,28,17,266,146,120,41,28,31,7,0
56732,837,443,394,129,89,87,38,385,212,173,57,40,39,21,0
56733,664,269,395,117,107,36,15,200,99,101,31,24,26,6,0
56734,898,397,501,102,98,54,37,619,305,314,85,93,71,29,0
56735,480,267,213,49,44,70,21,663,354,309,91,84,79,31,0
56736,328,156,172,44,37,44,15,218,111,107,45,29,24,6,0
56737,250,123,127,40,28,29,8,418,246,172,52,39,57,10,0
56738,403,176,227,71,56,51,11,222,124,98,37,29,22,9,0
56739,500,245,255,66,57,52,27,1755,905,850,214,196,183,79,0
56740,2446,1099,1347,363,294,233,100,135,65,70,21,25,15,9,0
56741,391,203,188,49,34,36,9,410,197,213,67,43,56,18,0
56742,607,305,302,92,89,74,23,906,455,451,116,105,87,46,0
56743,766,336,430,133,97,79,21,169,85,84,21,14,9,9,0
56744,860,349,511,166,166,58,19,89,42,47,16,12,15,6,0
56745,362,174,188,46,55,35,23,96,46,50,16,12,7,5,0
56746,710,352,358,104,86,84,41,290,147,143,34,34,39,13,0
56747,215,117,98,28,19,15,8,160,76,84,19,24,8,5,0
56748,415,217,198,50,31,42,17,290,147,143,34,34,39,13,0
56749,949,467,482,126,127,102,51,166,90,76,27,18,21,5,0
56750,482,231,251,76,81,64,26,756,348,408,101,103,60,40,0
56751,282,135,147,36,49,25,10,458,210,248,39,38,25,16,0
56752,340,145,195,46,38,26,23,314,151,163,42,61,39,16,0
56753,414,195,219,51,60,40,17,403,221,182,62,50,42,12,0
56754,161,75,86,24,20,10,7,689,343,346,105,102,81,35,0
56755,107,56,51,18,16,12,5,300,148,152,45,43,40,8,0
56756,416,207,209,63,47,56,15,204,96,108,31,37,20,5,0
56757,413,206,207,38,55,19,10,720,361,359,98,98,70,37,0
56758,278,104,174,46,34,23,14,978,536,442,132,107,67,32,0
56759,526,268,258,54,37,55,12,928,440,488,111,157,82,35,0
56760,380,148,232,81,69,24,8,138,69,69,28,7,10,10,0
56761,1120,436,684,208,120,101,115,375,210,165,49,37,29,27,0
56762,489,253,236,73,36,62,17,68,36,32,11,8,9,2,0
56763,753,395,358,93,72,71,16,156,90,66,17,22,11,10,0
56764,449,179,270,80,77,49,29,332,180,152,44,36,27,13,0
56765,261,130,131,27,41,19,16,87,38,49,23,10,10,9,0
56766,949,466,483,125,126,101,50,935,515,420,126,107,73,32,0
56767,456,214,242,76,62,52,22,457,245,212,62,58,57,21,0
56768,1341,481,860,275,264,57,21,439,227,212,60,55,58,8,0
56769,233,107,126,40,40,20,16,222,125,97,34,27,27,7,0
56770,364,192,172,49,36,39,14,720,357,363,113,85,62,39,0
56771,1161,514,647,159,138,122,37,374,202,172,50,39,31,24,0
56772,360,175,185,73,36,27,7,520,272,248,60,65,58,22,0
56773,282,160,122,36,28,27,7,392,214,178,48,40,53,22,0
56774,640,308,332,91,102,49,21,188,93,95,33,18,16,10,0
56775,368,201,167,61,38,38,12,165,90,75,36,18,20,6,0
56776,539,283,256,75,73,53,26,223,113,110,31,33,22,12,0
56777,2279,996,1283,375,328,158,60,487,252,235,79,58,55,26,0
56778,1508,733,775,216,186,172,60,167,79,88,22,26,16,9,0
56779,457,261,196,55,27,57,34,139,68,71,14,26,14,9,0
56780,407,207,200,53,36,38,8,492,278,214,65,58,32,11,0
56781,244,104,140,52,31,30,14,362,156,206,74,42,36,22,0
56782,479,227,252,69,48,46,18,744,385,359,105,96,57,31,0
56783,431,245,186,50,23,46,17,96,46,50,16,12,7,5,0
56784,622,354,268,89,60,64,18,1507,737,770,188,228,147,71,0
56785,594,321,273,98,59,57,23,106,46,60,29,13,14,5,0
56786,502,274,228,64,49,75,17,966,478,488,108,144,74,43,0
56787,879,457,422,93,98,143,32,463,268,195,59,46,46,21,0
56788,733,438,295,95,79,67,32,1241,619,622,183,169,155,59,0
56789,1161,514,647,159,138,122,37,699,334,365,108,80,70,20,0
56790,267,146,121,40,24,25,7,373,181,192,54,35,44,20,0
56791,429,238,191,47,49,56,29,600,254,346,104,100,44,17,0
56792,76,42,34,12,8,5,7,445,202,243,70,73,51,15,0
56793,343,162,181,65,38,29,12,323,168,155,51,41,38,12,0
56794,574,284,290,64,50,65,20,132,77,55,20,9,13,10,0
56795,533,297,236,74,57,39,28,1004,457,547,150,150,74,52,0
56796,496,209,287,113,55,72,14,633,311,322,94,82,45,20,0
56797,480,257,223,74,26,60,27,398,200,198,68,43,51,14,0
56798,270,166,104,30,26,28,14,187,89,98,36,24,20,6,0
56799,288,104,184,80,30,39,6,447,212,235,86,55,58,21,0
56800,259,151,108,39,18,23,11,373,183,190,49,37,33,18,0
56801,330,141,189,65,29,51,19,704,355,349,113,94,71,24,0
56802,200,103,97,17,16,10,10,406,234,172,63,35,43,10,0
56803,503,260,243,46,56,33,16,405,181,224,71,57,31,12,0
56804,1023,449,574,141,174,76,43,127,58,69,18,17,10,5,0
56805,1360,644,716,213,194,136,62,902,499,403,118,117,92,35,0
56806,235,100,135,36,25,30,8,323,171,152,48,41,40,16,0
56807,271,110,161,33,27,11,8,332,180,152,46,36,28,14,0
56808,357,182,175,49,36,39,15,385,212,173,57,40,39,21,0
56809,824,391,433,106,90,88,32,413,223,190,52,45,53,10,0
56810,932,575,357,94,69,76,40,858,461,397,125,114,79,45,0
56811,653,379,274,89,56,86,13,295,160,135,44,36,46,16,0
56812,1556,718,838,280,182,161,49,286,160,126,37,27,23,10,0
56813,159,105,54,22,9,14,25,179,101,78,25,15,13,13,0
56814,244,104,140,52,31,30,14,190,93,97,35,27,23,2,0
56815,800,416,384,102,105,83,22,289,140,149,33,42,30,15,0
56816,1186,495,691,182,208,88,32,535,288,247,79,72,35,21,0
56817,3969,1703,2266,619,432,259,144,756,348,408,101,103,60,40,0
56818,170,82,88,32,23,22,8,87,51,35,15,9,9,4,0
56819,220,121,99,28,26,17,6,72,34,38,8,2,3,12,0
56820,117,58,59,17,17,12,2,296,140,156,49,40,42,19,0
56821,466,199,267,86,59,32,17,147,74,73,28,20,24,4,0
56822,82,36,46,17,10,5,1,166,78,88,27,25,19,7,0
56823,1214,498,716,197,180,121,65,285,143,142,45,32,21,17,0
56824,404,197,207,60,48,47,20,904,436,468,138,146,82,39,0
56825,326,148,178,55,42,31,12,903,436,467,128,116,83,33,0
56826,347,181,166,27,20,12,12,395,169,226,73,55,38,9,0
56827,397,180,217,61,59,39,13,300,148,152,45,43,40,8,0
56828,338,139,199,54,54,18,11,390,190,200,66,50,43,12,0
56829,586,298,288,80,75,64,37,403,184,219,75,51,47,20,0
56830,412,203,209,65,47,37,18,68,36,32,11,8,9,2,0
56831,441,216,225,57,66,57,19,135,57,78,21,20,9,11,0
56832,416,222,194,58,38,38,20,422,237,185,53,47,62,20,0
56833,359,204,155,39,36,34,13,732,366,366,108,86,74,41,0
56834,570,238,332,112,95,39,23,266,146,120,41,28,31,7,0
56835,908,324,584,181,162,81,29,72,32,40,8,2,2,13,0
56836,301,150,151,45,47,33,13,396,223,173,57,37,44,19,0
56837,329,171,158,49,41,31,10,679,338,341,96,95,40,23,0
56838,579,246,333,102,79,41,19,346,178,168,58,41,33,12,0
56839,423,247,176,58,55,29,20,368,183,185,40,42,40,15,0
56840,453,240,213,53,33,44,16,368,183,185,40,42,40,15,0
56841,782,372,410,127,111,89,36,303,138,165,47,46,35,18,0
56842,347,181,166,27,20,12,12,403,225,178,56,38,33,25,0
56843,136,66,70,33,11,9,5,818,357,461,122,136,54,25,0
56844,517,245,272,92,77,46,24,564,264,300,79,84,65,26,0
56845,76,42,34,12,8,5,7,131,55,76,28,9,14,12,0
56846,3859,2011,1848,535,391,422,207,892,475,417,130,108,68,38,0
56847,456,223,233,77,54,47,20,483,258,225,70,53,54,20,0
56848,1339,494,845,216,298,92,37,425,177,248,60,62,33,16,0
56849,1042,529,513,161,151,103,52,195,100,95,27,20,17,11,0
56850,281,125,156,44,47,17,7,317,161,156,50,36,47,12,0
56851,376,171,205,45,45,34,12,470,205,265,71,80,33,11,0
56852,340,169,171,40,39,36,22,381,187,194,37,49,36,17,0
56853,126,56,70,31,10,10,3,497,227,270,70,63,66,30,0
56854,118,56,62,24,12,6,9,1265,689,576,169,177,128,60,0
56855,358,206,152,45,38,67,16,846,425,421,125,97,98,38,0
56856,83,45,38,11,8,8,3,132,61,71,22,21,15,3,0
56857,241,122,119,27,34,17,16,289,140,149,33,42,30,15,0
56858,2696,1169,1527,432,347,193,146,415,205,210,77,52,55,17,0
56859,414,206,208,56,68,35,19,338,169,169,53,44,39,21,0
56860,439,205,234,64,88,41,21,729,358,371,116,99,89,33,0
56861,124,58,66,20,28,11,7,111,60,51,17,23,10,7,0
56862,346,205,141,47,34,30,7,408,221,187,55,51,57,14,0
56863,419,210,209,54,44,31,23,290,147,143,34,34,39,13,0
56864,328,195,133,36,23,35,9,465,252,213,73,58,60,18,0
56865,346,186,160,40,37,34,21,873,411,462,132,107,84,40,0
56866,376,171,205,45,45,34,12,222,119,103,37,32,24,8,0
56867,428,248,180,44,39,28,9,467,240,227,65,65,51,23,0
56868,1439,713,726,195,180,110,34,133,61,72,21,19,13,4,0
56869,1105,544,561,165,167,99,40,230,113,117,31,40,28,10,0
56870,639,368,271,72,51,38,38,72,32,40,8,2,2,13,0
56871,610,249,361,107,69,72,33,166,78,88,27,25,19,7,0
56872,836,370,466,126,96,72,30,609,335,274,79,57,45,22,0
56873,288,140,148,59,33,27,12,127,54,73,11,33,15,6,0
56874,128,67,61,29,9,9,1,421,222,199,69,50,60,18,0
56875,413,236,177,41,25,35,19,204,96,108,31,37,20,5,0
56876,520,240,280,67,72,42,14,720,357,363,113,85,62,39,0
56877,184,88,96,15,40,17,8,763,418,345,113,84,59,32,0
56878,253,133,120,44,31,22,8,461,223,238,45,62,18,35,0
56879,184,88,96,15,40,17,8,132,61,71,22,21,15,3,0
56880,524,270,254,84,72,70,23,334,181,153,41,40,25,15,0
56881,837,443,394,129,89,87,38,390,223,167,58,36,45,18,0
56882,250,123,127,40,28,29,8,601,279,322,81,65,27,12,0
56883,451,225,226,69,57,64,22,169,84,85,29,19,21,7,0
56884,852,472,380,99,79,70,27,862,426,436,113,115,84,37,0
56885,949,466,483,125,126,101,50,715,348,367,109,84,68,30,0
56886,278,104,174,46,34,23,14,166,102,64,19,14,17,2,0
56887,860,348,512,121,136,75,35,299,140,159,49,44,26,11,0
56888,1365,590,775,257,168,136,93,138,69,69,28,7,10,10,0
56889,665,341,324,109,79,38,22,201,99,102,34,26,23,6,0
56890,416,207,209,63,47,56,15,362,156,206,74,42,36,22,0
56891,425,199,226,54,71,56,11,396,223,173,57,37,44,19,0
56892,1590,726,864,270,237,126,59,134,72,62,14,28,8,4,0
56893,505,247,258,72,71,60,27,530,287,243,79,70,33,26,0
56894,126,56,70,31,10,10,3,231,126,105,28,26,34,9,0
56895,605,277,328,99,54,63,43,165,87,78,24,19,22,9,0
56896,119,59,60,29,10,6,4,1040,564,476,134,110,114,51,0
56897,1199,589,610,189,128,167,65,156,90,66,17,22,11,10,0
56898,319,222,97,36,23,28,8,88,50,38,13,8,16,4,0
56899,543,265,278,52,37,54,19,1425,670,755,153,189,122,85,0
56900,463,250,213,56,45,73,25,72,33,39,8,2,3,12,0
56901,130,71,59,30,9,8,1,334,181,153,56,31,28,18,0
56902,582,328,254,78,48,35,9,348,212,136,53,31,25,18,0
56903,282,84,198,60,102,1,6,432,244,188,51,51,27,14,0
56904,346,186,160,40,37,34,21,406,223,183,61,53,46,17,0
56905,332,173,159,48,42,42,9,339,175,164,51,49,37,9,0
56906,260,120,140,34,39,36,12,665,361,304,87,91,84,31,0
56907,364,168,196,64,61,27,6,565,237,328,75,88,32,11,0
56908,398,186,212,76,70,18,13,584,249,335,80,96,22,13,0
56909,756,265,491,129,127,51,17,1208,565,643,182,162,120,57,0
56910,794,322,472,122,108,79,34,374,181,193,55,58,48,23,0
56911,682,260,422,153,78,109,46,91,42,49,21,9,8,3,0
56912,255,110,145,34,32,23,17,166,102,64,19,14,17,2,0
56913,739,389,350,129,61,69,25,297,175,122,46,30,31,6,0
56914,422,207,215,79,38,53,23,368,200,168,54,49,43,9,0
56915,869,489,380,110,77,79,29,535,288,247,79,72,35,21,0
56916,121,69,52,15,18,14,8,662,312,350,103,104,59,20,0
56917,334,155,179,47,34,38,11,367,199,168,62,44,34,8,0
56918,130,70,60,30,9,8,1,373,181,192,54,35,44,20,0
56919,553,319,234,56,37,54,18,903,436,467,128,116,83,33,0
56920,501,230,271,63,90,50,18,134,55,79,22,24,16,6,0
56921,856,429,427,113,105,96,24,1425,670,755,153,189,122,85,0
56922,330,77,253,86,52,20,12,270,130,140,48,44,37,12,0
56923,99,35,64,25,18,0,1,271,150,121,39,36,37,5,0
56924,3703,1708,1995,456,428,305,162,215,115,100,27,19,16,7,0
56925,1043,479,564,200,131,123,62,594,312,282,72,67,73,31,0
56926,361,167,194,55,35,41,11,413,223,190,52,45,53,10,0
56927,417,222,195,53,39,43,10,290,142,148,41,37,43,11,0
56928,665,341,324,109,79,38,22,230,113,117,31,40,28,10,0
56929,1395,595,800,223,206,113,61,196,105,91,40,13,19,10,0
56930,188,84,104,35,36,18,9,600,254,346,104,100,44,17,0
56931,505,201,304,116,58,75,31,555,292,263,75,63,67,27,0
56932,629,338,291,92,57,64,22,810,310,500,164,162,42,26,0
56933,554,217,337,112,72,90,38,350,196,154,52,37,21,14,0
56934,451,278,173,71,35,58,12,240,141,99,34,28,29,8,0
56935,561,282,279,68,62,36,14,152,71,81,41,16,14,2,0
56936,1047,443,604,162,156,78,52,389,210,179,51,37,43,9,0
56937,828,355,473,126,134,77,37,467,231,236,71,65,58,18,0
56938,521,249,272,53,36,50,18,149,77,72,37,10,20,5,0
56939,143,81,62,28,9,8,1,1323,690,633,132,178,112,61,0
56940,425,199,226,54,71,56,11,244,143,101,31,29,26,8,0
56941,308,129,179,44,60,19,8,252,130,122,45,23,32,11,0
56942,673,317,356,101,85,76,49,501,274,227,63,58,53,20,0
56943,150,64,86,22,12,29,12,548,273,275,84,81,64,30,0
56944,904,436,468,138,146,82,39,392,214,178,48,40,53,22,0
56945,314,158,156,39,28,30,17,257,139,118,64,17,24,7,0
56946,1004,464,540,143,104,78,55,671,321,350,95,87,75,34,0
56947,450,241,209,67,58,54,23,528,188,340,130,58,77,41,0
56948,613,303,310,70,28,28,18,482,232,250,77,81,44,13,0
56949,242,104,138,41,33,37,8,536,222,314,101,100,34,22,0
56950,612,341,271,66,76,57,23,785,375,410,100,116,66,39,0
56951,338,208,130,39,30,35,12,370,190,180,60,52,37,13,0
56952,484,264,220,59,62,68,15,1698,875,823,222,219,173,64,0
56953,181,75,106,35,26,11,9,260,131,129,42,31,40,9,0
56954,446,265,181,51,35,27,17,1230,644,586,198,125,123,61,0
56955,1718,735,983,266,225,130,68,483,287,196,71,50,54,17,0
56956,784,353,431,56,47,26,18,710,375,335,95,94,110,28,0
56957,425,220,205,60,55,45,18,535,311,224,66,52,49,24,0
56958,301,157,144,31,28,34,9,390,223,167,58,36,45,18,0
56959,594,279,315,93,68,68,26,798,385,413,120,115,79,30,0
56960,1441,504,937,264,329,69,46,517,295,222,69,62,40,28,0
56961,508,267,241,43,35,25,17,400,187,213,56,59,42,20,0
56962,412,193,219,69,57,43,14,452,231,221,74,53,56,20,0
56963,236,120,116,32,28,21,11,312,165,147,41,39,29,16,0
56964,626,300,326,91,82,68,26,729,358,371,116,99,89,33,0
56965,273,126,147,54,49,25,18,335,170,165,52,36,47,11,0
56966,126,57,69,31,10,10,3,154,78,76,23,21,13,5,0
56967,414,206,208,56,68,35,19,396,199,197,54,50,45,14,0
56968,359,167,192,49,37,27,19,620,324,296,81,68,66,31,0
56969,610,249,361,107,69,72,33,1062,522,540,151,147,105,66,0
56970,282,163,119,40,23,25,17,230,125,105,29,40,20,6,0
56971,343,162,181,65,38,29,12,715,348,367,109,84,68,30,0
56972,317,140,177,43,26,31,16,175,82,93,33,26,17,5,0
56973,165,66,99,28,32,16,3,277,163,114,33,24,21,16,0
56974,854,435,419,118,91,95,42,103,50,53,19,10,7,5,0
56975,359,204,155,39,36,34,13,385,188,197,57,42,36,16,0
56976,301,157,144,31,28,34,9,535,311,224,66,52,49,24,0
56977,494,242,252,67,47,25,21,160,76,84,19,24,8,5,0
56978,159,105,54,22,9,14,25,108,59,49,17,13,12,5,0
56979,360,205,155,35,24,52,14,380,178,202,69,53,37,10,0
56980,288,104,184,80,30,39,6,180,108,72,22,22,15,5,0
56981,457,261,196,55,27,57,34,1166,514,652,150,159,107,70,0
56982,315,170,145,48,56,22,11,422,237,185,53,47,62,20,0
56983,435,230,205,51,37,55,18,264,138,126,33,34,29,12,0
56984,1505,680,825,202,204,73,32,633,311,322,94,82,45,20,0
56985,474,243,231,66,54,41,29,461,223,238,45,62,18,35,0
56986,432,233,199,52,28,47,18,649,307,342,71,134,45,17,0
56987,766,336,430,133,97,79,21,98,49,49,14,15,9,2,0
56988,204,109,95,21,35,27,7,287,151,136,51,42,36,7,0
56989,447,236,211,56,52,49,14,2547,1280,1267,331,335,293,118,0
56990,411,171,240,61,81,30,15,395,198,197,55,55,36,10,0
56991,379,217,162,47,20,50,23,147,74,73,28,20,24,4,0
56992,180,92,88,29,20,26,8,153,65,88,28,21,20,8,0
56993,563,255,308,91,111,42,30,445,264,181,35,35,34,14,0
56994,136,65,71,33,11,9,6,928,440,488,111,157,82,35,0
56995,488,237,251,79,78,65,27,373,181,192,54,35,44,20,0
56996,291,120,171,63,39,26,6,188,101,87,20,18,20,14,0
56997,733,438,295,95,79,67,32,415,203,212,77,44,49,18,0
56998,368,201,167,61,38,38,12,405,181,224,71,57,31,12,0
56999,288,140,148,59,33,27,12,367,218,149,45,43,42,16,0
57000,317,167,150,45,21,30,26,370,173,197,65,57,42,10,0
57001,362,181,181,67,46,43,8,360,180,180,57,48,39,12,0
57002,755,271,484,113,226,61,20,160,76,84,19,24,8,5,0
57003,275,160,115,40,31,34,17,218,114,104,32,31,33,11,0
57004,126,56,70,31,10,10,3,258,129,129,45,24,31,10,0
57005,1759,838,921,269,212,191,92,410,197,213,67,43,56,18,0
57006,313,158,155,43,35,43,16,457,253,204,67,51,48,13,0
57007,333,171,162,50,34,19,8,1606,753,853,215,227,182,48,0
57008,257,132,125,39,27,26,10,158,71,87,23,21,17,12,0
57009,369,166,203,59,55,41,14,260,133,127,43,32,39,3,0
57010,598,300,298,68,77,59,21,457,253,204,67,51,48,13,0
57011,650,330,320,93,93,51,28,632,360,272,75,65,36,19,0
57012,285,148,137,31,42,42,16,547,295,252,81,65,57,23,0
57013,349,131,218,66,76,22,9,724,353,371,94,95,71,31,0
57014,389,176,213,81,59,24,7,862,426,436,113,115,84,37,0
57015,407,207,200,53,36,38,8,277,145,132,41,32,22,10,0
57016,1542,682,860,290,158,120,47,86,40,46,16,13,9,7,0
57017,126,57,69,31,10,10,3,1166,514,652,150,159,107,70,0
57018,115,62,53,13,10,9,7,306,157,149,52,35,39,16,0
57019,2000,965,1035,357,313,198,75,453,255,198,62,49,29,19,0
57020,261,148,113,23,29,26,21,519,287,232,68,58,45,21,0
57021,331,177,154,54,38,27,11,536,267,269,60,70,41,22,0
57022,594,248,346,104,109,53,5,252,130,122,45,23,32,11,0
57023,224,101,123,45,32,21,3,963,525,438,119,102,102,34,0
57024,427,191,236,67,60,41,34,429,187,242,79,72,28,19,0
57025,1068,434,634,173,160,61,29,374,191,183,40,52,40,16,0
57026,284,160,124,37,23,32,11,166,102,64,19,14,17,2,0
57027,125,46,79,24,16,12,2,270,162,108,26,26,16,11,0
57028,588,267,321,99,79,87,28,282,134,148,38,45,29,10,0
57029,508,136,372,157,91,22,9,538,274,264,84,67,52,35,0
57030,330,151,179,68,36,56,9,496,285,211,62,54,46,22,0
57031,960,409,551,166,134,77,44,501,249,252,77,70,55,22,0
57032,1199,589,610,189,128,167,65,375,176,199,48,61,40,12,0
57033,673,317,356,101,85,76,49,68,23,45,12,9,3,9,0
57034,802,430,372,65,102,87,23,87,51,35,15,9,9,4,0
57035,680,308,372,82,72,71,40,1755,905,850,214,196,183,79,0
57036,410,188,222,53,52,31,14,2038,1059,979,262,237,208,100,0
57037,369,166,203,59,55,41,14,380,211,169,47,37,33,21,0
57038,773,383,390,108,76,79,30,654,295,359,99,88,71,25,0
57039,462,233,229,66,49,43,30,437,221,216,62,64,47,13,0
57040,402,169,233,70,36,34,18,459,260,199,56,42,47,21,0
57041,361,171,190,44,40,18,13,106,46,60,27,18,12,3,0
57042,651,357,294,81,67,103,18,465,252,213,73,58,60,18,0
57043,1007,353,654,277,147,70,26,242,121,121,39,30,29,10,0
57044,241,122,119,27,34,17,16,364,189,175,58,41,35,17,0
57045,437,230,207,41,55,27,13,630,321,309,86,90,57,26,0
57046,319,153,166,61,52,26,12,405,195,210,57,74,24,17,0
57047,412,203,209,65,47,37,18,332,180,152,44,36,27,13,0
57048,618,289,329,97,86,70,17,290,142,148,41,37,43,11,0
57049,300,136,164,45,35,45,14,673,313,360,102,101,46,17,0
57050,172,98,74,20,21,22,8,337,152,185,49,54,42,21,0
57051,782,372,410,127,111,89,36,346,196,150,43,26,27,14,0
57052,517,196,321,103,98,33,12,630,321,309,86,90,57,26,0
57053,398,186,212,76,70,18,13,531,261,270,73,80,68,26,0
57054,1004,498,506,94,59,46,33,296,140,156,49,40,42,19,0
57055,340,181,159,44,39,35,21,720,361,359,98,98,70,37,0
57056,126,58,68,31,10,10,3,818,357,461,122,136,54,25,0
57057,630,231,399,150,83,84,50,171,94,77,24,28,30,11,0
57058,246,123,123,40,31,27,7,96,46,50,16,12,7,5,0
57059,1499,864,635,141,99,76,110,538,274,264,84,67,52,35,0
57060,330,77,253,86,52,20,12,2225,1244,981,271,243,217,93,0
57061,334,190,144,42,42,16,5,390,223,167,58,36,45,18,0
57062,911,489,422,121,98,97,36,663,354,309,91,84,79,31,0
57063,488,237,251,79,78,65,27,846,425,421,125,97,98,38,0
57064,395,189,206,63,50,49,28,756,348,408,101,103,60,40,0
57065,160,53,107,31,29,13,3,299,140,159,49,44,26,11,0
57066,480,257,223,74,26,60,27,218,114,104,32,31,33,11,0
57067,346,205,141,47,34,30,7,415,226,189,51,40,40,29,0
57068,315,174,141,46,38,47,16,257,126,131,61,24,22,8,0
57069,836,370,466,126,96,72,30,710,375,335,95,94,110,28,0
57070,556,306,250,69,60,80,18,601,278,323,124,87,65,21,0
57071,257,148,109,28,20,21,14,541,279,262,79,82,31,32,0
57072,444,250,194,58,21,60,23,611,314,297,79,75,78,22,0
57073,256,152,104,18,23,23,8,727,388,339,102,87,70,29,0
57074,490,198,292,65,81,39,27,359,171,188,49,74,45,11,0
57075,431,199,232,59,54,40,17,482,232,250,77,81,44,13,0
57076,412,146,266,106,38,67,35,229,120,109,31,30,22,9,0
57077,365,222,143,44,24,35,11,320,168,152,38,42,24,18,0
57078,221,80,141,48,37,14,10,660,333,327,102,95,69,31,0
57079,207,89,118,56,8,4,3,179,101,78,25,15,13,13,0
57080,479,228,251,71,57,60,14,514,248,266,86,82,52,22,0
57081,496,274,222,57,43,75,22,142,65,77,30,17,22,9,0
57082,401,236,165,53,38,34,9,531,261,270,73,80,68,26,0
57083,128,67,61,29,9,9,1,452,231,221,74,53,56,20,0
57084,450,227,223,53,36,48,12,242,124,118,39,32,28,22,0
57085,349,153,196,54,47,28,13,213,129,84,32,14,21,15,0
57086,335,171,164,51,38,38,10,286,152,134,38,38,32,11,0
57087,126,57,69,31,10,10,3,86,40,46,16,13,9,7,0
57088,301,156,145,32,25,15,5,218,115,103,32,32,34,11,0
57089,345,208,137,44,27,33,8,296,140,156,49,40,42,19,0
57090,1096,563,533,158,136,120,53,508,253,255,73,60,50,13,0
57091,119,59,60,29,10,6,4,180,89,91,28,27,18,7,0
57092,482,231,251,76,81,64,26,326,169,157,51,41,41,12,0
57093,615,308,307,83,75,58,32,384,212,172,44,43,34,14,0
57094,123,58,65,22,14,13,3,662,312,350,103,104,59,20,0
57095,756,265,491,129,127,51,17,763,418,345,113,84,59,32,0
57096,873,366,507,127,125,75,21,286,160,126,37,27,23,10,0
57097,299,128,171,57,40,13,25,393,210,183,58,37,34,20,0
57098,335,155,180,64,48,36,10,323,171,152,48,41,40,16,0
57099,315,170,145,48,56,22,11,467,240,227,65,65,51,23,0
57100,219,100,119,40,29,21,3,405,195,210,57,74,24,17,0
57101,136,66,70,33,11,9,5,91,44,47,9,12,4,7,0
57102,389,176,213,81,59,24,7,478,254,224,67,74,56,28,0
57103,570,238,332,112,95,39,23,339,175,164,51,49,37,9,0
57104,364,168,196,64,61,27,6,179,101,78,25,15,13,13,0
57105,603,311,292,102,71,66,23,277,138,139,40,39,20,14,0
57106,915,336,579,185,199,56,29,169,84,85,29,19,21,7,0
57107,221,114,107,65,7,2,1,222,124,98,37,29,22,9,0
57108,240,98,142,49,42,23,17,481,223,258,71,70,49,26,0
57109,2624,999,1625,415,495,109,84,145,77,68,26,7,15,8,0
57110,278,104,174,46,34,23,14,459,260,199,56,42,47,21,0
57111,474,243,231,66,54,41,29,2382,1162,1220,237,220,140,49,0
57112,346,191,155,52,38,40,13,339,180,159,36,29,16,16,0
57113,588,267,321,99,79,87,28,160,60,100,23,40,19,11,0
57114,346,209,137,46,37,44,10,701,380,321,94,84,96,34,0
57115,346,168,178,36,43,20,9,445,192,253,86,58,53,18,0
57116,607,294,313,94,95,62,14,298,129,169,51,40,29,8,0
57117,258,130,128,44,37,29,10,422,237,185,53,47,62,20,0
57118,860,348,512,121,136,75,35,246,125,121,38,36,30,11,0
57119,199,113,86,27,17,10,7,89,38,51,14,6,3,9,0
57120,674,318,356,86,139,50,11,103,59,44,25,2,13,6,0
57121,763,371,392,104,88,52,23,296,159,137,49,28,38,13,0
57122,736,320,416,113,97,61,36,316,159,157,38,48,30,11,0
57123,315,170,145,48,56,22,11,363,180,183,60,34,10,6,0
57124,595,316,279,86,60,65,40,564,264,300,79,84,65,26,0
57125,454,214,240,56,71,35,16,258,129,129,45,24,31,10,0
57126,329,168,161,48,34,41,16,389,207,182,53,58,52,18,0
57127,575,290,285,67,70,28,9,509,267,242,79,81,38,20,0
57128,626,300,326,91,82,68,26,129,60,69,21,15,8,5,0
57129,462,258,204,59,41,56,15,370,190,180,60,52,37,13,0
57130,524,262,262,62,72,39,49,173,94,79,18,24,12,7,0
57131,463,250,213,56,45,73,25,535,301,234,63,48,47,27,0
57132,411,211,200,61,46,35,18,403,184,219,75,51,47,20,0
57133,224,108,116,33,26,32,10,647,350,297,95,79,77,29,0
57134,350,212,138,32,26,40,13,462,251,211,74,53,41,18,0
57135,752,313,439,121,106,68,27,843,391,452,139,104,91,35,0
57136,403,176,227,71,56,51,11,189,95,94,25,33,16,8,0
57137,952,547,405,95,90,127,35,135,65,70,21,25,15,9,0
57138,346,168,178,36,43,20,9,619,305,314,85,93,71,29,0
57139,71,28,43,15,9,5,2,91,44,47,9,12,4,7,0
57140,956,450,506,122,117,82,36,316,166,150,45,38,37,13,0
57141,341,154,187,34,36,11,11,497,257,240,71,63,62,16,0
57142,282,135,147,27,37,30,19,535,311,224,66,52,49,24,0
57143,314,158,156,39,28,30,17,483,215,268,66,70,30,16,0
57144,341,195,146,42,21,36,9,360,180,180,57,48,39,12,0
57145,281,125,156,44,47,17,7,204,96,108,31,37,20,5,0
57146,411,211,200,61,46,35,18,398,200,198,68,43,51,14,0
57147,347,212,135,35,32,17,6,303,137,166,54,54,31,15,0
57148,204,109,95,21,35,27,7,91,42,49,21,9,8,3,0
57149,390,199,191,72,42,35,12,282,134,148,38,45,29,10,0
57150,365,222,143,44,24,35,11,496,285,211,62,54,46,22,0
57151,257,122,135,44,19,21,16,403,233,170,38,29,21,14,0
57152,766,336,430,133,97,79,21,481,223,258,71,70,49,26,0
57153,433,188,245,63,45,26,14,137,78,59,22,16,17,4,0
57154,331,169,162,40,28,22,14,200,89,111,26,25,17,7,0
57155,126,66,60,24,10,7,9,265,134,131,48,34,33,15,0
57156,407,230,177,44,39,34,19,256,141,115,32,22,32,8,0
57157,219,98,121,43,19,11,7,344,109,235,100,39,26,5,0
57158,435,225,210,58,46,50,14,156,90,66,17,22,11,10,0
57159,315,111,204,82,66,46,11,498,244,254,81,67,58,19,0
57160,336,134,202,51,64,27,12,600,254,346,104,100,44,17,0
57161,228,105,123,34,43,20,10,744,385,359,105,96,57,31,0
57162,426,231,195,51,52,45,24,360,185,175,51,43,36,16,0
57163,364,172,192,55,57,32,15,215,115,100,27,19,16,7,0
57164,828,355,473,126,134,77,37,374,174,200,54,52,42,21,0
57165,342,185,157,42,27,31,14,422,237,185,53,47,62,20,0
57166,217,98,119,38,35,18,9,265,134,131,48,34,33,15,0
57167,271,136,135,37,30,18,10,137,85,52,15,11,11,2,0
57168,1009,478,531,166,126,96,42,374,191,183,40,52,40,16,0
57169,520,261,259,74,52,49,22,244,143,101,31,29,26,8,0
57170,450,231,219,77,50,76,16,227,130,97,32,25,22,12,0
57171,228,82,146,45,37,18,8,406,223,183,61,53,46,17,0
57172,496,210,286,112,55,71,14,374,191,183,40,52,40,16,0
57173,227,120,107,31,28,28,13,274,157,117,40,29,40,8,0
57174,142,76,66,21,21,22,11,290,142,148,41,37,43,11,0
57175,1001,422,579,185,180,51,32,172,79,93,34,27,23,10,0
57176,1718,735,983,266,225,130,68,212,127,85,28,21,26,6,0
57177,255,110,145,34,32,23,17,504,272,232,75,57,53,19,0
57178,329,168,161,48,34,41,16,947,482,465,143,107,89,37,0
57179,284,160,124,37,23,32,11,483,258,225,70,53,54,20,0
57180,349,131,218,66,76,22,9,660,303,357,97,89,85,33,0
57181,401,204,197,49,33,29,17,133,61,72,21,19,13,4,0
57182,772,383,389,105,76,82,33,68,23,45,12,9,3,9,0
57183,688,310,378,130,82,78,47,724,353,371,94,95,71,31,0
57184,785,374,411,56,42,38,25,396,197,199,75,49,49,16,0
57185,143,81,62,28,9,8,1,660,303,357,97,89,85,33,0
57186,941,459,482,167,140,82,38,457,245,212,62,58,57,21,0
57187,149,78,71,20,20,19,5,250,116,134,41,30,33,19,0
57188,126,58,68,31,10,10,3,303,138,165,47,46,35,18,0
57189,734,366,368,121,99,63,39,906,455,451,116,105,87,46,0
57190,521,249,272,53,36,50,18,385,188,197,57,42,36,16,0
57191,1336,724,612,209,141,133,60,758,319,439,101,123,78,25,0
57192,1365,590,775,257,168,136,93,1395,627,768,172,263,141,59,0
57193,310,141,169,36,38,20,8,1065,581,484,134,97,76,46,0
57194,532,254,278,91,48,23,17,898,469,429,125,125,134,35,0
57195,275,125,150,37,48,27,7,1004,457,547,150,150,74,52,0
57196,380,187,193,38,51,30,18,105,51,54,13,17,12,8,0
57197,350,200,150,45,47,23,8,193,118,75,20,21,24,6,0
57198,773,383,390,108,76,79,30,102,51,51,12,15,12,3,0
57199,243,100,143,58,50,24,5,434,213,221,77,62,53,12,0
57200,447,232,215,55,65,50,25,528,188,340,130,58,77,41,0
57201,397,180,217,61,59,39,13,232,111,121,23,29,17,9,0
57202,150,60,90,27,16,6,3,264,138,126,33,34,29,12,0
57203,1759,838,921,269,212,191,92,335,186,149,40,28,29,13,0
57204,482,245,237,69,64,66,24,339,175,164,51,49,37,9,0
57205,574,269,305,91,63,54,27,303,137,166,54,54,31,15,0
57206,298,141,157,51,33,21,22,2382,1162,1220,237,220,140,49,0
57207,682,260,422,153,78,109,46,201,104,97,36,32,24,7,0
57208,519,245,274,58,61,34,22,583,321,262,73,67,45,25,0
57209,1544,738,806,239,217,145,91,662,373,289,89,80,77,29,0
57210,218,133,85,20,19,13,6,286,152,134,38,38,32,11,0
57211,180,57,123,39,22,10,8,972,471,501,152,138,112,40,0
57212,312,164,148,54,29,25,15,132,67,65,24,21,8,10,0
57213,240,98,142,49,42,23,17,188,105,83,25,17,24,7,0
57214,772,332,440,136,104,72,28,597,269,328,102,84,69,24,0
57215,161,75,86,24,20,10,7,166,102,64,19,14,17,2,0
57216,1112,457,655,180,164,99,39,953,489,464,126,104,111,44,0
57217,384,198,186,58,48,37,12,319,185,134,42,31,22,13,0
57218,426,214,212,63,47,53,20,715,345,370,110,97,64,25,0
57219,414,216,198,51,32,42,28,1382,508,874,334,320,98,36,0
57220,252,121,131,42,34,12,16,1101,626,475,145,122,120,50,0
57221,146,73,73,18,24,17,9,783,406,377,102,91,57,29,0
57222,1186,495,691,182,208,88,32,900,441,459,125,127,110,32,0
57223,1759,838,921,269,212,191,92,403,225,178,56,38,33,25,0
57224,180,92,88,29,20,26,8,338,169,169,53,44,39,21,0
57225,574,284,290,64,50,65,20,192,110,82,33,21,10,3,0
57226,665,341,324,109,79,38,22,89,51,38,15,15,5,4,0
57227,533,297,236,74,57,39,28,528,276,252,86,78,49,17,0
57228,2663,1073,1590,548,499,192,64,622,344,278,80,77,68,36,0
57229,284,128,156,48,29,34,8,331,180,151,46,35,47,17,0
57230,952,547,405,95,90,127,35,727,388,339,102,87,70,29,0
57231,301,150,151,45,47,33,13,260,133,127,43,32,39,3,0
57232,260,120,140,34,39,36,12,520,244,276,91,60,68,20,0
57233,837,443,394,129,89,87,38,332,173,159,48,40,31,11,0
57234,484,261,223,59,48,49,24,600,254,346,104,100,44,17,0
57235,399,220,179,48,37,68,18,579,285,294,78,72,64,32,0
57236,517,196,321,103,98,33,12,405,195,210,57,74,24,17,0
57237,908,324,584,181,162,81,29,165,90,75,36,18,20,6,0
57238,1105,544,561,165,167,99,40,222,125,97,34,27,27,7,0
57239,192,91,101,28,21,18,8,392,214,178,48,40,53,22,0
57240,784,353,431,56,47,26,18,391,189,202,55,56,56,12,0
57241,648,376,272,70,60,73,24,339,180,159,36,29,16,16,0
57242,758,378,380,89,64,37,31,362,156,206,74,42,36,22,0
57243,359,204,155,39,36,34,13,565,237,328,75,88,32,11,0
57244,928,442,486,139,118,91,43,783,406,377,102,91,57,29,0
57245,275,160,115,40,31,34,17,242,124,118,39,32,28,22,0
57246,1365,590,775,257,168,136,93,2517,1275,1242,304,324,245,135,0
57247,496,209,287,113,55,72,14,323,171,152,48,41,40,16,0
57248,1718,735,983,266,225,130,68,87,38,49,23,10,10,9,0
57249,249,104,145,47,41,24,17,135,57,78,21,20,9,11,0
57250,392,221,171,53,30,25,8,288,156,132,36,36,24,15,0
57251,1004,464,540,143,104,78,55,524,300,223,70,54,51,25,0
57252,426,213,213,60,56,46,24,609,335,274,79,57,45,22,0
57253,586,298,288,80,75,64,37,336,200,136,34,29,25,24,0
57254,476,199,277,82,80,49,24,1182,591,591,155,139,83,46,0
57255,956,450,506,122,117,82,36,160,76,84,19,24,8,5,0
57256,526,268,258,54,37,55,12,239,113,126,36,49,20,8,0
57257,444,250,194,58,21,60,23,452,254,198,72,57,38,18,0
57258,802,375,427,133,103,81,41,701,380,321,94,84,96,34,0
57259,361,177,184,59,51,24,15,649,307,342,71,134,45,17,0
57260,2442,1193,1249,278,183,170,145,749,384,365,108,105,86,31,0
57261,416,207,209,63,47,56,15,309,164,145,35,47,30,11,0
57262,230,114,116,30,33,29,8,699,334,365,108,80,70,20,0
57263,220,113,107,37,24,16,7,846,425,421,125,97,98,38,0
57264,952,547,405,95,90,127,35,1101,626,475,145,122,120,50,0
57265,467,233,234,83,37,77,22,727,362,365,123,107,63,23,0
57266,607,294,313,94,95,62,14,450,241,209,67,58,54,23,0
57267,344,109,235,100,39,26,5,405,195,210,57,74,24,17,0
57268,2442,1193,1249,278,183,170,145,389,210,179,51,37,43,9,0
57269,441,216,225,57,66,57,19,370,190,180,60,52,37,13,0
57270,414,195,219,51,60,40,17,400,187,213,56,59,42,20,0
57271,340,145,195,46,38,26,23,708,328,380,113,100,82,34,0
57272,318,164,154,52,43,34,10,131,55,76,28,9,14,12,0
57273,472,222,250,46,61,33,23,339,175,164,51,49,37,9,0
57274,418,163,255,57,54,38,24,149,77,72,37,10,20,5,0
57275,375,167,208,55,83,44,9,213,129,84,32,14,21,15,0
57276,435,222,213,67,49,67,12,866,397,469,117,153,95,48,0
57277,230,114,116,30,33,29,8,138,69,69,28,7,10,10,0
57278,1143,574,569,176,151,123,59,1061,543,518,146,123,109,67,0
57279,473,217,256,59,44,34,21,171,94,77,24,28,30,11,0
57280,225,111,114,38,22,25,10,325,172,153,44,34,27,14,0
57281,722,390,332,125,69,67,25,418,246,172,52,39,57,10,0
57282,437,228,209,47,61,26,11,346,196,150,43,26,27,14,0
57283,886,440,446,116,140,95,45,189,95,94,25,33,16,8,0
57284,570,238,332,112,95,39,23,295,160,135,44,36,46,16,0
57285,242,104,138,41,33,37,8,402,186,216,64,47,38,20,0
57286,225,111,114,38,22,25,10,665,361,304,87,91,84,31,0
57287,206,100,106,34,26,11,7,144,67,77,28,14,9,8,0
57288,411,236,175,39,45,50,30,135,57,78,21,20,9,11,0
57289,641,349,292,92,60,39,24,103,59,44,25,2,13,6,0
57290,1755,849,906,245,226,148,56,277,152,125,31,35,22,19,0
57291,535,217,318,87,106,41,14,1395,627,768,172,263,141,59,0
57292,1139,537,602,162,139,109,50,889,505,384,107,97,99,30,0
57293,347,212,135,35,32,17,6,963,525,438,119,102,102,34,0
57294,318,164,154,52,43,34,10,679,338,341,96,95,40,23,0
57295,538,263,275,71,85,44,18,212,127,85,28,21,26,6,0
57296,213,88,125,21,54,14,15,462,251,211,74,53,41,18,0
57297,1189,653,536,152,118,109,56,267,141,126,53,27,23,7,0
57298,391,203,188,49,34,36,9,72,32,40,8,2,2,13,0
57299,391,204,187,47,48,38,18,465,252,213,73,58,60,18,0
57300,458,210,248,39,38,25,16,374,191,183,40,52,40,16,0
57301,126,58,68,31,10,10,3,1047,562,485,141,127,114,41,0
57302,1001,422,579,185,180,51,32,449,252,197,61,52,36,18,0
57303,107,53,54,15,15,13,4,187,89,98,36,24,20,6,0
57304,219,98,121,43,19,11,7,164,61,103,47,19,14,5,0
57305,583,279,304,99,71,59,31,274,157,117,40,29,40,8,0
57306,275,160,115,40,31,34,17,545,269,276,80,76,27,32,0
57307,207,128,79,26,17,19,9,316,159,157,38,48,30,11,0
57308,196,107,89,20,31,17,4,180,115,65,17,12,9,9,0
57309,343,189,154,44,24,39,12,107,77,30,7,2,9,5,0
57310,517,245,272,92,77,46,24,414,203,211,58,56,48,14,0
57311,334,190,144,42,42,16,5,1696,771,925,257,225,149,63,0
57312,414,195,219,51,60,40,17,561,279,282,85,81,88,24,0
57313,347,154,193,48,51,25,11,127,58,69,18,17,10,5,0
57314,588,317,271,78,49,54,17,317,161,156,50,36,47,12,0
57315,330,182,148,47,27,40,11,200,89,111,26,25,17,7,0
57316,126,57,69,31,10,10,3,715,348,367,109,84,68,30,0
57317,142,76,66,21,21,22,11,189,95,94,25,33,16,8,0
57318,199,107,92,41,15,14,8,292,155,137,50,34,29,13,0
57319,138,35,103,38,2,15,9,308,146,162,42,39,24,12,0
57320,557,250,307,70,47,51,22,309,159,150,47,43,43,13,0
57321,692,305,387,100,97,78,30,201,99,102,34,26,23,6,0
57322,1711,865,846,204,176,105,60,792,398,394,109,96,90,39,0
57323,332,170,162,44,38,39,10,164,79,85,28,28,16,7,0
57324,282,160,122,36,28,27,7,395,169,226,73,55,38,9,0
57325,760,405,355,112,95,92,29,337,170,167,59,33,47,17,0
57326,1276,607,669,192,178,136,63,889,505,384,107,97,99,30,0
57327,347,198,149,45,29,29,8,380,178,202,69,53,37,10,0
57328,691,241,450,151,139,24,20,522,235,287,78,67,60,50,0
57329,465,305,160,40,47,34,9,87,51,35,15,9,9,4,0
57330,960,409,551,166,134,77,44,701,380,321,94,84,96,34,0
57331,150,60,90,27,16,6,3,508,261,247,65,53,58,23,0
57332,184,88,96,15,40,17,8,584,249,335,80,96,22,13,0
57333,478,220,258,47,70,41,10,421,222,199,69,50,60,18,0
57334,107,36,71,27,15,0,1,374,202,172,50,39,31,24,0
57335,854,435,419,118,91,95,42,633,311,322,94,82,45,20,0
57336,130,72,58,28,9,7,1,422,237,185,53,47,62,20,0
57337,118,56,62,24,12,6,9,748,359,389,125,113,86,31,0
57338,150,60,90,27,16,6,3,218,115,103,32,32,34,11,0
57339,2696,1169,1527,432,347,193,146,295,156,139,41,40,42,15,0
57340,301,150,151,45,47,33,13,148,84,64,30,7,17,4,0
57341,833,295,538,146,139,65,34,390,190,200,66,50,43,12,0
57342,641,349,292,92,60,39,24,461,223,238,45,62,18,35,0
57343,425,198,227,57,69,59,13,605,283,322,94,72,64,39,0
57344,301,156,145,32,25,15,5,710,375,335,95,94,110,28,0
57345,496,209,287,113,55,72,14,535,311,224,66,52,49,24,0
57346,484,261,223,59,48,49,24,130,67,63,24,10,12,4,0
57347,736,320,416,113,97,61,36,228,130,98,35,29,30,10,0
57348,303,147,156,49,49,20,8,131,55,76,28,9,14,12,0
57349,496,209,287,112,55,71,14,265,134,131,48,34,33,15,0
57350,161,75,86,24,20,10,7,445,202,243,70,73,51,15,0
57351,282,96,186,80,21,28,7,359,171,188,49,74,45,11,0
57352,243,114,129,37,30,32,8,452,252,200,55,49,61,16,0
57353,184,93,91,26,25,14,11,562,273,289,76,92,45,24,0
57354,483,236,247,82,60,43,18,285,143,142,45,32,21,17,0
57355,410,200,210,60,54,46,19,385,212,173,57,40,39,21,0
57356,67,40,27,10,8,7,6,296,151,145,45,42,32,11,0
57357,595,339,256,64,36,54,24,173,90,83,21,36,12,15,0
57358,764,277,487,158,162,64,31,1208,565,643,182,162,120,57,0
57359,1120,436,684,208,120,101,115,415,205,210,77,52,55,17,0
57360,673,317,356,101,85,76,49,295,160,135,42,37,46,16,0
57361,798,364,434,133,88,74,35,662,312,350,103,104,59,20,0
57362,314,178,136,42,32,30,17,1500,804,696,190,172,144,60,0
57363,567,266,301,139,46,76,37,1241,619,622,183,169,155,59,0
57364,172,98,74,20,21,22,8,187,89,98,36,24,20,6,0
57365,278,110,168,58,49,29,5,188,105,83,25,17,24,7,0
57366,231,105,126,56,10,24,10,228,130,98,35,29,30,10,0
57367,785,325,460,114,123,61,28,297,175,122,46,30,31,6,0
57368,486,243,243,65,48,63,22,166,78,88,27,25,19,7,0
57369,505,247,258,72,71,60,27,137,78,59,22,16,17,4,0
57370,418,163,255,57,54,38,24,516,245,271,82,84,70,26,0
57371,200,94,106,33,22,18,8,2547,1280,1267,331,335,293,118,0
57372,588,300,288,100,57,65,27,180,90,90,31,19,20,8,0
57373,365,210,155,46,30,24,12,715,348,367,109,84,68,30,0
57374,117,57,60,17,14,11,10,630,321,309,86,90,57,26,0
57375,580,308,272,82,79,58,25,547,295,252,81,65,57,23,0
57376,411,236,175,39,45,50,30,434,213,221,77,62,53,12,0
57377,535,315,220,57,55,71,19,732,366,366,108,86,74,41,0
57378,126,58,68,31,10,10,3,582,264,318,84,60,58,23,0
57379,485,237,248,83,35,52,24,300,148,152,45,43,40,8,0
57380,125,46,79,24,16,12,2,385,212,173,57,40,39,21,0
57381,331,165,166,52,34,48,22,592,249,343,91,90,50,42,0
57382,132,66,66,21,18,11,7,334,181,153,56,31,28,18,0
57383,172,82,90,21,35,21,5,334,181,153,41,40,25,15,0
57384,550,304,246,60,64,77,16,160,60,100,23,40,19,11,0
57385,1555,702,853,250,199,139,31,359,171,188,49,74,45,11,0
57386,420,202,218,67,43,51,15,530,287,243,79,70,33,26,0
57387,908,324,584,181,162,81,29,1182,591,591,155,139,83,46,0
57388,204,93,111,35,35,16,11,647,324,323,101,80,76,43,0
57389,538,263,275,71,85,44,18,873,411,462,132,107,84,40,0
57390,462,258,204,59,41,56,15,373,189,184,54,46,50,23,0
57391,447,236,211,56,52,49,14,201,93,108,34,39,21,6,0
57392,130,71,59,30,9,8,1,507,270,237,89,59,57,22,0
57393,1499,864,635,141,99,76,110,133,61,72,21,19,13,4,0
57394,221,80,141,48,37,14,10,584,249,335,80,96,22,13,0
57395,341,154,187,34,36,11,11,392,155,237,68,61,34,16,0
57396,3703,1708,1995,456,428,305,162,190,93,97,35,27,23,2,0
57397,126,56,70,31,10,10,3,627,323,304,81,90,53,27,0
57398,282,160,122,36,28,27,7,397,234,163,44,38,23,21,0
57399,525,254,271,60,76,46,13,367,218,149,45,43,42,16,0
57400,275,125,150,37,48,27,7,862,409,453,149,125,86,29,0
57401,339,170,169,32,17,24,13,225,129,96,32,33,20,8,0
57402,278,104,174,46,34,23,14,520,272,248,60,65,58,22,0
57403,708,344,364,106,98,66,33,649,307,342,71,134,45,17,0
57404,861,393,468,150,101,69,35,469,225,244,64,68,25,11,0
57405,457,261,196,55,27,57,34,526,266,260,76,75,53,22,0
57406,646,304,342,104,93,58,26,285,143,142,45,32,21,17,0
57407,553,319,234,56,37,54,18,662,312,350,103,104,59,20,0
57408,350,212,138,32,26,40,13,621,310,311,100,106,77,27,0
57409,126,57,69,31,10,10,3,396,197,199,75,49,49,16,0
57410,3230,1724,1506,361,358,157,75,277,152,125,31,35,22,19,0
57411,1058,497,561,194,142,87,63,482,232,250,77,81,44,13,0
57412,734,366,368,121,99,63,39,397,234,163,44,38,23,21,0
57413,347,154,193,48,51,25,11,364,189,175,58,41,35,17,0
57414,687,351,336,106,67,70,41,348,194,154,57,31,43,12,0
57415,325,177,148,40,24,23,13,339,180,159,36,29,16,16,0
57416,126,58,68,31,10,10,3,445,202,243,70,73,51,15,0
57417,607,305,302,92,89,74,23,1065,581,484,134,97,76,46,0
57418,786,378,408,106,98,77,39,119,61,58,17,12,10,6,0
57419,1544,738,806,239,217,145,91,380,178,202,69,53,37,10,0
57420,1257,464,793,221,264,75,37,297,164,133,45,39,40,9,0
57421,299,151,148,35,34,26,16,462,229,233,63,49,42,18,0
57422,107,53,54,15,15,13,4,410,197,213,67,43,56,18,0
57423,130,70,60,30,9,8,1,232,111,121,23,29,17,9,0
57424,362,174,188,46,55,35,23,86,40,46,16,13,9,7,0
57425,861,393,468,150,101,69,35,332,155,177,55,51,44,13,0
57426,164,61,103,47,19,14,5,306,157,149,52,35,39,16,0
57427,255,110,145,34,32,23,17,1323,690,633,132,178,112,61,0
57428,410,200,210,60,54,46,19,257,126,131,61,24,22,8,0
57429,860,349,511,166,166,58,19,137,85,52,15,11,11,2,0
57430,488,237,251,79,78,65,27,362,156,206,74,42,36,22,0
57431,509,251,258,69,49,55,17,732,402,330,81,86,87,33,0
57432,567,256,311,91,81,53,17,153,65,88,28,21,20,8,0
57433,813,412,401,114,93,112,26,766,386,380,101,81,78,31,0
57434,317,140,177,43,26,31,16,277,138,139,40,39,20,14,0
57435,1058,497,561,194,142,87,63,129,60,69,21,15,8,5,0
57436,1174,594,580,175,155,126,66,926,340,586,133,119,60,40,0
57437,1755,849,906,245,226,148,56,222,124,98,37,29,22,9,0
57438,729,351,378,111,98,58,18,346,178,168,58,41,33,12,0
57439,1544,738,806,239,217,145,91,225,111,114,32,34,32,16,0
57440,594,248,346,104,109,53,5,501,257,244,75,57,48,29,0
57441,482,245,237,69,64,66,24,337,170,167,59,33,47,17,0
57442,734,366,368,121,99,63,39,457,245,212,62,58,57,21,0
57443,230,114,116,30,33,29,8,1265,689,576,169,177,128,60,0
57444,530,259,271,83,50,54,41,736,388,348,88,85,67,28,0
57445,320,163,157,44,44,26,15,715,345,370,110,97,64,25,0
57446,283,172,111,39,31,29,8,630,321,309,86,90,57,26,0
57447,341,183,158,36,34,36,15,925,439,486,141,134,105,46,0
57448,510,288,222,44,36,24,7,598,333,265,79,66,54,33,0
57449,149,78,71,20,20,19,5,584,249,335,80,96,22,13,0
57450,1139,537,602,162,139,109,50,1321,653,668,186,195,70,35,0
57451,952,547,405,95,90,127,35,103,50,53,19,10,7,5,0
57452,379,217,162,47,20,50,23,903,436,467,128,116,83,33,0
57453,682,260,422,153,78,109,46,265,134,131,48,34,33,15,0
57454,207,93,114,20,33,19,10,630,321,309,86,90,57,26,0
57455,1365,590,775,257,168,136,93,449,252,197,61,52,36,18,0
57456,90,54,36,20,4,14,5,1214,475,739,177,250,89,49,0
57457,665,341,324,109,79,38,22,947,482,465,143,107,89,37,0
57458,726,312,414,121,73,82,23,172,79,93,34,27,23,10,0
57459,319,153,166,61,52,26,12,773,389,384,119,91,79,26,0
57460,130,70,60,30,9,8,1,68,23,45,12,9,3,9,0
57461,342,150,192,52,43,31,17,501,240,261,80,62,49,42,0
57462,192,91,101,28,21,18,8,380,178,202,69,53,37,10,0
57463,484,261,223,59,48,49,24,368,204,164,43,35,30,24,0
57464,358,212,146,51,36,33,9,627,289,338,101,73,62,43,0
57465,335,148,187,52,26,51,12,389,210,179,51,37,43,9,0
57466,258,126,132,38,22,29,8,751,394,357,107,96,73,35,0
57467,269,156,113,37,32,17,7,148,84,64,30,7,17,4,0
57468,502,274,228,64,49,75,17,485,244,241,80,55,59,20,0
57469,341,154,187,34,36,11,11,335,186,149,40,28,29,13,0
57470,418,163,255,57,54,38,24,373,213,160,44,33,26,17,0
57471,447,225,222,76,35,75,21,1249,638,611,166,153,141,45,0
57472,2414,1189,1225,277,178,170,169,496,251,245,78,62,61,23,0
57473,484,192,292,118,68,83,22,374,174,200,54,52,42,21,0
57474,163,70,93,28,21,17,6,312,165,147,41,39,29,16,0
57475,350,178,172,49,62,29,16,190,93,97,35,27,23,2,0
57476,2696,1169,1527,432,347,193,146,292,155,137,50,34,29,13,0
57477,221,80,141,48,37,14,10,663,354,309,91,84,79,31,0
57478,509,251,258,69,49,55,17,166,78,88,27,25,19,7,0
57479,958,451,507,165,135,97,41,958,451,507,165,135,97,41,0
57480,410,211,199,55,42,34,27,200,89,111,26,25,17,7,0
57481,2624,999,1625,415,495,109,84,261,127,134,36,27,36,4,0
57482,344,168,176,50,39,30,20,179,101,78,25,15,13,13,0
57483,103,44,59,16,17,9,5,219,105,114,36,29,19,8,0
57484,250,123,127,40,28,29,8,403,225,178,56,38,33,25,0
57485,3859,2011,1848,535,391,422,207,2382,1162,1220,237,220,140,49,0
57486,346,205,141,47,34,30,7,222,127,95,23,28,22,7,0
57487,240,99,141,53,38,29,15,441,189,252,73,50,47,23,0
57488,143,81,62,28,9,8,1,935,515,420,126,107,73,32,0
57489,600,324,276,89,73,45,39,89,37,52,13,6,2,9,0
57490,433,188,245,63,45,26,14,1020,538,482,145,115,111,58,0
57491,264,122,142,46,24,35,10,194,94,100,33,28,14,7,0
57492,403,176,227,71,56,51,11,323,162,161,52,41,39,13,0
57493,345,208,137,44,27,33,8,524,300,223,70,54,51,25,0
57494,439,220,219,63,72,25,20,134,72,62,14,28,8,4,0
57495,200,103,97,17,16,10,10,72,34,38,8,2,3,12,0
57496,772,332,440,136,104,72,28,72,32,40,8,2,1,14,0
57497,482,245,237,69,64,66,24,457,242,215,39,46,53,10,0
57498,650,330,320,97,77,65,28,328,195,133,39,40,27,13,0
57499,288,140,148,59,33,27,12,555,292,263,75,63,67,27,0
57500,345,208,137,44,27,33,8,137,78,59,22,16,17,4,0
57501,484,264,220,59,62,68,15,102,51,51,12,15,12,3,0
57502,333,171,162,50,34,19,8,119,61,58,17,12,10,6,0
57503,613,303,310,70,28,28,18,640,364,276,84,68,69,33,0
57504,520,261,259,74,52,49,22,230,113,117,31,40,28,10,0
57505,350,190,160,48,25,27,18,261,162,99,24,21,14,10,0
57506,540,252,288,73,67,57,20,296,151,145,45,42,32,11,0
57507,437,167,270,126,95,34,10,821,394,427,122,117,109,38,0
57508,502,274,228,64,49,75,17,201,98,103,28,25,19,13,0
57509,1417,598,819,223,188,135,58,54,26,28,11,4,3,3,0
57510,361,177,184,59,51,24,15,205,94,111,48,31,15,6,0
57511,401,183,218,72,73,28,10,474,268,206,66,42,45,24,0
57512,1199,589,610,189,128,167,65,267,141,126,53,27,23,7,0
57513,437,212,225,66,44,44,11,766,386,380,101,81,78,31,0
57514,1148,472,676,229,164,86,37,218,117,101,35,32,34,12,0
57515,407,230,177,44,39,34,19,196,105,91,40,13,19,10,0
57516,571,298,273,81,72,57,25,415,189,226,68,54,50,21,0
57517,358,206,152,45,38,67,16,290,147,143,34,34,39,13,0
57518,629,374,255,74,53,87,27,1338,720,618,179,145,141,85,0
57519,340,145,195,46,38,26,23,178,69,109,29,25,21,13,0
57520,292,102,190,71,27,51,21,898,469,429,125,125,134,35,0
57521,407,207,200,53,36,38,8,447,212,235,86,55,58,21,0
57522,446,195,251,56,53,31,15,1696,771,925,257,225,149,63,0
57523,255,126,129,41,37,13,5,368,183,185,40,42,40,15,0
57524,412,203,209,65,47,37,18,207,114,93,33,20,31,13,0
57525,2799,1324,1475,369,371,215,124,301,168,133,49,37,34,11,0
57526,356,199,157,36,43,28,12,862,409,453,149,125,86,29,0
57527,575,295,280,89,68,54,18,180,90,90,31,19,20,8,0
57528,785,351,434,136,93,71,37,1755,905,850,214,196,183,79,0
57529,977,462,515,185,119,76,12,180,89,91,28,27,18,7,0
57530,439,183,256,60,64,36,14,396,213,183,68,44,47,18,0
57531,639,368,271,72,51,38,38,323,162,161,52,41,39,13,0
57532,261,137,124,34,23,13,8,978,536,442,132,107,67,32,0
57533,674,318,356,86,139,50,11,481,223,258,71,70,49,26,0
57534,259,119,140,48,28,29,19,200,89,111,26,25,17,7,0
57535,166,59,107,36,41,10,4,415,226,189,51,40,40,29,0
57536,166,59,107,36,41,10,4,290,147,143,34,34,39,13,0
57537,484,264,220,59,62,68,15,88,50,38,13,8,16,4,0
57538,933,456,477,123,108,83,29,106,46,60,29,13,14,5,0
57539,350,172,178,61,45,32,13,710,375,335,95,94,110,28,0
57540,4128,2104,2024,581,505,453,205,462,251,211,74,53,41,18,0
57541,887,439,448,137,99,91,38,194,109,85,23,24,21,9,0
57542,574,269,305,91,63,54,27,302,150,152,56,40,52,15,0
57543,319,222,97,36,23,28,8,555,282,273,82,69,65,21,0
57544,335,155,180,64,48,36,10,142,73,69,27,9,15,11,0
57545,610,249,361,107,69,72,33,297,175,122,46,30,31,6,0
57546,126,57,69,31,10,10,3,904,436,468,143,118,108,32,0
57547,82,36,46,17,10,5,1,1239,659,580,169,148,131,54,0
57548,626,308,318,105,89,77,25,261,148,113,31,28,14,10,0
57549,1390,705,685,219,164,129,74,582,264,318,84,60,58,23,0
57550,269,124,145,36,24,32,11,398,200,198,68,43,51,14,0
57551,83,45,38,11,8,8,3,4646,2328,2318,674,639,475,170,0
57552,234,110,124,39,29,23,2,207,86,121,34,39,11,13,0
57553,346,168,178,36,43,20,9,627,289,338,101,73,62,43,0
57554,314,178,136,42,32,30,17,234,129,105,31,22,19,17,0
57555,521,249,272,53,36,50,18,271,150,121,39,36,37,5,0
57556,502,250,252,70,47,57,15,1062,522,540,151,147,105,66,0
57557,202,103,99,28,20,12,8,165,87,78,24,19,22,9,0
57558,98,32,66,15,25,5,4,87,38,49,23,10,10,9,0
57559,1068,434,634,173,160,61,29,605,283,322,94,72,64,39,0
57560,157,62,95,41,18,10,11,166,90,76,27,18,21,5,0
57561,330,77,253,86,52,20,12,303,137,166,54,54,31,15,0
57562,527,276,251,64,60,70,20,662,312,350,103,104,59,20,0
57563,458,226,232,77,59,61,14,1696,771,925,257,225,149,63,0
57564,960,409,551,166,134,77,44,445,202,243,70,73,51,15,0
57565,500,245,255,66,57,52,27,583,321,262,73,67,45,25,0
57566,1365,590,775,257,168,136,93,285,146,139,41,41,48,13,0
57567,406,207,199,56,46,68,19,647,350,297,95,79,77,29,0
57568,167,70,97,32,20,15,7,447,212,235,86,55,58,21,0
57569,708,344,364,106,98,66,33,492,278,214,65,58,32,11,0
57570,360,205,155,35,24,52,14,106,46,60,29,13,14,5,0
57571,911,445,466,154,121,108,48,153,80,73,26,18,19,4,0
57572,885,424,461,143,114,92,32,293,153,140,45,38,22,15,0
57573,368,154,214,80,52,41,16,475,251,224,67,49,48,23,0
57574,291,120,171,63,39,26,6,904,436,468,143,118,108,32,0
57575,413,169,244,66,94,28,19,1249,638,611,166,153,141,45,0
57576,784,353,431,56,47,26,18,265,134,131,48,34,33,15,0
57577,348,174,174,45,34,45,15,119,57,62,18,16,17,4,0
57578,130,70,60,30,9,8,1,727,362,365,123,107,63,23,0
57579,467,233,234,83,37,77,22,462,251,211,74,53,41,18,0
57580,331,144,187,57,46,33,19,1040,564,476,134,110,114,51,0
57581,546,265,281,101,64,38,16,783,406,377,102,91,57,29,0
57582,462,228,234,59,47,37,32,131,55,76,28,9,14,12,0
57583,473,212,261,72,64,45,28,515,276,239,62,59,43,31,0
57584,243,100,143,58,50,24,5,723,353,370,120,109,96,33,0
57585,127,54,73,31,10,11,3,736,388,348,88,85,67,28,0
57586,270,128,142,36,43,15,11,778,391,387,94,77,41,33,0
57587,1112,457,655,180,164,99,39,87,38,49,23,10,10,9,0
57588,164,77,87,33,19,6,7,963,455,508,127,130,115,48,0
57589,772,417,355,118,92,80,23,1537,701,836,209,187,129,58,0
57590,887,439,448,137,99,91,38,148,69,79,26,18,16,3,0
57591,961,465,496,139,156,62,34,601,279,322,81,65,27,12,0
57592,395,189,206,63,50,49,28,2225,1244,981,271,243,217,93,0
57593,143,81,62,28,9,8,1,415,203,212,77,44,49,18,0
57594,607,305,302,92,89,74,23,710,375,335,95,94,110,28,0
57595,240,99,141,53,38,29,15,204,80,124,29,51,10,5,0
57596,179,78,101,29,22,10,8,147,74,73,28,20,24,4,0
57597,126,57,69,31,10,10,3,536,267,269,60,70,41,22,0
57598,631,304,327,98,75,52,23,2202,1121,1081,338,274,269,81,0
57599,1030,567,463,118,106,94,49,403,221,182,62,50,42,12,0
57600,258,126,132,38,22,29,8,524,300,223,70,54,51,25,0
57601,2109,999,1110,332,294,187,89,292,155,137,50,34,29,13,0
57602,401,236,165,53,38,34,9,271,150,121,39,36,37,5,0
57603,350,190,160,48,25,27,18,261,148,113,31,28,14,10,0
57604,238,158,80,28,15,31,7,509,267,242,79,81,38,20,0
57605,280,128,152,39,37,38,18,1537,701,836,209,187,129,58,0
57606,860,349,511,166,166,58,19,222,122,100,39,32,24,9,0
57607,417,176,241,75,61,51,20,139,68,71,14,26,14,9,0
57608,734,339,395,135,89,78,36,498,244,254,81,67,58,19,0
57609,251,131,120,49,35,25,5,251,143,108,47,25,29,11,0
57610,395,219,176,47,41,50,18,329,194,135,45,32,33,9,0
57611,532,291,241,83,36,79,25,701,380,321,94,84,96,34,0
57612,1023,449,574,141,174,76,43,370,173,197,65,57,42,10,0
57613,526,268,258,54,37,55,12,462,229,233,63,49,42,18,0
57614,760,405,355,112,95,92,29,180,90,90,31,19,20,8,0
57615,1284,511,773,227,166,169,107,137,63,74,20,22,14,6,0
57616,305,124,181,27,25,31,21,98,49,49,14,15,9,2,0
57617,1199,589,610,189,128,167,65,218,118,100,33,30,25,11,0
57618,586,309,277,81,64,76,25,1162,528,634,193,161,107,74,0
57619,282,163,119,40,23,25,17,138,69,69,28,7,10,10,0
57620,574,284,290,64,50,65,20,220,107,113,36,35,28,9,0
57621,335,155,180,64,48,36,10,201,99,102,34,26,23,6,0
57622,291,131,160,49,35,32,15,262,129,133,40,41,31,10,0
57623,170,82,88,32,23,22,8,620,324,296,81,68,66,31,0
57624,503,260,243,46,56,33,16,455,191,264,68,86,21,19,0
57625,756,362,394,102,104,73,25,660,333,327,102,95,69,31,0
57626,1594,660,934,251,272,117,77,277,124,153,44,40,35,18,0
57627,781,367,414,60,67,43,17,671,306,365,114,76,49,19,0
57628,593,282,311,75,70,29,25,89,42,47,16,12,15,6,0
57629,447,232,215,55,65,50,25,381,187,194,37,49,36,17,0
57630,436,209,227,66,47,52,22,600,254,346,104,100,44,17,0
57631,332,170,162,44,38,39,10,160,60,100,23,40,19,11,0
57632,505,226,279,68,51,30,15,354,188,166,46,40,34,10,0
57633,315,174,141,46,38,47,16,287,151,136,51,42,36,7,0
57634,755,271,484,113,226,61,20,104,46,58,15,17,9,5,0
57635,281,154,127,45,31,24,9,479,215,264,67,80,46,28,0
57636,333,171,162,41,44,48,23,289,140,149,33,42,30,15,0
57637,507,242,265,53,44,31,22,242,124,118,39,32,28,22,0
57638,388,209,179,46,24,31,28,474,268,206,66,42,45,24,0
57639,103,56,47,27,7,8,2,424,179,245,65,67,29,11,0
57640,179,78,101,29,22,10,8,267,141,126,53,27,23,7,0
57641,269,156,113,37,32,17,7,439,231,208,65,51,55,17,0
57642,186,56,130,46,50,16,7,293,142,151,49,40,42,17,0
57643,586,298,288,80,75,64,37,547,295,252,81,65,57,23,0
57644,648,262,386,113,108,78,29,319,185,134,42,31,22,13,0
57645,505,247,258,72,71,60,27,332,180,152,44,36,27,13,0
57646,299,128,171,57,40,13,25,387,193,194,60,53,57,15,0
57647,502,236,266,66,66,58,17,640,364,276,84,68,69,33,0
57648,304,149,155,46,32,39,14,89,37,52,13,6,2,9,0
57649,1499,864,635,141,99,76,110,160,60,100,23,40,19,11,0
57650,1872,837,1035,280,338,169,80,302,150,152,56,40,52,15,0
57651,392,221,171,53,30,25,8,152,71,81,41,16,14,2,0
57652,356,199,157,36,43,28,12,492,278,214,65,58,32,11,0
57653,360,175,185,73,36,27,7,397,234,163,44,38,23,21,0
57654,273,126,147,54,49,25,18,142,65,77,30,17,22,9,0
57655,316,157,159,45,38,22,19,125,66,59,24,16,11,5,0
57656,159,105,54,22,9,14,25,601,278,323,124,87,65,21,0
57657,341,175,166,48,43,35,18,447,212,235,86,55,58,21,0
57658,504,222,282,71,64,53,29,929,459,470,140,120,94,45,0
57659,364,204,160,65,35,15,13,408,221,187,55,51,57,14,0
57660,800,416,384,102,105,83,22,403,233,170,38,29,21,14,0
57661,335,183,152,40,26,54,22,518,292,226,60,60,52,21,0
57662,1043,479,564,200,131,123,62,485,244,241,80,55,59,20,0
57663,508,251,257,74,53,51,18,348,212,136,53,31,25,18,0
57664,134,60,74,19,13,10,7,748,359,389,125,113,86,31,0
57665,616,304,312,75,71,55,25,166,90,76,27,18,21,5,0
57666,822,416,406,111,97,88,42,165,90,75,36,18,20,6,0
57667,1647,794,853,279,235,128,65,198,110,88,27,27,24,4,0
57668,484,192,292,118,68,83,22,222,124,98,37,29,22,9,0
57669,435,225,210,58,46,50,14,390,190,200,66,50,43,12,0
57670,445,231,214,45,64,53,23,89,42,47,16,12,15,6,0
57671,1023,449,574,141,174,76,43,507,270,237,89,59,57,22,0
57672,338,173,165,31,42,22,10,173,90,83,21,36,12,15,0
57673,764,277,487,158,162,64,31,137,63,74,20,22,14,6,0
57674,233,107,126,40,40,20,16,334,182,152,45,41,27,13,0
57675,745,402,343,95,71,69,40,975,475,500,139,140,119,28,0
57676,707,250,457,171,84,117,61,810,310,500,164,162,42,26,0
57677,226,120,106,68,8,2,1,148,84,64,30,7,17,4,0
57678,232,134,98,28,20,20,5,225,114,111,32,29,26,6,0
57679,396,150,246,103,64,38,3,474,268,206,66,42,45,24,0
57680,282,105,177,77,28,39,6,447,212,235,86,55,58,21,0
57681,241,122,119,27,34,17,16,889,505,384,107,97,99,30,0
57682,756,362,394,102,104,73,25,231,126,105,37,26,29,6,0
57683,410,211,199,55,42,34,27,741,383,358,92,63,79,36,0
57684,227,120,107,31,28,28,13,314,151,163,42,61,39,16,0
57685,243,114,129,37,30,32,8,72,32,40,8,2,2,13,0
57686,55,16,39,24,2,5,2,415,203,212,77,44,49,18,0
57687,929,410,519,187,146,53,30,389,207,182,53,58,52,18,0
57688,707,250,457,171,84,117,61,898,469,429,125,125,134,35,0
57689,563,255,308,91,111,42,30,127,64,63,26,8,12,8,0
57690,574,284,290,64,50,65,20,978,536,442,132,107,67,32,0
57691,627,237,390,137,57,108,44,549,273,276,74,68,72,24,0
57692,484,261,223,59,48,49,24,661,325,336,81,75,65,28,0
57693,130,70,60,30,9,8,1,679,338,341,96,95,40,23,0
57694,443,212,231,74,24,60,24,264,138,126,33,34,29,12,0
57695,373,194,179,42,54,26,13,166,90,76,27,18,21,5,0
57696,813,412,401,114,93,112,26,127,66,61,13,14,19,8,0
57697,469,221,248,49,60,55,21,480,255,225,67,64,50,22,0
57698,508,251,257,74,53,51,18,452,231,221,74,53,56,20,0
57699,833,295,538,146,139,65,34,329,194,135,45,32,33,9,0
57700,869,489,380,110,77,79,29,290,142,148,41,37,43,11,0
57701,548,250,298,85,64,56,21,201,98,103,28,25,19,13,0
57702,161,75,86,24,20,10,7,471,238,233,66,63,62,19,0
57703,313,134,179,58,37,43,19,296,151,145,45,42,32,11,0
57704,752,313,439,121,106,68,27,1537,701,836,209,187,129,58,0
57705,67,40,27,10,8,7,6,54,26,28,11,4,3,3,0
57706,164,77,87,33,19,6,7,374,191,183,40,52,40,16,0
57707,1058,497,561,194,142,87,63,317,161,156,40,49,41,11,0
57708,1960,875,1085,287,189,162,66,297,164,133,45,39,40,9,0
57709,272,136,136,32,34,12,12,403,221,182,62,50,42,12,0
57710,619,289,330,67,77,36,19,1382,508,874,334,320,98,36,0
57711,772,417,355,118,92,80,23,671,306,365,114,76,49,19,0
57712,302,160,142,35,35,37,10,172,88,84,24,31,20,12,0
57713,317,140,177,43,26,31,16,128,63,65,30,11,13,8,0
57714,736,353,383,117,83,71,18,515,276,239,62,59,43,31,0
57715,130,71,59,30,9,8,1,137,78,59,22,16,17,4,0
57716,346,209,137,46,37,44,10,180,108,72,22,22,15,5,0
57717,435,187,248,62,51,51,21,144,67,77,28,14,9,8,0
57718,381,146,235,74,48,47,34,463,268,195,59,46,46,21,0
57719,330,182,148,47,27,40,11,346,178,168,58,41,33,12,0
57720,136,66,70,33,11,9,5,194,109,85,23,24,21,9,0
57721,272,94,178,76,33,19,4,265,134,131,48,34,33,15,0
57722,180,57,123,39,22,10,8,349,200,149,41,39,30,20,0
57723,447,225,222,76,35,75,21,408,221,187,55,51,57,14,0
57724,732,355,377,108,109,79,27,496,285,211,62,54,46,22,0
57725,250,123,127,40,28,29,8,551,226,325,96,103,43,11,0
57726,435,222,213,67,49,67,12,352,207,145,40,33,25,21,0
57727,160,53,107,31,29,13,3,153,65,88,28,21,20,8,0
57728,485,237,248,83,35,52,24,843,391,452,139,104,91,35,0
57729,559,217,342,105,86,42,16,194,94,100,33,28,14,7,0
57730,407,230,177,44,39,34,19,246,125,121,38,36,30,11,0
57731,562,214,348,120,86,69,42,297,175,122,46,30,31,6,0
57732,340,169,171,40,39,36,22,298,129,169,51,40,29,8,0
57733,837,443,394,129,89,87,38,283,160,123,25,20,37,9,0
57734,393,223,170,44,36,32,14,204,96,108,31,37,20,5,0
57735,278,110,168,58,49,29,5,582,264,318,84,60,58,23,0
57736,172,98,74,20,21,22,8,406,234,172,63,35,43,10,0
57737,313,148,165,45,33,36,11,430,212,218,88,43,40,20,0
57738,785,374,411,56,42,38,25,392,214,178,48,40,53,22,0
57739,270,166,104,30,26,28,14,180,89,91,28,27,18,7,0
57740,207,93,114,20,33,19,10,242,121,121,39,30,29,10,0
57741,416,222,194,58,38,38,20,520,272,248,60,65,58,22,0
57742,747,360,387,125,92,69,32,649,307,342,71,134,45,17,0
57743,1087,523,564,146,177,103,33,134,72,62,14,28,8,4,0
57744,1560,778,782,224,235,132,78,295,160,135,42,37,46,16,0
57745,478,177,301,109,66,59,25,386,207,179,43,48,44,19,0
57746,103,56,47,27,7,8,2,520,272,248,60,65,58,22,0
57747,1594,660,934,251,272,117,77,300,148,152,45,43,40,8,0
57748,953,421,532,131,131,70,37,201,104,97,36,32,24,7,0
57749,345,203,142,47,35,31,11,265,134,131,48,34,33,15,0
57750,519,245,274,58,61,34,22,101,59,42,11,17,10,1,0
57751,136,66,70,33,11,9,4,277,138,139,40,39,20,14,0
57752,330,77,253,86,52,20,12,260,131,129,42,31,40,9,0
57753,501,230,271,63,90,50,18,377,184,193,50,43,33,17,0
57754,927,457,470,130,99,118,42,148,84,64,30,7,17,4,0
57755,243,100,143,58,50,24,5,395,169,226,73,55,38,9,0
57756,565,264,301,101,73,72,15,175,82,93,33,26,17,5,0
57757,372,189,183,60,44,41,18,509,267,242,79,81,38,20,0
57758,649,304,345,99,80,67,40,732,366,366,108,86,74,41,0
57759,426,214,212,63,47,53,20,277,138,139,40,39,20,14,0
57760,215,104,111,61,7,2,1,1395,627,768,172,263,141,59,0
57761,270,166,104,30,26,28,14,1249,638,611,166,153,141,45,0
57762,122,56,66,26,13,11,5,349,200,149,41,39,30,20,0
57763,502,274,228,64,49,75,17,106,46,60,27,18,12,3,0
57764,488,237,251,79,78,65,27,1378,692,686,194,174,105,56,0
57765,524,270,254,84,72,70,23,350,196,154,52,37,21,14,0
57766,271,136,135,37,30,18,10,352,207,145,40,33,25,21,0
57767,502,229,273,63,66,40,31,429,187,242,79,72,28,19,0
57768,803,358,445,135,117,80,43,2382,1162,1220,237,220,140,49,0
57769,346,168,178,36,43,20,9,91,44,47,9,12,4,7,0
57770,1214,612,602,169,173,98,35,137,63,74,20,22,14,6,0
57771,126,58,68,31,10,10,3,374,181,193,55,58,48,23,0
57772,1284,511,773,227,166,169,107,556,290,266,75,74,29,24,0
57773,203,80,123,40,37,20,3,858,461,397,125,114,79,45,0
57774,211,92,119,33,44,11,7,419,233,186,54,53,55,17,0
57775,118,56,62,24,12,6,9,172,79,93,34,27,23,10,0
57776,280,128,152,39,37,38,18,172,79,93,34,27,23,10,0
57777,911,489,422,121,98,97,36,341,170,171,41,66,27,10,0
57778,273,126,147,54,49,25,18,188,105,83,25,17,24,7,0
57779,419,210,209,54,44,31,23,418,246,172,52,39,57,10,0
57780,282,135,147,27,37,30,19,453,247,206,58,53,45,20,0
57781,484,261,223,59,48,49,24,363,180,183,60,34,10,6,0
57782,977,462,515,185,119,76,12,103,44,59,16,17,9,5,0
57783,213,104,109,56,14,9,2,325,159,166,59,46,30,12,0
57784,507,314,193,49,45,59,25,496,251,245,78,62,61,23,0
57785,833,295,538,146,139,65,34,1166,514,652,150,159,107,70,0
57786,203,80,123,40,37,20,3,2346,1231,1115,316,292,266,105,0
57787,2062,706,1356,414,368,158,63,346,178,168,58,41,33,12,0
57788,392,221,171,53,30,25,8,935,515,420,126,107,73,32,0
57789,658,349,309,77,70,73,35,314,177,137,34,40,29,9,0
57790,1004,464,540,143,104,78,55,935,515,420,126,107,73,32,0
57791,1327,520,807,241,174,141,60,364,189,175,58,41,35,17,0
57792,365,210,155,46,30,24,12,1020,538,482,145,115,111,58,0
57793,299,151,148,35,34,26,16,524,300,223,70,54,51,25,0
57794,326,154,172,45,39,20,10,160,76,84,19,24,8,5,0
57795,270,131,139,47,37,41,11,432,244,188,51,51,27,14,0
57796,487,256,231,72,41,65,31,729,420,309,73,78,57,37,0
57797,557,250,307,70,47,51,22,592,249,343,91,90,50,42,0
57798,290,156,134,44,29,39,9,370,173,197,65,57,42,10,0
57799,327,174,153,42,35,16,12,498,244,254,81,67,58,19,0
57800,717,281,436,165,81,112,49,154,78,76,23,21,13,5,0
57801,431,202,229,57,50,50,25,671,321,350,95,87,75,34,0
57802,450,231,219,77,50,76,16,482,232,250,77,81,44,13,0
57803,406,208,198,41,26,43,21,467,240,227,65,65,51,23,0
57804,335,148,187,52,26,51,12,579,285,294,78,72,64,32,0
57805,2109,999,1110,332,294,187,89,368,200,168,54,49,43,9,0
57806,682,260,422,153,78,109,46,744,385,359,105,96,57,31,0
57807,127,55,72,25,18,5,7,302,150,152,56,40,52,15,0
57808,347,198,149,45,29,29,8,132,67,65,24,21,8,10,0
57809,526,268,258,54,37,55,12,516,245,271,82,84,70,26,0
57810,200,103,97,17,16,10,10,679,338,341,96,95,40,23,0
57811,530,259,271,83,50,54,41,166,88,78,23,18,13,7,0
57812,71,28,43,15,9,5,2,1262,653,609,169,165,152,50,0
57813,317,140,177,43,26,31,16,406,202,204,54,51,63,21,0
57814,319,153,166,61,52,26,12,277,145,132,41,32,22,10,0
57815,215,104,111,61,7,2,1,457,253,204,67,51,48,13,0
57816,496,209,287,113,55,72,14,704,355,349,113,94,71,24,0
57817,594,248,346,104,109,53,5,374,212,162,48,40,32,23,0
57818,278,104,174,46,34,23,14,1696,771,925,257,225,149,63,0
57819,232,134,98,28,20,20,5,727,388,339,102,87,70,29,0
57820,410,208,202,59,58,43,26,188,88,100,53,12,15,6,0
57821,345,203,142,47,35,31,11,373,189,184,54,46,50,23,0
57822,361,183,178,50,54,51,22,601,278,323,124,87,65,21,0
57823,525,302,223,56,48,67,19,422,237,185,53,47,62,20,0
57824,327,174,153,42,35,16,12,1113,480,633,170,173,81,34,0
57825,1849,931,918,245,220,158,90,125,66,59,24,16,11,5,0
57826,136,66,70,33,11,9,4,492,278,214,65,58,32,11,0
57827,210,101,109,33,33,19,9,375,211,164,50,36,31,23,0
57828,977,462,515,185,119,76,12,413,223,190,52,45,53,10,0
57829,463,250,213,56,45,73,25,309,164,145,35,47,30,11,0
57830,290,156,134,44,29,39,9,1034,495,539,150,134,114,71,0
57831,361,183,178,50,54,51,22,620,324,296,81,68,66,31,0
57832,508,251,257,74,53,51,18,137,72,65,27,13,15,8,0
57833,579,246,333,102,79,41,19,207,86,121,34,39,11,13,0
57834,437,212,225,66,44,44,11,316,159,157,38,48,30,11,0
57835,401,236,165,53,38,34,9,222,122,100,39,32,24,9,0
57836,285,148,137,31,42,42,16,393,210,183,58,37,34,20,0
57837,446,174,272,84,61,57,23,715,345,370,110,97,64,25,0
57838,605,277,328,99,54,63,43,1248,584,664,184,164,155,67,0
57839,472,222,250,46,61,33,23,212,127,85,28,21,26,6,0
57840,203,80,123,40,37,20,3,316,166,150,45,38,37,13,0
57841,745,402,343,95,71,69,40,906,455,451,116,105,87,46,0
57842,1360,644,716,213,194,136,62,572,305,267,74,72,58,21,0
57843,1068,434,634,173,160,61,29,166,78,88,27,25,19,7,0
57844,126,58,68,31,10,10,3,178,69,109,29,25,21,13,0
57845,380,187,193,38,51,30,18,389,210,179,51,37,43,9,0
57846,853,400,453,137,109,88,42,270,130,140,48,44,37,12,0
57847,340,181,159,44,39,35,21,583,321,262,73,67,45,25,0
57848,447,236,211,56,52,49,14,215,115,100,27,19,16,7,0
57849,753,395,358,93,72,71,16,1025,549,476,118,109,88,61,0
57850,243,114,129,37,30,32,8,132,77,55,20,9,13,10,0
57851,111,29,82,10,54,0,1,354,188,166,46,40,34,10,0
57852,794,322,472,122,108,79,34,188,105,83,25,17,24,7,0
57853,1867,973,894,256,222,194,65,457,245,212,62,58,57,21,0
57854,410,211,199,55,42,34,27,392,214,178,48,40,53,22,0
57855,331,144,187,57,46,33,19,2517,1275,1242,304,324,245,135,0
57856,484,192,292,118,68,83,22,482,232,250,77,81,44,13,0
57857,394,207,187,52,42,37,24,519,287,232,68,58,45,21,0
57858,707,250,457,171,84,117,61,108,59,49,17,13,12,5,0
57859,510,288,222,44,36,24,7,413,223,190,52,45,53,10,0
57860,359,198,161,51,28,54,13,403,221,182,47,41,47,8,0
57861,202,103,99,28,20,12,8,449,252,197,61,52,36,18,0
57862,422,196,226,52,35,33,20,166,88,78,23,18,13,7,0
57863,240,99,141,53,38,29,15,252,130,122,45,23,32,11,0
57864,524,361,163,41,8,28,16,295,156,139,41,40,42,15,0
57865,345,208,137,44,27,33,8,89,51,38,15,15,5,4,0
57866,562,214,348,120,86,69,42,406,202,204,54,51,63,21,0
57867,562,214,348,120,86,69,42,323,171,152,48,41,40,16,0
57868,227,120,107,31,28,28,13,134,72,62,14,28,8,4,0
57869,640,279,361,102,83,69,21,665,361,304,87,91,84,31,0
57870,589,282,307,68,67,70,23,337,152,185,49,54,42,21,0
57871,233,110,123,34,22,34,9,609,335,274,79,57,45,22,0
57872,349,153,196,54,47,28,13,295,158,137,42,34,38,14,0
57873,1556,718,838,280,182,161,49,663,354,309,91,84,79,31,0
57874,598,300,298,68,77,59,21,418,246,172,52,39,57,10,0
57875,126,57,69,31,10,10,3,1040,564,476,134,110,114,51,0
57876,325,181,144,46,31,48,9,91,44,47,9,12,4,7,0
57877,366,190,176,39,62,55,14,422,202,220,80,52,57,18,0
57878,130,70,60,30,9,8,1,663,354,309,91,84,79,31,0
57879,298,141,157,51,33,21,22,200,99,101,31,24,26,6,0
57880,619,289,330,67,77,36,19,766,386,380,101,81,78,31,0
57881,677,361,316,81,61,42,22,671,321,350,95,87,75,34,0
57882,123,58,65,22,14,13,3,286,152,134,38,38,32,11,0
57883,397,180,217,61,59,39,13,647,350,297,95,79,77,29,0
57884,1199,589,610,189,128,167,65,180,95,85,22,21,17,8,0
57885,234,110,124,39,29,23,2,188,88,100,53,12,15,6,0
57886,552,295,257,67,49,70,30,1114,539,575,145,131,94,56,0
57887,378,202,176,34,32,44,13,391,189,202,55,56,56,12,0
57888,1464,693,771,153,136,91,86,198,115,83,30,22,8,8,0
57889,717,281,436,165,81,112,49,373,213,160,44,33,26,17,0
57890,256,152,104,18,23,23,8,375,210,165,49,37,29,27,0
57891,410,209,201,72,30,48,22,359,171,188,49,74,45,11,0
57892,204,109,95,21,35,27,7,723,363,360,107,106,52,14,0
57893,335,171,164,51,38,38,10,469,225,244,64,68,25,11,0
57894,264,122,142,33,29,13,13,98,49,49,14,15,9,2,0
57895,270,166,104,30,26,28,14,261,148,113,31,28,14,10,0
57896,526,268,258,54,37,55,12,398,200,198,68,43,51,14,0
57897,301,156,145,32,25,15,5,296,140,156,49,40,42,19,0
57898,465,240,225,50,54,24,14,403,185,218,67,62,63,19,0
57899,1616,735,881,285,248,153,72,601,279,322,81,65,27,12,0
57900,135,64,71,31,11,8,4,240,141,99,34,28,29,8,0
57901,1342,640,702,187,163,123,57,274,157,117,40,29,40,8,0
57902,1064,495,569,157,159,124,58,137,78,59,22,16,17,4,0
57903,414,195,219,51,60,40,17,180,108,72,22,22,15,5,0
57904,801,331,470,151,139,99,55,240,141,99,34,28,29,8,0
57905,5890,3314,2576,970,956,293,265,1338,720,618,179,145,141,85,0
57906,146,75,71,13,32,15,11,188,88,100,53,12,15,6,0
57907,479,227,252,69,48,46,18,715,348,367,109,84,68,30,0
57908,1148,472,676,229,164,86,37,396,223,173,57,37,44,19,0
57909,557,250,307,70,47,51,22,139,68,71,14,26,14,9,0
57910,545,221,324,101,72,55,30,501,249,252,77,70,55,22,0
57911,131,69,62,29,9,9,1,124,69,55,14,7,9,4,0
57912,836,370,466,126,96,72,30,230,113,117,31,40,28,10,0
57913,246,123,123,40,31,27,7,564,264,300,79,84,65,26,0
57914,1124,442,682,148,189,72,43,4646,2328,2318,674,639,475,170,0
57915,525,254,271,60,76,46,13,139,68,71,14,26,14,9,0
57916,410,188,222,53,52,31,14,690,345,345,96,83,73,42,0
57917,2285,1219,1066,207,180,178,106,397,234,163,44,38,23,21,0
57918,259,119,140,48,28,29,19,664,350,314,86,90,82,36,0
57919,347,212,135,35,32,17,6,536,251,285,75,79,60,23,0
57920,593,325,268,84,66,73,24,447,214,233,67,65,62,20,0
57921,446,265,181,51,35,27,17,597,300,297,96,89,68,29,0
57922,109,50,59,12,12,9,3,751,394,357,107,96,73,35,0
57923,1001,422,579,185,180,51,32,323,162,161,52,41,39,13,0
57924,895,388,507,130,84,90,31,846,425,421,125,97,98,38,0
57925,643,284,359,129,71,84,43,375,176,199,48,61,40,12,0
57926,536,287,249,64,73,21,27,535,311,224,66,52,49,24,0
57927,362,174,188,46,55,35,23,561,279,282,85,81,88,24,0
57928,650,330,320,97,77,65,28,469,225,244,64,68,25,11,0
57929,961,465,496,139,156,62,34,218,117,101,35,32,34,12,0
57930,2624,999,1625,415,495,109,84,644,343,301,96,69,59,28,0
57931,134,60,74,19,13,10,7,483,258,225,70,53,54,20,0
57932,789,362,427,90,82,70,35,368,204,164,43,35,30,24,0
57933,894,448,446,123,100,82,30,482,232,250,77,81,44,13,0
57934,585,277,308,92,73,61,32,811,361,450,124,107,80,31,0
57935,396,150,246,103,64,38,3,2038,1059,979,262,237,208,100,0
57936,360,175,185,73,36,27,7,780,337,443,112,116,77,28,0
57937,164,81,83,37,8,14,10,282,134,148,38,45,29,10,0
57938,521,289,232,71,58,49,16,1606,753,853,215,227,182,48,0
57939,619,289,330,67,77,36,19,339,175,164,51,49,37,9,0
57940,339,118,221,77,68,33,13,292,155,137,50,34,29,13,0
57941,443,250,193,52,23,49,13,926,425,501,159,147,77,35,0
57942,469,221,248,49,60,55,21,598,333,265,79,66,54,33,0
57943,450,231,219,77,50,76,16,396,199,197,54,50,45,14,0
57944,530,259,271,83,50,54,41,617,314,303,96,68,68,37,0
57945,193,95,98,33,17,25,17,172,79,93,34,27,23,10,0
57946,588,300,288,100,57,65,27,723,363,360,107,106,52,14,0
57947,648,376,272,70,60,73,24,325,159,166,59,46,30,12,0
57948,480,257,223,74,26,60,27,1182,591,591,155,139,83,46,0
57949,781,316,465,130,129,65,23,375,176,199,48,61,40,12,0
57950,772,383,389,105,76,82,33,548,296,252,71,74,43,28,0
57951,1417,598,819,223,188,135,58,172,88,84,24,31,20,12,0
57952,125,53,72,18,21,18,12,209,119,90,28,24,27,9,0
57953,411,171,240,61,81,30,15,72,34,38,8,2,3,12,0
57954,815,356,459,128,125,82,26,200,89,111,26,25,17,7,0
57955,5890,3314,2576,970,956,293,265,244,143,101,31,29,26,8,0
57956,550,304,246,60,64,77,16,763,418,345,113,84,59,32,0
57957,498,274,224,58,59,50,18,329,194,135,45,32,33,9,0
57958,406,207,199,56,46,68,19,1020,538,482,145,115,111,58,0
57959,126,56,70,31,10,10,3,515,276,239,62,59,43,31,0
57960,126,57,69,31,10,10,3,403,185,218,67,62,63,19,0
57961,283,172,111,39,31,29,8,242,124,118,39,32,28,22,0
57962,2446,1099,1347,363,294,233,100,583,321,262,73,67,45,25,0
57963,589,282,307,68,67,70,23,265,134,131,48,34,33,15,0
57964,421,237,184,47,54,45,10,274,142,132,33,34,18,14,0
57965,919,444,475,141,148,62,20,72,34,38,8,2,3,12,0
57966,567,256,311,91,81,53,17,1755,905,850,214,196,183,79,0
57967,1112,457,655,180,164,99,39,548,273,275,84,81,64,30,0
57968,680,308,372,82,72,71,40,471,238,233,66,63,62,19,0
57969,758,378,380,89,64,37,31,1208,565,643,182,162,120,57,0
57970,236,141,95,36,32,14,6,366,204,162,47,41,31,23,0
57971,228,105,123,34,43,20,10,139,68,71,14,26,14,9,0
57972,367,167,200,63,42,60,17,396,197,199,75,49,49,16,0
57973,329,168,161,48,34,41,16,935,515,420,126,107,73,32,0
57974,435,187,248,62,51,51,21,1214,475,739,177,250,89,49,0
57975,643,284,359,129,71,84,43,129,60,69,21,15,8,5,0
57976,728,358,370,118,100,55,29,381,187,194,37,49,36,17,0
57977,1718,735,983,266,225,130,68,222,127,95,23,28,22,7,0
57978,711,330,381,111,86,86,34,548,296,252,71,74,43,28,0
57979,1501,679,822,251,196,174,67,317,161,156,40,49,41,11,0
57980,873,366,507,127,125,75,21,437,221,216,62,64,47,13,0
57981,961,465,496,139,156,62,34,457,245,212,62,58,57,21,0
57982,949,467,482,126,127,102,51,234,116,118,34,35,23,9,0
57983,594,279,315,93,68,68,26,374,202,172,50,39,31,24,0
57984,288,140,148,59,33,27,12,1101,626,475,145,122,120,50,0
57985,1912,880,1032,331,334,180,84,467,240,227,65,65,51,23,0
57986,290,156,134,44,29,39,9,457,242,215,39,46,53,10,0
57987,365,210,155,46,30,24,12,1262,653,609,169,165,152,50,0
57988,650,330,320,97,77,65,28,381,196,185,55,57,43,16,0
57989,704,342,362,113,91,85,33,194,109,85,23,24,21,9,0
57990,524,270,254,84,72,70,23,323,168,155,51,41,38,12,0
57991,1041,497,544,180,167,98,34,241,127,114,34,33,29,12,0
57992,338,139,199,54,54,18,11,509,267,242,79,81,38,20,0
57993,753,361,392,99,94,66,16,447,232,215,55,65,50,25,0
57994,258,144,114,33,22,19,9,137,63,74,20,22,14,6,0
57995,144,57,87,38,26,10,4,457,245,212,62,58,57,21,0
57996,1755,849,906,245,226,148,56,354,188,166,46,40,34,10,0
57997,404,197,207,60,48,47,20,649,307,342,71,134,45,17,0
57998,785,374,411,56,42,38,25,846,425,421,125,97,98,38,0
57999,2649,1431,1218,377,299,266,102,241,127,114,34,33,29,12,0
58000,532,291,241,83,36,79,25,892,475,417,130,108,68,38,0
58001,722,390,332,125,69,67,25,671,306,365,114,76,49,19,0
58002,881,492,389,87,97,59,51,282,134,148,38,45,29,10,0
58003,306,172,134,35,31,37,18,89,51,38,15,15,5,4,0
58004,318,161,157,53,51,32,13,555,292,263,75,63,67,27,0
58005,71,39,32,7,11,6,4,1001,417,584,186,147,96,47,0
58006,626,300,326,91,82,68,26,597,300,297,96,89,68,29,0
58007,343,189,154,44,24,39,12,88,50,38,13,8,16,4,0
58008,412,146,266,106,38,67,35,125,66,59,24,16,11,5,0
58009,483,236,247,82,60,43,18,535,301,234,63,48,47,27,0
58010,328,195,133,36,23,35,9,457,242,215,39,46,53,10,0
58011,282,96,186,80,21,28,7,218,111,107,45,29,24,6,0
58012,2663,1073,1590,548,499,192,64,378,154,224,74,84,35,22,0
58013,1068,434,634,173,160,61,29,296,159,137,49,28,38,13,0
58014,733,382,351,126,92,93,27,386,181,205,55,51,57,31,0
58015,376,176,200,31,53,27,8,364,189,175,58,41,35,17,0
58016,441,218,223,69,55,50,27,374,174,200,54,52,42,21,0
58017,150,60,90,27,16,6,3,467,231,236,71,65,58,18,0
58018,677,361,316,81,61,42,22,307,132,175,48,53,26,10,0
58019,376,176,200,31,53,27,8,821,394,427,122,117,109,38,0
58020,224,101,123,45,32,21,3,531,277,254,82,75,33,22,0
58021,733,438,295,95,79,67,32,873,411,462,132,107,84,40,0
58022,1009,487,522,177,121,103,51,305,163,142,38,27,47,11,0
58023,580,265,315,97,89,79,17,142,73,69,27,9,15,11,0
58024,375,201,174,52,56,39,15,297,164,133,45,39,40,9,0
58025,772,383,389,105,76,82,33,133,61,72,21,19,13,4,0
58026,494,233,261,87,57,46,18,175,91,84,19,21,21,10,0
58027,333,171,162,41,44,48,23,223,113,110,31,33,22,12,0
58028,156,64,92,31,19,5,4,397,234,163,44,38,23,21,0
58029,462,258,204,59,41,56,15,583,280,303,95,66,76,25,0
58030,3703,1708,1995,456,428,305,162,297,164,133,45,39,40,9,0
58031,193,110,83,18,20,15,12,737,397,340,87,104,90,14,0
58032,475,208,267,84,67,50,20,1182,591,591,155,139,83,46,0
58033,684,353,331,95,98,77,38,397,223,174,50,39,29,17,0
58034,457,228,229,64,36,52,21,160,60,100,23,40,19,11,0
58035,336,134,202,51,64,27,12,106,46,60,29,13,14,5,0
58036,368,201,167,61,38,38,12,1249,638,611,166,153,141,45,0
58037,193,90,103,44,9,19,13,724,353,371,94,95,71,31,0
58038,233,110,123,34,22,34,9,457,245,212,62,58,57,21,0
58039,240,167,73,32,12,8,21,203,98,105,34,29,19,10,0
58040,516,224,292,79,29,45,33,374,212,162,48,40,32,23,0
58041,440,267,173,52,29,42,12,415,203,212,77,44,49,18,0
58042,1105,544,561,165,167,99,40,1182,591,591,155,139,83,46,0
58043,467,226,241,55,48,54,23,1127,527,600,147,128,83,58,0
58044,722,390,332,125,69,67,25,439,231,208,65,51,55,17,0
58045,879,457,422,93,98,143,32,341,170,171,41,66,27,10,0
58046,245,111,134,31,44,20,11,1243,650,593,158,159,98,55,0
58047,550,304,246,60,64,77,16,555,292,263,75,63,67,27,0
58048,961,465,496,139,156,62,34,123,61,62,17,18,17,7,0
58049,3859,2011,1848,535,391,422,207,704,355,349,113,94,71,24,0
58050,172,82,90,21,35,21,5,175,91,84,19,21,21,10,0
58051,364,172,192,55,57,32,15,583,321,262,73,67,45,25,0
58052,462,228,234,59,47,37,32,72,32,40,8,2,2,13,0
58053,341,175,166,48,43,35,18,892,475,417,130,108,68,38,0
58054,805,338,467,153,138,99,55,250,119,131,58,26,29,7,0
58055,231,105,126,56,10,24,10,198,113,85,19,20,26,12,0
58056,2414,1189,1225,277,178,170,169,72,34,38,8,2,3,12,0
58057,325,186,139,49,36,20,5,166,88,78,23,18,13,7,0
58058,583,279,304,99,71,59,31,194,94,100,33,28,14,7,0
58059,437,167,270,126,95,34,10,425,177,248,60,62,33,16,0
58060,739,389,350,129,61,69,25,947,482,465,143,107,89,37,0
58061,553,276,277,88,61,45,27,384,212,172,44,43,34,14,0
58062,522,251,271,87,68,60,21,800,328,472,159,159,41,15,0
58063,143,81,62,28,9,8,1,397,223,174,50,39,29,17,0
58064,107,56,51,18,16,12,5,810,310,500,164,162,42,26,0
58065,1501,679,822,251,196,174,67,579,285,294,78,72,64,32,0
58066,393,223,170,44,36,32,14,247,128,119,34,14,16,14,0
58067,524,262,262,62,72,39,49,207,114,93,33,20,31,13,0
58068,213,114,99,62,7,2,1,479,215,264,67,80,46,28,0
58069,426,196,230,76,65,54,20,134,55,79,22,24,16,6,0
58070,837,443,394,129,89,87,38,549,273,276,74,68,72,24,0
58071,311,154,157,47,29,34,13,328,199,129,39,29,27,14,0
58072,215,80,135,54,56,21,9,332,180,152,46,36,28,14,0
58073,288,104,184,80,30,39,6,229,120,109,31,30,22,9,0
58074,246,123,123,40,31,27,7,290,142,148,41,37,43,11,0
58075,425,220,205,60,55,45,18,1696,771,925,257,225,149,63,0
58076,1054,453,601,183,183,107,35,508,253,255,73,60,50,13,0
58077,589,282,307,68,67,70,23,198,115,83,30,22,8,8,0
58078,439,205,234,64,88,41,21,127,66,61,13,14,19,8,0
58079,458,226,232,77,59,61,14,418,223,195,51,45,49,14,0
58080,552,295,257,67,49,70,30,72,32,40,8,2,1,14,0
58081,439,183,256,60,64,36,14,375,210,165,49,37,29,27,0
58082,681,367,314,83,74,78,31,91,42,49,21,9,8,3,0
58083,265,165,100,32,19,27,5,2346,1231,1115,316,292,266,105,0
58084,873,366,507,127,125,75,21,314,151,163,42,61,39,16,0
58085,358,206,152,45,38,67,16,374,191,183,40,52,40,16,0
58086,364,204,160,65,35,15,13,234,116,118,34,35,23,9,0
58087,746,312,434,129,115,77,47,1065,581,484,134,97,76,46,0
58088,736,353,383,117,83,71,18,266,150,116,28,28,24,12,0
58089,527,254,273,67,66,70,31,630,321,309,86,90,57,26,0
58090,427,191,236,67,60,41,34,286,160,126,37,27,23,10,0
58091,341,154,187,34,36,11,11,373,213,160,44,33,26,17,0
58092,674,318,356,86,139,50,11,230,125,105,29,40,20,6,0
58093,2663,1073,1590,548,499,192,64,727,388,339,102,87,70,29,0
58094,462,233,229,66,49,43,30,334,181,153,41,40,25,15,0
58095,682,292,390,89,69,58,20,1166,514,652,150,159,107,70,0
58096,550,304,246,60,64,77,16,481,223,258,71,70,49,26,0
58097,332,173,159,48,42,42,9,418,223,195,53,43,49,15,0
58098,335,148,187,52,26,51,12,644,343,301,96,69,59,28,0
58099,508,251,257,74,53,51,18,338,169,169,53,44,39,21,0
58100,1718,735,983,266,225,130,68,1696,771,925,257,225,149,63,0
58101,304,149,155,46,32,39,14,520,244,276,91,60,68,20,0
58102,739,389,350,129,61,69,25,265,134,131,48,34,33,15,0
58103,461,207,254,82,66,55,33,629,317,312,80,87,51,22,0
58104,1007,353,654,277,147,70,26,392,155,237,68,61,34,16,0
58105,136,65,71,33,11,9,6,54,26,28,11,4,3,3,0
58106,1200,602,598,145,116,110,50,173,90,83,21,36,12,15,0
58107,312,173,139,43,47,28,6,194,106,88,33,10,15,6,0
58108,330,141,189,65,29,51,19,91,42,49,21,9,8,3,0
58109,1505,680,825,202,204,73,32,192,110,82,33,21,10,3,0
58110,270,166,104,30,26,28,14,609,335,274,79,57,45,22,0
58111,467,233,234,83,37,77,22,1154,489,665,200,196,95,54,0
58112,496,210,286,112,55,72,13,189,105,84,25,26,21,9,0
58113,510,269,241,66,67,71,26,367,199,168,62,44,34,8,0
58114,485,246,239,74,48,47,22,579,285,294,78,72,64,32,0
58115,550,304,246,60,64,77,16,390,223,167,58,36,45,18,0
58116,127,48,79,27,20,6,5,314,177,137,34,40,29,9,0
58117,475,208,267,84,67,50,20,538,274,264,84,67,52,35,0
58118,130,71,59,30,9,8,1,223,113,110,31,33,22,12,0
58119,150,60,90,27,16,6,3,1700,731,969,198,233,110,87,0
58120,373,194,179,42,54,26,13,1249,638,611,166,153,141,45,0
58121,2063,1024,1039,175,117,80,97,1537,701,836,209,187,129,58,0
58122,439,205,234,64,88,41,21,295,156,139,41,40,42,15,0
58123,302,178,124,34,29,50,13,137,85,52,15,11,11,2,0
58124,867,415,452,123,87,62,27,518,292,226,60,60,52,21,0
58125,786,378,408,106,98,77,39,547,295,252,81,65,57,23,0
58126,406,208,198,41,26,43,21,349,200,149,41,39,30,20,0
58127,458,210,248,39,38,25,16,317,161,156,40,49,41,11,0
58128,310,141,169,36,38,20,8,439,231,208,65,51,55,17,0
58129,519,245,274,58,61,34,22,475,251,224,67,49,48,23,0
58130,722,390,332,125,69,67,25,132,77,55,20,9,13,10,0
58131,486,243,243,65,48,63,22,538,274,264,84,67,52,35,0
58132,251,139,112,41,18,27,11,295,158,137,42,34,38,14,0
58133,313,158,155,43,35,43,16,551,226,325,96,103,43,11,0
58134,887,439,448,137,99,91,38,375,210,165,49,37,29,27,0
58135,526,268,258,54,37,55,12,187,89,98,36,24,20,6,0
58136,643,284,359,129,71,84,43,229,120,109,31,30,22,9,0
58137,368,201,167,61,38,38,12,744,385,359,105,96,57,31,0
58138,505,226,279,68,51,30,15,1101,626,475,145,122,120,50,0
58139,227,109,118,42,35,29,8,663,360,303,87,82,80,35,0
58140,401,183,218,72,73,28,10,134,72,62,14,28,8,4,0
58141,1054,453,601,183,183,107,35,65,32,33,16,4,8,3,0
58142,279,129,150,43,34,17,13,572,305,267,74,72,58,21,0
58143,126,57,69,31,10,10,3,375,211,164,50,36,31,23,0
58144,128,70,58,29,9,8,1,601,279,322,81,65,27,12,0
58145,949,467,482,126,127,102,51,149,77,72,37,10,20,5,0
58146,949,466,483,125,126,101,50,239,113,126,36,49,20,8,0
58147,529,290,239,54,63,85,15,72,32,40,8,2,2,13,0
58148,941,459,482,167,140,82,38,323,168,155,51,41,38,12,0
58149,535,315,220,57,55,71,19,736,388,348,88,85,67,28,0
58150,204,109,95,21,35,27,7,423,234,189,66,44,57,12,0
58151,393,223,170,44,36,32,14,203,98,105,34,29,19,10,0
58152,267,146,121,40,24,25,7,727,388,339,102,87,70,29,0
58153,425,198,227,57,69,59,13,136,65,71,26,11,7,5,0
58154,862,384,478,127,110,75,42,1182,591,591,155,139,83,46,0
58155,2236,1195,1041,227,187,186,118,307,132,175,48,53,26,10,0
58156,251,131,120,49,35,25,5,898,469,429,125,125,134,35,0
58157,429,238,191,47,49,56,29,439,227,212,60,55,58,8,0
58158,319,153,166,61,52,26,12,518,292,226,60,60,52,21,0
58159,228,82,146,45,37,18,8,748,359,389,125,113,86,31,0
58160,349,131,218,66,76,22,9,133,61,72,21,19,13,4,0
58161,149,78,71,20,20,19,5,295,160,135,42,37,46,16,0
58162,261,126,135,41,36,24,11,452,254,198,72,57,38,18,0
58163,127,55,72,25,18,5,7,749,384,365,108,105,86,31,0
58164,257,132,125,39,27,26,10,1062,522,540,151,147,105,66,0
58165,260,133,127,43,29,34,11,127,54,73,11,33,15,6,0
58166,595,316,279,86,60,65,40,482,232,250,77,81,44,13,0
58167,1417,598,819,223,188,135,58,306,157,149,52,35,39,16,0
58168,302,178,124,34,29,50,13,149,52,97,36,36,7,4,0
58169,588,300,288,100,57,65,27,1208,565,643,182,162,120,57,0
58170,335,155,180,64,48,36,10,1047,562,485,141,127,114,41,0
58171,580,265,315,97,89,79,17,188,101,87,20,18,20,14,0
58172,136,65,71,33,11,9,6,147,74,73,28,20,24,4,0
58173,348,198,150,57,25,37,18,403,225,178,56,38,33,25,0
58174,1112,457,655,180,164,99,39,218,117,101,35,32,34,12,0
58175,536,237,299,116,87,42,17,188,105,83,25,17,24,7,0
58176,646,304,342,104,93,58,26,277,152,125,31,35,22,19,0
58177,395,219,176,47,41,50,18,332,180,152,46,36,28,14,0
58178,210,101,109,33,33,19,9,496,251,245,78,62,61,23,0
58179,169,64,105,23,37,11,3,531,277,254,82,75,33,22,0
58180,653,379,274,89,56,86,13,457,242,215,39,46,53,10,0
58181,367,167,200,63,42,60,17,137,72,65,27,13,15,8,0
58182,665,341,324,109,79,38,22,449,252,197,61,52,36,18,0
58183,546,278,268,94,60,32,22,926,340,586,133,119,60,40,0
58184,1085,646,439,108,65,36,19,1382,508,874,334,320,98,36,0
58185,236,141,95,36,32,14,6,260,131,129,42,31,40,9,0
58186,521,249,272,53,36,50,18,225,111,114,32,34,32,16,0
58187,559,217,342,105,86,42,16,978,536,442,132,107,67,32,0
58188,269,124,145,36,24,32,11,424,179,245,65,67,29,11,0
58189,473,212,261,72,64,45,28,125,66,59,24,16,11,5,0
58190,1590,726,864,270,237,126,59,671,306,365,114,76,49,19,0
58191,475,235,240,77,58,43,22,381,187,194,37,49,36,17,0
58192,451,278,173,71,35,58,12,520,244,276,91,60,68,20,0
58193,667,366,301,96,55,84,25,892,475,417,130,108,68,38,0
58194,1200,602,598,145,116,110,50,376,189,187,47,53,44,26,0
58195,325,177,148,40,24,23,13,172,79,93,34,27,23,10,0
58196,492,253,239,73,67,77,29,376,183,193,50,50,43,21,0
58197,270,131,139,47,37,41,11,422,202,220,80,52,57,18,0
58198,218,133,85,20,19,13,6,305,163,142,38,27,47,11,0
58199,376,171,205,45,45,34,12,535,288,247,79,72,35,21,0
58200,412,208,204,54,47,42,17,441,189,252,73,50,47,23,0
58201,484,194,290,70,93,47,16,378,154,224,74,84,35,22,0
58202,126,66,60,24,10,7,9,132,67,65,24,21,8,10,0
58203,165,66,99,28,32,16,3,1061,543,518,146,123,109,67,0
58204,342,150,192,52,43,31,17,387,193,194,60,53,57,15,0
58205,172,98,74,20,21,22,8,727,362,365,123,107,63,23,0
58206,291,131,160,49,35,32,15,392,155,237,68,61,34,16,0
58207,446,283,163,51,26,33,19,135,65,70,21,25,15,9,0
58208,579,246,333,102,79,41,19,647,350,297,95,79,77,29,0
58209,584,340,244,77,60,47,25,317,161,156,50,36,47,12,0
58210,588,317,271,78,49,54,17,352,207,145,40,33,25,21,0
58211,585,277,308,92,73,61,32,463,170,293,115,54,75,32,0
58212,449,179,270,80,77,49,29,406,223,183,61,53,46,17,0
58213,419,210,209,54,44,31,23,166,88,78,23,18,13,7,0
58214,1217,647,570,142,160,129,45,137,72,65,27,13,15,8,0
58215,760,322,438,81,130,57,19,384,204,180,53,47,49,17,0
58216,473,212,261,72,64,45,28,132,61,71,22,21,15,3,0
58217,234,108,126,42,40,15,9,218,118,100,33,30,25,11,0
58218,953,421,532,131,131,70,37,163,79,84,22,24,13,5,0
58219,482,245,237,69,64,66,24,282,134,148,38,45,29,10,0
58220,554,217,337,112,72,90,38,397,234,163,44,38,23,21,0
58221,560,279,281,113,64,58,15,792,398,394,109,96,90,39,0
58222,374,202,172,58,40,41,7,432,244,188,51,51,27,14,0
58223,627,237,390,137,57,108,44,346,178,168,58,41,33,12,0
58224,514,226,288,71,66,63,32,349,200,149,41,39,30,20,0
58225,773,383,390,108,76,79,30,169,85,84,21,14,9,9,0
58226,773,383,390,108,76,79,30,68,36,32,11,8,9,2,0
58227,238,91,147,68,19,22,7,374,174,200,54,52,42,21,0
58228,437,212,225,66,44,44,11,647,324,323,101,80,76,43,0
58229,439,183,256,60,64,36,14,86,40,46,16,13,9,7,0
58230,533,300,233,74,50,74,17,2517,1275,1242,304,324,245,135,0
58231,469,253,216,49,51,48,18,1249,638,611,166,153,141,45,0
58232,325,181,144,46,31,48,9,332,180,152,46,36,28,14,0
58233,291,131,160,49,35,32,15,132,67,65,24,21,8,10,0
58234,580,265,315,97,89,79,17,389,207,182,53,58,52,18,0
58235,415,217,198,50,31,42,17,375,211,164,50,36,31,23,0
58236,588,267,321,99,79,87,28,380,211,169,47,37,33,21,0
58237,373,194,179,42,54,26,13,374,202,172,50,39,31,24,0
58238,575,290,285,67,70,28,9,152,71,81,41,16,14,2,0
58239,911,445,466,154,121,108,48,1047,562,485,141,127,114,41,0
58240,130,70,60,30,9,8,1,519,287,232,68,58,45,21,0
58241,380,185,195,68,54,32,16,508,261,247,65,53,58,23,0
58242,313,158,155,43,35,43,16,617,314,303,96,68,68,37,0
58243,426,214,212,63,47,53,20,234,129,105,31,22,19,17,0
58244,588,267,321,99,79,87,28,1507,737,770,188,228,147,71,0
58245,598,300,298,68,77,59,21,201,117,83,22,21,19,9,0
58246,149,78,71,20,20,19,5,555,292,263,75,63,67,27,0
58247,781,316,465,130,129,65,23,926,340,586,133,119,60,40,0
58248,336,134,202,51,64,27,12,198,113,85,19,20,26,12,0
58249,394,207,187,52,42,37,24,277,152,125,31,35,22,19,0
58250,367,167,200,63,42,60,17,579,285,294,78,72,64,32,0
58251,315,170,145,48,56,22,11,325,172,153,44,34,27,14,0
58252,412,146,266,106,38,67,35,106,54,52,12,9,7,6,0
58253,1001,422,579,185,180,51,32,136,65,71,26,11,7,5,0
58254,929,410,519,187,146,53,30,660,303,357,97,89,85,33,0
58255,482,231,251,76,81,64,26,106,46,60,29,13,14,5,0
58256,1226,513,713,184,147,87,43,137,78,59,22,16,17,4,0
58257,803,358,445,135,117,80,43,766,386,380,101,81,78,31,0
58258,284,128,156,48,29,34,8,201,93,108,34,39,21,6,0
58259,416,207,209,63,47,56,15,305,163,142,38,27,47,11,0
58260,531,259,272,75,81,39,13,396,197,199,75,49,49,16,0
58261,349,131,218,66,76,22,9,418,223,195,53,43,49,15,0
58262,2174,1057,1117,241,241,214,117,132,61,71,19,20,14,6,0
58263,364,168,196,64,61,27,6,381,186,195,69,55,46,15,0
58264,241,122,119,27,34,17,16,1248,584,664,184,164,155,67,0
58265,436,201,235,54,37,35,18,94,45,49,11,20,10,4,0
58266,535,217,318,87,106,41,14,430,212,218,88,43,40,20,0
58267,1087,523,564,146,177,103,33,267,141,126,53,27,23,7,0
58268,172,98,74,20,21,22,8,330,166,164,55,51,36,16,0
58269,282,84,198,60,102,1,6,374,202,172,50,39,31,24,0
58270,488,237,251,79,78,65,27,508,261,247,65,53,58,23,0
58271,526,228,298,69,64,32,30,520,272,248,60,65,58,22,0
58272,384,198,186,58,48,37,12,389,210,179,51,37,43,9,0
58273,933,456,477,123,108,83,29,149,52,97,36,36,7,4,0
58274,454,214,240,56,71,35,16,293,142,151,49,40,42,17,0
58275,179,78,101,29,22,10,8,508,253,255,73,60,50,13,0
58276,1912,880,1032,331,334,180,84,106,54,52,12,9,7,6,0
58277,485,183,302,79,81,73,33,507,270,237,89,59,57,22,0
58278,758,361,397,114,107,51,19,632,360,272,75,65,36,19,0
58279,473,265,208,47,26,50,30,169,84,85,29,19,21,7,0
58280,928,442,486,139,118,91,43,425,210,215,56,43,52,25,0
58281,1001,422,579,185,180,51,32,262,129,133,40,41,31,10,0
58282,2109,999,1110,332,294,187,89,531,261,270,73,80,68,26,0
58283,427,191,236,67,60,41,34,619,305,314,85,93,71,29,0
58284,332,170,162,44,38,39,10,144,67,77,28,14,9,8,0
58285,509,246,263,84,71,56,22,277,124,153,44,40,35,18,0
58286,1058,497,561,194,142,87,63,925,439,486,141,134,105,46,0
58287,521,249,272,53,36,50,18,332,180,152,46,36,28,14,0
58288,285,148,137,31,42,42,16,737,397,340,87,104,90,14,0
58289,342,185,157,42,27,31,14,334,181,153,41,40,25,15,0
58290,126,57,69,31,10,10,3,507,270,237,89,59,57,22,0
58291,228,105,123,34,43,20,10,260,131,129,42,31,40,9,0
58292,739,323,416,127,89,76,33,1378,692,686,194,174,105,56,0
58293,594,279,315,93,68,68,26,1214,475,739,177,250,89,49,0
58294,119,67,52,15,15,7,7,138,69,69,28,7,10,10,0
58295,539,283,256,75,73,53,26,621,273,348,104,102,48,19,0
58296,407,207,200,53,36,38,8,1606,753,853,215,227,182,48,0
58297,636,288,348,94,77,65,30,323,168,155,51,41,38,12,0
58298,161,94,67,23,13,8,10,245,131,114,30,27,18,13,0
58299,1709,650,1059,338,286,185,46,192,91,101,29,28,17,7,0
58300,288,140,148,59,33,27,12,137,72,65,27,13,15,8,0
58301,532,254,278,91,48,23,17,131,55,76,28,9,14,12,0
58302,575,305,270,74,87,73,25,334,182,152,45,41,27,13,0
58303,1217,647,570,142,160,129,45,229,120,109,31,30,22,9,0
58304,474,243,231,66,54,41,29,200,89,111,26,25,17,7,0
58305,1360,644,716,213,194,136,62,213,129,84,32,14,21,15,0
58306,508,251,257,74,53,51,18,218,118,100,33,30,25,11,0
58307,380,148,232,81,69,24,8,403,184,219,75,51,47,20,0
58308,595,208,387,157,60,91,48,925,439,486,141,134,105,46,0
58309,126,66,60,24,10,7,9,297,175,122,46,30,31,6,0
58310,136,66,70,33,11,9,4,744,385,359,105,96,57,31,0
58311,291,142,149,50,29,35,7,245,121,124,37,35,36,12,0
58312,747,360,387,125,92,69,32,1001,417,584,186,147,96,47,0
58313,475,208,267,84,67,50,20,190,93,97,35,27,23,2,0
58314,341,183,158,36,34,36,15,1543,794,749,182,152,132,55,0
58315,310,141,169,36,38,20,8,452,254,198,72,57,38,18,0
58316,282,96,186,80,21,28,7,246,107,139,55,33,27,11,0
58317,860,349,511,166,166,58,19,1314,693,621,174,155,140,58,0
58318,282,163,119,40,23,25,17,519,287,232,68,58,45,21,0
58319,186,56,130,46,50,16,7,492,278,214,65,58,32,11,0
58320,361,171,190,44,40,18,13,485,244,241,80,55,59,20,0
58321,246,111,135,64,47,27,3,392,214,178,48,40,53,22,0
58322,1542,682,860,290,158,120,47,926,425,501,159,147,77,35,0
58323,837,443,394,129,89,87,38,389,207,182,53,58,52,18,0
58324,1217,647,570,142,160,129,45,178,99,79,31,19,26,8,0
58325,730,298,432,128,69,86,26,898,469,429,125,125,134,35,0
58326,71,39,32,7,11,6,4,741,383,358,92,63,79,36,0
58327,593,325,268,84,66,73,24,403,214,189,54,45,41,22,0
58328,364,204,160,65,35,15,13,1241,619,622,183,169,155,59,0
58329,2279,996,1283,375,328,158,60,222,119,103,37,32,24,8,0
58330,233,110,123,34,22,34,9,119,61,58,17,12,10,6,0
58331,2414,1189,1225,277,178,170,169,375,176,199,48,61,40,12,0
58332,554,217,337,112,72,90,38,72,34,38,8,2,3,12,0
58333,755,271,484,113,226,61,20,439,227,212,60,55,58,8,0
58334,598,322,276,67,57,63,26,323,162,161,52,41,39,13,0
58335,111,29,82,10,54,0,1,1065,581,484,134,97,76,46,0
58336,1342,640,702,187,163,123,57,222,125,97,34,27,27,7,0
58337,2525,1232,1293,398,317,186,61,374,191,183,40,52,40,16,0
58338,1004,498,506,94,59,46,33,663,360,303,87,82,80,35,0
58339,674,268,406,118,96,70,21,316,159,157,38,48,30,11,0
58340,837,443,394,129,89,87,38,385,188,197,57,42,36,16,0
58341,125,46,79,24,16,12,2,381,187,194,37,49,36,17,0
58342,218,133,85,20,19,13,6,497,257,240,71,63,62,16,0
58343,613,303,310,70,28,28,18,531,261,270,73,80,68,26,0
58344,237,127,110,34,30,16,9,132,77,55,20,9,13,10,0
58345,401,236,165,53,38,34,9,245,121,124,37,35,36,12,0
58346,1096,563,533,158,136,120,53,535,301,234,63,48,47,27,0
58347,1462,711,751,219,222,148,65,647,350,297,95,79,77,29,0
58348,580,265,315,97,89,79,17,283,142,141,41,33,26,18,0
58349,469,221,248,49,60,55,21,818,357,461,122,136,54,25,0
58350,552,295,257,67,49,70,30,293,142,151,49,40,42,17,0
58351,1912,880,1032,331,334,180,84,374,174,200,54,52,42,21,0
58352,283,112,171,48,39,34,15,205,94,111,48,31,15,6,0
58353,464,237,227,64,66,33,12,294,146,148,50,45,51,15,0
58354,1064,495,569,157,159,124,58,467,231,236,71,65,58,18,0
58355,413,236,177,41,25,35,19,376,183,193,50,50,43,21,0
58356,485,246,239,74,48,47,22,222,124,98,37,29,22,9,0
58357,341,177,164,57,42,40,18,461,223,238,45,62,18,35,0
58358,631,304,327,98,75,52,23,413,223,190,52,45,53,10,0
58359,473,212,261,72,64,45,28,207,114,93,33,20,31,13,0
58360,330,77,253,86,52,20,12,308,146,162,42,39,24,12,0
58361,3969,1703,2266,619,432,259,144,180,115,65,17,12,9,9,0
58362,234,110,124,39,29,23,2,2038,1059,979,262,237,208,100,0
58363,605,277,328,99,54,63,43,479,215,264,67,80,46,28,0
58364,361,167,194,55,35,41,11,519,287,232,68,58,45,21,0
58365,155,85,70,17,16,4,8,153,65,88,28,21,20,8,0
58366,559,217,342,105,86,42,16,218,115,103,32,32,34,11,0
58367,257,122,135,44,19,21,16,441,189,252,73,50,47,23,0
58368,227,120,107,31,28,28,13,400,187,213,56,59,42,20,0
58369,130,71,59,30,9,8,1,266,150,116,28,28,24,12,0
58370,624,222,402,92,81,39,15,142,65,77,30,17,22,9,0
58371,240,166,74,32,12,8,15,528,276,252,86,78,49,17,0
58372,682,292,390,89,69,58,20,108,59,49,17,13,12,5,0
58373,773,383,390,108,76,79,30,375,176,199,48,61,40,12,0
58374,598,322,276,67,57,63,26,348,194,154,57,31,43,12,0
58375,117,57,60,17,14,11,10,257,126,131,61,24,22,8,0
58376,496,210,286,112,55,71,14,621,273,348,104,102,48,19,0
58377,333,171,162,41,44,48,23,2382,1162,1220,237,220,140,49,0
58378,1200,602,598,145,116,110,50,352,207,145,40,33,25,21,0
58379,226,120,106,68,8,2,1,295,158,137,42,34,38,14,0
58380,102,22,80,48,8,18,6,385,188,197,57,42,36,16,0
58381,640,271,369,111,79,57,17,483,215,268,66,70,30,16,0
58382,235,100,135,36,25,30,8,335,186,149,40,28,29,13,0
58383,439,183,256,60,64,36,14,474,268,206,66,42,45,24,0
58384,429,238,191,47,49,56,29,520,272,248,60,65,58,22,0
58385,127,62,65,13,33,7,6,483,215,268,66,70,30,16,0
58386,496,210,286,112,55,71,14,1606,753,853,215,227,182,48,0
58387,284,128,156,48,29,34,8,222,125,97,34,27,27,7,0
58388,270,166,104,30,26,28,14,354,188,166,46,40,34,10,0
58389,794,390,404,103,95,86,23,222,110,112,43,30,14,6,0
58390,399,196,203,62,45,38,19,514,248,266,86,82,52,22,0
58391,281,154,127,45,31,24,9,346,178,168,58,41,33,12,0
58392,158,85,73,24,18,18,8,583,280,303,95,66,76,25,0
58393,522,302,220,61,49,75,19,1395,627,768,172,263,141,59,0
58394,1214,612,602,169,173,98,35,514,248,266,86,82,52,22,0
58395,130,70,60,30,9,8,1,395,169,226,73,55,38,9,0
58396,362,174,188,46,55,35,23,501,249,252,77,70,55,22,0
58397,516,224,292,79,29,45,33,223,113,110,31,33,22,12,0
58398,1030,438,592,184,104,108,30,1214,475,739,177,250,89,49,0
58399,933,456,477,123,108,83,29,245,121,124,37,35,36,12,0
58400,3969,1703,2266,619,432,259,144,1230,644,586,198,125,123,61,0
58401,361,171,190,44,40,18,13,108,59,49,17,13,12,5,0
58402,256,152,104,18,23,23,8,384,212,172,44,43,34,14,0
58403,166,59,107,36,41,10,4,943,463,480,91,144,70,30,0
58404,579,246,333,102,79,41,19,222,125,97,34,27,27,7,0
58405,392,205,187,83,49,38,10,629,317,312,80,87,51,22,0
58406,739,323,416,127,89,76,33,264,138,126,33,34,29,12,0
58407,138,35,103,38,2,15,9,1352,602,750,166,185,81,70,0
58408,574,284,290,64,50,65,20,483,287,196,71,50,54,17,0
58409,395,195,200,41,55,23,10,72,32,40,8,2,1,14,0
58410,115,62,53,13,10,9,7,332,155,177,55,51,44,13,0
58411,525,302,223,56,48,67,19,516,245,271,82,84,70,26,0
58412,393,223,170,44,36,32,14,149,52,97,36,36,7,4,0
58413,469,253,216,49,51,48,18,148,84,64,30,7,17,4,0
58414,525,254,271,60,76,46,13,375,210,165,49,37,29,27,0
58415,86,50,36,9,14,8,7,165,87,78,24,19,22,9,0
58416,972,501,471,125,156,106,39,336,200,136,34,29,25,24,0
58417,1835,904,931,192,144,135,63,1061,543,518,146,123,109,67,0
58418,673,317,356,101,85,76,49,465,252,213,73,58,60,18,0
58419,92,46,46,14,9,8,6,415,205,210,77,52,55,17,0
58420,626,308,318,105,89,77,25,548,296,252,71,74,43,28,0
58421,341,183,158,36,34,36,15,374,181,193,55,58,48,23,0
58422,136,66,70,33,11,9,3,966,478,488,108,144,74,43,0
58423,282,96,186,80,21,28,7,422,202,220,80,52,57,18,0
58424,781,367,414,60,67,43,17,535,311,224,66,52,49,24,0
58425,179,78,101,29,22,10,8,690,345,345,96,83,73,42,0
58426,565,264,301,101,73,72,15,381,196,185,55,57,43,16,0
58427,395,219,176,47,41,50,18,600,254,346,104,100,44,17,0
58428,297,182,115,41,22,23,8,858,398,460,126,138,75,39,0
58429,200,103,97,17,16,10,10,404,190,214,55,55,35,27,0
58430,820,333,487,202,152,59,23,178,69,109,29,25,21,13,0
58431,121,69,52,15,18,14,8,234,129,105,31,22,19,17,0
58432,795,384,411,133,109,85,38,778,391,387,94,77,41,33,0
58433,309,137,172,51,50,28,14,551,226,325,96,103,43,11,0
58434,1217,647,570,142,160,129,45,147,74,73,28,20,24,4,0
58435,260,138,122,44,30,28,6,555,292,263,75,63,67,27,0
58436,443,226,217,67,34,53,10,386,207,179,43,48,44,19,0
58437,407,207,200,53,36,38,8,337,152,185,49,54,42,21,0
58438,436,209,227,66,47,52,22,439,227,212,60,55,58,8,0
58439,627,237,390,137,57,108,44,88,50,38,13,8,16,4,0
58440,238,91,147,68,19,22,7,439,231,208,65,51,55,17,0
58441,502,236,266,66,66,58,17,455,229,226,66,62,63,29,0
58442,126,58,68,31,10,10,3,395,169,226,73,55,38,9,0
58443,457,261,196,55,27,57,34,397,223,174,50,39,29,17,0
58444,99,35,64,25,18,0,1,192,110,82,33,21,10,3,0
58445,347,212,135,35,32,17,6,1265,689,576,169,177,128,60,0
58446,919,444,475,141,148,62,20,737,397,340,87,104,90,14,0
58447,146,73,73,18,24,17,9,264,138,126,33,34,29,12,0
58448,103,56,47,27,7,8,2,1113,480,633,170,173,81,34,0
58449,117,57,60,17,14,11,10,792,398,394,109,96,90,39,0
58450,221,75,146,68,21,16,5,662,373,289,89,80,77,29,0
58451,338,173,165,31,42,22,10,125,66,59,24,16,11,5,0
58452,1755,849,906,245,226,148,56,180,90,90,31,19,20,8,0
58453,200,94,106,33,22,18,8,89,51,38,15,15,5,4,0
58454,335,183,152,40,26,54,22,564,264,300,79,84,65,26,0
58455,270,128,142,36,43,15,11,408,221,187,55,51,57,14,0
58456,325,181,144,46,31,48,9,89,42,47,16,12,15,6,0
58457,589,282,307,68,67,70,23,148,69,79,26,18,16,3,0
58458,516,210,306,113,53,81,33,399,190,209,61,41,39,18,0
58459,531,284,247,66,42,49,15,395,169,226,73,55,38,9,0
58460,297,182,115,41,22,23,8,220,107,113,36,35,28,9,0
58461,531,259,272,75,81,39,13,548,273,275,84,81,64,30,0
58462,264,122,142,33,29,13,13,108,59,49,17,13,12,5,0
58463,127,48,79,27,20,6,5,389,207,182,53,58,52,18,0
58464,648,262,386,113,108,78,29,334,181,153,56,31,28,18,0
58465,228,105,123,34,43,20,10,600,254,346,104,100,44,17,0
58466,301,157,144,31,28,34,9,1040,564,476,134,110,114,51,0
58467,421,237,184,47,54,45,10,406,234,172,63,35,43,10,0
58468,2663,1073,1590,548,499,192,64,727,362,365,123,107,63,23,0
58469,146,73,73,18,24,17,9,288,156,132,36,36,24,15,0
58470,562,214,348,120,86,69,42,974,457,517,133,117,69,26,0
58471,631,304,327,98,75,52,23,169,85,84,21,14,9,9,0
58472,346,205,141,47,34,30,7,220,107,113,36,35,28,9,0
58473,359,167,192,49,37,27,19,336,200,136,34,29,25,24,0
58474,786,378,408,106,98,77,39,292,155,137,50,34,29,13,0
58475,272,141,131,45,29,36,9,173,94,79,18,24,12,7,0
58476,172,98,74,20,21,22,8,660,332,328,84,73,47,19,0
58477,488,237,251,79,78,65,27,101,59,42,11,17,10,1,0
58478,490,198,292,65,81,39,27,457,242,215,39,46,53,10,0
58479,587,318,269,76,50,38,21,199,105,94,27,27,28,9,0
58480,157,62,95,41,18,10,11,256,141,115,32,22,32,8,0
58481,443,250,193,52,23,49,13,127,64,63,26,8,12,8,0
58482,482,245,237,69,64,66,24,390,190,200,66,50,43,12,0
58483,1462,711,751,219,222,148,65,535,288,247,79,72,35,21,0
58484,500,257,243,60,55,27,22,111,60,51,17,23,10,7,0
58485,1689,821,868,277,250,177,78,198,86,112,36,27,23,9,0
58486,488,237,251,79,78,65,27,629,317,312,80,87,51,22,0
58487,424,170,254,69,56,47,28,617,314,303,96,68,68,37,0
58488,1009,478,531,166,126,96,42,498,244,254,81,67,58,19,0
58489,347,154,193,48,51,25,11,516,245,271,82,84,70,26,0
58490,752,313,439,121,106,68,27,222,127,95,23,28,22,7,0
58491,335,148,187,52,26,51,12,483,215,268,66,70,30,16,0
58492,270,166,104,30,26,28,14,134,72,62,14,28,8,4,0
58493,682,260,422,98,83,42,31,166,78,88,27,25,19,7,0
58494,317,140,177,43,26,31,16,531,277,254,82,75,33,22,0
58495,410,208,202,59,58,43,26,1025,549,476,118,109,88,61,0
58496,684,353,331,95,98,77,38,367,218,149,45,43,42,16,0
58497,264,122,142,46,24,35,10,354,188,166,46,40,34,10,0
58498,552,295,257,67,49,70,30,1922,923,999,267,275,215,90,0
58499,300,136,164,45,35,45,14,474,268,206,66,42,45,24,0
58500,1221,597,624,201,152,83,31,1034,495,539,150,134,114,71,0
58501,451,278,173,71,35,58,12,218,114,104,32,31,33,11,0
58502,260,138,122,44,30,28,6,775,407,368,122,100,97,32,0
58503,125,57,68,31,10,10,3,87,51,35,15,9,9,4,0
58504,417,176,241,75,61,51,20,131,55,76,28,9,14,12,0
58505,233,110,123,34,22,34,9,374,202,172,50,39,31,24,0
58506,126,57,69,31,10,10,3,329,194,135,45,32,33,9,0
58507,388,244,144,46,25,42,16,846,425,421,125,97,98,38,0
58508,401,236,165,53,38,34,9,660,333,327,102,95,69,31,0
58509,927,457,470,130,99,118,42,601,279,322,81,65,27,12,0
58510,180,57,123,39,22,10,8,346,178,168,58,41,33,12,0
58511,350,190,160,48,25,27,18,531,261,270,73,80,68,26,0
58512,163,70,93,28,21,17,6,925,439,486,141,134,105,46,0
58513,956,450,506,122,117,82,36,367,199,168,62,44,34,8,0
58514,546,265,281,101,64,38,16,245,121,124,37,35,36,12,0
58515,822,416,406,111,97,88,42,501,274,227,63,58,53,20,0
58516,219,100,119,40,29,21,3,368,204,164,43,35,30,24,0
58517,520,231,289,89,59,58,26,565,237,328,75,88,32,11,0
58518,1163,417,746,209,145,87,28,366,204,162,47,41,31,23,0
58519,142,60,82,20,28,13,5,545,269,276,80,76,27,32,0
58520,496,209,287,112,55,71,14,463,268,195,59,46,46,21,0
58521,457,261,196,55,27,57,34,483,215,268,66,70,30,16,0
58522,862,384,478,127,110,75,42,373,181,192,54,35,44,20,0
58523,473,217,256,59,44,34,21,295,156,139,41,40,42,15,0
58524,298,141,157,51,33,21,22,555,282,273,82,69,65,21,0
58525,436,201,235,54,37,35,18,391,189,202,55,56,56,12,0
58526,530,259,271,83,50,54,41,373,189,184,54,46,50,23,0
58527,773,383,390,108,76,79,30,535,301,234,63,48,47,27,0
58528,202,103,99,28,20,12,8,384,204,180,53,47,49,17,0
58529,640,271,369,111,79,57,17,395,198,197,55,55,36,10,0
58530,206,100,106,34,26,11,7,821,394,427,122,117,109,38,0
58531,439,241,198,67,40,40,13,65,32,33,16,4,8,3,0
58532,586,298,288,80,75,64,37,381,196,185,55,57,43,16,0
58533,673,317,356,101,85,76,49,138,69,69,28,7,10,10,0
58534,303,147,156,49,49,20,8,325,159,166,59,46,30,12,0
58535,1395,595,800,223,206,113,61,1114,539,575,145,131,94,56,0
58536,261,126,135,41,36,24,11,316,166,150,45,38,37,13,0
58537,119,67,52,15,15,7,7,585,277,308,92,73,61,32,0
58538,677,361,316,81,61,42,22,663,354,309,91,84,79,31,0
58539,332,173,159,48,42,42,9,1001,417,584,186,147,96,47,0
58540,540,252,288,73,67,57,20,963,455,508,127,130,115,48,0
58541,496,210,286,112,55,71,14,462,251,211,74,53,41,18,0
58542,261,130,131,27,41,19,16,88,50,38,13,8,16,4,0
58543,346,191,155,52,38,40,13,277,163,114,33,24,21,16,0
58544,682,292,390,89,69,58,20,267,141,126,53,27,23,7,0
58545,781,316,465,130,129,65,23,348,212,136,53,31,25,18,0
58546,747,360,387,125,92,69,32,1378,692,686,194,174,105,56,0
58547,859,411,448,118,100,95,49,452,231,221,74,53,56,20,0
58548,446,174,272,84,61,57,23,520,240,280,67,72,42,14,0
58549,51,10,41,25,0,5,8,283,142,141,41,33,26,18,0
58550,681,367,314,83,74,78,31,295,160,135,42,37,46,16,0
58551,410,200,210,60,54,46,19,536,267,269,60,70,41,22,0
58552,785,351,434,136,93,71,37,98,49,49,14,15,9,2,0
58553,798,364,434,133,88,74,35,360,185,175,51,43,36,16,0
58554,1214,612,602,169,173,98,35,727,362,365,123,107,63,23,0
58555,1011,559,452,121,97,132,33,455,229,226,66,62,63,29,0
58556,300,136,164,45,35,45,14,715,348,367,109,84,68,30,0
58557,501,230,271,63,90,50,18,972,471,501,152,138,112,40,0
58558,356,199,157,36,43,28,12,231,126,105,37,26,29,6,0
58559,852,461,391,109,102,72,24,334,182,152,45,41,27,13,0
58560,346,209,137,46,37,44,10,200,89,111,26,25,17,7,0
58561,446,174,272,84,61,57,23,381,187,194,37,49,36,17,0
58562,126,56,70,31,10,10,3,94,45,49,11,20,10,4,0
58563,1235,584,651,140,226,82,52,336,200,136,34,29,25,24,0
58564,1124,442,682,148,189,72,43,127,54,73,11,33,15,6,0
58565,259,119,140,48,28,29,19,453,255,198,62,49,29,19,0
58566,318,161,157,53,51,32,13,240,141,99,34,28,29,8,0
58567,442,254,188,46,22,40,19,2346,1231,1115,316,292,266,105,0
58568,441,216,225,57,66,57,19,858,461,397,125,114,79,45,0
58569,335,148,187,52,26,51,12,497,227,270,70,63,66,30,0
58570,330,182,148,47,27,40,11,555,292,263,75,63,67,27,0
58571,385,179,206,58,56,38,19,380,211,169,47,37,33,21,0
58572,1208,575,633,187,204,117,41,230,125,105,29,40,20,6,0
58573,667,366,301,96,55,84,25,106,41,65,36,6,11,7,0
58574,1043,479,564,200,131,123,62,172,79,93,34,27,23,10,0
58575,125,46,79,24,16,12,2,106,46,60,29,13,14,5,0
58576,447,225,222,76,35,75,21,194,106,88,33,10,15,6,0
58577,341,177,164,57,42,40,18,127,66,61,13,14,19,8,0
58578,130,71,59,30,9,8,1,1208,565,643,182,162,120,57,0
58579,458,210,248,39,38,25,16,384,212,172,44,43,34,14,0
58580,361,183,178,50,54,51,22,452,231,221,74,53,56,20,0
58581,680,308,372,82,72,71,40,1314,693,621,174,155,140,58,0
58582,315,170,145,48,56,22,11,457,242,215,39,46,53,10,0
58583,347,181,166,27,20,12,12,325,159,166,59,46,30,12,0
58584,338,172,166,59,30,39,18,270,162,108,26,26,16,11,0
58585,164,81,83,37,8,14,10,396,199,197,54,50,45,14,0
58586,556,306,250,69,60,80,18,723,363,360,107,106,52,14,0
58587,203,97,106,30,22,18,10,1208,565,643,182,162,120,57,0
58588,639,368,271,72,51,38,38,501,257,244,75,57,48,29,0
58589,2063,1024,1039,175,117,80,97,91,44,47,9,12,4,7,0
58590,76,42,34,12,8,5,7,732,366,366,108,86,74,41,0
58591,1341,481,860,275,264,57,21,198,115,83,30,22,8,8,0
58592,733,382,351,126,92,93,27,461,223,238,45,62,18,35,0
58593,333,171,162,50,34,19,8,222,127,95,23,28,22,7,0
58594,772,332,440,136,104,72,28,508,253,255,73,60,50,13,0
58595,574,269,305,91,63,54,27,679,338,341,96,95,40,23,0
58596,316,157,159,45,38,22,19,821,394,427,122,117,109,38,0
58597,127,48,79,27,20,6,5,457,253,204,67,51,48,13,0
58598,1970,978,992,245,206,198,80,396,197,199,75,49,49,16,0
58599,126,58,68,31,10,10,3,124,69,55,14,7,9,4,0
58600,667,366,301,96,55,84,25,1425,670,755,153,189,122,85,0
58601,728,358,370,118,100,55,29,339,175,164,51,49,37,9,0
58602,111,29,82,10,54,0,1,274,142,132,33,34,18,14,0
58603,317,140,177,43,26,31,16,294,146,148,50,45,51,15,0
58604,204,93,111,35,35,16,11,1001,417,584,186,147,96,47,0
58605,457,261,196,55,27,57,34,229,120,109,31,30,22,9,0
58606,326,176,150,35,22,29,11,309,164,145,35,47,30,11,0
58607,426,196,230,76,65,54,20,640,364,276,84,68,69,33,0
58608,287,124,163,52,48,24,16,280,118,162,35,32,41,37,0
58609,126,57,69,31,10,10,3,111,60,51,17,23,10,7,0
58610,557,250,307,70,47,51,22,508,261,247,65,53,58,23,0
58611,269,127,142,43,24,34,26,337,170,167,59,33,47,17,0
58612,717,381,336,118,103,85,29,547,295,252,81,65,57,23,0
58613,257,132,125,39,27,26,10,124,69,55,14,7,9,4,0
58614,193,105,88,33,16,9,4,564,264,300,79,84,65,26,0
58615,333,171,162,50,34,19,8,737,397,340,87,104,90,14,0
58616,2236,1195,1041,227,187,186,118,507,270,237,89,59,57,22,0
58617,484,192,292,118,68,83,22,536,267,269,60,70,41,22,0
58618,132,66,66,21,18,11,7,295,156,139,41,40,42,15,0
58619,271,110,161,33,27,11,8,2038,1059,979,262,237,208,100,0
58620,340,145,195,46,38,26,23,164,79,85,28,28,16,7,0
58621,372,189,183,60,44,41,18,218,111,107,45,29,24,6,0
58622,241,122,119,27,34,17,16,660,303,357,97,89,85,33,0
58623,580,240,340,108,81,59,22,374,174,200,54,52,42,21,0
58624,156,64,92,31,19,5,4,396,213,183,68,44,47,18,0
58625,397,180,217,61,59,39,13,135,65,70,21,25,15,9,0
58626,162,73,89,32,19,4,4,380,178,202,69,53,37,10,0
58627,1043,479,564,200,131,123,62,455,229,226,66,62,63,29,0
58628,429,238,191,47,49,56,29,509,267,242,79,81,38,20,0
58629,494,233,261,87,57,46,18,166,90,76,27,18,21,5,0
58630,498,274,224,58,59,50,18,279,142,137,43,39,28,7,0
58631,461,207,254,82,66,55,33,334,181,153,41,40,25,15,0
58632,833,295,538,146,139,65,34,149,52,97,36,36,7,4,0
58633,631,316,315,64,57,49,15,453,247,206,58,53,45,20,0
58634,813,412,401,114,93,112,26,350,196,154,52,37,21,14,0
58635,443,212,231,74,24,60,24,549,273,276,74,68,72,24,0
58636,743,366,377,41,37,26,14,582,264,318,84,60,58,23,0
58637,326,148,178,55,42,31,12,148,69,79,26,18,16,3,0
58638,760,322,438,81,130,57,19,783,406,377,102,91,57,29,0
58639,282,135,147,27,37,30,19,239,113,126,36,49,20,8,0
58640,257,132,125,39,27,26,10,467,240,227,65,65,51,23,0
58641,496,274,222,57,43,75,22,396,223,173,57,37,44,19,0
58642,166,59,107,36,41,10,4,483,287,196,71,50,54,17,0
58643,732,355,377,108,109,79,27,617,314,303,96,68,68,37,0
58644,447,232,215,55,65,50,25,715,345,370,110,97,64,25,0
58645,2000,965,1035,357,313,198,75,367,199,168,62,44,34,8,0
58646,260,136,124,24,41,19,4,301,168,133,49,37,34,11,0
58647,428,226,202,52,60,75,20,189,95,94,25,33,16,8,0
58648,159,105,54,22,9,14,25,305,161,144,39,40,44,17,0
58649,142,76,66,21,21,22,11,137,78,59,22,16,17,4,0
58650,315,174,141,46,38,47,16,241,127,114,34,33,29,12,0
58651,429,227,202,49,51,46,26,925,439,486,141,134,105,46,0
58652,496,210,286,112,55,71,14,397,223,174,50,39,29,17,0
58653,733,382,351,126,92,93,27,194,106,88,33,10,15,6,0
58654,447,225,222,76,35,75,21,396,197,199,75,49,49,16,0
58655,588,300,288,100,57,65,27,278,154,124,42,32,38,7,0
58656,374,202,172,58,40,41,7,2382,1162,1220,237,220,140,49,0
58657,429,227,202,49,51,46,26,732,402,330,81,86,87,33,0
58658,519,245,274,58,61,34,22,179,101,78,25,15,13,13,0
58659,465,220,245,88,34,61,23,528,276,252,86,78,49,17,0
58660,915,336,579,185,199,56,29,469,225,244,64,68,25,11,0
58661,977,462,515,185,119,76,12,341,170,171,41,66,27,10,0
58662,118,56,62,24,12,6,9,1113,480,633,170,173,81,34,0
58663,756,265,491,129,127,51,17,106,54,52,12,9,7,6,0
58664,206,100,106,34,26,11,7,548,273,275,84,81,64,30,0
58665,220,113,107,37,24,16,7,192,110,82,33,21,10,3,0
58666,494,242,252,67,47,25,21,418,223,195,51,45,49,14,0
58667,436,209,227,66,47,52,22,720,361,359,98,98,70,37,0
58668,488,237,251,79,78,65,27,317,161,156,50,36,47,12,0
58669,228,105,123,34,43,20,10,196,105,91,40,13,19,10,0
58670,350,190,160,48,25,27,18,384,212,172,44,43,34,14,0
58671,760,405,355,112,95,92,29,375,176,199,48,61,40,12,0
58672,374,202,172,58,40,41,7,368,200,168,54,49,43,9,0
58673,474,243,231,66,54,41,29,128,63,65,30,11,13,8,0
58674,1689,821,868,277,250,177,78,160,60,100,23,40,19,11,0
58675,505,201,304,116,58,75,31,198,115,83,30,22,8,8,0
58676,852,472,380,99,79,70,27,900,441,459,125,127,110,32,0
58677,301,156,145,32,25,15,5,323,168,155,51,41,38,12,0
58678,270,131,139,47,37,41,11,242,124,118,39,32,28,22,0
58679,485,237,248,83,35,52,24,188,101,87,20,18,20,14,0
58680,641,349,292,92,60,39,24,373,189,184,54,46,50,23,0
58681,269,156,113,37,32,17,7,266,150,116,28,28,24,12,0
58682,415,217,198,50,31,42,17,584,249,335,80,96,22,13,0
58683,822,416,406,111,97,88,42,286,160,126,37,27,23,10,0
58684,580,240,340,108,81,59,22,447,212,235,86,55,58,21,0
58685,411,236,175,39,45,50,30,169,84,85,29,19,21,7,0
58686,317,167,150,45,21,30,26,244,143,101,31,29,26,8,0
58687,344,109,235,100,39,26,5,105,51,54,13,17,12,8,0
58688,315,111,204,82,66,46,11,2547,1280,1267,331,335,293,118,0
58689,1501,679,822,251,196,174,67,483,287,196,71,50,54,17,0
58690,467,233,234,83,37,77,22,180,95,85,22,21,17,8,0
58691,109,42,67,25,13,1,1,145,77,68,26,7,15,8,0
58692,361,171,190,44,40,18,13,87,51,35,15,9,9,4,0
58693,626,300,326,91,82,68,26,89,37,52,13,6,2,9,0
58694,136,66,70,33,11,9,4,422,202,220,80,52,57,18,0
58695,462,258,204,59,41,56,15,160,60,100,23,40,19,11,0
58696,532,291,241,83,36,79,25,326,149,177,51,51,28,10,0
58697,480,267,213,49,44,70,21,258,129,129,45,24,31,10,0
58698,118,51,67,25,13,6,7,212,127,85,28,21,26,6,0
58699,275,125,150,37,48,27,7,662,373,289,89,80,77,29,0
58700,1249,543,706,187,164,125,52,257,139,118,64,17,24,7,0
58701,1872,837,1035,280,338,169,80,429,187,242,79,72,28,19,0
58702,269,124,145,36,24,32,11,106,46,60,27,18,12,3,0
58703,349,153,196,54,47,28,13,520,272,248,60,65,58,22,0
58704,584,340,244,77,60,47,25,91,44,47,9,12,4,7,0
58705,125,53,72,18,21,18,12,640,364,276,84,68,69,33,0
58706,1023,449,574,141,174,76,43,72,32,40,8,2,1,14,0
58707,800,416,384,102,105,83,22,277,163,114,33,24,21,16,0
58708,837,381,456,123,109,65,25,376,183,193,50,50,43,21,0
58709,1098,519,579,182,159,79,42,1040,564,476,134,110,114,51,0
58710,349,167,182,54,38,30,28,737,397,340,87,104,90,14,0
58711,230,114,116,30,33,29,8,663,360,303,87,82,80,35,0
58712,340,181,159,44,39,35,21,452,254,198,72,57,38,18,0
58713,722,390,332,125,69,67,25,323,168,155,51,41,38,12,0
58714,325,152,173,43,47,28,17,366,204,162,47,41,31,23,0
58715,447,236,211,56,52,49,14,325,159,166,59,46,30,12,0
58716,227,109,118,42,35,29,8,111,60,51,17,23,10,7,0
58717,1439,713,726,195,180,110,34,1700,731,969,198,233,110,87,0
58718,313,158,155,43,35,43,16,179,101,78,25,15,13,13,0
58719,331,169,162,40,28,22,14,520,272,248,60,65,58,22,0
58720,373,164,209,51,45,44,21,201,98,103,28,25,19,13,0
58721,107,53,54,15,15,13,4,163,79,84,22,24,13,5,0
58722,210,84,126,44,43,9,4,328,195,133,39,40,27,13,0
58723,643,284,359,129,71,84,43,245,121,124,37,35,36,12,0
58724,1970,978,992,245,206,198,80,173,86,87,30,22,19,12,0
58725,372,171,201,47,53,39,18,1922,923,999,267,275,215,90,0
58726,125,53,72,18,21,18,12,279,161,118,37,32,7,7,0
58727,233,110,123,34,22,34,9,341,170,171,41,66,27,10,0
58728,1390,705,685,219,164,129,74,230,113,117,31,40,28,10,0
58729,206,96,110,33,25,8,6,103,59,44,25,2,13,6,0
58730,960,409,551,166,134,77,44,374,191,183,40,52,40,16,0
58731,567,266,301,139,46,76,37,2382,1162,1220,237,220,140,49,0
58732,326,154,172,45,39,20,10,547,295,252,81,65,57,23,0
58733,389,176,213,81,59,24,7,892,475,417,130,108,68,38,0
58734,447,236,211,56,52,49,14,242,121,121,39,30,29,10,0
58735,275,160,115,40,31,34,17,316,159,157,38,48,30,11,0
58736,361,167,194,55,35,41,11,199,92,107,34,30,18,9,0
58737,524,361,163,41,8,28,16,1323,690,633,132,178,112,61,0
58738,343,162,181,65,38,29,12,1062,522,540,151,147,105,66,0
58739,898,397,501,102,98,54,37,230,113,117,31,40,28,10,0
58740,554,217,337,112,72,90,38,175,82,93,33,26,17,5,0
58741,150,60,90,27,16,6,3,266,146,120,41,28,31,7,0
58742,1214,612,602,169,173,98,35,203,98,105,34,29,19,10,0
58743,193,95,98,33,17,25,17,547,295,252,81,65,57,23,0
58744,260,120,140,34,39,36,12,975,400,575,160,162,62,31,0
58745,824,391,433,106,90,88,32,156,90,66,17,22,11,10,0
58746,1867,973,894,256,222,194,65,583,321,262,73,67,45,25,0
58747,215,117,98,28,19,15,8,665,361,304,87,91,84,31,0
58748,332,172,160,50,33,35,9,393,210,183,58,37,34,20,0
58749,323,156,167,52,45,39,18,246,125,121,38,36,30,11,0
58750,373,194,179,42,54,26,13,2382,1162,1220,237,220,140,49,0
58751,406,208,198,41,26,43,21,439,227,212,60,55,58,8,0
58752,462,258,204,59,41,56,15,390,223,167,58,36,45,18,0
58753,763,354,409,101,90,63,26,149,77,72,37,10,20,5,0
58754,349,167,182,54,38,30,28,137,85,52,15,11,11,2,0
58755,501,230,271,63,90,50,18,234,129,105,31,22,19,17,0
58756,340,169,171,40,39,36,22,279,106,173,48,35,41,39,0
58757,510,269,241,66,67,71,26,1696,771,925,257,225,149,63,0
58758,579,321,258,74,70,47,22,199,105,94,27,27,28,9,0
58759,436,209,227,66,47,52,22,597,300,297,96,89,68,29,0
58760,432,233,199,52,28,47,18,127,54,73,11,33,15,6,0
58761,426,213,213,60,56,46,24,178,99,79,31,19,26,8,0
58762,533,300,233,74,50,74,17,334,181,153,41,40,25,15,0
58763,496,272,224,70,58,42,18,332,180,152,46,36,28,14,0
58764,240,99,141,53,38,29,15,370,173,197,65,57,42,10,0
58765,498,274,224,58,59,50,18,406,234,172,63,35,43,10,0
58766,117,57,60,17,14,11,10,111,60,51,17,23,10,7,0
58767,510,288,222,44,36,24,7,1061,543,518,146,123,109,67,0
58768,217,98,119,38,35,18,9,617,314,303,96,68,68,37,0
58769,227,109,118,42,35,29,8,583,280,303,95,66,76,25,0
58770,108,51,57,16,12,16,11,424,198,226,57,46,41,19,0
58771,630,231,399,150,83,84,50,106,46,60,27,18,12,3,0
58772,2663,1073,1590,548,499,192,64,156,90,66,17,22,11,10,0
58773,782,372,410,127,111,89,36,316,159,157,38,48,30,11,0
58774,215,117,98,28,19,15,8,370,190,180,60,52,37,13,0
58775,479,228,251,71,57,60,14,545,269,276,80,76,27,32,0
58776,772,332,440,136,104,72,28,1061,543,518,146,123,109,67,0
58777,159,105,54,22,9,14,25,309,164,145,35,47,30,11,0
58778,1064,495,569,157,159,124,58,1696,771,925,257,225,149,63,0
58779,243,100,143,58,50,24,5,135,57,78,21,20,9,11,0
58780,436,201,235,54,37,35,18,1606,753,853,215,227,182,48,0
58781,2048,855,1193,297,287,191,93,1065,581,484,134,97,76,46,0
58782,585,277,308,92,73,61,32,298,129,169,51,40,29,8,0
58783,828,368,460,118,98,59,38,496,251,245,78,62,61,23,0
58784,852,461,391,109,102,72,24,467,240,227,65,65,51,23,0
58785,457,228,229,64,36,52,21,763,418,345,113,84,59,32,0
58786,99,35,64,25,18,0,1,415,203,212,77,44,49,18,0
58787,391,204,187,47,48,38,18,288,156,132,36,36,24,15,0
58788,107,53,54,15,15,13,4,644,343,301,96,69,59,28,0
58789,142,60,82,20,28,13,5,447,212,235,86,55,58,21,0
58790,284,160,124,37,23,32,11,350,196,154,52,37,21,14,0
58791,130,70,60,30,9,8,1,178,69,109,29,25,21,13,0
58792,331,144,187,57,46,33,19,89,37,52,13,6,2,9,0
58793,504,255,249,56,59,45,13,510,243,267,65,67,44,44,0
58794,763,371,392,104,88,52,23,1239,659,580,169,148,131,54,0
58795,476,276,200,57,34,43,16,225,129,96,32,33,20,8,0
58796,465,240,225,50,54,24,14,556,290,266,75,74,29,24,0
58797,753,361,392,99,94,66,16,528,188,340,130,58,77,41,0
58798,300,136,164,45,35,45,14,328,199,129,39,29,27,14,0
58799,215,117,98,28,19,15,8,213,129,84,32,14,21,15,0
58800,225,111,114,38,22,25,10,549,273,276,74,68,72,24,0
58801,2414,1189,1225,277,178,170,169,452,231,221,74,53,56,20,0
58802,125,46,79,24,16,12,2,749,384,365,108,105,86,31,0
58803,260,138,122,44,30,28,6,266,146,120,41,28,31,7,0
58804,580,281,299,95,60,74,29,264,138,126,33,34,29,12,0
58805,561,282,279,68,62,36,14,266,150,116,28,28,24,12,0
58806,442,211,231,57,67,47,14,913,393,520,160,165,87,40,0
58807,630,231,399,150,83,84,50,483,258,225,70,53,54,20,0
58808,664,269,395,117,107,36,15,516,245,271,82,84,70,26,0
58809,193,105,88,33,16,9,4,818,357,461,122,136,54,25,0
58810,410,200,210,60,54,46,19,169,84,85,29,19,21,7,0
58811,594,248,346,104,109,53,5,1922,923,999,267,275,215,90,0
58812,801,331,470,151,139,99,55,303,137,166,54,54,31,15,0
58813,126,57,69,31,10,10,3,319,185,134,42,31,22,13,0
58814,1099,491,608,163,141,107,62,387,193,194,60,53,57,15,0
58815,350,172,178,61,45,32,13,127,54,73,11,33,15,6,0
58816,1098,519,579,182,159,79,42,4646,2328,2318,674,639,475,170,0
58817,442,254,188,46,22,40,19,588,286,302,78,99,53,25,0
58818,375,167,208,55,83,44,9,300,148,152,45,43,40,8,0
58819,729,351,378,111,98,58,18,230,125,105,29,40,20,6,0
58820,1030,438,592,184,104,108,30,403,233,170,38,29,21,14,0
58821,1120,436,684,208,120,101,115,149,77,72,37,10,20,5,0
58822,335,183,152,40,26,54,22,402,186,216,64,47,38,20,0
58823,667,366,301,96,55,84,25,384,212,172,44,43,34,14,0
58824,465,305,160,40,47,34,9,149,52,97,36,36,7,4,0
58825,729,351,378,111,98,58,18,103,59,44,25,2,13,6,0
58826,587,318,269,76,50,38,21,1101,626,475,145,122,120,50,0
58827,2525,1232,1293,398,317,186,61,232,111,121,23,29,17,9,0
58828,276,149,127,45,34,39,9,727,362,365,123,107,63,23,0
58829,452,202,250,83,60,56,19,172,88,84,24,31,20,12,0
58830,222,108,114,37,20,25,12,283,160,123,25,20,37,9,0
58831,438,185,253,71,64,52,28,247,128,119,34,14,16,14,0
58832,1395,595,800,223,206,113,61,723,353,370,120,109,96,33,0
58833,466,199,267,86,59,32,17,432,244,188,51,51,27,14,0
58834,193,95,98,33,17,25,17,619,305,314,85,93,71,29,0
58835,90,54,36,20,4,14,5,127,58,69,18,17,10,5,0
58836,605,277,328,99,54,63,43,367,199,168,62,44,34,8,0
58837,149,68,81,15,38,11,10,520,240,280,67,72,42,14,0
58838,585,277,308,92,73,61,32,308,129,179,44,60,19,8,0
58839,733,438,295,95,79,67,32,548,273,275,84,81,64,30,0
58840,404,197,207,60,48,47,20,145,77,68,26,7,15,8,0
58841,278,110,168,58,49,29,5,584,249,335,80,96,22,13,0
58842,650,330,320,97,77,65,28,601,278,323,124,87,65,21,0
58843,255,110,145,34,32,23,17,661,325,336,81,75,65,28,0
58844,1124,442,682,148,189,72,43,621,310,311,100,106,77,27,0
58845,127,62,65,13,33,7,6,241,127,114,34,33,29,12,0
58846,169,64,105,23,37,11,3,180,108,72,22,22,15,5,0
58847,760,322,438,81,130,57,19,137,63,74,20,22,14,6,0
58848,2663,1073,1590,548,499,192,64,514,248,266,86,82,52,22,0
58849,231,105,126,56,10,24,10,108,59,49,17,13,12,5,0
58850,1098,519,579,182,159,79,42,957,381,576,184,158,86,48,0
58851,1417,598,819,223,188,135,58,133,61,72,21,19,13,4,0
58852,402,169,233,70,36,34,18,163,79,84,22,24,13,5,0
58853,279,129,150,43,34,17,13,201,93,108,34,39,21,6,0
58854,1960,875,1085,287,189,162,66,296,140,156,49,40,42,19,0
58855,213,113,100,26,21,26,12,517,295,222,69,62,40,28,0
58856,552,295,257,67,49,70,30,736,388,348,88,85,67,28,0
58857,553,319,234,56,37,54,18,594,312,282,72,67,73,31,0
58858,426,214,212,63,47,53,20,2346,1231,1115,316,292,266,105,0
58859,462,258,204,59,41,56,15,541,279,262,79,82,31,32,0
58860,522,302,220,61,49,75,19,319,185,134,42,31,22,13,0
58861,532,254,278,91,48,23,17,1001,417,584,186,147,96,47,0
58862,717,381,336,118,103,85,29,362,156,206,74,42,36,22,0
58863,306,172,134,35,31,37,18,592,249,343,91,90,50,42,0
58864,392,221,171,53,30,25,8,1230,644,586,198,125,123,61,0
58865,425,199,226,54,71,56,11,862,426,436,113,115,84,37,0
58866,130,70,60,30,9,8,1,330,166,164,55,51,36,16,0
58867,425,198,227,57,69,59,13,381,187,194,37,49,36,17,0
58868,603,311,292,102,71,66,23,1352,602,750,166,185,81,70,0
58869,557,211,346,129,125,48,19,319,185,134,42,31,22,13,0
58870,1023,449,574,141,174,76,43,283,160,123,25,20,37,9,0
58871,526,268,258,54,37,55,12,556,290,266,75,74,29,24,0
58872,714,260,454,140,97,120,54,972,471,501,152,138,112,40,0
58873,852,461,391,109,102,72,24,198,115,83,30,22,8,8,0
58874,575,305,270,74,87,73,25,469,225,244,64,68,25,11,0
58875,1148,472,676,229,164,86,37,818,357,461,122,136,54,25,0
58876,246,123,123,40,31,27,7,900,441,459,125,127,110,32,0
58877,498,274,224,58,59,50,18,766,386,380,101,81,78,31,0
58878,282,105,177,77,28,39,6,1698,875,823,222,219,173,64,0
58879,390,199,191,72,42,35,12,373,181,192,54,35,44,20,0
58880,420,248,172,64,30,43,17,627,289,338,101,73,62,43,0
58881,575,305,270,74,87,73,25,169,74,95,33,26,22,3,0
58882,1064,495,569,157,159,124,58,395,169,226,73,55,38,9,0
58883,502,229,273,63,66,40,31,142,73,69,27,9,15,11,0
58884,700,305,395,111,99,54,18,496,285,211,62,54,46,22,0
58885,199,113,86,27,17,10,7,2346,1231,1115,316,292,266,105,0
58886,949,467,482,126,127,102,51,644,343,301,96,69,59,28,0
58887,325,181,144,46,31,48,9,89,51,38,15,15,5,4,0
58888,454,230,224,63,56,38,33,535,288,247,79,72,35,21,0
58889,338,139,199,54,54,18,11,286,160,126,37,27,23,10,0
58890,344,109,235,100,39,26,5,207,86,121,34,39,11,13,0
58891,240,167,73,32,12,8,21,516,245,271,82,84,70,26,0
58892,624,222,402,92,81,39,15,189,95,94,25,33,16,8,0
58893,218,133,85,20,19,13,6,166,88,78,23,18,13,7,0
58894,772,332,440,136,104,72,28,338,169,169,53,44,39,21,0
58895,290,156,134,44,29,39,9,375,209,166,50,37,29,23,0
58896,126,57,69,31,10,10,3,654,295,359,99,88,71,25,0
58897,86,50,36,9,14,8,7,360,180,180,57,48,39,12,0
58898,1208,575,633,187,204,117,41,165,87,78,24,19,22,9,0
58899,394,207,187,52,42,37,24,892,475,417,130,108,68,38,0
58900,2063,1024,1039,175,117,80,97,547,295,252,81,65,57,23,0
58901,221,80,141,48,37,14,10,1214,475,739,177,250,89,49,0
58902,1499,864,635,141,99,76,110,166,90,76,27,18,21,5,0
58903,493,281,212,56,61,30,13,209,119,90,28,24,27,9,0
58904,246,123,123,40,31,27,7,398,200,198,68,43,51,14,0
58905,836,370,466,126,96,72,30,337,152,185,49,54,42,21,0
58906,326,154,172,45,39,20,10,282,134,148,38,45,29,10,0
58907,653,379,274,89,56,86,13,1279,669,610,164,162,104,55,0
58908,426,196,230,76,65,54,20,792,398,394,109,96,90,39,0
58909,885,424,461,143,114,92,32,195,100,95,27,20,17,11,0
58910,258,144,114,33,22,19,9,386,181,205,55,51,57,31,0
58911,379,217,162,47,20,50,23,335,170,165,52,36,47,11,0
58912,411,202,209,60,67,57,24,415,226,189,51,40,40,29,0
58913,203,80,123,40,37,20,3,751,394,357,107,96,73,35,0
58914,446,265,181,51,35,27,17,749,384,365,108,105,86,31,0
58915,428,226,202,52,60,75,20,187,89,98,36,24,20,6,0
58916,1058,497,561,194,142,87,63,898,469,429,125,125,134,35,0
58917,412,146,266,106,38,67,35,384,212,172,44,43,34,14,0
58918,380,185,195,68,54,32,16,462,251,211,74,53,41,18,0
58919,439,241,198,67,40,40,13,72,32,40,8,2,2,13,0
58920,431,199,232,59,54,40,17,241,127,114,34,33,29,12,0
58921,1499,864,635,141,99,76,110,384,204,180,53,47,49,17,0
58922,1960,875,1085,287,189,162,66,496,285,211,62,54,46,22,0
58923,325,181,144,46,31,48,9,89,38,51,14,6,3,9,0
58924,281,125,156,44,47,17,7,551,226,325,96,103,43,11,0
58925,385,203,182,47,43,51,21,278,154,124,42,32,38,7,0
58926,503,260,243,46,56,33,16,925,439,486,141,134,105,46,0
58927,622,354,268,89,60,64,18,222,124,98,37,29,22,9,0
58928,410,188,222,53,52,31,14,194,109,85,23,24,21,9,0
58929,1544,738,806,239,217,145,91,178,69,109,29,25,21,13,0
58930,462,258,204,59,41,56,15,535,311,224,66,52,49,24,0
58931,933,456,477,123,108,83,29,335,186,149,40,28,29,13,0
58932,364,192,172,49,36,39,14,173,90,83,30,19,19,11,0
58933,330,151,179,68,36,56,9,663,360,303,87,82,80,35,0
58934,262,133,129,44,38,31,12,418,223,195,51,45,49,14,0
58935,401,236,165,53,38,34,9,395,169,226,73,55,38,9,0
58936,1501,679,822,251,196,174,67,270,130,140,48,44,37,12,0
58937,416,207,209,63,47,56,15,647,350,297,95,79,77,29,0
58938,496,274,222,57,43,75,22,323,162,161,52,41,39,13,0
58939,727,426,301,79,71,64,32,246,125,121,38,36,30,11,0
58940,395,189,206,63,50,49,28,583,280,303,95,66,76,25,0
58941,441,218,223,69,55,50,27,277,163,114,33,24,21,16,0
58942,1872,837,1035,280,338,169,80,330,166,164,55,51,36,16,0
58943,261,148,113,23,29,26,21,693,360,333,100,88,62,26,0
58944,392,221,171,53,30,25,8,535,288,247,79,72,35,21,0
58945,109,42,67,25,13,1,1,133,61,72,21,19,13,4,0
58946,630,231,399,150,83,84,50,277,124,153,44,40,35,18,0
58947,674,318,356,86,139,50,11,1065,581,484,134,97,76,46,0
58948,1130,614,516,129,138,98,42,515,276,239,62,59,43,31,0
58949,255,110,145,34,32,23,17,258,129,129,45,24,31,10,0
58950,1960,875,1085,287,189,162,66,425,177,248,60,62,33,16,0
58951,2174,1057,1117,241,241,214,117,463,259,204,62,55,34,22,0
58952,301,156,145,32,25,15,5,373,213,160,44,33,26,17,0
58953,603,311,292,102,71,66,23,708,328,380,113,100,82,34,0
58954,446,174,272,84,61,57,23,450,241,209,67,58,54,23,0
58955,673,317,356,101,85,76,49,198,115,83,30,22,8,8,0
58956,476,227,249,52,59,38,17,1539,686,853,166,229,123,68,0
58957,118,51,67,25,13,6,7,430,212,218,88,43,40,20,0
58958,1171,542,629,170,146,114,64,783,406,377,102,91,57,29,0
58959,131,69,62,29,9,9,1,72,33,39,8,2,3,12,0
58960,243,70,173,54,65,8,6,483,287,196,71,50,54,17,0
58961,83,45,38,11,8,8,3,463,268,195,59,46,46,21,0
58962,507,242,265,53,44,31,22,621,310,311,100,106,77,27,0
58963,446,195,251,56,53,31,15,384,204,180,53,47,49,17,0
58964,485,246,239,74,48,47,22,198,113,85,19,20,26,12,0
58965,416,222,194,58,38,38,20,163,79,84,22,24,13,5,0
58966,350,190,160,48,25,27,18,445,192,253,86,58,53,18,0
58967,446,195,251,56,53,31,15,319,185,134,42,31,22,13,0
58968,346,168,178,36,43,20,9,943,463,480,91,144,70,30,0
58969,454,230,224,63,56,38,33,205,94,111,48,31,15,6,0
58970,126,58,68,31,10,10,3,798,385,413,120,115,79,30,0
58971,155,85,70,17,16,4,8,227,130,97,32,25,22,12,0
58972,496,210,286,112,55,72,13,693,360,333,100,88,62,26,0
58973,178,74,104,31,28,9,4,96,45,51,13,12,6,4,0
58974,380,148,232,81,69,24,8,452,231,221,74,53,56,20,0
58975,588,317,271,78,49,54,17,285,146,139,41,41,48,13,0
58976,717,281,436,165,81,112,49,929,459,470,140,120,94,45,0
58977,2063,1024,1039,175,117,80,97,260,131,129,42,31,40,9,0
58978,420,202,218,67,43,51,15,557,281,276,80,59,43,21,0
58979,346,209,137,46,37,44,10,453,247,206,58,53,45,20,0
58980,2649,1431,1218,377,299,266,102,101,59,42,11,17,10,1,0
58981,270,166,104,30,26,28,14,414,203,211,58,56,48,14,0
58982,331,169,162,40,28,22,14,240,141,99,34,28,29,8,0
58983,399,220,179,48,37,68,18,479,215,264,67,80,46,28,0
58984,2525,1232,1293,398,317,186,61,434,213,221,77,62,53,12,0
58985,261,126,135,41,36,24,11,137,78,59,22,16,17,4,0
58986,118,51,67,25,13,6,7,374,174,200,54,52,42,21,0
58987,288,142,146,52,32,26,8,266,150,116,28,28,24,12,0
58988,136,66,70,33,11,9,3,166,88,78,23,18,13,7,0
58989,473,212,261,72,64,45,28,889,505,384,107,97,99,30,0
58990,473,265,208,47,26,50,30,378,154,224,74,84,35,22,0
58991,360,205,155,35,24,52,14,4646,2328,2318,674,639,475,170,0
58992,466,259,207,59,50,83,12,526,266,260,76,75,53,22,0
58993,492,253,239,73,67,77,29,341,170,171,41,66,27,10,0
58994,734,339,395,135,89,78,36,316,159,157,38,48,30,11,0
58995,1580,742,838,208,146,144,71,403,192,211,102,39,49,15,0
58996,1835,904,931,192,144,135,63,260,133,127,43,32,39,3,0
58997,406,208,198,41,26,43,21,222,125,97,34,27,27,7,0
58998,431,245,186,50,23,46,17,295,160,135,44,36,46,16,0
58999,192,91,101,28,21,18,8,309,159,150,47,43,43,13,0
59000,584,297,287,89,80,65,17,300,148,152,45,43,40,8,0
59001,3859,2011,1848,535,391,422,207,415,203,212,77,44,49,18,0
59002,536,287,249,64,73,21,27,135,65,70,21,25,15,9,0
59003,255,110,145,34,32,23,17,261,148,113,31,28,14,10,0
59004,500,245,255,66,57,52,27,461,223,238,45,62,18,35,0
59005,372,171,201,47,53,39,18,418,223,195,53,43,49,15,0
59006,426,196,230,76,65,54,20,124,69,55,14,7,9,4,0
59007,184,93,91,26,25,14,11,708,328,380,113,100,82,34,0
59008,517,196,321,103,98,33,12,403,233,170,38,29,21,14,0
59009,589,282,307,68,67,70,23,339,180,159,36,29,16,16,0
59010,516,224,292,79,29,45,33,166,102,64,19,14,17,2,0
59011,758,378,380,89,64,37,31,732,402,330,81,86,87,33,0
59012,1096,563,533,158,136,120,53,892,475,417,130,108,68,38,0
59013,1009,478,531,166,126,96,42,227,130,97,32,25,22,12,0
59014,586,298,288,80,75,64,37,348,194,154,57,31,43,12,0
59015,813,412,401,114,93,112,26,385,188,197,57,42,36,16,0
59016,480,267,213,49,44,70,21,549,273,276,74,68,72,24,0
59017,246,128,118,39,34,22,7,192,111,81,20,23,18,10,0
59018,313,134,179,58,37,43,19,153,65,88,28,21,20,8,0
59019,933,456,477,123,108,83,29,376,189,187,47,53,44,26,0
59020,364,168,196,64,61,27,6,234,129,105,31,22,19,17,0
59021,291,131,160,49,35,32,15,103,59,44,25,2,13,6,0
59022,341,183,158,36,34,36,15,798,385,413,120,115,79,30,0
59023,785,374,411,56,42,38,25,723,353,370,120,109,96,33,0
59024,86,50,36,9,14,8,7,555,292,263,75,63,67,27,0
59025,580,308,272,82,79,58,25,1507,737,770,188,228,147,71,0
59026,103,56,47,27,7,8,2,105,51,54,13,17,12,8,0
59027,2136,1063,1073,317,308,223,90,98,49,49,14,15,9,2,0
59028,496,272,224,70,58,42,18,1127,527,600,147,128,83,58,0
59029,1616,735,881,285,248,153,72,654,295,359,99,88,71,25,0
59030,468,233,235,65,61,49,34,501,274,227,63,58,53,20,0
59031,402,169,233,70,36,34,18,261,127,134,36,27,36,4,0
59032,708,344,364,106,98,66,33,373,213,160,44,33,26,17,0
59033,331,165,166,52,34,48,22,421,222,199,69,50,60,18,0
59034,451,225,226,69,57,64,22,592,249,343,91,90,50,42,0
59035,570,238,332,112,95,39,23,663,360,303,87,82,80,35,0
59036,1087,523,564,146,177,103,33,392,186,206,62,56,29,15,0
59037,415,217,198,50,31,42,17,245,121,124,37,35,36,12,0
59038,615,308,307,83,75,58,32,2225,1244,981,271,243,217,93,0
59039,828,355,473,126,134,77,37,953,489,464,126,104,111,44,0
59040,388,244,144,46,25,42,16,332,155,177,55,51,44,13,0
59041,341,195,146,42,21,36,9,245,131,114,30,27,18,13,0
59042,129,70,59,29,9,7,2,975,400,575,160,162,62,31,0
59043,343,162,181,65,38,29,12,565,237,328,75,88,32,11,0
59044,535,217,318,87,106,41,14,662,373,289,89,80,77,29,0
59045,217,98,119,38,35,18,9,389,207,182,53,58,52,18,0
59046,395,195,200,41,55,23,10,247,128,119,34,14,16,14,0
59047,83,45,38,11,8,8,3,925,439,486,141,134,105,46,0
59048,227,120,107,31,28,28,13,245,121,124,37,35,36,12,0
59049,1217,647,570,142,160,129,45,368,204,164,43,35,30,24,0
59050,206,96,110,33,25,8,6,723,363,360,107,106,52,14,0
59051,484,194,290,70,93,47,16,295,156,139,41,40,42,15,0
59052,272,141,131,45,29,36,9,457,253,204,67,51,48,13,0
59053,1447,698,749,214,180,116,46,87,51,35,15,9,9,4,0
59054,297,182,115,41,22,23,8,309,159,150,47,43,43,13,0
59055,726,312,414,121,73,82,23,536,222,314,101,100,34,22,0
59056,127,62,65,13,33,7,6,234,116,118,34,35,23,9,0
59057,240,166,74,32,12,8,15,452,231,221,74,53,56,20,0
59058,1441,504,937,264,329,69,46,1873,935,938,233,225,203,79,0
59059,138,35,103,38,2,15,9,153,65,88,28,21,20,8,0
59060,505,226,279,68,51,30,15,314,177,137,34,40,29,9,0
59061,580,281,299,95,60,74,29,514,262,252,78,58,54,26,0
59062,213,88,125,21,54,14,15,455,229,226,66,62,63,29,0
59063,786,378,408,106,98,77,39,395,198,197,55,55,36,10,0
59064,470,163,307,99,68,73,30,798,385,413,120,115,79,30,0
59065,504,222,282,71,64,53,29,1352,602,750,166,185,81,70,0
59066,444,250,194,58,21,60,23,137,78,59,22,16,17,4,0
59067,2136,1063,1073,317,308,223,90,337,152,185,49,54,42,21,0
59068,520,240,280,87,63,67,16,205,94,111,48,31,15,6,0
59069,898,397,501,102,98,54,37,317,161,156,50,36,47,12,0
59070,1208,575,633,187,204,117,41,396,213,183,68,44,47,18,0
59071,262,133,129,44,38,31,12,309,159,150,47,43,43,13,0
59072,524,270,254,84,72,70,23,220,107,113,36,35,28,9,0
59073,530,259,271,83,50,54,41,810,310,500,164,162,42,26,0
59074,426,196,230,76,65,54,20,741,383,358,92,63,79,36,0
59075,2442,1193,1249,278,183,170,145,710,375,335,95,94,110,28,0
59076,528,273,255,67,53,29,20,556,290,266,75,74,29,24,0
59077,395,189,206,63,50,49,28,144,67,77,28,14,9,8,0
59078,498,274,224,58,59,50,18,414,203,211,58,56,48,14,0
59079,255,110,145,34,32,23,17,1047,562,485,141,127,114,41,0
59080,727,426,301,79,71,64,32,153,65,88,28,21,20,8,0
59081,494,233,261,87,57,46,18,515,276,239,62,59,43,31,0
59082,257,132,125,39,27,26,10,137,72,65,27,13,15,8,0
59083,272,141,131,45,29,36,9,425,210,215,56,43,52,25,0
59084,526,228,298,69,64,32,30,660,333,327,102,95,69,31,0
59085,282,160,122,36,28,27,7,455,229,226,66,62,63,29,0
59086,1199,589,610,189,128,167,65,430,212,218,88,43,40,20,0
59087,641,349,292,92,60,39,24,209,119,90,28,24,27,9,0
59088,362,174,188,46,55,35,23,137,78,59,22,16,17,4,0
59089,739,389,350,129,61,69,25,1314,693,621,174,155,140,58,0
59090,784,351,433,118,87,73,41,1182,591,591,155,139,83,46,0
59091,127,55,72,25,18,5,7,200,89,111,26,25,17,7,0
59092,283,112,171,48,39,34,15,647,324,323,101,80,76,43,0
59093,496,209,287,112,55,71,14,501,240,261,80,62,49,42,0
59094,395,189,206,63,50,49,28,501,257,244,75,57,48,29,0
59095,328,195,133,36,23,35,9,207,114,93,33,20,31,13,0
59096,556,306,250,69,60,80,18,584,249,335,80,96,22,13,0
59097,123,58,65,22,14,13,3,496,285,211,62,54,46,22,0
59098,290,156,134,44,29,39,9,194,109,85,23,24,21,9,0
59099,574,284,290,64,50,65,20,194,94,100,33,28,14,7,0
59100,227,120,107,31,28,28,13,744,385,359,105,96,57,31,0
59101,213,104,109,56,14,9,2,598,333,265,79,66,54,33,0
59102,272,141,131,45,29,36,9,415,226,189,51,40,40,29,0
59103,616,323,293,98,71,31,15,395,169,226,73,55,38,9,0
59104,126,58,68,31,10,10,3,240,141,99,34,28,29,8,0
59105,781,418,363,92,90,64,41,330,172,158,46,44,41,19,0
59106,425,198,227,57,69,59,13,453,255,198,62,49,29,19,0
59107,972,501,471,125,156,106,39,2724,1157,1567,269,518,239,77,0
59108,437,212,225,66,44,44,11,137,72,65,27,13,15,8,0
59109,380,187,193,38,51,30,18,332,173,159,48,40,31,11,0
59110,318,164,154,52,43,34,10,749,384,365,108,105,86,31,0
59111,213,104,109,56,14,9,2,111,60,51,17,23,10,7,0
59112,711,330,381,111,86,86,34,260,131,129,42,31,40,9,0
59113,1058,497,561,194,142,87,63,307,132,175,48,53,26,10,0
59114,410,188,222,53,52,31,14,565,237,328,75,88,32,11,0
59115,178,87,91,20,32,13,10,178,99,79,31,19,26,8,0
59116,318,164,154,52,43,34,10,245,121,124,37,35,36,12,0
59117,456,214,242,76,62,52,22,222,127,95,23,28,22,7,0
59118,475,235,240,77,58,43,22,134,72,62,14,28,8,4,0
59119,267,146,121,40,24,25,7,346,196,150,43,26,27,14,0
59120,959,496,463,144,132,75,35,389,210,179,51,37,43,9,0
59121,136,66,70,33,11,9,5,261,148,113,31,28,14,10,0
59122,346,173,173,50,56,31,14,593,289,304,85,69,48,19,0
59123,410,208,202,59,58,43,26,374,191,183,40,52,40,16,0
59124,316,157,159,45,38,22,19,319,185,134,42,31,22,13,0
59125,641,349,292,92,60,39,24,72,33,39,8,2,3,12,0
59126,144,57,87,38,26,10,4,173,86,87,30,22,19,12,0
59127,415,133,282,114,65,27,7,509,267,242,79,81,38,20,0
59128,1139,537,602,162,139,109,50,663,360,303,87,82,80,35,0
59129,269,127,142,43,24,34,26,1755,905,850,214,196,183,79,0
59130,314,178,136,42,32,30,17,405,195,210,57,74,24,17,0
59131,513,276,237,73,43,57,24,203,98,105,34,29,19,10,0
59132,380,185,195,68,54,32,16,611,314,297,79,75,78,22,0
59133,270,147,123,34,17,39,21,471,238,233,66,63,62,19,0
59134,1217,647,570,142,160,129,45,622,344,278,80,77,68,36,0
59135,338,208,130,39,30,35,12,583,321,262,73,67,45,25,0
59136,475,235,240,77,58,43,22,91,42,49,21,9,8,3,0
59137,282,135,147,27,37,30,19,335,186,149,40,28,29,13,0
59138,613,303,310,70,28,28,18,54,26,28,11,4,3,3,0
59139,283,112,171,48,39,34,15,720,361,359,98,98,70,37,0
59140,452,202,250,83,60,56,19,153,65,88,28,21,20,8,0
59141,861,393,468,150,101,69,35,1755,905,850,214,196,183,79,0
59142,476,199,277,82,80,49,24,336,200,136,34,29,25,24,0
59143,318,164,154,52,43,34,10,1114,539,575,145,131,94,56,0
59144,412,203,209,65,47,37,18,395,169,226,73,55,38,9,0
59145,747,469,278,60,41,53,23,517,295,222,69,62,40,28,0
59146,861,393,468,150,101,69,35,572,305,267,74,72,58,21,0
59147,429,238,191,47,49,56,29,601,279,322,81,65,27,12,0
59148,594,321,273,98,59,57,23,317,161,156,40,49,41,11,0
59149,443,206,237,76,68,52,28,103,59,44,25,2,13,6,0
59150,361,183,178,50,54,51,22,461,223,238,45,62,18,35,0
59151,533,300,233,74,50,74,17,437,224,213,40,29,42,25,0
59152,310,141,169,36,38,20,8,4646,2328,2318,674,639,475,170,0
59153,222,110,112,43,30,14,6,536,251,285,75,79,60,23,0
59154,446,195,251,56,53,31,15,1700,731,969,198,233,110,87,0
59155,126,56,70,31,10,10,3,173,90,83,21,36,12,15,0
59156,284,128,156,48,29,34,8,147,74,73,28,20,24,4,0
59157,519,245,274,58,61,34,22,518,292,226,60,60,52,21,0
59158,4640,2231,2409,660,549,437,245,389,210,179,51,37,43,9,0
59159,588,267,321,99,79,87,28,314,151,163,42,61,39,16,0
59160,610,249,361,107,69,72,33,196,105,91,40,13,19,10,0
59161,869,489,380,110,77,79,29,194,94,100,33,28,14,7,0
59162,437,212,225,66,44,44,11,175,82,93,33,26,17,5,0
59163,802,375,427,133,103,81,41,188,90,98,44,7,21,7,0
59164,861,393,468,150,101,69,35,1047,562,485,141,127,114,41,0
59165,410,200,210,60,54,46,19,87,38,49,23,10,10,9,0
59166,1148,592,556,152,133,133,41,419,175,244,71,73,23,23,0
59167,824,391,433,106,90,88,32,72,32,40,8,2,1,14,0
59168,983,449,534,95,77,55,36,135,57,78,21,20,9,11,0
59169,1257,464,793,221,264,75,37,200,99,101,31,24,26,6,0
59170,1186,495,691,182,208,88,32,373,181,192,54,35,44,20,0
59171,445,231,214,45,64,53,23,524,300,223,70,54,51,25,0
59172,1462,711,751,219,222,148,65,72,32,40,8,2,1,14,0
59173,1171,542,629,170,146,114,64,943,463,480,91,144,70,30,0
59174,764,277,487,158,162,64,31,222,122,100,39,32,24,9,0
59175,158,85,73,24,18,18,8,360,180,180,57,48,39,12,0
59176,209,75,134,53,48,20,9,660,333,327,102,95,69,31,0
59177,359,167,192,49,37,27,19,266,146,120,41,28,31,7,0
59178,496,209,287,112,55,71,14,252,130,122,45,23,32,11,0
59179,654,344,310,80,69,57,15,679,338,341,96,95,40,23,0
59180,1257,464,793,221,264,75,37,148,69,79,26,18,16,3,0
59181,1499,864,635,141,99,76,110,171,94,77,24,28,30,11,0
59182,607,305,302,92,89,74,23,376,189,187,47,53,44,26,0
59183,593,282,311,75,70,29,25,1001,417,584,186,147,96,47,0
59184,630,231,399,150,83,84,50,375,209,166,50,37,29,23,0
59185,478,177,301,109,66,59,25,137,72,65,27,13,15,8,0
59186,687,351,336,106,67,70,41,376,183,193,50,50,43,21,0
59187,828,368,460,118,98,59,38,405,181,224,71,57,31,12,0
59188,726,312,414,121,73,82,23,617,314,303,96,68,68,37,0
59189,941,459,482,167,140,82,38,231,126,105,37,26,29,6,0
59190,328,156,172,44,37,44,15,201,117,83,22,21,19,9,0
59191,1594,660,934,251,272,117,77,2225,1244,981,271,243,217,93,0
59192,828,368,460,118,98,59,38,203,98,105,34,29,19,10,0
59193,98,32,66,15,25,5,4,101,59,42,11,17,10,1,0
59194,641,324,317,88,92,49,14,192,111,81,20,23,18,10,0
59195,338,173,165,31,42,22,10,406,234,172,63,35,43,10,0
59196,2488,1085,1403,346,253,162,76,149,52,97,36,36,7,4,0
59197,184,93,91,26,25,14,11,480,255,225,67,64,50,22,0
59198,717,281,436,165,81,112,49,1034,495,539,150,134,114,71,0
59199,1689,821,868,277,250,177,78,367,218,149,45,43,42,16,0
59200,437,212,225,66,44,44,11,462,251,211,74,53,41,18,0
59201,338,164,174,45,32,37,13,2225,1244,981,271,243,217,93,0
59202,326,154,172,45,39,20,10,145,77,68,26,7,15,8,0
59203,143,81,62,28,9,8,1,296,159,137,49,28,38,13,0
59204,565,264,301,101,73,72,15,2225,1244,981,271,243,217,93,0
59205,618,289,329,97,86,70,17,538,274,264,84,67,52,35,0
59206,431,199,232,59,54,40,17,479,215,264,67,80,46,28,0
59207,107,56,51,18,16,12,5,701,380,321,94,84,96,34,0
59208,627,237,390,137,57,108,44,246,107,139,55,33,27,11,0
59209,260,136,124,24,41,19,4,520,272,248,60,65,58,22,0
59210,598,300,298,68,77,59,21,902,499,403,118,117,92,35,0
59211,932,575,357,94,69,76,40,504,272,232,75,57,53,19,0
59212,972,501,471,125,156,106,39,565,264,301,101,73,72,15,0
59213,856,429,427,113,105,96,24,348,212,136,53,31,25,18,0
59214,626,308,318,105,89,77,25,904,436,468,143,118,108,32,0
59215,410,188,222,53,52,31,14,175,82,93,33,26,17,5,0
59216,610,249,361,107,69,72,33,398,200,198,68,43,51,14,0
59217,643,284,359,129,71,84,43,223,113,110,31,33,22,12,0
59218,489,253,236,73,36,62,17,165,90,75,36,18,20,6,0
59219,2285,1219,1066,207,180,178,106,317,161,156,40,49,41,11,0
59220,246,123,123,40,31,27,7,496,285,211,62,54,46,22,0
59221,255,126,129,41,37,13,5,277,138,139,40,39,20,14,0
59222,627,237,390,137,57,108,44,548,273,275,84,81,64,30,0
59223,681,367,314,83,74,78,31,501,257,244,75,57,48,29,0
59224,2663,1073,1590,548,499,192,64,654,295,359,99,88,71,25,0
59225,67,40,27,10,8,7,6,374,174,200,54,52,42,21,0
59226,286,111,175,51,47,21,12,309,159,150,47,43,43,13,0
59227,446,283,163,51,26,33,19,88,50,38,13,8,16,4,0
59228,1139,537,602,162,139,109,50,279,142,137,43,39,28,7,0
59229,1217,647,570,142,160,129,45,465,252,213,73,58,60,18,0
59230,139,64,75,18,17,18,4,508,262,246,66,67,51,20,0
59231,242,104,138,41,33,37,8,425,210,215,56,43,52,25,0
59232,284,160,124,37,23,32,11,309,159,150,47,43,43,13,0
59233,496,274,222,57,43,75,22,866,397,469,117,153,95,48,0
59234,165,66,99,28,32,16,3,363,180,183,60,34,10,6,0
59235,465,305,160,40,47,34,9,661,325,336,81,75,65,28,0
59236,305,124,181,27,25,32,21,432,244,188,51,51,27,14,0
59237,285,148,137,31,42,42,16,483,258,225,70,53,54,20,0
59238,722,390,332,125,69,67,25,218,114,104,32,31,33,11,0
59239,2063,1024,1039,175,117,80,97,398,200,198,68,43,51,14,0
59240,673,317,356,101,85,76,49,597,300,297,96,89,68,29,0
59241,364,168,196,64,61,27,6,127,64,63,26,8,12,8,0
59242,351,166,185,48,61,24,15,340,169,171,40,39,36,22,0
59243,447,225,222,76,35,75,21,180,108,72,22,22,15,5,0
59244,462,258,204,59,41,56,15,1323,690,633,132,178,112,61,0
59245,390,199,191,72,42,35,12,228,130,98,35,29,30,10,0
59246,375,167,208,55,83,44,9,194,109,85,23,24,21,9,0
59247,245,111,134,36,27,18,6,536,251,285,75,79,60,23,0
59248,421,219,202,68,57,56,13,298,129,169,51,40,29,8,0
59249,1001,422,579,185,180,51,32,647,350,297,95,79,77,29,0
59250,1365,590,775,257,168,136,93,286,152,134,38,38,32,11,0
59251,204,109,95,21,35,27,7,453,247,206,58,53,45,20,0
59252,426,196,230,76,65,54,20,98,49,49,14,15,9,2,0
59253,639,368,271,72,51,38,38,900,441,459,125,127,110,32,0
59254,1284,511,773,227,166,169,107,381,196,185,55,57,43,16,0
59255,414,195,219,51,60,40,17,292,143,149,38,42,36,16,0
59256,403,176,227,71,56,51,11,198,113,85,19,20,26,12,0
59257,326,176,150,35,22,29,11,152,71,81,41,16,14,2,0
59258,320,163,157,44,44,26,15,418,223,195,51,45,49,14,0
59259,164,61,103,47,19,14,5,198,115,83,30,22,8,8,0
59260,425,199,226,54,71,56,11,662,373,289,89,80,77,29,0
59261,1163,417,746,209,145,87,28,928,440,488,111,157,82,35,0
59262,410,211,199,55,42,34,27,277,144,133,42,30,41,8,0
59263,55,16,39,24,2,5,2,611,314,297,79,75,78,22,0
59264,127,48,79,27,20,6,5,974,457,517,133,117,69,26,0
59265,517,196,321,103,98,33,12,535,311,224,66,52,49,24,0
59266,500,245,255,66,57,52,27,239,113,126,36,49,20,8,0
59267,357,182,175,49,36,39,15,406,223,183,61,53,46,17,0
59268,424,170,254,69,56,47,28,501,257,244,75,57,48,29,0
59269,260,136,124,24,41,19,4,325,159,166,59,46,30,12,0
59270,426,213,213,60,56,46,24,323,162,161,52,41,39,13,0
59271,756,265,491,129,127,51,17,378,154,224,74,84,35,22,0
59272,446,195,251,56,53,31,15,548,296,252,71,74,43,28,0
59273,1011,559,452,121,97,132,33,317,161,156,50,36,47,12,0
59274,580,281,299,95,60,74,29,405,195,210,57,74,24,17,0
59275,346,168,178,36,43,20,9,390,190,200,66,50,43,12,0
59276,410,188,222,53,52,31,14,222,119,103,37,32,24,8,0
59277,202,103,99,28,20,12,8,297,175,122,46,30,31,6,0
59278,99,35,64,25,18,0,1,111,60,51,17,23,10,7,0
59279,341,183,158,36,34,36,15,73,35,38,14,10,9,4,0
59280,278,110,168,58,49,29,5,240,141,99,34,28,29,8,0
59281,326,154,172,45,39,20,10,334,181,153,41,40,25,15,0
59282,490,198,292,65,81,39,27,277,152,125,31,35,22,19,0
59283,260,138,122,44,30,28,6,582,264,318,84,60,58,23,0
59284,204,109,95,21,35,27,7,332,173,159,48,40,31,11,0
59285,176,74,102,20,29,7,7,297,164,133,45,39,40,9,0
59286,505,201,304,116,58,75,31,501,249,252,77,70,55,22,0
59287,221,75,146,68,21,16,5,399,190,209,61,41,39,18,0
59288,600,324,276,89,73,45,39,367,218,149,45,43,42,16,0
59289,631,316,315,64,57,49,15,463,259,204,62,55,34,22,0
59290,429,238,191,47,49,56,29,415,203,212,77,44,49,18,0
59291,445,231,214,45,64,53,23,501,240,261,80,62,49,42,0
59292,343,162,181,65,38,29,12,463,268,195,59,46,46,21,0
59293,805,338,467,153,138,99,55,164,79,85,28,28,16,7,0
59294,651,357,294,81,67,103,18,729,358,371,116,99,89,33,0
59295,505,247,258,72,71,60,27,132,61,71,19,20,14,6,0
59296,333,171,162,50,34,19,8,392,214,178,48,40,53,22,0
59297,55,16,39,24,2,5,2,251,143,108,47,25,29,11,0
59298,527,276,251,64,60,70,20,547,295,252,81,65,57,23,0
59299,717,281,436,165,81,112,49,188,105,83,25,17,24,7,0
59300,204,103,101,16,32,22,8,172,79,93,34,27,23,10,0
59301,172,82,90,21,35,21,5,594,312,282,72,67,73,31,0
59302,465,240,225,50,54,24,14,230,113,117,31,40,28,10,0
59303,157,62,95,41,18,10,11,250,119,131,58,26,29,7,0
59304,130,71,59,30,9,8,2,270,130,140,48,44,37,12,0
59305,730,298,432,128,69,86,26,178,99,79,31,19,26,8,0
59306,291,120,171,63,39,26,6,301,168,133,49,37,34,11,0
59307,302,160,142,35,35,37,10,337,170,167,59,33,47,17,0
59308,344,109,235,100,39,26,5,203,98,105,34,29,19,10,0
59309,347,212,135,35,32,17,6,231,126,105,37,26,29,6,0
59310,1759,838,921,269,212,191,92,518,292,226,60,60,52,21,0
59311,773,383,390,108,76,79,30,516,245,271,82,84,70,26,0
59312,1047,443,604,162,156,78,52,101,59,42,11,17,10,1,0
59313,680,308,372,82,72,71,40,234,116,118,34,35,23,9,0
59314,416,207,209,63,47,56,15,963,455,508,127,130,115,48,0
59315,362,181,181,67,46,43,8,467,240,227,65,65,51,23,0
59316,256,152,104,18,23,23,8,397,234,163,44,38,23,21,0
59317,144,57,87,38,26,10,4,188,88,100,53,12,15,6,0
59318,466,259,207,59,50,83,12,408,221,187,55,51,57,14,0
59319,349,167,182,54,38,30,28,232,111,121,23,29,17,9,0
59320,586,309,277,81,64,76,25,403,214,189,54,45,41,22,0
59321,181,92,89,34,22,17,9,846,425,421,125,97,98,38,0
59322,326,148,178,55,42,31,12,679,338,341,96,95,40,23,0
59323,401,204,197,49,33,29,17,145,77,68,26,7,15,8,0
59324,136,66,70,33,11,9,4,300,148,152,45,43,40,8,0
59325,781,316,465,130,129,65,23,758,319,439,101,123,78,25,0
59326,800,328,472,159,159,41,15,2335,1200,1135,374,268,340,83,0
59327,503,260,243,46,56,33,16,200,99,101,31,24,26,6,0
59328,598,322,276,67,57,63,26,166,78,88,27,25,19,7,0
59329,376,171,205,45,45,34,12,328,199,129,39,29,27,14,0
59330,1872,837,1035,280,338,169,80,821,394,427,122,117,109,38,0
59331,622,354,268,89,60,64,18,194,109,85,23,24,21,9,0
59332,685,393,292,75,66,113,16,572,305,267,74,72,58,21,0
59333,378,202,176,34,32,44,13,900,441,459,125,127,110,32,0
59334,646,304,342,104,93,58,26,334,181,153,56,31,28,18,0
59335,2799,1324,1475,369,371,215,124,209,119,90,28,24,27,9,0
59336,671,334,337,105,104,77,27,885,421,464,121,127,48,29,0
59337,192,91,101,28,21,18,8,406,234,172,63,35,43,10,0
59338,500,257,243,60,55,27,22,483,287,196,71,50,54,17,0
59339,640,271,369,111,79,57,17,296,140,156,49,40,42,19,0
59340,665,341,324,109,79,38,22,194,106,88,33,10,15,6,0
59341,439,183,256,60,64,36,14,262,129,133,40,41,31,10,0
59342,317,153,164,34,52,30,14,715,345,370,110,97,64,25,0
59343,1718,735,983,266,225,130,68,404,190,214,55,55,35,27,0
59344,200,94,106,33,22,18,8,403,184,219,75,51,47,20,0
59345,1186,495,691,182,208,88,32,598,333,265,79,66,54,33,0
59346,366,190,176,39,62,55,14,222,125,97,34,27,27,7,0
59347,561,282,279,68,62,36,14,373,181,192,54,35,44,20,0
59348,466,259,207,59,50,83,12,222,119,103,37,32,24,8,0
59349,331,144,187,57,46,33,19,701,380,321,94,84,96,34,0
59350,261,148,113,23,29,26,21,452,252,200,55,49,61,16,0
59351,179,96,83,24,8,26,4,457,245,212,62,58,57,21,0
59352,833,295,538,146,139,65,34,68,36,32,11,8,9,2,0
59353,317,167,150,45,21,30,26,405,181,224,71,57,31,12,0
59354,181,75,106,35,26,11,9,463,170,293,115,54,75,32,0
59355,665,341,324,109,79,38,22,710,375,335,95,94,110,28,0
59356,299,128,171,57,40,13,25,620,324,296,81,68,66,31,0
59357,240,167,73,32,12,8,21,250,119,131,58,26,29,7,0
59358,368,154,214,80,52,41,16,137,72,65,27,13,15,8,0
59359,339,118,221,77,68,33,13,119,61,58,17,12,10,6,0
59360,372,189,183,60,44,41,18,234,116,118,34,35,23,9,0
59361,631,316,315,64,57,49,15,732,402,330,81,86,87,33,0
59362,1689,821,868,277,250,177,78,862,426,436,113,115,84,37,0
59363,256,152,104,18,23,23,8,225,114,111,32,29,26,6,0
59364,379,217,162,47,20,50,23,368,183,185,40,42,40,15,0
59365,794,322,472,122,108,79,34,295,158,137,42,34,38,14,0
59366,1189,653,536,152,118,109,56,339,175,164,51,49,37,9,0
59367,350,212,138,32,26,40,13,264,138,126,33,34,29,12,0
59368,452,217,235,59,47,60,20,664,350,314,86,90,82,36,0
59369,117,58,59,17,17,12,2,497,227,270,70,63,66,30,0
59370,221,80,141,48,37,14,10,209,119,90,28,24,27,9,0
59371,255,126,129,41,37,13,5,201,93,108,34,39,21,6,0
59372,207,128,79,26,17,19,9,387,193,194,60,53,57,15,0
59373,457,261,196,55,27,57,34,262,129,133,40,41,31,10,0
59374,432,190,242,85,82,28,11,370,190,180,60,52,37,13,0
59375,475,208,267,84,67,50,20,370,190,180,60,52,37,13,0
59376,204,103,101,16,32,22,8,218,115,103,37,33,33,9,0
59377,485,183,302,79,81,73,33,207,86,121,34,39,11,13,0
59378,173,90,83,30,19,19,11,463,170,293,115,54,75,32,0
59379,822,416,406,111,97,88,42,597,269,328,102,84,69,24,0
59380,1531,649,882,108,122,93,72,418,223,195,53,43,49,15,0
59381,861,393,468,150,101,69,35,188,101,87,20,18,20,14,0
59382,1085,646,439,108,65,36,19,732,366,366,108,86,74,41,0
59383,502,250,252,70,47,57,15,843,391,452,139,104,91,35,0
59384,435,225,210,58,46,50,14,601,279,322,81,65,27,12,0
59385,575,295,280,89,68,54,18,266,146,120,41,28,31,7,0
59386,674,268,406,118,96,70,21,501,257,244,75,57,48,29,0
59387,240,166,74,32,12,8,15,277,138,139,40,39,20,14,0
59388,269,124,145,36,24,32,11,1208,565,643,182,162,120,57,0
59389,479,227,252,69,48,46,18,507,270,237,89,59,57,22,0
59390,406,208,198,41,26,43,21,978,536,442,132,107,67,32,0
59391,1143,574,569,176,151,123,59,127,66,61,13,14,19,8,0
59392,454,230,224,63,56,38,33,2382,1162,1220,237,220,140,49,0
59393,127,54,73,31,10,11,3,619,305,314,85,93,71,29,0
59394,333,171,162,41,44,48,23,778,391,387,94,77,41,33,0
59395,443,226,217,67,34,53,10,338,169,169,53,44,39,21,0
59396,929,410,519,187,146,53,30,180,115,65,17,12,9,9,0
59397,667,366,301,96,55,84,25,139,68,71,14,26,14,9,0
59398,680,308,372,82,72,71,40,360,185,175,51,43,36,16,0
59399,411,202,209,60,67,57,24,1248,584,664,184,164,155,67,0
59400,126,56,70,31,10,10,3,978,536,442,132,107,67,32,0
59401,475,208,267,84,67,50,20,723,363,360,107,106,52,14,0
59402,1505,680,825,202,204,73,32,295,160,135,44,36,46,16,0
59403,507,242,265,53,44,31,22,926,340,586,133,119,60,40,0
59404,301,119,182,53,47,14,20,297,175,122,46,30,31,6,0
59405,410,200,210,60,54,46,19,584,249,335,80,96,22,13,0
59406,252,114,138,41,35,22,12,451,204,247,97,63,53,10,0
59407,461,207,254,82,66,55,33,514,262,252,78,58,54,26,0
59408,317,140,177,43,26,31,16,338,169,169,53,44,39,21,0
59409,331,177,154,54,38,27,11,421,222,199,69,50,60,18,0
59410,379,217,162,47,20,50,23,68,23,45,12,9,3,9,0
59411,545,221,324,101,72,55,30,367,199,168,62,44,34,8,0
59412,763,371,392,104,88,52,23,127,66,61,13,14,19,8,0
59413,680,308,372,82,72,71,40,926,340,586,133,119,60,40,0
59414,164,77,87,33,19,6,7,175,82,93,33,26,17,5,0
59415,412,203,209,65,47,37,18,297,164,133,45,39,40,9,0
59416,184,93,91,26,25,14,11,300,148,152,45,43,40,8,0
59417,326,154,172,45,39,20,10,305,163,142,38,27,47,11,0
59418,392,205,187,83,49,38,10,250,116,134,41,30,33,19,0
59419,209,75,134,53,48,20,9,133,61,72,21,19,13,4,0
59420,265,165,100,32,19,27,5,299,140,159,49,44,26,11,0
59421,563,255,308,91,111,42,30,408,221,187,55,51,57,14,0
59422,707,250,457,171,84,117,61,94,45,49,11,20,10,4,0
59423,707,250,457,171,84,117,61,376,183,193,50,50,43,21,0
59424,517,196,321,103,98,33,12,218,114,104,32,31,33,11,0
59425,297,182,115,41,22,23,8,222,124,98,37,29,22,9,0
59426,494,242,252,67,47,25,21,780,337,443,112,116,77,28,0
59427,521,289,232,71,58,49,16,392,155,237,68,61,34,16,0
59428,615,308,307,83,75,58,32,72,32,40,8,2,2,13,0
59429,132,66,66,21,18,11,7,277,138,139,40,39,20,14,0
59430,379,217,162,47,20,50,23,130,67,63,24,10,12,4,0
59431,233,110,123,34,22,34,9,247,128,119,34,14,16,14,0
59432,118,51,67,25,13,6,7,134,55,79,22,24,16,6,0
59433,887,439,448,137,99,91,38,404,190,214,55,55,35,27,0
59434,480,267,213,49,44,70,21,129,60,69,21,15,8,5,0
59435,473,265,208,47,26,50,30,720,361,359,98,98,70,37,0
59436,221,75,146,68,21,16,5,695,264,431,172,114,51,23,0
59437,2174,1057,1117,241,241,214,117,188,93,95,33,18,16,10,0
59438,371,209,162,46,17,36,19,290,147,143,34,34,39,13,0
59439,421,237,184,47,54,45,10,384,204,180,53,47,49,17,0
59440,136,66,70,33,11,9,3,727,362,365,123,107,63,23,0
59441,299,151,148,35,34,26,16,132,67,65,24,21,8,10,0
59442,582,328,254,78,48,35,9,396,213,183,68,44,47,18,0
59443,257,148,109,28,20,21,14,410,197,213,67,43,56,18,0
59444,328,156,172,44,37,44,15,317,161,156,40,49,41,11,0
59445,473,212,261,72,64,45,28,1114,539,575,145,131,94,56,0
59446,373,194,179,42,54,26,13,647,324,323,101,80,76,43,0
59447,466,259,207,59,50,83,12,1230,644,586,198,125,123,61,0
59448,1120,436,684,208,120,101,115,798,385,413,120,115,79,30,0
59449,745,402,343,95,71,69,40,287,151,136,51,42,36,7,0
59450,538,263,275,71,85,44,18,1507,737,770,188,228,147,71,0
59451,1054,497,557,190,168,107,45,381,186,195,69,55,46,15,0
59452,736,353,383,117,83,71,18,2202,1121,1081,338,274,269,81,0
59453,873,366,507,127,125,75,21,326,149,177,51,51,28,10,0
59454,202,103,99,28,20,12,8,296,151,145,45,42,32,11,0
59455,649,304,345,99,80,67,40,178,69,109,29,25,21,13,0
59456,594,279,315,93,68,68,26,165,90,75,36,18,20,6,0
59457,440,267,173,52,29,42,12,265,134,131,48,34,33,15,0
59458,1174,594,580,175,155,126,66,483,258,225,70,53,54,20,0
59459,435,225,210,58,46,50,14,200,89,111,26,25,17,7,0
59460,476,276,200,57,34,43,16,1700,731,969,198,233,110,87,0
59461,862,384,478,127,110,75,42,501,257,244,75,57,48,29,0
59462,391,204,187,47,48,38,18,301,168,133,49,37,34,11,0
59463,781,316,465,130,129,65,23,368,200,168,54,49,43,9,0
59464,269,127,142,43,24,34,26,1061,543,518,146,123,109,67,0
59465,428,226,202,52,60,75,20,405,181,224,71,57,31,12,0
59466,155,85,70,17,16,4,8,4646,2328,2318,674,639,475,170,0
59467,480,232,248,73,40,44,30,198,113,85,19,20,26,12,0
59468,118,51,67,25,13,6,7,142,65,77,30,17,22,9,0
59469,385,203,182,47,43,51,21,415,203,212,77,44,49,18,0
59470,476,199,277,82,80,49,24,418,246,172,52,39,57,10,0
59471,773,383,390,108,76,79,30,2346,1231,1115,316,292,266,105,0
59472,643,284,359,129,71,84,43,316,166,150,45,38,37,13,0
59473,820,333,487,202,152,59,23,432,244,188,51,51,27,14,0
59474,346,174,172,36,43,21,9,873,411,462,132,107,84,40,0
59475,347,154,193,48,51,25,11,617,314,303,96,68,68,37,0
59476,911,441,470,123,108,60,21,169,85,84,21,14,9,9,0
59477,585,277,308,92,73,61,32,720,357,363,113,85,62,39,0
59478,224,108,116,31,32,22,8,360,185,175,51,43,36,16,0
59479,1112,457,655,180,164,99,39,457,242,215,39,46,53,10,0
59480,484,261,223,59,48,49,24,368,183,185,40,42,40,15,0
59481,426,213,213,60,56,46,24,335,186,149,40,28,29,13,0
59482,464,237,227,64,66,33,12,375,209,166,50,37,29,23,0
59483,154,74,80,18,19,7,2,137,63,74,20,22,14,6,0
59484,1580,742,838,208,146,144,71,290,147,143,34,34,39,13,0
59485,435,230,205,51,37,55,18,145,77,68,26,7,15,8,0
59486,228,82,146,45,37,18,8,251,143,108,47,25,29,11,0
59487,471,221,250,87,68,42,25,630,321,309,86,90,57,26,0
59488,124,58,66,20,28,11,7,294,146,148,50,45,51,15,0
59489,736,353,383,117,83,71,18,1113,480,633,170,173,81,34,0
59490,438,185,253,71,64,52,28,104,46,58,15,17,9,5,0
59491,257,122,135,44,19,21,16,257,126,131,61,24,22,8,0
59492,1464,693,771,153,136,91,86,134,55,79,22,24,16,6,0
59493,736,353,383,117,83,71,18,222,122,100,39,32,24,9,0
59494,682,292,390,89,69,58,20,597,300,297,96,89,68,29,0
59495,463,225,238,76,36,59,26,422,237,185,53,47,62,20,0
59496,67,40,27,10,8,7,6,1025,549,476,118,109,88,61,0
59497,426,213,213,60,56,46,24,482,232,250,77,81,44,13,0
59498,415,217,198,50,31,42,17,96,46,50,16,12,7,5,0
59499,444,250,194,58,21,60,23,323,168,155,51,41,38,12,0
59500,458,210,248,39,38,25,16,2038,1059,979,262,237,208,100,0
59501,1755,849,906,245,226,148,56,1700,731,969,198,233,110,87,0
59502,331,169,162,40,28,22,14,178,99,79,31,19,26,8,0
59503,465,220,245,88,34,61,23,292,143,149,38,42,36,16,0
59504,301,156,145,32,25,15,5,1004,457,547,150,150,74,52,0
59505,379,203,176,55,48,45,16,553,276,277,88,61,45,27,0
59506,283,172,111,39,31,29,8,123,61,62,17,18,17,7,0
59507,406,207,199,56,46,68,19,1025,549,476,118,109,88,61,0
59508,144,57,87,38,26,10,4,337,152,185,49,54,42,21,0
59509,385,203,182,47,43,51,21,501,249,252,77,70,55,22,0
59510,102,22,80,48,8,18,6,492,278,214,65,58,32,11,0
59511,616,304,312,75,71,55,25,455,191,264,68,86,21,19,0
59512,257,148,109,28,20,21,14,671,306,365,114,76,49,19,0
59513,139,64,75,18,17,18,4,180,108,72,22,22,15,5,0
59514,415,133,282,114,65,27,7,515,276,239,62,59,43,31,0
59515,463,225,238,76,36,59,26,395,198,197,55,55,36,10,0
59516,629,338,291,92,57,64,22,509,267,242,79,81,38,20,0
59517,283,172,111,39,31,29,8,424,179,245,65,67,29,11,0
59518,431,216,215,46,40,33,9,65,32,33,16,4,8,3,0
59519,480,257,223,74,26,60,27,282,134,148,38,45,29,10,0
59520,188,84,104,35,36,18,9,749,384,365,108,105,86,31,0
59521,908,324,584,181,162,81,29,218,111,107,45,29,24,6,0
59522,743,377,366,87,74,68,30,766,386,380,101,81,78,31,0
59523,565,264,301,101,73,72,15,103,59,44,25,2,13,6,0
59524,392,221,171,53,30,25,8,509,267,242,79,81,38,20,0
59525,401,236,165,53,38,34,9,330,166,164,55,51,36,16,0
59526,585,277,308,92,73,61,32,199,105,94,27,27,28,9,0
59527,2446,1099,1347,363,294,233,100,96,46,50,16,12,7,5,0
59528,399,196,203,62,45,38,19,701,380,321,94,84,96,34,0
59529,717,381,336,118,103,85,29,427,251,176,51,39,25,22,0
59530,881,492,389,87,97,59,51,671,321,350,95,87,75,34,0
59531,476,276,200,57,34,43,16,671,321,350,95,87,75,34,0
59532,411,211,200,61,46,35,18,704,355,349,113,94,71,24,0
59533,328,195,133,36,23,35,9,132,67,65,24,21,8,10,0
59534,323,156,167,52,45,39,18,662,312,350,103,104,59,20,0
59535,2279,996,1283,375,328,158,60,1020,538,482,145,115,111,58,0
59536,204,103,101,16,32,22,8,190,93,97,35,27,23,2,0
59537,546,265,281,101,64,38,16,265,134,131,48,34,33,15,0
59538,1030,438,592,184,104,108,30,277,163,114,33,24,21,16,0
59539,437,167,270,126,95,34,10,633,311,322,94,82,45,20,0
59540,594,248,346,104,109,53,5,329,196,133,41,36,31,15,0
59541,639,368,271,72,51,38,38,286,152,134,38,38,32,11,0
59542,2109,999,1110,332,294,187,89,843,391,452,139,104,91,35,0
59543,338,139,199,54,54,18,11,929,459,470,140,120,94,45,0
59544,372,171,201,47,53,39,18,526,266,260,76,75,53,22,0
59545,228,105,123,34,43,20,10,292,155,137,50,34,29,13,0
59546,246,111,135,64,47,27,3,374,191,183,40,52,40,16,0
59547,275,160,115,40,31,34,17,230,113,117,31,40,28,10,0
59548,457,228,229,64,36,52,21,334,181,153,41,40,25,15,0
59549,543,265,278,52,37,54,19,144,67,77,28,14,9,8,0
59550,176,74,102,20,29,7,7,701,380,321,94,84,96,34,0
59551,339,170,169,32,17,24,13,548,296,252,71,74,43,28,0
59552,505,226,279,68,51,30,15,732,366,366,108,86,74,41,0
59553,309,137,172,51,50,28,14,222,127,95,23,28,22,7,0
59554,479,228,251,71,57,60,14,649,307,342,71,134,45,17,0
59555,1417,598,819,223,188,135,58,549,273,276,74,68,72,24,0
59556,494,242,252,67,47,25,21,212,127,85,28,21,26,6,0
59557,365,222,143,44,24,35,11,621,310,311,100,106,77,27,0
59558,284,128,156,48,29,34,8,231,126,105,37,26,29,6,0
59559,1105,544,561,165,167,99,40,244,143,101,31,29,26,8,0
59560,98,32,66,15,25,5,4,501,257,244,75,57,48,29,0
59561,465,305,160,40,47,34,9,415,205,210,77,52,55,17,0
59562,615,308,307,83,75,58,32,846,425,421,125,97,98,38,0
59563,674,268,406,118,96,70,21,308,146,162,42,39,24,12,0
59564,341,183,158,36,34,36,15,267,141,126,53,27,23,7,0
59565,330,77,253,86,52,20,12,928,440,488,111,157,82,35,0
59566,122,56,66,26,13,11,5,704,355,349,113,94,71,24,0
59567,281,125,156,44,47,17,7,297,175,122,46,30,31,6,0
59568,258,126,132,38,22,29,8,1700,731,969,198,233,110,87,0
59569,243,114,129,37,30,32,8,392,214,178,48,40,53,22,0
59570,320,183,137,51,18,38,8,452,231,221,74,53,56,20,0
59571,520,240,280,87,63,67,16,1378,692,686,194,174,105,56,0
59572,161,75,86,24,20,10,7,261,127,134,36,27,36,4,0
59573,2649,1431,1218,377,299,266,102,538,274,264,84,67,52,35,0
59574,290,156,134,44,29,39,9,399,190,209,61,41,39,18,0
59575,437,225,212,61,57,66,12,632,360,272,75,65,36,19,0
59576,211,92,119,33,44,11,7,386,207,179,43,48,44,19,0
59577,1531,649,882,108,122,93,72,292,155,137,50,34,29,13,0
59578,589,282,307,68,67,70,23,180,95,85,22,21,17,8,0
59579,1249,543,706,187,164,125,52,723,363,360,107,106,52,14,0
59580,717,281,436,165,81,112,49,701,380,321,94,84,96,34,0
59581,364,204,160,65,35,15,13,242,121,121,39,30,29,10,0
59582,795,384,411,133,109,85,38,246,125,121,38,36,30,11,0
59583,285,148,137,31,42,42,16,265,134,131,48,34,33,15,0
59584,605,277,328,99,54,63,43,337,170,167,59,33,47,17,0
59585,282,135,147,27,37,30,19,180,89,91,28,27,18,7,0
59586,1186,495,691,182,208,88,32,323,171,152,48,41,40,16,0
59587,604,239,365,124,63,84,37,417,232,185,58,50,29,21,0
59588,484,261,223,59,48,49,24,207,113,94,33,18,30,9,0
59589,1755,849,906,245,226,148,56,329,194,135,45,32,33,9,0
59590,483,236,247,82,60,43,18,483,258,225,70,53,54,20,0
59591,125,46,79,24,16,12,2,309,159,150,47,43,43,13,0
59592,443,206,237,76,68,52,28,373,213,160,44,33,26,17,0
59593,802,430,372,65,102,87,23,261,148,113,31,28,14,10,0
59594,329,165,164,61,44,29,17,418,246,172,52,39,57,10,0
59595,291,142,149,50,29,35,7,376,183,193,50,50,43,21,0
59596,470,163,307,99,68,73,30,654,295,359,99,88,71,25,0
59597,505,282,223,60,57,66,23,323,168,155,51,41,38,12,0
59598,339,170,169,32,17,24,13,339,175,164,51,49,37,9,0
59599,346,174,172,36,43,21,9,926,340,586,133,119,60,40,0
59600,350,190,160,48,25,27,18,72,32,40,8,2,1,14,0
59601,496,210,286,112,55,71,14,156,90,66,17,22,11,10,0
59602,403,176,227,71,56,51,11,445,202,243,70,73,51,15,0
59603,781,316,465,130,129,65,23,119,61,58,17,12,10,6,0
59604,179,96,83,24,8,26,4,1698,875,823,222,219,173,64,0
59605,184,88,96,15,40,17,8,662,312,350,103,104,59,20,0
59606,270,128,142,36,43,15,11,515,276,239,62,59,43,31,0
59607,119,59,60,29,10,6,4,715,348,367,109,84,68,30,0
59608,127,48,79,27,20,6,5,1114,539,575,145,131,94,56,0
59609,339,170,169,32,17,24,13,508,261,247,65,53,58,23,0
59610,288,140,148,59,33,27,12,395,169,226,73,55,38,9,0
59611,225,111,114,38,22,25,10,439,227,212,60,55,58,8,0
59612,301,119,182,53,47,14,20,507,270,237,89,59,57,22,0
59613,358,212,146,51,36,33,9,292,155,137,50,34,29,13,0
59614,618,289,329,97,86,70,17,198,110,88,27,27,24,4,0
59615,346,174,172,36,43,21,9,758,319,439,101,123,78,25,0
59616,302,160,142,35,35,37,10,103,44,59,16,17,9,5,0
59617,502,229,273,63,66,40,31,246,107,139,55,33,27,11,0
59618,164,81,83,37,8,14,10,715,348,367,109,84,68,30,0
59619,2488,1085,1403,346,253,162,76,459,260,199,56,42,47,21,0
59620,414,195,219,51,60,40,17,1004,457,547,150,150,74,52,0
59621,126,66,60,24,10,7,9,1606,753,853,215,227,182,48,0
59622,452,217,235,59,47,60,20,783,406,377,102,91,57,29,0
59623,1041,497,544,180,167,98,34,137,63,74,20,22,14,6,0
59624,498,274,224,58,59,50,18,325,159,166,59,46,30,12,0
59625,221,114,107,65,7,2,1,103,44,59,16,17,9,5,0
59626,785,374,411,56,42,38,25,514,248,266,86,82,52,22,0
59627,224,101,123,45,32,21,3,749,384,365,108,105,86,31,0
59628,447,225,222,76,35,75,21,1001,417,584,186,147,96,47,0
59629,179,78,101,29,22,10,8,671,321,350,95,87,75,34,0
59630,1341,481,860,275,264,57,21,601,279,322,81,65,27,12,0
59631,242,104,138,41,33,37,8,232,111,121,23,29,17,9,0
59632,246,111,135,64,47,27,3,1101,626,475,145,122,120,50,0
59633,126,56,70,31,10,10,3,978,536,442,132,107,67,32,0
59634,435,187,248,62,51,51,21,1338,720,618,179,145,141,85,0
59635,543,221,322,78,122,37,12,437,225,212,61,57,66,12,0
59636,747,469,278,60,41,53,23,392,155,237,68,61,34,16,0
59637,502,229,273,63,66,40,31,338,169,169,53,44,39,21,0
59638,512,254,258,70,48,37,32,376,183,193,50,50,43,21,0
59639,949,466,483,125,126,101,50,103,44,59,16,17,9,5,0
59640,700,305,395,111,99,54,18,459,260,199,56,42,47,21,0
59641,837,381,456,123,109,65,25,337,170,167,59,33,47,17,0
59642,560,279,281,113,64,58,15,445,202,243,70,73,51,15,0
59643,196,107,89,20,31,17,4,222,125,97,34,27,27,7,0
59644,473,212,261,72,64,45,28,175,91,84,19,21,21,10,0
59645,919,493,426,100,92,88,49,89,37,52,13,6,2,9,0
59646,99,35,64,25,18,0,1,292,155,137,50,34,29,13,0
59647,972,501,471,125,156,106,39,644,343,301,96,69,59,28,0
59648,446,283,163,51,26,33,19,693,360,333,100,88,62,26,0
59649,411,211,200,61,46,35,18,135,57,78,21,20,9,11,0
59650,563,255,308,91,111,42,30,535,311,224,66,52,49,24,0
59651,682,292,390,89,69,58,20,1696,771,925,257,225,149,63,0
59652,305,124,181,27,25,32,21,524,300,223,70,54,51,25,0
59653,368,154,214,80,52,41,16,966,478,488,108,144,74,43,0
59654,340,181,159,44,39,35,21,149,77,72,37,10,20,5,0
59655,458,210,248,39,38,25,16,520,244,276,91,60,68,20,0
59656,389,176,213,81,59,24,7,395,169,226,73,55,38,9,0
59657,301,150,151,45,47,33,13,137,78,59,22,16,17,4,0
59658,911,441,470,123,108,60,21,396,213,183,68,44,47,18,0
59659,756,265,491,129,127,51,17,858,461,397,125,114,79,45,0
59660,2414,1189,1225,277,178,170,169,247,128,119,34,14,16,14,0
59661,484,192,292,118,68,83,22,392,186,206,62,56,29,15,0
59662,473,217,256,59,44,34,21,244,143,101,31,29,26,8,0
59663,411,211,200,61,46,35,18,73,35,38,14,10,9,4,0
59664,1759,838,921,269,212,191,92,758,319,439,101,123,78,25,0
59665,730,298,432,128,69,86,26,1378,692,686,194,174,105,56,0
59666,361,171,190,44,40,18,13,405,214,191,53,42,49,20,0
59667,279,129,150,43,34,17,13,904,436,468,143,118,108,32,0
59668,271,136,135,37,30,18,10,225,129,96,32,33,20,8,0
59669,520,231,289,89,59,58,26,132,61,71,22,21,15,3,0
59670,219,100,119,40,29,21,3,227,130,97,32,25,22,12,0
59671,431,202,229,57,50,50,25,144,67,77,28,14,9,8,0
59672,339,170,169,32,17,24,13,708,328,380,113,100,82,34,0
59673,226,120,106,68,8,2,1,423,234,189,66,44,57,12,0
59674,411,236,175,39,45,50,30,283,160,123,25,20,37,9,0
59675,395,219,176,47,41,50,18,270,130,140,48,44,37,12,0
59676,342,150,192,52,43,31,17,274,142,132,33,34,18,14,0
59677,3969,1703,2266,619,432,259,144,1537,701,836,209,187,129,58,0
59678,82,36,46,17,10,5,1,761,351,410,117,73,103,45,0
59679,199,107,92,41,15,14,8,190,93,97,35,27,23,2,0
59680,1041,497,544,180,167,98,34,509,267,242,79,81,38,20,0
59681,126,57,69,31,10,10,3,175,91,84,19,21,21,10,0
59682,1054,453,601,183,183,107,35,91,44,47,9,12,4,7,0
59683,432,190,242,85,82,28,11,429,187,242,79,72,28,19,0
59684,1107,601,506,155,138,103,49,704,355,349,113,94,71,24,0
59685,130,72,58,28,9,7,1,547,295,252,81,65,57,23,0
59686,784,353,431,56,47,26,18,266,150,116,28,28,24,12,0
59687,308,163,145,38,33,30,20,307,132,175,48,53,26,10,0
59688,1220,575,645,208,179,99,56,556,290,266,75,74,29,24,0
59689,1143,574,569,176,151,123,59,418,246,172,52,39,57,10,0
59690,257,148,109,28,20,21,14,621,310,311,100,106,77,27,0
59691,279,127,152,50,36,28,8,107,77,30,7,2,9,5,0
59692,519,245,274,58,61,34,22,323,171,152,48,41,40,16,0
59693,604,239,365,124,63,84,37,689,343,346,105,102,81,35,0
59694,291,120,171,63,39,26,6,902,499,403,118,117,92,35,0
59695,514,226,288,71,66,63,32,487,252,235,79,58,55,26,0
59696,1058,497,561,194,142,87,63,125,66,59,24,16,11,5,0
59697,331,165,166,52,34,48,22,72,33,39,8,2,3,12,0
59698,261,137,124,34,23,13,8,536,267,269,60,70,41,22,0
59699,521,249,272,53,36,50,18,519,287,232,68,58,45,21,0
59700,219,116,103,66,7,2,1,194,109,85,23,24,21,9,0
59701,1009,487,522,177,121,103,51,156,90,66,17,22,11,10,0
59702,236,120,116,32,28,21,11,149,52,97,36,36,7,4,0
59703,412,146,266,106,38,67,35,583,280,303,95,66,76,25,0
59704,505,247,258,72,71,60,27,2202,1121,1081,338,274,269,81,0
59705,1616,735,881,285,248,153,72,395,198,197,55,55,36,10,0
59706,449,179,270,80,77,49,29,439,231,208,65,51,55,17,0
59707,563,255,308,91,111,42,30,422,237,185,53,47,62,20,0
59708,502,236,266,66,66,58,17,975,400,575,160,162,62,31,0
59709,429,227,202,49,51,46,26,132,77,55,20,9,13,10,0
59710,269,156,113,37,32,17,7,485,244,241,80,55,59,20,0
59711,622,354,268,89,60,64,18,2225,1244,981,271,243,217,93,0
59712,502,229,273,63,66,40,31,947,482,465,143,107,89,37,0
59713,784,351,433,118,87,73,41,106,41,65,36,6,11,7,0
59714,256,152,104,18,23,23,8,316,166,150,45,38,37,13,0
59715,297,182,115,41,22,23,8,194,109,85,23,24,21,9,0
59716,1174,594,580,175,155,126,66,665,361,304,87,91,84,31,0
59717,512,254,258,70,48,37,32,405,214,191,53,42,49,20,0
59718,314,158,156,39,28,30,17,103,50,53,19,10,7,5,0
59719,624,222,402,92,81,39,15,354,183,171,54,43,49,8,0
59720,886,440,446,116,140,95,45,169,85,84,21,14,9,9,0
59721,359,167,192,49,37,27,19,374,174,200,54,52,42,21,0
59722,142,76,66,21,21,22,11,136,65,71,26,11,7,5,0
59723,438,185,253,71,64,52,28,385,188,197,57,42,36,16,0
59724,125,46,79,24,16,12,2,600,254,346,104,100,44,17,0
59725,745,402,343,95,71,69,40,862,426,436,113,115,84,37,0
59726,730,298,432,128,69,86,26,260,133,127,43,32,39,3,0
59727,349,153,196,54,47,28,13,679,338,341,96,95,40,23,0
59728,203,97,106,30,22,18,10,398,200,198,68,43,51,14,0
59729,598,300,298,68,77,59,21,205,94,111,48,31,15,6,0
59730,1052,492,560,184,163,103,44,325,172,153,44,34,27,14,0
59731,127,55,72,25,18,5,7,479,215,264,67,80,46,28,0
59732,315,111,204,82,66,46,11,1020,538,482,145,115,111,58,0
59733,979,534,445,83,77,80,24,386,181,205,55,51,57,31,0
59734,485,246,239,74,48,47,22,222,127,95,23,28,22,7,0
59735,1068,434,634,173,160,61,29,228,130,98,35,29,30,10,0
59736,532,254,278,91,48,23,17,308,146,162,42,39,24,12,0
59737,434,216,218,72,58,40,20,1543,794,749,182,152,132,55,0
59738,580,281,299,95,60,74,29,370,190,180,60,52,37,13,0
59739,1007,353,654,277,147,70,26,137,78,59,22,16,17,4,0
59740,305,124,181,27,25,32,21,663,360,303,87,82,80,35,0
59741,454,214,240,56,71,35,16,188,90,98,44,7,21,7,0
59742,728,358,370,118,100,55,29,138,69,69,28,7,10,10,0
59743,67,40,27,10,8,7,6,148,69,79,26,18,16,3,0
59744,772,417,355,118,92,80,23,316,166,150,45,38,37,13,0
59745,136,66,70,33,11,9,3,640,364,276,84,68,69,33,0
59746,440,267,173,52,29,42,12,350,196,154,52,37,21,14,0
59747,648,376,272,70,60,73,24,149,77,72,37,10,20,5,0
59748,404,197,207,60,48,47,20,1378,692,686,194,174,105,56,0
59749,493,208,285,75,77,70,40,270,130,140,48,44,37,12,0
59750,232,134,98,28,20,20,5,602,310,292,87,66,70,36,0
59751,373,194,179,42,54,26,13,541,279,262,79,82,31,32,0
59752,362,181,181,67,46,43,8,605,283,322,94,72,64,39,0
59753,484,264,220,59,62,68,15,496,285,211,62,54,46,22,0
59754,107,56,51,18,16,12,5,230,125,105,29,40,20,6,0
59755,270,158,112,35,20,23,7,406,202,204,54,51,63,21,0
59756,341,154,187,34,36,11,11,480,255,225,67,64,50,22,0
59757,388,209,179,46,24,31,28,374,174,200,54,52,42,21,0
59758,428,226,202,52,60,75,20,396,197,199,75,49,49,16,0
59759,707,250,457,171,84,117,61,1248,584,664,184,164,155,67,0
59760,470,163,307,99,68,73,30,290,142,148,41,37,43,11,0
59761,929,410,519,187,146,53,30,204,80,124,29,51,10,5,0
59762,3969,1703,2266,619,432,259,144,418,223,195,53,43,49,15,0
59763,395,189,206,63,50,49,28,862,409,453,149,125,86,29,0
59764,1544,738,806,239,217,145,91,467,231,236,71,65,58,18,0
59765,381,146,235,74,48,47,34,508,253,255,73,60,50,13,0
59766,357,182,175,49,36,39,15,88,50,38,13,8,16,4,0
59767,753,361,392,99,94,66,16,446,174,272,84,61,57,23,0
59768,524,270,254,84,72,70,23,690,345,345,96,83,73,42,0
59769,346,209,137,46,37,44,10,72,34,38,8,2,3,12,0
59770,332,170,162,44,38,39,10,200,89,111,26,25,17,7,0
59771,729,351,378,111,98,58,18,308,146,162,42,39,24,12,0
59772,346,173,173,50,56,31,14,547,295,252,81,65,57,23,0
59773,395,195,200,41,55,23,10,582,264,318,84,60,58,23,0
59774,240,98,142,49,42,23,17,480,255,225,67,64,50,22,0
59775,230,114,116,30,33,29,8,137,72,65,27,13,15,8,0
59776,728,358,370,118,100,55,29,105,51,54,13,17,12,8,0
59777,2279,996,1283,375,328,158,60,660,332,328,84,73,47,19,0
59778,107,36,71,27,15,0,1,241,127,114,34,33,29,12,0
59779,413,206,207,38,55,19,10,346,196,150,43,26,27,14,0
59780,207,93,114,20,33,19,10,230,113,117,31,40,28,10,0
59781,272,94,178,76,33,19,4,1606,753,853,215,227,182,48,0
59782,1531,649,882,108,122,93,72,462,251,211,74,53,41,18,0
59783,280,128,152,39,37,38,18,504,272,232,75,57,53,19,0
59784,200,94,106,33,22,18,8,178,69,109,29,25,21,13,0
59785,808,366,442,130,133,66,31,348,194,154,57,31,43,12,0
59786,291,120,171,63,39,26,6,330,166,164,55,51,36,16,0
59787,413,236,177,41,25,35,19,138,69,69,28,7,10,10,0
59788,475,208,267,84,67,50,20,402,186,216,64,47,38,20,0
59789,219,116,103,66,7,2,1,780,337,443,112,116,77,28,0
59790,941,459,482,167,140,82,38,671,306,365,114,76,49,19,0
59791,418,163,255,57,54,38,24,1230,644,586,198,125,123,61,0
59792,755,271,484,113,226,61,20,188,105,83,25,17,24,7,0
59793,136,66,70,33,11,9,4,437,221,216,62,64,47,13,0
59794,486,243,243,65,48,63,22,277,124,153,44,40,35,18,0
59795,407,230,177,44,39,34,19,504,272,232,75,57,53,19,0
59796,473,217,256,59,44,34,21,231,126,105,28,26,34,9,0
59797,605,277,328,99,54,63,43,508,262,246,66,67,51,20,0
59798,1395,595,800,223,206,113,61,665,361,304,87,91,84,31,0
59799,267,146,121,40,24,25,7,775,407,368,122,100,97,32,0
59800,157,62,95,41,18,10,11,101,59,42,11,17,10,1,0
59801,1560,778,782,224,235,132,78,434,213,221,77,62,53,12,0
59802,332,172,160,50,33,35,9,296,140,156,49,40,42,19,0
59803,295,143,152,38,47,22,25,711,330,381,111,86,86,34,0
59804,161,75,86,24,20,10,7,198,110,88,27,27,24,4,0
59805,426,214,212,63,47,53,20,103,50,53,19,10,7,5,0
59806,359,167,192,49,37,27,19,811,361,450,124,107,80,31,0
59807,135,64,71,31,11,8,4,368,200,168,54,49,43,9,0
59808,567,266,301,139,46,76,37,72,32,40,8,2,1,14,0
59809,276,149,127,45,34,39,9,257,139,118,64,17,24,7,0
59810,325,152,173,43,47,28,17,225,114,111,32,29,26,6,0
59811,317,153,164,34,52,30,14,340,169,171,40,39,36,22,0
59812,288,104,184,80,30,39,6,160,60,100,23,40,19,11,0
59813,469,253,216,49,51,48,18,173,90,83,21,36,12,15,0
59814,1249,543,706,187,164,125,52,332,173,159,48,40,31,11,0
59815,1011,559,452,121,97,132,33,106,46,60,29,13,14,5,0
59816,535,315,220,57,55,71,19,153,65,88,28,21,20,8,0
59817,457,228,229,64,36,52,21,419,233,186,54,53,55,17,0
59818,1023,449,574,141,174,76,43,536,267,269,60,70,41,22,0
59819,463,250,213,56,45,73,25,104,46,58,15,17,9,5,0
59820,502,236,266,66,66,58,17,91,44,47,9,12,4,7,0
59821,332,173,159,48,42,42,9,145,77,68,26,7,15,8,0
59822,531,284,247,66,42,49,15,354,183,171,54,43,49,8,0
59823,763,354,409,101,90,63,26,535,311,224,66,52,49,24,0
59824,371,209,162,46,17,36,19,390,190,200,66,50,43,12,0
59825,411,202,209,60,67,57,24,405,195,210,57,74,24,17,0
59826,2286,1154,1132,338,314,278,103,1382,508,874,334,320,98,36,0
59827,55,16,39,24,2,5,2,223,113,110,31,33,22,12,0
59828,135,64,71,31,11,8,4,671,321,350,95,87,75,34,0
59829,275,160,115,40,31,34,17,508,253,255,73,60,50,13,0
59830,500,257,243,60,55,27,22,227,130,97,32,25,22,12,0
59831,349,153,196,54,47,28,13,296,151,145,45,42,32,11,0
59832,653,379,274,89,56,86,13,283,142,141,41,33,26,18,0
59833,532,254,278,91,48,23,17,1323,690,633,132,178,112,61,0
59834,1360,644,716,213,194,136,62,582,264,318,84,60,58,23,0
59835,860,349,511,166,166,58,19,336,200,136,34,29,25,24,0
59836,200,94,106,33,22,18,8,292,155,137,50,34,29,13,0
59837,520,261,259,74,52,49,22,467,240,227,65,65,51,23,0
59838,226,120,106,68,8,2,1,459,260,199,56,42,47,21,0
59839,726,312,414,121,73,82,23,517,295,222,69,62,40,28,0
59840,231,105,126,56,10,24,10,531,277,254,82,75,33,22,0
59841,350,178,172,49,62,29,16,188,101,87,20,18,20,14,0
59842,280,128,152,39,37,38,18,403,192,211,102,39,49,15,0
59843,667,366,301,96,55,84,25,439,231,208,65,51,55,17,0
59844,299,128,171,57,40,13,25,501,249,252,77,70,55,22,0
59845,862,384,478,127,110,75,42,2724,1157,1567,269,518,239,77,0
59846,1441,504,937,264,329,69,46,137,72,65,27,13,15,8,0
59847,1555,702,853,250,199,139,31,1065,581,484,134,97,76,46,0
59848,1121,458,663,158,210,76,47,188,88,100,53,12,15,6,0
59849,270,130,140,43,24,36,10,222,124,98,37,29,22,9,0
59850,758,378,380,89,64,37,31,103,50,53,19,10,7,5,0
59851,269,127,142,43,24,34,26,250,116,134,41,30,33,19,0
59852,256,152,104,18,23,23,8,508,253,255,73,60,50,13,0
59853,395,195,200,41,55,23,10,293,142,151,49,40,42,17,0
59854,700,305,395,111,99,54,18,375,211,164,50,36,31,23,0
59855,235,100,135,36,25,30,8,337,152,185,49,54,42,21,0
59856,361,177,184,59,51,24,15,496,251,245,78,62,61,23,0
59857,585,277,308,92,73,61,32,276,149,127,34,31,32,10,0
59858,502,274,228,64,49,75,17,190,93,97,35,27,23,2,0
59859,472,222,250,46,61,33,23,96,46,50,16,12,7,5,0
59860,308,129,179,44,60,19,8,649,307,342,71,134,45,17,0
59861,595,339,256,64,36,54,24,926,425,501,159,147,77,35,0
59862,178,74,104,31,28,9,4,328,199,129,39,29,27,14,0
59863,150,60,90,27,16,6,3,303,137,166,54,54,31,15,0
59864,255,110,145,34,32,23,17,430,212,218,88,43,40,20,0
59865,323,156,167,52,45,39,18,397,234,163,44,38,23,21,0
59866,347,198,149,45,29,29,8,331,180,151,46,35,47,17,0
59867,508,251,257,74,53,51,18,274,142,132,33,34,18,14,0
59868,514,226,288,71,66,63,32,102,51,51,12,15,12,3,0
59869,253,133,120,44,31,22,8,286,152,134,38,38,32,11,0
59870,1043,479,564,200,131,123,62,89,38,51,14,6,3,9,0
59871,570,238,332,112,95,39,23,334,181,153,56,31,28,18,0
59872,674,268,406,118,96,70,21,178,69,109,29,25,21,13,0
59873,728,358,370,118,100,55,29,169,84,85,29,19,21,7,0
59874,395,189,206,63,50,49,28,592,249,343,91,90,50,42,0
59875,2414,1189,1225,277,178,170,169,107,77,30,7,2,9,5,0
59876,121,69,52,15,18,14,8,385,212,173,57,40,39,21,0
59877,251,131,120,49,35,25,5,165,87,78,24,19,22,9,0
59878,429,238,191,47,49,56,29,405,181,224,71,57,31,12,0
59879,836,370,466,126,96,72,30,127,66,61,13,14,19,8,0
59880,736,353,383,117,83,71,18,329,196,133,41,36,31,15,0
59881,102,22,80,48,8,18,6,305,161,144,39,40,44,17,0
59882,291,120,171,63,39,26,6,1004,457,547,150,150,74,52,0
59883,275,160,115,40,31,34,17,584,249,335,80,96,22,13,0
59884,758,378,380,89,64,37,31,452,252,200,55,49,61,16,0
59885,341,183,158,36,34,36,15,386,207,179,43,48,44,19,0
59886,126,57,69,31,10,10,3,172,79,93,34,27,23,10,0
59887,437,212,225,66,44,44,11,297,164,133,45,39,40,9,0
59888,288,142,146,52,32,26,8,127,66,61,13,14,19,8,0
59889,570,238,332,112,95,39,23,708,328,380,113,100,82,34,0
59890,241,122,119,27,34,17,16,336,200,136,34,29,25,24,0
59891,426,228,198,62,42,47,22,242,104,138,41,33,37,8,0
59892,339,118,221,77,68,33,13,326,169,157,51,41,41,12,0
59893,486,243,243,65,48,63,22,1507,737,770,188,228,147,71,0
59894,640,271,369,111,79,57,17,953,489,464,126,104,111,44,0
59895,346,191,155,52,38,40,13,314,151,163,42,61,39,16,0
59896,164,77,87,33,19,6,7,462,251,211,74,53,41,18,0
59897,489,253,236,73,36,62,17,267,141,126,53,27,23,7,0
59898,743,377,366,87,74,68,30,305,161,144,39,40,44,17,0
59899,1085,646,439,108,65,36,19,337,170,167,59,33,47,17,0
59900,432,233,199,52,28,47,18,453,255,198,62,49,29,19,0
59901,443,250,193,52,23,49,13,508,262,246,66,67,51,20,0
59902,496,210,286,112,55,71,14,68,36,32,11,8,9,2,0
59903,468,233,235,65,61,49,34,144,67,77,28,14,9,8,0
59904,525,254,271,60,76,46,13,547,295,252,81,65,57,23,0
59905,204,103,101,16,32,22,8,301,168,133,49,37,34,11,0
59906,465,240,225,50,54,24,14,89,37,52,13,6,2,9,0
59907,575,305,270,74,87,73,25,2542,1245,1297,285,287,170,84,0
59908,813,412,401,114,93,112,26,821,394,427,122,117,109,38,0
59909,444,250,194,58,21,60,23,975,475,500,139,140,119,28,0
59910,126,57,69,31,10,10,3,475,251,224,67,49,48,23,0
59911,283,172,111,39,31,29,8,54,26,28,11,4,3,3,0
59912,358,206,152,45,38,67,16,307,132,175,48,53,26,10,0
59913,412,208,204,54,47,42,17,455,191,264,68,86,21,19,0
59914,136,65,71,33,11,9,6,583,321,262,73,67,45,25,0
59915,631,304,327,98,75,52,23,286,152,134,38,38,32,11,0
59916,219,100,119,40,29,21,3,288,156,132,36,36,24,15,0
59917,445,231,214,45,64,53,23,487,252,235,79,58,55,26,0
59918,236,141,95,36,32,14,6,370,173,197,65,57,42,10,0
59919,297,182,115,41,22,23,8,222,125,97,34,27,27,7,0
59920,494,242,252,67,47,25,21,605,283,322,94,72,64,39,0
59921,253,133,120,44,31,22,8,303,138,165,47,46,35,18,0
59922,1214,498,716,197,180,121,65,723,353,370,120,109,96,33,0
59923,492,253,239,73,67,77,29,283,160,123,25,20,37,9,0
59924,1200,602,598,145,116,110,50,424,179,245,65,67,29,11,0
59925,412,146,266,106,38,67,35,461,223,238,45,62,18,35,0
59926,186,56,130,46,50,16,7,127,66,61,13,14,19,8,0
59927,535,315,220,57,55,71,19,188,101,87,20,18,20,14,0
59928,2696,1169,1527,432,347,193,146,201,93,108,34,39,21,6,0
59929,341,195,146,42,21,36,9,928,440,488,111,157,82,35,0
59930,434,216,218,72,58,40,20,1323,690,633,132,178,112,61,0
59931,315,174,141,46,38,47,16,594,312,282,72,67,73,31,0
59932,559,217,342,105,86,42,16,1034,495,539,150,134,114,71,0
59933,449,179,270,80,77,49,29,663,354,309,91,84,79,31,0
59934,326,180,146,62,26,41,13,305,164,141,43,23,47,18,0
59935,325,186,139,49,36,20,5,375,176,199,48,61,40,12,0
59936,1121,458,663,158,210,76,47,467,240,227,65,65,51,23,0
59937,575,290,285,67,70,28,9,501,249,252,77,70,55,22,0
59938,493,208,285,75,77,70,40,699,334,365,108,80,70,20,0
59939,543,265,278,52,37,54,19,462,229,233,63,49,42,18,0
59940,350,178,172,49,62,29,16,478,254,224,67,74,56,28,0
59941,410,200,210,60,54,46,19,145,77,68,26,7,15,8,0
59942,494,242,252,67,47,25,21,427,251,176,51,39,25,22,0
59943,71,39,32,7,11,6,4,346,178,168,58,41,33,12,0
59944,700,305,395,111,99,54,18,326,169,157,51,41,41,12,0
59945,376,171,205,45,45,34,12,515,276,239,62,59,43,31,0
59946,466,199,267,86,59,32,17,403,233,170,38,29,21,14,0
59947,640,271,369,111,79,57,17,564,264,300,79,84,65,26,0
59948,434,221,213,58,47,54,15,205,94,111,48,31,15,6,0
59949,362,181,181,67,46,43,8,415,189,226,68,54,50,21,0
59950,728,358,370,118,100,55,29,374,212,162,48,40,32,23,0
59951,1214,498,716,197,180,121,65,73,35,38,14,10,9,4,0
59952,199,113,86,27,17,10,7,906,455,451,116,105,87,46,0
59953,543,221,322,78,122,37,12,769,329,440,116,66,55,22,0
59954,2000,965,1035,357,313,198,75,366,204,162,47,41,31,23,0
59955,330,141,189,65,29,51,19,88,50,38,13,8,16,4,0
59956,654,344,310,80,69,57,15,2542,1245,1297,285,287,170,84,0
59957,490,198,292,65,81,39,27,213,129,84,32,14,21,15,0
59958,364,204,160,65,35,15,13,329,196,133,41,36,31,15,0
59959,279,127,152,50,36,28,8,137,85,52,15,11,11,2,0
59960,306,172,134,35,31,37,18,377,184,193,50,43,33,17,0
59961,416,222,194,58,38,38,20,501,257,244,75,57,48,29,0
59962,738,358,380,106,99,62,25,657,326,331,80,81,53,31,0
59963,240,167,73,32,12,8,21,134,72,62,14,28,8,4,0
59964,351,166,185,48,61,24,15,450,241,209,67,58,54,23,0
59965,441,216,225,57,66,57,19,463,268,195,59,46,46,21,0
59966,246,111,135,64,47,27,3,289,140,149,33,42,30,15,0
59967,957,381,576,184,158,86,48,437,225,212,61,57,66,12,0
59968,238,158,80,28,15,31,7,352,207,145,40,33,25,21,0
59969,667,366,301,96,55,84,25,244,143,101,31,29,26,8,0
59970,489,253,236,73,36,62,17,316,159,157,38,48,30,11,0
59971,348,198,150,57,25,37,18,497,257,240,71,63,62,16,0
59972,756,362,394,102,104,73,25,132,67,65,24,21,8,10,0
59973,959,496,463,144,132,75,35,2346,1231,1115,316,292,266,105,0
59974,494,242,252,67,47,25,21,630,321,309,86,90,57,26,0
59975,130,72,58,28,9,7,1,524,300,223,70,54,51,25,0
59976,856,429,427,113,105,96,24,975,475,500,139,140,119,28,0
59977,594,248,346,104,109,53,5,598,333,265,79,66,54,33,0
59978,764,277,487,158,162,64,31,218,118,100,33,30,25,11,0
59979,756,362,394,102,104,73,25,260,131,129,42,31,40,9,0
59980,320,163,157,44,44,26,15,551,226,325,96,103,43,11,0
59981,86,50,36,9,14,8,7,175,82,93,33,26,17,5,0
59982,1417,598,819,223,188,135,58,166,78,88,27,25,19,7,0
59983,412,193,219,69,57,43,14,773,389,384,119,91,79,26,0
59984,412,203,209,65,47,37,18,1500,804,696,190,172,144,60,0
59985,525,254,271,60,76,46,13,810,310,500,164,162,42,26,0
59986,280,156,124,36,19,20,13,295,160,135,42,37,46,16,0
59987,284,128,156,48,29,34,8,588,286,302,78,99,53,25,0
59988,245,111,134,36,27,18,6,858,461,397,125,114,79,45,0
59989,260,120,140,34,39,36,12,1279,669,610,164,162,104,55,0
59990,252,121,131,42,34,12,16,398,200,198,68,43,51,14,0
59991,714,260,454,140,97,120,54,662,312,350,103,104,59,20,0
59992,323,171,152,36,36,47,15,373,183,190,49,37,33,18,0
59993,314,178,136,42,32,30,17,134,72,62,14,28,8,4,0
59994,179,78,101,29,22,10,8,89,51,38,15,15,5,4,0
59995,121,69,52,15,18,14,8,222,125,97,34,27,27,7,0
59996,1004,464,540,143,104,78,55,317,161,156,40,49,41,11,0
59997,102,22,80,48,8,18,6,314,177,137,34,40,29,9,0
59998,119,67,52,15,15,7,7,270,162,108,26,26,16,11,0
59999,326,176,150,35,22,29,11,328,199,129,39,29,27,14,0
60000,667,366,301,96,55,84,25,285,143,142,45,32,21,17,0
60001,318,164,154,52,43,34,10,354,188,166,46,40,34,10,0
60002,766,336,430,133,97,79,21,54,26,28,11,4,3,3,0
60003,1214,498,716,197,180,121,65,336,200,136,34,29,25,24,0
60004,1161,514,647,159,138,122,37,188,101,87,20,18,20,14,0
60005,204,109,95,21,35,27,7,422,237,185,53,47,62,20,0
60006,588,267,321,99,79,87,28,478,254,224,67,74,56,28,0
60007,1014,488,526,178,137,94,39,858,461,397,125,114,79,45,0
60008,781,367,414,60,67,43,17,73,35,38,14,10,9,4,0
60009,335,155,180,64,48,36,10,406,234,172,63,35,43,10,0
60010,186,56,130,46,50,16,7,457,253,204,67,51,48,13,0
60011,236,141,95,36,32,14,6,640,364,276,84,68,69,33,0
60012,193,105,88,33,16,9,4,1873,935,938,233,225,203,79,0
60013,582,328,254,78,48,35,9,194,94,100,33,28,14,7,0
60014,340,181,159,44,39,35,21,101,59,42,11,17,10,1,0
60015,1689,821,868,277,250,177,78,535,301,234,63,48,47,27,0
60016,119,67,52,15,15,7,7,479,215,264,67,80,46,28,0
60017,258,144,114,33,22,19,9,123,61,62,17,18,17,7,0
60018,350,178,172,49,62,29,16,320,168,152,38,42,24,18,0
60019,1199,589,610,189,128,167,65,858,461,397,125,114,79,45,0
60020,435,187,248,62,51,51,21,314,177,137,34,40,29,9,0
60021,502,250,252,70,47,57,15,325,172,153,44,34,27,14,0
60022,595,272,323,111,107,54,28,559,296,263,77,69,42,13,0
60023,692,305,387,100,97,78,30,551,226,325,96,103,43,11,0
60024,329,168,161,48,34,41,16,601,278,323,124,87,65,21,0
60025,410,211,199,55,42,34,27,106,46,60,27,18,12,3,0
60026,717,381,336,118,103,85,29,679,338,341,96,95,40,23,0
60027,186,56,130,46,50,16,7,453,247,206,58,53,45,20,0
60028,983,449,534,95,77,55,36,900,441,459,125,127,110,32,0
60029,255,136,119,39,20,32,10,1040,564,476,134,110,114,51,0
60030,279,127,152,50,36,28,8,229,120,109,31,30,22,9,0
60031,380,185,195,68,54,32,16,545,269,276,80,76,27,32,0
60032,556,306,250,69,60,80,18,240,141,99,34,28,29,8,0
60033,329,165,164,61,44,29,17,389,207,182,53,58,52,18,0
60034,800,416,384,102,105,83,22,166,88,78,23,18,13,7,0
60035,465,220,245,88,34,61,23,620,324,296,81,68,66,31,0
60036,432,233,199,52,28,47,18,166,102,64,19,14,17,2,0
60037,319,153,166,61,52,26,12,689,343,346,105,102,81,35,0
60038,339,118,221,77,68,33,13,163,79,84,22,24,13,5,0
60039,411,236,175,39,45,50,30,228,130,98,35,29,30,10,0
60040,373,194,179,42,54,26,13,903,436,467,128,116,83,33,0
60041,577,251,326,92,84,60,11,898,469,429,125,125,134,35,0
60042,782,372,410,127,111,89,36,218,117,101,35,32,34,12,0
60043,372,189,183,60,44,41,18,619,305,314,85,93,71,29,0
60044,1417,598,819,223,188,135,58,665,361,304,87,91,84,31,0
60045,422,196,226,52,35,33,20,1248,584,664,184,164,155,67,0
60046,505,226,279,68,51,30,15,325,159,166,59,46,30,12,0
60047,626,308,318,105,89,77,25,218,118,100,33,30,25,11,0
60048,246,111,135,64,47,27,3,1507,737,770,188,228,147,71,0
60049,1009,478,531,166,126,96,42,926,340,586,133,119,60,40,0
60050,332,170,162,44,38,39,10,463,268,195,59,46,46,21,0
60051,837,381,456,123,109,65,25,359,171,188,49,74,45,11,0
60052,616,304,312,75,71,55,25,732,366,366,108,86,74,41,0
60053,411,202,209,60,67,57,24,305,161,144,39,40,44,17,0
60054,525,254,271,60,76,46,13,128,63,65,30,11,13,8,0
60055,658,349,309,77,70,73,35,180,89,91,28,27,18,7,0
60056,567,266,301,139,46,76,37,188,93,95,33,18,16,10,0
60057,270,166,104,30,26,28,14,279,161,118,37,32,7,7,0
60058,410,188,222,53,52,31,14,308,146,162,42,39,24,12,0
60059,346,173,173,50,56,31,14,873,411,462,132,107,84,40,0
60060,276,149,127,45,34,39,9,673,313,360,102,101,46,17,0
60061,1284,511,773,227,166,169,107,627,323,304,81,90,53,27,0
60062,213,88,125,21,54,14,15,368,183,185,40,42,40,15,0
60063,1835,904,931,192,144,135,63,439,231,208,65,51,55,17,0
60064,685,393,292,75,66,113,16,732,402,330,81,86,87,33,0
60065,2000,965,1035,357,313,198,75,1114,539,575,145,131,94,56,0
60066,302,178,124,34,29,50,13,1873,935,938,233,225,203,79,0
60067,130,72,58,28,9,7,1,898,469,429,125,125,134,35,0
60068,1189,653,536,152,118,109,56,297,164,133,45,39,40,9,0
60069,118,51,67,25,13,6,7,873,411,462,132,107,84,40,0
60070,291,142,149,50,29,35,7,572,305,267,74,72,58,21,0
60071,281,154,127,45,31,24,9,441,189,252,73,50,47,23,0
60072,479,227,252,69,48,46,18,200,89,111,26,25,17,7,0
60073,326,154,172,45,39,20,10,724,353,371,94,95,71,31,0
60074,472,222,250,46,61,33,23,966,478,488,108,144,74,43,0
60075,157,62,95,41,18,10,11,520,272,248,60,65,58,22,0
60076,150,60,90,27,16,6,3,518,292,226,60,60,52,21,0
60077,1064,495,569,157,159,124,58,485,244,241,80,55,59,20,0
60078,139,64,75,18,17,18,4,406,202,204,54,51,63,21,0
60079,468,233,235,65,61,49,34,257,126,131,61,24,22,8,0
60080,435,230,205,51,37,55,18,277,145,132,41,32,22,10,0
60081,224,101,123,45,32,21,3,821,394,427,122,117,109,38,0
60082,375,167,208,55,83,44,9,481,223,258,71,70,49,26,0
60083,275,125,150,37,48,27,7,547,295,252,81,65,57,23,0
60084,457,261,196,55,27,57,34,198,115,83,30,22,8,8,0
60085,502,236,266,66,66,58,17,704,355,349,113,94,71,24,0
60086,629,374,255,74,53,87,27,662,312,350,103,104,59,20,0
60087,1339,494,845,216,298,92,37,664,350,314,86,90,82,36,0
60088,435,222,213,67,49,67,12,531,261,270,73,80,68,26,0
60089,55,16,39,24,2,5,2,432,244,188,51,51,27,14,0
60090,395,219,176,47,41,50,18,244,143,101,31,29,26,8,0
60091,594,321,273,98,59,57,23,376,183,193,50,50,43,21,0
60092,769,329,440,116,66,55,22,873,366,507,127,125,75,21,0
60093,346,191,155,52,38,40,13,1241,619,622,183,169,155,59,0
60094,3230,1724,1506,361,358,157,75,180,95,85,22,21,17,8,0
60095,1560,778,782,224,235,132,78,1696,771,925,257,225,149,63,0
60096,249,114,135,47,33,25,4,405,214,191,53,42,49,20,0
60097,571,298,273,81,72,57,25,222,124,98,37,29,22,9,0
60098,249,114,135,47,33,25,4,213,129,84,32,14,21,15,0
60099,1390,705,685,219,164,129,74,180,108,72,22,22,15,5,0
60100,2799,1324,1475,369,371,215,124,545,269,276,80,76,27,32,0
60101,300,136,164,45,35,45,14,1062,522,540,151,147,105,66,0
60102,1052,492,560,184,163,103,44,136,65,71,26,11,7,5,0
60103,390,199,191,72,42,35,12,334,181,153,56,31,28,18,0
60104,728,358,370,118,100,55,29,153,65,88,28,21,20,8,0
60105,441,216,225,57,66,57,19,260,133,127,43,32,39,3,0
60106,747,469,278,60,41,53,23,334,181,153,56,31,28,18,0
60107,535,217,318,87,106,41,14,689,343,346,105,102,81,35,0
60108,432,233,199,52,28,47,18,862,409,453,149,125,86,29,0
60109,437,230,207,41,55,27,13,282,134,148,38,45,29,10,0
60110,593,282,311,75,70,29,25,198,115,83,30,22,8,8,0
60111,860,348,512,121,136,75,35,165,87,78,24,19,22,9,0
60112,629,338,291,92,57,64,22,978,536,442,132,107,67,32,0
60113,941,459,482,167,140,82,38,620,324,296,81,68,66,31,0
60114,526,268,258,54,37,55,12,154,78,76,23,21,13,5,0
60115,234,108,126,42,40,15,9,469,225,244,64,68,25,11,0
60116,325,186,139,49,36,20,5,405,181,224,71,57,31,12,0
60117,414,195,219,51,60,40,17,198,110,88,27,27,24,4,0
60118,126,57,69,31,10,10,3,748,359,389,125,113,86,31,0
60119,243,70,173,54,65,8,6,492,278,214,65,58,32,11,0
60120,170,82,88,32,23,22,8,404,190,214,55,55,35,27,0
60121,476,199,277,82,80,49,24,89,38,51,14,6,3,9,0
60122,450,227,223,53,36,48,12,462,251,211,74,53,41,18,0
60123,286,111,175,51,47,21,12,289,140,149,33,42,30,15,0
60124,342,150,192,52,43,31,17,600,254,346,104,100,44,17,0
60125,451,225,226,69,57,64,22,455,191,264,68,86,21,19,0
60126,570,238,332,112,95,39,23,103,59,44,25,2,13,6,0
60127,553,319,234,56,37,54,18,104,46,58,15,17,9,5,0
60128,758,378,380,89,64,37,31,384,204,180,53,47,49,17,0
60129,854,435,419,118,91,95,42,305,163,142,38,27,47,11,0
60130,685,393,292,75,66,113,16,425,177,248,60,62,33,16,0
60131,258,144,114,33,22,19,9,392,155,237,68,61,34,16,0
60132,136,65,71,33,11,9,6,467,240,227,65,65,51,23,0
60133,873,366,507,127,125,75,21,106,41,65,36,6,11,7,0
60134,288,104,184,80,30,39,6,260,133,127,43,32,39,3,0
60135,837,443,394,129,89,87,38,274,142,132,33,34,18,14,0
60136,299,151,148,35,34,26,16,928,440,488,111,157,82,35,0
60137,895,388,507,130,84,90,31,601,278,323,124,87,65,21,0
60138,684,353,331,95,98,77,38,389,207,182,53,58,52,18,0
60139,624,222,402,92,81,39,15,125,66,59,24,16,11,5,0
60140,388,209,179,46,24,31,28,1265,689,576,169,177,128,60,0
60141,3859,2011,1848,535,391,422,207,386,181,205,55,51,57,31,0
60142,533,297,236,74,57,39,28,323,171,152,48,41,40,16,0
60143,517,245,272,92,77,46,24,756,348,408,101,103,60,40,0
60144,305,124,181,27,25,32,21,1208,565,643,182,162,120,57,0
60145,1505,680,825,202,204,73,32,201,117,83,22,21,19,9,0
60146,494,233,261,87,57,46,18,748,359,389,125,113,86,31,0
60147,202,103,99,28,20,12,8,647,324,323,101,80,76,43,0
60148,106,43,63,28,13,8,1,415,203,212,77,44,49,18,0
60149,297,182,115,41,22,23,8,246,107,139,55,33,27,11,0
60150,785,374,411,56,42,38,25,296,159,137,49,28,38,13,0
60151,242,104,138,41,33,37,8,366,204,162,47,41,31,23,0
60152,413,206,207,38,55,19,10,1543,794,749,182,152,132,55,0
60153,128,69,59,29,9,8,1,212,127,85,28,21,26,6,0
60154,527,254,273,67,66,70,31,390,223,167,58,36,45,18,0
60155,255,136,119,39,20,32,10,375,210,165,49,37,29,27,0
60156,207,128,79,26,17,19,9,392,214,178,48,40,53,22,0
60157,335,148,187,52,26,51,12,257,139,118,64,17,24,7,0
60158,349,167,182,54,38,30,28,128,63,65,30,11,13,8,0
60159,381,187,194,37,49,36,17,720,357,363,113,85,62,39,0
60160,161,99,62,15,22,9,7,374,174,200,54,52,42,21,0
60161,1339,494,845,216,298,92,37,242,124,118,39,32,28,22,0
60162,1590,726,864,270,237,126,59,189,105,84,25,26,21,9,0
60163,482,245,237,69,64,66,24,452,231,221,74,53,56,20,0
60164,281,125,156,44,47,17,7,4646,2328,2318,674,639,475,170,0
60165,1014,488,526,178,137,94,39,294,146,148,50,45,51,15,0
60166,972,501,471,125,156,106,39,654,295,359,99,88,71,25,0
60167,507,314,193,49,45,59,25,332,155,177,55,51,44,13,0
60168,328,195,133,36,23,35,9,334,181,153,56,31,28,18,0
60169,960,409,551,166,134,77,44,439,227,212,60,55,58,8,0
60170,2048,855,1193,297,287,191,93,528,276,252,86,78,49,17,0
60171,1054,453,601,183,183,107,35,239,113,126,36,49,20,8,0
60172,76,30,46,7,15,1,5,292,143,149,38,42,36,16,0
60173,972,501,471,125,156,106,39,1025,549,476,118,109,88,61,0
60174,743,377,366,87,74,68,30,926,340,586,133,119,60,40,0
60175,122,56,66,26,13,11,5,198,113,85,19,20,26,12,0
60176,435,187,248,62,51,51,21,201,104,97,36,32,24,7,0
60177,961,465,496,139,156,62,34,277,163,114,33,24,21,16,0
60178,853,400,453,137,109,88,42,230,113,117,31,40,28,10,0
60179,747,469,278,60,41,53,23,452,231,221,74,53,56,20,0
60180,313,178,135,43,18,35,6,621,310,311,100,106,77,27,0
60181,575,305,270,74,87,73,25,1425,670,755,153,189,122,85,0
60182,508,267,241,43,35,25,17,647,350,297,95,79,77,29,0
60183,738,358,380,106,99,62,25,980,481,499,131,107,85,44,0
60184,181,92,89,34,22,17,9,538,274,264,84,67,52,35,0
60185,443,206,237,76,68,52,28,152,71,81,41,16,14,2,0
60186,343,162,181,65,38,29,12,470,205,265,71,80,33,11,0
60187,595,339,256,64,36,54,24,497,257,240,71,63,62,16,0
60188,261,137,124,34,23,13,8,701,380,321,94,84,96,34,0
60189,288,140,148,59,33,27,12,337,152,185,49,54,42,21,0
60190,785,351,434,136,93,71,37,514,248,266,86,82,52,22,0
60191,365,148,217,86,37,51,28,538,274,264,84,67,52,35,0
60192,447,232,215,55,65,50,25,585,277,308,92,73,61,32,0
60193,548,310,238,72,62,54,13,660,303,357,97,89,85,33,0
60194,746,312,434,129,115,77,47,461,223,238,45,62,18,35,0
60195,494,242,252,67,47,25,21,257,126,131,61,24,22,8,0
60196,317,167,150,45,21,30,26,261,162,99,24,21,14,10,0
60197,338,139,199,54,54,18,11,266,150,116,28,28,24,12,0
60198,484,264,220,59,62,68,15,1321,653,668,186,195,70,35,0
60199,164,61,103,47,19,14,5,478,254,224,67,74,56,28,0
60200,220,121,99,28,26,17,6,902,499,403,118,117,92,35,0
60201,126,57,69,31,10,10,3,601,279,322,81,65,27,12,0
60202,356,199,157,36,43,28,12,204,96,108,31,37,20,5,0
60203,429,227,202,49,51,46,26,201,99,102,34,26,23,6,0
60204,391,204,187,47,48,38,18,169,74,95,33,26,22,3,0
60205,331,177,154,54,38,27,11,390,190,200,66,50,43,12,0
60206,1054,453,601,183,183,107,35,277,163,114,33,24,21,16,0
60207,246,111,135,64,47,27,3,192,110,82,33,21,10,3,0
60208,265,165,100,32,19,27,5,198,86,112,36,27,23,9,0
60209,192,91,101,28,21,18,8,1922,923,999,267,275,215,90,0
60210,219,100,119,40,29,21,3,106,54,52,12,9,7,6,0
60211,261,137,124,34,23,13,8,277,138,139,40,39,20,14,0
60212,1220,575,645,208,179,99,56,469,225,244,64,68,25,11,0
60213,420,202,218,67,43,51,15,230,113,117,31,40,28,10,0
60214,362,181,181,67,46,43,8,295,160,135,44,36,46,16,0
60215,265,165,100,32,19,27,5,225,129,96,32,33,20,8,0
60216,1505,680,825,202,204,73,32,331,180,151,46,35,47,17,0
60217,462,258,204,59,41,56,15,701,380,321,94,84,96,34,0
60218,215,117,98,28,19,15,8,189,95,94,25,33,16,8,0
60219,427,191,236,67,60,41,34,169,85,84,21,14,9,9,0
60220,358,206,152,45,38,67,16,199,92,107,34,30,18,9,0
60221,979,534,445,83,77,80,24,520,272,248,60,65,58,22,0
60222,244,104,140,52,31,30,14,137,72,65,27,13,15,8,0
60223,333,171,162,41,44,48,23,240,141,99,34,28,29,8,0
60224,230,114,116,30,33,29,8,375,210,165,49,37,29,27,0
60225,473,265,208,47,26,50,30,207,113,94,33,18,30,9,0
60226,86,50,36,9,14,8,7,422,237,185,53,47,62,20,0
60227,1043,479,564,200,131,123,62,152,71,81,41,16,14,2,0
60228,67,40,27,10,8,7,6,583,280,303,95,66,76,25,0
60229,605,277,328,99,54,63,43,189,105,84,25,26,21,9,0
60230,1199,589,610,189,128,167,65,1352,602,750,166,185,81,70,0
60231,309,164,145,35,47,30,11,119,57,62,18,16,17,4,0
60232,1030,567,463,118,106,94,49,375,176,199,48,61,40,12,0
60233,347,154,193,48,51,25,11,447,212,235,86,55,58,21,0
60234,169,64,105,23,37,11,3,192,110,82,33,21,10,3,0
60235,502,236,266,66,66,58,17,498,244,254,81,67,58,19,0
60236,439,211,228,65,73,26,21,272,173,99,32,32,11,8,0
60237,500,245,255,66,57,52,27,452,254,198,72,57,38,18,0
60238,476,276,200,57,34,43,16,267,141,126,53,27,23,7,0
60239,3969,1703,2266,619,432,259,144,741,383,358,92,63,79,36,0
60240,525,254,271,60,76,46,13,277,152,125,31,35,22,19,0
60241,466,259,207,59,50,83,12,94,45,49,11,20,10,4,0
60242,476,254,222,58,33,46,23,380,178,202,69,53,37,10,0
60243,613,303,310,70,28,28,18,296,159,137,49,28,38,13,0
60244,414,216,198,51,32,42,28,362,156,206,74,42,36,22,0
60245,361,171,190,44,40,18,13,384,204,180,53,47,49,17,0
60246,312,173,139,43,47,28,6,328,195,133,39,40,27,13,0
60247,722,390,332,125,69,67,25,135,57,78,21,20,9,11,0
60248,126,56,70,31,10,10,3,188,90,98,44,7,21,7,0
60249,414,195,219,51,60,40,17,1020,538,482,145,115,111,58,0
60250,1014,488,526,178,137,94,39,137,78,59,22,16,17,4,0
60251,640,308,332,91,102,49,21,305,161,144,39,40,44,17,0
60252,286,111,175,51,47,21,12,349,200,149,41,39,30,20,0
60253,269,127,142,43,24,34,26,124,69,55,14,7,9,4,0
60254,391,203,188,49,34,36,9,434,213,221,77,62,53,12,0
60255,828,355,473,126,134,77,37,194,106,88,33,10,15,6,0
60256,332,172,160,50,33,35,9,283,160,123,25,20,37,9,0
60257,128,70,58,29,9,8,1,240,141,99,34,28,29,8,0
60258,919,444,475,141,148,62,20,467,240,227,65,65,51,23,0
60259,2279,996,1283,375,328,158,60,396,223,173,57,37,44,19,0
60260,346,209,137,46,37,44,10,647,350,297,95,79,77,29,0
60261,437,228,209,47,61,26,11,295,160,135,42,37,46,16,0
60262,648,262,386,113,108,78,29,1700,731,969,198,233,110,87,0
60263,1171,542,629,170,146,114,64,106,54,52,12,9,7,6,0
60264,193,110,83,18,20,15,12,108,59,49,17,13,12,5,0
60265,308,129,179,44,60,19,8,127,58,69,18,17,10,5,0
60266,500,245,255,66,57,52,27,1025,549,476,118,109,88,61,0
60267,412,203,209,65,47,37,18,207,113,94,33,18,30,9,0
60268,2063,1024,1039,175,117,80,97,359,171,188,49,74,45,11,0
60269,531,260,271,97,68,47,11,199,92,107,34,30,18,9,0
60270,420,189,231,79,67,33,17,244,143,101,31,29,26,8,0
60271,122,56,66,26,13,11,5,399,190,209,61,41,39,18,0
60272,407,164,243,88,42,40,22,225,114,111,32,29,26,6,0
60273,297,161,136,36,35,24,9,2225,1244,981,271,243,217,93,0
60274,507,314,193,49,45,59,25,180,89,91,28,27,18,7,0
60275,452,217,235,59,47,60,20,619,305,314,85,93,71,29,0
60276,763,371,392,104,88,52,23,453,255,198,62,49,29,19,0
60277,319,222,97,36,23,28,8,107,77,30,7,2,9,5,0
60278,854,435,419,118,91,95,42,404,190,214,55,55,35,27,0
60279,219,116,103,66,7,2,1,501,249,252,77,70,55,22,0
60280,242,111,131,35,35,17,13,132,67,65,24,21,8,10,0
60281,517,245,272,92,77,46,24,323,162,161,52,41,39,13,0
60282,837,443,394,129,89,87,38,904,436,468,143,118,108,32,0
60283,450,227,223,53,36,48,12,360,180,180,57,48,39,12,0
60284,1112,457,655,180,164,99,39,732,402,330,81,86,87,33,0
60285,443,206,237,76,68,52,28,662,312,350,103,104,59,20,0
60286,272,94,178,76,33,19,4,660,303,357,97,89,85,33,0
60287,385,179,206,58,56,38,19,72,33,39,8,2,3,12,0
60288,221,80,141,48,37,14,10,265,134,131,48,34,33,15,0
60289,548,250,298,85,64,56,21,647,324,323,101,80,76,43,0
60290,415,217,198,50,31,42,17,227,130,97,32,25,22,12,0
60291,688,310,378,130,82,78,47,579,285,294,78,72,64,32,0
60292,538,263,275,71,85,44,18,978,536,442,132,107,67,32,0
60293,344,168,176,50,39,30,20,222,127,95,23,28,22,7,0
60294,338,208,130,39,30,35,12,290,147,143,34,34,39,13,0
60295,607,294,313,94,95,62,14,585,277,308,92,73,61,32,0
60296,546,265,281,101,64,38,16,387,193,194,60,53,57,15,0
60297,503,260,243,46,56,33,16,257,126,131,61,24,22,8,0
60298,895,388,507,130,84,90,31,1047,562,485,141,127,114,41,0
60299,193,95,98,33,17,25,17,633,311,322,94,82,45,20,0
60300,130,70,60,30,9,8,1,647,350,297,95,79,77,29,0
60301,357,182,175,49,36,39,15,288,156,132,36,36,24,15,0
60302,429,238,191,47,49,56,29,422,202,220,80,52,57,18,0
60303,584,297,287,89,80,65,17,391,189,202,55,56,56,12,0
60304,435,225,210,58,46,50,14,245,121,124,37,35,36,12,0
60305,350,212,138,32,26,40,13,906,455,451,116,105,87,46,0
60306,565,264,301,101,73,72,15,218,114,104,32,31,33,11,0
60307,330,151,179,68,36,56,9,873,411,462,132,107,84,40,0
60308,726,312,414,121,73,82,23,1323,690,633,132,178,112,61,0
60309,1068,434,634,173,160,61,29,368,183,185,40,42,40,15,0
60310,124,58,66,20,28,11,7,821,394,427,122,117,109,38,0
60311,629,374,255,74,53,87,27,497,257,240,71,63,62,16,0
60312,456,223,233,77,54,47,20,105,51,54,13,17,12,8,0
60313,979,534,445,83,77,80,24,947,482,465,143,107,89,37,0
60314,4128,2104,2024,581,505,453,205,111,60,51,17,23,10,7,0
60315,238,158,80,28,15,31,7,417,232,185,58,50,29,21,0
60316,1004,464,540,143,104,78,55,198,86,112,36,27,23,9,0
60317,747,469,278,60,41,53,23,1873,935,938,233,225,203,79,0
60318,1096,563,533,158,136,120,53,257,139,118,64,17,24,7,0
60319,4128,2104,2024,581,505,453,205,663,360,303,87,82,80,35,0
60320,1214,612,602,169,173,98,35,501,274,227,63,58,53,20,0
60321,1217,647,570,142,160,129,45,332,173,159,48,40,31,11,0
60322,622,354,268,89,60,64,18,627,323,304,81,90,53,27,0
60323,618,289,329,97,86,70,17,1239,659,580,169,148,131,54,0
60324,413,236,177,41,25,35,19,375,209,166,50,37,29,23,0
60325,136,66,70,33,11,9,5,671,321,350,95,87,75,34,0
60326,180,57,123,39,22,10,8,597,300,297,96,89,68,29,0
60327,685,393,292,75,66,113,16,230,113,117,31,40,28,10,0
60328,443,212,231,74,24,60,24,198,113,85,19,20,26,12,0
60329,431,216,215,46,40,33,9,225,111,114,32,34,32,16,0
60330,480,232,248,73,40,44,30,390,223,167,58,36,45,18,0
60331,1161,514,647,159,138,122,37,429,187,242,79,72,28,19,0
60332,786,378,408,106,98,77,39,147,74,73,28,20,24,4,0
60333,579,246,333,102,79,41,19,483,287,196,71,50,54,17,0
60334,532,254,278,91,48,23,17,368,183,185,40,42,40,15,0
60335,82,36,46,17,10,5,1,169,74,95,33,26,22,3,0
60336,292,102,190,71,27,51,21,165,90,75,36,18,20,6,0
60337,219,100,119,40,29,21,3,434,213,221,77,62,53,12,0
60338,684,353,331,95,98,77,38,277,152,125,31,35,22,19,0
60339,476,276,200,57,34,43,16,395,198,197,55,55,36,10,0
60340,379,203,176,55,48,45,16,211,115,96,37,19,29,10,0
60341,106,43,63,28,13,8,1,222,125,97,34,27,27,7,0
60342,246,123,123,40,31,27,7,600,254,346,104,100,44,17,0
60343,243,114,129,37,30,32,8,538,274,264,84,67,52,35,0
60344,218,133,85,20,19,13,6,149,52,97,36,36,7,4,0
60345,756,362,394,102,104,73,25,368,200,168,54,49,43,9,0
60346,1004,498,506,94,59,46,33,469,225,244,64,68,25,11,0
60347,378,202,176,34,32,44,13,111,60,51,17,23,10,7,0
60348,927,457,470,130,99,118,42,405,214,191,53,42,49,20,0
60349,873,366,507,127,125,75,21,135,57,78,21,20,9,11,0
60350,368,154,214,80,52,41,16,1265,689,576,169,177,128,60,0
60351,346,205,141,47,34,30,7,265,134,131,48,34,33,15,0
60352,361,167,194,55,35,41,11,323,168,155,51,41,38,12,0
60353,330,77,253,86,52,20,12,818,357,461,122,136,54,25,0
60354,1594,660,934,251,272,117,77,866,478,388,121,101,101,26,0
60355,288,104,184,80,30,39,6,362,156,206,74,42,36,22,0
60356,143,81,62,28,9,8,1,462,229,233,63,49,42,18,0
60357,51,10,41,25,0,5,8,617,314,303,96,68,68,37,0
60358,271,110,161,33,27,11,8,391,189,202,55,56,56,12,0
60359,802,430,372,65,102,87,23,246,125,121,38,36,30,11,0
60360,346,208,138,46,39,51,18,481,223,258,71,70,49,26,0
60361,538,263,275,71,85,44,18,325,172,153,44,34,27,14,0
60362,688,310,378,130,82,78,47,301,168,133,49,37,34,11,0
60363,532,254,278,91,48,23,17,207,114,93,33,20,31,13,0
60364,862,384,478,127,110,75,42,149,77,72,37,10,20,5,0
60365,546,265,281,101,64,38,16,555,292,263,75,63,67,27,0
60366,639,368,271,72,51,38,38,704,355,349,113,94,71,24,0
60367,2624,999,1625,415,495,109,84,483,287,196,71,50,54,17,0
60368,269,127,142,43,24,34,26,963,525,438,119,102,102,34,0
60369,743,377,366,87,74,68,30,1182,591,591,155,139,83,46,0
60370,200,94,106,33,22,18,8,1314,693,621,174,155,140,58,0
60371,258,144,114,33,22,19,9,462,229,233,63,49,42,18,0
60372,71,39,32,7,11,6,4,621,310,311,100,106,77,27,0
60373,454,214,240,56,71,35,16,323,168,155,51,41,38,12,0
60374,465,220,245,88,34,61,23,251,143,108,47,25,29,11,0
60375,346,191,155,52,38,40,13,501,274,227,63,58,53,20,0
60376,207,128,79,26,17,19,9,135,65,70,21,25,15,9,0
60377,641,349,292,92,60,39,24,166,88,78,23,18,13,7,0
60378,338,164,174,45,32,37,13,363,180,183,60,34,10,6,0
60379,446,283,163,51,26,33,19,134,72,62,14,28,8,4,0
60380,3703,1708,1995,456,428,305,162,370,190,180,60,52,37,13,0
60381,739,323,416,127,89,76,33,335,186,149,40,28,29,13,0
60382,480,267,213,49,44,70,21,775,407,368,122,100,97,32,0
60383,595,316,279,86,60,65,40,583,321,262,73,67,45,25,0
60384,213,88,125,21,54,14,15,536,267,269,60,70,41,22,0
60385,109,50,59,12,12,9,3,1537,701,836,209,187,129,58,0
60386,478,220,258,47,70,41,10,179,101,78,25,15,13,13,0
60387,136,66,70,33,11,9,3,531,261,270,73,80,68,26,0
60388,199,107,92,41,15,14,8,414,203,211,58,56,48,14,0
60389,828,355,473,126,134,77,37,1507,737,770,188,228,147,71,0
60390,202,103,99,28,20,12,8,396,223,173,57,37,44,19,0
60391,426,196,230,76,65,54,20,429,187,242,79,72,28,19,0
60392,594,248,346,104,109,53,5,846,425,421,125,97,98,38,0
60393,1689,821,868,277,250,177,78,266,146,120,41,28,31,7,0
60394,207,93,114,20,33,19,10,346,196,150,43,26,27,14,0
60395,801,331,470,151,139,99,55,459,260,199,56,42,47,21,0
60396,178,89,89,40,12,18,7,350,196,154,52,37,21,14,0
60397,561,282,279,68,62,36,14,1262,653,609,169,165,152,50,0
60398,293,153,140,45,38,22,15,195,100,95,27,20,17,11,0
60399,339,170,169,32,17,24,13,297,164,133,45,39,40,9,0
60400,684,353,331,95,98,77,38,953,489,464,126,104,111,44,0
60401,415,133,282,114,65,27,7,229,120,109,31,30,22,9,0
60402,149,78,71,20,20,19,5,710,375,335,95,94,110,28,0
60403,396,150,246,103,64,38,3,234,116,118,34,35,23,9,0
60404,299,128,171,57,40,13,25,1040,564,476,134,110,114,51,0
60405,326,176,150,35,22,29,11,1537,701,836,209,187,129,58,0
60406,211,92,119,33,44,11,7,274,142,132,33,34,18,14,0
60407,270,147,123,34,17,39,21,1065,581,484,134,97,76,46,0
60408,82,36,46,17,10,5,1,354,183,171,54,43,49,8,0
60409,574,269,305,91,63,54,27,381,187,194,37,49,36,17,0
60410,228,105,123,34,43,20,10,89,38,51,14,6,3,9,0
60411,517,196,321,103,98,33,12,377,184,193,50,43,33,17,0
60412,126,58,68,31,10,10,3,592,249,343,91,90,50,42,0
60413,426,231,195,51,52,45,24,1040,564,476,134,110,114,51,0
60414,603,311,292,102,71,66,23,396,199,197,54,50,45,14,0
60415,330,151,179,68,36,56,9,715,348,367,109,84,68,30,0
60416,560,279,281,113,64,58,15,1500,804,696,190,172,144,60,0
60417,270,158,112,35,20,23,7,2346,1231,1115,316,292,266,105,0
60418,380,185,195,68,54,32,16,579,285,294,78,72,64,32,0
60419,450,227,223,53,36,48,12,414,203,211,58,56,48,14,0
60420,299,151,148,35,34,26,16,457,245,212,62,58,57,21,0
60421,181,75,106,35,26,11,9,375,209,166,50,37,29,23,0
60422,298,141,157,51,33,21,22,588,286,302,78,99,53,25,0
60423,1390,585,805,241,230,118,46,862,409,453,149,125,86,29,0
60424,462,228,234,59,47,37,32,242,121,121,39,30,29,10,0
60425,545,221,324,101,72,55,30,130,67,63,24,10,12,4,0
60426,162,73,89,32,19,4,4,276,149,127,34,31,32,10,0
60427,480,234,246,79,77,65,23,246,108,138,32,44,21,10,0
60428,413,206,207,38,55,19,10,448,217,231,56,63,29,10,0
60429,394,207,187,52,42,37,24,906,455,451,116,105,87,46,0
60430,439,241,198,67,40,40,13,1922,923,999,267,275,215,90,0
60431,484,192,292,118,68,83,22,2225,1244,981,271,243,217,93,0
60432,457,228,229,64,36,52,21,134,72,62,14,28,8,4,0
60433,2414,1189,1225,277,178,170,169,308,146,162,42,39,24,12,0
60434,579,246,333,102,79,41,19,390,223,167,58,36,45,18,0
60435,417,222,195,53,39,43,10,462,251,211,74,53,41,18,0
60436,1276,607,669,192,178,136,63,520,272,248,60,65,58,22,0
60437,326,148,178,55,42,31,12,194,109,85,23,24,21,9,0
60438,164,77,87,33,19,6,7,368,200,168,54,49,43,9,0
60439,373,194,179,42,54,26,13,266,150,116,28,28,24,12,0
60440,658,349,309,77,70,73,35,295,160,135,44,36,46,16,0
60441,380,185,195,68,54,32,16,354,188,166,46,40,34,10,0
60442,854,435,419,118,91,95,42,395,198,197,55,55,36,10,0
60443,118,56,62,24,12,6,9,975,475,500,139,140,119,28,0
60444,1498,731,767,220,175,148,68,461,223,238,45,62,18,35,0
60445,570,238,332,112,95,39,23,295,158,137,42,34,38,14,0
60446,196,107,89,20,31,17,4,607,293,314,98,71,62,32,0
60447,306,172,134,35,31,37,18,392,214,178,48,40,53,22,0
60448,340,145,195,46,38,26,23,103,44,59,16,17,9,5,0
60449,126,56,70,31,10,10,3,180,108,72,22,22,15,5,0
60450,425,198,227,57,69,59,13,203,98,105,34,29,19,10,0
60451,317,167,150,45,21,30,26,375,176,199,48,61,40,12,0
60452,429,227,202,49,51,46,26,2517,1275,1242,304,324,245,135,0
60453,255,136,119,39,20,32,10,773,389,384,119,91,79,26,0
60454,559,217,342,105,86,42,16,136,65,71,26,11,7,5,0
60455,1912,880,1032,331,334,180,84,662,312,350,103,104,59,20,0
60456,425,220,205,60,55,45,18,385,212,173,57,40,39,21,0
60457,86,50,36,9,14,8,7,459,260,199,56,42,47,21,0
60458,233,107,126,40,40,20,16,309,159,150,47,43,43,13,0
60459,272,141,131,45,29,36,9,348,212,136,53,31,25,18,0
60460,704,342,362,113,91,85,33,396,199,197,54,50,45,14,0
60461,493,208,285,75,77,70,40,392,214,178,48,40,53,22,0
60462,496,210,286,112,55,72,13,96,45,51,13,12,6,4,0
60463,3230,1724,1506,361,358,157,75,1001,417,584,186,147,96,47,0
60464,178,89,89,40,12,18,7,299,140,159,49,44,26,11,0
60465,861,393,468,150,101,69,35,323,162,161,52,41,39,13,0
60466,473,265,208,47,26,50,30,127,58,69,18,17,10,5,0
60467,121,69,52,15,18,14,8,392,214,178,48,40,53,22,0
60468,574,284,290,64,50,65,20,392,214,178,48,40,53,22,0
60469,1161,514,647,159,138,122,37,1352,602,750,166,185,81,70,0
60470,125,57,68,31,10,10,3,241,127,114,34,33,29,12,0
60471,303,161,142,38,31,42,17,250,116,134,41,30,33,19,0
60472,560,279,281,113,64,58,15,373,189,184,54,46,50,23,0
60473,609,292,317,102,96,64,21,341,170,171,41,66,27,10,0
60474,575,290,285,67,70,28,9,1062,522,540,151,147,105,66,0
60475,941,459,482,167,140,82,38,209,119,90,28,24,27,9,0
60476,734,366,368,121,99,63,39,386,181,205,55,51,57,31,0
60477,1163,417,746,209,145,87,28,415,205,210,77,52,55,17,0
60478,715,345,370,110,97,64,25,298,129,169,51,40,29,8,0
60479,687,351,336,106,67,70,41,406,234,172,63,35,43,10,0
60480,273,126,147,54,49,25,18,180,95,85,22,21,17,8,0
60481,1542,682,860,290,158,120,47,679,338,341,96,95,40,23,0
60482,1390,585,805,241,230,118,46,665,361,304,87,91,84,31,0
60483,410,209,201,72,30,48,22,644,343,301,96,69,59,28,0
60484,224,108,116,31,32,22,8,748,359,389,125,113,86,31,0
60485,507,242,265,53,44,31,22,145,77,68,26,7,15,8,0
60486,519,259,260,86,78,59,22,679,338,341,96,95,40,23,0
60487,861,393,468,150,101,69,35,220,107,113,36,35,28,9,0
60488,411,211,200,61,46,35,18,474,268,206,66,42,45,24,0
60489,798,287,511,126,125,77,26,1696,771,925,257,225,149,63,0
60490,1616,735,881,285,248,153,72,373,181,192,54,35,44,20,0
60491,535,315,220,57,55,71,19,188,90,98,44,7,21,7,0
60492,130,71,59,30,9,8,2,422,202,220,80,52,57,18,0
60493,566,263,303,83,87,74,31,904,436,468,138,146,82,39,0
60494,180,92,88,29,20,26,8,72,32,40,8,2,1,14,0
60495,253,133,120,44,31,22,8,375,176,199,48,61,40,12,0
60496,594,279,315,93,68,68,26,449,252,197,61,52,36,18,0
60497,270,130,140,43,24,36,10,928,440,488,111,157,82,35,0
60498,279,129,150,43,34,17,13,278,154,124,42,32,38,7,0
60499,648,262,386,113,108,78,29,380,178,202,69,53,37,10,0
60500,764,277,487,158,162,64,31,453,247,206,58,53,45,20,0
60501,898,397,501,102,98,54,37,309,164,145,35,47,30,11,0
60502,972,501,471,125,156,106,39,507,270,237,89,59,57,22,0
60503,489,253,236,73,36,62,17,783,406,377,102,91,57,29,0
60504,746,312,434,129,115,77,47,693,360,333,100,88,62,26,0
60505,422,207,215,79,38,53,23,127,54,73,11,33,15,6,0
60506,126,56,70,31,10,10,3,380,178,202,69,53,37,10,0
60507,172,82,90,21,35,21,5,405,214,191,53,42,49,20,0
60508,1051,429,622,179,148,125,54,187,89,98,36,24,20,6,0
60509,828,355,473,126,134,77,37,723,363,360,107,106,52,14,0
60510,71,28,43,15,9,5,2,520,272,248,60,65,58,22,0
60511,357,182,175,49,36,39,15,218,115,103,37,33,33,9,0
60512,443,226,217,67,34,53,10,288,156,132,36,36,24,15,0
60513,4128,2104,2024,581,505,453,205,547,295,252,81,65,57,23,0
60514,380,148,232,81,69,24,8,375,176,199,48,61,40,12,0
60515,2109,999,1110,332,294,187,89,228,130,98,35,29,30,10,0
60516,5890,3314,2576,970,956,293,265,508,253,255,73,60,50,13,0
60517,516,210,306,113,53,81,33,367,199,168,62,44,34,8,0
60518,118,56,62,24,12,6,9,673,313,360,102,101,46,17,0
60519,258,144,114,33,22,19,9,350,196,154,52,37,21,14,0
60520,429,227,202,49,51,46,26,142,73,69,27,9,15,11,0
60521,793,355,438,134,117,77,43,138,69,69,28,7,10,10,0
60522,1105,544,561,165,167,99,40,649,307,342,71,134,45,17,0
60523,2799,1324,1475,369,371,215,124,2542,1245,1297,285,287,170,84,0
60524,224,101,123,45,32,21,3,1166,514,652,150,159,107,70,0
60525,630,231,399,150,83,84,50,660,303,357,97,89,85,33,0
60526,412,208,204,54,47,42,17,663,354,309,91,84,79,31,0
60527,957,381,576,184,158,86,48,632,360,272,75,65,36,19,0
60528,339,170,169,32,17,24,13,403,233,170,38,29,21,14,0
60529,933,456,477,123,108,83,29,453,255,198,62,49,29,19,0
60530,3703,1708,1995,456,428,305,162,128,63,65,30,11,13,8,0
60531,465,240,225,50,54,24,14,514,248,266,86,82,52,22,0
60532,543,221,322,78,122,37,12,219,105,114,36,29,19,8,0
60533,490,198,292,65,81,39,27,406,234,172,63,35,43,10,0
60534,502,250,252,70,47,57,15,1500,804,696,190,172,144,60,0
60535,336,199,137,46,22,51,13,457,245,212,62,58,57,21,0
60536,431,245,186,50,23,46,17,2038,1059,979,262,237,208,100,0
60537,582,328,254,78,48,35,9,555,282,273,82,69,65,21,0
60538,1004,498,506,94,59,46,33,303,137,166,54,54,31,15,0
60539,585,277,308,92,73,61,32,562,273,289,76,92,45,24,0
60540,313,134,179,58,37,43,19,380,178,202,69,53,37,10,0
60541,146,73,73,18,24,17,9,453,247,206,58,53,45,20,0
60542,313,134,179,58,37,43,19,242,121,121,39,30,29,10,0
60543,346,191,155,52,38,40,13,1507,737,770,188,228,147,71,0
60544,436,201,235,54,37,35,18,929,459,470,140,120,94,45,0
60545,508,251,257,74,53,51,18,515,276,239,62,59,43,31,0
60546,106,43,63,28,13,8,1,520,244,276,91,60,68,20,0
60547,531,259,272,75,81,39,13,415,203,212,77,44,49,18,0
60548,575,305,270,74,87,73,25,207,114,93,33,20,31,13,0
60549,571,298,273,81,72,57,25,758,319,439,101,123,78,25,0
60550,1054,453,601,183,183,107,35,124,69,55,14,7,9,4,0
60551,457,228,229,64,36,52,21,362,156,206,74,42,36,22,0
60552,786,378,408,106,98,77,39,798,385,413,120,115,79,30,0
60553,594,248,346,104,109,53,5,127,66,61,13,14,19,8,0
60554,451,225,226,69,57,64,22,230,113,117,31,40,28,10,0
60555,582,328,254,78,48,35,9,222,125,97,34,27,27,7,0
60556,360,205,155,35,24,52,14,295,160,135,42,37,46,16,0
60557,142,60,82,20,28,13,5,190,93,97,35,27,23,2,0
60558,500,297,203,66,33,53,15,862,409,453,149,125,86,29,0
60559,625,283,342,93,89,67,25,328,195,133,39,40,27,13,0
60560,1499,864,635,141,99,76,110,526,266,260,76,75,53,22,0
60561,766,336,430,133,97,79,21,517,295,222,69,62,40,28,0
60562,624,222,402,92,81,39,15,218,114,104,32,31,33,11,0
60563,320,163,157,44,44,26,15,196,105,91,40,13,19,10,0
60564,144,57,87,38,26,10,4,405,214,191,53,42,49,20,0
60565,509,251,258,69,49,55,17,405,181,224,71,57,31,12,0
60566,391,203,188,49,34,36,9,132,77,55,20,9,13,10,0
60567,755,271,484,113,226,61,20,520,244,276,91,60,68,20,0
60568,570,238,332,112,95,39,23,230,125,105,29,40,20,6,0
60569,193,90,103,44,9,19,13,425,177,248,60,62,33,16,0
60570,220,113,107,37,24,16,7,149,52,97,36,36,7,4,0
60571,121,69,52,15,18,14,8,180,90,90,31,19,20,8,0
60572,228,82,146,45,37,18,8,548,296,252,71,74,43,28,0
60573,1051,429,622,179,148,125,54,514,262,252,78,58,54,26,0
60574,1960,875,1085,287,189,162,66,1922,923,999,267,275,215,90,0
60575,179,78,101,29,22,10,8,88,50,38,13,8,16,4,0
60576,492,253,239,73,67,77,29,873,411,462,132,107,84,40,0
60577,548,250,298,85,64,56,21,1395,627,768,172,263,141,59,0
60578,335,155,180,64,48,36,10,531,261,270,73,80,68,26,0
60579,2488,1085,1403,346,253,162,76,172,79,93,34,27,23,10,0
60580,179,96,83,24,8,26,4,247,128,119,34,14,16,14,0
60581,543,265,278,52,37,54,19,1395,627,768,172,263,141,59,0
60582,432,233,199,52,28,47,18,277,144,133,42,30,41,8,0
60583,546,285,261,71,49,47,24,1755,905,850,214,196,183,79,0
60584,401,183,218,72,73,28,10,1314,693,621,174,155,140,58,0
60585,315,170,145,48,56,22,11,1352,602,750,166,185,81,70,0
60586,493,208,285,75,77,70,40,194,109,85,23,24,21,9,0
60587,692,305,387,100,97,78,30,325,159,166,59,46,30,12,0
60588,415,133,282,114,65,27,7,445,264,181,35,35,34,14,0
60589,700,305,395,111,99,54,18,68,36,32,11,8,9,2,0
60590,1505,680,825,202,204,73,32,400,187,213,56,59,42,20,0
60591,418,163,255,57,54,38,24,497,257,240,71,63,62,16,0
60592,919,493,426,100,92,88,49,106,46,60,29,13,14,5,0
60593,262,133,129,44,38,31,12,373,189,184,54,46,50,23,0
60594,466,259,207,59,50,83,12,497,257,240,71,63,62,16,0
60595,436,209,227,66,47,52,22,246,125,121,38,36,30,11,0
60596,240,98,142,49,42,23,17,393,210,183,58,37,34,20,0
60597,349,153,196,54,47,28,13,597,269,328,102,84,69,24,0
60598,607,294,313,94,95,62,14,520,240,280,67,72,42,14,0
60599,452,217,235,59,47,60,20,215,115,100,27,19,16,7,0
60600,393,223,170,44,36,32,14,165,87,78,24,19,22,9,0
60601,466,199,267,86,59,32,17,609,335,274,79,57,45,22,0
60602,261,137,124,34,23,13,8,727,362,365,123,107,63,23,0
60603,392,221,171,53,30,25,8,389,210,179,51,37,43,9,0
60604,1011,559,452,121,97,132,33,445,202,243,70,73,51,15,0
60605,238,91,147,68,19,22,7,335,170,165,52,36,47,11,0
60606,346,168,178,36,43,20,9,285,146,139,41,41,48,13,0
60607,911,445,466,154,121,108,48,531,277,254,82,75,33,22,0
60608,340,181,159,44,39,35,21,319,185,134,42,31,22,13,0
60609,629,374,255,74,53,87,27,346,196,150,43,26,27,14,0
60610,272,136,136,32,34,12,12,926,425,501,159,147,77,35,0
60611,730,298,432,128,69,86,26,292,143,149,38,42,36,16,0
60612,784,353,431,56,47,26,18,1182,591,591,155,139,83,46,0
60613,361,171,190,44,40,18,13,194,94,100,33,28,14,7,0
60614,734,366,368,121,99,63,39,172,88,84,24,31,20,12,0
60615,439,183,256,60,64,36,14,295,158,137,42,34,38,14,0
60616,1464,693,771,153,136,91,86,862,426,436,113,115,84,37,0
60617,1235,584,651,140,226,82,52,2382,1162,1220,237,220,140,49,0
60618,503,260,243,46,56,33,16,149,77,72,37,10,20,5,0
60619,1462,711,751,219,222,148,65,704,355,349,113,94,71,24,0
60620,737,320,417,112,94,73,34,2525,1232,1293,398,317,186,61,0
60621,236,120,116,32,28,21,11,134,72,62,14,28,8,4,0
60622,315,170,145,48,56,22,11,108,59,49,17,13,12,5,0
60623,317,153,164,34,52,30,14,720,357,363,113,85,62,39,0
60624,398,186,212,76,70,18,13,376,189,187,47,53,44,26,0
60625,758,378,380,89,64,37,31,364,189,175,58,41,35,17,0
60626,252,121,131,42,34,12,16,929,459,470,140,120,94,45,0
60627,340,166,174,39,40,36,26,702,358,344,113,87,81,30,0
60628,236,141,95,36,32,14,6,199,92,107,34,30,18,9,0
60629,1463,521,942,252,204,105,52,858,398,460,126,138,75,39,0
60630,552,295,257,67,49,70,30,72,34,38,8,2,3,12,0
60631,615,308,307,83,75,58,32,811,361,450,124,107,80,31,0
60632,380,185,195,68,54,32,16,2724,1157,1567,269,518,239,77,0
60633,348,198,150,57,25,37,18,287,151,136,51,42,36,7,0
60634,977,462,515,185,119,76,12,434,213,221,77,62,53,12,0
60635,1647,794,853,279,235,128,65,320,168,152,38,42,24,18,0
60636,264,122,142,33,29,13,13,597,269,328,102,84,69,24,0
60637,815,356,459,128,125,82,26,483,258,225,70,53,54,20,0
60638,206,96,110,33,25,8,6,277,163,114,33,24,21,16,0
60639,627,237,390,137,57,108,44,1154,489,665,200,196,95,54,0
60640,320,163,157,44,44,26,15,441,189,252,73,50,47,23,0
60641,369,166,203,59,55,41,14,514,262,252,78,58,54,26,0
60642,126,66,60,24,10,7,9,285,146,139,41,41,48,13,0
60643,436,209,227,66,47,52,22,256,141,115,32,22,32,8,0
60644,979,534,445,83,77,80,24,892,475,417,130,108,68,38,0
60645,301,157,144,31,28,34,9,633,311,322,94,82,45,20,0
60646,343,162,181,65,38,29,12,309,164,145,35,47,30,11,0
60647,410,188,222,53,52,31,14,376,189,187,47,53,44,26,0
60648,303,161,142,38,31,42,17,54,26,28,11,4,3,3,0
60649,594,279,315,93,68,68,26,132,67,65,24,21,8,10,0
60650,758,378,380,89,64,37,31,303,137,166,54,54,31,15,0
60651,305,124,181,27,25,32,21,72,32,40,8,2,2,13,0
60652,92,46,46,14,9,8,6,1249,638,611,166,153,141,45,0
60653,579,246,333,102,79,41,19,520,272,248,60,65,58,22,0
60654,773,383,390,108,76,79,30,354,183,171,54,43,49,8,0
60655,684,353,331,95,98,77,38,701,380,321,94,84,96,34,0
60656,417,176,241,75,61,51,20,536,222,314,101,100,34,22,0
60657,496,274,222,57,43,75,22,296,159,137,49,28,38,13,0
60658,336,199,137,46,22,51,13,396,223,173,57,37,44,19,0
60659,1064,495,569,157,159,124,58,758,319,439,101,123,78,25,0
60660,854,435,419,118,91,95,42,2202,1121,1081,338,274,269,81,0
60661,1439,713,726,195,180,110,34,127,66,61,13,14,19,8,0
60662,4128,2104,2024,581,505,453,205,339,180,159,36,29,16,16,0
60663,1498,731,767,220,175,148,68,413,223,190,52,45,53,10,0
60664,458,226,232,77,59,61,14,98,49,49,14,15,9,2,0
60665,76,42,34,12,8,5,7,487,252,235,79,58,55,26,0
60666,648,376,272,70,60,73,24,425,177,248,60,62,33,16,0
60667,313,148,165,45,33,36,11,54,26,28,11,4,3,3,0
60668,380,187,193,38,51,30,18,519,287,232,68,58,45,21,0
60669,270,131,139,47,37,41,11,798,385,413,120,115,79,30,0
60670,530,259,271,83,50,54,41,1700,731,969,198,233,110,87,0
60671,441,218,223,69,55,50,27,551,226,325,96,103,43,11,0
60672,126,56,70,31,10,10,3,415,205,210,77,52,55,17,0
60673,126,56,70,31,10,10,3,679,338,341,96,95,40,23,0
60674,250,123,127,40,28,29,8,437,224,213,40,29,42,25,0
60675,1498,731,767,220,175,148,68,276,149,127,34,31,32,10,0
60676,840,411,429,122,101,79,34,300,148,152,45,43,40,8,0
60677,536,287,249,64,73,21,27,487,252,235,79,58,55,26,0
60678,385,203,182,47,43,51,21,561,279,282,85,81,88,24,0
60679,243,100,143,58,50,24,5,332,180,152,44,36,27,13,0
60680,429,238,191,47,49,56,29,673,313,360,102,101,46,17,0
60681,372,171,201,47,53,39,18,1182,591,591,155,139,83,46,0
60682,437,230,207,41,55,27,13,359,171,188,49,74,45,11,0
60683,680,308,372,82,72,71,40,501,249,252,77,70,55,22,0
60684,1970,978,992,245,206,198,80,605,283,322,94,72,64,39,0
60685,269,124,145,36,24,32,11,192,91,101,29,28,17,7,0
60686,953,421,532,131,131,70,37,780,337,443,112,116,77,28,0
60687,325,177,148,40,24,23,13,594,312,282,72,67,73,31,0
60688,124,58,66,20,28,11,7,201,98,103,28,25,19,13,0
60689,343,189,154,44,24,39,12,341,170,171,41,66,27,10,0
60690,1872,837,1035,280,338,169,80,1114,539,575,145,131,94,56,0
60691,553,276,277,88,61,45,27,422,202,220,80,52,57,18,0
60692,650,330,320,97,77,65,28,1248,584,664,184,164,155,67,0
60693,484,261,223,59,48,49,24,352,207,145,40,33,25,21,0
60694,450,231,219,77,50,76,16,457,245,212,62,58,57,21,0
60695,854,435,419,118,91,95,42,947,482,465,143,107,89,37,0
60696,464,237,227,64,66,33,12,296,151,145,45,42,32,11,0
60697,320,163,157,44,44,26,15,299,140,159,49,44,26,11,0
60698,772,417,355,118,92,80,23,1166,514,652,150,159,107,70,0
60699,119,67,52,15,15,7,7,285,146,139,41,41,48,13,0
60700,473,265,208,47,26,50,30,487,252,235,79,58,55,26,0
60701,437,228,209,47,61,26,11,1755,905,850,214,196,183,79,0
60702,164,77,87,33,19,6,7,810,310,500,164,162,42,26,0
60703,579,321,258,74,70,47,22,346,178,168,58,41,33,12,0
60704,399,196,203,62,45,38,19,270,162,108,26,26,16,11,0
60705,828,368,460,118,98,59,38,164,79,85,28,28,16,7,0
60706,674,268,406,118,96,70,21,519,287,232,68,58,45,21,0
60707,240,98,142,49,42,23,17,373,181,192,54,35,44,20,0
60708,417,222,195,53,39,43,10,205,94,111,48,31,15,6,0
60709,488,237,251,79,78,65,27,974,457,517,133,117,69,26,0
60710,2220,1085,1135,312,304,202,91,866,478,388,121,101,101,26,0
60711,318,164,154,52,43,34,10,526,266,260,76,75,53,22,0
60712,249,114,135,47,33,25,4,773,389,384,119,91,79,26,0
60713,215,117,98,28,19,15,8,91,42,49,21,9,8,3,0
60714,500,257,243,60,55,27,22,314,177,137,34,40,29,9,0
60715,507,242,265,53,44,31,22,231,126,105,28,26,34,9,0
60716,281,125,156,44,47,17,7,148,84,64,30,7,17,4,0
60717,584,297,287,89,80,65,17,192,91,101,29,28,17,7,0
60718,1052,492,560,184,163,103,44,106,46,60,29,13,14,5,0
60719,333,171,162,50,34,19,8,520,244,276,91,60,68,20,0
60720,346,186,160,40,37,34,21,925,439,486,141,134,105,46,0
60721,3703,1708,1995,456,428,305,162,1698,875,823,222,219,173,64,0
60722,178,89,89,40,12,18,7,286,152,134,38,38,32,11,0
60723,1068,434,634,173,160,61,29,1873,935,938,233,225,203,79,0
60724,577,251,326,92,84,60,11,429,187,242,79,72,28,19,0
60725,567,256,311,91,81,53,17,1154,489,665,200,196,95,54,0
60726,575,305,270,74,87,73,25,297,175,122,46,30,31,6,0
60727,435,187,248,62,51,51,21,2382,1162,1220,237,220,140,49,0
60728,717,281,436,165,81,112,49,397,234,163,44,38,23,21,0
60729,344,109,235,100,39,26,5,108,59,49,17,13,12,5,0
60730,188,84,104,35,36,18,9,724,353,371,94,95,71,31,0
60731,107,36,71,27,15,0,1,207,86,121,34,39,11,13,0
60732,500,245,255,66,57,52,27,106,46,60,27,18,12,3,0
60733,734,366,368,121,99,63,39,773,389,384,119,91,79,26,0
60734,505,282,223,60,57,66,23,337,170,167,59,33,47,17,0
60735,281,154,127,45,31,24,9,1004,457,547,150,150,74,52,0
60736,1284,511,773,227,166,169,107,87,38,49,23,10,10,9,0
60737,653,379,274,89,56,86,13,247,128,119,34,14,16,14,0
60738,71,28,43,15,9,5,2,1020,538,482,145,115,111,58,0
60739,360,192,168,55,45,48,16,266,133,133,54,19,38,10,0
60740,303,161,142,38,31,42,17,432,244,188,51,51,27,14,0
60741,335,148,187,52,26,51,12,296,140,156,49,40,42,19,0
60742,313,134,179,58,37,43,19,1004,457,547,150,150,74,52,0
60743,203,97,106,30,22,18,10,378,154,224,74,84,35,22,0
60744,640,308,332,91,102,49,21,103,59,44,25,2,13,6,0
60745,249,114,135,47,33,25,4,250,116,134,41,30,33,19,0
60746,496,210,286,111,55,74,13,218,117,101,35,32,34,12,0
60747,235,100,135,36,25,30,8,366,204,162,47,41,31,23,0
60748,607,305,302,92,89,74,23,453,255,198,62,49,29,19,0
60749,680,308,372,82,72,71,40,378,154,224,74,84,35,22,0
60750,747,469,278,60,41,53,23,773,389,384,119,91,79,26,0
60751,1199,589,610,189,128,167,65,87,51,35,15,9,9,4,0
60752,484,264,220,59,62,68,15,299,140,159,49,44,26,11,0
60753,424,170,254,69,56,47,28,127,54,73,11,33,15,6,0
60754,279,127,152,50,36,28,8,384,204,180,53,47,49,17,0
60755,345,203,142,47,35,31,11,102,51,51,12,15,12,3,0
60756,1711,865,846,204,176,105,60,445,202,243,70,73,51,15,0
60757,435,187,248,62,51,51,21,660,332,328,84,73,47,19,0
60758,570,238,332,112,95,39,23,1922,923,999,267,275,215,90,0
60759,329,165,164,61,44,29,17,338,169,169,53,44,39,21,0
60760,213,104,109,56,14,9,2,209,119,90,28,24,27,9,0
60761,2525,1232,1293,398,317,186,61,873,411,462,132,107,84,40,0
60762,2220,1085,1135,312,304,202,91,368,183,185,40,42,40,15,0
60763,782,372,410,127,111,89,36,229,120,109,31,30,22,9,0
60764,836,370,466,126,96,72,30,843,391,452,139,104,91,35,0
60765,193,110,83,18,20,15,12,239,113,126,36,49,20,8,0
60766,472,222,250,46,61,33,23,242,124,118,39,32,28,22,0
60767,649,304,345,99,80,67,40,222,119,103,37,32,24,8,0
60768,1068,434,634,173,160,61,29,381,187,194,37,49,36,17,0
60769,711,330,381,111,86,86,34,975,475,500,139,140,119,28,0
60770,1052,492,560,184,163,103,44,363,180,183,60,34,10,6,0
60771,521,249,272,53,36,50,18,325,172,153,44,34,27,14,0
60772,224,101,123,45,32,21,3,429,187,242,79,72,28,19,0
60773,560,279,281,113,64,58,15,154,78,76,23,21,13,5,0
60774,2649,1431,1218,377,299,266,102,396,199,197,54,50,45,14,0
60775,178,74,104,31,28,9,4,329,194,135,45,32,33,9,0
60776,631,316,315,64,57,49,15,288,156,132,36,36,24,15,0
60777,428,226,202,52,60,75,20,2346,1231,1115,316,292,266,105,0
60778,496,272,224,70,58,42,18,108,59,49,17,13,12,5,0
60779,388,244,144,46,25,42,16,175,82,93,33,26,17,5,0
60780,664,269,395,117,107,36,15,459,260,199,56,42,47,21,0
60781,407,230,177,44,39,34,19,418,223,195,51,45,49,14,0
60782,1447,698,749,214,180,116,46,297,164,133,45,39,40,9,0
60783,428,226,202,52,60,75,20,200,99,101,31,24,26,6,0
60784,704,342,362,113,91,85,33,798,385,413,120,115,79,30,0
60785,4640,2231,2409,660,549,437,245,425,177,248,60,62,33,16,0
60786,1501,679,822,251,196,174,67,1020,538,482,145,115,111,58,0
60787,431,216,215,46,40,33,9,172,88,84,24,31,20,12,0
60788,99,35,64,25,18,0,1,665,361,304,87,91,84,31,0
60789,343,189,154,44,24,39,12,701,380,321,94,84,96,34,0
60790,279,127,152,50,36,28,8,665,361,304,87,91,84,31,0
60791,798,364,434,133,88,74,35,1025,549,476,118,109,88,61,0
60792,422,196,226,52,35,33,20,154,78,76,23,21,13,5,0
60793,682,260,422,153,78,109,46,455,229,226,66,62,63,29,0
60794,305,124,181,27,25,31,21,250,116,134,41,30,33,19,0
60795,972,501,471,125,156,106,39,173,90,83,21,36,12,15,0
60796,579,321,258,74,70,47,22,148,69,79,26,18,16,3,0
60797,805,338,467,109,145,49,25,832,428,404,131,89,88,38,0
60798,1555,702,853,250,199,139,31,708,328,380,113,100,82,34,0
60799,465,220,245,88,34,61,23,478,254,224,67,74,56,28,0
60800,1463,521,942,252,204,105,52,144,67,77,28,14,9,8,0
60801,1341,481,860,275,264,57,21,175,82,93,33,26,17,5,0
60802,180,92,88,29,20,26,8,620,324,296,81,68,66,31,0
60803,99,35,64,25,18,0,1,317,161,156,50,36,47,12,0
60804,126,56,70,31,10,10,3,647,350,297,95,79,77,29,0
60805,743,366,377,41,37,26,14,368,200,168,54,49,43,9,0
60806,640,279,361,102,83,69,21,124,69,55,14,7,9,4,0
60807,586,298,288,80,75,64,37,337,170,167,59,33,47,17,0
60808,1009,487,522,177,121,103,51,91,44,47,9,12,4,7,0
60809,467,233,234,83,37,77,22,536,222,314,101,100,34,22,0
60810,261,137,124,34,23,13,8,278,154,124,42,32,38,7,0
60811,192,91,101,28,21,18,8,565,237,328,75,88,32,11,0
60812,1052,492,560,184,163,103,44,169,85,84,21,14,9,9,0
60813,428,248,180,44,39,28,9,277,163,114,33,24,21,16,0
60814,326,176,150,35,22,29,11,424,179,245,65,67,29,11,0
60815,500,257,243,60,55,27,22,131,55,76,28,9,14,12,0
60816,784,353,431,56,47,26,18,906,455,451,116,105,87,46,0
60817,130,72,58,28,9,7,1,171,94,77,24,28,30,11,0
60818,384,198,186,58,48,37,12,457,242,215,39,46,53,10,0
60819,1189,653,536,152,118,109,56,135,65,70,21,25,15,9,0
60820,338,164,174,45,32,37,13,660,333,327,102,95,69,31,0
60821,493,281,212,56,61,30,13,127,58,69,18,17,10,5,0
60822,200,94,106,33,22,18,8,935,515,420,126,107,73,32,0
60823,729,351,378,111,98,58,18,1114,539,575,145,131,94,56,0
60824,462,228,234,59,47,37,32,153,65,88,28,21,20,8,0
60825,121,69,52,15,18,14,8,406,234,172,63,35,43,10,0
60826,374,187,187,51,52,40,27,430,212,218,88,43,40,20,0
60827,360,188,172,50,50,45,15,465,230,235,68,64,48,24,0
60828,331,165,166,52,34,48,22,2547,1280,1267,331,335,293,118,0
60829,1009,487,522,177,121,103,51,339,175,164,51,49,37,9,0
60830,640,308,332,91,102,49,21,72,32,40,8,2,1,14,0
60831,538,263,275,71,85,44,18,621,273,348,104,102,48,19,0
60832,466,199,267,86,59,32,17,266,150,116,28,28,24,12,0
60833,169,64,105,23,37,11,3,1248,584,664,184,164,155,67,0
60834,67,40,27,10,8,7,6,198,110,88,27,27,24,4,0
60835,246,123,123,40,31,27,7,332,180,152,46,36,28,14,0
60836,457,228,229,64,36,52,21,649,307,342,71,134,45,17,0
60837,490,224,266,80,70,39,32,594,312,282,72,67,73,31,0
60838,802,375,427,133,103,81,41,179,101,78,25,15,13,13,0
60839,586,309,277,81,64,76,25,447,214,233,67,65,62,20,0
60840,170,82,88,32,23,22,8,204,80,124,29,51,10,5,0
60841,1544,738,806,239,217,145,91,405,214,191,53,42,49,20,0
60842,414,195,219,51,60,40,17,194,109,85,23,24,21,9,0
60843,447,236,211,56,52,49,14,72,33,39,8,2,3,12,0
60844,172,82,90,21,35,21,5,165,87,78,24,19,22,9,0
60845,346,173,173,50,56,31,14,285,143,142,45,32,21,17,0
60846,1560,778,782,224,235,132,78,978,536,442,132,107,67,32,0
60847,271,136,135,37,30,18,10,514,262,252,78,58,54,26,0
60848,146,73,73,18,24,17,9,225,114,111,32,29,26,6,0
60849,345,208,137,44,27,33,8,68,36,32,11,8,9,2,0
60850,1709,650,1059,338,286,185,46,317,161,156,40,49,41,11,0
60851,808,366,442,130,133,66,31,180,90,90,31,19,20,8,0
60852,341,175,166,48,43,35,18,234,129,105,31,22,19,17,0
60853,674,318,356,86,139,50,11,349,200,149,41,39,30,20,0
60854,1199,589,610,189,128,167,65,180,108,72,22,22,15,5,0
60855,127,54,73,31,10,11,3,188,101,87,20,18,20,14,0
60856,436,209,227,66,47,52,22,135,65,70,21,25,15,9,0
60857,2136,1063,1073,317,308,223,90,178,99,79,31,19,26,8,0
60858,1138,615,523,142,120,116,57,460,199,261,72,63,60,9,0
60859,429,238,191,47,49,56,29,2346,1231,1115,316,292,266,105,0
60860,241,122,119,27,34,17,16,274,142,132,33,34,18,14,0
60861,575,295,280,89,68,54,18,378,154,224,74,84,35,22,0
60862,586,298,288,80,75,64,37,325,172,153,44,34,27,14,0
60863,1009,487,522,177,121,103,51,138,69,69,28,7,10,10,0
60864,579,246,333,102,79,41,19,405,181,224,71,57,31,12,0
60865,463,250,213,56,45,73,25,326,169,157,51,41,41,12,0
60866,365,222,143,44,24,35,11,400,187,213,56,59,42,20,0
60867,510,269,241,66,67,71,26,230,125,105,29,40,20,6,0
60868,505,201,304,116,58,75,31,538,274,264,84,67,52,35,0
60869,261,137,124,34,23,13,8,418,246,172,52,39,57,10,0
60870,667,366,301,96,55,84,25,773,389,384,119,91,79,26,0
60871,1580,742,838,208,146,144,71,169,84,85,29,19,21,7,0
60872,291,142,149,50,29,35,7,821,394,427,122,117,109,38,0
60873,278,110,168,58,49,29,5,661,325,336,81,75,65,28,0
60874,240,99,141,53,38,29,15,297,164,133,45,39,40,9,0
60875,682,260,422,98,83,42,31,617,314,303,96,68,68,37,0
60876,380,187,193,38,51,30,18,1872,837,1035,280,338,169,80,0
60877,261,130,131,27,41,19,16,125,66,59,24,16,11,5,0
60878,463,250,213,56,45,73,25,889,505,384,107,97,99,30,0
60879,479,227,252,69,48,46,18,1338,720,618,179,145,141,85,0
60880,490,198,292,65,81,39,27,592,249,343,91,90,50,42,0
60881,236,141,95,36,32,14,6,251,143,108,47,25,29,11,0
60882,270,147,123,34,17,39,21,565,237,328,75,88,32,11,0
60883,583,279,304,99,71,59,31,194,109,85,23,24,21,9,0
60884,256,152,104,18,23,23,8,622,344,278,80,77,68,36,0
60885,2649,1431,1218,377,299,266,102,1425,670,755,153,189,122,85,0
60886,166,59,107,36,41,10,4,1395,627,768,172,263,141,59,0
60887,860,348,512,121,136,75,35,374,174,200,54,52,42,21,0
60888,1872,837,1035,280,338,169,80,375,210,165,49,37,29,27,0
60889,308,163,145,38,33,30,20,132,61,71,22,21,15,3,0
60890,640,279,361,102,83,69,21,123,61,62,17,18,17,7,0
60891,272,94,178,76,33,19,4,758,319,439,101,123,78,25,0
60892,456,223,233,77,54,47,20,406,234,172,63,35,43,10,0
60893,2488,1085,1403,346,253,162,76,145,77,68,26,7,15,8,0
60894,325,177,148,40,24,23,13,457,242,215,39,46,53,10,0
60895,264,122,142,46,24,35,10,366,204,162,47,41,31,23,0
60896,1054,497,557,190,168,107,45,72,34,38,8,2,3,12,0
60897,674,268,406,118,96,70,21,1378,692,686,194,174,105,56,0
60898,322,164,158,46,44,29,7,68,23,45,12,9,3,9,0
60899,291,131,160,49,35,32,15,664,350,314,86,90,82,36,0
60900,516,210,306,113,53,81,33,138,69,69,28,7,10,10,0
60901,2285,1219,1066,207,180,178,106,346,178,168,58,41,33,12,0
60902,279,129,150,43,34,17,13,292,143,149,38,42,36,16,0
60903,395,189,206,63,50,49,28,437,224,213,40,29,42,25,0
60904,684,353,331,95,98,77,38,1543,794,749,182,152,132,55,0
60905,2109,999,1110,332,294,187,89,68,36,32,11,8,9,2,0
60906,1004,464,540,143,104,78,55,601,279,322,81,65,27,12,0
60907,309,137,172,51,50,28,14,363,180,183,60,34,10,6,0
60908,2062,706,1356,414,368,158,63,309,159,150,47,43,43,13,0
60909,346,205,141,47,34,30,7,660,333,327,102,95,69,31,0
60910,482,245,237,69,64,66,24,592,249,343,91,90,50,42,0
60911,441,218,223,69,55,50,27,455,191,264,68,86,21,19,0
60912,203,97,106,30,22,18,10,1698,875,823,222,219,173,64,0
60913,1221,597,624,201,152,83,31,417,232,185,58,50,29,21,0
60914,436,209,227,66,47,52,22,422,237,185,53,47,62,20,0
60915,432,233,199,52,28,47,18,104,46,58,15,17,9,5,0
60916,464,237,227,64,66,33,12,225,114,111,32,29,26,6,0
60917,71,39,32,7,11,6,4,690,345,345,96,83,73,42,0
60918,417,222,195,53,39,43,10,516,245,271,82,84,70,26,0
60919,424,170,254,69,56,47,28,227,130,97,32,25,22,12,0
60920,260,138,122,44,30,28,6,588,286,302,78,99,53,25,0
60921,128,70,58,29,9,8,1,178,69,109,29,25,21,13,0
60922,422,207,215,79,38,53,23,201,98,103,28,25,19,13,0
60923,484,264,220,59,62,68,15,106,46,60,29,13,14,5,0
60924,747,360,387,125,92,69,32,432,244,188,51,51,27,14,0
60925,589,282,307,68,67,70,23,136,65,71,26,11,7,5,0
60926,553,276,277,88,61,45,27,277,163,114,33,24,21,16,0
60927,736,320,416,113,97,61,36,2724,1157,1567,269,518,239,77,0
60928,251,131,120,49,35,25,5,418,223,195,53,43,49,15,0
60929,401,204,197,49,33,29,17,218,115,103,32,32,34,11,0
60930,436,209,227,66,47,52,22,188,88,100,53,12,15,6,0
60931,517,196,321,103,98,33,12,309,159,150,47,43,43,13,0
60932,351,166,185,48,61,24,15,607,294,313,94,95,62,14,0
60933,149,78,71,20,20,19,5,134,55,79,22,24,16,6,0
60934,734,366,368,121,99,63,39,132,61,71,19,20,14,6,0
60935,160,53,107,31,29,13,3,664,350,314,86,90,82,36,0
60936,474,250,224,58,47,37,12,748,359,389,125,113,86,31,0
60937,130,70,60,30,9,8,1,164,79,85,28,28,16,7,0
60938,412,203,209,65,47,37,18,439,227,212,60,55,58,8,0
60939,206,100,106,34,26,11,7,332,173,159,48,40,31,11,0
60940,593,282,311,75,70,29,25,693,360,333,100,88,62,26,0
60941,528,188,340,130,58,77,41,308,129,179,44,60,19,8,0
60942,391,203,188,49,34,36,9,471,238,233,66,63,62,19,0
60943,224,108,116,33,26,32,10,390,190,200,66,50,43,12,0
60944,184,93,91,26,25,14,11,479,215,264,67,80,46,28,0
60945,335,148,187,52,26,51,12,204,96,108,31,37,20,5,0
60946,316,157,159,45,38,22,19,108,59,49,17,13,12,5,0
60947,393,223,170,44,36,32,14,86,40,46,16,13,9,7,0
60948,270,131,139,47,37,41,11,417,232,185,58,50,29,21,0
60949,507,314,193,49,45,59,25,947,482,465,143,107,89,37,0
60950,312,173,139,43,47,28,6,133,61,72,21,19,13,4,0
60951,447,236,211,56,52,49,14,662,312,350,103,104,59,20,0
60952,304,149,155,46,32,39,14,555,292,263,75,63,67,27,0
60953,500,297,203,66,33,53,15,406,223,183,61,53,46,17,0
60954,347,154,193,48,51,25,11,724,353,371,94,95,71,31,0
60955,565,264,301,101,73,72,15,96,45,51,13,12,6,4,0
60956,221,75,146,68,21,16,5,215,115,100,27,19,16,7,0
60957,4640,2231,2409,660,549,437,245,482,232,250,77,81,44,13,0
60958,136,66,70,33,11,9,3,607,293,314,98,71,62,32,0
60959,708,344,364,106,98,66,33,404,190,214,55,55,35,27,0
60960,131,69,62,29,9,9,1,417,232,185,58,50,29,21,0
60961,221,114,107,65,7,2,1,403,192,211,102,39,49,15,0
60962,160,53,107,31,29,13,3,132,61,71,22,21,15,3,0
60963,329,171,158,49,41,31,10,689,343,346,105,102,81,35,0
60964,270,128,142,36,43,15,11,387,193,194,60,53,57,15,0
60965,304,149,155,46,32,39,14,1696,771,925,257,225,149,63,0
60966,446,265,181,51,35,27,17,662,373,289,89,80,77,29,0
60967,441,218,223,69,55,50,27,188,88,100,53,12,15,6,0
60968,684,353,331,95,98,77,38,404,190,214,55,55,35,27,0
60969,1590,726,864,270,237,126,59,452,252,200,55,49,61,16,0
60970,784,351,433,118,87,73,41,373,189,184,54,46,50,23,0
60971,822,416,406,111,97,88,42,271,150,121,39,36,37,5,0
60972,55,16,39,24,2,5,2,690,345,345,96,83,73,42,0
60973,368,201,167,61,38,38,12,846,425,421,125,97,98,38,0
60974,290,156,134,44,29,39,9,601,279,322,81,65,27,12,0
60975,648,262,386,113,108,78,29,163,79,84,22,24,13,5,0
60976,509,251,258,69,49,55,17,366,204,162,47,41,31,23,0
60977,756,265,491,129,127,51,17,660,303,357,97,89,85,33,0
60978,798,364,434,133,88,74,35,192,110,82,33,21,10,3,0
60979,949,467,482,126,127,102,51,858,461,397,125,114,79,45,0
60980,361,167,194,55,35,41,11,471,238,233,66,63,62,19,0
60981,510,288,222,44,36,24,7,583,321,262,73,67,45,25,0
60982,193,110,83,18,20,15,12,1922,923,999,267,275,215,90,0
60983,717,381,336,118,103,85,29,320,168,152,38,42,24,18,0
60984,130,71,59,30,9,8,1,306,157,149,52,35,39,16,0
60985,520,261,259,74,52,49,22,374,191,183,40,52,40,16,0
60986,305,124,181,27,25,31,21,175,91,84,19,21,21,10,0
60987,531,284,247,66,42,49,15,187,89,98,36,24,20,6,0
60988,126,58,68,31,10,10,3,943,463,480,91,144,70,30,0
60989,326,148,178,55,42,31,12,557,281,276,80,59,43,21,0
60990,371,209,162,46,17,36,19,285,143,142,45,32,21,17,0
60991,422,196,226,52,35,33,20,106,46,60,27,18,12,3,0
60992,484,192,292,118,68,83,22,474,268,206,66,42,45,24,0
60993,122,56,66,26,13,11,5,285,143,142,45,32,21,17,0
60994,557,250,307,70,47,51,22,106,54,52,12,9,7,6,0
60995,1058,497,561,194,142,87,63,326,169,157,51,41,41,12,0
60996,428,226,202,52,60,75,20,665,361,304,87,91,84,31,0
60997,389,176,213,81,59,24,7,320,168,152,38,42,24,18,0
60998,144,57,87,38,26,10,4,286,152,134,38,38,32,11,0
60999,648,262,386,113,108,78,29,389,207,182,53,58,52,18,0
61000,204,93,111,35,35,16,11,346,196,150,43,26,27,14,0
61001,238,158,80,28,15,31,7,180,90,90,31,19,20,8,0
61002,426,231,195,51,52,45,24,549,273,276,74,68,72,24,0
61003,1161,514,647,159,138,122,37,562,273,289,76,92,45,24,0
61004,414,206,208,56,68,35,19,316,159,157,38,48,30,11,0
61005,437,228,209,47,61,26,11,207,114,93,33,20,31,13,0
61006,364,168,196,64,61,27,6,516,245,271,82,84,70,26,0
61007,1163,417,746,209,145,87,28,132,77,55,20,9,13,10,0
61008,929,410,519,187,146,53,30,166,90,76,27,18,21,5,0
61009,282,135,147,27,37,30,19,729,358,371,116,99,89,33,0
61010,399,196,203,62,45,38,19,367,218,149,45,43,42,16,0
61011,1120,436,684,208,120,101,115,370,173,197,65,57,42,10,0
61012,420,189,231,79,67,33,17,403,233,170,38,29,21,14,0
61013,260,138,122,44,30,28,6,86,40,46,16,13,9,7,0
61014,118,51,67,25,13,6,7,1034,495,539,150,134,114,71,0
61015,437,228,209,47,61,26,11,132,61,71,19,20,14,6,0
61016,734,339,395,135,89,78,36,479,215,264,67,80,46,28,0
61017,125,46,79,24,16,12,2,528,276,252,86,78,49,17,0
61018,453,240,213,53,33,44,16,392,186,206,62,56,29,15,0
61019,469,221,248,49,60,55,21,204,80,124,29,51,10,5,0
61020,136,66,70,33,11,9,5,323,168,155,51,41,38,12,0
61021,859,411,448,118,100,95,49,277,144,133,42,30,41,8,0
61022,715,345,370,110,97,64,25,720,357,363,113,85,62,39,0
61023,359,204,155,39,36,34,13,125,66,59,24,16,11,5,0
61024,461,257,204,63,49,50,29,173,86,87,30,22,19,12,0
61025,837,381,456,123,109,65,25,106,46,60,27,18,12,3,0
61026,415,217,198,50,31,42,17,163,79,84,22,24,13,5,0
61027,213,88,125,21,54,14,15,408,221,187,55,51,57,14,0
61028,235,100,135,36,25,30,8,609,335,274,79,57,45,22,0
61029,1171,542,629,170,146,114,64,375,209,166,50,37,29,23,0
61030,258,144,114,33,22,19,9,1696,771,925,257,225,149,63,0
61031,272,141,131,45,29,36,9,547,295,252,81,65,57,23,0
61032,615,308,307,83,75,58,32,278,154,124,42,32,38,7,0
61033,490,224,266,80,70,39,32,328,195,133,39,40,27,13,0
61034,529,290,239,54,63,85,15,396,223,173,57,37,44,19,0
61035,1759,838,921,269,212,191,92,729,358,371,116,99,89,33,0
61036,443,212,231,74,24,60,24,673,313,360,102,101,46,17,0
61037,422,207,215,79,38,53,23,374,174,200,54,52,42,21,0
61038,603,311,292,102,71,66,23,200,89,111,26,25,17,7,0
61039,250,123,127,40,28,29,8,457,253,204,67,51,48,13,0
61040,203,97,106,30,22,18,10,432,244,188,51,51,27,14,0
61041,365,148,217,86,37,51,28,91,44,47,9,12,4,7,0
61042,347,212,135,35,32,17,6,300,148,152,45,43,40,8,0
61043,242,104,138,41,33,37,8,1061,543,518,146,123,109,67,0
61044,756,265,491,129,127,51,17,73,35,38,14,10,9,4,0
61045,1143,574,569,176,151,123,59,139,68,71,14,26,14,9,0
61046,785,325,460,114,123,61,28,144,67,77,28,14,9,8,0
61047,860,349,511,166,166,58,19,866,397,469,117,153,95,48,0
61048,525,254,271,60,76,46,13,704,355,349,113,94,71,24,0
61049,1835,904,931,192,144,135,63,2346,1231,1115,316,292,266,105,0
61050,139,81,58,17,14,24,9,348,194,154,57,31,43,12,0
61051,747,360,387,125,92,69,32,127,64,63,26,8,12,8,0
61052,347,154,193,48,51,25,11,139,68,71,14,26,14,9,0
61053,813,412,401,114,93,112,26,427,251,176,51,39,25,22,0
61054,486,243,243,65,48,63,22,866,397,469,117,153,95,48,0
61055,1235,584,651,140,226,82,52,101,59,42,11,17,10,1,0
61056,109,50,59,12,12,9,3,708,328,380,113,100,82,34,0
61057,320,163,157,44,44,26,15,205,94,111,48,31,15,6,0
61058,3703,1708,1995,456,428,305,162,165,87,78,24,19,22,9,0
61059,2525,1232,1293,398,317,186,61,1314,693,621,174,155,140,58,0
61060,1711,865,846,204,176,105,60,307,132,175,48,53,26,10,0
61061,381,146,235,74,48,47,34,166,90,76,27,18,21,5,0
61062,416,207,209,63,47,56,15,561,279,282,85,81,88,24,0
61063,329,168,161,48,34,41,16,354,188,166,46,40,34,10,0
61064,240,98,142,49,42,23,17,1034,495,539,150,134,114,71,0
61065,521,289,232,71,58,49,16,175,82,93,33,26,17,5,0
61066,763,354,409,101,90,63,26,749,384,365,108,105,86,31,0
61067,426,214,212,63,47,53,20,267,141,126,53,27,23,7,0
61068,531,260,271,97,68,47,11,535,288,247,79,72,35,21,0
61069,595,339,256,64,36,54,24,148,69,79,26,18,16,3,0
61070,1001,422,579,185,180,51,32,498,244,254,81,67,58,19,0
61071,331,169,162,40,28,22,14,392,155,237,68,61,34,16,0
61072,488,237,251,79,78,65,27,403,225,178,56,38,33,25,0
61073,227,109,118,42,35,29,8,335,170,165,52,36,47,11,0
61074,149,68,81,15,38,11,10,585,277,308,92,73,61,32,0
61075,341,183,158,36,34,36,15,89,38,51,14,6,3,9,0
61076,840,411,429,122,101,79,34,165,87,78,24,19,22,9,0
61077,535,315,220,57,55,71,19,166,102,64,19,14,17,2,0
61078,227,109,118,42,35,29,8,246,107,139,55,33,27,11,0
61079,344,109,235,100,39,26,5,194,94,100,33,28,14,7,0
61080,514,226,288,71,66,63,32,555,292,263,75,63,67,27,0
61081,109,50,59,12,12,9,3,231,126,105,28,26,34,9,0
61082,2414,1189,1225,277,178,170,169,335,186,149,40,28,29,13,0
61083,673,317,356,101,85,76,49,127,66,61,13,14,19,8,0
61084,235,100,135,36,25,30,8,188,90,98,44,7,21,7,0
61085,439,241,198,67,40,40,13,1241,619,622,183,169,155,59,0
61086,485,246,239,74,48,47,22,501,240,261,80,62,49,42,0
61087,319,153,166,61,52,26,12,461,223,238,45,62,18,35,0
61088,2442,1193,1249,278,183,170,145,274,157,117,40,29,40,8,0
61089,473,212,261,72,64,45,28,972,471,501,152,138,112,40,0
61090,347,212,135,35,32,17,6,296,151,145,45,42,32,11,0
61091,525,302,223,56,48,67,19,406,223,183,61,53,46,17,0
61092,428,226,202,52,60,75,20,588,286,302,78,99,53,25,0
61093,1087,523,564,146,177,103,33,517,295,222,69,62,40,28,0
61094,636,288,348,94,77,65,30,270,162,108,26,26,16,11,0
61095,206,100,106,34,26,11,7,392,155,237,68,61,34,16,0
61096,164,77,87,33,19,6,7,536,267,269,60,70,41,22,0
61097,172,98,74,20,21,22,8,405,181,224,71,57,31,12,0
61098,217,98,119,38,35,18,9,1230,644,586,198,125,123,61,0
61099,246,111,135,64,47,27,3,363,180,183,60,34,10,6,0
61100,178,87,91,20,32,13,10,1265,689,576,169,177,128,60,0
61101,2488,1085,1403,346,253,162,76,424,179,245,65,67,29,11,0
61102,449,179,270,80,77,49,29,1020,538,482,145,115,111,58,0
61103,509,251,258,69,49,55,17,663,354,309,91,84,79,31,0
61104,1970,978,992,245,206,198,80,89,38,51,14,6,3,9,0
61105,328,195,133,36,23,35,9,178,99,79,31,19,26,8,0
61106,364,168,196,64,61,27,6,898,469,429,125,125,134,35,0
61107,529,290,239,54,63,85,15,483,287,196,71,50,54,17,0
61108,553,276,277,88,61,45,27,124,69,55,14,7,9,4,0
61109,1139,537,602,162,139,109,50,1020,538,482,145,115,111,58,0
61110,784,351,433,118,87,73,41,452,254,198,72,57,38,18,0
61111,376,171,205,45,45,34,12,1166,514,652,150,159,107,70,0
61112,1441,504,937,264,329,69,46,325,172,153,44,34,27,14,0
61113,282,96,186,80,21,28,7,761,351,410,117,73,103,45,0
61114,2649,1431,1218,377,299,266,102,179,101,78,25,15,13,13,0
61115,150,64,86,22,12,29,12,201,98,103,28,25,19,13,0
61116,1284,511,773,227,166,169,107,663,360,303,87,82,80,35,0
61117,484,264,220,59,62,68,15,403,192,211,102,39,49,15,0
61118,282,160,122,36,28,27,7,501,274,227,63,58,53,20,0
61119,1030,567,463,118,106,94,49,517,295,222,69,62,40,28,0
61120,435,222,213,67,49,67,12,180,108,72,22,22,15,5,0
61121,496,274,222,57,43,75,22,783,406,377,102,91,57,29,0
61122,297,161,136,36,35,24,9,322,180,142,45,38,28,7,0
61123,733,382,351,126,92,93,27,127,66,61,13,14,19,8,0
61124,301,150,151,45,47,33,13,165,87,78,24,19,22,9,0
61125,407,164,243,88,42,40,22,621,273,348,104,102,48,19,0
61126,351,166,185,48,61,24,15,720,357,363,113,85,62,39,0
61127,1970,978,992,245,206,198,80,137,72,65,27,13,15,8,0
61128,125,46,79,24,16,12,2,101,59,42,11,17,10,1,0
61129,167,70,97,32,20,15,7,2547,1280,1267,331,335,293,118,0
61130,446,283,163,51,26,33,19,647,350,297,95,79,77,29,0
61131,424,170,254,69,56,47,28,173,90,83,21,36,12,15,0
61132,130,70,60,30,9,8,1,403,233,170,38,29,21,14,0
61133,302,178,124,34,29,50,13,127,54,73,11,33,15,6,0
61134,284,160,124,37,23,32,11,198,86,112,36,27,23,9,0
61135,485,237,248,83,35,52,24,535,301,234,63,48,47,27,0
61136,361,167,194,55,35,41,11,395,198,197,55,55,36,10,0
61137,121,69,52,15,18,14,8,519,287,232,68,58,45,21,0
61138,1501,679,822,251,196,174,67,498,244,254,81,67,58,19,0
61139,475,235,240,77,58,43,22,1101,626,475,145,122,120,50,0
61140,473,212,261,72,64,45,28,261,148,113,31,28,14,10,0
61141,127,54,73,31,10,11,3,172,88,84,24,31,20,12,0
61142,435,230,205,51,37,55,18,415,203,212,77,44,49,18,0
61143,240,167,73,32,12,8,21,127,58,69,18,17,10,5,0
61144,311,154,157,47,29,34,13,475,251,224,67,49,48,23,0
61145,76,30,46,7,15,1,5,127,54,73,11,33,15,6,0
61146,258,144,114,33,22,19,9,96,45,51,13,12,6,4,0
61147,221,80,141,48,37,14,10,370,173,197,65,57,42,10,0
61148,463,250,213,56,45,73,25,699,334,365,108,80,70,20,0
61149,763,371,392,104,88,52,23,843,391,452,139,104,91,35,0
61150,535,315,220,57,55,71,19,102,51,51,12,15,12,3,0
61151,210,101,109,33,33,19,9,535,288,247,79,72,35,21,0
61152,862,384,478,127,110,75,42,1004,457,547,150,150,74,52,0
61153,267,146,121,40,24,25,7,662,312,350,103,104,59,20,0
61154,392,205,187,83,49,38,10,278,154,124,42,32,38,7,0
61155,2136,1063,1073,317,308,223,90,499,239,260,73,75,34,19,0
61156,128,67,61,29,9,9,1,2382,1162,1220,237,220,140,49,0
61157,704,342,362,113,91,85,33,445,202,243,70,73,51,15,0
61158,125,46,79,24,16,12,2,518,292,226,60,60,52,21,0
61159,308,129,179,44,60,19,8,295,156,139,41,40,42,15,0
61160,255,126,129,41,37,13,5,425,177,248,60,62,33,16,0
61161,1014,488,526,178,137,94,39,305,163,142,38,27,47,11,0
61162,467,233,234,83,37,77,22,629,317,312,80,87,51,22,0
61163,733,382,351,126,92,93,27,339,180,159,36,29,16,16,0
61164,397,180,217,61,59,39,13,277,163,114,33,24,21,16,0
61165,156,64,92,31,19,5,4,381,186,195,69,55,46,15,0
61166,181,92,89,34,22,17,9,892,475,417,130,108,68,38,0
61167,756,362,394,102,104,73,25,375,211,164,50,36,31,23,0
61168,929,410,519,187,146,53,30,153,65,88,28,21,20,8,0
61169,904,436,468,138,146,82,39,173,94,79,18,24,12,7,0
61170,536,237,299,116,87,42,17,663,360,303,87,82,80,35,0
61171,117,57,60,17,14,11,10,137,63,74,20,22,14,6,0
61172,813,412,401,114,93,112,26,346,196,150,43,26,27,14,0
61173,462,258,204,59,41,56,15,773,389,384,119,91,79,26,0
61174,598,322,276,67,57,63,26,423,234,189,66,44,57,12,0
61175,640,271,369,111,79,57,17,471,238,233,66,63,62,19,0
61176,528,273,255,67,53,29,20,250,116,134,41,30,33,19,0
61177,314,158,156,39,28,30,17,283,142,141,41,33,26,18,0
61178,726,312,414,121,73,82,23,775,407,368,122,100,97,32,0
61179,625,283,342,93,89,67,25,783,406,377,102,91,57,29,0
61180,260,120,140,34,39,36,12,335,186,149,40,28,29,13,0
61181,284,128,156,48,29,34,8,1025,549,476,118,109,88,61,0
61182,1580,742,838,208,146,144,71,846,425,421,125,97,98,38,0
61183,760,322,438,81,130,57,19,87,51,35,15,9,9,4,0
61184,753,361,392,99,94,66,16,317,153,164,34,52,30,14,0
61185,794,322,472,122,108,79,34,194,94,100,33,28,14,7,0
61186,1130,614,516,129,138,98,42,257,126,131,61,24,22,8,0
61187,313,158,155,43,35,43,16,644,343,301,96,69,59,28,0
61188,435,225,210,58,46,50,14,96,46,50,16,12,7,5,0
61189,228,82,146,45,37,18,8,227,130,97,32,25,22,12,0
61190,494,233,261,87,57,46,18,644,343,301,96,69,59,28,0
61191,127,54,73,31,10,11,3,403,192,211,102,39,49,15,0
61192,476,254,222,58,33,46,23,704,355,349,113,94,71,24,0
61193,437,212,225,66,44,44,11,963,525,438,119,102,102,34,0
61194,380,187,193,38,51,30,18,203,98,105,34,29,19,10,0
61195,250,123,127,40,28,29,8,487,252,235,79,58,55,26,0
61196,536,287,249,64,73,21,27,296,159,137,49,28,38,13,0
61197,794,322,472,122,108,79,34,391,189,202,55,56,56,12,0
61198,587,318,269,76,50,38,21,137,78,59,22,16,17,4,0
61199,329,171,158,49,41,31,10,471,238,233,66,63,62,19,0
61200,538,263,275,71,85,44,18,398,200,198,68,43,51,14,0
61201,1417,598,819,223,188,135,58,1262,653,609,169,165,152,50,0
61202,388,209,179,46,24,31,28,621,273,348,104,102,48,19,0
61203,177,100,77,22,17,20,11,565,264,301,101,73,72,15,0
61204,2220,1085,1135,312,304,202,91,531,261,270,73,80,68,26,0
61205,240,99,141,53,38,29,15,627,289,338,101,73,62,43,0
61206,331,165,166,52,34,48,22,483,258,225,70,53,54,20,0
61207,407,207,200,53,36,38,8,132,77,55,20,9,13,10,0
61208,711,330,381,111,86,86,34,723,353,370,120,109,96,33,0
61209,798,364,434,133,88,74,35,1265,689,576,169,177,128,60,0
61210,378,202,176,34,32,44,13,103,50,53,19,10,7,5,0
61211,420,189,231,79,67,33,17,445,192,253,86,58,53,18,0
61212,535,217,318,87,106,41,14,332,180,152,44,36,27,13,0
61213,682,292,390,89,69,58,20,218,115,103,37,33,33,9,0
61214,452,217,235,59,47,60,20,227,130,97,32,25,22,12,0
61215,1200,602,598,145,116,110,50,873,411,462,132,107,84,40,0
61216,240,167,73,32,12,8,21,178,99,79,31,19,26,8,0
61217,593,282,311,75,70,29,25,487,252,235,79,58,55,26,0
61218,389,176,213,81,59,24,7,535,301,234,63,48,47,27,0
61219,674,318,356,86,139,50,11,530,287,243,79,70,33,26,0
61220,717,281,436,165,81,112,49,437,224,213,40,29,42,25,0
61221,1360,644,716,213,194,136,62,947,482,465,143,107,89,37,0
61222,315,174,141,46,38,47,16,605,283,322,94,72,64,39,0
61223,269,127,142,43,24,34,26,406,234,172,63,35,43,10,0
61224,180,57,123,39,22,10,8,154,78,76,23,21,13,5,0
61225,618,289,329,97,86,70,17,252,130,122,45,23,32,11,0
61226,434,216,218,72,58,40,20,136,65,71,26,11,7,5,0
61227,494,242,252,67,47,25,21,350,196,154,52,37,21,14,0
61228,130,71,59,30,9,8,1,323,171,152,48,41,40,16,0
61229,456,223,233,77,54,47,20,160,76,84,19,24,8,5,0
61230,249,104,145,47,41,24,17,196,105,91,40,13,19,10,0
61231,684,353,331,95,98,77,38,640,364,276,84,68,69,33,0
61232,1341,481,860,275,264,57,21,173,94,79,18,24,12,7,0
61233,372,189,183,60,44,41,18,775,407,368,122,100,97,32,0
61234,556,279,277,83,69,71,19,114,64,50,16,19,14,5,0
61235,580,308,272,82,79,58,25,514,262,252,78,58,54,26,0
61236,450,241,209,67,58,54,23,149,68,81,15,38,11,10,0
61237,98,32,66,15,25,5,4,2724,1157,1567,269,518,239,77,0
61238,119,67,52,15,15,7,7,862,409,453,149,125,86,29,0
61239,859,411,448,118,100,95,49,234,129,105,31,22,19,17,0
61240,328,156,172,44,37,44,15,947,482,465,143,107,89,37,0
61241,86,50,36,9,14,8,7,562,273,289,76,92,45,24,0
61242,755,271,484,113,226,61,20,811,361,450,124,107,80,31,0
61243,488,237,251,79,78,65,27,662,312,350,103,104,59,20,0
61244,508,251,257,74,53,51,18,943,463,480,91,144,70,30,0
61245,215,117,98,28,19,15,8,194,109,85,23,24,21,9,0
61246,157,62,95,41,18,10,11,452,254,198,72,57,38,18,0
61247,963,477,486,134,143,123,38,279,142,137,43,39,28,7,0
61248,462,258,204,59,41,56,15,290,147,143,34,34,39,13,0
61249,256,152,104,18,23,23,8,173,86,87,30,22,19,12,0
61250,1284,511,773,227,166,169,107,417,232,185,58,50,29,21,0
61251,349,153,196,54,47,28,13,290,147,143,34,34,39,13,0
61252,513,276,237,73,43,57,24,132,67,65,24,21,8,10,0
61253,485,237,248,83,35,52,24,524,300,223,70,54,51,25,0
61254,412,203,209,65,47,37,18,156,90,66,17,22,11,10,0
61255,463,225,238,76,36,59,26,171,94,77,24,28,30,11,0
61256,431,202,229,57,50,50,25,866,397,469,117,153,95,48,0
61257,439,205,234,64,88,41,21,396,197,199,75,49,49,16,0
61258,1030,567,463,118,106,94,49,390,223,167,58,36,45,18,0
61259,283,112,171,48,39,34,15,172,88,84,24,31,20,12,0
61260,420,189,231,79,67,33,17,1062,522,540,151,147,105,66,0
61261,288,142,146,52,32,26,8,418,246,172,52,39,57,10,0
61262,2048,855,1193,297,287,191,93,1543,794,749,182,152,132,55,0
61263,429,227,202,49,51,46,26,497,257,240,71,63,62,16,0
61264,280,128,152,39,37,38,18,1471,709,762,198,184,154,62,0
61265,456,223,233,77,54,47,20,196,105,91,40,13,19,10,0
61266,242,111,131,35,35,17,13,457,242,215,39,46,53,10,0
61267,380,148,232,81,69,24,8,783,406,377,102,91,57,29,0
61268,2446,1099,1347,363,294,233,100,704,355,349,113,94,71,24,0
61269,217,98,119,38,35,18,9,153,80,73,26,18,19,4,0
61270,502,236,266,66,66,58,17,352,207,145,40,33,25,21,0
61271,130,70,60,30,9,8,1,132,77,55,20,9,13,10,0
61272,470,163,307,99,68,73,30,504,272,232,75,57,53,19,0
61273,350,172,178,61,45,32,13,858,398,460,126,138,75,39,0
61274,164,77,87,33,19,6,7,419,233,186,54,53,55,17,0
61275,867,415,452,123,87,62,27,821,394,427,122,117,109,38,0
61276,815,356,459,128,125,82,26,415,203,212,77,44,49,18,0
61277,203,80,123,40,37,20,3,437,224,213,40,29,42,25,0
61278,464,237,227,64,66,33,12,1239,659,580,169,148,131,54,0
61279,837,381,456,123,109,65,25,1500,804,696,190,172,144,60,0
61280,439,205,234,64,88,41,21,132,61,71,19,20,14,6,0
61281,822,416,406,111,97,88,42,415,189,226,68,54,50,21,0
61282,329,171,158,49,41,31,10,598,333,265,79,66,54,33,0
61283,2442,1193,1249,278,183,170,145,671,321,350,95,87,75,34,0
61284,347,212,135,35,32,17,6,483,287,196,71,50,54,17,0
61285,755,271,484,113,226,61,20,381,186,195,69,55,46,15,0
61286,610,249,361,107,69,72,33,218,115,103,37,33,33,9,0
61287,505,201,304,116,58,75,31,188,90,98,44,7,21,7,0
61288,428,248,180,44,39,28,9,402,186,216,64,47,38,20,0
61289,312,164,148,54,29,25,15,180,115,65,17,12,9,9,0
61290,269,124,145,36,24,32,11,963,525,438,119,102,102,34,0
61291,335,155,180,64,48,36,10,556,290,266,75,74,29,24,0
61292,130,72,58,28,9,7,1,246,107,139,55,33,27,11,0
61293,320,183,137,51,18,38,8,455,229,226,66,62,63,29,0
61294,300,136,164,45,35,45,14,627,289,338,101,73,62,43,0
61295,941,459,482,167,140,82,38,748,359,389,125,113,86,31,0
61296,1023,449,574,141,174,76,43,455,191,264,68,86,21,19,0
61297,1689,821,868,277,250,177,78,319,185,134,42,31,22,13,0
61298,5890,3314,2576,970,956,293,265,295,160,135,44,36,46,16,0
61299,1148,472,676,229,164,86,37,169,85,84,21,14,9,9,0
61300,234,110,124,39,29,23,2,866,478,388,121,101,101,26,0
61301,136,66,70,33,11,9,4,89,37,52,13,6,2,9,0
61302,443,212,231,74,24,60,24,178,69,109,29,25,21,13,0
61303,436,201,235,54,37,35,18,360,180,180,57,48,39,12,0
61304,526,268,258,54,37,55,12,748,359,389,125,113,86,31,0
61305,1594,660,934,251,272,117,77,196,105,91,40,13,19,10,0
61306,193,95,98,33,17,25,17,262,129,133,40,41,31,10,0
61307,332,173,159,48,42,42,9,515,276,239,62,59,43,31,0
61308,217,98,119,38,35,18,9,437,221,216,62,64,47,13,0
61309,271,136,135,37,30,18,10,262,129,133,40,41,31,10,0
61310,215,80,135,54,56,21,9,305,163,142,38,27,47,11,0
61311,802,430,372,65,102,87,23,1696,771,925,257,225,149,63,0
61312,258,126,132,38,22,29,8,283,142,141,41,33,26,18,0
61313,280,156,124,36,19,20,13,363,180,183,60,34,10,6,0
61314,341,175,166,48,43,35,18,152,71,81,41,16,14,2,0
61315,556,306,250,69,60,80,18,538,274,264,84,67,52,35,0
61316,336,199,137,46,22,51,13,517,295,222,69,62,40,28,0
61317,739,389,350,129,61,69,25,87,38,49,23,10,10,9,0
61318,243,100,143,58,50,24,5,517,295,222,69,62,40,28,0
61319,760,322,438,81,130,57,19,501,274,227,63,58,53,20,0
61320,588,267,321,99,79,87,28,374,191,183,40,52,40,16,0
61321,126,56,70,31,10,10,3,459,260,199,56,42,47,21,0
61322,496,272,224,70,58,42,18,73,35,38,14,10,9,4,0
61323,417,222,195,53,39,43,10,194,94,100,33,28,14,7,0
61324,224,108,116,31,32,22,8,432,244,188,51,51,27,14,0
61325,126,58,68,31,10,10,3,690,345,345,96,83,73,42,0
61326,360,175,185,73,36,27,7,283,142,141,41,33,26,18,0
61327,764,277,487,158,162,64,31,106,41,65,36,6,11,7,0
61328,222,110,112,43,30,14,6,94,45,49,11,20,10,4,0
61329,308,163,145,38,33,30,20,792,398,394,109,96,90,39,0
61330,496,272,224,70,58,42,18,189,105,84,25,26,21,9,0
61331,410,211,199,55,42,34,27,326,149,177,51,51,28,10,0
61332,328,156,172,44,37,44,15,434,213,221,77,62,53,12,0
61333,507,242,265,53,44,31,22,421,222,199,69,50,60,18,0
61334,1867,973,894,256,222,194,65,296,140,156,49,40,42,19,0
61335,451,278,173,71,35,58,12,515,276,239,62,59,43,31,0
61336,297,161,136,36,35,24,9,201,117,83,22,21,19,9,0
61337,206,96,110,33,25,8,6,497,257,240,71,63,62,16,0
61338,292,102,190,71,27,51,21,690,345,345,96,83,73,42,0
61339,595,208,387,157,60,91,48,384,212,172,44,43,34,14,0
61340,220,113,107,37,24,16,7,1004,464,540,143,104,78,55,0
61341,860,348,512,121,136,75,35,286,152,134,38,38,32,11,0
61342,346,173,173,50,56,31,14,406,223,183,61,53,46,17,0
61343,446,283,163,51,26,33,19,172,88,84,24,31,20,12,0
61344,522,302,220,61,49,75,19,384,212,172,44,43,34,14,0
61345,781,316,465,130,129,65,23,323,168,155,51,41,38,12,0
61346,124,58,66,20,28,11,7,165,87,78,24,19,22,9,0
61347,772,332,440,136,104,72,28,306,157,149,52,35,39,16,0
61348,398,186,212,76,70,18,13,441,189,252,73,50,47,23,0
61349,107,53,54,15,15,13,4,137,72,65,27,13,15,8,0
61350,431,216,215,46,40,33,9,204,80,124,29,51,10,5,0
61351,193,90,103,44,9,19,13,188,101,87,20,18,20,14,0
61352,553,319,234,56,37,54,18,294,146,148,50,45,51,15,0
61353,616,304,312,75,71,55,25,526,266,260,76,75,53,22,0
61354,1327,520,807,241,174,141,60,528,276,252,86,78,49,17,0
61355,258,130,128,44,37,29,10,469,225,244,64,68,25,11,0
61356,107,36,71,27,15,0,1,564,264,300,79,84,65,26,0
61357,251,131,120,49,35,25,5,708,328,380,113,100,82,34,0
61358,327,174,153,42,35,16,12,673,313,360,102,101,46,17,0
61359,256,152,104,18,23,23,8,1395,627,768,172,263,141,59,0
61360,505,282,223,60,57,66,23,467,240,227,65,65,51,23,0
61361,588,300,288,100,57,65,27,334,181,153,56,31,28,18,0
61362,860,349,511,166,166,58,19,199,92,107,34,30,18,9,0
61363,803,358,445,135,117,80,43,504,272,232,75,57,53,19,0
61364,119,59,60,29,10,6,4,862,426,436,113,115,84,37,0
61365,531,284,247,66,42,49,15,399,190,209,61,41,39,18,0
61366,508,136,372,157,91,22,9,152,71,81,41,16,14,2,0
61367,103,56,47,27,7,8,2,611,314,297,79,75,78,22,0
61368,257,122,135,44,19,21,16,663,354,309,91,84,79,31,0
61369,536,287,249,64,73,21,27,375,210,165,49,37,29,27,0
61370,213,113,100,26,21,26,12,139,68,71,14,26,14,9,0
61371,674,318,356,86,139,50,11,314,177,137,34,40,29,9,0
61372,366,190,176,39,62,55,14,367,218,149,45,43,42,16,0
61373,525,254,271,60,76,46,13,335,170,165,52,36,47,11,0
61374,126,56,70,31,10,10,3,2547,1280,1267,331,335,293,118,0
61375,350,178,172,49,62,29,16,1338,720,618,179,145,141,85,0
61376,291,142,149,50,29,35,7,106,46,60,27,18,12,3,0
61377,593,282,311,75,70,29,25,261,148,113,31,28,14,10,0
61378,222,110,112,43,30,14,6,858,461,397,125,114,79,45,0
61379,959,496,463,144,132,75,35,1425,670,755,153,189,122,85,0
61380,1130,614,516,129,138,98,42,260,131,129,42,31,40,9,0
61381,490,224,266,80,70,39,32,452,252,200,55,49,61,16,0
61382,350,178,172,49,62,29,16,1040,564,476,134,110,114,51,0
61383,567,256,311,91,81,53,17,621,310,311,100,106,77,27,0
61384,756,265,491,129,127,51,17,1230,644,586,198,125,123,61,0
61385,332,172,160,50,33,35,9,169,85,84,21,14,9,9,0
61386,510,269,241,66,67,71,26,142,65,77,30,17,22,9,0
61387,344,109,235,100,39,26,5,341,170,171,41,66,27,10,0
61388,1107,601,506,155,138,103,49,201,99,102,34,26,23,6,0
61389,222,108,114,37,20,25,12,758,319,439,101,123,78,25,0
61390,308,129,179,44,60,19,8,354,183,171,54,43,49,8,0
61391,86,50,36,9,14,8,7,331,180,151,46,35,47,17,0
61392,136,66,70,33,11,9,5,326,149,177,51,51,28,10,0
61393,828,368,460,118,98,59,38,336,200,136,34,29,25,24,0
61394,395,195,200,41,55,23,10,710,375,335,95,94,110,28,0
61395,1531,649,882,108,122,93,72,296,140,156,49,40,42,19,0
61396,312,164,148,54,29,25,15,285,146,139,41,41,48,13,0
61397,505,201,304,116,58,75,31,551,226,325,96,103,43,11,0
61398,166,59,107,36,41,10,4,457,242,215,39,46,53,10,0
61399,90,54,36,20,4,14,5,715,348,367,109,84,68,30,0
61400,399,220,179,48,37,68,18,328,199,129,39,29,27,14,0
61401,1042,529,513,161,151,103,52,245,137,108,34,30,19,10,0
61402,580,265,315,97,89,79,17,374,174,200,54,52,42,21,0
61403,193,107,86,13,20,13,6,1004,457,547,150,150,74,52,0
61404,346,168,178,36,43,20,9,368,204,164,43,35,30,24,0
61405,820,333,487,202,152,59,23,378,154,224,74,84,35,22,0
61406,376,176,200,31,53,27,8,334,182,152,45,41,27,13,0
61407,766,336,430,133,97,79,21,406,223,183,61,53,46,17,0
61408,932,575,357,94,69,76,40,265,134,131,48,34,33,15,0
61409,584,340,244,77,60,47,25,1034,495,539,150,134,114,71,0
61410,338,139,199,54,54,18,11,928,440,488,111,157,82,35,0
61411,336,199,137,46,22,51,13,288,156,132,36,36,24,15,0
61412,249,104,145,47,41,24,17,329,196,133,41,36,31,15,0
61413,301,119,182,53,47,14,20,975,400,575,160,162,62,31,0
61414,553,276,277,88,61,45,27,360,180,180,57,48,39,12,0
61415,2799,1324,1475,369,371,215,124,406,223,183,61,53,46,17,0
61416,963,477,486,134,143,123,38,252,130,122,45,23,32,11,0
61417,1186,495,691,182,208,88,32,627,289,338,101,73,62,43,0
61418,456,214,242,76,62,52,22,295,160,135,44,36,46,16,0
61419,4128,2104,2024,581,505,453,205,1922,923,999,267,275,215,90,0
61420,71,39,32,7,11,6,4,496,285,211,62,54,46,22,0
61421,359,167,192,49,37,27,19,1321,653,668,186,195,70,35,0
61422,469,253,216,49,51,48,18,621,273,348,104,102,48,19,0
61423,124,58,66,20,28,11,7,309,164,145,35,47,30,11,0
61424,856,429,427,113,105,96,24,418,223,195,53,43,49,15,0
61425,485,237,248,83,35,52,24,439,231,208,65,51,55,17,0
61426,565,264,301,101,73,72,15,89,37,52,13,6,2,9,0
61427,479,227,252,69,48,46,18,902,499,403,118,117,92,35,0
61428,436,201,235,54,37,35,18,144,67,77,28,14,9,8,0
61429,575,305,270,74,87,73,25,579,285,294,78,72,64,32,0
61430,548,310,238,72,62,54,13,175,91,84,19,21,21,10,0
61431,310,141,169,36,38,20,8,1500,804,696,190,172,144,60,0
61432,622,354,268,89,60,64,18,271,150,121,39,36,37,5,0
61433,240,167,73,32,12,8,21,452,252,200,55,49,61,16,0
61434,360,205,155,35,24,52,14,199,105,94,27,27,28,9,0
61435,384,196,188,42,43,32,20,1471,709,762,198,184,154,62,0
61436,132,66,66,21,18,11,7,463,268,195,59,46,46,21,0
61437,853,400,453,137,109,88,42,175,82,93,33,26,17,5,0
61438,425,220,205,60,55,45,18,1025,549,476,118,109,88,61,0
61439,618,289,329,97,86,70,17,464,236,228,64,56,53,28,0
61440,313,148,165,45,33,36,11,374,202,172,50,39,31,24,0
61441,210,101,109,33,33,19,9,925,439,486,141,134,105,46,0
61442,149,78,71,20,20,19,5,536,251,285,75,79,60,23,0
61443,397,180,217,61,59,39,13,335,186,149,40,28,29,13,0
61444,332,172,160,50,33,35,9,303,137,166,54,54,31,15,0
61445,384,198,186,58,48,37,12,250,116,134,41,30,33,19,0
61446,862,384,478,127,110,75,42,218,115,103,37,33,33,9,0
61447,204,93,111,35,35,16,11,660,333,327,102,95,69,31,0
61448,331,177,154,54,38,27,11,601,278,323,124,87,65,21,0
61449,235,100,135,36,25,30,8,360,180,180,57,48,39,12,0
61450,1257,464,793,221,264,75,37,843,391,452,139,104,91,35,0
61451,904,436,468,138,146,82,39,1500,804,696,190,172,144,60,0
61452,260,138,122,44,30,28,6,242,124,118,39,32,28,22,0
61453,127,54,73,31,10,11,3,479,215,264,67,80,46,28,0
61454,1011,559,452,121,97,132,33,935,515,420,126,107,73,32,0
61455,420,189,231,79,67,33,17,732,366,366,108,86,74,41,0
61456,1009,487,522,177,121,103,51,497,257,240,71,63,62,16,0
61457,722,390,332,125,69,67,25,103,50,53,19,10,7,5,0
61458,210,101,109,33,33,19,9,1214,475,739,177,250,89,49,0
61459,577,251,326,92,84,60,11,123,61,62,17,18,17,7,0
61460,3230,1724,1506,361,358,157,75,928,440,488,111,157,82,35,0
61461,269,156,113,37,32,17,7,125,66,59,24,16,11,5,0
61462,505,201,304,116,58,75,31,418,223,195,51,45,49,14,0
61463,315,174,141,46,38,47,16,171,94,77,24,28,30,11,0
61464,303,161,142,38,31,42,17,98,49,49,14,15,9,2,0
61465,347,154,193,48,51,25,11,530,287,243,79,70,33,26,0
61466,339,118,221,77,68,33,13,689,343,346,105,102,81,35,0
61467,221,80,141,48,37,14,10,545,269,276,80,76,27,32,0
61468,178,87,91,20,32,13,10,300,148,152,45,43,40,8,0
61469,979,534,445,83,77,80,24,396,197,199,75,49,49,16,0
61470,270,166,104,30,26,28,14,127,64,63,26,8,12,8,0
61471,682,292,390,89,69,58,20,125,66,59,24,16,11,5,0
61472,282,84,198,60,102,1,6,188,88,100,53,12,15,6,0
61473,1556,718,838,280,182,161,49,437,224,213,40,29,42,25,0
61474,789,362,427,90,82,70,35,296,140,156,49,40,42,19,0
61475,347,154,193,48,51,25,11,821,394,427,122,117,109,38,0
61476,1709,650,1059,338,286,185,46,188,105,83,25,17,24,7,0
61477,282,135,147,27,37,30,19,307,132,175,48,53,26,10,0
61478,203,80,123,40,37,20,3,373,213,160,44,33,26,17,0
61479,346,208,138,46,39,51,18,598,333,265,79,66,54,33,0
61480,417,176,241,75,61,51,20,360,185,175,51,43,36,16,0
61481,220,113,107,37,24,16,7,761,351,410,117,73,103,45,0
61482,760,322,438,81,130,57,19,218,115,103,37,33,33,9,0
61483,653,379,274,89,56,86,13,334,182,152,45,41,27,13,0
61484,704,342,362,113,91,85,33,405,181,224,71,57,31,12,0
61485,1594,660,934,251,272,117,77,397,223,174,50,39,29,17,0
61486,415,217,198,50,31,42,17,338,169,169,53,44,39,21,0
61487,339,118,221,77,68,33,13,368,183,185,40,42,40,15,0
61488,227,109,118,42,35,29,8,242,124,118,39,32,28,22,0
61489,2525,1232,1293,398,317,186,61,671,321,350,95,87,75,34,0
61490,351,166,185,48,61,24,15,463,170,293,115,54,75,32,0
61491,130,70,60,30,9,8,1,267,141,126,53,27,23,7,0
61492,396,150,246,103,64,38,3,640,364,276,84,68,69,33,0
61493,314,158,156,39,28,30,17,892,475,417,130,108,68,38,0
61494,500,297,203,66,33,53,15,292,143,149,38,42,36,16,0
61495,485,246,239,74,48,47,22,201,104,97,36,32,24,7,0
61496,813,412,401,114,93,112,26,903,436,467,128,116,83,33,0
61497,557,211,346,129,125,48,19,2038,1059,979,262,237,208,100,0
61498,509,246,263,84,71,56,22,410,197,213,67,43,56,18,0
61499,2649,1431,1218,377,299,266,102,65,32,33,16,4,8,3,0
61500,414,195,219,51,60,40,17,530,287,243,79,70,33,26,0
61501,360,205,155,35,24,52,14,710,375,335,95,94,110,28,0
61502,454,230,224,63,56,38,33,225,111,114,32,34,32,16,0
61503,350,190,160,48,25,27,18,245,121,124,37,35,36,12,0
61504,496,210,286,112,55,72,13,403,225,178,56,38,33,25,0
61505,224,108,116,31,32,22,8,245,131,114,30,27,18,13,0
61506,204,103,101,16,32,22,8,136,65,71,26,11,7,5,0
61507,932,575,357,94,69,76,40,1113,480,633,170,173,81,34,0
61508,478,220,258,47,70,41,10,338,169,169,53,44,39,21,0
61509,1544,738,806,239,217,145,91,107,77,30,7,2,9,5,0
61510,414,195,219,51,60,40,17,286,160,126,37,27,23,10,0
61511,453,240,213,53,33,44,16,207,114,93,33,20,31,13,0
61512,371,209,162,46,17,36,19,1230,644,586,198,125,123,61,0
61513,55,16,39,24,2,5,2,396,199,197,54,50,45,14,0
61514,977,462,515,185,119,76,12,305,163,142,38,27,47,11,0
61515,130,70,60,30,9,8,1,622,344,278,80,77,68,36,0
61516,284,160,124,37,23,32,11,103,50,53,19,10,7,5,0
61517,949,466,483,125,126,101,50,173,86,87,30,22,19,12,0
61518,526,268,258,54,37,55,12,541,279,262,79,82,31,32,0
61519,186,56,130,46,50,16,7,160,76,84,19,24,8,5,0
61520,342,150,192,52,43,31,17,470,205,265,71,80,33,11,0
61521,439,205,234,64,88,41,21,929,459,470,140,120,94,45,0
61522,420,189,231,79,67,33,17,497,257,240,71,63,62,16,0
61523,125,46,79,24,16,12,2,286,160,126,37,27,23,10,0
61524,99,35,64,25,18,0,1,478,254,224,67,74,56,28,0
61525,305,124,181,27,25,31,21,425,177,248,60,62,33,16,0
61526,527,254,273,67,66,70,31,222,119,103,37,32,24,8,0
61527,414,206,208,56,68,35,19,858,461,397,125,114,79,45,0
61528,331,177,154,54,38,27,11,277,163,114,33,24,21,16,0
61529,1341,481,860,275,264,57,21,447,212,235,86,55,58,21,0
61530,149,78,71,20,20,19,5,376,183,193,50,50,43,21,0
61531,504,222,282,71,64,53,29,101,59,42,11,17,10,1,0
61532,250,123,127,40,28,29,8,132,67,65,24,21,8,10,0
61533,2220,1085,1135,312,304,202,91,166,102,64,19,14,17,2,0
61534,1047,443,604,162,156,78,52,862,426,436,113,115,84,37,0
61535,803,358,445,135,117,80,43,926,425,501,159,147,77,35,0
61536,571,298,273,81,72,57,25,277,163,114,33,24,21,16,0
61537,465,240,225,50,54,24,14,218,115,103,32,32,34,11,0
61538,603,311,292,102,71,66,23,242,121,121,39,30,29,10,0
61539,347,154,193,48,51,25,11,247,128,119,34,14,16,14,0
61540,396,150,246,103,64,38,3,437,221,216,62,64,47,13,0
61541,653,379,274,89,56,86,13,222,125,97,34,27,27,7,0
61542,316,157,159,45,38,22,19,892,475,417,130,108,68,38,0
61543,466,199,267,86,59,32,17,306,157,149,52,35,39,16,0
61544,420,202,218,67,43,51,15,289,140,149,33,42,30,15,0
61545,700,305,395,111,99,54,18,545,269,276,80,76,27,32,0
61546,240,98,142,49,42,23,17,1395,627,768,172,263,141,59,0
61547,421,237,184,47,54,45,10,89,38,51,14,6,3,9,0
61548,340,145,195,46,38,26,23,334,182,152,45,41,27,13,0
61549,1163,417,746,209,145,87,28,257,126,131,61,24,22,8,0
61550,348,198,150,57,25,37,18,72,33,39,8,2,3,12,0
61551,653,379,274,89,56,86,13,381,187,194,37,49,36,17,0
61552,249,114,135,47,33,25,4,374,181,193,55,58,48,23,0
61553,476,254,222,58,33,46,23,925,439,486,141,134,105,46,0
61554,144,57,87,38,26,10,4,2724,1157,1567,269,518,239,77,0
61555,176,74,102,20,29,7,7,1166,514,652,150,159,107,70,0
61556,181,92,89,34,22,17,9,295,160,135,42,37,46,16,0
61557,369,166,203,59,55,41,14,212,127,85,28,21,26,6,0
61558,1226,513,713,184,147,87,43,305,161,144,39,40,44,17,0
61559,410,208,202,59,58,43,26,283,160,123,25,20,37,9,0
61560,209,75,134,53,48,20,9,432,244,188,51,51,27,14,0
61561,227,120,107,31,28,28,13,862,426,436,113,115,84,37,0
61562,123,58,65,22,14,13,3,1001,417,584,186,147,96,47,0
61563,126,66,60,24,10,7,9,601,279,322,81,65,27,12,0
61564,674,318,356,86,139,50,11,169,74,95,33,26,22,3,0
61565,335,171,164,51,38,38,10,548,273,275,84,81,64,30,0
61566,553,319,234,56,37,54,18,588,286,302,78,99,53,25,0
61567,257,132,125,39,27,26,10,453,247,206,58,53,45,20,0
61568,360,175,185,73,36,27,7,316,159,157,38,48,30,11,0
61569,598,300,298,68,77,59,21,166,88,78,23,18,13,7,0
61570,480,267,213,49,44,70,21,445,202,243,70,73,51,15,0
61571,1030,438,592,184,104,108,30,296,159,137,49,28,38,13,0
61572,1124,442,682,148,189,72,43,414,203,211,58,56,48,14,0
61573,291,120,171,63,39,26,6,744,385,359,105,96,57,31,0
61574,202,103,99,28,20,12,8,715,348,367,109,84,68,30,0
61575,894,448,446,123,100,82,30,403,184,219,75,51,47,20,0
61576,336,134,202,51,64,27,12,405,195,210,57,74,24,17,0
61577,447,225,222,76,35,75,21,418,223,195,53,43,49,15,0
61578,67,40,27,10,8,7,6,925,439,486,141,134,105,46,0
61579,313,148,165,45,33,36,11,380,211,169,47,37,33,21,0
61580,426,214,212,63,47,53,20,862,426,436,113,115,84,37,0
61581,360,205,155,35,24,52,14,972,471,501,152,138,112,40,0
61582,161,99,62,15,22,9,7,538,274,264,84,67,52,35,0
61583,733,438,295,95,79,67,32,306,157,149,52,35,39,16,0
61584,123,58,65,22,14,13,3,169,84,85,29,19,21,7,0
61585,2525,1232,1293,398,317,186,61,328,199,129,39,29,27,14,0
61586,220,113,107,37,24,16,7,247,128,119,34,14,16,14,0
61587,700,305,395,111,99,54,18,445,202,243,70,73,51,15,0
61588,261,126,135,41,36,24,11,501,249,252,77,70,55,22,0
61589,2624,999,1625,415,495,109,84,975,400,575,160,162,62,31,0
61590,957,381,576,184,158,86,48,543,221,322,78,122,37,12,0
61591,717,281,436,165,81,112,49,98,49,49,14,15,9,2,0
61592,436,209,227,66,47,52,22,509,267,242,79,81,38,20,0
61593,122,56,66,26,13,11,5,679,338,341,96,95,40,23,0
61594,401,236,165,53,38,34,9,314,177,137,34,40,29,9,0
61595,658,349,309,77,70,73,35,245,121,124,37,35,36,12,0
61596,422,196,226,52,35,33,20,601,278,323,124,87,65,21,0
61597,238,158,80,28,15,31,7,2542,1245,1297,285,287,170,84,0
61598,261,126,135,41,36,24,11,139,68,71,14,26,14,9,0
61599,102,49,53,14,21,7,4,139,73,66,26,13,9,9,0
61600,333,171,162,50,34,19,8,198,113,85,19,20,26,12,0
61601,366,190,176,39,62,55,14,378,154,224,74,84,35,22,0
61602,861,393,468,150,101,69,35,301,168,133,49,37,34,11,0
61603,588,317,271,78,49,54,17,277,152,125,31,35,22,19,0
61604,326,154,172,45,39,20,10,123,61,62,17,18,17,7,0
61605,220,113,107,37,24,16,7,500,245,255,66,57,52,27,0
61606,801,331,470,151,139,99,55,1239,659,580,169,148,131,54,0
61607,580,281,299,95,60,74,29,188,105,83,25,17,24,7,0
61608,269,127,142,43,24,34,26,346,178,168,58,41,33,12,0
61609,588,317,271,78,49,54,17,928,440,488,111,157,82,35,0
61610,505,247,258,72,71,60,27,305,163,142,38,27,47,11,0
61611,580,240,340,108,81,59,22,175,82,93,33,26,17,5,0
61612,535,315,220,57,55,71,19,119,61,58,17,12,10,6,0
61613,325,177,148,40,24,23,13,485,244,241,80,55,59,20,0
61614,270,147,123,34,17,39,21,130,67,63,24,10,12,4,0
61615,579,321,258,74,70,47,22,427,251,176,51,39,25,22,0
61616,508,136,372,157,91,22,9,1378,692,686,194,174,105,56,0
61617,443,250,193,52,23,49,13,225,111,114,32,34,32,16,0
61618,134,60,74,19,13,10,7,531,261,270,73,80,68,26,0
61619,462,258,204,59,41,56,15,663,354,309,91,84,79,31,0
61620,446,174,272,84,61,57,23,463,170,293,115,54,75,32,0
61621,426,228,198,62,42,47,22,1127,527,600,147,128,83,58,0
61622,347,198,149,45,29,29,8,530,287,243,79,70,33,26,0
61623,587,318,269,76,50,38,21,811,361,450,124,107,80,31,0
61624,1342,640,702,187,163,123,57,160,76,84,19,24,8,5,0
61625,341,154,187,34,36,11,11,437,221,216,62,64,47,13,0
61626,437,167,270,126,95,34,10,4646,2328,2318,674,639,475,170,0
61627,344,109,235,100,39,26,5,387,193,194,60,53,57,15,0
61628,378,202,176,34,32,44,13,1101,626,475,145,122,120,50,0
61629,238,91,147,68,19,22,7,148,84,64,30,7,17,4,0
61630,815,356,459,128,125,82,26,405,195,210,57,74,24,17,0
61631,763,354,409,101,90,63,26,156,90,66,17,22,11,10,0
61632,526,268,258,54,37,55,12,276,149,127,34,31,32,10,0
61633,550,304,246,60,64,77,16,225,114,111,32,29,26,6,0
61634,420,202,218,67,43,51,15,368,183,185,40,42,40,15,0
61635,291,131,160,49,35,32,15,445,202,243,70,73,51,15,0
61636,264,122,142,33,29,13,13,138,69,69,28,7,10,10,0
61637,242,104,138,41,33,37,8,142,73,69,27,9,15,11,0
61638,833,295,538,146,139,65,34,175,91,84,19,21,21,10,0
61639,972,501,471,125,156,106,39,660,332,328,84,73,47,19,0
61640,57,24,33,11,3,5,3,744,385,359,105,96,57,31,0
61641,505,282,223,60,57,66,23,501,257,244,75,57,48,29,0
61642,483,236,247,82,60,43,18,368,204,164,43,35,30,24,0
61643,760,322,438,81,130,57,19,386,207,179,43,48,44,19,0
61644,983,449,534,95,77,55,36,325,159,166,59,46,30,12,0
61645,98,32,66,15,25,5,4,928,440,488,111,157,82,35,0
61646,232,134,98,28,20,20,5,171,94,77,24,28,30,11,0
61647,209,75,134,53,48,20,9,389,207,182,53,58,52,18,0
61648,304,159,145,38,40,32,3,425,204,221,71,56,45,13,0
61649,682,292,390,89,69,58,20,127,54,73,11,33,15,6,0
61650,388,209,179,46,24,31,28,1606,753,853,215,227,182,48,0
61651,343,162,181,65,38,29,12,145,77,68,26,7,15,8,0
61652,142,76,66,21,21,22,11,104,46,58,15,17,9,5,0
61653,332,173,159,48,42,42,9,325,172,153,44,34,27,14,0
61654,437,228,209,47,61,26,11,326,149,177,51,51,28,10,0
61655,1221,597,624,201,152,83,31,247,128,119,34,14,16,14,0
61656,365,222,143,44,24,35,11,497,227,270,70,63,66,30,0
61657,1616,735,881,285,248,153,72,480,255,225,67,64,50,22,0
61658,255,126,129,41,37,13,5,137,78,59,22,16,17,4,0
61659,711,330,381,111,86,86,34,87,51,35,15,9,9,4,0
61660,496,210,286,112,55,72,13,520,244,276,91,60,68,20,0
61661,315,170,145,48,56,22,11,296,140,156,49,40,42,19,0
61662,756,265,491,129,127,51,17,362,156,206,74,42,36,22,0
61663,604,239,365,124,63,84,37,1378,692,686,194,174,105,56,0
61664,366,190,176,39,62,55,14,72,32,40,8,2,2,13,0
61665,343,162,181,65,38,29,12,346,196,150,43,26,27,14,0
61666,419,210,209,54,44,31,23,1507,737,770,188,228,147,71,0
61667,504,222,282,71,64,53,29,139,68,71,14,26,14,9,0
61668,439,241,198,67,40,40,13,88,50,38,13,8,16,4,0
61669,76,42,34,12,8,5,7,1922,923,999,267,275,215,90,0
61670,178,74,104,31,28,9,4,286,152,134,38,38,32,11,0
61671,595,208,387,157,60,91,48,241,127,114,34,33,29,12,0
61672,1235,584,651,140,226,82,52,160,76,84,19,24,8,5,0
61673,505,247,258,72,71,60,27,87,51,35,15,9,9,4,0
61674,579,321,258,74,70,47,22,156,90,66,17,22,11,10,0
61675,465,220,245,88,34,61,23,89,37,52,13,6,2,9,0
61676,126,58,68,31,10,10,3,225,129,96,32,33,20,8,0
61677,359,167,192,49,37,27,19,330,166,164,55,51,36,16,0
61678,193,95,98,33,17,25,17,389,207,182,53,58,52,18,0
61679,219,100,119,40,29,21,3,732,366,366,108,86,74,41,0
61680,520,261,259,74,52,49,22,422,202,220,80,52,57,18,0
61681,1087,523,564,146,177,103,33,501,274,227,63,58,53,20,0
61682,391,203,188,49,34,36,9,457,245,212,62,58,57,21,0
61683,365,210,155,46,30,24,12,303,138,165,47,46,35,18,0
61684,406,207,199,56,46,68,19,1239,659,580,169,148,131,54,0
61685,496,274,222,57,43,75,22,818,357,461,122,136,54,25,0
61686,2624,999,1625,415,495,109,84,417,232,185,58,50,29,21,0
61687,1447,698,749,214,180,116,46,346,178,168,58,41,33,12,0
61688,773,383,390,108,76,79,30,137,63,74,20,22,14,6,0
61689,129,70,59,29,9,7,2,1040,564,476,134,110,114,51,0
61690,615,308,307,83,75,58,32,780,337,443,112,116,77,28,0
61691,375,167,208,55,83,44,9,449,252,197,61,52,36,18,0
61692,172,82,90,21,35,21,5,497,257,240,71,63,62,16,0
61693,574,284,290,64,50,65,20,316,166,150,45,38,37,13,0
61694,146,73,73,18,24,17,9,239,113,126,36,49,20,8,0
61695,228,105,123,34,43,20,10,292,143,149,38,42,36,16,0
61696,193,110,83,18,20,15,12,517,295,222,69,62,40,28,0
61697,125,46,79,24,16,12,2,385,188,197,57,42,36,16,0
61698,837,443,394,129,89,87,38,811,361,450,124,107,80,31,0
61699,546,265,281,101,64,38,16,257,139,118,64,17,24,7,0
61700,927,457,470,130,99,118,42,72,33,39,8,2,3,12,0
61701,473,212,261,72,64,45,28,227,130,97,32,25,22,12,0
61702,291,131,160,49,35,32,15,392,186,206,62,56,29,15,0
61703,426,213,213,60,56,46,24,54,26,28,11,4,3,3,0
61704,2663,1073,1590,548,499,192,64,536,251,285,75,79,60,23,0
61705,598,322,276,67,57,63,26,403,221,182,62,50,42,12,0
61706,193,90,103,44,9,19,13,775,407,368,122,100,97,32,0
61707,525,254,271,60,76,46,13,467,231,236,71,65,58,18,0
61708,508,251,257,74,53,51,18,230,125,105,29,40,20,6,0
61709,375,201,174,52,56,39,15,250,116,134,41,30,33,19,0
61710,290,156,134,44,29,39,9,1001,417,584,186,147,96,47,0
61711,1189,653,536,152,118,109,56,374,191,183,40,52,40,16,0
61712,128,67,61,29,9,9,1,475,251,224,67,49,48,23,0
61713,341,195,146,42,21,36,9,975,400,575,160,162,62,31,0
61714,132,66,66,21,18,11,7,199,105,94,27,27,28,9,0
61715,1560,778,782,224,235,132,78,741,383,358,92,63,79,36,0
61716,524,262,262,62,72,39,49,673,313,360,102,101,46,17,0
61717,1112,457,655,180,164,99,39,455,229,226,66,62,63,29,0
61718,952,547,405,95,90,127,35,127,54,73,11,33,15,6,0
61719,206,96,110,33,25,8,6,204,80,124,29,51,10,5,0
61720,730,298,432,128,69,86,26,380,211,169,47,37,33,21,0
61721,222,110,112,43,30,14,6,966,478,488,108,144,74,43,0
61722,1052,492,560,184,163,103,44,91,44,47,9,12,4,7,0
61723,427,218,209,61,53,45,26,465,229,236,68,62,40,22,0
61724,941,459,482,167,140,82,38,89,37,52,13,6,2,9,0
61725,1336,724,612,209,141,133,60,305,163,142,38,27,47,11,0
61726,1220,575,645,208,179,99,56,192,91,101,29,28,17,7,0
61727,429,238,191,47,49,56,29,562,273,289,76,92,45,24,0
61728,500,245,255,66,57,52,27,597,300,297,96,89,68,29,0
61729,859,411,448,118,100,95,49,381,196,185,55,57,43,16,0
61730,582,328,254,78,48,35,9,1239,659,580,169,148,131,54,0
61731,1390,705,685,219,164,129,74,305,163,142,38,27,47,11,0
61732,319,153,166,61,52,26,12,348,212,136,53,31,25,18,0
61733,300,136,164,45,35,45,14,134,55,79,22,24,16,6,0
61734,482,245,237,69,64,66,24,326,169,157,51,41,41,12,0
61735,279,127,152,50,36,28,8,621,273,348,104,102,48,19,0
61736,251,131,120,49,35,25,5,332,180,152,44,36,27,13,0
61737,220,113,107,37,24,16,7,904,436,468,143,118,108,32,0
61738,358,212,146,51,36,33,9,471,238,233,66,63,62,19,0
61739,71,39,32,7,11,6,4,455,191,264,68,86,21,19,0
61740,575,305,270,74,87,73,25,348,194,154,57,31,43,12,0
61741,911,489,422,121,98,97,36,630,321,309,86,90,57,26,0
61742,320,183,137,51,18,38,8,132,61,71,22,21,15,3,0
61743,496,209,287,113,55,72,14,520,272,248,60,65,58,22,0
61744,649,304,345,99,80,67,40,4646,2328,2318,674,639,475,170,0
61745,413,206,207,38,55,19,10,418,246,172,52,39,57,10,0
61746,714,260,454,140,97,120,54,418,223,195,53,43,49,15,0
61747,297,161,136,36,35,24,9,452,231,221,74,53,56,20,0
61748,531,260,271,97,68,47,11,348,212,136,53,31,25,18,0
61749,789,362,427,90,82,70,35,341,170,171,41,66,27,10,0
61750,322,164,158,46,44,29,7,403,192,211,102,39,49,15,0
61751,453,240,213,53,33,44,16,592,249,343,91,90,50,42,0
61752,1531,649,882,108,122,93,72,557,281,276,80,59,43,21,0
61753,126,56,70,31,10,10,3,660,333,327,102,95,69,31,0
61754,130,70,60,30,9,8,1,204,96,108,31,37,20,5,0
61755,519,259,260,86,78,59,22,1696,771,925,257,225,149,63,0
61756,605,277,328,99,54,63,43,535,301,234,63,48,47,27,0
61757,626,308,318,105,89,77,25,199,92,107,34,30,18,9,0
61758,357,182,175,49,36,39,15,87,51,35,15,9,9,4,0
61759,456,214,242,76,62,52,22,4646,2328,2318,674,639,475,170,0
61760,410,209,201,72,30,48,22,531,261,270,73,80,68,26,0
61761,341,175,166,48,43,35,18,1001,417,584,186,147,96,47,0
61762,470,163,307,99,68,73,30,374,181,193,55,58,48,23,0
61763,464,237,227,64,66,33,12,751,394,357,107,96,73,35,0
61764,520,231,289,89,59,58,26,367,199,168,62,44,34,8,0
61765,384,198,186,58,48,37,12,265,134,131,48,34,33,15,0
61766,433,188,245,63,45,26,14,373,181,192,54,35,44,20,0
61767,300,136,164,45,35,45,14,380,211,169,47,37,33,21,0
61768,932,575,357,94,69,76,40,418,223,195,53,43,49,15,0
61769,143,81,62,28,9,8,1,498,244,254,81,67,58,19,0
61770,232,134,98,28,20,20,5,597,269,328,102,84,69,24,0
61771,311,154,157,47,29,34,13,225,114,111,32,29,26,6,0
61772,587,318,269,76,50,38,21,128,63,65,30,11,13,8,0
61773,349,131,218,66,76,22,9,276,149,127,34,31,32,10,0
61774,139,81,58,17,14,24,9,1265,689,576,169,177,128,60,0
61775,1542,682,860,290,158,120,47,188,93,95,33,18,16,10,0
61776,658,349,309,77,70,73,35,485,244,241,80,55,59,20,0
61777,161,75,86,24,20,10,7,399,190,209,61,41,39,18,0
61778,1390,705,685,219,164,129,74,780,337,443,112,116,77,28,0
61779,1124,442,682,148,189,72,43,392,186,206,62,56,29,15,0
61780,587,318,269,76,50,38,21,925,439,486,141,134,105,46,0
61781,1043,479,564,200,131,123,62,73,35,38,14,10,9,4,0
61782,1064,495,569,157,159,124,58,277,144,133,42,30,41,8,0
61783,580,281,299,95,60,74,29,405,181,224,71,57,31,12,0
61784,492,253,239,73,67,77,29,457,245,212,62,58,57,21,0
61785,580,240,340,108,81,59,22,627,323,304,81,90,53,27,0
61786,501,230,271,63,90,50,18,1323,690,633,132,178,112,61,0
61787,193,110,83,18,20,15,12,536,267,269,60,70,41,22,0
61788,158,85,73,24,18,18,8,231,126,105,37,26,29,6,0
61789,150,60,90,27,16,6,3,564,264,300,79,84,65,26,0
61790,743,366,377,41,37,26,14,906,455,451,116,105,87,46,0
61791,404,197,207,60,48,47,20,873,411,462,132,107,84,40,0
61792,526,268,258,54,37,55,12,1154,489,665,200,196,95,54,0
61793,469,221,248,49,60,55,21,627,289,338,101,73,62,43,0
61794,2048,855,1193,297,287,191,93,257,139,118,64,17,24,7,0
61795,359,167,192,49,37,27,19,594,312,282,72,67,73,31,0
61796,150,64,86,22,12,29,12,196,105,91,40,13,19,10,0
61797,616,323,293,98,71,31,15,723,363,360,107,106,52,14,0
61798,479,227,252,69,48,46,18,305,163,142,38,27,47,11,0
61799,411,236,175,39,45,50,30,234,116,118,34,35,23,9,0
61800,343,162,181,65,38,29,12,91,42,49,21,9,8,3,0
61801,425,198,227,57,69,59,13,218,114,104,32,31,33,11,0
61802,126,57,69,31,10,10,3,180,108,72,22,22,15,5,0
61803,379,217,162,47,20,50,23,470,205,265,71,80,33,11,0
61804,419,210,209,54,44,31,23,2225,1244,981,271,243,217,93,0
61805,1360,644,716,213,194,136,62,579,285,294,78,72,64,32,0
61806,282,84,198,60,102,1,6,393,210,183,58,37,34,20,0
61807,619,289,330,67,77,36,19,375,176,199,48,61,40,12,0
61808,121,69,52,15,18,14,8,866,397,469,117,153,95,48,0
61809,664,269,395,117,107,36,15,463,268,195,59,46,46,21,0
61810,1096,563,533,158,136,120,53,689,343,346,105,102,81,35,0
61811,836,370,466,126,96,72,30,231,126,105,28,26,34,9,0
61812,285,148,137,31,42,42,16,1262,653,609,169,165,152,50,0
61813,1041,497,544,180,167,98,34,386,181,205,55,51,57,31,0
61814,443,250,193,52,23,49,13,169,74,95,33,26,22,3,0
61815,131,69,62,29,9,9,1,418,246,172,52,39,57,10,0
61816,540,252,288,73,67,57,20,215,115,100,27,19,16,7,0
61817,130,71,59,30,9,8,2,225,129,96,32,33,20,8,0
61818,306,172,134,35,31,37,18,858,398,460,126,138,75,39,0
61819,373,194,179,42,54,26,13,336,200,136,34,29,25,24,0
61820,1148,472,676,229,164,86,37,588,286,302,78,99,53,25,0
61821,1121,458,663,158,210,76,47,462,229,233,63,49,42,18,0
61822,273,126,147,54,49,25,18,926,425,501,159,147,77,35,0
61823,319,222,97,36,23,28,8,818,357,461,122,136,54,25,0
61824,594,321,273,98,59,57,23,892,475,417,130,108,68,38,0
61825,682,260,422,153,78,109,46,316,166,150,45,38,37,13,0
61826,539,283,256,75,73,53,26,96,46,50,16,12,7,5,0
61827,483,236,247,82,60,43,18,763,418,345,113,84,59,32,0
61828,1360,644,716,213,194,136,62,198,115,83,30,22,8,8,0
61829,674,268,406,118,96,70,21,335,170,165,52,36,47,11,0
61830,426,214,212,63,47,53,20,748,359,389,125,113,86,31,0
61831,142,76,66,21,21,22,11,111,60,51,17,23,10,7,0
61832,244,104,140,52,31,30,14,128,63,65,30,11,13,8,0
61833,326,148,178,55,42,31,12,4646,2328,2318,674,639,475,170,0
61834,453,240,213,53,33,44,16,421,222,199,69,50,60,18,0
61835,318,161,157,53,51,32,13,198,86,112,36,27,23,9,0
61836,646,304,342,104,93,58,26,1507,737,770,188,228,147,71,0
61837,911,489,422,121,98,97,36,858,398,460,126,138,75,39,0
61838,282,135,147,27,37,30,19,445,202,243,70,73,51,15,0
61839,426,214,212,63,47,53,20,105,51,54,13,17,12,8,0
61840,288,104,184,80,30,39,6,389,207,182,53,58,52,18,0
61841,211,92,119,33,44,11,7,1262,653,609,169,165,152,50,0
61842,538,263,275,71,85,44,18,548,296,252,71,74,43,28,0
61843,301,150,151,45,47,33,13,1696,771,925,257,225,149,63,0
61844,524,262,262,62,72,39,49,314,151,163,42,61,39,16,0
61845,275,125,150,37,48,27,7,621,273,348,104,102,48,19,0
61846,90,54,36,20,4,14,5,277,144,133,42,30,41,8,0
61847,163,70,93,28,21,17,6,302,150,152,56,40,52,15,0
61848,772,383,389,105,76,82,33,866,478,388,121,101,101,26,0
61849,605,277,328,99,54,63,43,1382,508,874,334,320,98,36,0
61850,474,243,231,66,54,41,29,470,205,265,71,80,33,11,0
61851,505,247,258,72,71,60,27,862,409,453,149,125,86,29,0
61852,126,56,70,31,10,10,3,622,344,278,80,77,68,36,0
61853,933,456,477,123,108,83,29,405,195,210,57,74,24,17,0
61854,412,193,219,69,57,43,14,396,223,173,57,37,44,19,0
61855,297,161,136,36,35,24,9,562,273,289,76,92,45,24,0
61856,500,257,243,60,55,27,22,518,292,226,60,60,52,21,0
61857,199,107,92,41,15,14,8,471,238,233,66,63,62,19,0
61858,800,328,472,159,159,41,15,972,501,471,125,156,106,39,0
61859,252,121,131,42,34,12,16,422,237,185,53,47,62,20,0
61860,332,173,159,48,42,42,9,94,45,49,11,20,10,4,0
61861,161,99,62,15,22,9,7,452,252,200,55,49,61,16,0
61862,733,382,351,126,92,93,27,501,240,261,80,62,49,42,0
61863,384,198,186,58,48,37,12,758,319,439,101,123,78,25,0
61864,374,187,187,51,52,40,27,297,175,122,46,30,31,6,0
61865,565,264,301,101,73,72,15,594,312,282,72,67,73,31,0
61866,304,149,155,46,32,39,14,963,455,508,127,130,115,48,0
61867,630,231,399,150,83,84,50,108,59,49,17,13,12,5,0
61868,432,233,199,52,28,47,18,462,229,233,63,49,42,18,0
61869,384,198,186,58,48,37,12,963,525,438,119,102,102,34,0
61870,1556,718,838,280,182,161,49,410,197,213,67,43,56,18,0
61871,794,322,472,122,108,79,34,422,237,185,53,47,62,20,0
61872,435,187,248,62,51,51,21,531,261,270,73,80,68,26,0
61873,109,50,59,12,12,9,3,156,90,66,17,22,11,10,0
61874,828,355,473,126,134,77,37,91,42,49,21,9,8,3,0
61875,381,146,235,74,48,47,34,246,107,139,55,33,27,11,0
61876,1139,537,602,162,139,109,50,131,55,76,28,9,14,12,0
61877,271,110,161,33,27,11,8,188,101,87,20,18,20,14,0
61878,485,183,302,79,81,73,33,508,262,246,66,67,51,20,0
61879,739,323,416,127,89,76,33,902,499,403,118,117,92,35,0
61880,144,57,87,38,26,10,4,204,96,108,31,37,20,5,0
61881,334,190,144,42,42,16,5,601,279,322,81,65,27,12,0
61882,1096,563,533,158,136,120,53,278,154,124,42,32,38,7,0
61883,252,121,131,42,34,12,16,194,94,100,33,28,14,7,0
61884,648,376,272,70,60,73,24,601,279,322,81,65,27,12,0
61885,484,261,223,59,48,49,24,323,171,152,48,41,40,16,0
61886,331,169,162,40,28,22,14,352,207,145,40,33,25,21,0
61887,347,198,149,45,29,29,8,94,45,49,11,20,10,4,0
61888,234,108,126,42,40,15,9,169,85,84,21,14,9,9,0
61889,241,122,119,27,34,17,16,166,90,76,27,18,21,5,0
61890,815,356,459,128,125,82,26,247,128,119,34,14,16,14,0
61891,325,152,173,43,47,28,17,246,125,121,38,36,30,11,0
61892,959,496,463,144,132,75,35,198,113,85,19,20,26,12,0
61893,346,168,178,36,43,20,9,363,180,183,60,34,10,6,0
61894,640,308,332,91,102,49,21,364,189,175,58,41,35,17,0
61895,364,168,196,64,61,27,6,611,314,297,79,75,78,22,0
61896,2109,999,1110,332,294,187,89,396,223,173,57,37,44,19,0
61897,489,253,236,73,36,62,17,434,213,221,77,62,53,12,0
61898,279,106,173,48,35,41,39,364,192,172,49,36,39,14,0
61899,733,438,295,95,79,67,32,378,154,224,74,84,35,22,0
61900,261,137,124,34,23,13,8,360,185,175,51,43,36,16,0
61901,764,277,487,158,162,64,31,102,51,51,12,15,12,3,0
61902,603,311,292,102,71,66,23,261,162,99,24,21,14,10,0
61903,1462,711,751,219,222,148,65,866,478,388,121,101,101,26,0
61904,650,330,320,97,77,65,28,514,248,266,86,82,52,22,0
61905,371,143,228,77,48,29,26,348,212,136,53,31,25,18,0
61906,1200,602,598,145,116,110,50,1004,457,547,150,150,74,52,0
61907,808,366,442,130,133,66,31,106,41,65,36,6,11,7,0
61908,260,133,127,43,29,34,11,293,142,151,49,40,42,17,0
61909,395,219,176,47,41,50,18,218,117,101,35,32,34,12,0
61910,571,298,273,81,72,57,25,1507,737,770,188,228,147,71,0
61911,397,180,217,61,59,39,13,671,321,350,95,87,75,34,0
61912,2663,1073,1590,548,499,192,64,209,119,90,28,24,27,9,0
61913,736,320,416,113,97,61,36,341,170,171,41,66,27,10,0
61914,561,282,279,68,62,36,14,299,140,159,49,44,26,11,0
61915,1058,497,561,194,142,87,63,780,337,443,112,116,77,28,0
61916,395,189,206,63,50,49,28,406,234,172,63,35,43,10,0
61917,236,120,116,32,28,21,11,417,232,185,58,50,29,21,0
61918,225,111,114,38,22,25,10,1755,905,850,214,196,183,79,0
61919,373,194,179,42,54,26,13,551,226,325,96,103,43,11,0
61920,130,71,59,30,9,8,1,326,169,157,51,41,41,12,0
61921,410,211,199,55,42,34,27,690,345,345,96,83,73,42,0
61922,2285,1219,1066,207,180,178,106,665,361,304,87,91,84,31,0
61923,139,64,75,18,17,18,4,368,204,164,43,35,30,24,0
61924,1139,537,602,162,139,109,50,229,120,109,31,30,22,9,0
61925,1009,478,531,166,126,96,42,137,72,65,27,13,15,8,0
61926,1689,821,868,277,250,177,78,724,353,371,94,95,71,31,0
61927,508,251,257,74,53,51,18,408,221,187,55,51,57,14,0
61928,428,248,180,44,39,28,9,240,141,99,34,28,29,8,0
61929,411,171,240,61,81,30,15,974,457,517,133,117,69,26,0
61930,1120,436,684,208,120,101,115,455,191,264,68,86,21,19,0
61931,431,199,232,59,54,40,17,396,197,199,75,49,49,16,0
61932,800,416,384,102,105,83,22,778,391,387,94,77,41,33,0
61933,123,58,65,22,14,13,3,88,50,38,13,8,16,4,0
61934,106,43,63,28,13,8,1,330,166,164,55,51,36,16,0
61935,297,161,136,36,35,24,9,332,180,152,44,36,27,13,0
61936,347,154,193,48,51,25,11,218,117,101,35,32,34,12,0
61937,639,368,271,72,51,38,38,285,146,139,41,41,48,13,0
61938,435,225,210,58,46,50,14,274,157,117,40,29,40,8,0
61939,204,93,111,35,35,16,11,271,150,121,39,36,37,5,0
61940,410,188,222,53,52,31,14,341,170,171,41,66,27,10,0
61941,345,208,137,44,27,33,8,232,111,121,23,29,17,9,0
61942,261,130,131,27,41,19,16,374,202,172,50,39,31,24,0
61943,509,251,258,69,49,55,17,441,189,252,73,50,47,23,0
61944,887,439,448,137,99,91,38,507,270,237,89,59,57,22,0
61945,270,158,112,35,20,23,7,562,273,289,76,92,45,24,0
61946,126,57,69,31,10,10,3,326,169,157,51,41,41,12,0
61947,395,219,176,47,41,50,18,148,84,64,30,7,17,4,0
61948,813,412,401,114,93,112,26,189,105,84,25,26,21,9,0
61949,365,210,155,46,30,24,12,218,115,103,32,32,34,11,0
61950,349,167,182,54,38,30,28,1065,581,484,134,97,76,46,0
61951,574,269,305,91,63,54,27,349,200,149,41,39,30,20,0
61952,410,208,202,59,58,43,26,798,385,413,120,115,79,30,0
61953,217,98,119,38,35,18,9,402,186,216,64,47,38,20,0
61954,681,367,314,83,74,78,31,1230,644,586,198,125,123,61,0
61955,782,372,410,127,111,89,36,396,197,199,75,49,49,16,0
61956,126,56,70,31,10,10,3,773,389,384,119,91,79,26,0
61957,1960,875,1085,287,189,162,66,1321,653,668,186,195,70,35,0
61958,372,171,201,47,53,39,18,330,166,164,55,51,36,16,0
61959,315,170,145,48,56,22,11,497,257,240,71,63,62,16,0
61960,329,165,164,61,44,29,17,376,183,193,50,50,43,21,0
61961,1711,865,846,204,176,105,60,758,319,439,101,123,78,25,0
61962,1560,778,782,224,235,132,78,218,117,101,35,32,34,12,0
61963,682,260,422,153,78,109,46,384,204,180,53,47,49,17,0
61964,360,175,185,73,36,27,7,508,261,247,65,53,58,23,0
61965,258,126,132,38,22,29,8,330,166,164,55,51,36,16,0
61966,646,304,342,104,93,58,26,148,69,79,26,18,16,3,0
61967,282,96,186,80,21,28,7,602,310,292,87,66,70,36,0
61968,228,82,146,45,37,18,8,132,61,71,22,21,15,3,0
61969,648,376,272,70,60,73,24,926,425,501,159,147,77,35,0
61970,252,121,131,42,34,12,16,1265,689,576,169,177,128,60,0
61971,2286,1154,1132,338,314,278,103,780,337,443,112,116,77,28,0
61972,733,438,295,95,79,67,32,519,287,232,68,58,45,21,0
61973,805,338,467,153,138,99,55,246,125,121,38,36,30,11,0
61974,211,92,119,33,44,11,7,354,188,166,46,40,34,10,0
61975,130,71,59,30,9,8,2,169,84,85,29,19,21,7,0
61976,1849,931,918,245,220,158,90,536,251,285,75,79,60,23,0
61977,1009,478,531,166,126,96,42,620,324,296,81,68,66,31,0
61978,498,274,224,58,59,50,18,180,115,65,17,12,9,9,0
61979,242,111,131,35,35,17,13,222,122,100,39,32,24,9,0
61980,207,128,79,26,17,19,9,1314,693,621,174,155,140,58,0
61981,500,257,243,60,55,27,22,103,50,53,19,10,7,5,0
61982,325,181,144,46,31,48,9,153,80,73,26,18,19,4,0
61983,664,269,395,117,107,36,15,128,63,65,30,11,13,8,0
61984,485,246,239,74,48,47,22,166,102,64,19,14,17,2,0
61985,440,267,173,52,29,42,12,142,65,77,30,17,22,9,0
61986,483,236,247,82,60,43,18,415,203,212,77,44,49,18,0
61987,350,190,160,48,25,27,18,337,152,185,49,54,42,21,0
61988,51,10,41,25,0,5,8,455,229,226,66,62,63,29,0
61989,312,164,148,54,29,25,15,314,177,137,34,40,29,9,0
61990,126,58,68,31,10,10,3,1034,495,539,150,134,114,71,0
61991,325,181,144,46,31,48,9,592,249,343,91,90,50,42,0
61992,139,81,58,17,14,24,9,160,60,100,23,40,19,11,0
61993,169,64,105,23,37,11,3,597,300,297,96,89,68,29,0
61994,557,250,307,70,47,51,22,207,113,94,33,18,30,9,0
61995,502,274,228,64,49,75,17,350,196,154,52,37,21,14,0
61996,169,64,105,23,37,11,3,323,171,152,48,41,40,16,0
61997,567,266,301,139,46,76,37,926,340,586,133,119,60,40,0
61998,431,199,232,59,54,40,17,462,251,211,74,53,41,18,0
61999,688,310,378,130,82,78,47,135,65,70,21,25,15,9,0
62000,682,292,390,89,69,58,20,462,229,233,63,49,42,18,0
62001,193,110,83,18,20,15,12,276,149,127,34,31,32,10,0
62002,334,190,144,42,42,16,5,620,324,296,81,68,66,31,0
62003,126,56,70,31,10,10,3,866,397,469,117,153,95,48,0
62004,760,322,438,81,130,57,19,1537,701,836,209,187,129,58,0
62005,734,366,368,121,99,63,39,763,418,345,113,84,59,32,0
62006,539,283,256,75,73,53,26,480,255,225,67,64,50,22,0
62007,1336,724,612,209,141,133,60,72,32,40,8,2,1,14,0
62008,1096,563,533,158,136,120,53,390,223,167,58,36,45,18,0
62009,1199,589,610,189,128,167,65,213,129,84,32,14,21,15,0
62010,431,245,186,50,23,46,17,1001,417,584,186,147,96,47,0
62011,1867,973,894,256,222,194,65,180,115,65,17,12,9,9,0
62012,793,355,438,134,117,77,43,154,78,76,23,21,13,5,0
62013,505,282,223,60,57,66,23,290,147,143,34,34,39,13,0
62014,476,199,277,82,80,49,24,392,155,237,68,61,34,16,0
62015,1004,464,540,143,104,78,55,373,213,160,44,33,26,17,0
62016,600,324,276,89,73,45,39,201,99,102,34,26,23,6,0
62017,425,198,227,57,69,59,13,98,49,49,14,15,9,2,0
62018,535,217,318,87,106,41,14,316,166,150,45,38,37,13,0
62019,773,383,390,108,76,79,30,138,69,69,28,7,10,10,0
62020,2109,999,1110,332,294,187,89,704,355,349,113,94,71,24,0
62021,911,445,466,154,121,108,48,453,255,198,62,49,29,19,0
62022,610,249,361,107,69,72,33,403,184,219,75,51,47,20,0
62023,856,429,427,113,105,96,24,415,226,189,51,40,40,29,0
62024,531,260,271,97,68,47,11,415,226,189,51,40,40,29,0
62025,766,336,430,133,97,79,21,322,180,142,45,38,28,7,0
62026,436,201,235,54,37,35,18,105,51,54,13,17,12,8,0
62027,539,283,256,75,73,53,26,190,93,97,35,27,23,2,0
62028,529,290,239,54,63,85,15,262,129,133,40,41,31,10,0
62029,344,109,235,100,39,26,5,418,246,172,52,39,57,10,0
62030,677,361,316,81,61,42,22,380,211,169,47,37,33,21,0
62031,134,60,74,19,13,10,7,391,189,202,55,56,56,12,0
62032,433,188,245,63,45,26,14,108,59,49,17,13,12,5,0
62033,1498,731,767,220,175,148,68,209,119,90,28,24,27,9,0
62034,441,218,223,69,55,50,27,439,231,208,65,51,55,17,0
62035,280,156,124,36,19,20,13,583,280,303,95,66,76,25,0
62036,519,259,260,86,78,59,22,547,295,252,81,65,57,23,0
62037,252,121,131,42,34,12,16,296,151,145,45,42,32,11,0
62038,426,214,212,63,47,53,20,213,129,84,32,14,21,15,0
62039,380,185,195,68,54,32,16,1040,564,476,134,110,114,51,0
62040,911,489,422,121,98,97,36,171,94,77,24,28,30,11,0
62041,271,110,161,33,27,11,8,381,196,185,55,57,43,16,0
62042,622,354,268,89,60,64,18,660,332,328,84,73,47,19,0
62043,1189,653,536,152,118,109,56,127,64,63,26,8,12,8,0
62044,359,167,192,49,37,27,19,368,200,168,54,49,43,9,0
62045,561,282,279,68,62,36,14,198,113,85,19,20,26,12,0
62046,346,205,141,47,34,30,7,514,248,266,86,82,52,22,0
62047,90,54,36,20,4,14,5,145,77,68,26,7,15,8,0
62048,388,209,179,46,24,31,28,337,152,185,49,54,42,21,0
62049,1849,931,918,245,220,158,90,89,37,52,13,6,2,9,0
62050,485,237,248,83,35,52,24,104,46,58,15,17,9,5,0
62051,860,349,511,166,166,58,19,758,319,439,101,123,78,25,0
62052,411,211,200,61,46,35,18,843,391,452,139,104,91,35,0
62053,281,125,156,44,47,17,7,172,79,93,34,27,23,10,0
62054,456,223,233,77,54,47,20,975,475,500,139,140,119,28,0
62055,126,56,70,31,10,10,3,390,190,200,66,50,43,12,0
62056,358,212,146,51,36,33,9,199,105,94,27,27,28,9,0
62057,261,130,131,27,41,19,16,335,170,165,52,36,47,11,0
62058,1220,575,645,208,179,99,56,368,204,164,43,35,30,24,0
62059,441,216,225,57,66,57,19,449,252,197,61,52,36,18,0
62060,536,287,249,64,73,21,27,660,333,327,102,95,69,31,0
62061,374,187,187,51,52,40,27,380,211,169,47,37,33,21,0
62062,357,182,175,49,36,39,15,390,190,200,66,50,43,12,0
62063,301,119,182,53,47,14,20,535,311,224,66,52,49,24,0
62064,852,472,380,99,79,70,27,346,178,168,58,41,33,12,0
62065,262,133,129,44,38,31,12,583,280,303,95,66,76,25,0
62066,441,218,223,69,55,50,27,300,148,152,45,43,40,8,0
62067,665,341,324,109,79,38,22,453,255,198,62,49,29,19,0
62068,346,209,137,46,37,44,10,464,236,228,64,56,53,28,0
62069,557,211,346,129,125,48,19,234,116,118,34,35,23,9,0
62070,342,185,157,42,27,31,14,160,76,84,19,24,8,5,0
62071,450,227,223,53,36,48,12,218,111,107,45,29,24,6,0
62072,420,202,218,67,43,51,15,584,249,335,80,96,22,13,0
62073,416,207,209,63,47,56,15,531,261,270,73,80,68,26,0
62074,631,304,327,98,75,52,23,390,190,200,66,50,43,12,0
62075,519,259,260,86,78,59,22,164,79,85,28,28,16,7,0
62076,181,75,106,35,26,11,9,715,345,370,110,97,64,25,0
62077,271,136,135,37,30,18,10,240,141,99,34,28,29,8,0
62078,179,96,83,24,8,26,4,290,142,148,41,37,43,11,0
62079,1439,713,726,195,180,110,34,106,46,60,27,18,12,3,0
62080,361,167,194,55,35,41,11,541,279,262,79,82,31,32,0
62081,658,349,309,77,70,73,35,514,262,252,78,58,54,26,0
62082,367,167,200,63,42,60,17,597,269,328,102,84,69,24,0
62083,1221,597,624,201,152,83,31,142,73,69,27,9,15,11,0
62084,432,190,242,85,82,28,11,188,93,95,33,18,16,10,0
62085,482,245,237,69,64,66,24,201,104,97,36,32,24,7,0
62086,221,114,107,65,7,2,1,974,457,517,133,117,69,26,0
62087,139,81,58,17,14,24,9,1065,581,484,134,97,76,46,0
62088,157,62,95,41,18,10,11,277,138,139,40,39,20,14,0
62089,279,129,150,43,34,17,13,260,133,127,43,32,39,3,0
62090,1058,497,561,194,142,87,63,260,131,129,42,31,40,9,0
62091,224,101,123,45,32,21,3,647,324,323,101,80,76,43,0
62092,753,395,358,93,72,71,16,68,23,45,12,9,3,9,0
62093,680,308,372,82,72,71,40,463,259,204,62,55,34,22,0
62094,494,242,252,67,47,25,21,198,86,112,36,27,23,9,0
62095,828,368,460,118,98,59,38,171,94,77,24,28,30,11,0
62096,527,276,251,64,60,70,20,178,69,109,29,25,21,13,0
62097,717,281,436,165,81,112,49,395,198,197,55,55,36,10,0
62098,559,217,342,105,86,42,16,381,187,194,37,49,36,17,0
62099,580,281,299,95,60,74,29,441,189,252,73,50,47,23,0
62100,911,489,422,121,98,97,36,102,51,51,12,15,12,3,0
62101,234,110,124,39,29,23,2,518,292,226,60,60,52,21,0
62102,350,178,172,49,62,29,16,660,333,327,102,95,69,31,0
62103,99,35,64,25,18,0,1,926,425,501,159,147,77,35,0
62104,746,312,434,129,115,77,47,1265,689,576,169,177,128,60,0
62105,267,146,121,40,24,25,7,91,44,47,9,12,4,7,0
62106,949,467,482,126,127,102,51,2382,1162,1220,237,220,140,49,0
62107,588,317,271,78,49,54,17,332,173,159,48,40,31,11,0
62108,379,217,162,47,20,50,23,136,65,71,26,11,7,5,0
62109,222,108,114,37,20,25,12,309,159,150,47,43,43,13,0
62110,109,42,67,25,13,1,1,330,166,164,55,51,36,16,0
62111,281,154,127,45,31,24,9,478,254,224,67,74,56,28,0
62112,561,282,279,68,62,36,14,326,149,177,51,51,28,10,0
62113,346,168,178,36,43,20,9,317,161,156,50,36,47,12,0
62114,536,287,249,64,73,21,27,137,63,74,20,22,14,6,0
62115,83,45,38,11,8,8,3,422,202,220,80,52,57,18,0
62116,193,107,86,13,20,13,6,515,276,239,62,59,43,31,0
62117,639,368,271,72,51,38,38,406,202,204,54,51,63,21,0
62118,493,208,285,75,77,70,40,364,189,175,58,41,35,17,0
62119,304,149,155,46,32,39,14,129,60,69,21,15,8,5,0
62120,508,267,241,43,35,25,17,360,185,175,51,43,36,16,0
62121,393,223,170,44,36,32,14,403,233,170,38,29,21,14,0
62122,161,94,67,23,13,8,10,337,152,185,49,54,42,21,0
62123,553,276,277,88,61,45,27,139,68,71,14,26,14,9,0
62124,356,199,157,36,43,28,12,665,361,304,87,91,84,31,0
62125,536,287,249,64,73,21,27,561,279,282,85,81,88,24,0
62126,301,156,145,32,25,15,5,708,328,380,113,100,82,34,0
62127,588,317,271,78,49,54,17,715,345,370,110,97,64,25,0
62128,437,230,207,41,55,27,13,2382,1162,1220,237,220,140,49,0
62129,443,250,193,52,23,49,13,509,267,242,79,81,38,20,0
62130,333,171,162,50,34,19,8,218,114,104,32,31,33,11,0
62131,347,212,135,35,32,17,6,452,254,198,72,57,38,18,0
62132,390,199,191,72,42,35,12,536,222,314,101,100,34,22,0
62133,227,110,117,33,26,24,13,165,87,78,24,19,22,9,0
62134,476,199,277,82,80,49,24,218,111,107,45,29,24,6,0
62135,510,269,241,66,67,71,26,662,312,350,103,104,59,20,0
62136,1501,679,822,251,196,174,67,173,94,79,18,24,12,7,0
62137,338,139,199,54,54,18,11,198,86,112,36,27,23,9,0
62138,746,312,434,129,115,77,47,385,212,173,57,40,39,21,0
62139,579,246,333,102,79,41,19,234,129,105,31,22,19,17,0
62140,396,150,246,103,64,38,3,296,159,137,49,28,38,13,0
62141,432,233,199,52,28,47,18,418,223,195,53,43,49,15,0
62142,303,147,156,49,49,20,8,198,115,83,30,22,8,8,0
62143,362,181,181,67,46,43,8,171,94,77,24,28,30,11,0
62144,1718,735,983,266,225,130,68,349,200,149,41,39,30,20,0
62145,159,105,54,22,9,14,25,260,133,127,43,32,39,3,0
62146,1249,543,706,187,164,125,52,278,154,124,42,32,38,7,0
62147,428,226,202,52,60,75,20,455,229,226,66,62,63,29,0
62148,2136,1063,1073,317,308,223,90,258,129,129,45,24,31,10,0
62149,1087,523,564,146,177,103,33,198,86,112,36,27,23,9,0
62150,158,85,73,24,18,18,8,380,178,202,69,53,37,10,0
62151,641,349,292,92,60,39,24,302,150,152,56,40,52,15,0
62152,610,249,361,107,69,72,33,374,212,162,48,40,32,23,0
62153,1189,653,536,152,118,109,56,531,261,270,73,80,68,26,0
62154,136,66,70,33,11,9,3,548,273,275,84,81,64,30,0
62155,271,136,135,37,30,18,10,408,221,187,55,51,57,14,0
62156,442,254,188,46,22,40,19,633,311,322,94,82,45,20,0
62157,524,270,254,84,72,70,23,732,366,366,108,86,74,41,0
62158,301,150,151,45,47,33,13,309,159,150,47,43,43,13,0
62159,717,281,436,165,81,112,49,592,249,343,91,90,50,42,0
62160,471,221,250,87,68,42,25,487,252,235,79,58,55,26,0
62161,482,231,251,76,81,64,26,620,324,296,81,68,66,31,0
62162,270,158,112,35,20,23,7,1061,543,518,146,123,109,67,0
62163,1555,702,853,250,199,139,31,137,63,74,20,22,14,6,0
62164,911,445,466,154,121,108,48,935,515,420,126,107,73,32,0
62165,2063,1024,1039,175,117,80,97,106,54,52,12,9,7,6,0
62166,426,214,212,63,47,53,20,549,273,276,74,68,72,24,0
62167,1199,589,610,189,128,167,65,111,60,51,17,23,10,7,0
62168,381,146,235,74,48,47,34,374,174,200,54,52,42,21,0
62169,196,107,89,20,31,17,4,609,335,274,79,57,45,22,0
62170,739,323,416,127,89,76,33,295,160,135,44,36,46,16,0
62171,1051,429,622,179,148,125,54,323,168,155,51,41,38,12,0
62172,594,279,315,93,68,68,26,374,191,183,40,52,40,16,0
62173,1134,574,560,157,164,47,48,364,181,183,63,55,36,11,0
62174,490,198,292,65,81,39,27,452,252,200,55,49,61,16,0
62175,820,333,487,202,152,59,23,1047,562,485,141,127,114,41,0
62176,747,360,387,125,92,69,32,173,90,83,21,36,12,15,0
62177,1709,650,1059,338,286,185,46,231,126,105,28,26,34,9,0
62178,390,199,191,72,42,35,12,172,88,84,24,31,20,12,0
62179,346,191,155,52,38,40,13,1700,731,969,198,233,110,87,0
62180,406,208,198,41,26,43,21,352,207,145,40,33,25,21,0
62181,392,205,187,83,49,38,10,654,295,359,99,88,71,25,0
62182,501,230,271,63,90,50,18,422,202,220,80,52,57,18,0
62183,415,133,282,114,65,27,7,925,439,486,141,134,105,46,0
62184,795,384,411,133,109,85,38,188,101,87,20,18,20,14,0
62185,286,111,175,51,47,21,12,1500,804,696,190,172,144,60,0
62186,795,384,411,133,109,85,38,1061,543,518,146,123,109,67,0
62187,1143,574,569,176,151,123,59,89,37,52,13,6,2,9,0
62188,879,457,422,93,98,143,32,125,66,59,24,16,11,5,0
62189,717,281,436,165,81,112,49,406,234,172,63,35,43,10,0
62190,169,64,105,23,37,11,3,437,224,213,40,29,42,25,0
62191,1200,602,598,145,116,110,50,727,362,365,123,107,63,23,0
62192,227,120,107,31,28,28,13,900,441,459,125,127,110,32,0
62193,431,216,215,46,40,33,9,975,400,575,160,162,62,31,0
62194,130,72,58,28,9,7,1,761,351,410,117,73,103,45,0
62195,380,148,232,81,69,24,8,551,226,325,96,103,43,11,0
62196,411,202,209,60,67,57,24,300,148,152,45,43,40,8,0
62197,1064,495,569,157,159,124,58,222,119,103,37,32,24,8,0
62198,2062,706,1356,414,368,158,63,396,223,173,57,37,44,19,0
62199,626,300,326,91,82,68,26,299,140,159,49,44,26,11,0
62200,879,457,422,93,98,143,32,1114,539,575,145,131,94,56,0
62201,245,111,134,36,27,18,6,244,143,101,31,29,26,8,0
62202,325,177,148,40,24,23,13,132,67,65,24,21,8,10,0
62203,121,69,52,15,18,14,8,222,124,98,37,29,22,9,0
62204,753,361,392,99,94,66,16,298,129,169,51,40,29,8,0
62205,824,391,433,106,90,88,32,368,204,164,43,35,30,24,0
62206,122,56,66,26,13,11,5,175,82,93,33,26,17,5,0
62207,953,421,532,131,131,70,37,900,441,459,125,127,110,32,0
62208,323,156,167,52,45,39,18,588,286,302,78,99,53,25,0
62209,364,192,172,49,36,39,14,308,129,179,44,60,19,8,0
62210,1143,574,569,176,151,123,59,449,252,197,61,52,36,18,0
62211,330,77,253,86,52,20,12,94,45,49,11,20,10,4,0
62212,128,70,58,29,9,8,1,153,80,73,26,18,19,4,0
62213,240,98,142,49,42,23,17,744,385,359,105,96,57,31,0
62214,315,174,141,46,38,47,16,260,131,129,42,31,40,9,0
62215,717,381,336,118,103,85,29,478,254,224,67,74,56,28,0
62216,98,32,66,15,25,5,4,434,213,221,77,62,53,12,0
62217,71,39,32,7,11,6,4,720,361,359,98,98,70,37,0
62218,326,148,178,55,42,31,12,106,46,60,27,18,12,3,0
62219,502,250,252,70,47,57,15,251,143,108,47,25,29,11,0
62220,983,449,534,95,77,55,36,508,262,246,66,67,51,20,0
62221,315,111,204,82,66,46,11,531,261,270,73,80,68,26,0
62222,521,289,232,71,58,49,16,541,279,262,79,82,31,32,0
62223,586,298,288,80,75,64,37,373,181,192,54,35,44,20,0
62224,1235,584,651,140,226,82,52,467,231,236,71,65,58,18,0
62225,344,109,235,100,39,26,5,1873,935,938,233,225,203,79,0
62226,431,202,229,57,50,50,25,124,69,55,14,7,9,4,0
62227,640,271,369,111,79,57,17,475,251,224,67,49,48,23,0
62228,595,208,387,157,60,91,48,283,160,123,25,20,37,9,0
62229,111,29,82,10,54,0,1,332,180,152,44,36,27,13,0
62230,828,355,473,126,134,77,37,457,245,212,62,58,57,21,0
62231,221,75,146,68,21,16,5,461,223,238,45,62,18,35,0
62232,468,233,235,65,61,49,34,207,114,93,33,20,31,13,0
62233,172,98,74,20,21,22,8,461,223,238,45,62,18,35,0
62234,136,66,70,33,11,9,3,732,402,330,81,86,87,33,0
62235,327,174,153,42,35,16,12,132,61,71,22,21,15,3,0
62236,1498,731,767,220,175,148,68,592,249,343,91,90,50,42,0
62237,1174,594,580,175,155,126,66,331,180,151,46,35,47,17,0
62238,299,151,148,35,34,26,16,464,236,228,64,56,53,28,0
62239,469,221,248,49,60,55,21,360,180,180,57,48,39,12,0
62240,553,276,277,88,61,45,27,332,173,159,48,40,31,11,0
62241,118,51,67,25,13,6,7,463,259,204,62,55,34,22,0
62242,327,174,153,42,35,16,12,422,237,185,53,47,62,20,0
62243,412,146,266,106,38,67,35,293,142,151,49,40,42,17,0
62244,502,274,228,64,49,75,17,723,363,360,107,106,52,14,0
62245,650,330,320,97,77,65,28,406,234,172,63,35,43,10,0
62246,643,284,359,129,71,84,43,2038,1059,979,262,237,208,100,0
62247,493,281,212,56,61,30,13,381,196,185,55,57,43,16,0
62248,589,282,307,68,67,70,23,346,196,150,43,26,27,14,0
62249,579,246,333,102,79,41,19,1873,935,938,233,225,203,79,0
62250,856,429,427,113,105,96,24,227,130,97,32,25,22,12,0
62251,434,216,218,72,58,40,20,180,115,65,17,12,9,9,0
62252,231,105,126,56,10,24,10,148,69,79,26,18,16,3,0
62253,425,198,227,57,69,59,13,240,141,99,34,28,29,8,0
62254,808,366,442,130,133,66,31,380,178,202,69,53,37,10,0
62255,1226,513,713,184,147,87,43,1395,627,768,172,263,141,59,0
62256,437,230,207,41,55,27,13,773,389,384,119,91,79,26,0
62257,898,397,501,102,98,54,37,1101,626,475,145,122,120,50,0
62258,467,233,234,83,37,77,22,334,181,153,56,31,28,18,0
62259,594,248,346,104,109,53,5,504,272,232,75,57,53,19,0
62260,516,210,306,113,53,81,33,391,189,202,55,56,56,12,0
62261,1221,597,624,201,152,83,31,188,88,100,53,12,15,6,0
62262,388,209,179,46,24,31,28,445,202,243,70,73,51,15,0
62263,434,221,213,58,47,54,15,492,278,214,65,58,32,11,0
62264,465,220,245,88,34,61,23,663,360,303,87,82,80,35,0
62265,278,104,174,46,34,23,14,594,312,282,72,67,73,31,0
62266,753,395,358,93,72,71,16,403,192,211,102,39,49,15,0
62267,629,374,255,74,53,87,27,373,181,192,54,35,44,20,0
62268,374,202,172,58,40,41,7,524,300,223,70,54,51,25,0
62269,279,129,150,43,34,17,13,192,91,101,29,28,17,7,0
62270,715,345,370,110,97,64,25,495,217,278,79,64,44,22,0
62271,785,351,434,136,93,71,37,227,130,97,32,25,22,12,0
62272,272,141,131,45,29,36,9,437,221,216,62,64,47,13,0
62273,204,93,111,35,35,16,11,314,177,137,34,40,29,9,0
62274,972,501,471,125,156,106,39,1154,489,665,200,196,95,54,0
62275,300,136,164,45,35,45,14,72,32,40,8,2,2,13,0
62276,107,36,71,27,15,0,1,68,23,45,12,9,3,9,0
62277,2442,1193,1249,278,183,170,145,257,139,118,64,17,24,7,0
62278,236,141,95,36,32,14,6,127,58,69,18,17,10,5,0
62279,469,221,248,49,60,55,21,325,159,166,59,46,30,12,0
62280,1580,742,838,208,146,144,71,194,94,100,33,28,14,7,0
62281,784,353,431,56,47,26,18,470,205,265,71,80,33,11,0
62282,1096,563,533,158,136,120,53,363,180,183,60,34,10,6,0
62283,1257,464,793,221,264,75,37,270,130,140,48,44,37,12,0
62284,329,171,158,49,41,31,10,449,252,197,61,52,36,18,0
62285,331,169,162,40,28,22,14,393,210,183,58,37,34,20,0
62286,1464,693,771,153,136,91,86,732,402,330,81,86,87,33,0
62287,789,362,427,90,82,70,35,467,231,236,71,65,58,18,0
62288,230,114,116,30,33,29,8,201,93,108,34,39,21,6,0
62289,426,213,213,60,56,46,24,305,161,144,39,40,44,17,0
62290,412,203,209,65,47,37,18,142,65,77,30,17,22,9,0
62291,626,308,318,105,89,77,25,470,205,265,71,80,33,11,0
62292,886,440,446,116,140,95,45,198,86,112,36,27,23,9,0
62293,580,308,272,82,79,58,25,346,196,150,43,26,27,14,0
62294,496,274,222,57,43,75,22,72,32,40,8,2,2,13,0
62295,313,178,135,43,18,35,6,242,124,118,39,32,28,22,0
62296,571,298,273,81,72,57,25,1040,564,476,134,110,114,51,0
62297,565,264,301,101,73,72,15,1323,690,633,132,178,112,61,0
62298,629,338,291,92,57,64,22,449,252,197,61,52,36,18,0
62299,520,240,280,87,63,67,16,332,180,152,44,36,27,13,0
62300,692,305,387,100,97,78,30,715,345,370,110,97,64,25,0
62301,243,70,173,54,65,8,6,148,84,64,30,7,17,4,0
62302,443,226,217,67,34,53,10,975,475,500,139,140,119,28,0
62303,340,181,159,44,39,35,21,192,110,82,33,21,10,3,0
62304,502,250,252,70,47,57,15,212,127,85,28,21,26,6,0
62305,505,226,279,68,51,30,15,524,300,223,70,54,51,25,0
62306,347,212,135,35,32,17,6,323,171,152,48,41,40,16,0
62307,929,410,519,187,146,53,30,662,312,350,103,104,59,20,0
62308,760,322,438,81,130,57,19,445,202,243,70,73,51,15,0
62309,164,61,103,47,19,14,5,1352,602,750,166,185,81,70,0
62310,1011,559,452,121,97,132,33,132,61,71,22,21,15,3,0
62311,484,192,292,118,68,83,22,222,127,95,23,28,22,7,0
62312,233,107,126,40,40,20,16,541,279,262,79,82,31,32,0
62313,919,493,426,100,92,88,49,640,364,276,84,68,69,33,0
62314,283,112,171,48,39,34,15,257,139,118,64,17,24,7,0
62315,478,177,301,109,66,59,25,277,138,139,40,39,20,14,0
62316,437,167,270,126,95,34,10,309,159,150,47,43,43,13,0
62317,130,70,60,30,9,8,1,1537,701,836,209,187,129,58,0
62318,318,161,157,53,51,32,13,1698,875,823,222,219,173,64,0
62319,164,81,83,37,8,14,10,332,155,177,55,51,44,13,0
62320,447,236,211,56,52,49,14,381,186,195,69,55,46,15,0
62321,446,283,163,51,26,33,19,720,361,359,98,98,70,37,0
62322,451,225,226,69,57,64,22,246,125,121,38,36,30,11,0
62323,398,186,212,76,70,18,13,1001,417,584,186,147,96,47,0
62324,340,181,159,44,39,35,21,348,194,154,57,31,43,12,0
62325,362,181,181,67,46,43,8,299,140,159,49,44,26,11,0
62326,396,150,246,103,64,38,3,549,273,276,74,68,72,24,0
62327,666,204,462,110,194,42,14,381,187,194,37,49,36,17,0
62328,345,203,142,47,35,31,11,257,126,131,61,24,22,8,0
62329,519,259,260,86,78,59,22,322,180,142,45,38,28,7,0
62330,411,211,200,61,46,35,18,2346,1231,1115,316,292,266,105,0
62331,412,203,209,65,47,37,18,386,207,179,43,48,44,19,0
62332,1580,742,838,208,146,144,71,149,77,72,37,10,20,5,0
62333,210,84,126,44,43,9,4,380,211,169,47,37,33,21,0
62334,785,374,411,56,42,38,25,337,152,185,49,54,42,21,0
62335,512,254,258,70,48,37,32,441,189,252,73,50,47,23,0
62336,782,372,410,127,111,89,36,644,343,301,96,69,59,28,0
62337,435,230,205,51,37,55,18,314,177,137,34,40,29,9,0
62338,130,71,59,30,9,8,1,398,200,198,68,43,51,14,0
62339,579,281,298,91,78,74,27,583,321,262,73,67,45,25,0
62340,860,348,512,121,136,75,35,289,140,149,33,42,30,15,0
62341,733,438,295,95,79,67,32,144,67,77,28,14,9,8,0
62342,245,111,134,36,27,18,6,201,99,102,34,26,23,6,0
62343,339,118,221,77,68,33,13,620,324,296,81,68,66,31,0
62344,252,121,131,42,34,12,16,485,244,241,80,55,59,20,0
62345,226,120,106,68,8,2,1,671,306,365,114,76,49,19,0
62346,508,136,372,157,91,22,9,348,194,154,57,31,43,12,0
62347,249,104,145,47,41,24,17,132,67,65,24,21,8,10,0
62348,548,250,298,85,64,56,21,295,160,135,42,37,46,16,0
62349,648,262,386,113,108,78,29,153,65,88,28,21,20,8,0
62350,301,119,182,53,47,14,20,818,357,461,122,136,54,25,0
62351,369,166,203,59,55,41,14,89,51,38,15,15,5,4,0
62352,1208,575,633,187,204,117,41,106,41,65,36,6,11,7,0
62353,446,265,181,51,35,27,17,375,176,199,48,61,40,12,0
62354,616,304,312,75,71,55,25,439,231,208,65,51,55,17,0
62355,490,224,266,80,70,39,32,419,233,186,54,53,55,17,0
62356,437,230,207,41,55,27,13,262,129,133,40,41,31,10,0
62357,458,226,232,77,59,61,14,478,254,224,67,74,56,28,0
62358,553,276,277,88,61,45,27,326,169,157,51,41,41,12,0
62359,401,183,218,72,73,28,10,364,189,175,58,41,35,17,0
62360,221,114,107,65,7,2,1,201,99,102,34,26,23,6,0
62361,1835,904,931,192,144,135,63,190,93,97,35,27,23,2,0
62362,1226,513,713,184,147,87,43,251,143,108,47,25,29,11,0
62363,546,265,281,101,64,38,16,89,37,52,13,6,2,9,0
62364,1011,559,452,121,97,132,33,223,113,110,31,33,22,12,0
62365,595,208,387,157,60,91,48,277,138,139,40,39,20,14,0
62366,1960,875,1085,287,189,162,66,194,109,85,23,24,21,9,0
62367,556,306,250,69,60,80,18,555,282,273,82,69,65,21,0
62368,636,288,348,94,77,65,30,125,66,59,24,16,11,5,0
62369,1030,567,463,118,106,94,49,526,266,260,76,75,53,22,0
62370,682,260,422,98,83,42,31,627,289,338,101,73,62,43,0
62371,727,426,301,79,71,64,32,124,69,55,14,7,9,4,0
62372,575,290,285,67,70,28,9,744,385,359,105,96,57,31,0
62373,2220,1085,1135,312,304,202,91,314,151,163,42,61,39,16,0
62374,413,206,207,38,55,19,10,158,71,87,23,21,17,12,0
62375,524,262,262,62,72,39,49,395,169,226,73,55,38,9,0
62376,960,409,551,166,134,77,44,232,111,121,23,29,17,9,0
62377,1087,523,564,146,177,103,33,373,213,160,44,33,26,17,0
62378,109,42,67,25,13,1,1,526,266,260,76,75,53,22,0
62379,595,316,279,86,60,65,40,729,358,371,116,99,89,33,0
62380,126,58,68,31,10,10,3,203,98,105,34,29,19,10,0
62381,414,195,219,51,60,40,17,283,160,123,25,20,37,9,0
62382,142,76,66,21,21,22,11,354,183,171,54,43,49,8,0
62383,489,253,236,73,36,62,17,135,57,78,21,20,9,11,0
62384,607,305,302,92,89,74,23,408,221,187,55,51,57,14,0
62385,312,173,139,43,47,28,6,1606,753,853,215,227,182,48,0
62386,428,248,180,44,39,28,9,111,60,51,17,23,10,7,0
62387,462,233,229,66,49,43,30,199,92,107,34,30,18,9,0
62388,785,374,411,56,42,38,25,778,391,387,94,77,41,33,0
62389,118,56,62,24,12,6,9,561,279,282,85,81,88,24,0
62390,178,74,104,31,28,9,4,188,101,87,20,18,20,14,0
62391,509,251,258,69,49,55,17,406,234,172,63,35,43,10,0
62392,605,277,328,99,54,63,43,266,150,116,28,28,24,12,0
62393,1171,542,629,170,146,114,64,727,362,365,123,107,63,23,0
62394,509,251,258,69,49,55,17,330,166,164,55,51,36,16,0
62395,397,180,217,61,59,39,13,348,212,136,53,31,25,18,0
62396,282,96,186,80,21,28,7,664,350,314,86,90,82,36,0
62397,524,262,262,62,72,39,49,862,426,436,113,115,84,37,0
62398,710,352,358,104,86,84,41,203,98,105,34,29,19,10,0
62399,2000,965,1035,357,313,198,75,180,90,90,31,19,20,8,0
62400,150,60,90,27,16,6,3,160,76,84,19,24,8,5,0
62401,557,250,307,70,47,51,22,328,195,133,39,40,27,13,0
62402,2174,1057,1117,241,241,214,117,119,61,58,17,12,10,6,0
62403,726,312,414,121,73,82,23,975,475,500,139,140,119,28,0
62404,401,183,218,72,73,28,10,673,313,360,102,101,46,17,0
62405,520,261,259,74,52,49,22,240,141,99,34,28,29,8,0
62406,109,42,67,25,13,1,1,1249,638,611,166,153,141,45,0
62407,224,101,123,45,32,21,3,166,102,64,19,14,17,2,0
62408,410,211,199,55,42,34,27,205,94,111,48,31,15,6,0
62409,220,121,99,28,26,17,6,295,158,137,42,34,38,14,0
62410,626,308,318,105,89,77,25,350,196,154,52,37,21,14,0
62411,359,198,161,51,28,54,13,247,128,119,40,21,27,11,0
62412,643,284,359,129,71,84,43,247,128,119,34,14,16,14,0
62413,462,228,234,59,47,37,32,744,385,359,105,96,57,31,0
62414,1360,644,716,213,194,136,62,720,361,359,98,98,70,37,0
62415,480,232,248,73,40,44,30,328,199,129,39,29,27,14,0
62416,496,210,286,112,55,72,13,200,99,101,31,24,26,6,0
62417,446,265,181,51,35,27,17,171,94,77,24,28,30,11,0
62418,627,237,390,137,57,108,44,474,268,206,66,42,45,24,0
62419,483,236,247,82,60,43,18,556,290,266,75,74,29,24,0
62420,431,202,229,57,50,50,25,1755,905,850,214,196,183,79,0
62421,1054,453,601,183,183,107,35,485,244,241,80,55,59,20,0
62422,498,274,224,58,59,50,18,665,361,304,87,91,84,31,0
62423,320,163,157,44,44,26,15,173,86,87,30,22,19,12,0
62424,795,384,411,133,109,85,38,297,164,133,45,39,40,9,0
62425,538,263,275,71,85,44,18,309,159,150,47,43,43,13,0
62426,335,171,164,51,38,38,10,405,195,210,57,74,24,17,0
62427,51,10,41,25,0,5,8,975,475,500,139,140,119,28,0
62428,423,247,176,58,55,29,20,303,138,165,47,46,35,18,0
62429,1011,559,452,121,97,132,33,222,125,97,34,27,27,7,0
62430,237,127,110,34,30,16,9,935,515,420,126,107,73,32,0
62431,983,449,534,95,77,55,36,101,59,42,11,17,10,1,0
62432,429,227,202,49,51,46,26,169,84,85,29,19,21,7,0
62433,1163,417,746,209,145,87,28,1249,638,611,166,153,141,45,0
62434,595,316,279,86,60,65,40,279,142,137,43,39,28,7,0
62435,437,167,270,126,95,34,10,164,79,85,28,28,16,7,0
62436,540,252,288,73,67,57,20,397,223,174,50,39,29,17,0
62437,270,147,123,34,17,39,21,203,98,105,34,29,19,10,0
62438,117,58,59,17,17,12,2,198,86,112,36,27,23,9,0
62439,271,110,161,33,27,11,8,737,397,340,87,104,90,14,0
62440,1217,647,570,142,160,129,45,963,455,508,127,130,115,48,0
62441,1501,679,822,251,196,174,67,188,93,95,33,18,16,10,0
62442,643,284,359,129,71,84,43,192,91,101,29,28,17,7,0
62443,139,81,58,17,14,24,9,178,99,79,31,19,26,8,0
62444,178,74,104,31,28,9,4,138,69,69,28,7,10,10,0
62445,220,113,107,37,24,16,7,339,175,164,51,49,37,9,0
62446,181,92,89,34,22,17,9,479,215,264,67,80,46,28,0
62447,432,190,242,85,82,28,11,207,113,94,33,18,30,9,0
62448,557,250,307,70,47,51,22,346,178,168,58,41,33,12,0
62449,545,221,324,101,72,55,30,978,536,442,132,107,67,32,0
62450,919,444,475,141,148,62,20,843,391,452,139,104,91,35,0
62451,219,98,121,43,19,11,7,248,118,130,54,31,26,5,0
62452,282,84,198,60,102,1,6,234,116,118,34,35,23,9,0
62453,1390,585,805,241,230,118,46,398,200,198,68,43,51,14,0
62454,521,289,232,71,58,49,16,406,202,204,54,51,63,21,0
62455,687,351,336,106,67,70,41,483,258,225,70,53,54,20,0
62456,553,319,234,56,37,54,18,741,383,358,92,63,79,36,0
62457,325,181,144,46,31,48,9,178,69,109,29,25,21,13,0
62458,260,136,124,24,41,19,4,201,117,83,22,21,19,9,0
62459,126,56,70,31,10,10,3,296,140,156,49,40,42,19,0
62460,2279,996,1283,375,328,158,60,218,118,100,33,30,25,11,0
62461,908,324,584,181,162,81,29,661,325,336,81,75,65,28,0
62462,341,154,187,34,36,11,11,445,264,181,35,35,34,14,0
62463,1711,865,846,204,176,105,60,403,192,211,102,39,49,15,0
62464,619,289,330,67,77,36,19,279,142,137,43,39,28,7,0
62465,789,362,427,90,82,70,35,663,354,309,91,84,79,31,0
62466,802,430,372,65,102,87,23,594,312,282,72,67,73,31,0
62467,824,391,433,106,90,88,32,452,254,198,72,57,38,18,0
62468,260,133,127,43,29,34,11,232,111,121,23,29,17,9,0
62469,126,56,70,31,10,10,3,378,154,224,74,84,35,22,0
62470,126,57,69,31,10,10,3,242,124,118,39,32,28,22,0
62471,134,60,74,19,13,10,7,374,191,183,40,52,40,16,0
62472,2442,1193,1249,278,183,170,145,843,391,452,139,104,91,35,0
62473,595,316,279,86,60,65,40,487,252,235,79,58,55,26,0
62474,898,397,501,102,98,54,37,492,278,214,65,58,32,11,0
62475,330,182,148,47,27,40,11,535,301,234,63,48,47,27,0
62476,894,448,446,123,100,82,30,1113,480,633,170,173,81,34,0
62477,158,85,73,24,18,18,8,367,199,168,62,44,34,8,0
62478,580,240,340,108,81,59,22,410,197,213,67,43,56,18,0
62479,449,179,270,80,77,49,29,319,185,134,42,31,22,13,0
62480,963,477,486,134,143,123,38,142,65,77,30,17,22,9,0
62481,680,308,372,82,72,71,40,87,38,49,23,10,10,9,0
62482,2062,706,1356,414,368,158,63,462,229,233,63,49,42,18,0
62483,340,181,159,44,39,35,21,218,117,101,35,32,34,12,0
62484,341,154,187,34,36,11,11,1020,538,482,145,115,111,58,0
62485,562,214,348,120,86,69,42,689,343,346,105,102,81,35,0
62486,527,254,273,67,66,70,31,205,94,111,48,31,15,6,0
62487,221,80,141,48,37,14,10,246,125,121,38,36,30,11,0
62488,301,157,144,31,28,34,9,475,251,224,67,49,48,23,0
62489,166,59,107,36,41,10,4,334,181,153,41,40,25,15,0
62490,125,53,72,18,21,18,12,172,79,93,34,27,23,10,0
62491,462,228,234,59,47,37,32,295,160,135,42,37,46,16,0
62492,317,164,153,33,50,27,9,119,57,62,18,16,17,4,0
62493,1099,491,608,163,141,107,62,400,187,213,56,59,42,20,0
62494,299,151,148,35,34,26,16,271,150,121,39,36,37,5,0
62495,210,101,109,33,33,19,9,242,121,121,39,30,29,10,0
62496,504,222,282,71,64,53,29,144,67,77,28,14,9,8,0
62497,456,214,242,76,62,52,22,434,213,221,77,62,53,12,0
62498,131,69,62,29,9,9,1,889,505,384,107,97,99,30,0
62499,595,339,256,64,36,54,24,164,79,85,28,28,16,7,0
62500,447,225,222,76,35,75,21,325,172,153,44,34,27,14,0
62501,334,155,179,47,34,38,11,102,51,51,12,15,12,3,0
62502,1124,442,682,148,189,72,43,279,161,118,37,32,7,7,0
62503,389,176,213,81,59,24,7,601,278,323,124,87,65,21,0
62504,347,212,135,35,32,17,6,54,26,28,11,4,3,3,0
62505,402,169,233,70,36,34,18,620,324,296,81,68,66,31,0
62506,392,221,171,53,30,25,8,145,77,68,26,7,15,8,0
62507,941,459,482,167,140,82,38,518,292,226,60,60,52,21,0
62508,249,114,135,47,33,25,4,180,108,72,22,22,15,5,0
62509,798,287,511,126,125,77,26,1154,489,665,200,196,95,54,0
62510,366,190,176,39,62,55,14,535,311,224,66,52,49,24,0
62511,579,246,333,102,79,41,19,1248,584,664,184,164,155,67,0
62512,773,383,390,108,76,79,30,277,124,153,44,40,35,18,0
62513,333,171,162,41,44,48,23,622,344,278,80,77,68,36,0
62514,692,305,387,100,97,78,30,403,221,182,62,50,42,12,0
62515,533,297,236,74,57,39,28,277,163,114,33,24,21,16,0
62516,447,225,222,76,35,75,21,164,79,85,28,28,16,7,0
62517,440,267,173,52,29,42,12,54,26,28,11,4,3,3,0
62518,584,297,287,89,80,65,17,508,261,247,65,53,58,23,0
62519,127,54,73,31,10,11,3,424,179,245,65,67,29,11,0
62520,170,82,88,32,23,22,8,332,180,152,44,36,27,13,0
62521,1339,494,845,216,298,92,37,422,237,185,53,47,62,20,0
62522,126,57,69,31,10,10,3,415,203,212,77,44,49,18,0
62523,416,222,194,58,38,38,20,594,312,282,72,67,73,31,0
62524,375,201,174,52,56,39,15,462,251,211,74,53,41,18,0
62525,1052,492,560,184,163,103,44,341,170,171,41,66,27,10,0
62526,257,132,125,39,27,26,10,727,362,365,123,107,63,23,0
62527,531,260,271,97,68,47,11,671,321,350,95,87,75,34,0
62528,349,167,182,54,38,30,28,592,249,343,91,90,50,42,0
62529,292,102,190,71,27,51,21,199,105,94,27,27,28,9,0
62530,83,45,38,11,8,8,3,180,108,72,22,22,15,5,0
62531,210,101,109,33,33,19,9,517,295,222,69,62,40,28,0
62532,478,220,258,47,70,41,10,222,125,97,34,27,27,7,0
62533,215,104,111,61,7,2,1,326,169,157,51,41,41,12,0
62534,471,221,250,87,68,42,25,453,247,206,58,53,45,20,0
62535,373,194,179,42,54,26,13,128,63,65,30,11,13,8,0
62536,1390,585,805,241,230,118,46,189,105,84,25,26,21,9,0
62537,253,133,120,44,31,22,8,439,227,212,60,55,58,8,0
62538,1462,711,751,219,222,148,65,201,104,97,36,32,24,7,0
62539,102,22,80,48,8,18,6,483,258,225,70,53,54,20,0
62540,793,355,438,134,117,77,43,232,111,121,23,29,17,9,0
62541,512,254,258,70,48,37,32,230,125,105,29,40,20,6,0
62542,2446,1099,1347,363,294,233,100,398,200,198,68,43,51,14,0
62543,524,262,262,62,72,39,49,102,51,51,12,15,12,3,0
62544,586,298,288,80,75,64,37,549,273,276,74,68,72,24,0
62545,360,205,155,35,24,52,14,285,146,139,41,41,48,13,0
62546,586,298,288,80,75,64,37,487,252,235,79,58,55,26,0
62547,1463,521,942,252,204,105,52,582,264,318,84,60,58,23,0
62548,502,274,228,64,49,75,17,101,59,42,11,17,10,1,0
62549,127,48,79,27,20,6,5,348,194,154,57,31,43,12,0
62550,161,75,86,24,20,10,7,405,214,191,53,42,49,20,0
62551,410,200,210,60,54,46,19,332,155,177,55,51,44,13,0
62552,126,57,69,31,10,10,3,1047,562,485,141,127,114,41,0
62553,269,127,142,43,24,34,26,483,215,268,66,70,30,16,0
62554,432,233,199,52,28,47,18,173,90,83,21,36,12,15,0
62555,312,164,148,54,29,25,15,283,142,141,41,33,26,18,0
62556,288,142,146,52,32,26,8,332,155,177,55,51,44,13,0
62557,2000,965,1035,357,313,198,75,475,251,224,67,49,48,23,0
62558,275,155,120,37,31,16,14,195,100,95,27,20,17,11,0
62559,231,105,126,56,10,24,10,220,107,113,36,35,28,9,0
62560,343,189,154,44,24,39,12,309,164,145,35,47,30,11,0
62561,505,247,258,72,71,60,27,479,215,264,67,80,46,28,0
62562,445,231,214,45,64,53,23,483,287,196,71,50,54,17,0
62563,2286,1154,1132,338,314,278,103,403,185,218,67,62,63,19,0
62564,717,281,436,165,81,112,49,821,394,427,122,117,109,38,0
62565,959,496,463,144,132,75,35,732,402,330,81,86,87,33,0
62566,711,330,381,111,86,86,34,192,110,82,33,21,10,3,0
62567,346,208,138,46,39,51,18,72,34,38,8,2,3,12,0
62568,335,171,164,51,38,38,10,258,129,129,45,24,31,10,0
62569,484,261,223,59,48,49,24,445,202,243,70,73,51,15,0
62570,747,360,387,125,92,69,32,2542,1245,1297,285,287,170,84,0
62571,464,237,227,64,66,33,12,317,161,156,50,36,47,12,0
62572,853,400,453,137,109,88,42,403,184,219,75,51,47,20,0
62573,130,70,60,30,9,8,1,402,186,216,64,47,38,20,0
62574,471,221,250,87,68,42,25,323,168,155,51,41,38,12,0
62575,1143,574,569,176,151,123,59,727,388,339,102,87,70,29,0
62576,729,351,378,111,98,58,18,415,203,212,77,44,49,18,0
62577,711,330,381,111,86,86,34,96,45,51,13,12,6,4,0
62578,508,267,241,43,35,25,17,1279,669,610,164,162,104,55,0
62579,314,178,136,42,32,30,17,250,119,131,58,26,29,7,0
62580,1447,698,749,214,180,116,46,597,269,328,102,84,69,24,0
62581,859,411,448,118,100,95,49,152,71,81,41,16,14,2,0
62582,457,261,196,55,27,57,34,611,314,297,79,75,78,22,0
62583,330,182,148,47,27,40,11,325,172,153,44,34,27,14,0
62584,822,416,406,111,97,88,42,413,223,190,52,45,53,10,0
62585,417,176,241,75,61,51,20,374,174,200,54,52,42,21,0
62586,490,198,292,65,81,39,27,508,261,247,65,53,58,23,0
62587,282,160,122,36,28,27,7,152,71,81,41,16,14,2,0
62588,949,466,483,125,126,101,50,727,388,339,102,87,70,29,0
62589,391,204,187,47,48,38,18,334,181,153,56,31,28,18,0
62590,553,319,234,56,37,54,18,866,478,388,121,101,101,26,0
62591,677,361,316,81,61,42,22,188,105,83,25,17,24,7,0
62592,2279,996,1283,375,328,158,60,89,37,52,13,6,2,9,0
62593,736,353,383,117,83,71,18,373,189,184,54,46,50,23,0
62594,130,71,59,30,9,8,1,455,229,226,66,62,63,29,0
62595,582,328,254,78,48,35,9,332,180,152,44,36,27,13,0
62596,298,141,157,51,33,21,22,1395,627,768,172,263,141,59,0
62597,929,410,519,187,146,53,30,308,146,162,42,39,24,12,0
62598,284,160,124,37,23,32,11,331,180,151,46,35,47,17,0
62599,908,324,584,181,162,81,29,244,143,101,31,29,26,8,0
62600,772,417,355,118,92,80,23,953,489,464,126,104,111,44,0
62601,375,167,208,55,83,44,9,302,150,152,56,40,52,15,0
62602,1616,735,881,285,248,153,72,127,54,73,11,33,15,6,0
62603,107,36,71,27,15,0,1,464,236,228,64,56,53,28,0
62604,260,136,124,24,41,19,4,903,436,467,128,116,83,33,0
62605,1064,495,569,157,159,124,58,602,310,292,87,66,70,36,0
62606,126,57,69,31,10,10,3,68,23,45,12,9,3,9,0
62607,867,415,452,123,87,62,27,339,175,164,51,49,37,9,0
62608,193,110,83,18,20,15,12,133,61,72,21,19,13,4,0
62609,1594,660,934,251,272,117,77,397,234,163,44,38,23,21,0
62610,753,395,358,93,72,71,16,240,141,99,34,28,29,8,0
62611,476,276,200,57,34,43,16,296,140,156,49,40,42,19,0
62612,545,221,324,101,72,55,30,974,457,517,133,117,69,26,0
62613,245,112,133,32,45,20,10,1243,650,593,158,159,98,55,0
62614,330,141,189,65,29,51,19,173,94,79,18,24,12,7,0
62615,342,150,192,52,43,31,17,341,170,171,41,66,27,10,0
62616,368,154,214,80,52,41,16,633,311,322,94,82,45,20,0
62617,594,321,273,98,59,57,23,286,160,126,37,27,23,10,0
62618,671,327,344,110,95,91,41,537,276,261,75,68,68,22,0
62619,220,121,99,28,26,17,6,103,44,59,16,17,9,5,0
62620,331,177,154,54,38,27,11,389,207,182,53,58,52,18,0
62621,480,257,223,74,26,60,27,230,113,117,31,40,28,10,0
62622,415,133,282,114,65,27,7,286,160,126,37,27,23,10,0
62623,1339,494,845,216,298,92,37,264,138,126,33,34,29,12,0
62624,700,305,395,111,99,54,18,230,113,117,31,40,28,10,0
62625,860,349,511,166,166,58,19,405,195,210,57,74,24,17,0
62626,179,96,83,24,8,26,4,597,300,297,96,89,68,29,0
62627,546,278,268,94,60,32,22,389,210,179,51,37,43,9,0
62628,493,208,285,75,77,70,40,148,69,79,26,18,16,3,0
62629,911,441,470,123,108,60,21,285,143,142,45,32,21,17,0
62630,2286,1154,1132,338,314,278,103,592,249,343,91,90,50,42,0
62631,215,80,135,54,56,21,9,154,78,76,23,21,13,5,0
62632,253,133,120,44,31,22,8,619,305,314,85,93,71,29,0
62633,299,128,171,57,40,13,25,303,138,165,47,46,35,18,0
62634,496,210,286,112,55,71,14,172,88,84,24,31,20,12,0
62635,125,53,72,18,21,18,12,246,107,139,55,33,27,11,0
62636,453,240,213,53,33,44,16,286,152,134,38,38,32,11,0
62637,2488,1085,1403,346,253,162,76,403,185,218,67,62,63,19,0
62638,738,358,380,106,99,62,25,612,341,271,66,76,57,23,0
62639,861,393,468,150,101,69,35,373,181,192,54,35,44,20,0
62640,299,128,171,57,40,13,25,858,461,397,125,114,79,45,0
62641,641,349,292,92,60,39,24,262,129,133,40,41,31,10,0
62642,313,134,179,58,37,43,19,292,155,137,50,34,29,13,0
62643,243,100,143,58,50,24,5,68,36,32,11,8,9,2,0
62644,557,211,346,129,125,48,19,953,489,464,126,104,111,44,0
62645,500,257,243,60,55,27,22,323,171,152,48,41,40,16,0
62646,763,371,392,104,88,52,23,761,351,410,117,73,103,45,0
62647,833,295,538,146,139,65,34,403,185,218,67,62,63,19,0
62648,342,150,192,52,43,31,17,928,440,488,111,157,82,35,0
62649,538,263,275,71,85,44,18,332,180,152,46,36,28,14,0
62650,131,69,62,29,9,9,1,305,161,144,39,40,44,17,0
62651,451,225,226,69,57,64,22,429,187,242,79,72,28,19,0
62652,793,355,438,134,117,77,43,902,499,403,118,117,92,35,0
62653,636,288,348,94,77,65,30,207,86,121,34,39,11,13,0
62654,524,270,254,84,72,70,23,132,67,65,24,21,8,10,0
62655,318,161,157,53,51,32,13,163,79,84,22,24,13,5,0
62656,604,239,365,124,63,84,37,190,93,97,35,27,23,2,0
62657,255,110,145,34,32,23,17,846,425,421,125,97,98,38,0
62658,107,56,51,18,16,12,5,153,65,88,28,21,20,8,0
62659,1030,567,463,118,106,94,49,508,253,255,73,60,50,13,0
62660,1208,575,633,187,204,117,41,352,207,145,40,33,25,21,0
62661,270,147,123,34,17,39,21,629,317,312,80,87,51,22,0
62662,587,318,269,76,50,38,21,335,170,165,52,36,47,11,0
62663,338,173,165,31,42,22,10,173,94,79,18,24,12,7,0
62664,1096,563,533,158,136,120,53,334,181,153,41,40,25,15,0
62665,414,195,219,51,60,40,17,207,86,121,34,39,11,13,0
62666,234,110,124,39,29,23,2,172,79,93,34,27,23,10,0
62667,1221,597,624,201,152,83,31,148,69,79,26,18,16,3,0
62668,286,111,175,51,47,21,12,106,46,60,27,18,12,3,0
62669,375,201,174,52,56,39,15,338,169,169,53,44,39,21,0
62670,55,16,39,24,2,5,2,501,249,252,77,70,55,22,0
62671,619,289,330,67,77,36,19,228,130,98,35,29,30,10,0
62672,203,80,123,40,37,20,3,2547,1280,1267,331,335,293,118,0
62673,586,298,288,80,75,64,37,314,151,163,42,61,39,16,0
62674,374,187,187,51,52,40,27,222,122,100,39,32,24,9,0
62675,325,181,144,46,31,48,9,627,289,338,101,73,62,43,0
62676,305,124,181,27,25,32,21,326,149,177,51,51,28,10,0
62677,2048,855,1193,297,287,191,93,418,223,195,53,43,49,15,0
62678,209,75,134,53,48,20,9,397,234,163,44,38,23,21,0
62679,246,123,123,40,31,27,7,531,261,270,73,80,68,26,0
62680,615,308,307,83,75,58,32,562,273,289,76,92,45,24,0
62681,760,405,355,112,95,92,29,132,61,71,22,21,15,3,0
62682,577,342,235,63,57,23,37,137,72,65,27,13,15,8,0
62683,380,148,232,81,69,24,8,132,67,65,24,21,8,10,0
62684,368,201,167,61,38,38,12,289,140,149,33,42,30,15,0
62685,603,311,292,102,71,66,23,218,117,101,35,32,34,12,0
62686,484,192,292,118,68,83,22,689,343,346,105,102,81,35,0
62687,734,366,368,121,99,63,39,593,289,304,85,69,48,19,0
62688,685,393,292,75,66,113,16,359,171,188,49,74,45,11,0
62689,543,265,278,52,37,54,19,234,129,105,31,22,19,17,0
62690,273,126,147,54,49,25,18,209,119,90,28,24,27,9,0
62691,781,367,414,60,67,43,17,352,207,145,40,33,25,21,0
62692,326,154,172,45,39,20,10,583,321,262,73,67,45,25,0
62693,125,57,68,31,10,10,3,173,94,79,18,24,12,7,0
62694,525,254,271,60,76,46,13,531,277,254,82,75,33,22,0
62695,1718,735,983,266,225,130,68,413,223,190,52,45,53,10,0
62696,619,289,330,67,77,36,19,530,287,243,79,70,33,26,0
62697,513,276,237,73,43,57,24,482,232,250,77,81,44,13,0
62698,575,295,280,89,68,54,18,487,252,235,79,58,55,26,0
62699,217,109,108,30,23,28,10,173,86,87,30,22,19,12,0
62700,213,88,125,21,54,14,15,761,351,410,117,73,103,45,0
62701,960,409,551,166,134,77,44,178,69,109,29,25,21,13,0
62702,347,154,193,48,51,25,11,218,111,107,45,29,24,6,0
62703,335,183,152,40,26,54,22,271,150,121,39,36,37,5,0
62704,467,233,234,83,37,77,22,325,159,166,59,46,30,12,0
62705,961,465,496,139,156,62,34,364,189,175,58,41,35,17,0
62706,594,321,273,98,59,57,23,380,178,202,69,53,37,10,0
62707,346,168,178,36,43,20,9,1154,489,665,200,196,95,54,0
62708,1531,649,882,108,122,93,72,169,84,85,29,19,21,7,0
62709,350,190,160,48,25,27,18,392,186,206,62,56,29,15,0
62710,237,127,110,34,30,16,9,220,107,113,36,35,28,9,0
62711,67,40,27,10,8,7,6,621,273,348,104,102,48,19,0
62712,119,67,52,15,15,7,7,748,359,389,125,113,86,31,0
62713,368,154,214,80,52,41,16,974,457,517,133,117,69,26,0
62714,484,192,292,118,68,83,22,385,212,173,57,40,39,21,0
62715,260,136,124,24,41,19,4,312,165,147,41,39,29,16,0
62716,221,114,107,65,7,2,1,169,74,95,33,26,22,3,0
62717,282,163,119,40,23,25,17,123,61,62,17,18,17,7,0
62718,238,91,147,68,19,22,7,811,361,450,124,107,80,31,0
62719,372,189,183,60,44,41,18,368,183,185,40,42,40,15,0
62720,330,77,253,86,52,20,12,149,52,97,36,36,7,4,0
62721,626,300,326,91,82,68,26,370,173,197,65,57,42,10,0
62722,126,57,69,31,10,10,3,332,173,159,48,40,31,11,0
62723,480,257,223,74,26,60,27,267,141,126,53,27,23,7,0
62724,356,199,157,36,43,28,12,234,116,118,34,35,23,9,0
62725,664,269,395,117,107,36,15,413,223,190,52,45,53,10,0
62726,500,245,255,66,57,52,27,897,326,571,154,146,72,39,0
62727,372,189,183,60,44,41,18,261,162,99,24,21,14,10,0
62728,2663,1073,1590,548,499,192,64,1004,457,547,150,150,74,52,0
62729,238,91,147,68,19,22,7,475,251,224,67,49,48,23,0
62730,150,60,90,27,16,6,3,761,351,410,117,73,103,45,0
62731,338,173,165,31,42,22,10,498,244,254,81,67,58,19,0
62732,753,395,358,93,72,71,16,328,199,129,39,29,27,14,0
62733,119,59,60,29,10,6,4,178,69,109,29,25,21,13,0
62734,3969,1703,2266,619,432,259,144,332,180,152,44,36,27,13,0
62735,585,277,308,92,73,61,32,232,111,121,23,29,17,9,0
62736,291,120,171,63,39,26,6,250,116,134,41,30,33,19,0
62737,683,304,379,140,101,48,19,972,501,471,125,156,106,39,0
62738,798,364,434,133,88,74,35,555,282,273,82,69,65,21,0
62739,517,245,272,92,77,46,24,261,148,113,31,28,14,10,0
62740,475,208,267,84,67,50,20,1214,475,739,177,250,89,49,0
62741,493,208,285,75,77,70,40,250,116,134,41,30,33,19,0
62742,496,210,286,112,55,72,13,386,207,179,43,48,44,19,0
62743,747,469,278,60,41,53,23,405,181,224,71,57,31,12,0
62744,397,180,217,61,59,39,13,966,478,488,108,144,74,43,0
62745,437,230,207,41,55,27,13,287,151,136,51,42,36,7,0
62746,598,322,276,67,57,63,26,661,325,336,81,75,65,28,0
62747,161,94,67,23,13,8,10,662,373,289,89,80,77,29,0
62748,434,216,218,72,58,40,20,756,348,408,101,103,60,40,0
62749,1709,650,1059,338,286,185,46,710,375,335,95,94,110,28,0
62750,270,147,123,34,17,39,21,240,141,99,34,28,29,8,0
62751,588,267,321,99,79,87,28,783,406,377,102,91,57,29,0
62752,246,111,135,64,47,27,3,708,328,380,113,100,82,34,0
62753,446,283,163,51,26,33,19,732,366,366,108,86,74,41,0
62754,282,105,177,77,28,39,6,336,200,136,34,29,25,24,0
62755,302,178,124,34,29,50,13,381,196,185,55,57,43,16,0
62756,452,202,250,83,60,56,19,633,311,322,94,82,45,20,0
62757,333,171,162,41,44,48,23,528,276,252,86,78,49,17,0
62758,498,274,224,58,59,50,18,378,154,224,74,84,35,22,0
62759,368,154,214,80,52,41,16,376,189,187,47,53,44,26,0
62760,1616,735,881,285,248,153,72,132,61,71,19,20,14,6,0
62761,466,199,267,86,59,32,17,201,99,102,34,26,23,6,0
62762,359,167,192,49,37,27,19,386,207,179,43,48,44,19,0
62763,603,311,292,102,71,66,23,452,231,221,74,53,56,20,0
62764,650,330,320,97,77,65,28,277,144,133,42,30,41,8,0
62765,184,93,91,26,25,14,11,761,351,410,117,73,103,45,0
62766,359,198,161,51,28,54,13,305,164,141,43,23,47,18,0
62767,417,222,195,53,39,43,10,858,461,397,125,114,79,45,0
62768,257,148,109,28,20,21,14,385,188,197,57,42,36,16,0
62769,443,212,231,74,24,60,24,218,111,107,45,29,24,6,0
62770,163,70,93,28,21,17,6,91,44,47,9,12,4,7,0
62771,1011,559,452,121,97,132,33,501,249,252,77,70,55,22,0
62772,746,312,434,129,115,77,47,103,59,44,25,2,13,6,0
62773,631,304,327,98,75,52,23,270,130,140,48,44,37,12,0
62774,193,90,103,44,9,19,13,821,394,427,122,117,109,38,0
62775,261,130,131,27,41,19,16,663,354,309,91,84,79,31,0
62776,156,64,92,31,19,5,4,536,267,269,60,70,41,22,0
62777,297,182,115,41,22,23,8,323,162,161,52,41,39,13,0
62778,2220,1085,1135,312,304,202,91,354,188,166,46,40,34,10,0
62779,119,67,52,15,15,7,7,190,93,97,35,27,23,2,0
62780,331,177,154,54,38,27,11,285,143,142,45,32,21,17,0
62781,396,150,246,103,64,38,3,414,203,211,58,56,48,14,0
62782,271,136,135,37,30,18,10,339,175,164,51,49,37,9,0
62783,220,113,107,37,24,16,7,337,170,167,59,33,47,17,0
62784,492,253,239,73,67,77,29,1698,875,823,222,219,173,64,0
62785,1342,640,702,187,163,123,57,415,189,226,68,54,50,21,0
62786,513,246,267,71,66,60,35,351,184,167,59,45,54,9,0
62787,2446,1099,1347,363,294,233,100,1040,564,476,134,110,114,51,0
62788,584,340,244,77,60,47,25,403,184,219,75,51,47,20,0
62789,203,97,106,30,22,18,10,134,72,62,14,28,8,4,0
62790,1004,498,506,94,59,46,33,609,335,274,79,57,45,22,0
62791,908,324,584,181,162,81,29,483,215,268,66,70,30,16,0
62792,358,212,146,51,36,33,9,704,355,349,113,94,71,24,0
62793,160,53,107,31,29,13,3,229,120,109,31,30,22,9,0
62794,746,312,434,129,115,77,47,363,180,183,60,34,10,6,0
62795,803,358,445,135,117,80,43,389,210,179,51,37,43,9,0
62796,470,163,307,99,68,73,30,314,177,137,34,40,29,9,0
62797,490,198,292,65,81,39,27,463,268,195,59,46,46,21,0
62798,162,73,89,32,19,4,4,583,321,262,73,67,45,25,0
62799,130,70,60,30,9,8,1,737,397,340,87,104,90,14,0
62800,789,362,427,90,82,70,35,277,138,139,40,39,20,14,0
62801,245,111,134,36,27,18,6,334,181,153,41,40,25,15,0
62802,238,91,147,68,19,22,7,309,164,145,35,47,30,11,0
62803,242,104,138,41,33,37,8,129,60,69,21,15,8,5,0
62804,393,223,170,44,36,32,14,314,177,137,34,40,29,9,0
62805,462,228,234,59,47,37,32,348,212,136,53,31,25,18,0
62806,260,120,140,34,39,36,12,149,52,97,36,36,7,4,0
62807,136,66,70,33,11,9,3,373,181,192,54,35,44,20,0
62808,824,391,433,106,90,88,32,583,280,303,95,66,76,25,0
62809,860,348,512,121,136,75,35,903,436,467,128,116,83,33,0
62810,371,143,228,77,48,29,26,349,200,149,41,39,30,20,0
62811,734,366,368,121,99,63,39,601,278,323,124,87,65,21,0
62812,126,66,60,24,10,7,9,904,436,468,143,118,108,32,0
62813,330,182,148,47,27,40,11,1062,522,540,151,147,105,66,0
62814,420,202,218,67,43,51,15,149,77,72,37,10,20,5,0
62815,468,233,235,65,61,49,34,514,262,252,78,58,54,26,0
62816,215,80,135,54,56,21,9,227,130,97,32,25,22,12,0
62817,339,118,221,77,68,33,13,218,115,103,32,32,34,11,0
62818,271,136,135,37,30,18,10,1314,693,621,174,155,140,58,0
62819,374,202,172,58,40,41,7,231,126,105,28,26,34,9,0
62820,598,300,298,68,77,59,21,415,203,212,77,44,49,18,0
62821,1912,880,1032,331,334,180,84,469,225,244,64,68,25,11,0
62822,1041,497,544,180,167,98,34,188,88,100,53,12,15,6,0
62823,310,141,169,36,38,20,8,689,343,346,105,102,81,35,0
62824,154,74,80,18,19,7,2,331,180,151,46,35,47,17,0
62825,2062,706,1356,414,368,158,63,290,142,148,41,37,43,11,0
62826,335,183,152,40,26,54,22,415,205,210,77,52,55,17,0
62827,773,383,390,108,76,79,30,514,248,266,86,82,52,22,0
62828,144,57,87,38,26,10,4,1166,514,652,150,159,107,70,0
62829,233,110,123,34,22,34,9,332,180,152,46,36,28,14,0
62830,369,207,162,67,35,16,14,166,88,78,23,18,13,7,0
62831,275,125,150,37,48,27,7,332,180,152,44,36,27,13,0
62832,257,122,135,44,19,21,16,91,44,47,9,12,4,7,0
62833,350,172,178,61,45,32,13,392,186,206,62,56,29,15,0
62834,461,257,204,63,49,50,29,1065,581,484,134,97,76,46,0
62835,338,173,165,31,42,22,10,103,44,59,16,17,9,5,0
62836,286,111,175,51,47,21,12,418,223,195,53,43,49,15,0
62837,437,167,270,126,95,34,10,104,46,58,15,17,9,5,0
62838,225,111,114,38,22,25,10,452,254,198,72,57,38,18,0
62839,502,236,266,66,66,58,17,336,200,136,34,29,25,24,0
62840,3969,1703,2266,619,432,259,144,397,234,163,44,38,23,21,0
62841,933,456,477,123,108,83,29,453,247,206,58,53,45,20,0
62842,1759,838,921,269,212,191,92,474,268,206,66,42,45,24,0
62843,260,136,124,24,41,19,4,247,128,119,34,14,16,14,0
62844,392,221,171,53,30,25,8,277,138,139,40,39,20,14,0
62845,1041,497,544,180,167,98,34,798,385,413,120,115,79,30,0
62846,128,70,58,29,9,8,1,295,156,139,41,40,42,15,0
62847,500,297,203,66,33,53,15,337,170,167,59,33,47,17,0
62848,343,162,181,65,38,29,12,404,190,214,55,55,35,27,0
62849,437,228,209,47,61,26,11,454,214,240,56,71,35,16,0
62850,346,191,155,52,38,40,13,367,218,149,45,43,42,16,0
62851,520,261,259,74,52,49,22,758,319,439,101,123,78,25,0
62852,772,332,440,136,104,72,28,445,264,181,35,35,34,14,0
62853,243,114,129,37,30,32,8,2542,1245,1297,285,287,170,84,0
62854,1970,978,992,245,206,198,80,88,50,38,13,8,16,4,0
62855,395,195,200,41,55,23,10,194,94,100,33,28,14,7,0
62856,342,150,192,52,43,31,17,727,362,365,123,107,63,23,0
62857,593,325,268,84,66,73,24,1162,528,634,193,161,107,74,0
62858,1200,602,598,145,116,110,50,396,223,173,57,37,44,19,0
62859,1174,594,580,175,155,126,66,498,244,254,81,67,58,19,0
62860,154,74,80,18,19,7,2,1114,539,575,145,131,94,56,0
62861,900,434,466,134,97,86,36,463,259,204,62,55,34,22,0
62862,275,125,150,37,48,27,7,173,90,83,21,36,12,15,0
62863,146,73,73,18,24,17,9,2038,1059,979,262,237,208,100,0
62864,117,58,59,17,17,12,2,1265,689,576,169,177,128,60,0
62865,167,70,97,32,20,15,7,598,333,265,79,66,54,33,0
62866,492,253,239,73,67,77,29,479,215,264,67,80,46,28,0
62867,338,139,199,54,54,18,11,336,200,136,34,29,25,24,0
62868,1121,458,663,158,210,76,47,662,373,289,89,80,77,29,0
62869,476,199,277,82,80,49,24,423,234,189,66,44,57,12,0
62870,837,443,394,129,89,87,38,282,134,148,38,45,29,10,0
62871,432,233,199,52,28,47,18,751,394,357,107,96,73,35,0
62872,71,39,32,7,11,6,4,1262,653,609,169,165,152,50,0
62873,57,24,33,11,3,5,3,393,210,183,58,37,34,20,0
62874,629,374,255,74,53,87,27,926,425,501,159,147,77,35,0
62875,286,111,175,51,47,21,12,225,114,111,32,29,26,6,0
62876,273,126,147,54,49,25,18,516,245,271,82,84,70,26,0
62877,1341,481,860,275,264,57,21,1034,495,539,150,134,114,71,0
62878,314,178,136,42,32,30,17,427,251,176,51,39,25,22,0
62879,574,284,290,64,50,65,20,538,274,264,84,67,52,35,0
62880,466,199,267,86,59,32,17,509,267,242,79,81,38,20,0
62881,83,45,38,11,8,8,3,737,397,340,87,104,90,14,0
62882,178,74,104,31,28,9,4,519,287,232,68,58,45,21,0
62883,1105,544,561,165,167,99,40,403,184,219,75,51,47,20,0
62884,747,469,278,60,41,53,23,583,280,303,95,66,76,25,0
62885,434,216,218,72,58,40,20,732,366,366,108,86,74,41,0
62886,269,124,145,36,24,32,11,501,257,244,75,57,48,29,0
62887,358,206,152,45,38,67,16,630,321,309,86,90,57,26,0
62888,338,172,166,59,30,39,18,2382,1162,1220,237,220,140,49,0
62889,556,306,250,69,60,80,18,225,114,111,32,29,26,6,0
62890,450,231,219,77,50,76,16,1239,659,580,169,148,131,54,0
62891,1004,464,540,143,104,78,55,91,42,49,21,9,8,3,0
62892,272,136,136,32,34,12,12,858,461,397,125,114,79,45,0
62893,2220,1085,1135,312,304,202,91,215,115,100,27,19,16,7,0
62894,546,278,268,94,60,32,22,132,61,71,22,21,15,3,0
62895,326,148,178,55,42,31,12,368,200,168,54,49,43,9,0
62896,193,107,86,13,20,13,6,286,160,126,37,27,23,10,0
62897,275,125,150,37,48,27,7,218,118,100,33,30,25,11,0
62898,1054,497,557,190,168,107,45,485,244,241,80,55,59,20,0
62899,949,467,482,126,127,102,51,459,260,199,56,42,47,21,0
62900,282,135,147,27,37,30,19,137,72,65,27,13,15,8,0
62901,437,212,225,66,44,44,11,368,204,164,43,35,30,24,0
62902,221,80,141,48,37,14,10,152,71,81,41,16,14,2,0
62903,330,77,253,86,52,20,12,517,295,222,69,62,40,28,0
62904,1339,494,845,216,298,92,37,106,54,52,12,9,7,6,0
62905,941,459,482,167,140,82,38,474,268,206,66,42,45,24,0
62906,243,114,129,37,30,32,8,758,319,439,101,123,78,25,0
62907,1011,559,452,121,97,132,33,457,245,212,62,58,57,21,0
62908,574,269,305,91,63,54,27,105,51,54,13,17,12,8,0
62909,157,62,95,41,18,10,11,334,181,153,56,31,28,18,0
62910,753,361,392,99,94,66,16,421,219,202,68,57,56,13,0
62911,502,250,252,70,47,57,15,2225,1244,981,271,243,217,93,0
62912,594,248,346,104,109,53,5,89,37,52,13,6,2,9,0
62913,3859,2011,1848,535,391,422,207,457,245,212,62,58,57,21,0
62914,631,304,327,98,75,52,23,673,313,360,102,101,46,17,0
62915,305,124,181,27,25,32,21,153,65,88,28,21,20,8,0
62916,342,185,157,42,27,31,14,1395,627,768,172,263,141,59,0
62917,193,110,83,18,20,15,12,748,359,389,125,113,86,31,0
62918,199,107,92,41,15,14,8,325,172,153,44,34,27,14,0
62919,351,166,185,48,61,24,15,119,67,52,15,15,7,7,0
62920,319,222,97,36,23,28,8,245,131,114,30,27,18,13,0
62921,666,204,462,110,194,42,14,231,126,105,28,26,34,9,0
62922,368,201,167,61,38,38,12,107,77,30,7,2,9,5,0
62923,1217,647,570,142,160,129,45,164,79,85,28,28,16,7,0
62924,126,57,69,31,10,10,3,1378,692,686,194,174,105,56,0
62925,238,91,147,68,19,22,7,396,199,197,54,50,45,14,0
62926,2236,1195,1041,227,187,186,118,89,42,47,16,12,15,6,0
62927,365,222,143,44,24,35,11,106,41,65,36,6,11,7,0
62928,315,111,204,82,66,46,11,194,94,100,33,28,14,7,0
62929,554,217,337,112,72,90,38,178,69,109,29,25,21,13,0
62930,219,100,119,40,29,21,3,220,107,113,36,35,28,9,0
62931,317,140,177,43,26,31,16,572,305,267,74,72,58,21,0
62932,475,235,240,77,58,43,22,189,95,94,25,33,16,8,0
62933,329,165,164,61,44,29,17,400,187,213,56,59,42,20,0
62934,483,236,247,82,60,43,18,602,310,292,87,66,70,36,0
62935,456,223,233,77,54,47,20,277,138,139,40,39,20,14,0
62936,336,199,137,46,22,51,13,367,199,168,62,44,34,8,0
62937,600,324,276,89,73,45,39,403,192,211,102,39,49,15,0
62938,2696,1169,1527,432,347,193,146,278,154,124,42,32,38,7,0
62939,327,174,153,42,35,16,12,96,46,50,16,12,7,5,0
62940,281,125,156,44,47,17,7,701,380,321,94,84,96,34,0
62941,733,438,295,95,79,67,32,137,78,59,22,16,17,4,0
62942,426,231,195,51,52,45,24,386,181,205,55,51,57,31,0
62943,952,547,405,95,90,127,35,710,375,335,95,94,110,28,0
62944,815,356,459,128,125,82,26,285,143,142,45,32,21,17,0
62945,222,108,114,37,20,25,12,415,205,210,77,52,55,17,0
62946,575,290,285,67,70,28,9,106,54,52,12,9,7,6,0
62947,631,316,315,64,57,49,15,106,46,60,27,18,12,3,0
62948,682,292,390,89,69,58,20,508,262,246,66,67,51,20,0
62949,130,72,58,28,9,7,1,4646,2328,2318,674,639,475,170,0
62950,1872,837,1035,280,338,169,80,290,147,143,34,34,39,13,0
62951,1124,442,682,148,189,72,43,423,234,189,66,44,57,12,0
62952,1041,497,544,180,167,98,34,72,32,40,8,2,2,13,0
62953,514,226,288,71,66,63,32,690,345,345,96,83,73,42,0
62954,471,221,250,87,68,42,25,166,90,76,27,18,21,5,0
62955,125,46,79,24,16,12,2,1020,538,482,145,115,111,58,0
62956,485,246,239,74,48,47,22,583,280,303,95,66,76,25,0
62957,1462,711,751,219,222,148,65,292,143,149,38,42,36,16,0
62958,609,292,317,102,96,64,21,143,81,62,28,9,8,1,0
62959,82,36,46,17,10,5,1,811,361,450,124,107,80,31,0
62960,320,183,137,51,18,38,8,317,161,156,50,36,47,12,0
62961,961,465,496,139,156,62,34,222,127,95,23,28,22,7,0
62962,456,214,242,76,62,52,22,199,105,94,27,27,28,9,0
62963,126,66,60,24,10,7,9,209,119,90,28,24,27,9,0
62964,341,154,187,34,36,11,11,265,134,131,48,34,33,15,0
62965,410,209,201,72,30,48,22,601,279,322,81,65,27,12,0
62966,622,354,268,89,60,64,18,242,121,121,39,30,29,10,0
62967,609,292,317,102,96,64,21,96,46,50,16,12,7,5,0
62968,580,281,299,95,60,74,29,148,69,79,26,18,16,3,0
62969,349,167,182,54,38,30,28,396,223,173,57,37,44,19,0
62970,531,284,247,66,42,49,15,1314,693,621,174,155,140,58,0
62971,570,238,332,112,95,39,23,524,300,223,70,54,51,25,0
62972,1439,713,726,195,180,110,34,277,138,139,40,39,20,14,0
62973,135,64,71,31,11,8,4,296,151,145,45,42,32,11,0
62974,439,183,256,60,64,36,14,1061,543,518,146,123,109,67,0
62975,479,227,252,69,48,46,18,621,273,348,104,102,48,19,0
62976,291,120,171,63,39,26,6,4646,2328,2318,674,639,475,170,0
62977,83,45,38,11,8,8,3,775,407,368,122,100,97,32,0
62978,482,231,251,76,81,64,26,354,183,171,54,43,49,8,0
62979,421,237,184,47,54,45,10,744,385,359,105,96,57,31,0
62980,640,271,369,111,79,57,17,293,142,151,49,40,42,17,0
62981,126,56,70,31,10,10,3,518,292,226,60,60,52,21,0
62982,1124,442,682,148,189,72,43,515,276,239,62,59,43,31,0
62983,330,182,148,47,27,40,11,277,152,125,31,35,22,19,0
62984,533,297,236,74,57,39,28,555,292,263,75,63,67,27,0
62985,1009,478,531,166,126,96,42,1755,905,850,214,196,183,79,0
62986,272,136,136,32,34,12,12,111,60,51,17,23,10,7,0
62987,579,246,333,102,79,41,19,1241,619,622,183,169,155,59,0
62988,496,272,224,70,58,42,18,751,394,357,107,96,73,35,0
62989,1970,978,992,245,206,198,80,963,455,508,127,130,115,48,0
62990,2220,1085,1135,312,304,202,91,384,204,180,53,47,49,17,0
62991,717,281,436,165,81,112,49,283,142,141,41,33,26,18,0
62992,260,138,122,44,30,28,6,103,59,44,25,2,13,6,0
62993,704,342,362,113,91,85,33,664,350,314,86,90,82,36,0
62994,258,126,132,38,22,29,8,231,126,105,37,26,29,6,0
62995,279,129,150,43,34,17,13,89,37,52,13,6,2,9,0
62996,416,207,209,63,47,56,15,508,253,255,73,60,50,13,0
62997,557,250,307,70,47,51,22,679,338,341,96,95,40,23,0
62998,565,264,301,101,73,72,15,218,117,101,35,32,34,12,0
62999,249,114,135,47,33,25,4,455,191,264,68,86,21,19,0
63000,329,168,161,48,34,41,16,368,200,168,54,49,43,9,0
63001,250,123,127,40,28,29,8,483,258,225,70,53,54,20,0
63002,328,195,133,36,23,35,9,88,50,38,13,8,16,4,0
63003,219,100,119,40,29,21,3,873,411,462,132,107,84,40,0
63004,392,205,187,83,49,38,10,242,121,121,39,30,29,10,0
63005,329,171,158,49,41,31,10,429,187,242,79,72,28,19,0
63006,582,328,254,78,48,35,9,246,125,121,38,36,30,11,0
63007,117,57,60,17,14,11,10,173,86,87,30,22,19,12,0
63008,362,174,188,46,55,35,23,329,194,135,45,32,33,9,0
63009,687,351,336,106,67,70,41,464,236,228,64,56,53,28,0
63010,784,353,431,56,47,26,18,326,149,177,51,51,28,10,0
63011,1120,436,684,208,120,101,115,496,285,211,62,54,46,22,0
63012,235,100,135,36,25,30,8,397,223,174,50,39,29,17,0
63013,580,281,299,95,60,74,29,414,203,211,58,56,48,14,0
63014,575,295,280,89,68,54,18,297,175,122,46,30,31,6,0
63015,111,29,82,10,54,0,1,386,207,179,43,48,44,19,0
63016,240,166,74,32,12,8,15,204,96,108,31,37,20,5,0
63017,496,209,287,112,55,71,14,188,93,95,33,18,16,10,0
63018,752,313,439,121,106,68,27,592,249,343,91,90,50,42,0
63019,422,207,215,79,38,53,23,175,82,93,33,26,17,5,0
63020,221,114,107,65,7,2,1,171,94,77,24,28,30,11,0
63021,468,233,235,65,61,49,34,212,127,85,28,21,26,6,0
63022,396,150,246,103,64,38,3,418,223,195,51,45,49,14,0
63023,462,228,234,59,47,37,32,1166,514,652,150,159,107,70,0
63024,680,308,372,82,72,71,40,396,223,173,57,37,44,19,0
63025,682,260,422,98,83,42,31,627,323,304,81,90,53,27,0
63026,475,208,267,84,67,50,20,375,211,164,50,36,31,23,0
63027,588,267,321,99,79,87,28,405,214,191,53,42,49,20,0
63028,416,222,194,58,38,38,20,72,32,40,8,2,2,13,0
63029,450,231,219,77,50,76,16,106,46,60,27,18,12,3,0
63030,301,156,145,32,25,15,5,972,471,501,152,138,112,40,0
63031,122,56,66,26,13,11,5,271,150,121,39,36,37,5,0
63032,246,123,123,40,31,27,7,317,161,156,40,49,41,11,0
63033,467,233,234,83,37,77,22,524,300,223,70,54,51,25,0
63034,895,388,507,130,84,90,31,449,252,197,61,52,36,18,0
63035,92,46,46,14,9,8,6,134,55,79,22,24,16,6,0
63036,640,271,369,111,79,57,17,344,190,154,34,31,36,10,0
63037,347,181,166,27,20,12,12,123,61,62,17,18,17,7,0
63038,126,57,69,31,10,10,3,222,124,98,37,29,22,9,0
63039,625,283,342,93,89,67,25,270,162,108,26,26,16,11,0
63040,438,185,253,71,64,52,28,724,353,371,94,95,71,31,0
63041,318,161,157,53,51,32,13,483,258,225,70,53,54,20,0
63042,447,232,215,55,65,50,25,119,67,52,15,15,7,7,0
63043,801,331,470,151,139,99,55,906,455,451,116,105,87,46,0
63044,280,156,124,36,19,20,13,377,184,193,50,43,33,17,0
63045,664,269,395,117,107,36,15,98,49,49,14,15,9,2,0
63046,773,383,390,108,76,79,30,453,247,206,58,53,45,20,0
63047,320,163,157,44,44,26,15,180,89,91,28,27,18,7,0
63048,158,85,73,24,18,18,8,403,185,218,67,62,63,19,0
63049,188,84,104,35,36,18,9,375,209,166,50,37,29,23,0
63050,1498,731,767,220,175,148,68,290,142,148,41,37,43,11,0
63051,800,416,384,102,105,83,22,198,113,85,19,20,26,12,0
63052,860,348,512,121,136,75,35,761,351,410,117,73,103,45,0
63053,583,279,304,99,71,59,31,720,361,359,98,98,70,37,0
63054,92,46,46,14,9,8,6,212,127,85,28,21,26,6,0
63055,359,167,192,49,37,27,19,1154,489,665,200,196,95,54,0
63056,134,60,74,19,13,10,7,154,78,76,23,21,13,5,0
63057,125,57,68,31,10,10,3,617,314,303,96,68,68,37,0
63058,516,224,292,79,29,45,33,732,402,330,81,86,87,33,0
63059,291,131,160,49,35,32,15,222,127,95,23,28,22,7,0
63060,224,101,123,45,32,21,3,732,402,330,81,86,87,33,0
63061,344,109,235,100,39,26,5,144,67,77,28,14,9,8,0
63062,733,438,295,95,79,67,32,403,184,219,75,51,47,20,0
63063,249,104,145,47,41,24,17,335,170,165,52,36,47,11,0
63064,485,183,302,79,81,73,33,292,155,137,50,34,29,13,0
63065,67,40,27,10,8,7,6,386,181,205,55,51,57,31,0
63066,641,349,292,92,60,39,24,966,478,488,108,144,74,43,0
63067,462,228,234,59,47,37,32,265,134,131,48,34,33,15,0
63068,130,72,58,28,9,7,1,551,226,325,96,103,43,11,0
63069,461,207,254,82,66,55,33,644,343,301,96,69,59,28,0
63070,470,163,307,99,68,73,30,437,224,213,40,29,42,25,0
63071,428,248,180,44,39,28,9,199,105,94,27,27,28,9,0
63072,338,208,130,39,30,35,12,929,459,470,140,120,94,45,0
63073,561,282,279,68,62,36,14,320,168,152,38,42,24,18,0
63074,333,171,162,50,34,19,8,519,287,232,68,58,45,21,0
63075,627,237,390,137,57,108,44,501,240,261,80,62,49,42,0
63076,260,138,122,44,30,28,6,138,69,69,28,7,10,10,0
63077,714,260,454,140,97,120,54,748,359,389,125,113,86,31,0
63078,530,259,271,83,50,54,41,139,68,71,14,26,14,9,0
63079,375,201,174,52,56,39,15,166,90,76,27,18,21,5,0
63080,461,257,204,63,49,50,29,671,306,365,114,76,49,19,0
63081,516,224,292,79,29,45,33,399,190,209,61,41,39,18,0
63082,328,156,172,44,37,44,15,282,134,148,38,45,29,10,0
63083,407,230,177,44,39,34,19,303,138,165,47,46,35,18,0
63084,272,141,131,45,29,36,9,749,384,365,108,105,86,31,0
63085,117,58,59,17,17,12,2,279,142,137,43,39,28,7,0
63086,643,284,359,129,71,84,43,323,162,161,52,41,39,13,0
63087,575,290,285,67,70,28,9,723,363,360,107,106,52,14,0
63088,365,210,155,46,30,24,12,415,205,210,77,52,55,17,0
63089,952,547,405,95,90,127,35,169,85,84,21,14,9,9,0
63090,420,202,218,67,43,51,15,65,32,33,16,4,8,3,0
63091,756,265,491,129,127,51,17,165,87,78,24,19,22,9,0
63092,242,104,138,41,33,37,8,187,89,98,36,24,20,6,0
63093,904,436,468,138,146,82,39,341,170,171,41,66,27,10,0
63094,443,212,231,74,24,60,24,180,108,72,22,22,15,5,0
63095,1004,464,540,143,104,78,55,96,45,51,13,12,6,4,0
63096,333,171,162,50,34,19,8,175,91,84,19,21,21,10,0
63097,126,57,69,31,10,10,3,621,310,311,100,106,77,27,0
63098,270,158,112,35,20,23,7,629,317,312,80,87,51,22,0
63099,284,128,156,48,29,34,8,171,94,77,24,28,30,11,0
63100,136,65,71,33,11,9,6,664,350,314,86,90,82,36,0
63101,238,158,80,28,15,31,7,821,394,427,122,117,109,38,0
63102,532,254,278,91,48,23,17,583,280,303,95,66,76,25,0
63103,1339,494,845,216,298,92,37,415,205,210,77,52,55,17,0
63104,510,269,241,66,67,71,26,384,212,172,44,43,34,14,0
63105,556,306,250,69,60,80,18,136,65,71,26,11,7,5,0
63106,395,195,200,41,55,23,10,134,55,79,22,24,16,6,0
63107,275,160,115,40,31,34,17,467,231,236,71,65,58,18,0
63108,379,217,162,47,20,50,23,517,295,222,69,62,40,28,0
63109,361,183,178,50,54,51,22,497,257,240,71,63,62,16,0
63110,236,141,95,36,32,14,6,483,287,196,71,50,54,17,0
63111,453,240,213,53,33,44,16,1004,457,547,150,150,74,52,0
63112,860,349,511,166,166,58,19,778,391,387,94,77,41,33,0
63113,330,141,189,65,29,51,19,508,253,255,73,60,50,13,0
63114,610,249,361,107,69,72,33,218,118,100,33,30,25,11,0
63115,567,266,301,139,46,76,37,1279,669,610,164,162,104,55,0
63116,126,56,70,31,10,10,3,354,188,166,46,40,34,10,0
63117,949,467,482,126,127,102,51,108,59,49,17,13,12,5,0
63118,164,61,103,47,19,14,5,218,115,103,32,32,34,11,0
63119,1064,495,569,157,159,124,58,148,69,79,26,18,16,3,0
63120,178,87,91,20,32,13,10,179,101,78,25,15,13,13,0
63121,3230,1724,1506,361,358,157,75,545,269,276,80,76,27,32,0
63122,406,207,199,56,46,68,19,457,245,212,62,58,57,21,0
63123,664,269,395,117,107,36,15,119,61,58,17,12,10,6,0
63124,426,231,195,51,52,45,24,1922,923,999,267,275,215,90,0
63125,743,366,377,41,37,26,14,303,137,166,54,54,31,15,0
63126,126,57,69,31,10,10,3,319,185,134,42,31,22,13,0
63127,476,254,222,58,33,46,23,501,249,252,77,70,55,22,0
63128,332,170,162,44,38,39,10,198,110,88,27,27,24,4,0
63129,867,415,452,123,87,62,27,271,150,121,39,36,37,5,0
63130,127,55,72,25,18,5,7,504,272,232,75,57,53,19,0
63131,180,57,123,39,22,10,8,317,161,156,50,36,47,12,0
63132,525,254,271,60,76,46,13,239,113,126,36,49,20,8,0
63133,1124,442,682,148,189,72,43,470,205,265,71,80,33,11,0
63134,240,99,141,53,38,29,15,207,114,93,33,20,31,13,0
63135,630,231,399,150,83,84,50,810,310,500,164,162,42,26,0
63136,1096,563,533,158,136,120,53,303,138,165,47,46,35,18,0
63137,462,228,234,59,47,37,32,535,301,234,63,48,47,27,0
63138,206,100,106,34,26,11,7,732,402,330,81,86,87,33,0
63139,136,65,71,33,11,9,6,132,67,65,24,21,8,10,0
63140,556,306,250,69,60,80,18,663,360,303,87,82,80,35,0
63141,840,411,429,122,101,79,34,295,160,135,42,37,46,16,0
63142,856,429,427,113,105,96,24,617,314,303,96,68,68,37,0
63143,717,381,336,118,103,85,29,524,300,223,70,54,51,25,0
63144,275,125,150,37,48,27,7,88,50,38,13,8,16,4,0
63145,1689,821,868,277,250,177,78,1248,584,664,184,164,155,67,0
63146,429,238,191,47,49,56,29,1241,619,622,183,169,155,59,0
63147,2236,1195,1041,227,187,186,118,904,436,468,143,118,108,32,0
63148,150,64,86,22,12,29,12,189,105,84,25,26,21,9,0
63149,1199,589,610,189,128,167,65,367,218,149,45,43,42,16,0
63150,267,146,121,40,24,25,7,290,147,143,34,34,39,13,0
63151,255,126,129,41,37,13,5,377,184,193,50,43,33,17,0
63152,443,250,193,52,23,49,13,175,91,84,19,21,21,10,0
63153,538,263,275,71,85,44,18,65,32,33,16,4,8,3,0
63154,367,167,200,63,42,60,17,339,175,164,51,49,37,9,0
63155,629,338,291,92,57,64,22,148,69,79,26,18,16,3,0
63156,369,166,203,59,55,41,14,630,321,309,86,90,57,26,0
63157,577,342,235,63,57,23,37,647,324,323,101,80,76,43,0
63158,420,202,218,67,43,51,15,326,169,157,51,41,41,12,0
63159,2000,965,1035,357,313,198,75,346,178,168,58,41,33,12,0
63160,756,265,491,129,127,51,17,364,189,175,58,41,35,17,0
63161,476,254,222,58,33,46,23,727,388,339,102,87,70,29,0
63162,130,71,59,30,9,8,1,647,350,297,95,79,77,29,0
63163,509,246,263,84,71,56,22,326,169,157,51,41,41,12,0
63164,470,163,307,99,68,73,30,145,77,68,26,7,15,8,0
63165,251,139,112,41,18,27,11,520,272,248,60,65,58,22,0
63166,224,108,116,31,32,22,8,241,127,114,34,33,29,12,0
63167,329,171,158,49,41,31,10,316,159,157,38,48,30,11,0
63168,234,110,124,39,29,23,2,201,104,97,36,32,24,7,0
63169,126,57,69,31,10,10,3,535,288,247,79,72,35,21,0
63170,437,228,209,47,61,26,11,213,129,84,32,14,21,15,0
63171,335,155,180,64,48,36,10,266,150,116,28,28,24,12,0
63172,781,316,465,130,129,65,23,496,251,245,78,62,61,23,0
63173,131,69,62,29,9,9,1,1700,731,969,198,233,110,87,0
63174,347,154,193,48,51,25,11,497,257,240,71,63,62,16,0
63175,739,323,416,127,89,76,33,132,77,55,20,9,13,10,0
63176,301,150,151,45,47,33,13,588,286,302,78,99,53,25,0
63177,282,160,122,36,28,27,7,2346,1231,1115,316,292,266,105,0
63178,2624,999,1625,415,495,109,84,391,189,202,55,56,56,12,0
63179,305,124,181,27,25,32,21,630,321,309,86,90,57,26,0
63180,222,110,112,43,30,14,6,147,74,73,28,20,24,4,0
63181,437,225,212,61,57,66,12,2000,965,1035,357,313,198,75,0
63182,616,323,293,98,71,31,15,1249,638,611,166,153,141,45,0
63183,484,194,290,70,93,47,16,292,155,137,50,34,29,13,0
63184,419,210,209,54,44,31,23,199,92,107,34,30,18,9,0
63185,412,208,204,54,47,42,17,1700,731,969,198,233,110,87,0
63186,714,260,454,140,97,120,54,137,85,52,15,11,11,2,0
63187,507,314,193,49,45,59,25,223,113,110,31,33,22,12,0
63188,243,100,143,58,50,24,5,295,158,137,42,34,38,14,0
63189,1498,731,767,220,175,148,68,422,237,185,53,47,62,20,0
63190,426,214,212,63,47,53,20,535,311,224,66,52,49,24,0
63191,752,313,439,121,106,68,27,445,202,243,70,73,51,15,0
63192,124,58,66,20,28,11,7,377,184,193,50,43,33,17,0
63193,494,242,252,67,47,25,21,137,72,65,27,13,15,8,0
63194,257,122,135,44,19,21,16,387,193,194,60,53,57,15,0
63195,217,109,108,30,23,28,10,413,223,190,52,45,53,10,0
63196,411,202,209,60,67,57,24,302,150,152,56,40,52,15,0
63197,956,450,506,122,117,82,36,758,319,439,101,123,78,25,0
63198,130,71,59,30,9,8,1,1114,539,575,145,131,94,56,0
63199,369,207,162,67,35,16,14,464,236,228,64,56,53,28,0
63200,314,178,136,42,32,30,17,556,290,266,75,74,29,24,0
63201,138,35,103,38,2,15,9,399,190,209,61,41,39,18,0
63202,500,297,203,66,33,53,15,396,197,199,75,49,49,16,0
63203,626,300,326,91,82,68,26,300,148,152,45,43,40,8,0
63204,503,260,243,46,56,33,16,483,215,268,66,70,30,16,0
63205,443,212,231,74,24,60,24,974,457,517,133,117,69,26,0
63206,267,146,121,40,24,25,7,370,173,197,65,57,42,10,0
63207,853,400,453,137,109,88,42,780,337,443,112,116,77,28,0
63208,361,177,184,59,51,24,15,900,441,459,125,127,110,32,0
63209,600,324,276,89,73,45,39,2542,1245,1297,285,287,170,84,0
63210,129,70,59,29,9,7,2,98,49,49,14,15,9,2,0
63211,904,436,468,138,146,82,39,274,142,132,33,34,18,14,0
63212,115,62,53,13,10,9,7,866,478,388,121,101,101,26,0
63213,1014,488,526,178,137,94,39,251,143,108,47,25,29,11,0
63214,358,206,152,45,38,67,16,496,251,245,78,62,61,23,0
63215,155,85,70,17,16,4,8,295,160,135,42,37,46,16,0
63216,600,324,276,89,73,45,39,469,225,244,64,68,25,11,0
63217,919,493,426,100,92,88,49,180,108,72,22,22,15,5,0
63218,1441,504,937,264,329,69,46,584,249,335,80,96,22,13,0
63219,271,136,135,37,30,18,10,89,37,52,13,6,2,9,0
63220,1009,478,531,166,126,96,42,1378,692,686,194,174,105,56,0
63221,777,367,410,89,85,64,43,737,320,417,112,94,73,34,0
63222,437,167,270,126,95,34,10,415,226,189,51,40,40,29,0
63223,594,248,346,104,109,53,5,294,146,148,50,45,51,15,0
63224,350,212,138,32,26,40,13,288,156,132,36,36,24,15,0
63225,579,321,258,74,70,47,22,364,189,175,58,41,35,17,0
63226,361,183,178,50,54,51,22,287,151,136,51,42,36,7,0
63227,258,130,128,44,37,29,10,290,142,148,41,37,43,11,0
63228,445,231,214,45,64,53,23,264,138,126,33,34,29,12,0
63229,700,305,395,111,99,54,18,201,93,108,34,39,21,6,0
63230,258,144,114,33,22,19,9,1922,923,999,267,275,215,90,0
63231,451,278,173,71,35,58,12,314,177,137,34,40,29,9,0
63232,815,356,459,128,125,82,26,271,150,121,39,36,37,5,0
63233,127,55,72,25,18,5,7,107,77,30,7,2,9,5,0
63234,111,29,82,10,54,0,1,285,143,142,45,32,21,17,0
63235,752,313,439,121,106,68,27,889,505,384,107,97,99,30,0
63236,128,69,59,29,9,8,1,773,389,384,119,91,79,26,0
63237,300,136,164,45,35,45,14,926,340,586,133,119,60,40,0
63238,1161,514,647,159,138,122,37,2547,1280,1267,331,335,293,118,0
63239,465,240,225,50,54,24,14,200,89,111,26,25,17,7,0
63240,476,199,277,82,80,49,24,222,122,100,39,32,24,9,0
63241,243,114,129,37,30,32,8,209,119,90,28,24,27,9,0
63242,199,107,92,41,15,14,8,282,134,148,38,45,29,10,0
63243,269,124,145,36,24,32,11,240,141,99,34,28,29,8,0
63244,126,58,68,31,10,10,3,68,36,32,11,8,9,2,0
63245,928,442,486,139,118,91,43,459,260,199,56,42,47,21,0
63246,952,547,405,95,90,127,35,583,280,303,95,66,76,25,0
63247,479,227,252,69,48,46,18,149,52,97,36,36,7,4,0
63248,426,196,230,76,65,54,20,528,276,252,86,78,49,17,0
63249,1043,479,564,200,131,123,62,328,199,129,39,29,27,14,0
63250,359,204,155,39,36,34,13,400,187,213,56,59,42,20,0
63251,231,105,126,56,10,24,10,497,257,240,71,63,62,16,0
63252,435,222,213,67,49,67,12,453,255,198,62,49,29,19,0
63253,249,104,145,47,41,24,17,270,162,108,26,26,16,11,0
63254,118,56,62,24,12,6,9,515,276,239,62,59,43,31,0
63255,139,81,58,17,14,24,9,171,94,77,24,28,30,11,0
63256,420,189,231,79,67,33,17,548,296,252,71,74,43,28,0
63257,483,236,247,82,60,43,18,127,54,73,11,33,15,6,0
63258,527,254,273,67,66,70,31,497,227,270,70,63,66,30,0
63259,532,254,278,91,48,23,17,647,324,323,101,80,76,43,0
63260,346,205,141,47,34,30,7,390,190,200,66,50,43,12,0
63261,204,93,111,35,35,16,11,175,91,84,19,21,21,10,0
63262,218,133,85,20,19,13,6,180,108,72,22,22,15,5,0
63263,449,179,270,80,77,49,29,329,194,135,45,32,33,9,0
63264,626,308,318,105,89,77,25,671,321,350,95,87,75,34,0
63265,732,355,377,108,109,79,27,437,224,213,40,29,42,25,0
63266,2279,996,1283,375,328,158,60,149,52,97,36,36,7,4,0
63267,1200,602,598,145,116,110,50,165,90,75,36,18,20,6,0
63268,734,339,395,135,89,78,36,561,279,282,85,81,88,24,0
63269,164,78,86,28,23,12,8,904,436,468,138,146,82,39,0
63270,1912,880,1032,331,334,180,84,429,187,242,79,72,28,19,0
63271,815,356,459,128,125,82,26,926,425,501,159,147,77,35,0
63272,302,160,142,35,35,37,10,387,193,194,60,53,57,15,0
63273,228,82,146,45,37,18,8,384,204,180,53,47,49,17,0
63274,260,136,124,24,41,19,4,818,357,461,122,136,54,25,0
63275,859,411,448,118,100,95,49,213,129,84,32,14,21,15,0
63276,575,295,280,89,68,54,18,134,55,79,22,24,16,6,0
63277,297,182,115,41,22,23,8,562,273,289,76,92,45,24,0
63278,1594,660,934,251,272,117,77,188,90,98,44,7,21,7,0
63279,362,174,188,46,55,35,23,509,267,242,79,81,38,20,0
63280,853,400,453,137,109,88,42,389,210,179,51,37,43,9,0
63281,226,120,106,68,8,2,1,607,293,314,98,71,62,32,0
63282,301,119,182,53,47,14,20,418,223,195,53,43,49,15,0
63283,1226,513,713,184,147,87,43,194,106,88,33,10,15,6,0
63284,1107,601,506,155,138,103,49,295,160,135,42,37,46,16,0
63285,450,227,223,53,36,48,12,68,36,32,11,8,9,2,0
63286,462,228,234,59,47,37,32,271,150,121,39,36,37,5,0
63287,308,129,179,44,60,19,8,1378,692,686,194,174,105,56,0
63288,588,267,321,99,79,87,28,207,113,94,33,18,30,9,0
63289,476,254,222,58,33,46,23,449,252,197,61,52,36,18,0
63290,514,226,288,71,66,63,32,1062,522,540,151,147,105,66,0
63291,452,217,235,59,47,60,20,148,69,79,26,18,16,3,0
63292,1560,778,782,224,235,132,78,367,199,168,62,44,34,8,0
63293,305,124,181,27,25,32,21,285,146,139,41,41,48,13,0
63294,298,141,157,51,33,21,22,2038,1059,979,262,237,208,100,0
63295,785,325,460,114,123,61,28,166,78,88,27,25,19,7,0
63296,562,214,348,120,86,69,42,194,94,100,33,28,14,7,0
63297,508,136,372,157,91,22,9,137,72,65,27,13,15,8,0
63298,593,282,311,75,70,29,25,1543,794,749,182,152,132,55,0
63299,895,388,507,130,84,90,31,173,86,87,30,22,19,12,0
63300,2286,1154,1132,338,314,278,103,1040,564,476,134,110,114,51,0
63301,465,240,225,50,54,24,14,1262,653,609,169,165,152,50,0
63302,380,187,193,38,51,30,18,904,436,468,138,146,82,39,0
63303,728,358,370,118,100,55,29,798,385,413,120,115,79,30,0
63304,234,108,126,42,40,15,9,180,115,65,17,12,9,9,0
63305,688,310,378,130,82,78,47,326,149,177,51,51,28,10,0
63306,221,114,107,65,7,2,1,474,268,206,66,42,45,24,0
63307,427,191,236,67,60,41,34,144,67,77,28,14,9,8,0
63308,327,174,153,42,35,16,12,222,125,97,34,27,27,7,0
63309,665,341,324,109,79,38,22,432,244,188,51,51,27,14,0
63310,267,146,121,40,24,25,7,773,389,384,119,91,79,26,0
63311,127,55,72,25,18,5,7,1262,653,609,169,165,152,50,0
63312,319,153,166,61,52,26,12,337,170,167,59,33,47,17,0
63313,149,78,71,20,20,19,5,316,159,157,38,48,30,11,0
63314,1257,464,793,221,264,75,37,105,51,54,13,17,12,8,0
63315,271,136,135,37,30,18,10,520,272,248,60,65,58,22,0
63316,435,222,213,67,49,67,12,246,107,139,55,33,27,11,0
63317,674,268,406,118,96,70,21,165,87,78,24,19,22,9,0
63318,119,67,52,15,15,7,7,220,107,113,36,35,28,9,0
63319,972,501,471,125,156,106,39,127,66,61,13,14,19,8,0
63320,755,271,484,113,226,61,20,866,478,388,121,101,101,26,0
63321,326,148,178,55,42,31,12,105,51,54,13,17,12,8,0
63322,193,107,86,13,20,13,6,360,185,175,51,43,36,16,0
63323,438,185,253,71,64,52,28,663,354,309,91,84,79,31,0
63324,199,113,86,27,17,10,7,704,355,349,113,94,71,24,0
63325,55,16,39,24,2,5,2,424,179,245,65,67,29,11,0
63326,508,267,241,43,35,25,17,107,77,30,7,2,9,5,0
63327,1689,821,868,277,250,177,78,975,400,575,160,162,62,31,0
63328,1872,837,1035,280,338,169,80,274,157,117,40,29,40,8,0
63329,577,251,326,92,84,60,11,396,197,199,75,49,49,16,0
63330,508,267,241,43,35,25,17,336,200,136,34,29,25,24,0
63331,163,70,93,28,21,17,6,380,211,169,47,37,33,21,0
63332,1105,544,561,165,167,99,40,68,23,45,12,9,3,9,0
63333,245,111,134,36,27,18,6,462,251,211,74,53,41,18,0
63334,469,221,248,49,60,55,21,307,132,175,48,53,26,10,0
63335,1970,978,992,245,206,198,80,267,141,126,53,27,23,7,0
63336,588,300,288,100,57,65,27,439,227,212,60,55,58,8,0
63337,313,178,135,43,18,35,6,89,37,52,13,6,2,9,0
63338,401,204,197,49,33,29,17,91,44,47,9,12,4,7,0
63339,482,231,251,76,81,64,26,413,223,190,52,45,53,10,0
63340,350,178,172,49,62,29,16,375,209,166,50,37,29,23,0
63341,813,412,401,114,93,112,26,303,138,165,47,46,35,18,0
63342,4640,2231,2409,660,549,437,245,303,137,166,54,54,31,15,0
63343,410,200,210,60,54,46,19,751,394,357,107,96,73,35,0
63344,653,379,274,89,56,86,13,260,133,127,43,32,39,3,0
63345,933,456,477,123,108,83,29,470,205,265,71,80,33,11,0
63346,193,107,86,13,20,13,6,127,58,69,18,17,10,5,0
63347,484,261,223,59,48,49,24,270,162,108,26,26,16,11,0
63348,275,125,150,37,48,27,7,541,279,262,79,82,31,32,0
63349,82,36,46,17,10,5,1,178,99,79,31,19,26,8,0
63350,71,28,43,15,9,5,2,535,311,224,66,52,49,24,0
63351,1542,682,860,290,158,120,47,360,185,175,51,43,36,16,0
63352,1007,353,654,277,147,70,26,295,160,135,44,36,46,16,0
63353,465,240,225,50,54,24,14,690,345,345,96,83,73,42,0
63354,240,98,142,49,42,23,17,201,117,83,22,21,19,9,0
63355,505,201,304,116,58,75,31,277,124,153,44,40,35,18,0
63356,598,322,276,67,57,63,26,373,181,192,54,35,44,20,0
63357,798,287,511,126,125,77,26,415,203,212,77,44,49,18,0
63358,309,137,172,51,50,28,14,332,173,159,48,40,31,11,0
63359,356,199,157,36,43,28,12,194,109,85,23,24,21,9,0
63360,416,207,209,63,47,56,15,360,180,180,57,48,39,12,0
63361,469,221,248,49,60,55,21,520,272,248,60,65,58,22,0
63362,320,183,137,51,18,38,8,261,162,99,24,21,14,10,0
63363,490,198,292,65,81,39,27,103,59,44,25,2,13,6,0
63364,261,137,124,34,23,13,8,106,46,60,29,13,14,5,0
63365,526,228,298,69,64,32,30,111,60,51,17,23,10,7,0
63366,887,439,448,137,99,91,38,504,272,232,75,57,53,19,0
63367,928,442,486,139,118,91,43,305,163,142,38,27,47,11,0
63368,1835,904,931,192,144,135,63,260,131,129,42,31,40,9,0
63369,567,256,311,91,81,53,17,277,145,132,41,32,22,10,0
63370,485,246,239,74,48,47,22,87,38,49,23,10,10,9,0
63371,282,84,198,60,102,1,6,354,183,171,54,43,49,8,0
63372,928,442,486,139,118,91,43,445,202,243,70,73,51,15,0
63373,475,208,267,84,67,50,20,334,182,152,45,41,27,13,0
63374,126,57,69,31,10,10,3,362,156,206,74,42,36,22,0
63375,565,264,301,101,73,72,15,479,215,264,67,80,46,28,0
63376,528,188,340,130,58,77,41,720,357,363,113,85,62,39,0
63377,486,243,243,65,48,63,22,478,254,224,67,74,56,28,0
63378,314,178,136,42,32,30,17,479,215,264,67,80,46,28,0
63379,929,410,519,187,146,53,30,385,188,197,57,42,36,16,0
63380,1124,442,682,148,189,72,43,693,360,333,100,88,62,26,0
63381,439,183,256,60,64,36,14,154,78,76,23,21,13,5,0
63382,629,338,291,92,57,64,22,943,463,480,91,144,70,30,0
63383,410,209,201,72,30,48,22,134,72,62,14,28,8,4,0
63384,364,168,196,64,61,27,6,198,115,83,30,22,8,8,0
63385,163,70,93,28,21,17,6,647,350,297,95,79,77,29,0
63386,535,315,220,57,55,71,19,758,319,439,101,123,78,25,0
63387,598,322,276,67,57,63,26,866,397,469,117,153,95,48,0
63388,228,105,123,34,43,20,10,465,252,213,73,58,60,18,0
63389,103,56,47,27,7,8,2,660,333,327,102,95,69,31,0
63390,803,358,445,135,117,80,43,775,407,368,122,100,97,32,0
63391,302,178,124,34,29,50,13,594,312,282,72,67,73,31,0
63392,419,210,209,54,44,31,23,627,289,338,101,73,62,43,0
63393,802,430,372,65,102,87,23,2517,1275,1242,304,324,245,135,0
63394,221,114,107,65,7,2,1,137,78,59,22,16,17,4,0
63395,552,295,257,67,49,70,30,285,146,139,41,41,48,13,0
63396,347,154,193,48,51,25,11,148,84,64,30,7,17,4,0
63397,410,209,201,72,30,48,22,86,40,46,16,13,9,7,0
63398,426,196,230,76,65,54,20,108,59,49,17,13,12,5,0
63399,594,248,346,104,109,53,5,104,46,58,15,17,9,5,0
63400,260,133,127,43,29,34,11,135,57,78,21,20,9,11,0
63401,345,203,142,47,35,31,11,478,254,224,67,74,56,28,0
63402,522,302,220,61,49,75,19,557,281,276,80,59,43,21,0
63403,862,409,453,149,125,86,29,589,314,275,70,83,44,28,0
63404,380,185,195,68,54,32,16,207,86,121,34,39,11,13,0
63405,595,339,256,64,36,54,24,423,234,189,66,44,57,12,0
63406,318,164,154,52,43,34,10,397,234,163,44,38,23,21,0
63407,376,176,200,31,53,27,8,403,192,211,102,39,49,15,0
63408,99,35,64,25,18,0,1,555,292,263,75,63,67,27,0
63409,867,415,452,123,87,62,27,258,129,129,45,24,31,10,0
63410,520,240,280,87,63,67,16,287,151,136,51,42,36,7,0
63411,204,103,101,16,32,22,8,469,225,244,64,68,25,11,0
63412,306,172,134,35,31,37,18,277,138,139,40,39,20,14,0
63413,264,122,142,33,29,13,13,230,125,105,29,40,20,6,0
63414,956,450,506,122,117,82,36,231,126,105,28,26,34,9,0
63415,313,178,135,43,18,35,6,583,280,303,95,66,76,25,0
63416,172,82,90,21,35,21,5,108,59,49,17,13,12,5,0
63417,729,351,378,111,98,58,18,504,272,232,75,57,53,19,0
63418,435,230,205,51,37,55,18,1262,653,609,169,165,152,50,0
63419,290,156,134,44,29,39,9,1114,539,575,145,131,94,56,0
63420,584,340,244,77,60,47,25,188,88,100,53,12,15,6,0
63421,941,459,482,167,140,82,38,630,321,309,86,90,57,26,0
63422,432,190,242,85,82,28,11,1425,670,755,153,189,122,85,0
63423,533,297,236,74,57,39,28,2202,1121,1081,338,274,269,81,0
63424,1590,726,864,270,237,126,59,296,151,145,45,42,32,11,0
63425,886,440,446,116,140,95,45,373,213,160,44,33,26,17,0
63426,781,367,414,60,67,43,17,415,226,189,51,40,40,29,0
63427,484,264,220,59,62,68,15,306,157,149,52,35,39,16,0
63428,538,263,275,71,85,44,18,843,391,452,139,104,91,35,0
63429,446,265,181,51,35,27,17,556,290,266,75,74,29,24,0
63430,312,173,139,43,47,28,6,222,122,100,39,32,24,9,0
63431,311,154,157,47,29,34,13,135,57,78,21,20,9,11,0
63432,1580,742,838,208,146,144,71,127,66,61,13,14,19,8,0
63433,2624,999,1625,415,495,109,84,1001,417,584,186,147,96,47,0
63434,126,66,60,24,10,7,9,724,353,371,94,95,71,31,0
63435,739,323,416,127,89,76,33,374,181,193,55,58,48,23,0
63436,315,174,141,46,38,47,16,376,189,187,47,53,44,26,0
63437,492,238,254,72,56,49,20,244,105,139,38,28,20,15,0
63438,132,66,66,21,18,11,7,325,159,166,59,46,30,12,0
63439,246,123,123,40,31,27,7,201,98,103,28,25,19,13,0
63440,502,250,252,70,47,57,15,1113,480,633,170,173,81,34,0
63441,261,148,113,23,29,26,21,662,312,350,103,104,59,20,0
63442,308,129,179,44,60,19,8,492,278,214,65,58,32,11,0
63443,600,324,276,89,73,45,39,2547,1280,1267,331,335,293,118,0
63444,275,125,150,37,48,27,7,331,180,151,46,35,47,17,0
63445,2136,1063,1073,317,308,223,90,447,212,235,86,55,58,21,0
63446,625,283,342,93,89,67,25,974,457,517,133,117,69,26,0
63447,747,360,387,125,92,69,32,1873,935,938,233,225,203,79,0
63448,332,170,162,44,38,39,10,230,125,105,29,40,20,6,0
63449,911,441,470,123,108,60,21,266,150,116,28,28,24,12,0
63450,347,212,135,35,32,17,6,811,361,450,124,107,80,31,0
63451,480,257,223,74,26,60,27,1020,538,482,145,115,111,58,0
63452,648,376,272,70,60,73,24,375,211,164,50,36,31,23,0
63453,288,104,184,80,30,39,6,455,191,264,68,86,21,19,0
63454,126,57,69,31,10,10,3,579,285,294,78,72,64,32,0
63455,388,209,179,46,24,31,28,415,226,189,51,40,40,29,0
63456,164,61,103,47,19,14,5,647,324,323,101,80,76,43,0
63457,747,360,387,125,92,69,32,334,181,153,41,40,25,15,0
63458,126,58,68,31,10,10,3,778,391,387,94,77,41,33,0
63459,424,198,226,57,46,41,19,593,325,268,84,66,73,24,0
63460,1616,735,881,285,248,153,72,661,325,336,81,75,65,28,0
63461,753,395,358,93,72,71,16,362,156,206,74,42,36,22,0
63462,509,251,258,69,49,55,17,1696,771,925,257,225,149,63,0
63463,234,110,124,39,29,23,2,457,245,212,62,58,57,21,0
63464,395,195,200,41,55,23,10,535,288,247,79,72,35,21,0
63465,646,304,342,104,93,58,26,218,118,100,33,30,25,11,0
63466,747,360,387,125,92,69,32,175,82,93,33,26,17,5,0
63467,2414,1189,1225,277,178,170,169,557,281,276,80,59,43,21,0
63468,707,250,457,171,84,117,61,169,84,85,29,19,21,7,0
63469,618,289,329,97,86,70,17,180,89,91,28,27,18,7,0
63470,429,238,191,47,49,56,29,134,55,79,22,24,16,6,0
63471,828,355,473,126,134,77,37,200,99,101,31,24,26,6,0
63472,805,338,467,153,138,99,55,498,244,254,81,67,58,19,0
63473,605,277,328,99,54,63,43,173,86,87,30,22,19,12,0
63474,898,397,501,102,98,54,37,296,159,137,49,28,38,13,0
63475,492,253,239,73,67,77,29,316,159,157,38,48,30,11,0
63476,727,426,301,79,71,64,32,103,50,53,19,10,7,5,0
63477,2063,1024,1039,175,117,80,97,482,232,250,77,81,44,13,0
63478,98,32,66,15,25,5,4,338,169,169,53,44,39,21,0
63479,2649,1431,1218,377,299,266,102,72,32,40,8,2,2,13,0
63480,338,172,166,59,30,39,18,715,348,367,109,84,68,30,0
63481,202,113,89,16,27,21,11,584,249,335,80,96,22,13,0
63482,734,366,368,121,99,63,39,406,223,183,61,53,46,17,0
63483,760,405,355,112,95,92,29,152,71,81,41,16,14,2,0
63484,364,168,196,64,61,27,6,366,204,162,47,41,31,23,0
63485,301,156,145,32,25,15,5,277,124,153,44,40,35,18,0
63486,331,177,154,54,38,27,11,332,173,159,48,40,31,11,0
63487,1161,514,647,159,138,122,37,2225,1244,981,271,243,217,93,0
63488,1047,443,604,162,156,78,52,2202,1121,1081,338,274,269,81,0
63489,338,208,130,39,30,35,12,328,195,133,39,40,27,13,0
63490,415,217,198,50,31,42,17,386,181,205,55,51,57,31,0
63491,99,35,64,25,18,0,1,1425,670,755,153,189,122,85,0
63492,290,156,134,44,29,39,9,277,124,153,44,40,35,18,0
63493,403,176,227,71,56,51,11,947,482,465,143,107,89,37,0
63494,193,90,103,44,9,19,13,218,115,103,37,33,33,9,0
63495,342,150,192,52,43,31,17,397,223,174,50,39,29,17,0
63496,498,274,224,58,59,50,18,671,306,365,114,76,49,19,0
63497,376,171,205,45,45,34,12,403,184,219,75,51,47,20,0
63498,496,272,224,70,58,42,18,978,536,442,132,107,67,32,0
63499,199,107,92,41,15,14,8,134,72,62,14,28,8,4,0
63500,462,233,229,66,49,43,30,555,282,273,82,69,65,21,0
63501,346,191,155,52,38,40,13,414,203,211,58,56,48,14,0
63502,1590,726,864,270,237,126,59,406,223,183,61,53,46,17,0
63503,1235,584,651,140,226,82,52,363,180,183,60,34,10,6,0
63504,228,82,146,45,37,18,8,137,63,74,20,22,14,6,0
63505,232,108,124,33,27,19,16,559,317,242,58,65,37,23,0
63506,358,206,152,45,38,67,16,385,212,173,57,40,39,21,0
63507,341,183,158,36,34,36,15,319,185,134,42,31,22,13,0
63508,447,236,211,56,52,49,14,858,461,397,125,114,79,45,0
63509,218,133,85,20,19,13,6,1214,475,739,177,250,89,49,0
63510,339,170,169,32,17,24,13,647,324,323,101,80,76,43,0
63511,928,442,486,139,118,91,43,396,213,183,68,44,47,18,0
63512,273,126,147,54,49,25,18,368,200,168,54,49,43,9,0
63513,636,288,348,94,77,65,30,89,37,52,13,6,2,9,0
63514,227,109,118,42,35,29,8,928,440,488,111,157,82,35,0
63515,199,107,92,41,15,14,8,439,227,212,60,55,58,8,0
63516,485,183,302,79,81,73,33,274,157,117,40,29,40,8,0
63517,2048,855,1193,297,287,191,93,1606,753,853,215,227,182,48,0
63518,538,263,275,71,85,44,18,189,105,84,25,26,21,9,0
63519,1011,559,452,121,97,132,33,232,111,121,23,29,17,9,0
63520,859,411,448,118,100,95,49,1040,564,476,134,110,114,51,0
63521,291,120,171,63,39,26,6,536,251,285,75,79,60,23,0
63522,478,177,301,109,66,59,25,974,457,517,133,117,69,26,0
63523,204,109,95,21,35,27,7,929,459,470,140,120,94,45,0
63524,136,66,70,33,11,9,5,715,348,367,109,84,68,30,0
63525,2000,965,1035,357,313,198,75,632,360,272,75,65,36,19,0
63526,1120,436,684,208,120,101,115,843,391,452,139,104,91,35,0
63527,164,61,103,47,19,14,5,279,142,137,43,39,28,7,0
63528,127,55,72,25,18,5,7,536,267,269,60,70,41,22,0
63529,340,181,159,44,39,35,21,536,267,269,60,70,41,22,0
63530,322,164,158,46,44,29,7,403,233,170,38,29,21,14,0
63531,301,150,151,45,47,33,13,274,142,132,33,34,18,14,0
63532,496,210,286,111,55,74,13,136,65,71,26,11,7,5,0
63533,206,96,110,33,25,8,6,386,207,179,43,48,44,19,0
63534,525,302,223,56,48,67,19,2038,1059,979,262,237,208,100,0
63535,1390,585,805,241,230,118,46,1166,514,652,150,159,107,70,0
63536,3230,1724,1506,361,358,157,75,215,115,100,27,19,16,7,0
63537,1544,738,806,239,217,145,91,337,170,167,59,33,47,17,0
63538,575,295,280,89,68,54,18,72,32,40,8,2,2,13,0
63539,301,150,151,45,47,33,13,265,134,131,48,34,33,15,0
63540,595,316,279,86,60,65,40,247,128,119,34,14,16,14,0
63541,508,251,257,74,53,51,18,314,151,163,42,61,39,16,0
63542,142,76,66,21,21,22,11,978,536,442,132,107,67,32,0
63543,425,199,226,54,71,56,11,1034,495,539,150,134,114,71,0
63544,505,201,304,116,58,75,31,439,231,208,65,51,55,17,0
63545,630,231,399,150,83,84,50,1537,701,836,209,187,129,58,0
63546,594,248,346,104,109,53,5,519,287,232,68,58,45,21,0
63547,435,222,213,67,49,67,12,447,212,235,86,55,58,21,0
63548,275,125,150,37,48,27,7,218,114,104,32,31,33,11,0
63549,305,124,181,27,25,31,21,1040,564,476,134,110,114,51,0
63550,507,242,265,53,44,31,22,661,325,336,81,75,65,28,0
63551,579,321,258,74,70,47,22,375,211,164,50,36,31,23,0
63552,1004,464,540,143,104,78,55,306,157,149,52,35,39,16,0
63553,618,289,329,97,86,70,17,663,354,309,91,84,79,31,0
63554,531,259,272,75,81,39,13,359,171,188,49,74,45,11,0
63555,395,219,176,47,41,50,18,715,348,367,109,84,68,30,0
63556,394,207,187,52,42,37,24,348,212,136,53,31,25,18,0
63557,347,198,149,45,29,29,8,101,59,42,11,17,10,1,0
63558,130,71,59,30,9,8,2,483,215,268,66,70,30,16,0
63559,117,57,60,17,14,11,10,207,113,94,33,18,30,9,0
63560,482,245,237,69,64,66,24,414,203,211,58,56,48,14,0
63561,915,336,579,185,199,56,29,775,407,368,122,100,97,32,0
63562,395,195,200,41,55,23,10,386,181,205,55,51,57,31,0
63563,575,295,280,89,68,54,18,145,77,68,26,7,15,8,0
63564,410,200,210,60,54,46,19,149,52,97,36,36,7,4,0
63565,242,104,138,41,33,37,8,348,212,136,53,31,25,18,0
63566,505,201,304,116,58,75,31,129,60,69,21,15,8,5,0
63567,437,167,270,126,95,34,10,265,134,131,48,34,33,15,0
63568,282,105,177,77,28,39,6,201,93,108,34,39,21,6,0
63569,554,217,337,112,72,90,38,322,180,142,45,38,28,7,0
63570,311,154,157,47,29,34,13,526,266,260,76,75,53,22,0
63571,375,201,174,52,56,39,15,72,32,40,8,2,1,14,0
63572,471,221,250,87,68,42,25,332,180,152,44,36,27,13,0
63573,795,384,411,133,109,85,38,783,406,377,102,91,57,29,0
63574,221,75,146,68,21,16,5,504,272,232,75,57,53,19,0
63575,482,245,237,69,64,66,24,514,262,252,78,58,54,26,0
63576,346,174,172,36,43,21,9,1352,602,750,166,185,81,70,0
63577,856,429,427,113,105,96,24,516,245,271,82,84,70,26,0
63578,463,250,213,56,45,73,25,276,149,127,34,31,32,10,0
63579,127,55,72,25,18,5,7,160,76,84,19,24,8,5,0
63580,2000,965,1035,357,313,198,75,457,253,204,67,51,48,13,0
63581,474,243,231,66,54,41,29,329,196,133,41,36,31,15,0
63582,316,157,159,45,38,22,19,73,35,38,14,10,9,4,0
63583,253,133,120,44,31,22,8,127,64,63,26,8,12,8,0
63584,2220,1085,1135,312,304,202,91,904,436,468,143,118,108,32,0
63585,781,367,414,60,67,43,17,106,46,60,29,13,14,5,0
63586,336,199,137,46,22,51,13,414,203,211,58,56,48,14,0
63587,760,322,438,81,130,57,19,232,111,121,23,29,17,9,0
63588,193,95,98,33,17,25,17,661,325,336,81,75,65,28,0
63589,378,202,176,34,32,44,13,673,313,360,102,101,46,17,0
63590,313,178,135,43,18,35,6,262,129,133,40,41,31,10,0
63591,5890,3314,2576,970,956,293,265,375,210,165,49,37,29,27,0
63592,135,64,71,31,11,8,4,274,157,117,40,29,40,8,0
63593,556,306,250,69,60,80,18,422,237,185,53,47,62,20,0
63594,180,92,88,29,20,26,8,230,125,105,29,40,20,6,0
63595,2048,855,1193,297,287,191,93,390,223,167,58,36,45,18,0
63596,219,116,103,66,7,2,1,892,475,417,130,108,68,38,0
63597,313,148,165,45,33,36,11,496,251,245,78,62,61,23,0
63598,462,258,204,59,41,56,15,535,301,234,63,48,47,27,0
63599,443,226,217,67,34,53,10,507,270,237,89,59,57,22,0
63600,494,233,261,87,57,46,18,423,234,189,66,44,57,12,0
63601,417,222,195,53,39,43,10,204,80,124,29,51,10,5,0
63602,881,492,389,87,97,59,51,1101,626,475,145,122,120,50,0
63603,76,30,46,7,15,1,5,1873,935,938,233,225,203,79,0
63604,204,109,95,21,35,27,7,457,242,215,39,46,53,10,0
63605,484,264,220,59,62,68,15,640,364,276,84,68,69,33,0
63606,261,130,131,27,41,19,16,103,59,44,25,2,13,6,0
63607,496,210,286,112,55,72,13,156,90,66,17,22,11,10,0
63608,441,216,225,57,66,57,19,621,273,348,104,102,48,19,0
63609,107,56,51,18,16,12,5,601,278,323,124,87,65,21,0
63610,261,148,113,23,29,26,21,241,127,114,34,33,29,12,0
63611,2136,1063,1073,317,308,223,90,1214,475,739,177,250,89,49,0
63612,129,70,59,29,9,7,2,381,187,194,37,49,36,17,0
63613,325,177,148,40,24,23,13,661,325,336,81,75,65,28,0
63614,1560,778,782,224,235,132,78,189,95,94,25,33,16,8,0
63615,283,112,171,48,39,34,15,102,51,51,12,15,12,3,0
63616,341,154,187,34,36,11,11,975,475,500,139,140,119,28,0
63617,193,110,83,18,20,15,12,1040,564,476,134,110,114,51,0
63618,895,388,507,130,84,90,31,218,117,101,35,32,34,12,0
63619,320,183,137,51,18,38,8,671,321,350,95,87,75,34,0
63620,802,430,372,65,102,87,23,504,272,232,75,57,53,19,0
63621,469,221,248,49,60,55,21,160,60,100,23,40,19,11,0
63622,410,188,222,53,52,31,14,194,106,88,33,10,15,6,0
63623,524,361,163,41,8,28,16,607,293,314,98,71,62,32,0
63624,489,253,236,73,36,62,17,579,285,294,78,72,64,32,0
63625,132,66,66,21,18,11,7,320,168,152,38,42,24,18,0
63626,680,308,372,82,72,71,40,601,279,322,81,65,27,12,0
63627,282,163,119,40,23,25,17,201,93,108,34,39,21,6,0
63628,584,297,287,89,80,65,17,389,210,179,51,37,43,9,0
63629,410,211,199,55,42,34,27,621,310,311,100,106,77,27,0
63630,224,108,116,31,32,22,8,106,54,52,12,9,7,6,0
63631,450,227,223,53,36,48,12,295,160,135,42,37,46,16,0
63632,364,168,196,64,61,27,6,335,186,149,40,28,29,13,0
63633,763,354,409,101,90,63,26,395,198,197,55,55,36,10,0
63634,338,208,130,39,30,35,12,1606,753,853,215,227,182,48,0
63635,246,111,135,64,47,27,3,415,203,212,77,44,49,18,0
63636,469,253,216,49,51,48,18,334,181,153,41,40,25,15,0
63637,508,251,257,74,53,51,18,455,191,264,68,86,21,19,0
63638,894,448,446,123,100,82,30,425,177,248,60,62,33,16,0
63639,484,261,223,59,48,49,24,374,202,172,50,39,31,24,0
63640,365,148,217,86,37,51,28,68,36,32,11,8,9,2,0
63641,785,325,460,114,123,61,28,665,361,304,87,91,84,31,0
63642,272,94,178,76,33,19,4,244,143,101,31,29,26,8,0
63643,1139,537,602,162,139,109,50,242,121,121,39,30,29,10,0
63644,630,231,399,150,83,84,50,622,344,278,80,77,68,36,0
63645,375,201,174,52,56,39,15,360,185,175,51,43,36,16,0
63646,815,356,459,128,125,82,26,526,266,260,76,75,53,22,0
63647,83,45,38,11,8,8,3,257,126,131,61,24,22,8,0
63648,707,250,457,171,84,117,61,447,212,235,86,55,58,21,0
63649,341,175,166,48,43,35,18,247,128,119,34,14,16,14,0
63650,180,92,88,29,20,26,8,267,141,126,53,27,23,7,0
63651,230,114,116,30,33,29,8,862,426,436,113,115,84,37,0
63652,524,262,262,62,72,39,49,386,181,205,55,51,57,31,0
63653,1099,491,608,163,141,107,62,419,233,186,54,53,55,17,0
63654,132,66,66,21,18,11,7,630,321,309,86,90,57,26,0
63655,188,84,104,35,36,18,9,205,94,111,48,31,15,6,0
63656,270,131,139,47,37,41,11,972,471,501,152,138,112,40,0
63657,226,120,106,68,8,2,1,73,35,38,14,10,9,4,0
63658,142,76,66,21,21,22,11,419,233,186,54,53,55,17,0
63659,507,314,193,49,45,59,25,403,221,182,62,50,42,12,0
63660,416,222,194,58,38,38,20,1700,731,969,198,233,110,87,0
63661,224,101,123,45,32,21,3,1700,731,969,198,233,110,87,0
63662,318,161,157,53,51,32,13,230,113,117,31,40,28,10,0
63663,262,133,129,44,38,31,12,375,210,165,49,37,29,27,0
63664,192,91,101,28,21,18,8,583,280,303,95,66,76,25,0
63665,125,46,79,24,16,12,2,453,255,198,62,49,29,19,0
63666,919,493,426,100,92,88,49,102,51,51,12,15,12,3,0
63667,371,209,162,46,17,36,19,424,179,245,65,67,29,11,0
63668,193,105,88,33,16,9,4,363,180,183,60,34,10,6,0
63669,228,82,146,45,37,18,8,277,138,139,40,39,20,14,0
63670,119,59,60,29,10,6,4,299,140,159,49,44,26,11,0
63671,219,116,103,66,7,2,1,1034,495,539,150,134,114,71,0
63672,125,57,68,31,10,10,3,425,177,248,60,62,33,16,0
63673,279,129,150,43,34,17,13,535,301,234,63,48,47,27,0
63674,280,128,152,39,37,38,18,207,86,121,34,39,11,13,0
63675,579,321,258,74,70,47,22,1248,584,664,184,164,155,67,0
63676,338,139,199,54,54,18,11,1425,670,755,153,189,122,85,0
63677,222,108,114,37,20,25,12,601,279,322,81,65,27,12,0
63678,240,167,73,32,12,8,21,408,221,187,55,51,57,14,0
63679,305,124,181,27,25,32,21,483,287,196,71,50,54,17,0
63680,412,208,204,54,47,42,17,736,388,348,88,85,67,28,0
63681,461,257,204,63,49,50,29,403,185,218,67,62,63,19,0
63682,589,282,307,68,67,70,23,627,323,304,81,90,53,27,0
63683,326,148,178,55,42,31,12,73,35,38,14,10,9,4,0
63684,1214,498,716,197,180,121,65,348,194,154,57,31,43,12,0
63685,473,265,208,47,26,50,30,758,319,439,101,123,78,25,0
63686,1011,559,452,121,97,132,33,374,191,183,40,52,40,16,0
63687,218,133,85,20,19,13,6,325,172,153,44,34,27,14,0
63688,435,187,248,62,51,51,21,482,232,250,77,81,44,13,0
63689,595,208,387,157,60,91,48,314,151,163,42,61,39,16,0
63690,836,370,466,126,96,72,30,218,117,101,35,32,34,12,0
63691,530,259,271,83,50,54,41,2542,1245,1297,285,287,170,84,0
63692,618,289,329,97,86,70,17,517,295,222,69,62,40,28,0
63693,184,93,91,26,25,14,11,302,150,152,56,40,52,15,0
63694,425,198,227,57,69,59,13,441,189,252,73,50,47,23,0
63695,184,93,91,26,25,14,11,497,257,240,71,63,62,16,0
63696,207,93,114,20,33,19,10,163,79,84,22,24,13,5,0
63697,789,362,427,90,82,70,35,190,93,97,35,27,23,2,0
63698,1499,864,635,141,99,76,110,517,295,222,69,62,40,28,0
63699,272,94,178,76,33,19,4,437,221,216,62,64,47,13,0
63700,546,278,268,94,60,32,22,452,254,198,72,57,38,18,0
63701,243,114,129,37,30,32,8,198,110,88,27,27,24,4,0
63702,505,282,223,60,57,66,23,418,223,195,51,45,49,14,0
63703,431,199,232,59,54,40,17,201,93,108,34,39,21,6,0
63704,2048,855,1193,297,287,191,93,898,469,429,125,125,134,35,0
63705,55,16,39,24,2,5,2,397,223,174,50,39,29,17,0
63706,1249,543,706,187,164,125,52,241,127,114,34,33,29,12,0
63707,1163,417,746,209,145,87,28,588,286,302,78,99,53,25,0
63708,315,174,141,46,38,47,16,135,57,78,21,20,9,11,0
63709,640,271,369,111,79,57,17,565,237,328,75,88,32,11,0
63710,665,341,324,109,79,38,22,329,196,133,41,36,31,15,0
63711,348,198,150,57,25,37,18,528,276,252,86,78,49,17,0
63712,392,221,171,53,30,25,8,545,269,276,80,76,27,32,0
63713,513,276,237,73,43,57,24,89,37,52,13,6,2,9,0
63714,411,171,240,61,81,30,15,137,85,52,15,11,11,2,0
63715,341,175,166,48,43,35,18,366,204,162,47,41,31,23,0
63716,717,281,436,165,81,112,49,538,274,264,84,67,52,35,0
63717,291,120,171,63,39,26,6,689,343,346,105,102,81,35,0
63718,361,167,194,55,35,41,11,720,361,359,98,98,70,37,0
63719,476,254,222,58,33,46,23,89,51,38,15,15,5,4,0
63720,283,112,171,48,39,34,15,487,252,235,79,58,55,26,0
63721,378,202,176,34,32,44,13,1248,584,664,184,164,155,67,0
63722,119,67,52,15,15,7,7,276,149,127,34,31,32,10,0
63723,979,534,445,83,77,80,24,926,340,586,133,119,60,40,0
63724,347,212,135,35,32,17,6,622,344,278,80,77,68,36,0
63725,251,131,120,49,35,25,5,367,218,149,45,43,42,16,0
63726,941,459,482,167,140,82,38,501,249,252,77,70,55,22,0
63727,527,276,251,64,60,70,20,205,94,111,48,31,15,6,0
63728,1226,513,713,184,147,87,43,135,65,70,21,25,15,9,0
63729,272,94,178,76,33,19,4,418,223,195,51,45,49,14,0
63730,594,321,273,98,59,57,23,471,238,233,66,63,62,19,0
63731,339,118,221,77,68,33,13,189,95,94,25,33,16,8,0
63732,800,416,384,102,105,83,22,180,89,91,28,27,18,7,0
63733,1580,742,838,208,146,144,71,751,394,357,107,96,73,35,0
63734,471,221,250,87,68,42,25,316,166,150,45,38,37,13,0
63735,103,44,59,16,17,9,5,758,361,397,114,107,51,19,0
63736,312,173,139,43,47,28,6,391,189,202,55,56,56,12,0
63737,677,361,316,81,61,42,22,398,200,198,68,43,51,14,0
63738,479,228,251,71,57,60,14,68,23,45,12,9,3,9,0
63739,1342,640,702,187,163,123,57,452,254,198,72,57,38,18,0
63740,210,84,126,44,43,9,4,663,360,303,87,82,80,35,0
63741,419,210,209,54,44,31,23,307,132,175,48,53,26,10,0
63742,181,92,89,34,22,17,9,549,273,276,74,68,72,24,0
63743,320,163,157,44,44,26,15,463,268,195,59,46,46,21,0
63744,1220,575,645,208,179,99,56,1182,591,591,155,139,83,46,0
63745,442,254,188,46,22,40,19,279,161,118,37,32,7,7,0
63746,235,100,135,36,25,30,8,201,104,97,36,32,24,7,0
63747,472,222,250,46,61,33,23,723,353,370,120,109,96,33,0
63748,335,183,152,40,26,54,22,928,440,488,111,157,82,35,0
63749,1759,838,921,269,212,191,92,715,348,367,109,84,68,30,0
63750,282,160,122,36,28,27,7,376,183,193,50,50,43,21,0
63751,429,227,202,49,51,46,26,302,150,152,56,40,52,15,0
63752,1098,519,579,182,159,79,42,373,181,192,54,35,44,20,0
63753,178,74,104,31,28,9,4,415,226,189,51,40,40,29,0
63754,1341,481,860,275,264,57,21,947,482,465,143,107,89,37,0
63755,1441,504,937,264,329,69,46,396,199,197,54,50,45,14,0
63756,282,84,198,60,102,1,6,621,273,348,104,102,48,19,0
63757,854,435,419,118,91,95,42,405,181,224,71,57,31,12,0
63758,2109,999,1110,332,294,187,89,455,191,264,68,86,21,19,0
63759,546,278,268,94,60,32,22,524,300,223,70,54,51,25,0
63760,530,259,271,83,50,54,41,381,187,194,37,49,36,17,0
63761,395,189,206,63,50,49,28,748,359,389,125,113,86,31,0
63762,447,225,222,76,35,75,21,889,505,384,107,97,99,30,0
63763,682,260,422,98,83,42,31,316,159,157,38,48,30,11,0
63764,367,199,168,41,41,33,16,714,364,350,98,102,91,27,0
63765,502,250,252,70,47,57,15,593,289,304,85,69,48,19,0
63766,126,58,68,31,10,10,3,729,358,371,116,99,89,33,0
63767,280,128,152,39,37,38,18,165,90,75,36,18,20,6,0
63768,465,220,245,88,34,61,23,906,455,451,116,105,87,46,0
63769,303,147,156,49,49,20,8,332,173,159,48,40,31,11,0
63770,139,64,75,18,17,18,4,399,190,209,61,41,39,18,0
63771,224,108,116,33,26,32,10,1239,659,580,169,148,131,54,0
63772,132,66,66,21,18,11,7,437,224,213,40,29,42,25,0
63773,1214,498,716,197,180,121,65,497,257,240,71,63,62,16,0
63774,310,141,169,36,38,20,8,479,215,264,67,80,46,28,0
63775,772,383,389,105,76,82,33,303,137,166,54,54,31,15,0
63776,881,492,389,87,97,59,51,621,310,311,100,106,77,27,0
63777,1001,422,579,185,180,51,32,266,146,120,41,28,31,7,0
63778,305,124,181,27,25,32,21,455,191,264,68,86,21,19,0
63779,392,221,171,53,30,25,8,178,69,109,29,25,21,13,0
63780,572,353,219,70,42,57,25,211,88,123,38,28,26,10,0
63781,178,74,104,31,28,9,4,125,66,59,24,16,11,5,0
63782,346,174,172,36,43,21,9,396,197,199,75,49,49,16,0
63783,1556,718,838,280,182,161,49,373,189,184,54,46,50,23,0
63784,402,169,233,70,36,34,18,732,366,366,108,86,74,41,0
63785,346,168,178,36,43,20,9,763,418,345,113,84,59,32,0
63786,567,266,301,139,46,76,37,519,287,232,68,58,45,21,0
63787,264,122,142,33,29,13,13,1425,670,755,153,189,122,85,0
63788,227,109,118,42,35,29,8,378,154,224,74,84,35,22,0
63789,828,368,460,118,98,59,38,335,186,149,40,28,29,13,0
63790,496,209,287,112,55,71,14,975,475,500,139,140,119,28,0
63791,258,126,132,38,22,29,8,376,183,193,50,50,43,21,0
63792,396,150,246,103,64,38,3,519,287,232,68,58,45,21,0
63793,297,161,136,36,35,24,9,245,121,124,37,35,36,12,0
63794,785,325,460,114,123,61,28,325,159,166,59,46,30,12,0
63795,467,233,234,83,37,77,22,538,274,264,84,67,52,35,0
63796,1011,559,452,121,97,132,33,679,338,341,96,95,40,23,0
63797,575,290,285,67,70,28,9,621,273,348,104,102,48,19,0
63798,220,121,99,28,26,17,6,562,273,289,76,92,45,24,0
63799,519,259,260,86,78,59,22,611,314,297,79,75,78,22,0
63800,440,267,173,52,29,42,12,72,34,38,8,2,3,12,0
63801,895,388,507,130,84,90,31,373,189,184,54,46,50,23,0
63802,181,75,106,35,26,11,9,232,108,124,33,27,19,16,0
63803,852,461,391,109,102,72,24,212,127,85,28,21,26,6,0
63804,425,199,226,54,71,56,11,402,186,216,64,47,38,20,0
63805,443,206,237,76,68,52,28,201,98,103,28,25,19,13,0
63806,335,155,180,64,48,36,10,245,121,124,37,35,36,12,0
63807,193,95,98,33,17,25,17,349,200,149,41,39,30,20,0
63808,126,57,69,31,10,10,3,127,66,61,13,14,19,8,0
63809,298,141,157,51,33,21,22,267,141,126,53,27,23,7,0
63810,240,98,142,49,42,23,17,463,268,195,59,46,46,21,0
63811,484,192,292,118,68,83,22,1166,514,652,150,159,107,70,0
63812,502,250,252,70,47,57,15,548,296,252,71,74,43,28,0
63813,728,358,370,118,100,55,29,792,398,394,109,96,90,39,0
63814,126,56,70,31,10,10,3,297,175,122,46,30,31,6,0
63815,798,287,511,126,125,77,26,437,224,213,40,29,42,25,0
63816,766,336,430,133,97,79,21,395,198,197,55,55,36,10,0
63817,257,148,109,28,20,21,14,124,69,55,14,7,9,4,0
63818,286,111,175,51,47,21,12,462,229,233,63,49,42,18,0
63819,361,183,178,50,54,51,22,322,180,142,45,38,28,7,0
63820,524,270,254,84,72,70,23,406,234,172,63,35,43,10,0
63821,898,397,501,102,98,54,37,715,345,370,110,97,64,25,0
63822,471,221,250,87,68,42,25,439,231,208,65,51,55,17,0
63823,335,148,187,52,26,51,12,551,226,325,96,103,43,11,0
63824,179,78,101,29,22,10,8,843,391,452,139,104,91,35,0
63825,579,321,258,74,70,47,22,200,89,111,26,25,17,7,0
63826,111,29,82,10,54,0,1,137,85,52,15,11,11,2,0
63827,325,152,173,43,47,28,17,390,190,200,66,50,43,12,0
63828,803,358,445,135,117,80,43,396,213,183,68,44,47,18,0
63829,138,35,103,38,2,15,9,452,252,200,55,49,61,16,0
63830,342,150,192,52,43,31,17,279,142,137,43,39,28,7,0
63831,442,254,188,46,22,40,19,247,128,119,34,14,16,14,0
63832,586,298,288,80,75,64,37,517,295,222,69,62,40,28,0
63833,480,267,213,49,44,70,21,188,88,100,53,12,15,6,0
63834,281,125,156,44,47,17,7,689,343,346,105,102,81,35,0
63835,525,254,271,60,76,46,13,549,273,276,74,68,72,24,0
63836,1556,718,838,280,182,161,49,266,150,116,28,28,24,12,0
63837,326,154,172,45,39,20,10,266,150,116,28,28,24,12,0
63838,1590,726,864,270,237,126,59,396,199,197,54,50,45,14,0
63839,403,176,227,71,56,51,11,441,189,252,73,50,47,23,0
63840,424,170,254,69,56,47,28,633,311,322,94,82,45,20,0
63841,454,214,240,56,71,35,16,108,59,49,17,13,12,5,0
63842,339,170,169,32,17,24,13,1873,935,938,233,225,203,79,0
63843,522,302,220,61,49,75,19,434,213,221,77,62,53,12,0
63844,146,75,71,13,32,15,11,363,180,183,60,34,10,6,0
63845,932,575,357,94,69,76,40,198,86,112,36,27,23,9,0
63846,2279,996,1283,375,328,158,60,277,138,139,40,39,20,14,0
63847,1096,563,533,158,136,120,53,455,229,226,66,62,63,29,0
63848,594,279,315,93,68,68,26,323,168,155,51,41,38,12,0
63849,199,107,92,41,15,14,8,290,147,143,34,34,39,13,0
63850,498,274,224,58,59,50,18,209,119,90,28,24,27,9,0
63851,55,16,39,24,2,5,2,597,300,297,96,89,68,29,0
63852,316,157,159,45,38,22,19,4646,2328,2318,674,639,475,170,0
63853,714,260,454,140,97,120,54,701,380,321,94,84,96,34,0
63854,282,160,122,36,28,27,7,180,89,91,28,27,18,7,0
63855,291,120,171,63,39,26,6,778,391,387,94,77,41,33,0
63856,234,110,124,39,29,23,2,926,340,586,133,119,60,40,0
63857,98,32,66,15,25,5,4,662,373,289,89,80,77,29,0
63858,743,377,366,87,74,68,30,483,258,225,70,53,54,20,0
63859,837,381,456,123,109,65,25,188,101,87,20,18,20,14,0
63860,126,57,69,31,10,10,3,660,303,357,97,89,85,33,0
63861,580,308,272,82,79,58,25,283,142,141,41,33,26,18,0
63862,346,208,138,46,39,51,18,349,200,149,41,39,30,20,0
63863,303,161,142,38,31,42,17,582,264,318,84,60,58,23,0
63864,257,148,109,28,20,21,14,406,202,204,54,51,63,21,0
63865,498,274,224,58,59,50,18,531,277,254,82,75,33,22,0
63866,126,56,70,31,10,10,3,391,189,202,55,56,56,12,0
63867,543,221,322,78,122,37,12,873,366,507,127,125,75,21,0
63868,707,250,457,171,84,117,61,232,111,121,23,29,17,9,0
63869,519,259,260,86,78,59,22,810,310,500,164,162,42,26,0
63870,1058,497,561,194,142,87,63,142,65,77,30,17,22,9,0
63871,136,66,70,33,11,9,5,1020,538,482,145,115,111,58,0
63872,169,64,105,23,37,11,3,475,251,224,67,49,48,23,0
63873,297,161,136,36,35,24,9,1279,669,610,164,162,104,55,0
63874,1214,498,716,197,180,121,65,373,213,160,44,33,26,17,0
63875,586,298,288,80,75,64,37,378,154,224,74,84,35,22,0
63876,261,126,135,41,36,24,11,257,139,118,64,17,24,7,0
63877,276,149,127,45,34,39,9,903,436,467,128,116,83,33,0
63878,281,154,127,45,31,24,9,557,281,276,80,59,43,21,0
63879,240,167,73,32,12,8,21,524,300,223,70,54,51,25,0
63880,373,164,209,51,45,44,21,902,499,403,118,117,92,35,0
63881,142,60,82,20,28,13,5,627,323,304,81,90,53,27,0
63882,539,283,256,75,73,53,26,72,32,40,8,2,1,14,0
63883,1556,718,838,280,182,161,49,241,127,114,34,33,29,12,0
63884,407,207,200,53,36,38,8,322,180,142,45,38,28,7,0
63885,119,67,52,15,15,7,7,308,129,179,44,60,19,8,0
63886,349,153,196,54,47,28,13,106,41,65,36,6,11,7,0
63887,126,58,68,31,10,10,3,359,171,188,49,74,45,11,0
63888,894,448,446,123,100,82,30,390,190,200,66,50,43,12,0
63889,502,274,228,64,49,75,17,732,366,366,108,86,74,41,0
63890,508,251,257,74,53,51,18,172,79,93,34,27,23,10,0
63891,1342,640,702,187,163,123,57,649,307,342,71,134,45,17,0
63892,1531,649,882,108,122,93,72,330,166,164,55,51,36,16,0
63893,739,323,416,127,89,76,33,465,252,213,73,58,60,18,0
63894,144,57,87,38,26,10,4,330,166,164,55,51,36,16,0
63895,734,366,368,121,99,63,39,335,186,149,40,28,29,13,0
63896,322,164,158,46,44,29,7,689,343,346,105,102,81,35,0
63897,129,70,59,29,9,7,2,1700,731,969,198,233,110,87,0
63898,1199,589,610,189,128,167,65,204,80,124,29,51,10,5,0
63899,203,97,106,30,22,18,10,241,127,114,34,33,29,12,0
63900,1051,429,622,179,148,125,54,972,471,501,152,138,112,40,0
63901,963,477,486,134,143,123,38,330,166,164,55,51,36,16,0
63902,496,210,286,112,55,71,14,1279,669,610,164,162,104,55,0
63903,211,92,119,33,44,11,7,148,69,79,26,18,16,3,0
63904,959,496,463,144,132,75,35,242,124,118,39,32,28,22,0
63905,401,204,197,49,33,29,17,972,471,501,152,138,112,40,0
63906,313,148,165,45,33,36,11,297,164,133,45,39,40,9,0
63907,335,183,152,40,26,54,22,94,45,49,11,20,10,4,0
63908,301,150,151,45,47,33,13,594,312,282,72,67,73,31,0
63909,2285,1219,1066,207,180,178,106,368,200,168,54,49,43,9,0
63910,126,57,69,31,10,10,3,328,195,133,39,40,27,13,0
63911,500,245,255,66,57,52,27,1016,501,515,109,71,76,37,0
63912,441,218,223,69,55,50,27,134,55,79,22,24,16,6,0
63913,463,225,238,76,36,59,26,403,225,178,56,38,33,25,0
63914,107,53,54,15,15,13,4,481,223,258,71,70,49,26,0
63915,852,472,380,99,79,70,27,194,106,88,33,10,15,6,0
63916,319,153,166,61,52,26,12,1230,644,586,198,125,123,61,0
63917,509,251,258,69,49,55,17,963,455,508,127,130,115,48,0
63918,335,183,152,40,26,54,22,821,394,427,122,117,109,38,0
63919,756,265,491,129,127,51,17,519,287,232,68,58,45,21,0
63920,406,208,198,41,26,43,21,548,273,275,84,81,64,30,0
63921,275,125,150,37,48,27,7,1543,794,749,182,152,132,55,0
63922,932,575,357,94,69,76,40,332,155,177,55,51,44,13,0
63923,785,374,411,56,42,38,25,548,296,252,71,74,43,28,0
63924,714,260,454,140,97,120,54,496,251,245,78,62,61,23,0
63925,308,163,145,38,33,30,20,419,233,186,54,53,55,17,0
63926,837,443,394,129,89,87,38,611,314,297,79,75,78,22,0
63927,475,208,267,84,67,50,20,381,186,195,69,55,46,15,0
63928,215,104,111,61,7,2,1,207,114,93,33,20,31,13,0
63929,130,71,59,30,9,8,2,98,49,49,14,15,9,2,0
63930,603,311,292,102,71,66,23,1700,731,969,198,233,110,87,0
63931,722,390,332,125,69,67,25,536,251,285,75,79,60,23,0
63932,330,151,179,68,36,56,9,1265,689,576,169,177,128,60,0
63933,1220,575,645,208,179,99,56,377,184,193,50,43,33,17,0
63934,315,174,141,46,38,47,16,328,199,129,39,29,27,14,0
63935,360,205,155,35,24,52,14,173,94,79,18,24,12,7,0
63936,126,66,60,24,10,7,9,2547,1280,1267,331,335,293,118,0
63937,391,203,188,49,34,36,9,377,184,193,50,43,33,17,0
63938,129,70,59,29,9,7,2,316,166,150,45,38,37,13,0
63939,972,501,471,125,156,106,39,487,252,235,79,58,55,26,0
63940,486,243,243,65,48,63,22,320,168,152,38,42,24,18,0
63941,682,260,422,98,83,42,31,858,398,460,126,138,75,39,0
63942,439,241,198,67,40,40,13,497,227,270,70,63,66,30,0
63943,417,176,241,75,61,51,20,326,169,157,51,41,41,12,0
63944,2525,1232,1293,398,317,186,61,520,244,276,91,60,68,20,0
63945,493,281,212,56,61,30,13,166,88,78,23,18,13,7,0
63946,429,238,191,47,49,56,29,338,169,169,53,44,39,21,0
63947,150,64,86,22,12,29,12,370,173,197,65,57,42,10,0
63948,516,210,306,113,53,81,33,483,258,225,70,53,54,20,0
63949,213,104,109,56,14,9,2,194,109,85,23,24,21,9,0
63950,639,368,271,72,51,38,38,508,253,255,73,60,50,13,0
63951,429,238,191,47,49,56,29,1755,905,850,214,196,183,79,0
63952,368,201,167,61,38,38,12,322,180,142,45,38,28,7,0
63953,125,53,72,18,21,18,12,294,146,148,50,45,51,15,0
63954,255,136,119,39,20,32,10,350,196,154,52,37,21,14,0
63955,531,259,272,75,81,39,13,65,32,33,16,4,8,3,0
63956,2063,1024,1039,175,117,80,97,2346,1231,1115,316,292,266,105,0
63957,509,246,263,84,71,56,22,222,127,95,23,28,22,7,0
63958,546,278,268,94,60,32,22,127,58,69,18,17,10,5,0
63959,746,312,434,129,115,77,47,218,114,104,32,31,33,11,0
63960,410,200,210,60,54,46,19,354,183,171,54,43,49,8,0
63961,1616,735,881,285,248,153,72,710,375,335,95,94,110,28,0
63962,399,220,179,48,37,68,18,535,311,224,66,52,49,24,0
63963,734,366,368,121,99,63,39,153,80,73,26,18,19,4,0
63964,766,336,430,133,97,79,21,531,261,270,73,80,68,26,0
63965,1214,612,602,169,173,98,35,2542,1245,1297,285,287,170,84,0
63966,431,245,186,50,23,46,17,188,93,95,33,18,16,10,0
63967,326,176,150,35,22,29,11,292,143,149,38,42,36,16,0
63968,588,300,288,100,57,65,27,453,247,206,58,53,45,20,0
63969,442,254,188,46,22,40,19,461,223,238,45,62,18,35,0
63970,734,339,395,135,89,78,36,515,276,239,62,59,43,31,0
63971,130,71,59,30,9,8,2,381,186,195,69,55,46,15,0
63972,361,167,194,55,35,41,11,350,196,154,52,37,21,14,0
63973,394,207,187,52,42,37,24,598,333,265,79,66,54,33,0
63974,1030,567,463,118,106,94,49,274,142,132,33,34,18,14,0
63975,184,93,91,26,25,14,11,526,266,260,76,75,53,22,0
63976,505,226,279,68,51,30,15,1034,495,539,150,134,114,71,0
63977,308,129,179,44,60,19,8,341,170,171,41,66,27,10,0
63978,760,405,355,112,95,92,29,417,232,185,58,50,29,21,0
63979,227,109,118,42,35,29,8,474,268,206,66,42,45,24,0
63980,631,304,327,98,75,52,23,230,125,105,29,40,20,6,0
63981,443,212,231,74,24,60,24,439,227,212,60,55,58,8,0
63982,437,230,207,41,55,27,13,1698,875,823,222,219,173,64,0
63983,533,300,233,74,50,74,17,727,388,339,102,87,70,29,0
63984,649,304,345,99,80,67,40,190,93,97,35,27,23,2,0
63985,640,279,361,102,83,69,21,285,143,142,45,32,21,17,0
63986,605,277,328,99,54,63,43,935,515,420,126,107,73,32,0
63987,484,264,220,59,62,68,15,821,394,427,122,117,109,38,0
63988,469,253,216,49,51,48,18,201,104,97,36,32,24,7,0
63989,579,321,258,74,70,47,22,535,288,247,79,72,35,21,0
63990,476,276,200,57,34,43,16,319,185,134,42,31,22,13,0
63991,236,120,116,32,28,21,11,561,279,282,85,81,88,24,0
63992,430,198,232,57,46,37,19,1328,648,680,220,151,109,40,0
63993,529,290,239,54,63,85,15,246,125,121,38,36,30,11,0
63994,451,278,173,71,35,58,12,501,240,261,80,62,49,42,0
63995,1139,537,602,162,139,109,50,963,455,508,127,130,115,48,0
63996,862,384,478,127,110,75,42,459,260,199,56,42,47,21,0
63997,514,226,288,71,66,63,32,1321,653,668,186,195,70,35,0
63998,579,246,333,102,79,41,19,555,292,263,75,63,67,27,0
63999,291,131,160,49,35,32,15,463,259,204,62,55,34,22,0
64000,418,163,255,57,54,38,24,715,348,367,109,84,68,30,0
64001,366,190,176,39,62,55,14,142,65,77,30,17,22,9,0
64002,251,131,120,49,35,25,5,103,59,44,25,2,13,6,0
64003,424,170,254,69,56,47,28,396,197,199,75,49,49,16,0
64004,522,302,220,61,49,75,19,348,194,154,57,31,43,12,0
64005,881,492,389,87,97,59,51,605,283,322,94,72,64,39,0
64006,1143,574,569,176,151,123,59,292,155,137,50,34,29,13,0
64007,666,204,462,110,194,42,14,230,125,105,29,40,20,6,0
64008,246,111,135,64,47,27,3,334,182,152,45,41,27,13,0
64009,300,136,164,45,35,45,14,1323,690,633,132,178,112,61,0
64010,220,121,99,28,26,17,6,1062,522,540,151,147,105,66,0
64011,1339,494,845,216,298,92,37,487,252,235,79,58,55,26,0
64012,2279,996,1283,375,328,158,60,780,337,443,112,116,77,28,0
64013,546,265,281,101,64,38,16,751,394,357,107,96,73,35,0
64014,488,237,251,79,78,65,27,463,268,195,59,46,46,21,0
64015,677,361,316,81,61,42,22,229,120,109,31,30,22,9,0
64016,434,216,218,72,58,40,20,405,195,210,57,74,24,17,0
64017,192,91,101,28,21,18,8,403,185,218,67,62,63,19,0
64018,1130,614,516,129,138,98,42,147,74,73,28,20,24,4,0
64019,1143,574,569,176,151,123,59,387,193,194,60,53,57,15,0
64020,130,71,59,30,9,8,1,671,306,365,114,76,49,19,0
64021,915,336,579,185,199,56,29,152,71,81,41,16,14,2,0
64022,346,174,172,36,43,21,9,303,137,166,54,54,31,15,0
64023,452,217,235,59,47,60,20,309,164,145,35,47,30,11,0
64024,933,456,477,123,108,83,29,154,78,76,23,21,13,5,0
64025,395,189,206,63,50,49,28,898,469,429,125,125,134,35,0
64026,315,111,204,82,66,46,11,1182,591,591,155,139,83,46,0
64027,390,199,191,72,42,35,12,111,60,51,17,23,10,7,0
64028,580,240,340,108,81,59,22,509,267,242,79,81,38,20,0
64029,218,133,85,20,19,13,6,452,252,200,55,49,61,16,0
64030,434,216,218,72,58,40,20,600,254,346,104,100,44,17,0
64031,367,167,200,63,42,60,17,396,199,197,54,50,45,14,0
64032,1867,973,894,256,222,194,65,403,184,219,75,51,47,20,0
64033,446,283,163,51,26,33,19,947,482,465,143,107,89,37,0
64034,233,110,123,34,22,34,9,201,98,103,28,25,19,13,0
64035,234,108,126,42,40,15,9,257,139,118,64,17,24,7,0
64036,240,99,141,53,38,29,15,556,290,266,75,74,29,24,0
64037,546,285,261,71,49,47,24,1241,619,622,183,169,155,59,0
64038,1068,434,634,173,160,61,29,405,195,210,57,74,24,17,0
64039,358,212,146,51,36,33,9,288,156,132,36,36,24,15,0
64040,380,185,195,68,54,32,16,218,115,103,37,33,33,9,0
64041,372,171,201,47,53,39,18,106,46,60,29,13,14,5,0
64042,344,168,176,50,39,30,20,482,232,250,77,81,44,13,0
64043,260,136,124,24,41,19,4,370,173,197,65,57,42,10,0
64044,102,22,80,48,8,18,6,452,254,198,72,57,38,18,0
64045,410,209,201,72,30,48,22,288,156,132,36,36,24,15,0
64046,241,122,119,27,34,17,16,404,190,214,55,55,35,27,0
64047,911,445,466,154,121,108,48,622,344,278,80,77,68,36,0
64048,500,297,203,66,33,53,15,415,203,212,77,44,49,18,0
64049,1498,731,767,220,175,148,68,245,131,114,30,27,18,13,0
64050,1052,492,560,184,163,103,44,212,127,85,28,21,26,6,0
64051,529,290,239,54,63,85,15,810,310,500,164,162,42,26,0
64052,282,96,186,80,21,28,7,375,176,199,48,61,40,12,0
64053,196,107,89,20,31,17,4,467,240,227,65,65,51,23,0
64054,317,167,150,45,21,30,26,289,140,149,33,42,30,15,0
64055,539,283,256,75,73,53,26,430,212,218,88,43,40,20,0
64056,933,456,477,123,108,83,29,266,146,120,41,28,31,7,0
64057,209,75,134,53,48,20,9,579,285,294,78,72,64,32,0
64058,527,254,273,67,66,70,31,1500,804,696,190,172,144,60,0
64059,273,126,147,54,49,25,18,222,122,100,39,32,24,9,0
64060,142,60,82,20,28,13,5,417,232,185,58,50,29,21,0
64061,1501,679,822,251,196,174,67,329,196,133,41,36,31,15,0
64062,911,441,470,123,108,60,21,821,394,427,122,117,109,38,0
64063,440,267,173,52,29,42,12,240,141,99,34,28,29,8,0
64064,425,199,226,54,71,56,11,452,254,198,72,57,38,18,0
64065,494,233,261,87,57,46,18,270,162,108,26,26,16,11,0
64066,1709,650,1059,338,286,185,46,234,129,105,31,22,19,17,0
64067,531,284,247,66,42,49,15,332,180,152,44,36,27,13,0
64068,313,134,179,58,37,43,19,189,105,84,25,26,21,9,0
64069,270,128,142,36,43,15,11,266,150,116,28,28,24,12,0
64070,275,160,115,40,31,34,17,381,187,194,37,49,36,17,0
64071,417,222,195,53,39,43,10,218,118,100,33,30,25,11,0
64072,548,250,298,85,64,56,21,699,334,365,108,80,70,20,0
64073,512,254,258,70,48,37,32,561,279,282,85,81,88,24,0
64074,683,304,379,140,101,48,19,2335,1200,1135,374,268,340,83,0
64075,956,450,506,122,117,82,36,142,73,69,27,9,15,11,0
64076,595,316,279,86,60,65,40,360,180,180,57,48,39,12,0
64077,344,168,176,50,39,30,20,334,181,153,41,40,25,15,0
64078,828,355,473,126,134,77,37,123,61,62,17,18,17,7,0
64079,1759,838,921,269,212,191,92,535,288,247,79,72,35,21,0
64080,435,222,213,67,49,67,12,928,440,488,111,157,82,35,0
64081,238,158,80,28,15,31,7,218,118,100,33,30,25,11,0
64082,447,225,222,76,35,75,21,149,77,72,37,10,20,5,0
64083,249,114,135,47,33,25,4,483,215,268,66,70,30,16,0
64084,305,124,181,27,25,31,21,1001,417,584,186,147,96,47,0
64085,159,105,54,22,9,14,25,1395,627,768,172,263,141,59,0
64086,161,75,86,24,20,10,7,374,174,200,54,52,42,21,0
64087,466,259,207,59,50,83,12,306,157,149,52,35,39,16,0
64088,764,277,487,158,162,64,31,396,223,173,57,37,44,19,0
64089,927,457,470,130,99,118,42,598,333,265,79,66,54,33,0
64090,437,230,207,41,55,27,13,524,300,223,70,54,51,25,0
64091,297,182,115,41,22,23,8,485,244,241,80,55,59,20,0
64092,540,252,288,73,67,57,20,664,350,314,86,90,82,36,0
64093,665,341,324,109,79,38,22,471,238,233,66,63,62,19,0
64094,687,351,336,106,67,70,41,218,114,104,32,31,33,11,0
64095,204,109,95,21,35,27,7,387,193,194,60,53,57,15,0
64096,331,169,162,40,28,22,14,132,67,65,24,21,8,10,0
64097,1030,567,463,118,106,94,49,277,144,133,42,30,41,8,0
64098,474,243,231,66,54,41,29,437,224,213,40,29,42,25,0
64099,800,416,384,102,105,83,22,166,78,88,27,25,19,7,0
64100,610,249,361,107,69,72,33,277,163,114,33,24,21,16,0
64101,648,376,272,70,60,73,24,242,121,121,39,30,29,10,0
64102,953,421,532,131,131,70,37,671,321,350,95,87,75,34,0
64103,317,167,150,45,21,30,26,396,197,199,75,49,49,16,0
64104,350,212,138,32,26,40,13,274,157,117,40,29,40,8,0
64105,603,311,292,102,71,66,23,225,111,114,32,34,32,16,0
64106,598,322,276,67,57,63,26,335,170,165,52,36,47,11,0
64107,326,154,172,45,39,20,10,404,190,214,55,55,35,27,0
64108,1054,497,557,190,168,107,45,384,212,172,44,43,34,14,0
64109,520,240,280,67,72,42,14,463,170,293,115,54,75,32,0
64110,3703,1708,1995,456,428,305,162,286,160,126,37,27,23,10,0
64111,308,163,145,38,33,30,20,457,245,212,62,58,57,21,0
64112,257,132,125,39,27,26,10,439,227,212,60,55,58,8,0
64113,983,449,534,95,77,55,36,843,391,452,139,104,91,35,0
64114,331,165,166,52,34,48,22,153,65,88,28,21,20,8,0
64115,128,70,58,29,9,8,1,660,332,328,84,73,47,19,0
64116,206,96,110,33,25,8,6,396,223,173,57,37,44,19,0
64117,585,277,308,92,73,61,32,189,95,94,25,33,16,8,0
64118,437,167,270,126,95,34,10,536,267,269,60,70,41,22,0
64119,168,67,101,37,17,13,13,632,360,272,75,65,36,19,0
64120,961,465,496,139,156,62,34,367,218,149,45,43,42,16,0
64121,577,342,235,63,57,23,37,72,33,39,8,2,3,12,0
64122,1098,519,579,182,159,79,42,144,67,77,28,14,9,8,0
64123,520,240,280,87,63,67,16,196,105,91,40,13,19,10,0
64124,350,172,178,61,45,32,13,326,149,177,51,51,28,10,0
64125,622,354,268,89,60,64,18,773,389,384,119,91,79,26,0
64126,372,171,201,47,53,39,18,415,203,212,77,44,49,18,0
64127,1501,679,822,251,196,174,67,418,223,195,53,43,49,15,0
64128,414,216,198,51,32,42,28,821,394,427,122,117,109,38,0
64129,1970,978,992,245,206,198,80,337,170,167,59,33,47,17,0
64130,588,300,288,100,57,65,27,429,187,242,79,72,28,19,0
64131,467,233,234,83,37,77,22,377,184,193,50,43,33,17,0
64132,413,206,207,38,55,19,10,346,178,168,58,41,33,12,0
64133,904,436,468,138,146,82,39,98,49,49,14,15,9,2,0
64134,432,233,199,52,28,47,18,374,202,172,50,39,31,24,0
64135,159,105,54,22,9,14,25,124,69,55,14,7,9,4,0
64136,261,126,135,41,36,24,11,326,149,177,51,51,28,10,0
64137,763,354,409,101,90,63,26,72,32,40,8,2,2,13,0
64138,316,157,159,45,38,22,19,289,140,149,33,42,30,15,0
64139,1208,575,633,187,204,117,41,846,425,421,125,97,98,38,0
64140,193,105,88,33,16,9,4,766,386,380,101,81,78,31,0
64141,193,95,98,33,17,25,17,173,86,87,30,22,19,12,0
64142,784,351,433,118,87,73,41,309,159,150,47,43,43,13,0
64143,577,342,235,63,57,23,37,198,86,112,36,27,23,9,0
64144,458,226,232,77,59,61,14,561,279,282,85,81,88,24,0
64145,1189,653,536,152,118,109,56,449,252,197,61,52,36,18,0
64146,425,199,226,54,71,56,11,601,279,322,81,65,27,12,0
64147,204,103,101,16,32,22,8,821,394,427,122,117,109,38,0
64148,616,323,293,98,71,31,15,194,106,88,33,10,15,6,0
64149,435,225,210,58,46,50,14,164,79,85,28,28,16,7,0
64150,336,134,202,51,64,27,12,290,142,148,41,37,43,11,0
64151,507,242,265,53,44,31,22,290,142,148,41,37,43,11,0
64152,550,304,246,60,64,77,16,198,110,88,27,27,24,4,0
64153,390,199,191,72,42,35,12,536,267,269,60,70,41,22,0
64154,648,262,386,113,108,78,29,447,212,235,86,55,58,21,0
64155,90,54,36,20,4,14,5,947,482,465,143,107,89,37,0
64156,520,240,280,87,63,67,16,555,292,263,75,63,67,27,0
64157,261,148,113,23,29,26,21,225,129,96,32,33,20,8,0
64158,236,141,95,36,32,14,6,68,23,45,12,9,3,9,0
64159,1390,585,805,241,230,118,46,325,172,153,44,34,27,14,0
64160,129,70,59,29,9,7,2,423,234,189,66,44,57,12,0
64161,231,105,126,56,10,24,10,123,61,62,17,18,17,7,0
64162,126,57,69,31,10,10,3,925,439,486,141,134,105,46,0
64163,126,58,68,31,10,10,3,198,115,83,30,22,8,8,0
64164,361,183,178,50,54,51,22,449,252,197,61,52,36,18,0
64165,129,70,59,29,9,7,2,660,333,327,102,95,69,31,0
64166,279,127,152,50,36,28,8,68,36,32,11,8,9,2,0
64167,1199,589,610,189,128,167,65,2225,1244,981,271,243,217,93,0
64168,1501,679,822,251,196,174,67,222,122,100,39,32,24,9,0
64169,404,197,207,60,48,47,20,270,130,140,48,44,37,12,0
64170,1339,494,845,216,298,92,37,2225,1244,981,271,243,217,93,0
64171,280,128,152,39,37,38,18,427,251,176,51,39,25,22,0
64172,213,88,125,21,54,14,15,360,180,180,57,48,39,12,0
64173,255,110,145,34,32,23,17,367,199,168,62,44,34,8,0
64174,466,199,267,86,59,32,17,119,61,58,17,12,10,6,0
64175,164,77,87,33,19,6,7,593,289,304,85,69,48,19,0
64176,1124,442,682,148,189,72,43,482,231,251,76,81,64,26,0
64177,399,196,203,62,45,38,19,188,105,83,25,17,24,7,0
64178,350,178,172,49,62,29,16,561,279,282,85,81,88,24,0
64179,420,189,231,79,67,33,17,239,113,126,36,49,20,8,0
64180,221,75,146,68,21,16,5,846,425,421,125,97,98,38,0
64181,288,142,146,52,32,26,8,265,134,131,48,34,33,15,0
64182,57,24,33,11,3,5,3,314,177,137,34,40,29,9,0
64183,640,279,361,102,83,69,21,926,340,586,133,119,60,40,0
64184,641,349,292,92,60,39,24,492,278,214,65,58,32,11,0
64185,919,444,475,141,148,62,20,366,204,162,47,41,31,23,0
64186,331,177,154,54,38,27,11,381,196,185,55,57,43,16,0
64187,126,58,68,31,10,10,3,142,73,69,27,9,15,11,0
64188,752,313,439,121,106,68,27,138,69,69,28,7,10,10,0
64189,1960,875,1085,287,189,162,66,758,319,439,101,123,78,25,0
64190,2048,855,1193,297,287,191,93,132,61,71,22,21,15,3,0
64191,2279,996,1283,375,328,158,60,429,187,242,79,72,28,19,0
64192,236,141,95,36,32,14,6,1696,771,925,257,225,149,63,0
64193,369,207,162,67,35,16,14,312,165,147,41,39,29,16,0
64194,236,141,95,36,32,14,6,149,77,72,37,10,20,5,0
64195,426,231,195,51,52,45,24,605,283,322,94,72,64,39,0
64196,828,368,460,118,98,59,38,457,242,215,39,46,53,10,0
64197,333,171,162,41,44,48,23,724,353,371,94,95,71,31,0
64198,562,214,348,120,86,69,42,306,157,149,52,35,39,16,0
64199,356,199,157,36,43,28,12,679,338,341,96,95,40,23,0
64200,412,193,219,69,57,43,14,414,203,211,58,56,48,14,0
64201,3859,2011,1848,535,391,422,207,153,65,88,28,21,20,8,0
64202,346,173,173,50,56,31,14,337,152,185,49,54,42,21,0
64203,390,199,191,72,42,35,12,403,221,182,62,50,42,12,0
64204,426,228,198,62,42,47,22,440,246,194,62,49,41,16,0
64205,131,69,62,29,9,9,1,2382,1162,1220,237,220,140,49,0
64206,860,348,512,121,136,75,35,410,197,213,67,43,56,18,0
64207,243,70,173,54,65,8,6,329,196,133,41,36,31,15,0
64208,350,212,138,32,26,40,13,180,108,72,22,22,15,5,0
64209,260,136,124,24,41,19,4,1543,794,749,182,152,132,55,0
64210,458,226,232,77,59,61,14,390,223,167,58,36,45,18,0
64211,798,364,434,133,88,74,35,309,164,145,35,47,30,11,0
64212,215,104,111,61,7,2,1,374,174,200,54,52,42,21,0
64213,443,226,217,67,34,53,10,199,92,107,34,30,18,9,0
64214,580,308,272,82,79,58,25,201,93,108,34,39,21,6,0
64215,493,208,285,75,77,70,40,524,300,223,70,54,51,25,0
64216,587,318,269,76,50,38,21,220,107,113,36,35,28,9,0
64217,160,53,107,31,29,13,3,403,225,178,56,38,33,25,0
64218,900,434,466,134,97,86,36,660,333,327,102,95,69,31,0
64219,435,222,213,67,49,67,12,301,168,133,49,37,34,11,0
64220,261,148,113,23,29,26,21,98,49,49,14,15,9,2,0
64221,101,41,60,18,19,10,5,222,125,97,36,28,17,5,0
64222,639,368,271,72,51,38,38,144,67,77,28,14,9,8,0
64223,449,179,270,80,77,49,29,406,234,172,63,35,43,10,0
64224,443,250,193,52,23,49,13,437,221,216,62,64,47,13,0
64225,446,195,251,56,53,31,15,317,161,156,50,36,47,12,0
64226,516,210,306,113,53,81,33,597,300,297,96,89,68,29,0
64227,313,148,165,45,33,36,11,256,141,115,32,22,32,8,0
64228,417,222,195,53,39,43,10,1065,581,484,134,97,76,46,0
64229,527,276,251,64,60,70,20,400,187,213,56,59,42,20,0
64230,464,237,227,64,66,33,12,218,117,101,35,32,34,12,0
64231,465,220,245,88,34,61,23,54,26,28,11,4,3,3,0
64232,733,382,351,126,92,93,27,422,202,220,80,52,57,18,0
64233,586,298,288,80,75,64,37,584,249,335,80,96,22,13,0
64234,781,367,414,60,67,43,17,367,218,149,45,43,42,16,0
64235,643,284,359,129,71,84,43,501,274,227,63,58,53,20,0
64236,338,208,130,39,30,35,12,744,385,359,105,96,57,31,0
64237,536,237,299,116,87,42,17,507,270,237,89,59,57,22,0
64238,530,259,271,83,50,54,41,328,195,133,39,40,27,13,0
64239,510,288,222,44,36,24,7,429,187,242,79,72,28,19,0
64240,2446,1099,1347,363,294,233,100,171,94,77,24,28,30,11,0
64241,3859,2011,1848,535,391,422,207,926,340,586,133,119,60,40,0
64242,932,575,357,94,69,76,40,136,65,71,26,11,7,5,0
64243,160,53,107,31,29,13,3,406,234,172,63,35,43,10,0
64244,473,265,208,47,26,50,30,630,321,309,86,90,57,26,0
64245,789,362,427,90,82,70,35,699,334,365,108,80,70,20,0
64246,328,156,172,44,37,44,15,285,143,142,45,32,21,17,0
64247,176,74,102,20,29,7,7,96,45,51,13,12,6,4,0
64248,164,77,87,33,19,6,7,792,398,394,109,96,90,39,0
64249,245,111,134,36,27,18,6,766,386,380,101,81,78,31,0
64250,476,199,277,82,80,49,24,222,124,98,37,29,22,9,0
64251,374,202,172,58,40,41,7,422,237,185,53,47,62,20,0
64252,142,60,82,20,28,13,5,132,67,65,24,21,8,10,0
64253,76,42,34,12,8,5,7,278,154,124,42,32,38,7,0
64254,1439,713,726,195,180,110,34,549,273,276,74,68,72,24,0
64255,332,173,159,48,42,42,9,277,124,153,44,40,35,18,0
64256,908,324,584,181,162,81,29,811,361,450,124,107,80,31,0
64257,956,450,506,122,117,82,36,723,363,360,107,106,52,14,0
64258,928,442,486,139,118,91,43,403,184,219,75,51,47,20,0
64259,763,371,392,104,88,52,23,862,409,453,149,125,86,29,0
64260,376,176,200,31,53,27,8,406,223,183,61,53,46,17,0
64261,509,246,263,84,71,56,22,926,340,586,133,119,60,40,0
64262,272,94,178,76,33,19,4,545,269,276,80,76,27,32,0
64263,228,82,146,45,37,18,8,501,274,227,63,58,53,20,0
64264,756,362,394,102,104,73,25,166,78,88,27,25,19,7,0
64265,421,237,184,47,54,45,10,647,324,323,101,80,76,43,0
64266,361,177,184,59,51,24,15,229,120,109,31,30,22,9,0
64267,626,308,318,105,89,77,25,302,150,152,56,40,52,15,0
64268,130,71,59,30,9,8,1,630,321,309,86,90,57,26,0
64269,1121,458,663,158,210,76,47,457,245,212,62,58,57,21,0
64270,756,362,394,102,104,73,25,727,388,339,102,87,70,29,0
64271,480,257,223,74,26,60,27,283,142,141,41,33,26,18,0
64272,330,141,189,65,29,51,19,377,184,193,50,43,33,17,0
64273,593,325,268,84,66,73,24,605,283,322,94,72,64,39,0
64274,372,189,183,60,44,41,18,418,223,195,53,43,49,15,0
64275,452,202,250,83,60,56,19,766,386,380,101,81,78,31,0
64276,376,176,200,31,53,27,8,485,244,241,80,55,59,20,0
64277,224,108,116,31,32,22,8,227,130,97,32,25,22,12,0
64278,385,203,182,47,43,51,21,374,212,162,48,40,32,23,0
64279,747,469,278,60,41,53,23,621,310,311,100,106,77,27,0
64280,146,73,73,18,24,17,9,508,253,255,73,60,50,13,0
64281,288,142,146,52,32,26,8,207,113,94,33,18,30,9,0
64282,335,171,164,51,38,38,10,325,172,153,44,34,27,14,0
64283,231,105,126,56,10,24,10,579,285,294,78,72,64,32,0
64284,57,24,33,11,3,5,3,572,305,267,74,72,58,21,0
64285,473,217,256,59,44,34,21,453,255,198,62,49,29,19,0
64286,411,202,209,60,67,57,24,91,42,49,21,9,8,3,0
64287,269,156,113,37,32,17,7,303,137,166,54,54,31,15,0
64288,244,104,140,52,31,30,14,130,67,63,24,10,12,4,0
64289,342,185,157,42,27,31,14,222,125,97,34,27,27,7,0
64290,129,70,59,29,9,7,2,2202,1121,1081,338,274,269,81,0
64291,234,110,124,39,29,23,2,245,131,114,30,27,18,13,0
64292,711,330,381,111,86,86,34,1543,794,749,182,152,132,55,0
64293,315,174,141,46,38,47,16,508,262,246,66,67,51,20,0
64294,252,121,131,42,34,12,16,605,283,322,94,72,64,39,0
64295,588,300,288,100,57,65,27,72,32,40,8,2,1,14,0
64296,340,181,159,44,39,35,21,148,69,79,26,18,16,3,0
64297,127,62,65,13,33,7,6,246,125,121,38,36,30,11,0
64298,328,156,172,44,37,44,15,1425,670,755,153,189,122,85,0
64299,304,149,155,46,32,39,14,531,277,254,82,75,33,22,0
64300,513,276,237,73,43,57,24,198,110,88,27,27,24,4,0
64301,184,88,96,15,40,17,8,715,345,370,110,97,64,25,0
64302,130,71,59,30,9,8,1,535,301,234,63,48,47,27,0
64303,380,148,232,81,69,24,8,335,186,149,40,28,29,13,0
64304,1200,602,598,145,116,110,50,630,321,309,86,90,57,26,0
64305,887,439,448,137,99,91,38,386,181,205,55,51,57,31,0
64306,1068,434,634,173,160,61,29,384,212,172,44,43,34,14,0
64307,349,131,218,66,76,22,9,261,162,99,24,21,14,10,0
64308,646,304,342,104,93,58,26,1265,689,576,169,177,128,60,0
64309,710,352,358,104,86,84,41,190,93,97,35,27,23,2,0
64310,306,172,134,35,31,37,18,475,251,224,67,49,48,23,0
64311,102,22,80,48,8,18,6,250,116,134,41,30,33,19,0
64312,736,353,383,117,83,71,18,350,196,154,52,37,21,14,0
64313,482,231,251,76,81,64,26,660,333,327,102,95,69,31,0
64314,1098,519,579,182,159,79,42,234,129,105,31,22,19,17,0
64315,730,298,432,128,69,86,26,471,238,233,66,63,62,19,0
64316,350,190,160,48,25,27,18,598,333,265,79,66,54,33,0
64317,301,150,151,45,47,33,13,1698,875,823,222,219,173,64,0
64318,258,130,128,44,37,29,10,873,411,462,132,107,84,40,0
64319,406,208,198,41,26,43,21,68,36,32,11,8,9,2,0
64320,466,199,267,86,59,32,17,336,200,136,34,29,25,24,0
64321,772,332,440,136,104,72,28,204,96,108,31,37,20,5,0
64322,446,195,251,56,53,31,15,334,182,152,45,41,27,13,0
64323,179,96,83,24,8,26,4,397,223,174,50,39,29,17,0
64324,329,165,164,61,44,29,17,246,125,121,38,36,30,11,0
64325,102,22,80,48,8,18,6,142,73,69,27,9,15,11,0
64326,646,304,342,104,93,58,26,201,104,97,36,32,24,7,0
64327,502,274,228,64,49,75,17,198,110,88,27,27,24,4,0
64328,1594,660,934,251,272,117,77,207,113,94,33,18,30,9,0
64329,1064,495,569,157,159,124,58,419,233,186,54,53,55,17,0
64330,500,297,203,66,33,53,15,337,152,185,49,54,42,21,0
64331,435,225,210,58,46,50,14,144,67,77,28,14,9,8,0
64332,1014,488,526,178,137,94,39,139,68,71,14,26,14,9,0
64333,413,169,244,66,94,28,19,415,203,212,77,44,49,18,0
64334,243,114,129,37,30,32,8,1873,935,938,233,225,203,79,0
64335,346,173,173,50,56,31,14,633,311,322,94,82,45,20,0
64336,837,381,456,123,109,65,25,679,338,341,96,95,40,23,0
64337,215,80,135,54,56,21,9,375,211,164,50,36,31,23,0
64338,715,345,370,110,97,64,25,559,317,242,58,65,37,23,0
64339,411,211,200,61,46,35,18,427,251,176,51,39,25,22,0
64340,1867,973,894,256,222,194,65,88,50,38,13,8,16,4,0
64341,349,167,182,54,38,30,28,492,278,214,65,58,32,11,0
64342,438,185,253,71,64,52,28,103,59,44,25,2,13,6,0
64343,202,113,89,16,27,21,11,196,105,91,40,13,19,10,0
64344,161,75,86,24,20,10,7,483,258,225,70,53,54,20,0
64345,102,22,80,48,8,18,6,390,223,167,58,36,45,18,0
64346,447,232,215,55,65,50,25,450,241,209,67,58,54,23,0
64347,626,300,326,91,82,68,26,397,234,163,44,38,23,21,0
64348,531,259,272,75,81,39,13,231,126,105,28,26,34,9,0
64349,199,107,92,41,15,14,8,597,300,297,96,89,68,29,0
64350,453,240,213,53,33,44,16,302,150,152,56,40,52,15,0
64351,1042,529,513,161,151,103,52,293,153,140,45,38,22,15,0
64352,658,349,309,77,70,73,35,260,131,129,42,31,40,9,0
64353,682,260,422,153,78,109,46,492,278,214,65,58,32,11,0
64354,427,191,236,67,60,41,34,475,251,224,67,49,48,23,0
64355,437,167,270,126,95,34,10,2724,1157,1567,269,518,239,77,0
64356,929,410,519,187,146,53,30,147,74,73,28,20,24,4,0
64357,873,366,507,127,125,75,21,257,139,118,64,17,24,7,0
64358,392,205,187,83,49,38,10,166,90,76,27,18,21,5,0
64359,972,501,471,125,156,106,39,470,205,265,71,80,33,11,0
64360,833,295,538,146,139,65,34,545,269,276,80,76,27,32,0
64361,467,233,234,83,37,77,22,96,46,50,16,12,7,5,0
64362,1447,698,749,214,180,116,46,368,200,168,54,49,43,9,0
64363,376,249,127,47,23,43,16,334,181,153,56,31,28,18,0
64364,309,137,172,51,50,28,14,203,98,105,34,29,19,10,0
64365,376,176,200,31,53,27,8,105,51,54,13,17,12,8,0
64366,833,295,538,146,139,65,34,758,319,439,101,123,78,25,0
64367,667,366,301,96,55,84,25,218,115,103,37,33,33,9,0
64368,607,305,302,92,89,74,23,188,90,98,44,7,21,7,0
64369,456,214,242,76,62,52,22,173,86,87,30,22,19,12,0
64370,412,146,266,106,38,67,35,462,229,233,63,49,42,18,0
64371,193,95,98,33,17,25,17,452,254,198,72,57,38,18,0
64372,557,250,307,70,47,51,22,218,114,104,32,31,33,11,0
64373,582,328,254,78,48,35,9,106,54,52,12,9,7,6,0
64374,422,207,215,79,38,53,23,1101,626,475,145,122,120,50,0
64375,927,457,470,130,99,118,42,370,173,197,65,57,42,10,0
64376,304,149,155,46,32,39,14,246,125,121,38,36,30,11,0
64377,2696,1169,1527,432,347,193,146,395,169,226,73,55,38,9,0
64378,178,87,91,20,32,13,10,332,155,177,55,51,44,13,0
64379,210,101,109,33,33,19,9,68,23,45,12,9,3,9,0
64380,473,265,208,47,26,50,30,178,69,109,29,25,21,13,0
64381,272,141,131,45,29,36,9,660,303,357,97,89,85,33,0
64382,411,171,240,61,81,30,15,129,60,69,21,15,8,5,0
64383,793,355,438,134,117,77,43,405,214,191,53,42,49,20,0
64384,972,501,471,125,156,106,39,499,239,260,73,75,34,19,0
64385,206,100,106,34,26,11,7,169,84,85,29,19,21,7,0
64386,1014,488,526,178,137,94,39,441,189,252,73,50,47,23,0
64387,178,74,104,31,28,9,4,607,293,314,98,71,62,32,0
64388,500,297,203,66,33,53,15,239,113,126,36,49,20,8,0
64389,381,146,235,74,48,47,34,395,198,197,55,55,36,10,0
64390,139,81,58,17,14,24,9,172,79,93,34,27,23,10,0
64391,575,295,280,89,68,54,18,627,289,338,101,73,62,43,0
64392,488,237,251,79,78,65,27,497,257,240,71,63,62,16,0
64393,579,321,258,74,70,47,22,172,79,93,34,27,23,10,0
64394,204,93,111,35,35,16,11,250,119,131,58,26,29,7,0
64395,131,69,62,29,9,9,1,73,35,38,14,10,9,4,0
64396,784,353,431,56,47,26,18,367,218,149,45,43,42,16,0
64397,258,126,132,38,22,29,8,396,213,183,68,44,47,18,0
64398,299,151,148,35,34,26,16,194,109,85,23,24,21,9,0
64399,983,449,534,95,77,55,36,469,225,244,64,68,25,11,0
64400,998,496,502,149,146,89,27,671,334,337,105,104,77,27,0
64401,446,174,272,84,61,57,23,364,192,172,49,36,39,14,0
64402,1556,718,838,280,182,161,49,376,183,193,50,50,43,21,0
64403,162,73,89,32,19,4,4,633,311,322,94,82,45,20,0
64404,648,262,386,113,108,78,29,332,173,159,48,40,31,11,0
64405,238,91,147,68,19,22,7,245,121,124,37,35,36,12,0
64406,1960,875,1085,287,189,162,66,660,303,357,97,89,85,33,0
64407,1068,434,634,173,160,61,29,246,107,139,55,33,27,11,0
64408,526,228,298,69,64,32,30,462,229,233,63,49,42,18,0
64409,206,100,106,34,26,11,7,227,130,97,32,25,22,12,0
64410,361,183,178,50,54,51,22,402,186,216,64,47,38,20,0
64411,708,344,364,106,98,66,33,679,338,341,96,95,40,23,0
64412,451,278,173,71,35,58,12,87,38,49,23,10,10,9,0
64413,99,35,64,25,18,0,1,453,255,198,62,49,29,19,0
64414,292,102,190,71,27,51,21,724,353,371,94,95,71,31,0
64415,224,108,116,31,32,22,8,266,146,120,41,28,31,7,0
64416,469,221,248,49,60,55,21,142,73,69,27,9,15,11,0
64417,543,265,278,52,37,54,19,348,194,154,57,31,43,12,0
64418,297,161,136,36,35,24,9,370,190,180,60,52,37,13,0
64419,381,146,235,74,48,47,34,149,77,72,37,10,20,5,0
64420,452,202,250,83,60,56,19,225,111,114,32,34,32,16,0
64421,681,367,314,83,74,78,31,633,311,322,94,82,45,20,0
64422,264,122,142,33,29,13,13,295,156,139,41,40,42,15,0
64423,449,179,270,80,77,49,29,325,172,153,44,34,27,14,0
64424,349,131,218,66,76,22,9,130,67,63,24,10,12,4,0
64425,361,177,184,59,51,24,15,279,142,137,43,39,28,7,0
64426,107,53,54,15,15,13,4,295,156,139,41,40,42,15,0
64427,98,32,66,15,25,5,4,519,287,232,68,58,45,21,0
64428,2174,1057,1117,241,241,214,117,487,252,235,79,58,55,26,0
64429,258,126,132,38,22,29,8,474,268,206,66,42,45,24,0
64430,199,113,86,27,17,10,7,222,119,103,37,32,24,8,0
64431,314,178,136,42,32,30,17,400,187,213,56,59,42,20,0
64432,567,256,311,91,81,53,17,470,205,265,71,80,33,11,0
64433,164,81,83,37,8,14,10,252,130,122,45,23,32,11,0
64434,374,202,172,58,40,41,7,551,226,325,96,103,43,11,0
64435,502,229,273,63,66,40,31,925,439,486,141,134,105,46,0
64436,399,220,179,48,37,68,18,582,264,318,84,60,58,23,0
64437,358,206,152,45,38,67,16,393,210,183,58,37,34,20,0
64438,126,57,69,31,10,10,3,204,96,108,31,37,20,5,0
64439,479,227,252,69,48,46,18,142,65,77,30,17,22,9,0
64440,365,210,155,46,30,24,12,445,192,253,86,58,53,18,0
64441,431,216,215,46,40,33,9,376,189,187,47,53,44,26,0
64442,1341,481,860,275,264,57,21,65,32,33,16,4,8,3,0
64443,378,202,176,34,32,44,13,240,141,99,34,28,29,8,0
64444,496,209,287,113,55,72,14,926,425,501,159,147,77,35,0
64445,1709,650,1059,338,286,185,46,331,180,151,46,35,47,17,0
64446,648,262,386,113,108,78,29,471,238,233,66,63,62,19,0
64447,895,388,507,130,84,90,31,557,281,276,80,59,43,21,0
64448,240,166,74,32,12,8,15,507,270,237,89,59,57,22,0
64449,178,89,89,40,12,18,7,148,84,64,30,7,17,4,0
64450,320,183,137,51,18,38,8,385,188,197,57,42,36,16,0
64451,219,116,103,66,7,2,1,297,164,133,45,39,40,9,0
64452,1498,731,767,220,175,148,68,588,286,302,78,99,53,25,0
64453,1014,488,526,178,137,94,39,314,177,137,34,40,29,9,0
64454,4640,2231,2409,660,549,437,245,352,207,145,40,33,25,21,0
64455,1105,544,561,165,167,99,40,296,151,145,45,42,32,11,0
64456,292,102,190,71,27,51,21,276,149,127,34,31,32,10,0
64457,291,146,145,39,45,22,16,958,451,507,165,135,97,41,0
64458,557,211,346,129,125,48,19,332,180,152,44,36,27,13,0
64459,230,114,116,30,33,29,8,354,183,171,54,43,49,8,0
64460,490,224,266,80,70,39,32,430,212,218,88,43,40,20,0
64461,1124,442,682,148,189,72,43,410,197,213,67,43,56,18,0
64462,204,103,101,16,32,22,8,245,121,124,37,35,36,12,0
64463,267,146,121,40,24,25,7,344,190,154,34,31,36,10,0
64464,219,116,103,66,7,2,1,132,61,71,22,21,15,3,0
64465,760,405,355,112,95,92,29,294,146,148,50,45,51,15,0
64466,301,156,145,32,25,15,5,173,90,83,21,36,12,15,0
64467,341,177,164,57,42,40,18,261,127,134,36,27,36,4,0
64468,772,332,440,136,104,72,28,339,175,164,51,49,37,9,0
64469,782,372,410,127,111,89,36,741,383,358,92,63,79,36,0
64470,519,259,260,86,78,59,22,189,95,94,25,33,16,8,0
64471,452,202,250,83,60,56,19,251,143,108,47,25,29,11,0
64472,299,128,171,57,40,13,25,1020,538,482,145,115,111,58,0
64473,67,40,27,10,8,7,6,319,185,134,42,31,22,13,0
64474,410,209,201,72,30,48,22,1395,627,768,172,263,141,59,0
64475,785,351,434,136,93,71,37,1543,794,749,182,152,132,55,0
64476,425,199,226,54,71,56,11,943,463,480,91,144,70,30,0
64477,257,148,109,28,20,21,14,1537,701,836,209,187,129,58,0
64478,51,10,41,25,0,5,8,374,212,162,48,40,32,23,0
64479,2220,1085,1135,312,304,202,91,1922,923,999,267,275,215,90,0
64480,117,57,60,17,14,11,10,286,160,126,37,27,23,10,0
64481,143,81,62,28,9,8,1,374,181,193,55,58,48,23,0
64482,404,197,207,60,48,47,20,480,255,225,67,64,50,22,0
64483,416,207,209,63,47,56,15,663,360,303,87,82,80,35,0
64484,815,356,459,128,125,82,26,201,98,103,28,25,19,13,0
64485,215,117,98,28,19,15,8,201,117,83,22,21,19,9,0
64486,369,207,162,67,35,16,14,309,164,145,35,47,30,11,0
64487,475,208,267,84,67,50,20,501,240,261,80,62,49,42,0
64488,373,164,209,51,45,44,21,619,305,314,85,93,71,29,0
64489,1054,453,601,183,183,107,35,222,124,98,37,29,22,9,0
64490,202,113,89,16,27,21,11,72,32,40,8,2,2,13,0
64491,179,96,83,24,8,26,4,362,156,206,74,42,36,22,0
64492,361,167,194,55,35,41,11,332,173,159,48,40,31,11,0
64493,329,171,158,49,41,31,10,385,188,197,57,42,36,16,0
64494,128,67,61,29,9,9,1,434,213,221,77,62,53,12,0
64495,598,300,298,68,77,59,21,192,91,101,29,28,17,7,0
64496,758,378,380,89,64,37,31,390,223,167,58,36,45,18,0
64497,1835,904,931,192,144,135,63,363,180,183,60,34,10,6,0
64498,121,69,52,15,18,14,8,555,292,263,75,63,67,27,0
64499,836,370,466,126,96,72,30,2225,1244,981,271,243,217,93,0
64500,188,84,104,35,36,18,9,406,234,172,63,35,43,10,0
64501,431,216,215,46,40,33,9,127,58,69,18,17,10,5,0
64502,126,57,69,31,10,10,3,246,125,121,38,36,30,11,0
64503,458,226,232,77,59,61,14,1154,489,665,200,196,95,54,0
64504,330,151,179,68,36,56,9,392,214,178,48,40,53,22,0
64505,410,208,202,59,58,43,26,504,272,232,75,57,53,19,0
64506,146,73,73,18,24,17,9,68,36,32,11,8,9,2,0
64507,4640,2231,2409,660,549,437,245,290,147,143,34,34,39,13,0
64508,853,400,453,137,109,88,42,1352,602,750,166,185,81,70,0
64509,347,181,166,27,20,12,12,551,226,325,96,103,43,11,0
64510,394,207,187,52,42,37,24,204,96,108,31,37,20,5,0
64511,318,161,157,53,51,32,13,778,391,387,94,77,41,33,0
64512,919,444,475,141,148,62,20,370,190,180,60,52,37,13,0
64513,646,304,342,104,93,58,26,385,188,197,57,42,36,16,0
64514,249,104,145,47,41,24,17,536,251,285,75,79,60,23,0
64515,322,164,158,46,44,29,7,715,348,367,109,84,68,30,0
64516,162,73,89,32,19,4,4,2724,1157,1567,269,518,239,77,0
64517,732,355,377,108,109,79,27,283,160,123,25,20,37,9,0
64518,496,209,287,113,55,72,14,662,312,350,103,104,59,20,0
64519,325,181,144,46,31,48,9,464,236,228,64,56,53,28,0
64520,479,228,251,71,57,60,14,548,273,275,84,81,64,30,0
64521,927,457,470,130,99,118,42,620,324,296,81,68,66,31,0
64522,224,108,116,33,26,32,10,194,94,100,33,28,14,7,0
64523,760,405,355,112,95,92,29,323,162,161,52,41,39,13,0
64524,422,207,215,79,38,53,23,362,156,206,74,42,36,22,0
64525,420,189,231,79,67,33,17,763,418,345,113,84,59,32,0
64526,852,461,391,109,102,72,24,285,143,142,45,32,21,17,0
64527,710,352,358,104,86,84,41,138,69,69,28,7,10,10,0
64528,500,297,203,66,33,53,15,483,258,225,70,53,54,20,0
64529,772,332,440,136,104,72,28,556,290,266,75,74,29,24,0
64530,640,271,369,111,79,57,17,189,95,94,25,33,16,8,0
64531,1054,497,557,190,168,107,45,679,338,341,96,95,40,23,0
64532,275,160,115,40,31,34,17,131,55,76,28,9,14,12,0
64533,345,203,142,47,35,31,11,496,251,245,78,62,61,23,0
64534,136,66,70,33,11,9,5,783,406,377,102,91,57,29,0
64535,271,136,135,37,30,18,10,390,190,200,66,50,43,12,0
64536,222,108,114,37,20,25,12,386,207,179,43,48,44,19,0
64537,431,245,186,50,23,46,17,689,343,346,105,102,81,35,0
64538,525,302,223,56,48,67,19,297,164,133,45,39,40,9,0
64539,454,230,224,63,56,38,33,242,124,118,39,32,28,22,0
64540,651,357,294,81,67,103,18,2346,1231,1115,316,292,266,105,0
64541,224,101,123,45,32,21,3,317,161,156,50,36,47,12,0
64542,508,136,372,157,91,22,9,479,215,264,67,80,46,28,0
64543,109,42,67,25,13,1,1,538,274,264,84,67,52,35,0
64544,953,421,532,131,131,70,37,622,344,278,80,77,68,36,0
64545,911,445,466,154,121,108,48,285,143,142,45,32,21,17,0
64546,563,255,308,91,111,42,30,194,94,100,33,28,14,7,0
64547,272,141,131,45,29,36,9,507,270,237,89,59,57,22,0
64548,399,196,203,62,45,38,19,96,45,51,13,12,6,4,0
64549,928,442,486,139,118,91,43,319,185,134,42,31,22,13,0
64550,360,205,155,35,24,52,14,136,65,71,26,11,7,5,0
64551,510,288,222,44,36,24,7,105,51,54,13,17,12,8,0
64552,146,75,71,13,32,15,11,621,273,348,104,102,48,19,0
64553,258,126,132,38,22,29,8,336,200,136,34,29,25,24,0
64554,472,222,250,46,61,33,23,583,280,303,95,66,76,25,0
64555,260,138,122,44,30,28,6,509,267,242,79,81,38,20,0
64556,283,112,171,48,39,34,15,200,99,101,31,24,26,6,0
64557,317,167,150,45,21,30,26,147,74,73,28,20,24,4,0
64558,1085,646,439,108,65,36,19,866,478,388,121,101,101,26,0
64559,653,379,274,89,56,86,13,1382,508,874,334,320,98,36,0
64560,520,240,280,67,72,42,14,559,317,242,58,65,37,23,0
64561,251,139,112,41,18,27,11,384,204,180,53,47,49,17,0
64562,520,240,280,87,63,67,16,662,312,350,103,104,59,20,0
64563,301,157,144,31,28,34,9,207,113,94,33,18,30,9,0
64564,496,210,286,112,55,71,14,205,94,111,48,31,15,6,0
64565,429,227,202,49,51,46,26,218,115,103,32,32,34,11,0
64566,484,194,290,70,93,47,16,297,164,133,45,39,40,9,0
64567,360,175,185,73,36,27,7,594,312,282,72,67,73,31,0
64568,358,212,146,51,36,33,9,201,98,103,28,25,19,13,0
64569,1501,679,822,251,196,174,67,198,115,83,30,22,8,8,0
64570,149,68,81,15,38,11,10,119,67,52,15,15,7,7,0
64571,1199,589,610,189,128,167,65,2382,1162,1220,237,220,140,49,0
64572,439,241,198,67,40,40,13,274,142,132,33,34,18,14,0
64573,246,111,135,64,47,27,3,535,311,224,66,52,49,24,0
64574,1054,453,601,183,183,107,35,900,441,459,125,127,110,32,0
64575,439,205,234,64,88,41,21,316,159,157,38,48,30,11,0
64576,567,256,311,91,81,53,17,316,159,157,38,48,30,11,0
64577,449,179,270,80,77,49,29,72,33,39,8,2,3,12,0
64578,1505,680,825,202,204,73,32,289,140,149,33,42,30,15,0
64579,130,70,60,30,9,8,1,660,303,357,97,89,85,33,0
64580,517,196,321,103,98,33,12,375,210,165,49,37,29,27,0
64581,1007,353,654,277,147,70,26,583,280,303,95,66,76,25,0
64582,535,315,220,57,55,71,19,501,274,227,63,58,53,20,0
64583,1052,492,560,184,163,103,44,497,227,270,70,63,66,30,0
64584,594,321,273,98,59,57,23,199,92,107,34,30,18,9,0
64585,330,77,253,86,52,20,12,370,190,180,60,52,37,13,0
64586,677,361,316,81,61,42,22,858,398,460,126,138,75,39,0
64587,270,128,142,36,43,15,11,414,203,211,58,56,48,14,0
64588,264,122,142,33,29,13,13,1034,495,539,150,134,114,71,0
64589,862,384,478,127,110,75,42,322,180,142,45,38,28,7,0
64590,2488,1085,1403,346,253,162,76,91,42,49,21,9,8,3,0
64591,519,245,274,58,61,34,22,106,46,60,29,13,14,5,0
64592,144,57,87,38,26,10,4,230,113,117,31,40,28,10,0
64593,410,208,202,59,58,43,26,727,362,365,123,107,63,23,0
64594,928,442,486,139,118,91,43,467,226,241,55,48,54,23,0
64595,217,98,119,38,35,18,9,1323,690,633,132,178,112,61,0
64596,554,217,337,112,72,90,38,724,353,371,94,95,71,31,0
64597,76,42,34,12,8,5,7,775,407,368,122,100,97,32,0
64598,170,82,88,32,23,22,8,107,77,30,7,2,9,5,0
64599,126,56,70,31,10,10,3,455,191,264,68,86,21,19,0
64600,624,222,402,92,81,39,15,1500,804,696,190,172,144,60,0
64601,423,247,176,58,55,29,20,858,461,397,125,114,79,45,0
64602,369,166,203,59,55,41,14,215,115,100,27,19,16,7,0
64603,340,145,195,46,38,26,23,103,50,53,19,10,7,5,0
64604,338,173,165,31,42,22,10,87,51,35,15,9,9,4,0
64605,372,189,183,60,44,41,18,671,321,350,95,87,75,34,0
64606,341,175,166,48,43,35,18,514,248,266,86,82,52,22,0
64607,436,201,235,54,37,35,18,866,397,469,117,153,95,48,0
64608,588,300,288,100,57,65,27,251,143,108,47,25,29,11,0
64609,160,53,107,31,29,13,3,406,202,204,54,51,63,21,0
64610,427,191,236,67,60,41,34,65,32,33,16,4,8,3,0
64611,411,171,240,61,81,30,15,204,80,124,29,51,10,5,0
64612,222,108,114,37,20,25,12,245,121,124,37,35,36,12,0
64613,734,339,395,135,89,78,36,386,207,179,43,48,44,19,0
64614,227,109,118,42,35,29,8,279,142,137,43,39,28,7,0
64615,347,212,135,35,32,17,6,73,35,38,14,10,9,4,0
64616,444,250,194,58,21,60,23,463,259,204,62,55,34,22,0
64617,159,105,54,22,9,14,25,172,88,84,24,31,20,12,0
64618,269,156,113,37,32,17,7,406,234,172,63,35,43,10,0
64619,199,107,92,41,15,14,8,380,178,202,69,53,37,10,0
64620,752,313,439,121,106,68,27,374,202,172,50,39,31,24,0
64621,536,237,299,116,87,42,17,87,38,49,23,10,10,9,0
64622,567,266,301,139,46,76,37,1182,591,591,155,139,83,46,0
64623,949,466,483,125,126,101,50,898,469,429,125,125,134,35,0
64624,199,113,86,27,17,10,7,391,189,202,55,56,56,12,0
64625,282,135,147,27,37,30,19,317,161,156,50,36,47,12,0
64626,2624,999,1625,415,495,109,84,104,46,58,15,17,9,5,0
64627,426,213,213,60,56,46,24,538,274,264,84,67,52,35,0
64628,243,70,173,54,65,8,6,368,204,164,43,35,30,24,0
64629,557,250,307,70,47,51,22,392,186,206,62,56,29,15,0
64630,139,64,75,18,17,18,4,292,155,137,50,34,29,13,0
64631,326,176,150,35,22,29,11,449,252,197,61,52,36,18,0
64632,447,225,222,76,35,75,21,294,146,148,50,45,51,15,0
64633,126,58,68,31,10,10,3,392,214,178,48,40,53,22,0
64634,375,201,174,52,56,39,15,1001,417,584,186,147,96,47,0
64635,301,157,144,31,28,34,9,601,278,323,124,87,65,21,0
64636,1199,589,610,189,128,167,65,368,204,164,43,35,30,24,0
64637,535,315,220,57,55,71,19,200,99,101,31,24,26,6,0
64638,639,368,271,72,51,38,38,434,213,221,77,62,53,12,0
64639,471,221,250,87,68,42,25,137,78,59,22,16,17,4,0
64640,524,270,254,84,72,70,23,457,242,215,39,46,53,10,0
64641,206,96,110,33,25,8,6,225,129,96,32,33,20,8,0
64642,588,317,271,78,49,54,17,198,113,85,19,20,26,12,0
64643,369,207,162,67,35,16,14,300,148,152,45,43,40,8,0
64644,480,232,248,73,40,44,30,264,138,126,33,34,29,12,0
64645,758,378,380,89,64,37,31,403,225,178,56,38,33,25,0
64646,338,208,130,39,30,35,12,737,397,340,87,104,90,14,0
64647,330,141,189,65,29,51,19,509,267,242,79,81,38,20,0
64648,626,308,318,105,89,77,25,773,389,384,119,91,79,26,0
64649,180,57,123,39,22,10,8,194,106,88,33,10,15,6,0
64650,199,113,86,27,17,10,7,160,60,100,23,40,19,11,0
64651,433,188,245,63,45,26,14,470,205,265,71,80,33,11,0
64652,123,58,65,22,14,13,3,201,117,83,22,21,19,9,0
64653,136,65,71,33,11,9,6,87,51,35,15,9,9,4,0
64654,443,250,193,52,23,49,13,339,180,159,36,29,16,16,0
64655,449,179,270,80,77,49,29,1382,508,874,334,320,98,36,0
64656,233,110,123,34,22,34,9,178,99,79,31,19,26,8,0
64657,772,383,389,105,76,82,33,689,343,346,105,102,81,35,0
64658,256,152,104,18,23,23,8,153,65,88,28,21,20,8,0
64659,234,110,124,39,29,23,2,366,204,162,47,41,31,23,0
64660,349,131,218,66,76,22,9,296,159,137,49,28,38,13,0
64661,360,175,185,73,36,27,7,346,196,150,43,26,27,14,0
64662,331,177,154,54,38,27,11,904,436,468,143,118,108,32,0
64663,557,250,307,70,47,51,22,306,157,149,52,35,39,16,0
64664,753,361,392,99,94,66,16,520,240,280,67,72,42,14,0
64665,150,60,90,27,16,6,3,501,257,244,75,57,48,29,0
64666,722,390,332,125,69,67,25,720,361,359,98,98,70,37,0
64667,607,294,313,94,95,62,14,381,187,194,37,49,36,17,0
64668,852,461,391,109,102,72,24,387,193,194,60,53,57,15,0
64669,410,188,222,53,52,31,14,966,478,488,108,144,74,43,0
64670,339,170,169,32,17,24,13,1113,480,633,170,173,81,34,0
64671,329,165,164,61,44,29,17,415,205,210,77,52,55,17,0
64672,392,221,171,53,30,25,8,390,190,200,66,50,43,12,0
64673,264,122,142,46,24,35,10,469,225,244,64,68,25,11,0
64674,949,467,482,126,127,102,51,514,262,252,78,58,54,26,0
64675,580,240,340,108,81,59,22,360,185,175,51,43,36,16,0
64676,406,207,199,56,46,68,19,572,305,267,74,72,58,21,0
64677,126,56,70,31,10,10,3,972,471,501,152,138,112,40,0
64678,478,177,301,109,66,59,25,1004,457,547,150,150,74,52,0
64679,517,196,321,103,98,33,12,1265,689,576,169,177,128,60,0
64680,682,292,390,89,69,58,20,326,149,177,51,51,28,10,0
64681,682,260,422,153,78,109,46,526,266,260,76,75,53,22,0
64682,2286,1154,1132,338,314,278,103,346,178,168,58,41,33,12,0
64683,531,260,271,97,68,47,11,381,186,195,69,55,46,15,0
64684,431,199,232,59,54,40,17,134,72,62,14,28,8,4,0
64685,170,82,88,32,23,22,8,2724,1157,1567,269,518,239,77,0
64686,584,297,287,89,80,65,17,296,140,156,49,40,42,19,0
64687,747,360,387,125,92,69,32,350,196,154,52,37,21,14,0
64688,490,198,292,65,81,39,27,169,84,85,29,19,21,7,0
64689,176,74,102,20,29,7,7,483,215,268,66,70,30,16,0
64690,326,148,178,55,42,31,12,633,311,322,94,82,45,20,0
64691,202,103,99,28,20,12,8,622,344,278,80,77,68,36,0
64692,2063,1024,1039,175,117,80,97,579,285,294,78,72,64,32,0
64693,329,168,161,48,34,41,16,395,198,197,55,55,36,10,0
64694,334,155,179,47,34,38,11,403,185,218,67,62,63,19,0
64695,414,216,198,51,32,42,28,86,40,46,16,13,9,7,0
64696,2220,1085,1135,312,304,202,91,452,254,198,72,57,38,18,0
64697,493,281,212,56,61,30,13,160,76,84,19,24,8,5,0
64698,426,214,212,63,47,53,20,449,252,197,61,52,36,18,0
64699,457,261,196,55,27,57,34,862,426,436,113,115,84,37,0
64700,604,239,365,124,63,84,37,609,335,274,79,57,45,22,0
64701,126,56,70,31,10,10,3,375,209,166,50,37,29,23,0
64702,708,344,364,106,98,66,33,225,111,114,32,34,32,16,0
64703,136,65,71,33,11,9,6,377,184,193,50,43,33,17,0
64704,1464,693,771,153,136,91,86,410,197,213,67,43,56,18,0
64705,180,92,88,29,20,26,8,701,380,321,94,84,96,34,0
64706,330,151,179,68,36,56,9,662,373,289,89,80,77,29,0
64707,470,163,307,99,68,73,30,160,60,100,23,40,19,11,0
64708,244,104,140,52,31,30,14,68,36,32,11,8,9,2,0
64709,648,262,386,113,108,78,29,135,57,78,21,20,9,11,0
64710,232,134,98,28,20,20,5,164,79,85,28,28,16,7,0
64711,401,183,218,72,73,28,10,260,131,129,42,31,40,9,0
64712,1284,511,773,227,166,169,107,323,171,152,48,41,40,16,0
64713,417,176,241,75,61,51,20,496,285,211,62,54,46,22,0
64714,341,175,166,48,43,35,18,390,190,200,66,50,43,12,0
64715,420,202,218,67,43,51,15,172,79,93,34,27,23,10,0
64716,520,231,289,89,59,58,26,260,133,127,43,32,39,3,0
64717,270,128,142,36,43,15,11,496,285,211,62,54,46,22,0
64718,786,378,408,106,98,77,39,818,357,461,122,136,54,25,0
64719,176,74,102,20,29,7,7,289,140,149,33,42,30,15,0
64720,2649,1431,1218,377,299,266,102,222,119,103,37,32,24,8,0
64721,162,73,89,32,19,4,4,323,168,155,51,41,38,12,0
64722,2663,1073,1590,548,499,192,64,447,212,235,86,55,58,21,0
64723,381,187,194,37,49,36,17,391,165,226,67,64,36,27,0
64724,146,73,73,18,24,17,9,359,171,188,49,74,45,11,0
64725,1112,457,655,180,164,99,39,724,353,371,94,95,71,31,0
64726,419,210,209,54,44,31,23,385,212,173,57,40,39,21,0
64727,366,190,176,39,62,55,14,171,94,77,24,28,30,11,0
64728,795,384,411,133,109,85,38,671,321,350,95,87,75,34,0
64729,361,183,178,50,54,51,22,548,296,252,71,74,43,28,0
64730,540,252,288,73,67,57,20,148,69,79,26,18,16,3,0
64731,461,207,254,82,66,55,33,2542,1245,1297,285,287,170,84,0
64732,432,233,199,52,28,47,18,266,146,120,41,28,31,7,0
64733,285,148,137,31,42,42,16,153,65,88,28,21,20,8,0
64734,2000,965,1035,357,313,198,75,773,389,384,119,91,79,26,0
64735,129,70,59,29,9,7,2,661,325,336,81,75,65,28,0
64736,785,325,460,114,123,61,28,810,310,500,164,162,42,26,0
64737,636,288,348,94,77,65,30,133,61,72,21,19,13,4,0
64738,273,126,147,54,49,25,18,111,60,51,17,23,10,7,0
64739,474,243,231,66,54,41,29,222,122,100,39,32,24,9,0
64740,213,114,99,62,7,2,1,72,33,39,8,2,3,12,0
64741,869,489,380,110,77,79,29,1239,659,580,169,148,131,54,0
64742,179,78,101,29,22,10,8,405,214,191,53,42,49,20,0
64743,310,141,169,36,38,20,8,265,134,131,48,34,33,15,0
64744,516,210,306,113,53,81,33,462,229,233,63,49,42,18,0
64745,413,236,177,41,25,35,19,199,105,94,27,27,28,9,0
64746,305,124,181,27,25,32,21,264,138,126,33,34,29,12,0
64747,193,110,83,18,20,15,12,715,348,367,109,84,68,30,0
64748,284,128,156,48,29,34,8,464,236,228,64,56,53,28,0
64749,900,434,466,134,97,86,36,218,117,101,35,32,34,12,0
64750,575,305,270,74,87,73,25,339,180,159,36,29,16,16,0
64751,463,225,238,76,36,59,26,205,94,111,48,31,15,6,0
64752,338,208,130,39,30,35,12,1262,653,609,169,165,152,50,0
64753,798,287,511,126,125,77,26,180,95,85,22,21,17,8,0
64754,1590,726,864,270,237,126,59,1425,670,755,153,189,122,85,0
64755,245,111,134,36,27,18,6,309,164,145,35,47,30,11,0
64756,341,195,146,42,21,36,9,408,221,187,55,51,57,14,0
64757,820,333,487,202,152,59,23,319,185,134,42,31,22,13,0
64758,2414,1189,1225,277,178,170,169,314,151,163,42,61,39,16,0
64759,1390,705,685,219,164,129,74,737,397,340,87,104,90,14,0
64760,1960,875,1085,287,189,162,66,328,195,133,39,40,27,13,0
64761,1030,567,463,118,106,94,49,605,283,322,94,72,64,39,0
64762,529,290,239,54,63,85,15,212,127,85,28,21,26,6,0
64763,933,456,477,123,108,83,29,720,361,359,98,98,70,37,0
64764,1085,646,439,108,65,36,19,137,72,65,27,13,15,8,0
64765,228,82,146,45,37,18,8,368,204,164,43,35,30,24,0
64766,3859,2011,1848,535,391,422,207,350,196,154,52,37,21,14,0
64767,2446,1099,1347,363,294,233,100,276,149,127,34,31,32,10,0
64768,221,80,141,48,37,14,10,295,160,135,42,37,46,16,0
64769,347,181,166,27,20,12,12,65,32,33,16,4,8,3,0
64770,546,285,261,71,49,47,24,128,63,65,30,11,13,8,0
64771,529,290,239,54,63,85,15,106,41,65,36,6,11,7,0
64772,422,207,215,79,38,53,23,360,180,180,57,48,39,12,0
64773,397,180,217,61,59,39,13,457,245,212,62,58,57,21,0
64774,435,225,210,58,46,50,14,663,360,303,87,82,80,35,0
64775,306,172,134,35,31,37,18,131,55,76,28,9,14,12,0
64776,794,322,472,122,108,79,34,317,161,156,40,49,41,11,0
64777,241,122,119,27,34,17,16,381,187,194,37,49,36,17,0
64778,329,165,164,61,44,29,17,198,113,85,19,20,26,12,0
64779,1047,443,604,162,156,78,52,201,93,108,34,39,21,6,0
64780,517,245,272,92,77,46,24,201,99,102,34,26,23,6,0
64781,441,216,225,57,66,57,19,471,238,233,66,63,62,19,0
64782,2236,1195,1041,227,187,186,118,129,60,69,21,15,8,5,0
64783,461,207,254,82,66,55,33,649,307,342,71,134,45,17,0
64784,604,239,365,124,63,84,37,673,313,360,102,101,46,17,0
64785,2109,999,1110,332,294,187,89,307,132,175,48,53,26,10,0
64786,510,269,241,66,67,71,26,320,168,152,38,42,24,18,0
64787,1544,738,806,239,217,145,91,229,120,109,31,30,22,9,0
64788,188,84,104,35,36,18,9,471,238,233,66,63,62,19,0
64789,562,214,348,120,86,69,42,225,111,114,32,34,32,16,0
64790,3230,1724,1506,361,358,157,75,207,113,94,33,18,30,9,0
64791,452,217,235,59,47,60,20,1696,771,925,257,225,149,63,0
64792,1051,429,622,179,148,125,54,198,110,88,27,27,24,4,0
64793,639,368,271,72,51,38,38,147,74,73,28,20,24,4,0
64794,2236,1195,1041,227,187,186,118,198,115,83,30,22,8,8,0
64795,458,210,248,39,38,25,16,597,300,297,96,89,68,29,0
64796,2062,706,1356,414,368,158,63,758,319,439,101,123,78,25,0
64797,413,206,207,38,55,19,10,309,159,150,47,43,43,13,0
64798,674,268,406,118,96,70,21,166,78,88,27,25,19,7,0
64799,346,174,172,36,43,21,9,147,74,73,28,20,24,4,0
64800,224,108,116,31,32,22,8,218,118,100,33,30,25,11,0
64801,651,357,294,81,67,103,18,621,273,348,104,102,48,19,0
64802,886,440,446,116,140,95,45,741,383,358,92,63,79,36,0
64803,412,193,219,69,57,43,14,172,79,93,34,27,23,10,0
64804,428,226,202,52,60,75,20,261,127,134,36,27,36,4,0
64805,232,134,98,28,20,20,5,286,152,134,38,38,32,11,0
64806,789,362,427,90,82,70,35,222,127,95,23,28,22,7,0
64807,479,227,252,69,48,46,18,483,287,196,71,50,54,17,0
64808,310,141,169,36,38,20,8,295,158,137,42,34,38,14,0
64809,193,90,103,44,9,19,13,898,469,429,125,125,134,35,0
64810,840,411,429,122,101,79,34,548,273,275,84,81,64,30,0
64811,380,187,193,38,51,30,18,292,143,149,38,42,36,16,0
64812,129,70,59,29,9,7,2,662,312,350,103,104,59,20,0
64813,453,240,213,53,33,44,16,139,68,71,14,26,14,9,0
64814,388,244,144,46,25,42,16,323,171,152,48,41,40,16,0
64815,437,212,225,66,44,44,11,392,186,206,62,56,29,15,0
64816,808,366,442,130,133,66,31,346,178,168,58,41,33,12,0
64817,432,233,199,52,28,47,18,866,478,388,121,101,101,26,0
64818,904,436,468,138,146,82,39,348,194,154,57,31,43,12,0
64819,575,305,270,74,87,73,25,367,199,168,62,44,34,8,0
64820,272,94,178,76,33,19,4,441,189,252,73,50,47,23,0
64821,575,295,280,89,68,54,18,205,94,111,48,31,15,6,0
64822,956,450,506,122,117,82,36,260,133,127,43,32,39,3,0
64823,1023,449,574,141,174,76,43,715,348,367,109,84,68,30,0
64824,605,277,328,99,54,63,43,180,90,90,31,19,20,8,0
64825,531,284,247,66,42,49,15,1040,564,476,134,110,114,51,0
64826,412,146,266,106,38,67,35,663,354,309,91,84,79,31,0
64827,349,153,196,54,47,28,13,519,287,232,68,58,45,21,0
64828,528,188,340,130,58,77,41,173,90,83,30,19,19,11,0
64829,577,251,326,92,84,60,11,711,330,381,111,86,86,34,0
64830,630,231,399,150,83,84,50,148,84,64,30,7,17,4,0
64831,482,245,237,69,64,66,24,306,157,149,52,35,39,16,0
64832,371,143,228,77,48,29,26,588,286,302,78,99,53,25,0
64833,311,154,157,47,29,34,13,317,161,156,40,49,41,11,0
64834,539,283,256,75,73,53,26,188,105,83,25,17,24,7,0
64835,1124,442,682,148,189,72,43,773,389,384,119,91,79,26,0
64836,407,164,243,88,42,40,22,902,499,403,118,117,92,35,0
64837,348,198,150,57,25,37,18,188,93,95,33,18,16,10,0
64838,895,388,507,130,84,90,31,689,343,346,105,102,81,35,0
64839,625,283,342,93,89,67,25,305,163,142,38,27,47,11,0
64840,520,240,280,87,63,67,16,445,202,243,70,73,51,15,0
64841,521,249,272,53,36,50,18,843,391,452,139,104,91,35,0
64842,682,292,390,89,69,58,20,469,225,244,64,68,25,11,0
64843,773,383,390,108,76,79,30,160,60,100,23,40,19,11,0
64844,435,222,213,67,49,67,12,283,142,141,41,33,26,18,0
64845,261,126,135,41,36,24,11,337,152,185,49,54,42,21,0
64846,465,305,160,40,47,34,9,142,73,69,27,9,15,11,0
64847,428,248,180,44,39,28,9,190,93,97,35,27,23,2,0
64848,102,22,80,48,8,18,6,241,127,114,34,33,29,12,0
64849,438,185,253,71,64,52,28,392,155,237,68,61,34,16,0
64850,548,310,238,72,62,54,13,189,105,84,25,26,21,9,0
64851,510,288,222,44,36,24,7,445,264,181,35,35,34,14,0
64852,505,247,258,72,71,60,27,445,192,253,86,58,53,18,0
64853,461,207,254,82,66,55,33,1425,670,755,153,189,122,85,0
64854,401,183,218,72,73,28,10,744,385,359,105,96,57,31,0
64855,270,130,140,43,24,36,10,308,146,162,42,39,24,12,0
64856,297,161,136,36,35,24,9,727,362,365,123,107,63,23,0
64857,803,358,445,135,117,80,43,1001,417,584,186,147,96,47,0
64858,180,92,88,29,20,26,8,474,268,206,66,42,45,24,0
64859,649,304,345,99,80,67,40,400,187,213,56,59,42,20,0
64860,423,247,176,58,55,29,20,975,475,500,139,140,119,28,0
64861,1009,478,531,166,126,96,42,464,236,228,64,56,53,28,0
64862,615,308,307,83,75,58,32,373,189,184,54,46,50,23,0
64863,298,141,157,51,33,21,22,821,394,427,122,117,109,38,0
64864,281,154,127,45,31,24,9,654,295,359,99,88,71,25,0
64865,376,176,200,31,53,27,8,277,138,139,40,39,20,14,0
64866,503,260,243,46,56,33,16,761,351,410,117,73,103,45,0
64867,146,73,73,18,24,17,9,247,128,119,34,14,16,14,0
64868,447,236,211,56,52,49,14,478,254,224,67,74,56,28,0
64869,401,183,218,72,73,28,10,332,180,152,46,36,28,14,0
64870,915,336,579,185,199,56,29,89,37,52,13,6,2,9,0
64871,420,248,172,64,30,43,17,201,98,103,28,25,19,13,0
64872,852,472,380,99,79,70,27,633,311,322,94,82,45,20,0
64873,557,211,346,129,125,48,19,723,363,360,107,106,52,14,0
64874,428,226,202,52,60,75,20,247,128,119,34,14,16,14,0
64875,368,201,167,61,38,38,12,483,287,196,71,50,54,17,0
64876,371,209,162,46,17,36,19,312,165,147,41,39,29,16,0
64877,228,82,146,45,37,18,8,925,439,486,141,134,105,46,0
64878,485,246,239,74,48,47,22,204,96,108,31,37,20,5,0
64879,2285,1219,1066,207,180,178,106,459,260,199,56,42,47,21,0
64880,682,260,422,98,83,42,31,811,361,450,124,107,80,31,0
64881,98,32,66,15,25,5,4,396,223,173,57,37,44,19,0
64882,282,163,119,40,23,25,17,96,46,50,16,12,7,5,0
64883,462,228,234,59,47,37,32,427,251,176,51,39,25,22,0
64884,773,383,390,108,76,79,30,664,350,314,86,90,82,36,0
64885,204,109,95,21,35,27,7,798,385,413,120,115,79,30,0
64886,181,75,106,35,26,11,9,153,80,73,26,18,19,4,0
64887,237,127,110,34,30,16,9,196,105,91,40,13,19,10,0
64888,616,323,293,98,71,31,15,418,246,172,52,39,57,10,0
64889,346,168,178,36,43,20,9,1214,475,739,177,250,89,49,0
64890,149,78,71,20,20,19,5,165,87,78,24,19,22,9,0
64891,136,66,70,33,11,9,3,467,240,227,65,65,51,23,0
64892,102,22,80,48,8,18,6,708,328,380,113,100,82,34,0
64893,368,154,214,80,52,41,16,1395,627,768,172,263,141,59,0
64894,983,449,534,95,77,55,36,461,223,238,45,62,18,35,0
64895,213,114,99,62,7,2,1,470,205,265,71,80,33,11,0
64896,270,130,140,43,24,36,10,4646,2328,2318,674,639,475,170,0
64897,258,130,128,44,37,29,10,660,303,357,97,89,85,33,0
64898,326,176,150,35,22,29,11,94,45,49,11,20,10,4,0
64899,431,216,215,46,40,33,9,406,223,183,61,53,46,17,0
64900,325,186,139,49,36,20,5,464,236,228,64,56,53,28,0
64901,493,208,285,75,77,70,40,617,314,303,96,68,68,37,0
64902,461,207,254,82,66,55,33,173,90,83,21,36,12,15,0
64903,184,88,96,15,40,17,8,338,169,169,53,44,39,21,0
64904,687,351,336,106,67,70,41,818,357,461,122,136,54,25,0
64905,785,351,434,136,93,71,37,354,188,166,46,40,34,10,0
64906,404,197,207,60,48,47,20,201,93,108,34,39,21,6,0
64907,125,53,72,18,21,18,12,545,269,276,80,76,27,32,0
64908,619,289,330,67,77,36,19,218,114,104,32,31,33,11,0
64909,232,134,98,28,20,20,5,326,149,177,51,51,28,10,0
64910,347,181,166,27,20,12,12,201,104,97,36,32,24,7,0
64911,334,190,144,42,42,16,5,579,285,294,78,72,64,32,0
64912,519,245,274,58,61,34,22,418,223,195,51,45,49,14,0
64913,314,158,156,39,28,30,17,2225,1244,981,271,243,217,93,0
64914,407,230,177,44,39,34,19,732,402,330,81,86,87,33,0
64915,1214,612,602,169,173,98,35,244,143,101,31,29,26,8,0
64916,496,272,224,70,58,42,18,497,257,240,71,63,62,16,0
64917,508,267,241,43,35,25,17,103,50,53,19,10,7,5,0
64918,180,57,123,39,22,10,8,285,146,139,41,41,48,13,0
64919,2236,1195,1041,227,187,186,118,445,264,181,35,35,34,14,0
64920,107,56,51,18,16,12,5,309,159,150,47,43,43,13,0
64921,933,456,477,123,108,83,29,413,223,190,52,45,53,10,0
64922,117,58,59,17,17,12,2,720,361,359,98,98,70,37,0
64923,476,199,277,82,80,49,24,381,196,185,55,57,43,16,0
64924,412,208,204,54,47,42,17,621,310,311,100,106,77,27,0
64925,2062,706,1356,414,368,158,63,307,132,175,48,53,26,10,0
64926,745,402,343,95,71,69,40,144,67,77,28,14,9,8,0
64927,492,253,239,73,67,77,29,260,131,129,42,31,40,9,0
64928,282,84,198,60,102,1,6,452,254,198,72,57,38,18,0
64929,257,148,109,28,20,21,14,290,142,148,41,37,43,11,0
64930,559,217,342,105,86,42,16,354,183,171,54,43,49,8,0
64931,395,195,200,41,55,23,10,1696,771,925,257,225,149,63,0
64932,55,16,39,24,2,5,2,464,236,228,64,56,53,28,0
64933,344,109,235,100,39,26,5,135,65,70,21,25,15,9,0
64934,320,183,137,51,18,38,8,250,119,131,58,26,29,7,0
64935,1339,494,845,216,298,92,37,492,278,214,65,58,32,11,0
64936,297,182,115,41,22,23,8,330,166,164,55,51,36,16,0
64937,439,183,256,60,64,36,14,621,310,311,100,106,77,27,0
64938,1441,504,937,264,329,69,46,1606,753,853,215,227,182,48,0
64939,963,477,486,134,143,123,38,1040,564,476,134,110,114,51,0
64940,653,379,274,89,56,86,13,297,164,133,45,39,40,9,0
64941,438,185,253,71,64,52,28,286,160,126,37,27,23,10,0
64942,424,170,254,69,56,47,28,266,150,116,28,28,24,12,0
64943,279,129,150,43,34,17,13,337,152,185,49,54,42,21,0
64944,540,252,288,73,67,57,20,89,37,52,13,6,2,9,0
64945,172,82,90,21,35,21,5,296,159,137,49,28,38,13,0
64946,437,167,270,126,95,34,10,225,111,114,32,34,32,16,0
64947,636,288,348,94,77,65,30,277,152,125,31,35,22,19,0
64948,711,330,381,111,86,86,34,975,400,575,160,162,62,31,0
64949,330,182,148,47,27,40,11,403,225,178,56,38,33,25,0
64950,358,206,152,45,38,67,16,397,223,174,50,39,29,17,0
64951,250,123,127,40,28,29,8,148,84,64,30,7,17,4,0
64952,435,222,213,67,49,67,12,204,80,124,29,51,10,5,0
64953,782,372,410,127,111,89,36,381,186,195,69,55,46,15,0
64954,334,155,179,47,34,38,11,2517,1275,1242,304,324,245,135,0
64955,368,154,214,80,52,41,16,778,391,387,94,77,41,33,0
64956,221,75,146,68,21,16,5,135,57,78,21,20,9,11,0
64957,417,176,241,75,61,51,20,242,124,118,39,32,28,22,0
64958,586,298,288,80,75,64,37,756,348,408,101,103,60,40,0
64959,520,240,280,87,63,67,16,609,335,274,79,57,45,22,0
64960,76,30,46,7,15,1,5,469,225,244,64,68,25,11,0
64961,500,257,243,60,55,27,22,723,353,370,120,109,96,33,0
64962,403,176,227,71,56,51,11,404,190,214,55,55,35,27,0
64963,439,241,198,67,40,40,13,391,189,202,55,56,56,12,0
64964,406,208,198,41,26,43,21,429,187,242,79,72,28,19,0
64965,714,260,454,140,97,120,54,926,340,586,133,119,60,40,0
64966,466,259,207,59,50,83,12,482,232,250,77,81,44,13,0
64967,292,102,190,71,27,51,21,609,335,274,79,57,45,22,0
64968,594,248,346,104,109,53,5,348,194,154,57,31,43,12,0
64969,391,203,188,49,34,36,9,87,51,35,15,9,9,4,0
64970,786,378,408,106,98,77,39,335,170,165,52,36,47,11,0
64971,395,219,176,47,41,50,18,415,205,210,77,52,55,17,0
64972,243,114,129,37,30,32,8,396,199,197,54,50,45,14,0
64973,546,285,261,71,49,47,24,1182,591,591,155,139,83,46,0
64974,732,355,377,108,109,79,27,405,181,224,71,57,31,12,0
64975,575,305,270,74,87,73,25,287,151,136,51,42,36,7,0
64976,853,400,453,137,109,88,42,129,60,69,21,15,8,5,0
64977,213,114,99,62,7,2,1,862,409,453,149,125,86,29,0
64978,562,214,348,120,86,69,42,811,361,450,124,107,80,31,0
64979,358,212,146,51,36,33,9,124,69,55,14,7,9,4,0
64980,469,221,248,49,60,55,21,88,50,38,13,8,16,4,0
64981,894,448,446,123,100,82,30,723,363,360,107,106,52,14,0
64982,517,196,321,103,98,33,12,437,221,216,62,64,47,13,0
64983,119,67,52,15,15,7,7,385,212,173,57,40,39,21,0
64984,258,130,128,44,37,29,10,447,212,235,86,55,58,21,0
64985,204,109,95,21,35,27,7,445,264,181,35,35,34,14,0
64986,135,64,71,31,11,8,4,588,286,302,78,99,53,25,0
64987,220,121,99,28,26,17,6,1321,653,668,186,195,70,35,0
64988,594,321,273,98,59,57,23,461,223,238,45,62,18,35,0
64989,418,163,255,57,54,38,24,535,301,234,63,48,47,27,0
64990,643,284,359,129,71,84,43,1378,692,686,194,174,105,56,0
64991,431,245,186,50,23,46,17,1698,875,823,222,219,173,64,0
64992,412,208,204,54,47,42,17,374,202,172,50,39,31,24,0
64993,380,148,232,81,69,24,8,218,117,101,35,32,34,12,0
64994,178,89,89,40,12,18,7,693,360,333,100,88,62,26,0
64995,736,320,416,113,97,61,36,384,212,172,44,43,34,14,0
64996,403,176,227,71,56,51,11,778,391,387,94,77,41,33,0
64997,373,194,179,42,54,26,13,380,211,169,47,37,33,21,0
64998,317,153,164,34,52,30,14,364,192,172,49,36,39,14,0
64999,798,364,434,133,88,74,35,943,463,480,91,144,70,30,0
65000,700,305,395,111,99,54,18,751,394,357,107,96,73,35,0
65001,711,330,381,111,86,86,34,349,200,149,41,39,30,20,0
65002,651,357,294,81,67,103,18,582,264,318,84,60,58,23,0
65003,385,203,182,47,43,51,21,350,196,154,52,37,21,14,0
65004,423,247,176,58,55,29,20,366,204,162,47,41,31,23,0
65005,860,348,512,121,136,75,35,274,157,117,40,29,40,8,0
65006,233,107,126,40,40,20,16,1543,794,749,182,152,132,55,0
65007,261,148,113,23,29,26,21,290,142,148,41,37,43,11,0
65008,1130,614,516,129,138,98,42,395,198,197,55,55,36,10,0
65009,684,353,331,95,98,77,38,266,146,120,41,28,31,7,0
65010,325,186,139,49,36,20,5,334,181,153,56,31,28,18,0
65011,125,57,68,31,10,10,3,232,111,121,23,29,17,9,0
65012,215,80,135,54,56,21,9,403,221,182,62,50,42,12,0
65013,126,57,69,31,10,10,3,266,150,116,28,28,24,12,0
65014,595,339,256,64,36,54,24,288,156,132,36,36,24,15,0
65015,862,409,453,149,125,86,29,465,228,237,64,42,63,24,0
65016,258,126,132,38,22,29,8,536,251,285,75,79,60,23,0
65017,772,383,389,105,76,82,33,1873,935,938,233,225,203,79,0
65018,144,57,87,38,26,10,4,306,157,149,52,35,39,16,0
65019,1327,520,807,241,174,141,60,218,114,104,32,31,33,11,0
65020,420,248,172,64,30,43,17,966,478,488,108,144,74,43,0
65021,486,243,243,65,48,63,22,405,195,210,57,74,24,17,0
65022,407,230,177,44,39,34,19,906,455,451,116,105,87,46,0
65023,412,203,209,65,47,37,18,241,127,114,34,33,29,12,0
65024,395,186,209,53,48,46,30,702,358,344,113,87,81,30,0
65025,476,276,200,57,34,43,16,132,61,71,19,20,14,6,0
65026,188,84,104,35,36,18,9,492,278,214,65,58,32,11,0
65027,251,139,112,41,18,27,11,975,400,575,160,162,62,31,0
65028,366,190,176,39,62,55,14,175,82,93,33,26,17,5,0
65029,594,321,273,98,59,57,23,736,388,348,88,85,67,28,0
65030,505,247,258,72,71,60,27,104,46,58,15,17,9,5,0
65031,439,183,256,60,64,36,14,218,115,103,37,33,33,9,0
65032,186,56,130,46,50,16,7,207,114,93,33,20,31,13,0
65033,824,391,433,106,90,88,32,207,114,93,33,20,31,13,0
65034,331,169,162,40,28,22,14,748,359,389,125,113,86,31,0
65035,155,85,70,17,16,4,8,496,285,211,62,54,46,22,0
65036,166,59,107,36,41,10,4,1338,720,618,179,145,141,85,0
65037,531,260,271,97,68,47,11,89,42,47,16,12,15,6,0
65038,188,84,104,35,36,18,9,463,268,195,59,46,46,21,0
65039,1007,353,654,277,147,70,26,775,407,368,122,100,97,32,0
65040,1711,865,846,204,176,105,60,132,61,71,22,21,15,3,0
65041,1226,513,713,184,147,87,43,335,186,149,40,28,29,13,0
65042,218,133,85,20,19,13,6,866,478,388,121,101,101,26,0
65043,615,308,307,83,75,58,32,209,119,90,28,24,27,9,0
65044,246,111,135,64,47,27,3,526,266,260,76,75,53,22,0
65045,299,128,171,57,40,13,25,866,478,388,121,101,101,26,0
65046,284,160,124,37,23,32,11,414,203,211,58,56,48,14,0
65047,213,114,99,62,7,2,1,287,151,136,51,42,36,7,0
65048,692,305,387,100,97,78,30,483,258,225,70,53,54,20,0
65049,117,58,59,17,17,12,2,283,160,123,25,20,37,9,0
65050,753,395,358,93,72,71,16,207,114,93,33,20,31,13,0
65051,230,114,116,30,33,29,8,555,282,273,82,69,65,21,0
65052,346,205,141,47,34,30,7,295,160,135,42,37,46,16,0
65053,952,547,405,95,90,127,35,376,183,193,50,50,43,21,0
65054,313,134,179,58,37,43,19,367,199,168,62,44,34,8,0
65055,887,439,448,137,99,91,38,201,117,83,22,21,19,9,0
65056,402,169,233,70,36,34,18,349,200,149,41,39,30,20,0
65057,76,42,34,12,8,5,7,381,196,185,55,57,43,16,0
65058,449,179,270,80,77,49,29,334,181,153,56,31,28,18,0
65059,500,297,203,66,33,53,15,1182,591,591,155,139,83,46,0
65060,388,244,144,46,25,42,16,373,189,184,54,46,50,23,0
65061,217,109,108,30,23,28,10,644,343,301,96,69,59,28,0
65062,215,104,111,61,7,2,1,480,255,225,67,64,50,22,0
65063,126,56,70,31,10,10,3,306,157,149,52,35,39,16,0
65064,326,176,150,35,22,29,11,530,287,243,79,70,33,26,0
65065,494,233,261,87,57,46,18,974,457,517,133,117,69,26,0
65066,331,177,154,54,38,27,11,374,181,193,55,58,48,23,0
65067,384,198,186,58,48,37,12,239,113,126,36,49,20,8,0
65068,431,245,186,50,23,46,17,588,286,302,78,99,53,25,0
65069,376,171,205,45,45,34,12,710,375,335,95,94,110,28,0
65070,535,315,220,57,55,71,19,106,46,60,27,18,12,3,0
65071,710,352,358,104,86,84,41,309,164,145,35,47,30,11,0
65072,76,42,34,12,8,5,7,423,234,189,66,44,57,12,0
65073,376,171,205,45,45,34,12,422,202,220,80,52,57,18,0
65074,505,201,304,116,58,75,31,102,51,51,12,15,12,3,0
65075,412,146,266,106,38,67,35,257,126,131,61,24,22,8,0
65076,416,207,209,63,47,56,15,1395,627,768,172,263,141,59,0
65077,251,131,120,49,35,25,5,1755,905,850,214,196,183,79,0
65078,316,157,159,45,38,22,19,134,72,62,14,28,8,4,0
65079,528,273,255,67,53,29,20,239,113,126,36,49,20,8,0
65080,684,353,331,95,98,77,38,1239,659,580,169,148,131,54,0
65081,346,186,160,50,33,27,12,328,179,149,35,34,16,14,0
65082,580,240,340,108,81,59,22,297,164,133,45,39,40,9,0
65083,425,220,205,60,55,45,18,518,292,226,60,60,52,21,0
65084,531,259,272,75,81,39,13,715,345,370,110,97,64,25,0
65085,571,298,273,81,72,57,25,346,178,168,58,41,33,12,0
65086,279,129,150,43,34,17,13,265,134,131,48,34,33,15,0
65087,1112,457,655,180,164,99,39,277,144,133,42,30,41,8,0
65088,297,182,115,41,22,23,8,422,202,220,80,52,57,18,0
65089,396,150,246,103,64,38,3,376,183,193,50,50,43,21,0
65090,127,54,73,31,10,11,3,245,131,114,30,27,18,13,0
65091,330,141,189,65,29,51,19,373,213,160,44,33,26,17,0
65092,412,146,266,106,38,67,35,1279,669,610,164,162,104,55,0
65093,225,111,114,38,22,25,10,903,436,467,128,116,83,33,0
65094,1531,649,882,108,122,93,72,160,76,84,19,24,8,5,0
65095,130,72,58,28,9,7,1,314,177,137,34,40,29,9,0
65096,126,56,70,31,10,10,3,260,133,127,43,32,39,3,0
65097,371,209,162,46,17,36,19,419,233,186,54,53,55,17,0
65098,341,177,164,57,42,40,18,1208,565,643,182,162,120,57,0
65099,336,134,202,51,64,27,12,285,143,142,45,32,21,17,0
65100,199,113,86,27,17,10,7,274,142,132,33,34,18,14,0
65101,594,321,273,98,59,57,23,404,190,214,55,55,35,27,0
65102,743,366,377,41,37,26,14,373,213,160,44,33,26,17,0
65103,1960,875,1085,287,189,162,66,427,251,176,51,39,25,22,0
65104,3703,1708,1995,456,428,305,162,277,152,125,31,35,22,19,0
65105,127,62,65,13,33,7,6,396,223,173,57,37,44,19,0
65106,130,70,60,30,9,8,1,858,461,397,125,114,79,45,0
65107,1085,646,439,108,65,36,19,617,314,303,96,68,68,37,0
65108,367,167,200,63,42,60,17,396,223,173,57,37,44,19,0
65109,376,176,200,31,53,27,8,375,209,166,50,37,29,23,0
65110,616,304,312,75,71,55,25,381,196,185,55,57,43,16,0
65111,1339,494,845,216,298,92,37,374,181,193,55,58,48,23,0
65112,106,43,63,28,13,8,1,230,125,105,29,40,20,6,0
65113,428,226,202,52,60,75,20,149,77,72,37,10,20,5,0
65114,233,110,123,34,22,34,9,640,364,276,84,68,69,33,0
65115,711,330,381,111,86,86,34,665,361,304,87,91,84,31,0
65116,273,126,147,54,49,25,18,173,94,79,18,24,12,7,0
65117,420,189,231,79,67,33,17,470,205,265,71,80,33,11,0
65118,546,265,281,101,64,38,16,139,68,71,14,26,14,9,0
65119,447,232,215,55,65,50,25,364,192,172,49,36,39,14,0
65120,267,146,121,40,24,25,7,250,119,131,58,26,29,7,0
65121,333,171,162,50,34,19,8,173,94,79,18,24,12,7,0
65122,213,113,100,26,21,26,12,679,338,341,96,95,40,23,0
65123,1835,904,931,192,144,135,63,106,54,52,12,9,7,6,0
65124,348,174,174,46,34,46,16,119,57,62,18,16,17,4,0
65125,136,65,71,33,11,9,6,482,232,250,77,81,44,13,0
65126,299,151,148,35,34,26,16,180,115,65,17,12,9,9,0
65127,836,370,466,126,96,72,30,242,124,118,39,32,28,22,0
65128,264,122,142,46,24,35,10,119,61,58,17,12,10,6,0
65129,580,265,315,97,89,79,17,165,87,78,24,19,22,9,0
65130,1462,711,751,219,222,148,65,1065,581,484,134,97,76,46,0
65131,502,250,252,70,47,57,15,127,54,73,11,33,15,6,0
65132,246,123,123,40,31,27,7,374,191,183,40,52,40,16,0
65133,824,391,433,106,90,88,32,1395,627,768,172,263,141,59,0
65134,933,456,477,123,108,83,29,354,188,166,46,40,34,10,0
65135,781,367,414,60,67,43,17,376,183,193,50,50,43,21,0
65136,520,231,289,89,59,58,26,54,26,28,11,4,3,3,0
65137,473,217,256,59,44,34,21,551,226,325,96,103,43,11,0
65138,407,230,177,44,39,34,19,290,147,143,34,34,39,13,0
65139,546,265,281,101,64,38,16,514,262,252,78,58,54,26,0
65140,1755,849,906,245,226,148,56,292,155,137,50,34,29,13,0
65141,348,198,150,57,25,37,18,285,146,139,41,41,48,13,0
65142,509,246,263,84,71,56,22,137,63,74,20,22,14,6,0
65143,1336,724,612,209,141,133,60,862,426,436,113,115,84,37,0
65144,376,187,189,55,48,36,17,1471,709,762,198,184,154,62,0
65145,283,112,171,48,39,34,15,395,198,197,55,55,36,10,0
65146,571,298,273,81,72,57,25,187,89,98,36,24,20,6,0
65147,242,104,138,41,33,37,8,397,223,174,50,39,29,17,0
65148,607,294,313,94,95,62,14,340,169,171,40,39,36,22,0
65149,317,153,164,34,52,30,14,173,90,83,30,19,19,11,0
65150,1580,742,838,208,146,144,71,274,142,132,33,34,18,14,0
65151,334,155,179,47,34,38,11,301,168,133,49,37,34,11,0
65152,548,310,238,72,62,54,13,926,425,501,159,147,77,35,0
65153,1186,495,691,182,208,88,32,406,234,172,63,35,43,10,0
65154,164,81,83,37,8,14,10,68,36,32,11,8,9,2,0
65155,852,461,391,109,102,72,24,605,283,322,94,72,64,39,0
65156,124,58,66,20,28,11,7,257,126,131,61,24,22,8,0
65157,1276,607,669,192,178,136,63,1004,457,547,150,150,74,52,0
65158,136,65,71,33,11,9,6,389,207,182,53,58,52,18,0
65159,218,133,85,20,19,13,6,198,115,83,30,22,8,8,0
65160,278,104,174,46,34,23,14,376,189,187,47,53,44,26,0
65161,959,496,463,144,132,75,35,385,212,173,57,40,39,21,0
65162,1171,542,629,170,146,114,64,761,351,410,117,73,103,45,0
65163,173,90,83,30,19,19,11,559,317,242,58,65,37,23,0
65164,144,57,87,38,26,10,4,744,385,359,105,96,57,31,0
65165,1327,520,807,241,174,141,60,501,274,227,63,58,53,20,0
65166,417,176,241,75,61,51,20,373,181,192,54,35,44,20,0
65167,618,289,329,97,86,70,17,467,240,227,65,65,51,23,0
65168,127,55,72,25,18,5,7,400,187,213,56,59,42,20,0
65169,1709,650,1059,338,286,185,46,1061,543,518,146,123,109,67,0
65170,653,379,274,89,56,86,13,4646,2328,2318,674,639,475,170,0
65171,392,205,187,83,49,38,10,1537,701,836,209,187,129,58,0
65172,341,154,187,34,36,11,11,245,131,114,30,27,18,13,0
65173,629,374,255,74,53,87,27,132,61,71,19,20,14,6,0
65174,1009,487,522,177,121,103,51,1425,670,755,153,189,122,85,0
65175,559,217,342,105,86,42,16,925,439,486,141,134,105,46,0
65176,2649,1431,1218,377,299,266,102,225,129,96,32,33,20,8,0
65177,291,142,149,50,29,35,7,470,205,265,71,80,33,11,0
65178,3230,1724,1506,361,358,157,75,405,181,224,71,57,31,12,0
65179,979,534,445,83,77,80,24,963,525,438,119,102,102,34,0
65180,463,250,213,56,45,73,25,549,273,276,74,68,72,24,0
65181,331,144,187,57,46,33,19,403,233,170,38,29,21,14,0
65182,579,321,258,74,70,47,22,424,179,245,65,67,29,11,0
65183,338,139,199,54,54,18,11,1338,720,618,179,145,141,85,0
65184,437,228,209,47,61,26,11,415,205,210,77,52,55,17,0
65185,334,190,144,42,42,16,5,330,166,164,55,51,36,16,0
65186,317,167,150,45,21,30,26,749,384,365,108,105,86,31,0
65187,359,198,161,51,28,54,13,377,171,206,46,59,22,6,0
65188,736,353,383,117,83,71,18,362,156,206,74,42,36,22,0
65189,138,35,103,38,2,15,9,94,45,49,11,20,10,4,0
65190,469,221,248,49,60,55,21,773,389,384,119,91,79,26,0
65191,341,177,164,57,42,40,18,889,505,384,107,97,99,30,0
65192,420,189,231,79,67,33,17,266,146,120,41,28,31,7,0
65193,344,168,176,50,39,30,20,403,233,170,38,29,21,14,0
65194,588,317,271,78,49,54,17,323,168,155,51,41,38,12,0
65195,594,248,346,104,109,53,5,346,196,150,43,26,27,14,0
65196,150,64,86,22,12,29,12,858,461,397,125,114,79,45,0
65197,471,221,250,87,68,42,25,396,199,197,54,50,45,14,0
65198,433,188,245,63,45,26,14,329,194,135,45,32,33,9,0
65199,772,332,440,136,104,72,28,390,190,200,66,50,43,12,0
65200,536,237,299,116,87,42,17,1239,659,580,169,148,131,54,0
65201,463,250,213,56,45,73,25,375,176,199,48,61,40,12,0
65202,514,226,288,71,66,63,32,323,168,155,51,41,38,12,0
65203,528,273,255,67,53,29,20,1395,627,768,172,263,141,59,0
65204,828,355,473,126,134,77,37,405,214,191,53,42,49,20,0
65205,264,122,142,46,24,35,10,336,200,136,34,29,25,24,0
65206,219,100,119,40,29,21,3,501,240,261,80,62,49,42,0
65207,2414,1189,1225,277,178,170,169,331,180,151,46,35,47,17,0
65208,335,148,187,52,26,51,12,507,270,237,89,59,57,22,0
65209,1441,504,937,264,329,69,46,2724,1157,1567,269,518,239,77,0
65210,221,80,141,48,37,14,10,286,152,134,38,38,32,11,0
65211,222,110,112,43,30,14,6,277,152,125,31,35,22,19,0
65212,259,119,140,48,28,29,19,470,205,265,71,80,33,11,0
65213,1208,575,633,187,204,117,41,395,198,197,55,55,36,10,0
65214,732,355,377,108,109,79,27,218,111,107,45,29,24,6,0
65215,166,59,107,36,41,10,4,727,388,339,102,87,70,29,0
65216,345,203,142,47,35,31,11,1755,905,850,214,196,183,79,0
65217,802,375,427,133,103,81,41,323,168,155,51,41,38,12,0
65218,349,167,182,54,38,30,28,1154,489,665,200,196,95,54,0
65219,285,148,137,31,42,42,16,231,126,105,28,26,34,9,0
65220,482,245,237,69,64,66,24,381,186,195,69,55,46,15,0
65221,529,290,239,54,63,85,15,241,127,114,34,33,29,12,0
65222,489,253,236,73,36,62,17,166,88,78,23,18,13,7,0
65223,616,323,293,98,71,31,15,173,94,79,18,24,12,7,0
65224,1872,837,1035,280,338,169,80,362,156,206,74,42,36,22,0
65225,345,208,137,44,27,33,8,549,273,276,74,68,72,24,0
65226,490,198,292,65,81,39,27,178,69,109,29,25,21,13,0
65227,1043,479,564,200,131,123,62,467,240,227,65,65,51,23,0
65228,227,109,118,42,35,29,8,144,67,77,28,14,9,8,0
65229,747,360,387,125,92,69,32,535,311,224,66,52,49,24,0
65230,127,62,65,13,33,7,6,455,229,226,66,62,63,29,0
65231,246,111,135,64,47,27,3,198,110,88,27,27,24,4,0
65232,785,351,434,136,93,71,37,935,515,420,126,107,73,32,0
65233,323,156,167,52,45,39,18,295,160,135,42,37,46,16,0
65234,369,207,162,67,35,16,14,201,104,97,36,32,24,7,0
65235,1047,443,604,162,156,78,52,309,159,150,47,43,43,13,0
65236,406,207,199,56,46,68,19,508,253,255,73,60,50,13,0
65237,261,126,135,41,36,24,11,338,169,169,53,44,39,21,0
65238,575,290,285,67,70,28,9,360,185,175,51,43,36,16,0
65239,1199,589,610,189,128,167,65,139,68,71,14,26,14,9,0
65240,3703,1708,1995,456,428,305,162,230,125,105,29,40,20,6,0
65241,1616,735,881,285,248,153,72,536,267,269,60,70,41,22,0
65242,953,421,532,131,131,70,37,293,142,151,49,40,42,17,0
65243,412,193,219,69,57,43,14,413,223,190,52,45,53,10,0
65244,142,76,66,21,21,22,11,230,113,117,31,40,28,10,0
65245,325,152,173,43,47,28,17,246,107,139,55,33,27,11,0
65246,340,181,159,44,39,35,21,557,281,276,80,59,43,21,0
65247,210,84,126,44,43,9,4,266,146,120,41,28,31,7,0
65248,535,315,220,57,55,71,19,524,300,223,70,54,51,25,0
65249,334,190,144,42,42,16,5,282,134,148,38,45,29,10,0
65250,417,222,195,53,39,43,10,551,226,325,96,103,43,11,0
65251,1390,585,805,241,230,118,46,419,233,186,54,53,55,17,0
65252,475,235,240,77,58,43,22,240,141,99,34,28,29,8,0
65253,222,108,114,37,20,25,12,282,134,148,38,45,29,10,0
65254,291,142,149,50,29,35,7,434,213,221,77,62,53,12,0
65255,588,317,271,78,49,54,17,332,180,152,44,36,27,13,0
65256,130,71,59,30,9,8,1,137,72,65,27,13,15,8,0
65257,2663,1073,1590,548,499,192,64,152,71,81,41,16,14,2,0
65258,557,250,307,70,47,51,22,234,129,105,31,22,19,17,0
65259,977,462,515,185,119,76,12,166,90,76,27,18,21,5,0
65260,1960,875,1085,287,189,162,66,392,186,206,62,56,29,15,0
65261,341,183,158,36,34,36,15,173,86,87,30,22,19,12,0
65262,1139,537,602,162,139,109,50,557,281,276,80,59,43,21,0
65263,332,173,159,48,42,42,9,132,61,71,22,21,15,3,0
65264,462,233,229,66,49,43,30,107,77,30,7,2,9,5,0
65265,390,199,191,72,42,35,12,258,129,129,45,24,31,10,0
65266,425,199,226,54,71,56,11,199,92,107,34,30,18,9,0
65267,682,260,422,153,78,109,46,708,328,380,113,100,82,34,0
65268,404,197,207,60,48,47,20,403,233,170,38,29,21,14,0
65269,734,339,395,135,89,78,36,179,101,78,25,15,13,13,0
65270,334,190,144,42,42,16,5,172,88,84,24,31,20,12,0
65271,919,493,426,100,92,88,49,374,202,172,50,39,31,24,0
65272,1360,644,716,213,194,136,62,928,440,488,111,157,82,35,0
65273,243,70,173,54,65,8,6,425,177,248,60,62,33,16,0
65274,525,254,271,60,76,46,13,222,124,98,37,29,22,9,0
65275,435,222,213,67,49,67,12,149,77,72,37,10,20,5,0
65276,146,73,73,18,24,17,9,297,164,133,45,39,40,9,0
65277,715,345,370,110,97,64,25,463,170,293,115,54,75,32,0
65278,579,281,298,91,78,74,27,180,108,72,22,22,15,5,0
65279,262,133,129,44,38,31,12,1114,539,575,145,131,94,56,0
65280,220,113,107,37,24,16,7,389,210,179,51,37,43,9,0
65281,677,361,316,81,61,42,22,1378,692,686,194,174,105,56,0
65282,517,245,272,92,77,46,24,430,212,218,88,43,40,20,0
65283,259,119,140,48,28,29,19,292,155,137,50,34,29,13,0
65284,397,180,217,61,59,39,13,775,407,368,122,100,97,32,0
65285,536,237,299,116,87,42,17,736,388,348,88,85,67,28,0
65286,3230,1724,1506,361,358,157,75,1065,581,484,134,97,76,46,0
65287,161,75,86,24,20,10,7,246,107,139,55,33,27,11,0
65288,130,71,59,30,9,8,1,134,55,79,22,24,16,6,0
65289,525,302,223,56,48,67,19,1154,489,665,200,196,95,54,0
65290,785,325,460,114,123,61,28,271,150,121,39,36,37,5,0
65291,261,137,124,34,23,13,8,441,189,252,73,50,47,23,0
65292,789,362,427,90,82,70,35,72,33,39,8,2,3,12,0
65293,301,119,182,53,47,14,20,572,305,267,74,72,58,21,0
65294,528,188,340,130,58,77,41,495,217,278,79,64,44,22,0
65295,260,138,122,44,30,28,6,218,111,107,45,29,24,6,0
65296,313,158,155,43,35,43,16,260,133,127,43,32,39,3,0
65297,368,201,167,61,38,38,12,935,515,420,126,107,73,32,0
65298,272,136,136,32,34,12,12,601,278,323,124,87,65,21,0
65299,317,140,177,43,26,31,16,520,244,276,91,60,68,20,0
65300,317,140,177,43,26,31,16,328,199,129,39,29,27,14,0
65301,344,168,176,50,39,30,20,561,279,282,85,81,88,24,0
65302,406,207,199,56,46,68,19,295,160,135,44,36,46,16,0
65303,411,236,175,39,45,50,30,778,391,387,94,77,41,33,0
65304,328,195,133,36,23,35,9,1065,581,484,134,97,76,46,0
65305,508,136,372,157,91,22,9,406,202,204,54,51,63,21,0
65306,786,378,408,106,98,77,39,453,247,206,58,53,45,20,0
65307,1835,904,931,192,144,135,63,598,333,265,79,66,54,33,0
65308,419,210,209,54,44,31,23,601,279,322,81,65,27,12,0
65309,199,107,92,41,15,14,8,103,50,53,19,10,7,5,0
65310,736,320,416,113,97,61,36,673,313,360,102,101,46,17,0
65311,956,450,506,122,117,82,36,130,67,63,24,10,12,4,0
65312,2063,1024,1039,175,117,80,97,187,89,98,36,24,20,6,0
65313,445,231,214,45,64,53,23,902,499,403,118,117,92,35,0
65314,425,220,205,60,55,45,18,156,90,66,17,22,11,10,0
65315,238,158,80,28,15,31,7,535,288,247,79,72,35,21,0
65316,1912,880,1032,331,334,180,84,418,223,195,51,45,49,14,0
65317,291,142,149,50,29,35,7,671,306,365,114,76,49,19,0
65318,364,192,172,49,36,39,14,298,129,169,51,40,29,8,0
65319,402,169,233,70,36,34,18,627,289,338,101,73,62,43,0
65320,346,208,138,46,39,51,18,332,180,152,44,36,27,13,0
65321,1054,453,601,183,183,107,35,329,194,135,45,32,33,9,0
65322,587,318,269,76,50,38,21,375,209,166,50,37,29,23,0
65323,1023,449,574,141,174,76,43,1040,564,476,134,110,114,51,0
65324,548,250,298,85,64,56,21,286,152,134,38,38,32,11,0
65325,200,94,106,33,22,18,8,101,59,42,11,17,10,1,0
65326,805,338,467,153,138,99,55,1338,720,618,179,145,141,85,0
65327,532,291,241,83,36,79,25,462,229,233,63,49,42,18,0
65328,509,251,258,69,49,55,17,1395,627,768,172,263,141,59,0
65329,338,173,165,31,42,22,10,175,91,84,19,21,21,10,0
65330,282,84,198,60,102,1,6,562,273,289,76,92,45,24,0
65331,1689,821,868,277,250,177,78,528,276,252,86,78,49,17,0
65332,126,58,68,31,10,10,3,374,212,162,48,40,32,23,0
65333,729,351,378,111,98,58,18,336,200,136,34,29,25,24,0
65334,412,203,209,65,47,37,18,866,397,469,117,153,95,48,0
65335,378,202,176,34,32,44,13,1382,508,874,334,320,98,36,0
65336,674,318,356,86,139,50,11,647,350,297,95,79,77,29,0
65337,852,461,391,109,102,72,24,105,51,54,13,17,12,8,0
65338,325,186,139,49,36,20,5,199,105,94,27,27,28,9,0
65339,413,236,177,41,25,35,19,519,287,232,68,58,45,21,0
65340,297,182,115,41,22,23,8,105,51,54,13,17,12,8,0
65341,242,104,138,41,33,37,8,198,115,83,30,22,8,8,0
65342,349,167,182,54,38,30,28,260,131,129,42,31,40,9,0
65343,416,222,194,58,38,38,20,199,92,107,34,30,18,9,0
65344,785,325,460,114,123,61,28,103,44,59,16,17,9,5,0
65345,798,287,511,126,125,77,26,2547,1280,1267,331,335,293,118,0
65346,167,70,97,32,20,15,7,741,383,358,92,63,79,36,0
65347,1009,478,531,166,126,96,42,228,130,98,35,29,30,10,0
65348,522,302,220,61,49,75,19,274,142,132,33,34,18,14,0
65349,443,206,237,76,68,52,28,2382,1162,1220,237,220,140,49,0
65350,359,204,155,39,36,34,13,1154,489,665,200,196,95,54,0
65351,960,409,551,166,134,77,44,1239,659,580,169,148,131,54,0
65352,785,351,434,136,93,71,37,134,72,62,14,28,8,4,0
65353,164,61,103,47,19,14,5,627,323,304,81,90,53,27,0
65354,259,119,140,48,28,29,19,194,94,100,33,28,14,7,0
65355,629,374,255,74,53,87,27,583,321,262,73,67,45,25,0
65356,439,183,256,60,64,36,14,260,131,129,42,31,40,9,0
65357,533,297,236,74,57,39,28,389,210,179,51,37,43,9,0
65358,629,338,291,92,57,64,22,73,35,38,14,10,9,4,0
65359,406,207,199,56,46,68,19,609,335,274,79,57,45,22,0
65360,682,260,422,98,83,42,31,231,126,105,37,26,29,6,0
65361,496,210,286,112,55,71,14,246,107,139,55,33,27,11,0
65362,860,348,512,121,136,75,35,288,156,132,36,36,24,15,0
65363,911,445,466,154,121,108,48,1040,564,476,134,110,114,51,0
65364,298,141,157,51,33,21,22,256,141,115,32,22,32,8,0
65365,607,305,302,92,89,74,23,222,124,98,37,29,22,9,0
65366,270,158,112,35,20,23,7,303,137,166,54,54,31,15,0
65367,344,109,235,100,39,26,5,256,141,115,32,22,32,8,0
65368,500,257,243,60,55,27,22,218,118,100,33,30,25,11,0
65369,736,320,416,113,97,61,36,222,125,97,34,27,27,7,0
65370,343,162,181,65,38,29,12,222,124,98,37,29,22,9,0
65371,1235,584,651,140,226,82,52,314,177,137,34,40,29,9,0
65372,1174,594,580,175,155,126,66,169,85,84,21,14,9,9,0
65373,395,195,200,41,55,23,10,633,311,322,94,82,45,20,0
65374,1139,537,602,162,139,109,50,406,202,204,54,51,63,21,0
65375,625,283,342,93,89,67,25,246,107,139,55,33,27,11,0
65376,586,298,288,80,75,64,37,131,55,76,28,9,14,12,0
65377,317,153,164,34,52,30,14,607,294,313,94,95,62,14,0
65378,479,228,251,71,57,60,14,72,34,38,8,2,3,12,0
65379,616,304,312,75,71,55,25,231,126,105,37,26,29,6,0
65380,575,305,270,74,87,73,25,104,46,58,15,17,9,5,0
65381,640,308,332,91,102,49,21,780,337,443,112,116,77,28,0
65382,282,96,186,80,21,28,7,188,93,95,33,18,16,10,0
65383,1464,693,771,153,136,91,86,741,383,358,92,63,79,36,0
65384,530,259,271,83,50,54,41,432,244,188,51,51,27,14,0
65385,561,282,279,68,62,36,14,199,105,94,27,27,28,9,0
65386,203,80,123,40,37,20,3,727,388,339,102,87,70,29,0
65387,302,160,142,35,35,37,10,283,142,141,41,33,26,18,0
65388,373,164,209,51,45,44,21,665,361,304,87,91,84,31,0
65389,259,119,140,48,28,29,19,375,209,166,50,37,29,23,0
65390,609,292,317,102,96,64,21,173,86,87,30,22,19,12,0
65391,126,57,69,31,10,10,3,974,457,517,133,117,69,26,0
65392,1462,711,751,219,222,148,65,300,148,152,45,43,40,8,0
65393,270,131,139,47,37,41,11,332,155,177,55,51,44,13,0
65394,1912,880,1032,331,334,180,84,403,185,218,67,62,63,19,0
65395,636,320,316,79,61,67,31,1606,753,853,215,227,182,48,0
65396,129,70,59,29,9,7,2,222,127,95,23,28,22,7,0
65397,388,209,179,46,24,31,28,926,425,501,159,147,77,35,0
65398,509,246,263,84,71,56,22,1062,522,540,151,147,105,66,0
65399,395,195,200,41,55,23,10,194,106,88,33,10,15,6,0
65400,243,114,129,37,30,32,8,285,146,139,41,41,48,13,0
65401,707,250,457,171,84,117,61,145,77,68,26,7,15,8,0
65402,299,128,171,57,40,13,25,701,380,321,94,84,96,34,0
65403,575,290,285,67,70,28,9,710,375,335,95,94,110,28,0
65404,1087,523,564,146,177,103,33,385,188,197,57,42,36,16,0
65405,91,50,41,8,14,4,5,139,73,66,26,13,9,9,0
65406,557,211,346,129,125,48,19,367,218,149,45,43,42,16,0
65407,524,262,262,62,72,39,49,873,411,462,132,107,84,40,0
65408,508,267,241,43,35,25,17,274,157,117,40,29,40,8,0
65409,2236,1195,1041,227,187,186,118,470,205,265,71,80,33,11,0
65410,1098,519,579,182,159,79,42,543,221,322,78,122,37,12,0
65411,255,136,119,39,20,32,10,149,77,72,37,10,20,5,0
65412,329,168,161,48,34,41,16,763,418,345,113,84,59,32,0
65413,505,247,258,72,71,60,27,430,212,218,88,43,40,20,0
65414,414,216,198,51,32,42,28,479,215,264,67,80,46,28,0
65415,269,127,142,43,24,34,26,218,117,101,35,32,34,12,0
65416,71,28,43,15,9,5,2,274,142,132,33,34,18,14,0
65417,410,208,202,59,58,43,26,293,142,151,49,40,42,17,0
65418,413,206,207,38,55,19,10,699,334,365,108,80,70,20,0
65419,458,210,248,39,38,25,16,204,80,124,29,51,10,5,0
65420,522,302,220,61,49,75,19,773,389,384,119,91,79,26,0
65421,281,154,127,45,31,24,9,2346,1231,1115,316,292,266,105,0
65422,143,81,62,28,9,8,1,1034,495,539,150,134,114,71,0
65423,126,57,69,31,10,10,3,89,38,51,14,6,3,9,0
65424,584,340,244,77,60,47,25,227,130,97,32,25,22,12,0
65425,283,172,111,39,31,29,8,300,148,152,45,43,40,8,0
65426,375,167,208,55,83,44,9,562,273,289,76,92,45,24,0
65427,249,104,145,47,41,24,17,297,175,122,46,30,31,6,0
65428,1594,660,934,251,272,117,77,380,211,169,47,37,33,21,0
65429,333,171,162,50,34,19,8,89,38,51,14,6,3,9,0
65430,118,56,62,24,12,6,9,107,77,30,7,2,9,5,0
65431,317,140,177,43,26,31,16,322,180,142,45,38,28,7,0
65432,418,163,255,57,54,38,24,106,46,60,29,13,14,5,0
65433,360,205,155,35,24,52,14,240,141,99,34,28,29,8,0
65434,681,367,314,83,74,78,31,974,457,517,133,117,69,26,0
65435,1105,544,561,165,167,99,40,555,292,263,75,63,67,27,0
65436,808,366,442,130,133,66,31,481,223,258,71,70,49,26,0
65437,2000,965,1035,357,313,198,75,373,189,184,54,46,50,23,0
65438,233,107,126,40,40,20,16,403,192,211,102,39,49,15,0
65439,927,457,470,130,99,118,42,485,244,241,80,55,59,20,0
65440,575,295,280,89,68,54,18,555,282,273,82,69,65,21,0
65441,358,206,152,45,38,67,16,403,185,218,67,62,63,19,0
65442,270,130,140,43,24,36,10,127,64,63,26,8,12,8,0
65443,512,254,258,70,48,37,32,124,69,55,14,7,9,4,0
65444,305,124,181,27,25,32,21,555,282,273,82,69,65,21,0
65445,525,302,223,56,48,67,19,207,113,94,33,18,30,9,0
65446,852,472,380,99,79,70,27,107,77,30,7,2,9,5,0
65447,143,81,62,28,9,8,1,783,406,377,102,91,57,29,0
65448,376,249,127,47,23,43,16,545,269,276,80,76,27,32,0
65449,815,356,459,128,125,82,26,188,101,87,20,18,20,14,0
65450,484,194,290,70,93,47,16,1001,417,584,186,147,96,47,0
65451,103,56,47,27,7,8,2,4646,2328,2318,674,639,475,170,0
65452,743,366,377,41,37,26,14,106,54,52,12,9,7,6,0
65453,486,243,243,65,48,63,22,1182,591,591,155,139,83,46,0
65454,186,56,130,46,50,16,7,163,79,84,22,24,13,5,0
65455,360,175,185,73,36,27,7,452,254,198,72,57,38,18,0
65456,456,223,233,77,54,47,20,766,386,380,101,81,78,31,0
65457,314,158,156,39,28,30,17,423,234,189,66,44,57,12,0
65458,278,104,174,46,34,23,14,410,197,213,67,43,56,18,0
65459,326,180,146,62,26,41,13,403,221,182,47,41,47,8,0
65460,443,226,217,67,34,53,10,106,54,52,12,9,7,6,0
65461,395,219,176,47,41,50,18,943,463,480,91,144,70,30,0
65462,314,178,136,42,32,30,17,464,236,228,64,56,53,28,0
65463,1441,504,937,264,329,69,46,690,345,345,96,83,73,42,0
65464,2696,1169,1527,432,347,193,146,166,88,78,23,18,13,7,0
65465,486,243,243,65,48,63,22,127,54,73,11,33,15,6,0
65466,434,221,213,58,47,54,15,88,50,38,13,8,16,4,0
65467,724,363,361,109,108,77,15,938,484,454,137,100,104,41,0
65468,346,209,137,46,37,44,10,317,161,156,50,36,47,12,0
65469,476,276,200,57,34,43,16,2517,1275,1242,304,324,245,135,0
65470,1221,597,624,201,152,83,31,260,131,129,42,31,40,9,0
65471,422,196,226,52,35,33,20,125,66,59,24,16,11,5,0
65472,434,221,213,58,47,54,15,247,128,119,34,14,16,14,0
65473,579,246,333,102,79,41,19,178,99,79,31,19,26,8,0
65474,520,240,280,87,63,67,16,434,213,221,77,62,53,12,0
65475,516,210,306,113,53,81,33,198,115,83,30,22,8,8,0
65476,1462,711,751,219,222,148,65,375,211,164,50,36,31,23,0
65477,51,10,41,25,0,5,8,222,122,100,39,32,24,9,0
65478,111,29,82,10,54,0,1,201,104,97,36,32,24,7,0
65479,479,228,251,71,57,60,14,535,288,247,79,72,35,21,0
65480,341,177,164,57,42,40,18,935,515,420,126,107,73,32,0
65481,554,217,337,112,72,90,38,200,99,101,31,24,26,6,0
65482,199,113,86,27,17,10,7,370,173,197,65,57,42,10,0
65483,161,94,67,23,13,8,10,414,203,211,58,56,48,14,0
65484,369,207,162,67,35,16,14,736,388,348,88,85,67,28,0
65485,86,50,36,9,14,8,7,293,142,151,49,40,42,17,0
65486,142,76,66,21,21,22,11,2542,1245,1297,285,287,170,84,0
65487,2649,1431,1218,377,299,266,102,535,288,247,79,72,35,21,0
65488,746,312,434,129,115,77,47,514,248,266,86,82,52,22,0
65489,828,355,473,126,134,77,37,245,121,124,37,35,36,12,0
65490,206,100,106,34,26,11,7,619,305,314,85,93,71,29,0
65491,651,357,294,81,67,103,18,132,67,65,24,21,8,10,0
65492,700,305,395,111,99,54,18,710,375,335,95,94,110,28,0
65493,67,40,27,10,8,7,6,2517,1275,1242,304,324,245,135,0
65494,361,171,190,44,40,18,13,89,42,47,16,12,15,6,0
65495,482,231,251,76,81,64,26,201,117,83,22,21,19,9,0
65496,1718,735,983,266,225,130,68,402,186,216,64,47,38,20,0
65497,379,217,162,47,20,50,23,403,233,170,38,29,21,14,0
65498,961,465,496,139,156,62,34,516,245,271,82,84,70,26,0
65499,414,195,219,51,60,40,17,439,231,208,65,51,55,17,0
65500,305,124,181,27,25,31,21,374,212,162,48,40,32,23,0
65501,586,298,288,80,75,64,37,406,202,204,54,51,63,21,0
65502,193,90,103,44,9,19,13,148,69,79,26,18,16,3,0
65503,463,225,238,76,36,59,26,277,145,132,41,32,22,10,0
65504,959,496,463,144,132,75,35,432,244,188,51,51,27,14,0
65505,2174,1057,1117,241,241,214,117,232,111,121,23,29,17,9,0
65506,736,353,383,117,83,71,18,137,85,52,15,11,11,2,0
65507,489,253,236,73,36,62,17,1182,591,591,155,139,83,46,0
65508,429,227,202,49,51,46,26,898,469,429,125,125,134,35,0
65509,393,223,170,44,36,32,14,966,478,488,108,144,74,43,0
65510,333,171,162,41,44,48,23,439,231,208,65,51,55,17,0
65511,1174,594,580,175,155,126,66,352,207,145,40,33,25,21,0
65512,550,304,246,60,64,77,16,179,101,78,25,15,13,13,0
65513,434,221,213,58,47,54,15,437,224,213,40,29,42,25,0
65514,470,163,307,99,68,73,30,250,116,134,41,30,33,19,0
65515,341,183,158,36,34,36,15,250,116,134,41,30,33,19,0
65516,435,230,205,51,37,55,18,256,141,115,32,22,32,8,0
65517,420,248,172,64,30,43,17,773,389,384,119,91,79,26,0
65518,496,274,222,57,43,75,22,264,138,126,33,34,29,12,0
65519,335,183,152,40,26,54,22,96,46,50,16,12,7,5,0
65520,365,148,217,86,37,51,28,761,351,410,117,73,103,45,0
65521,594,248,346,104,109,53,5,279,161,118,37,32,7,7,0
65522,1047,443,604,162,156,78,52,134,55,79,22,24,16,6,0
65523,1107,601,506,155,138,103,49,966,478,488,108,144,74,43,0
65524,1439,713,726,195,180,110,34,396,223,173,57,37,44,19,0
65525,426,231,195,51,52,45,24,737,397,340,87,104,90,14,0
65526,126,56,70,31,10,10,3,818,357,461,122,136,54,25,0
65527,1186,495,691,182,208,88,32,124,69,55,14,7,9,4,0
65528,932,575,357,94,69,76,40,415,226,189,51,40,40,29,0
65529,322,164,158,46,44,29,7,866,478,388,121,101,101,26,0
65530,313,148,165,45,33,36,11,288,156,132,36,36,24,15,0
65531,270,128,142,36,43,15,11,928,440,488,111,157,82,35,0
65532,894,448,446,123,100,82,30,218,118,100,33,30,25,11,0
65533,128,69,59,29,9,8,1,445,264,181,35,35,34,14,0
65534,169,64,105,23,37,11,3,376,183,193,50,50,43,21,0
65535,1501,679,822,251,196,174,67,89,51,38,15,15,5,4,0
65536,264,122,142,33,29,13,13,154,78,76,23,21,13,5,0
65537,629,338,291,92,57,64,22,756,348,408,101,103,60,40,0
65538,128,69,59,29,9,8,1,288,156,132,36,36,24,15,0
65539,103,56,47,27,7,8,2,346,178,168,58,41,33,12,0
65540,418,163,255,57,54,38,24,295,160,135,44,36,46,16,0
65541,130,72,58,28,9,7,1,278,154,124,42,32,38,7,0
65542,344,168,176,50,39,30,20,293,142,151,49,40,42,17,0
65543,375,167,208,55,83,44,9,354,188,166,46,40,34,10,0
65544,580,265,315,97,89,79,17,222,127,95,23,28,22,7,0
65545,1544,738,806,239,217,145,91,501,274,227,63,58,53,20,0
65546,1052,492,560,184,163,103,44,398,200,198,68,43,51,14,0
65547,412,193,219,69,57,43,14,160,60,100,23,40,19,11,0
65548,107,53,54,15,15,13,4,198,113,85,19,20,26,12,0
65549,302,160,142,35,35,37,10,475,251,224,67,49,48,23,0
65550,1186,495,691,182,208,88,32,262,129,133,40,41,31,10,0
65551,401,183,218,72,73,28,10,463,268,195,59,46,46,21,0
65552,261,130,131,27,41,19,16,107,77,30,7,2,9,5,0
65553,631,316,315,64,57,49,15,434,213,221,77,62,53,12,0
65554,425,198,227,57,69,59,13,926,340,586,133,119,60,40,0
65555,1590,726,864,270,237,126,59,105,51,54,13,17,12,8,0
65556,1360,644,716,213,194,136,62,564,264,300,79,84,65,26,0
65557,886,440,446,116,140,95,45,309,164,145,35,47,30,11,0
65558,128,69,59,29,9,8,1,149,77,72,37,10,20,5,0
65559,395,219,176,47,41,50,18,403,221,182,62,50,42,12,0
65560,1030,438,592,184,104,108,30,524,300,223,70,54,51,25,0
65561,579,321,258,74,70,47,22,360,180,180,57,48,39,12,0
65562,347,181,166,27,20,12,12,413,223,190,52,45,53,10,0
65563,707,250,457,171,84,117,61,142,65,77,30,17,22,9,0
65564,519,259,260,86,78,59,22,953,489,464,126,104,111,44,0
65565,525,302,223,56,48,67,19,549,273,276,74,68,72,24,0
65566,1689,821,868,277,250,177,78,1230,644,586,198,125,123,61,0
65567,1096,563,533,158,136,120,53,293,142,151,49,40,42,17,0
65568,181,92,89,34,22,17,9,978,536,442,132,107,67,32,0
65569,346,191,155,52,38,40,13,715,348,367,109,84,68,30,0
65570,507,314,193,49,45,59,25,137,72,65,27,13,15,8,0
65571,410,211,199,55,42,34,27,187,89,98,36,24,20,6,0
65572,126,66,60,24,10,7,9,432,244,188,51,51,27,14,0
65573,979,534,445,83,77,80,24,425,177,248,60,62,33,16,0
65574,521,289,232,71,58,49,16,1249,638,611,166,153,141,45,0
65575,927,457,470,130,99,118,42,926,425,501,159,147,77,35,0
65576,397,180,217,61,59,39,13,978,536,442,132,107,67,32,0
65577,179,78,101,29,22,10,8,902,499,403,118,117,92,35,0
65578,484,264,220,59,62,68,15,330,166,164,55,51,36,16,0
65579,428,248,180,44,39,28,9,467,231,236,71,65,58,18,0
65580,543,265,278,52,37,54,19,169,85,84,21,14,9,9,0
65581,1718,735,983,266,225,130,68,611,314,297,79,75,78,22,0
65582,556,306,250,69,60,80,18,227,130,97,32,25,22,12,0
65583,164,77,87,33,19,6,7,246,125,121,38,36,30,11,0
65584,1054,497,557,190,168,107,45,306,157,149,52,35,39,16,0
65585,426,196,230,76,65,54,20,395,198,197,55,55,36,10,0
65586,1171,542,629,170,146,114,64,609,335,274,79,57,45,22,0
65587,211,92,119,33,44,11,7,232,111,121,23,29,17,9,0
65588,722,390,332,125,69,67,25,274,142,132,33,34,18,14,0
65589,139,64,75,18,17,18,4,660,333,327,102,95,69,31,0
65590,243,70,173,54,65,8,6,103,50,53,19,10,7,5,0
65591,500,257,243,60,55,27,22,397,234,163,44,38,23,21,0
65592,2799,1324,1475,369,371,215,124,663,360,303,87,82,80,35,0
65593,443,226,217,67,34,53,10,223,113,110,31,33,22,12,0
65594,493,208,285,75,77,70,40,679,338,341,96,95,40,23,0
65595,372,171,201,47,53,39,18,727,388,339,102,87,70,29,0
65596,496,210,286,111,55,74,13,439,231,208,65,51,55,17,0
65597,331,177,154,54,38,27,11,783,406,377,102,91,57,29,0
65598,122,56,66,26,13,11,5,953,489,464,126,104,111,44,0
65599,747,469,278,60,41,53,23,194,94,100,33,28,14,7,0
65600,316,157,159,45,38,22,19,201,99,102,34,26,23,6,0
65601,234,110,124,39,29,23,2,441,189,252,73,50,47,23,0
65602,365,222,143,44,24,35,11,245,121,124,37,35,36,12,0
65603,213,88,125,21,54,14,15,515,276,239,62,59,43,31,0
65604,391,203,188,49,34,36,9,300,148,152,45,43,40,8,0
65605,502,274,228,64,49,75,17,375,176,199,48,61,40,12,0
65606,347,198,149,45,29,29,8,406,202,204,54,51,63,21,0
65607,429,238,191,47,49,56,29,405,195,210,57,74,24,17,0
65608,960,409,551,166,134,77,44,127,66,61,13,14,19,8,0
65609,465,305,160,40,47,34,9,391,189,202,55,56,56,12,0
65610,860,349,511,166,166,58,19,103,44,59,16,17,9,5,0
65611,260,133,127,43,29,34,11,375,210,165,49,37,29,27,0
65612,349,153,196,54,47,28,13,1182,591,591,155,139,83,46,0
65613,760,405,355,112,95,92,29,290,142,148,41,37,43,11,0
65614,618,289,329,97,86,70,17,204,80,124,29,51,10,5,0
65615,338,173,165,31,42,22,10,1500,804,696,190,172,144,60,0
65616,422,207,215,79,38,53,23,671,321,350,95,87,75,34,0
65617,180,92,88,29,20,26,8,403,225,178,56,38,33,25,0
65618,1130,614,516,129,138,98,42,261,162,99,24,21,14,10,0
65619,436,209,227,66,47,52,22,518,292,226,60,60,52,21,0
65620,369,207,162,67,35,16,14,325,172,153,44,34,27,14,0
65621,207,89,118,56,8,4,3,178,69,109,29,25,21,13,0
65622,442,254,188,46,22,40,19,514,262,252,78,58,54,26,0
65623,535,315,220,57,55,71,19,2202,1121,1081,338,274,269,81,0
65624,580,240,340,108,81,59,22,94,45,49,11,20,10,4,0
65625,204,93,111,35,35,16,11,1230,644,586,198,125,123,61,0
65626,627,237,390,137,57,108,44,229,120,109,31,30,22,9,0
65627,598,322,276,67,57,63,26,1040,564,476,134,110,114,51,0
65628,369,207,162,67,35,16,14,1214,475,739,177,250,89,49,0
65629,415,133,282,114,65,27,7,1700,731,969,198,233,110,87,0
65630,879,457,422,93,98,143,32,729,358,371,116,99,89,33,0
65631,520,261,259,74,52,49,22,497,257,240,71,63,62,16,0
65632,301,156,145,32,25,15,5,1382,508,874,334,320,98,36,0
65633,410,209,201,72,30,48,22,292,155,137,50,34,29,13,0
65634,346,191,155,52,38,40,13,514,262,252,78,58,54,26,0
65635,410,211,199,55,42,34,27,1248,584,664,184,164,155,67,0
65636,431,245,186,50,23,46,17,1208,565,643,182,162,120,57,0
65637,206,100,106,34,26,11,7,732,366,366,108,86,74,41,0
65638,1872,837,1035,280,338,169,80,262,129,133,40,41,31,10,0
65639,420,189,231,79,67,33,17,166,78,88,27,25,19,7,0
65640,1498,731,767,220,175,148,68,389,207,182,53,58,52,18,0
65641,402,169,233,70,36,34,18,200,99,101,31,24,26,6,0
65642,240,167,73,32,12,8,21,904,436,468,143,118,108,32,0
65643,204,93,111,35,35,16,11,1606,753,853,215,227,182,48,0
65644,270,158,112,35,20,23,7,247,128,119,34,14,16,14,0
65645,206,100,106,34,26,11,7,455,229,226,66,62,63,29,0
65646,327,174,153,42,35,16,12,102,51,51,12,15,12,3,0
65647,561,282,279,68,62,36,14,134,55,79,22,24,16,6,0
65648,538,263,275,71,85,44,18,519,287,232,68,58,45,21,0
65649,326,148,178,55,42,31,12,178,69,109,29,25,21,13,0
65650,1647,794,853,279,235,128,65,1425,670,755,153,189,122,85,0
65651,420,248,172,64,30,43,17,188,105,83,25,17,24,7,0
65652,554,217,337,112,72,90,38,434,213,221,77,62,53,12,0
65653,526,268,258,54,37,55,12,309,159,150,47,43,43,13,0
65654,548,310,238,72,62,54,13,630,321,309,86,90,57,26,0
65655,157,62,95,41,18,10,11,137,85,52,15,11,11,2,0
65656,426,214,212,63,47,53,20,690,345,345,96,83,73,42,0
65657,520,240,280,87,63,67,16,720,361,359,98,98,70,37,0
65658,310,141,169,36,38,20,8,72,34,38,8,2,3,12,0
65659,3969,1703,2266,619,432,259,144,972,471,501,152,138,112,40,0
65660,215,117,98,28,19,15,8,292,155,137,50,34,29,13,0
65661,2525,1232,1293,398,317,186,61,1214,475,739,177,250,89,49,0
65662,172,98,74,20,21,22,8,134,55,79,22,24,16,6,0
65663,463,250,213,56,45,73,25,403,233,170,38,29,21,14,0
65664,580,281,299,95,60,74,29,978,536,442,132,107,67,32,0
65665,496,210,286,111,55,74,13,397,223,174,50,39,29,17,0
65666,273,126,147,54,49,25,18,445,192,253,86,58,53,18,0
65667,192,91,101,28,21,18,8,536,222,314,101,100,34,22,0
65668,57,24,33,11,3,5,3,780,337,443,112,116,77,28,0
65669,2446,1099,1347,363,294,233,100,368,183,185,40,42,40,15,0
65670,1759,838,921,269,212,191,92,671,306,365,114,76,49,19,0
65671,401,183,218,72,73,28,10,180,115,65,17,12,9,9,0
65672,894,448,446,123,100,82,30,213,129,84,32,14,21,15,0
65673,815,356,459,128,125,82,26,2038,1059,979,262,237,208,100,0
65674,213,113,100,26,21,26,12,232,111,121,23,29,17,9,0
65675,484,194,290,70,93,47,16,245,131,114,30,27,18,13,0
65676,117,57,60,17,14,11,10,292,143,149,38,42,36,16,0
65677,458,226,232,77,59,61,14,600,254,346,104,100,44,17,0
65678,472,222,250,46,61,33,23,549,273,276,74,68,72,24,0
65679,326,180,146,62,26,41,13,336,190,146,52,30,41,6,0
65680,441,216,225,57,66,57,19,200,89,111,26,25,17,7,0
65681,130,71,59,30,9,8,1,380,178,202,69,53,37,10,0
65682,562,214,348,120,86,69,42,437,224,213,40,29,42,25,0
65683,255,110,145,34,32,23,17,470,205,265,71,80,33,11,0
65684,134,60,74,19,13,10,7,245,131,114,30,27,18,13,0
65685,1171,542,629,170,146,114,64,277,145,132,41,32,22,10,0
65686,585,277,308,92,73,61,32,810,310,500,164,162,42,26,0
65687,126,57,69,31,10,10,3,744,385,359,105,96,57,31,0
65688,794,322,472,122,108,79,34,87,38,49,23,10,10,9,0
65689,365,222,143,44,24,35,11,218,115,103,37,33,33,9,0
65690,257,122,135,44,19,21,16,276,149,127,34,31,32,10,0
65691,127,54,73,31,10,11,3,222,122,100,39,32,24,9,0
65692,260,138,122,44,30,28,6,225,114,111,32,29,26,6,0
65693,305,124,181,27,25,31,21,290,142,148,41,37,43,11,0
65694,188,84,104,35,36,18,9,103,50,53,19,10,7,5,0
65695,2174,1057,1117,241,241,214,117,621,310,311,100,106,77,27,0
65696,395,219,176,47,41,50,18,2346,1231,1115,316,292,266,105,0
65697,130,70,60,30,9,8,1,262,129,133,40,41,31,10,0
65698,240,166,74,32,12,8,15,362,156,206,74,42,36,22,0
65699,560,279,281,113,64,58,15,339,180,159,36,29,16,16,0
65700,519,259,260,86,78,59,22,640,364,276,84,68,69,33,0
65701,272,94,178,76,33,19,4,748,359,389,125,113,86,31,0
65702,420,189,231,79,67,33,17,381,196,185,55,57,43,16,0
65703,1087,523,564,146,177,103,33,276,149,127,34,31,32,10,0
65704,364,168,196,64,61,27,6,178,99,79,31,19,26,8,0
65705,469,253,216,49,51,48,18,336,200,136,34,29,25,24,0
65706,1960,875,1085,287,189,162,66,222,124,98,37,29,22,9,0
65707,416,222,194,58,38,38,20,818,357,461,122,136,54,25,0
65708,348,198,150,57,25,37,18,373,189,184,54,46,50,23,0
65709,139,64,75,18,17,18,4,201,98,103,28,25,19,13,0
65710,560,279,281,113,64,58,15,415,203,212,77,44,49,18,0
65711,1718,735,983,266,225,130,68,427,251,176,51,39,25,22,0
65712,270,166,104,30,26,28,14,180,115,65,17,12,9,9,0
65713,2000,965,1035,357,313,198,75,163,79,84,22,24,13,5,0
65714,2442,1193,1249,278,183,170,145,328,195,133,39,40,27,13,0
65715,525,254,271,60,76,46,13,497,227,270,70,63,66,30,0
65716,1143,574,569,176,151,123,59,397,223,174,50,39,29,17,0
65717,589,282,307,68,67,70,23,415,189,226,68,54,50,21,0
65718,726,312,414,121,73,82,23,978,536,442,132,107,67,32,0
65719,221,80,141,48,37,14,10,222,124,98,37,29,22,9,0
65720,139,64,75,18,17,18,4,780,337,443,112,116,77,28,0
65721,443,226,217,67,34,53,10,194,106,88,33,10,15,6,0
65722,417,222,195,53,39,43,10,403,184,219,75,51,47,20,0
65723,516,210,306,113,53,81,33,470,205,265,71,80,33,11,0
65724,447,232,215,55,65,50,25,149,68,81,15,38,11,10,0
65725,380,185,195,68,54,32,16,654,295,359,99,88,71,25,0
65726,1163,417,746,209,145,87,28,406,202,204,54,51,63,21,0
65727,348,198,150,57,25,37,18,425,177,248,60,62,33,16,0
65728,736,353,383,117,83,71,18,715,345,370,110,97,64,25,0
65729,2048,855,1193,297,287,191,93,300,148,152,45,43,40,8,0
65730,463,225,238,76,36,59,26,370,190,180,60,52,37,13,0
65731,465,240,225,50,54,24,14,180,115,65,17,12,9,9,0
65732,519,245,274,58,61,34,22,106,54,52,12,9,7,6,0
65733,421,237,184,47,54,45,10,663,360,303,87,82,80,35,0
65734,192,91,101,28,21,18,8,288,156,132,36,36,24,15,0
65735,1342,640,702,187,163,123,57,279,161,118,37,32,7,7,0
65736,326,176,150,35,22,29,11,119,61,58,17,12,10,6,0
65737,331,165,166,52,34,48,22,320,168,152,38,42,24,18,0
65738,626,308,318,105,89,77,25,423,234,189,66,44,57,12,0
65739,154,74,80,18,19,7,2,419,233,186,54,53,55,17,0
65740,2696,1169,1527,432,347,193,146,180,108,72,22,22,15,5,0
65741,574,284,290,64,50,65,20,128,63,65,30,11,13,8,0
65742,193,105,88,33,16,9,4,1034,495,539,150,134,114,71,0
65743,1709,650,1059,338,286,185,46,354,188,166,46,40,34,10,0
65744,246,123,123,40,31,27,7,279,142,137,43,39,28,7,0
65745,446,195,251,56,53,31,15,317,161,156,40,49,41,11,0
65746,449,179,270,80,77,49,29,246,107,139,55,33,27,11,0
65747,359,167,192,49,37,27,19,250,116,134,41,30,33,19,0
65748,389,176,213,81,59,24,7,538,274,264,84,67,52,35,0
65749,153,65,88,27,14,18,9,427,205,222,53,52,51,22,0
65750,130,70,60,30,9,8,1,520,272,248,60,65,58,22,0
65751,643,284,359,129,71,84,43,605,283,322,94,72,64,39,0
65752,341,195,146,42,21,36,9,400,187,213,56,59,42,20,0
65753,392,205,187,83,49,38,10,660,332,328,84,73,47,19,0
65754,154,74,80,18,19,7,2,906,455,451,116,105,87,46,0
65755,640,279,361,102,83,69,21,1114,539,575,145,131,94,56,0
65756,496,210,286,112,55,71,14,173,94,79,18,24,12,7,0
65757,2696,1169,1527,432,347,193,146,866,397,469,117,153,95,48,0
65758,298,141,157,51,33,21,22,222,122,100,39,32,24,9,0
65759,1217,647,570,142,160,129,45,331,180,151,46,35,47,17,0
65760,312,173,139,43,47,28,6,306,157,149,52,35,39,16,0
65761,485,246,239,74,48,47,22,198,115,83,30,22,8,8,0
65762,193,110,83,18,20,15,12,555,292,263,75,63,67,27,0
65763,1970,978,992,245,206,198,80,225,129,96,32,33,20,8,0
65764,207,128,79,26,17,19,9,227,130,97,32,25,22,12,0
65765,349,131,218,66,76,22,9,660,333,327,102,95,69,31,0
65766,1689,821,868,277,250,177,78,690,345,345,96,83,73,42,0
65767,708,344,364,106,98,66,33,2038,1059,979,262,237,208,100,0
65768,103,56,47,27,7,8,2,548,273,275,84,81,64,30,0
65769,213,88,125,21,54,14,15,403,185,218,67,62,63,19,0
65770,580,281,299,95,60,74,29,1034,495,539,150,134,114,71,0
65771,366,190,176,39,62,55,14,89,42,47,16,12,15,6,0
65772,615,308,307,83,75,58,32,649,307,342,71,134,45,17,0
65773,362,174,188,46,55,35,23,633,311,322,94,82,45,20,0
65774,1249,543,706,187,164,125,52,286,152,134,38,38,32,11,0
65775,535,217,318,87,106,41,14,386,181,205,55,51,57,31,0
65776,258,144,114,33,22,19,9,453,247,206,58,53,45,20,0
65777,673,317,356,101,85,76,49,4646,2328,2318,674,639,475,170,0
65778,109,42,67,25,13,1,1,763,418,345,113,84,59,32,0
65779,320,183,137,51,18,38,8,538,274,264,84,67,52,35,0
65780,584,297,287,89,80,65,17,303,137,166,54,54,31,15,0
65781,126,56,70,31,10,10,3,846,425,421,125,97,98,38,0
65782,641,324,317,88,92,49,14,586,240,346,94,110,29,19,0
65783,305,124,181,27,25,32,21,504,272,232,75,57,53,19,0
65784,200,94,106,33,22,18,8,928,440,488,111,157,82,35,0
65785,648,262,386,113,108,78,29,1338,720,618,179,145,141,85,0
65786,107,36,71,27,15,0,1,415,226,189,51,40,40,29,0
65787,374,202,172,58,40,41,7,515,276,239,62,59,43,31,0
65788,626,300,326,91,82,68,26,103,44,59,16,17,9,5,0
65789,598,322,276,67,57,63,26,1700,731,969,198,233,110,87,0
65790,639,368,271,72,51,38,38,332,180,152,46,36,28,14,0
65791,600,324,276,89,73,45,39,374,202,172,50,39,31,24,0
65792,1867,973,894,256,222,194,65,305,163,142,38,27,47,11,0
65793,785,351,434,136,93,71,37,397,223,174,50,39,29,17,0
65794,326,154,172,45,39,20,10,261,127,134,36,27,36,4,0
65795,595,208,387,157,60,91,48,406,202,204,54,51,63,21,0
65796,561,282,279,68,62,36,14,370,173,197,65,57,42,10,0
65797,412,193,219,69,57,43,14,403,233,170,38,29,21,14,0
65798,411,236,175,39,45,50,30,250,116,134,41,30,33,19,0
65799,342,185,157,42,27,31,14,756,348,408,101,103,60,40,0
65800,435,225,210,58,46,50,14,332,155,177,55,51,44,13,0
65801,224,101,123,45,32,21,3,89,42,47,16,12,15,6,0
65802,425,220,205,60,55,45,18,261,162,99,24,21,14,10,0
65803,346,191,155,52,38,40,13,978,536,442,132,107,67,32,0
65804,219,116,103,66,7,2,1,359,171,188,49,74,45,11,0
65805,357,182,175,49,36,39,15,334,181,153,41,40,25,15,0
65806,215,80,135,54,56,21,9,296,159,137,49,28,38,13,0
65807,328,156,172,44,37,44,15,609,335,274,79,57,45,22,0
65808,949,466,483,125,126,101,50,415,205,210,77,52,55,17,0
65809,450,227,223,53,36,48,12,633,311,322,94,82,45,20,0
65810,146,73,73,18,24,17,9,749,384,365,108,105,86,31,0
65811,316,157,159,45,38,22,19,487,252,235,79,58,55,26,0
65812,297,182,115,41,22,23,8,594,312,282,72,67,73,31,0
65813,595,316,279,86,60,65,40,135,65,70,21,25,15,9,0
65814,500,245,255,66,57,52,27,524,300,223,70,54,51,25,0
65815,556,306,250,69,60,80,18,1154,489,665,200,196,95,54,0
65816,516,210,306,113,53,81,33,119,61,58,17,12,10,6,0
65817,346,174,172,36,43,21,9,246,125,121,38,36,30,11,0
65818,431,216,215,46,40,33,9,169,74,95,33,26,22,3,0
65819,119,59,60,29,10,6,4,277,144,133,42,30,41,8,0
65820,184,93,91,26,25,14,11,535,288,247,79,72,35,21,0
65821,404,197,207,60,48,47,20,778,391,387,94,77,41,33,0
65822,109,42,67,25,13,1,1,415,189,226,68,54,50,21,0
65823,548,250,298,85,64,56,21,1004,457,547,150,150,74,52,0
65824,475,235,240,77,58,43,22,227,130,97,32,25,22,12,0
65825,426,231,195,51,52,45,24,277,145,132,41,32,22,10,0
65826,313,178,135,43,18,35,6,245,131,114,30,27,18,13,0
65827,755,271,484,113,226,61,20,469,225,244,64,68,25,11,0
65828,833,295,538,146,139,65,34,201,98,103,28,25,19,13,0
65829,357,182,175,49,36,39,15,364,189,175,58,41,35,17,0
65830,127,48,79,27,20,6,5,190,93,97,35,27,23,2,0
65831,959,496,463,144,132,75,35,535,311,224,66,52,49,24,0
65832,589,282,307,68,67,70,23,972,471,501,152,138,112,40,0
65833,373,164,209,51,45,44,21,402,186,216,64,47,38,20,0
65834,326,148,178,55,42,31,12,453,255,198,62,49,29,19,0
65835,605,277,328,99,54,63,43,380,178,202,69,53,37,10,0
65836,650,330,320,93,93,51,28,103,44,59,16,17,9,5,0
65837,172,98,74,20,21,22,8,397,223,174,50,39,29,17,0
65838,180,92,88,29,20,26,8,350,196,154,52,37,21,14,0
65839,548,250,298,85,64,56,21,368,204,164,43,35,30,24,0
65840,505,226,279,68,51,30,15,727,388,339,102,87,70,29,0
65841,1390,585,805,241,230,118,46,368,204,164,43,35,30,24,0
65842,626,300,326,91,82,68,26,421,222,199,69,50,60,18,0
65843,1555,702,853,250,199,139,31,600,254,346,104,100,44,17,0
65844,509,251,258,69,49,55,17,374,181,193,55,58,48,23,0
65845,261,137,124,34,23,13,8,457,253,204,67,51,48,13,0
65846,516,210,306,113,53,81,33,201,99,102,34,26,23,6,0
65847,361,171,190,44,40,18,13,246,107,139,55,33,27,11,0
65848,349,131,218,66,76,22,9,305,161,144,39,40,44,17,0
65849,270,158,112,35,20,23,7,245,121,124,37,35,36,12,0
65850,126,57,69,31,10,10,3,354,188,166,46,40,34,10,0
65851,360,175,185,73,36,27,7,335,186,149,40,28,29,13,0
65852,180,57,123,39,22,10,8,583,280,303,95,66,76,25,0
65853,784,351,433,118,87,73,41,213,129,84,32,14,21,15,0
65854,186,56,130,46,50,16,7,200,99,101,31,24,26,6,0
65855,800,416,384,102,105,83,22,427,251,176,51,39,25,22,0
65856,193,110,83,18,20,15,12,305,161,144,39,40,44,17,0
65857,439,241,198,67,40,40,13,397,234,163,44,38,23,21,0
65858,284,128,156,48,29,34,8,1040,564,476,134,110,114,51,0
65859,433,188,245,63,45,26,14,350,196,154,52,37,21,14,0
65860,1560,778,782,224,235,132,78,600,254,346,104,100,44,17,0
65861,257,132,125,39,27,26,10,282,134,148,38,45,29,10,0
65862,605,277,328,99,54,63,43,88,50,38,13,8,16,4,0
65863,176,74,102,20,29,7,7,501,257,244,75,57,48,29,0
65864,1011,559,452,121,97,132,33,309,164,145,35,47,30,11,0
65865,546,285,261,71,49,47,24,496,285,211,62,54,46,22,0
65866,235,100,135,36,25,30,8,330,166,164,55,51,36,16,0
65867,1390,585,805,241,230,118,46,1378,692,686,194,174,105,56,0
65868,164,77,87,33,19,6,7,858,461,397,125,114,79,45,0
65869,3230,1724,1506,361,358,157,75,329,196,133,41,36,31,15,0
65870,293,153,140,45,38,22,15,160,67,93,32,37,15,9,0
65871,126,58,68,31,10,10,3,72,32,40,8,2,1,14,0
65872,979,534,445,83,77,80,24,285,143,142,45,32,21,17,0
65873,209,75,134,53,48,20,9,328,195,133,39,40,27,13,0
65874,301,157,144,31,28,34,9,947,482,465,143,107,89,37,0
65875,439,241,198,67,40,40,13,564,264,300,79,84,65,26,0
65876,536,287,249,64,73,21,27,526,266,260,76,75,53,22,0
65877,1023,449,574,141,174,76,43,204,80,124,29,51,10,5,0
65878,476,276,200,57,34,43,16,464,236,228,64,56,53,28,0
65879,219,100,119,40,29,21,3,607,293,314,98,71,62,32,0
65880,484,264,220,59,62,68,15,279,142,137,43,39,28,7,0
65881,76,42,34,12,8,5,7,178,99,79,31,19,26,8,0
65882,150,64,86,22,12,29,12,557,281,276,80,59,43,21,0
65883,407,164,243,88,42,40,22,661,325,336,81,75,65,28,0
65884,604,239,365,124,63,84,37,212,127,85,28,21,26,6,0
65885,1647,794,853,279,235,128,65,91,44,47,9,12,4,7,0
65886,626,308,318,105,89,77,25,2542,1245,1297,285,287,170,84,0
65887,181,75,106,35,26,11,9,362,156,206,74,42,36,22,0
65888,330,141,189,65,29,51,19,1114,539,575,145,131,94,56,0
65889,959,496,463,144,132,75,35,368,183,185,40,42,40,15,0
65890,476,254,222,58,33,46,23,524,300,223,70,54,51,25,0
65891,1501,679,822,251,196,174,67,250,116,134,41,30,33,19,0
65892,461,207,254,82,66,55,33,551,226,325,96,103,43,11,0
65893,588,267,321,99,79,87,28,508,261,247,65,53,58,23,0
65894,577,251,326,92,84,60,11,519,287,232,68,58,45,21,0
65895,519,245,274,58,61,34,22,277,145,132,41,32,22,10,0
65896,224,108,116,33,26,32,10,200,99,101,31,24,26,6,0
65897,734,366,368,121,99,63,39,1352,602,750,166,185,81,70,0
65898,129,70,59,29,9,7,2,654,295,359,99,88,71,25,0
65899,586,298,288,80,75,64,37,194,109,85,23,24,21,9,0
65900,161,94,67,23,13,8,10,319,185,134,42,31,22,13,0
65901,516,224,292,79,29,45,33,106,54,52,12,9,7,6,0
65902,176,74,102,20,29,7,7,241,127,114,34,33,29,12,0
65903,2286,1154,1132,338,314,278,103,375,211,164,50,36,31,23,0
65904,126,56,70,31,10,10,3,73,35,38,14,10,9,4,0
65905,498,274,224,58,59,50,18,399,190,209,61,41,39,18,0
65906,313,134,179,58,37,43,19,111,60,51,17,23,10,7,0
65907,398,186,212,76,70,18,13,166,88,78,23,18,13,7,0
65908,673,317,356,101,85,76,49,397,234,163,44,38,23,21,0
65909,603,311,292,102,71,66,23,344,190,154,34,31,36,10,0
65910,86,50,36,9,14,8,7,278,154,124,42,32,38,7,0
65911,117,57,60,17,14,11,10,720,361,359,98,98,70,37,0
65912,650,330,320,93,93,51,28,219,105,114,36,29,19,8,0
65913,272,141,131,45,29,36,9,218,115,103,32,32,34,11,0
65914,222,108,114,37,20,25,12,127,54,73,11,33,15,6,0
65915,313,158,155,43,35,43,16,763,418,345,113,84,59,32,0
65916,447,232,215,55,65,50,25,340,169,171,40,39,36,22,0
65917,1441,504,937,264,329,69,46,222,125,97,34,27,27,7,0
65918,422,196,226,52,35,33,20,418,246,172,52,39,57,10,0
65919,347,212,135,35,32,17,6,137,63,74,20,22,14,6,0
65920,371,143,228,77,48,29,26,415,203,212,77,44,49,18,0
65921,685,393,292,75,66,113,16,91,42,49,21,9,8,3,0
65922,756,362,394,102,104,73,25,103,59,44,25,2,13,6,0
65923,134,60,74,19,13,10,7,282,134,148,38,45,29,10,0
65924,381,146,235,74,48,47,34,1062,522,540,151,147,105,66,0
65925,164,77,87,33,19,6,7,212,127,85,28,21,26,6,0
65926,410,200,210,60,54,46,19,160,76,84,19,24,8,5,0
65927,450,231,219,77,50,76,16,439,227,212,60,55,58,8,0
65928,640,279,361,102,83,69,21,215,115,100,27,19,16,7,0
65929,516,224,292,79,29,45,33,128,63,65,30,11,13,8,0
65930,616,323,293,98,71,31,15,741,383,358,92,63,79,36,0
65931,390,199,191,72,42,35,12,305,161,144,39,40,44,17,0
65932,1498,731,767,220,175,148,68,1425,670,755,153,189,122,85,0
65933,1214,612,602,169,173,98,35,294,146,148,50,45,51,15,0
65934,613,303,310,70,28,28,18,1696,771,925,257,225,149,63,0
65935,149,78,71,20,20,19,5,953,489,464,126,104,111,44,0
65936,401,236,165,53,38,34,9,68,23,45,12,9,3,9,0
65937,410,209,201,72,30,48,22,283,142,141,41,33,26,18,0
65938,126,66,60,24,10,7,9,136,65,71,26,11,7,5,0
65939,1970,978,992,245,206,198,80,296,159,137,49,28,38,13,0
65940,139,81,58,17,14,24,9,453,255,198,62,49,29,19,0
65941,217,109,108,30,23,28,10,810,310,500,164,162,42,26,0
65942,410,200,210,60,54,46,19,127,66,61,13,14,19,8,0
65943,803,358,445,135,117,80,43,165,87,78,24,19,22,9,0
65944,1107,601,506,155,138,103,49,166,78,88,27,25,19,7,0
65945,210,101,109,33,33,19,9,598,333,265,79,66,54,33,0
65946,429,227,202,49,51,46,26,231,126,105,37,26,29,6,0
65947,571,298,273,81,72,57,25,240,141,99,34,28,29,8,0
65948,280,156,124,36,19,20,13,145,77,68,26,7,15,8,0
65949,118,56,62,24,12,6,9,196,105,91,40,13,19,10,0
65950,392,205,187,83,49,38,10,720,361,359,98,98,70,37,0
65951,894,420,474,136,146,93,39,452,236,216,73,54,50,29,0
65952,437,230,207,41,55,27,13,478,254,224,67,74,56,28,0
65953,1462,711,751,219,222,148,65,508,253,255,73,60,50,13,0
65954,378,202,176,34,32,44,13,292,155,137,50,34,29,13,0
65955,206,96,110,33,25,8,6,1606,753,853,215,227,182,48,0
65956,1499,864,635,141,99,76,110,367,218,149,45,43,42,16,0
65957,953,421,532,131,131,70,37,368,204,164,43,35,30,24,0
65958,328,156,172,44,37,44,15,748,359,389,125,113,86,31,0
65959,412,208,204,54,47,42,17,106,54,52,12,9,7,6,0
65960,360,175,185,73,36,27,7,693,360,333,100,88,62,26,0
65961,588,317,271,78,49,54,17,2517,1275,1242,304,324,245,135,0
65962,772,332,440,136,104,72,28,903,436,467,128,116,83,33,0
65963,255,126,129,41,37,13,5,285,146,139,41,41,48,13,0
65964,282,163,119,40,23,25,17,142,65,77,30,17,22,9,0
65965,124,58,66,20,28,11,7,188,93,95,33,18,16,10,0
65966,417,222,195,53,39,43,10,305,163,142,38,27,47,11,0
65967,86,50,36,9,14,8,7,1425,670,755,153,189,122,85,0
65968,107,36,71,27,15,0,1,328,199,129,39,29,27,14,0
65969,563,255,308,91,111,42,30,1382,508,874,334,320,98,36,0
65970,426,214,212,63,47,53,20,385,212,173,57,40,39,21,0
65971,429,227,202,49,51,46,26,413,223,190,52,45,53,10,0
65972,193,105,88,33,16,9,4,220,107,113,36,35,28,9,0
65973,625,283,342,93,89,67,25,201,98,103,28,25,19,13,0
65974,887,439,448,137,99,91,38,1425,670,755,153,189,122,85,0
65975,122,56,66,26,13,11,5,405,214,191,53,42,49,20,0
65976,546,265,281,101,64,38,16,536,251,285,75,79,60,23,0
65977,543,265,278,52,37,54,19,337,170,167,59,33,47,17,0
65978,132,66,66,21,18,11,7,125,66,59,24,16,11,5,0
65979,1616,735,881,285,248,153,72,583,321,262,73,67,45,25,0
65980,593,282,311,75,70,29,25,892,475,417,130,108,68,38,0
65981,3703,1708,1995,456,428,305,162,252,130,122,45,23,32,11,0
65982,2414,1189,1225,277,178,170,169,963,525,438,119,102,102,34,0
65983,199,113,86,27,17,10,7,761,351,410,117,73,103,45,0
65984,607,305,302,92,89,74,23,169,85,84,21,14,9,9,0
65985,269,127,142,43,24,34,26,1378,692,686,194,174,105,56,0
65986,280,156,124,36,19,20,13,245,131,114,30,27,18,13,0
65987,734,366,368,121,99,63,39,209,119,90,28,24,27,9,0
65988,380,185,195,68,54,32,16,866,397,469,117,153,95,48,0
65989,437,167,270,126,95,34,10,292,155,137,50,34,29,13,0
65990,417,176,241,75,61,51,20,246,125,121,38,36,30,11,0
65991,418,163,255,57,54,38,24,463,259,204,62,55,34,22,0
65992,2220,1085,1135,312,304,202,91,547,295,252,81,65,57,23,0
65993,753,395,358,93,72,71,16,307,132,175,48,53,26,10,0
65994,323,171,152,36,36,47,15,259,151,108,39,18,23,11,0
65995,509,246,263,84,71,56,22,1101,626,475,145,122,120,50,0
65996,594,321,273,98,59,57,23,246,125,121,38,36,30,11,0
65997,524,262,262,62,72,39,49,1700,731,969,198,233,110,87,0
65998,514,226,288,71,66,63,32,397,223,174,50,39,29,17,0
65999,466,199,267,86,59,32,17,188,105,83,25,17,24,7,0
66000,641,349,292,92,60,39,24,452,254,198,72,57,38,18,0
66001,252,121,131,42,34,12,16,975,475,500,139,140,119,28,0
66002,505,201,304,116,58,75,31,223,113,110,31,33,22,12,0
66003,98,32,66,15,25,5,4,1425,670,755,153,189,122,85,0
66004,119,59,60,29,10,6,4,400,187,213,56,59,42,20,0
66005,3703,1708,1995,456,428,305,162,457,242,215,39,46,53,10,0
66006,261,130,131,27,41,19,16,103,44,59,16,17,9,5,0
66007,412,193,219,69,57,43,14,127,64,63,26,8,12,8,0
66008,390,199,191,72,42,35,12,153,80,73,26,18,19,4,0
66009,202,113,89,16,27,21,11,866,397,469,117,153,95,48,0
66010,1555,702,853,250,199,139,31,258,129,129,45,24,31,10,0
66011,595,208,387,157,60,91,48,396,213,183,68,44,47,18,0
66012,264,122,142,46,24,35,10,758,319,439,101,123,78,25,0
66013,450,241,209,67,58,54,23,559,317,242,58,65,37,23,0
66014,304,149,155,46,32,39,14,166,102,64,19,14,17,2,0
66015,484,192,292,118,68,83,22,935,515,420,126,107,73,32,0
66016,485,237,248,83,35,52,24,528,276,252,86,78,49,17,0
66017,325,152,173,43,47,28,17,649,307,342,71,134,45,17,0
66018,500,245,255,66,57,52,27,1507,737,770,188,228,147,71,0
66019,781,316,465,130,129,65,23,509,267,242,79,81,38,20,0
66020,308,129,179,44,60,19,8,366,204,162,47,41,31,23,0
66021,71,39,32,7,11,6,4,1040,564,476,134,110,114,51,0
66022,311,154,157,47,29,34,13,452,252,200,55,49,61,16,0
66023,339,118,221,77,68,33,13,562,273,289,76,92,45,24,0
66024,252,121,131,42,34,12,16,464,236,228,64,56,53,28,0
66025,1235,584,651,140,226,82,52,475,251,224,67,49,48,23,0
66026,136,66,70,33,11,9,4,457,253,204,67,51,48,13,0
66027,539,283,256,75,73,53,26,251,143,108,47,25,29,11,0
66028,362,174,188,46,55,35,23,241,127,114,34,33,29,12,0
66029,358,212,146,51,36,33,9,524,300,223,70,54,51,25,0
66030,639,368,271,72,51,38,38,846,425,421,125,97,98,38,0
66031,192,91,101,28,21,18,8,478,254,224,67,74,56,28,0
66032,161,94,67,23,13,8,10,480,255,225,67,64,50,22,0
66033,462,233,229,66,49,43,30,331,180,151,46,35,47,17,0
66034,727,426,301,79,71,64,32,386,207,179,43,48,44,19,0
66035,364,192,172,49,36,39,14,391,165,226,67,64,36,27,0
66036,443,206,237,76,68,52,28,1214,475,739,177,250,89,49,0
66037,785,374,411,56,42,38,25,821,394,427,122,117,109,38,0
66038,524,262,262,62,72,39,49,297,164,133,45,39,40,9,0
66039,259,119,140,48,28,29,19,1425,670,755,153,189,122,85,0
66040,124,58,66,20,28,11,7,96,45,51,13,12,6,4,0
66041,407,164,243,88,42,40,22,497,257,240,71,63,62,16,0
66042,224,108,116,33,26,32,10,198,86,112,36,27,23,9,0
66043,929,410,519,187,146,53,30,474,268,206,66,42,45,24,0
66044,142,76,66,21,21,22,11,862,409,453,149,125,86,29,0
66045,379,217,162,47,20,50,23,1241,619,622,183,169,155,59,0
66046,255,126,129,41,37,13,5,398,200,198,68,43,51,14,0
66047,605,277,328,99,54,63,43,103,44,59,16,17,9,5,0
66048,828,394,434,105,110,81,33,657,326,331,80,81,53,31,0
66049,130,70,60,30,9,8,1,171,94,77,24,28,30,11,0
66050,126,56,70,31,10,10,3,517,295,222,69,62,40,28,0
66051,330,182,148,47,27,40,11,689,343,346,105,102,81,35,0
66052,346,205,141,47,34,30,7,427,251,176,51,39,25,22,0
66053,258,126,132,38,22,29,8,582,264,318,84,60,58,23,0
66054,435,187,248,62,51,51,21,737,397,340,87,104,90,14,0
66055,496,210,286,111,55,74,13,225,129,96,32,33,20,8,0
66056,519,245,274,58,61,34,22,336,200,136,34,29,25,24,0
66057,193,107,86,13,20,13,6,2346,1231,1115,316,292,266,105,0
66058,563,255,308,91,111,42,30,222,124,98,37,29,22,9,0
66059,272,141,131,45,29,36,9,128,63,65,30,11,13,8,0
66060,1499,864,635,141,99,76,110,708,328,380,113,100,82,34,0
66061,228,105,123,34,43,20,10,405,195,210,57,74,24,17,0
66062,399,196,203,62,45,38,19,664,350,314,86,90,82,36,0
66063,640,308,332,91,102,49,21,463,259,204,62,55,34,22,0
66064,446,195,251,56,53,31,15,501,240,261,80,62,49,42,0
66065,485,183,302,79,81,73,33,565,237,328,75,88,32,11,0
66066,217,98,119,38,35,18,9,457,245,212,62,58,57,21,0
66067,548,310,238,72,62,54,13,279,161,118,37,32,7,7,0
66068,507,314,193,49,45,59,25,127,64,63,26,8,12,8,0
66069,451,278,173,71,35,58,12,251,143,108,47,25,29,11,0
66070,575,290,285,67,70,28,9,536,267,269,60,70,41,22,0
66071,486,243,243,65,48,63,22,437,221,216,62,64,47,13,0
66072,1235,584,651,140,226,82,52,261,127,134,36,27,36,4,0
66073,802,375,427,133,103,81,41,246,107,139,55,33,27,11,0
66074,1221,597,624,201,152,83,31,2038,1059,979,262,237,208,100,0
66075,271,110,161,33,27,11,8,294,146,148,50,45,51,15,0
66076,365,148,217,86,37,51,28,403,233,170,38,29,21,14,0
66077,805,338,467,153,138,99,55,732,402,330,81,86,87,33,0
66078,136,66,70,33,11,9,3,1537,701,836,209,187,129,58,0
66079,941,459,482,167,140,82,38,314,177,137,34,40,29,9,0
66080,126,56,70,31,10,10,3,478,254,224,67,74,56,28,0
66081,508,136,372,157,91,22,9,399,190,209,61,41,39,18,0
66082,345,203,142,47,35,31,11,504,272,232,75,57,53,19,0
66083,641,349,292,92,60,39,24,376,183,193,50,50,43,21,0
66084,328,195,133,36,23,35,9,654,295,359,99,88,71,25,0
66085,570,238,332,112,95,39,23,257,126,131,61,24,22,8,0
66086,180,92,88,29,20,26,8,172,88,84,24,31,20,12,0
66087,1171,542,629,170,146,114,64,403,221,182,62,50,42,12,0
66088,265,165,100,32,19,27,5,385,212,173,57,40,39,21,0
66089,426,231,195,51,52,45,24,792,398,394,109,96,90,39,0
66090,979,534,445,83,77,80,24,286,160,126,37,27,23,10,0
66091,320,163,157,44,44,26,15,792,398,394,109,96,90,39,0
66092,685,393,292,75,66,113,16,514,262,252,78,58,54,26,0
66093,238,158,80,28,15,31,7,309,159,150,47,43,43,13,0
66094,756,362,394,102,104,73,25,332,173,159,48,40,31,11,0
66095,288,104,184,80,30,39,6,597,269,328,102,84,69,24,0
66096,521,289,232,71,58,49,16,260,131,129,42,31,40,9,0
66097,323,156,167,52,45,39,18,415,205,210,77,52,55,17,0
66098,282,135,147,27,37,30,19,378,154,224,74,84,35,22,0
66099,598,322,276,67,57,63,26,627,323,304,81,90,53,27,0
66100,743,366,377,41,37,26,14,368,183,185,40,42,40,15,0
66101,196,107,89,20,31,17,4,408,221,187,55,51,57,14,0
66102,384,198,186,58,48,37,12,584,249,335,80,96,22,13,0
66103,474,243,231,66,54,41,29,467,231,236,71,65,58,18,0
66104,301,157,144,31,28,34,9,89,51,38,15,15,5,4,0
66105,526,228,298,69,64,32,30,821,394,427,122,117,109,38,0
66106,1009,487,522,177,121,103,51,455,229,226,66,62,63,29,0
66107,199,113,86,27,17,10,7,866,478,388,121,101,101,26,0
66108,1174,594,580,175,155,126,66,422,237,185,53,47,62,20,0
66109,527,276,251,64,60,70,20,279,161,118,37,32,7,7,0
66110,246,111,135,64,47,27,3,403,233,170,38,29,21,14,0
66111,328,195,133,36,23,35,9,1543,794,749,182,152,132,55,0
66112,126,57,69,31,10,10,3,508,261,247,65,53,58,23,0
66113,1130,614,516,129,138,98,42,429,187,242,79,72,28,19,0
66114,545,221,324,101,72,55,30,180,89,91,28,27,18,7,0
66115,1462,711,751,219,222,148,65,267,141,126,53,27,23,7,0
66116,118,56,62,24,12,6,9,520,244,276,91,60,68,20,0
66117,1867,973,894,256,222,194,65,163,79,84,22,24,13,5,0
66118,894,448,446,123,100,82,30,621,310,311,100,106,77,27,0
66119,1464,693,771,153,136,91,86,283,142,141,41,33,26,18,0
66120,206,96,110,33,25,8,6,441,189,252,73,50,47,23,0
66121,130,71,59,30,9,8,1,418,223,195,53,43,49,15,0
66122,1339,494,845,216,298,92,37,482,232,250,77,81,44,13,0
66123,1464,693,771,153,136,91,86,406,202,204,54,51,63,21,0
66124,429,238,191,47,49,56,29,192,110,82,33,21,10,3,0
66125,526,228,298,69,64,32,30,332,155,177,55,51,44,13,0
66126,350,190,160,48,25,27,18,180,90,90,31,19,20,8,0
66127,521,289,232,71,58,49,16,1922,923,999,267,275,215,90,0
66128,388,209,179,46,24,31,28,441,189,252,73,50,47,23,0
66129,281,154,127,45,31,24,9,106,46,60,29,13,14,5,0
66130,474,250,224,58,47,37,12,137,78,59,22,16,17,4,0
66131,833,295,538,146,139,65,34,392,155,237,68,61,34,16,0
66132,580,265,315,97,89,79,17,1500,804,696,190,172,144,60,0
66133,99,35,64,25,18,0,1,1062,522,540,151,147,105,66,0
66134,2062,706,1356,414,368,158,63,287,151,136,51,42,36,7,0
66135,247,128,119,40,21,27,11,403,221,182,47,41,47,8,0
66136,92,46,46,14,9,8,6,873,411,462,132,107,84,40,0
66137,373,194,179,42,54,26,13,246,107,139,55,33,27,11,0
66138,279,129,150,43,34,17,13,395,169,226,73,55,38,9,0
66139,496,274,222,57,43,75,22,496,285,211,62,54,46,22,0
66140,1130,614,516,129,138,98,42,332,155,177,55,51,44,13,0
66141,186,56,130,46,50,16,7,270,162,108,26,26,16,11,0
66142,546,285,261,71,49,47,24,239,113,126,36,49,20,8,0
66143,243,100,143,58,50,24,5,756,348,408,101,103,60,40,0
66144,226,120,106,68,8,2,1,392,155,237,68,61,34,16,0
66145,2063,1024,1039,175,117,80,97,737,397,340,87,104,90,14,0
66146,461,207,254,82,66,55,33,225,129,96,32,33,20,8,0
66147,571,298,273,81,72,57,25,301,168,133,49,37,34,11,0
66148,373,164,209,51,45,44,21,1321,653,668,186,195,70,35,0
66149,237,127,110,34,30,16,9,127,54,73,11,33,15,6,0
66150,490,224,266,80,70,39,32,647,324,323,101,80,76,43,0
66151,119,67,52,15,15,7,7,199,92,107,34,30,18,9,0
66152,1217,647,570,142,160,129,45,947,482,465,143,107,89,37,0
66153,265,165,100,32,19,27,5,773,389,384,119,91,79,26,0
66154,305,124,181,27,25,32,21,487,252,235,79,58,55,26,0
66155,267,146,121,40,24,25,7,234,129,105,31,22,19,17,0
66156,1001,422,579,185,180,51,32,187,89,98,36,24,20,6,0
66157,802,430,372,65,102,87,23,469,225,244,64,68,25,11,0
66158,476,254,222,58,33,46,23,250,119,131,58,26,29,7,0
66159,260,133,127,43,29,34,11,188,105,83,25,17,24,7,0
66160,461,207,254,82,66,55,33,201,93,108,34,39,21,6,0
66161,71,28,43,15,9,5,2,555,292,263,75,63,67,27,0
66162,335,171,164,51,38,38,10,1323,690,633,132,178,112,61,0
66163,416,207,209,63,47,56,15,231,126,105,37,26,29,6,0
66164,524,361,163,41,8,28,16,86,40,46,16,13,9,7,0
66165,627,237,390,137,57,108,44,180,108,72,22,22,15,5,0
66166,333,171,162,50,34,19,8,424,179,245,65,67,29,11,0
66167,103,56,47,27,7,8,2,410,197,213,67,43,56,18,0
66168,343,189,154,44,24,39,12,1208,565,643,182,162,120,57,0
66169,747,360,387,125,92,69,32,107,77,30,7,2,9,5,0
66170,401,236,165,53,38,34,9,1922,923,999,267,275,215,90,0
66171,269,156,113,37,32,17,7,250,119,131,58,26,29,7,0
66172,526,268,258,54,37,55,12,320,168,152,38,42,24,18,0
66173,233,110,123,34,22,34,9,1382,508,874,334,320,98,36,0
66174,210,101,109,33,33,19,9,408,221,187,55,51,57,14,0
66175,584,340,244,77,60,47,25,368,204,164,43,35,30,24,0
66176,298,141,157,51,33,21,22,509,267,242,79,81,38,20,0
66177,517,196,321,103,98,33,12,1700,731,969,198,233,110,87,0
66178,366,190,176,39,62,55,14,203,98,105,34,29,19,10,0
66179,130,70,60,30,9,8,1,536,267,269,60,70,41,22,0
66180,764,277,487,158,162,64,31,131,55,76,28,9,14,12,0
66181,172,82,90,21,35,21,5,549,273,276,74,68,72,24,0
66182,285,148,137,31,42,42,16,54,26,28,11,4,3,3,0
66183,262,133,129,44,38,31,12,386,181,205,55,51,57,31,0
66184,480,267,213,49,44,70,21,260,131,129,42,31,40,9,0
66185,898,397,501,102,98,54,37,452,231,221,74,53,56,20,0
66186,1221,597,624,201,152,83,31,1543,794,749,182,152,132,55,0
66187,180,57,123,39,22,10,8,744,385,359,105,96,57,31,0
66188,521,289,232,71,58,49,16,374,202,172,50,39,31,24,0
66189,432,190,242,85,82,28,11,329,196,133,41,36,31,15,0
66190,361,183,178,50,54,51,22,376,183,193,50,50,43,21,0
66191,67,40,27,10,8,7,6,172,79,93,34,27,23,10,0
66192,369,207,162,67,35,16,14,621,310,311,100,106,77,27,0
66193,500,257,243,60,55,27,22,405,181,224,71,57,31,12,0
66194,150,64,86,22,12,29,12,904,436,468,143,118,108,32,0
66195,181,92,89,34,22,17,9,201,98,103,28,25,19,13,0
66196,1047,443,604,162,156,78,52,1065,581,484,134,97,76,46,0
66197,234,108,126,42,40,15,9,260,133,127,43,32,39,3,0
66198,436,201,235,54,37,35,18,309,164,145,35,47,30,11,0
66199,482,245,237,69,64,66,24,935,515,420,126,107,73,32,0
66200,503,260,243,46,56,33,16,373,181,192,54,35,44,20,0
66201,178,74,104,31,28,9,4,188,88,100,53,12,15,6,0
66202,1014,488,526,178,137,94,39,175,91,84,19,21,21,10,0
66203,421,219,202,68,57,56,13,720,357,363,113,85,62,39,0
66204,329,171,158,49,41,31,10,171,94,77,24,28,30,11,0
66205,772,417,355,118,92,80,23,403,192,211,102,39,49,15,0
66206,414,216,198,51,32,42,28,295,160,135,42,37,46,16,0
66207,464,237,227,64,66,33,12,390,223,167,58,36,45,18,0
66208,2000,965,1035,357,313,198,75,279,142,137,43,39,28,7,0
66209,808,366,442,130,133,66,31,199,92,107,34,30,18,9,0
66210,342,150,192,52,43,31,17,367,218,149,45,43,42,16,0
66211,284,128,156,48,29,34,8,332,180,152,46,36,28,14,0
66212,603,311,292,102,71,66,23,107,77,30,7,2,9,5,0
66213,808,366,442,130,133,66,31,892,475,417,130,108,68,38,0
66214,200,94,106,33,22,18,8,200,89,111,26,25,17,7,0
66215,111,29,82,10,54,0,1,307,132,175,48,53,26,10,0
66216,786,378,408,106,98,77,39,231,126,105,37,26,29,6,0
66217,392,205,187,83,49,38,10,972,471,501,152,138,112,40,0
66218,651,357,294,81,67,103,18,231,126,105,37,26,29,6,0
66219,496,209,287,112,55,71,14,679,338,341,96,95,40,23,0
66220,437,228,209,47,61,26,11,457,245,212,62,58,57,21,0
66221,384,198,186,58,48,37,12,720,361,359,98,98,70,37,0
66222,347,181,166,27,20,12,12,188,105,83,25,17,24,7,0
66223,329,165,164,61,44,29,17,220,107,113,36,35,28,9,0
66224,210,84,126,44,43,9,4,889,505,384,107,97,99,30,0
66225,650,330,320,93,93,51,28,2000,965,1035,357,313,198,75,0
66226,233,107,126,40,40,20,16,598,333,265,79,66,54,33,0
66227,535,315,220,57,55,71,19,479,215,264,67,80,46,28,0
66228,428,226,202,52,60,75,20,381,186,195,69,55,46,15,0
66229,249,114,135,47,33,25,4,597,269,328,102,84,69,24,0
66230,228,105,123,34,43,20,10,526,266,260,76,75,53,22,0
66231,717,381,336,118,103,85,29,766,386,380,101,81,78,31,0
66232,598,322,276,67,57,63,26,173,90,83,21,36,12,15,0
66233,284,160,124,37,23,32,11,316,159,157,38,48,30,11,0
66234,129,70,59,29,9,7,2,89,42,47,16,12,15,6,0
66235,1130,614,516,129,138,98,42,1262,653,609,169,165,152,50,0
66236,574,269,305,91,63,54,27,292,143,149,38,42,36,16,0
66237,255,126,129,41,37,13,5,403,185,218,67,62,63,19,0
66238,450,231,219,77,50,76,16,232,111,121,23,29,17,9,0
66239,803,358,445,135,117,80,43,392,186,206,62,56,29,15,0
66240,861,393,468,150,101,69,35,601,278,323,124,87,65,21,0
66241,441,216,225,57,66,57,19,94,45,49,11,20,10,4,0
66242,869,489,380,110,77,79,29,978,536,442,132,107,67,32,0
66243,157,62,95,41,18,10,11,601,278,323,124,87,65,21,0
66244,607,294,313,94,95,62,14,559,317,242,58,65,37,23,0
66245,484,264,220,59,62,68,15,557,281,276,80,59,43,21,0
66246,727,426,301,79,71,64,32,230,125,105,29,40,20,6,0
66247,258,126,132,38,22,29,8,152,71,81,41,16,14,2,0
66248,425,199,226,54,71,56,11,483,215,268,66,70,30,16,0
66249,785,325,460,114,123,61,28,1500,804,696,190,172,144,60,0
66250,402,169,233,70,36,34,18,317,161,156,40,49,41,11,0
66251,333,171,162,50,34,19,8,708,328,380,113,100,82,34,0
66252,71,39,32,7,11,6,4,775,407,368,122,100,97,32,0
66253,2109,999,1110,332,294,187,89,207,114,93,33,20,31,13,0
66254,288,140,148,59,33,27,12,665,361,304,87,91,84,31,0
66255,476,254,222,58,33,46,23,222,122,100,39,32,24,9,0
66256,1555,702,853,250,199,139,31,297,175,122,46,30,31,6,0
66257,437,228,209,47,61,26,11,264,138,126,33,34,29,12,0
66258,67,40,27,10,8,7,6,453,247,206,58,53,45,20,0
66259,631,304,327,98,75,52,23,332,173,159,48,40,31,11,0
66260,475,208,267,84,67,50,20,455,229,226,66,62,63,29,0
66261,484,194,290,70,93,47,16,395,169,226,73,55,38,9,0
66262,106,43,63,28,13,8,1,663,360,303,87,82,80,35,0
66263,242,104,138,41,33,37,8,843,391,452,139,104,91,35,0
66264,419,210,209,54,44,31,23,68,23,45,12,9,3,9,0
66265,431,199,232,59,54,40,17,497,257,240,71,63,62,16,0
66266,184,88,96,15,40,17,8,605,283,322,94,72,64,39,0
66267,682,292,390,89,69,58,20,200,89,111,26,25,17,7,0
66268,299,128,171,57,40,13,25,261,127,134,36,27,36,4,0
66269,462,233,229,66,49,43,30,149,52,97,36,36,7,4,0
66270,335,171,164,51,38,38,10,231,126,105,28,26,34,9,0
66271,820,333,487,202,152,59,23,260,133,127,43,32,39,3,0
66272,1107,601,506,155,138,103,49,179,101,78,25,15,13,13,0
66273,136,66,70,33,11,9,3,323,162,161,52,41,39,13,0
66274,217,98,119,38,35,18,9,258,129,129,45,24,31,10,0
66275,815,356,459,128,125,82,26,256,141,115,32,22,32,8,0
66276,586,298,288,80,75,64,37,453,255,198,62,49,29,19,0
66277,484,194,290,70,93,47,16,497,227,270,70,63,66,30,0
66278,118,56,62,24,12,6,9,400,187,213,56,59,42,20,0
66279,485,237,248,83,35,52,24,457,253,204,67,51,48,13,0
66280,524,262,262,62,72,39,49,963,525,438,119,102,102,34,0
66281,348,198,150,57,25,37,18,693,360,333,100,88,62,26,0
66282,746,312,434,129,115,77,47,296,140,156,49,40,42,19,0
66283,524,361,163,41,8,28,16,926,425,501,159,147,77,35,0
66284,413,236,177,41,25,35,19,508,253,255,73,60,50,13,0
66285,1112,457,655,180,164,99,39,2346,1231,1115,316,292,266,105,0
66286,894,448,446,123,100,82,30,166,90,76,27,18,21,5,0
66287,496,210,286,112,55,72,13,953,489,464,126,104,111,44,0
66288,1221,597,624,201,152,83,31,101,59,42,11,17,10,1,0
66289,281,125,156,44,47,17,7,337,152,185,49,54,42,21,0
66290,330,77,253,86,52,20,12,245,131,114,30,27,18,13,0
66291,1390,585,805,241,230,118,46,234,116,118,34,35,23,9,0
66292,422,207,215,79,38,53,23,1040,564,476,134,110,114,51,0
66293,298,141,157,51,33,21,22,432,244,188,51,51,27,14,0
66294,895,388,507,130,84,90,31,89,42,47,16,12,15,6,0
66295,218,133,85,20,19,13,6,406,202,204,54,51,63,21,0
66296,1163,417,746,209,145,87,28,465,252,213,73,58,60,18,0
66297,319,153,166,61,52,26,12,548,273,275,84,81,64,30,0
66298,425,220,205,60,55,45,18,1698,875,823,222,219,173,64,0
66299,308,129,179,44,60,19,8,501,257,244,75,57,48,29,0
66300,130,71,59,30,9,8,1,1182,591,591,155,139,83,46,0
66301,1249,543,706,187,164,125,52,439,231,208,65,51,55,17,0
66302,3230,1724,1506,361,358,157,75,337,152,185,49,54,42,21,0
66303,666,204,462,110,194,42,14,314,151,163,42,61,39,16,0
66304,343,189,154,44,24,39,12,953,489,464,126,104,111,44,0
66305,466,259,207,59,50,83,12,972,471,501,152,138,112,40,0
66306,411,171,240,61,81,30,15,463,268,195,59,46,46,21,0
66307,364,204,160,65,35,15,13,171,94,77,24,28,30,11,0
66308,711,330,381,111,86,86,34,295,160,135,42,37,46,16,0
66309,379,217,162,47,20,50,23,317,161,156,50,36,47,12,0
66310,394,207,187,52,42,37,24,445,264,181,35,35,34,14,0
66311,329,171,158,49,41,31,10,138,69,69,28,7,10,10,0
66312,473,217,256,59,44,34,21,200,89,111,26,25,17,7,0
66313,919,493,426,100,92,88,49,277,124,153,44,40,35,18,0
66314,255,110,145,34,32,23,17,222,127,95,23,28,22,7,0
66315,753,361,392,99,94,66,16,149,68,81,15,38,11,10,0
66316,466,199,267,86,59,32,17,247,128,119,34,14,16,14,0
66317,915,336,579,185,199,56,29,88,50,38,13,8,16,4,0
66318,461,207,254,82,66,55,33,455,229,226,66,62,63,29,0
66319,452,202,250,83,60,56,19,1543,794,749,182,152,132,55,0
66320,1590,726,864,270,237,126,59,132,67,65,24,21,8,10,0
66321,485,237,248,83,35,52,24,190,93,97,35,27,23,2,0
66322,840,411,429,122,101,79,34,246,107,139,55,33,27,11,0
66323,745,402,343,95,71,69,40,303,138,165,47,46,35,18,0
66324,2174,1057,1117,241,241,214,117,538,274,264,84,67,52,35,0
66325,193,90,103,44,9,19,13,152,71,81,41,16,14,2,0
66326,456,223,233,77,54,47,20,862,426,436,113,115,84,37,0
66327,789,362,427,90,82,70,35,225,114,111,32,29,26,6,0
66328,1189,653,536,152,118,109,56,292,143,149,38,42,36,16,0
66329,270,131,139,47,37,41,11,398,200,198,68,43,51,14,0
66330,524,270,254,84,72,70,23,732,402,330,81,86,87,33,0
66331,207,93,114,20,33,19,10,267,141,126,53,27,23,7,0
66332,302,160,142,35,35,37,10,328,199,129,39,29,27,14,0
66333,204,103,101,16,32,22,8,54,26,28,11,4,3,3,0
66334,490,224,266,80,70,39,32,165,87,78,24,19,22,9,0
66335,687,351,336,106,67,70,41,218,115,103,37,33,33,9,0
66336,410,209,201,72,30,48,22,1154,489,665,200,196,95,54,0
66337,881,492,389,87,97,59,51,405,195,210,57,74,24,17,0
66338,2696,1169,1527,432,347,193,146,531,277,254,82,75,33,22,0
66339,372,189,183,60,44,41,18,232,111,121,23,29,17,9,0
66340,494,242,252,67,47,25,21,172,88,84,24,31,20,12,0
66341,346,191,155,52,38,40,13,201,104,97,36,32,24,7,0
66342,107,56,51,18,16,12,5,306,157,149,52,35,39,16,0
66343,404,197,207,60,48,47,20,94,45,49,11,20,10,4,0
66344,369,207,162,67,35,16,14,662,373,289,89,80,77,29,0
66345,431,202,229,57,50,50,25,89,38,51,14,6,3,9,0
66346,446,283,163,51,26,33,19,457,242,215,39,46,53,10,0
66347,178,89,89,40,12,18,7,297,164,133,45,39,40,9,0
66348,323,142,181,67,26,45,33,284,111,173,47,34,47,42,0
66349,532,254,278,91,48,23,17,663,354,309,91,84,79,31,0
66350,410,209,201,72,30,48,22,761,351,410,117,73,103,45,0
66351,932,575,357,94,69,76,40,720,361,359,98,98,70,37,0
66352,560,279,281,113,64,58,15,328,195,133,39,40,27,13,0
66353,407,230,177,44,39,34,19,277,144,133,42,30,41,8,0
66354,210,84,126,44,43,9,4,723,363,360,107,106,52,14,0
66355,240,99,141,53,38,29,15,131,55,76,28,9,14,12,0
66356,346,205,141,47,34,30,7,335,186,149,40,28,29,13,0
66357,941,459,482,167,140,82,38,354,188,166,46,40,34,10,0
66358,126,66,60,24,10,7,9,892,475,417,130,108,68,38,0
66359,177,100,77,22,17,20,11,2136,1063,1073,317,308,223,90,0
66360,600,324,276,89,73,45,39,278,154,124,42,32,38,7,0
66361,538,263,275,71,85,44,18,149,77,72,37,10,20,5,0
66362,639,368,271,72,51,38,38,132,61,71,19,20,14,6,0
66363,519,259,260,86,78,59,22,331,180,151,46,35,47,17,0
66364,2414,1189,1225,277,178,170,169,344,190,154,34,31,36,10,0
66365,531,260,271,97,68,47,11,329,196,133,41,36,31,15,0
66366,425,198,227,57,69,59,13,660,333,327,102,95,69,31,0
66367,466,199,267,86,59,32,17,242,124,118,39,32,28,22,0
66368,1009,478,531,166,126,96,42,778,391,387,94,77,41,33,0
66369,398,186,212,76,70,18,13,266,150,116,28,28,24,12,0
66370,640,308,332,91,102,49,21,199,105,94,27,27,28,9,0
66371,146,75,71,13,32,15,11,783,406,377,102,91,57,29,0
66372,132,66,66,21,18,11,7,336,200,136,34,29,25,24,0
66373,103,56,47,27,7,8,2,329,196,133,41,36,31,15,0
66374,390,199,191,72,42,35,12,368,183,185,40,42,40,15,0
66375,124,58,66,20,28,11,7,582,264,318,84,60,58,23,0
66376,259,119,140,48,28,29,19,374,174,200,54,52,42,21,0
66377,389,176,213,81,59,24,7,378,154,224,74,84,35,22,0
66378,708,344,364,106,98,66,33,609,335,274,79,57,45,22,0
66379,524,262,262,62,72,39,49,378,154,224,74,84,35,22,0
66380,127,62,65,13,33,7,6,602,310,292,87,66,70,36,0
66381,126,57,69,31,10,10,3,633,311,322,94,82,45,20,0
66382,424,170,254,69,56,47,28,1323,690,633,132,178,112,61,0
66383,179,96,83,24,8,26,4,374,191,183,40,52,40,16,0
66384,626,308,318,105,89,77,25,1239,659,580,169,148,131,54,0
66385,685,393,292,75,66,113,16,218,117,101,35,32,34,12,0
66386,282,163,119,40,23,25,17,164,79,85,28,28,16,7,0
66387,1004,498,506,94,59,46,33,516,245,271,82,84,70,26,0
66388,369,166,203,59,55,41,14,142,73,69,27,9,15,11,0
66389,106,43,63,28,13,8,1,107,77,30,7,2,9,5,0
66390,369,207,162,67,35,16,14,124,69,55,14,7,9,4,0
66391,3859,2011,1848,535,391,422,207,470,205,265,71,80,33,11,0
66392,343,162,181,65,38,29,12,452,254,198,72,57,38,18,0
66393,517,196,321,103,98,33,12,469,225,244,64,68,25,11,0
66394,172,82,90,21,35,21,5,105,51,54,13,17,12,8,0
66395,422,196,226,52,35,33,20,611,314,297,79,75,78,22,0
66396,501,230,271,63,90,50,18,308,146,162,42,39,24,12,0
66397,126,56,70,31,10,10,3,903,436,467,128,116,83,33,0
66398,344,168,176,50,39,30,20,386,207,179,43,48,44,19,0
66399,2286,1154,1132,338,314,278,103,773,389,384,119,91,79,26,0
66400,594,248,346,104,109,53,5,1696,771,925,257,225,149,63,0
66401,1501,679,822,251,196,174,67,2225,1244,981,271,243,217,93,0
66402,522,302,220,61,49,75,19,611,314,297,79,75,78,22,0
66403,625,283,342,93,89,67,25,149,77,72,37,10,20,5,0
66404,278,104,174,46,34,23,14,660,303,357,97,89,85,33,0
66405,335,183,152,40,26,54,22,1606,753,853,215,227,182,48,0
66406,126,56,70,31,10,10,3,663,360,303,87,82,80,35,0
66407,1439,713,726,195,180,110,34,111,60,51,17,23,10,7,0
66408,351,166,185,48,61,24,15,421,219,202,68,57,56,13,0
66409,57,24,33,11,3,5,3,535,311,224,66,52,49,24,0
66410,454,214,240,56,71,35,16,286,160,126,37,27,23,10,0
66411,458,210,248,39,38,25,16,445,192,253,86,58,53,18,0
66412,319,153,166,61,52,26,12,926,425,501,159,147,77,35,0
66413,369,166,203,59,55,41,14,199,105,94,27,27,28,9,0
66414,1105,544,561,165,167,99,40,518,292,226,60,60,52,21,0
66415,252,121,131,42,34,12,16,761,351,410,117,73,103,45,0
66416,729,351,378,111,98,58,18,180,90,90,31,19,20,8,0
66417,193,90,103,44,9,19,13,400,187,213,56,59,42,20,0
66418,406,207,199,56,46,68,19,445,192,253,86,58,53,18,0
66419,732,355,377,108,109,79,27,362,156,206,74,42,36,22,0
66420,451,225,226,69,57,64,22,1020,538,482,145,115,111,58,0
66421,589,282,307,68,67,70,23,396,223,173,57,37,44,19,0
66422,255,110,145,34,32,23,17,142,65,77,30,17,22,9,0
66423,260,138,122,44,30,28,6,496,285,211,62,54,46,22,0
66424,496,274,222,57,43,75,22,328,195,133,39,40,27,13,0
66425,331,177,154,54,38,27,11,415,226,189,51,40,40,29,0
66426,727,426,301,79,71,64,32,579,285,294,78,72,64,32,0
66427,524,262,262,62,72,39,49,810,310,500,164,162,42,26,0
66428,200,94,106,33,22,18,8,87,51,35,15,9,9,4,0
66429,193,107,86,13,20,13,6,524,300,223,70,54,51,25,0
66430,1872,837,1035,280,338,169,80,1047,562,485,141,127,114,41,0
66431,478,177,301,109,66,59,25,295,156,139,41,40,42,15,0
66432,373,164,209,51,45,44,21,295,158,137,42,34,38,14,0
66433,215,80,135,54,56,21,9,218,115,103,32,32,34,11,0
66434,478,220,258,47,70,41,10,294,146,148,50,45,51,15,0
66435,292,102,190,71,27,51,21,124,69,55,14,7,9,4,0
66436,431,202,229,57,50,50,25,107,77,30,7,2,9,5,0
66437,317,167,150,45,21,30,26,501,240,261,80,62,49,42,0
66438,373,164,209,51,45,44,21,203,98,105,34,29,19,10,0
66439,625,283,342,93,89,67,25,396,197,199,75,49,49,16,0
66440,548,310,238,72,62,54,13,384,212,172,44,43,34,14,0
66441,1214,498,716,197,180,121,65,1114,539,575,145,131,94,56,0
66442,219,116,103,66,7,2,1,629,317,312,80,87,51,22,0
66443,1257,464,793,221,264,75,37,89,38,51,14,6,3,9,0
66444,347,212,135,35,32,17,6,360,185,175,51,43,36,16,0
66445,927,457,470,130,99,118,42,423,234,189,66,44,57,12,0
66446,919,493,426,100,92,88,49,396,197,199,75,49,49,16,0
66447,282,105,177,77,28,39,6,727,388,339,102,87,70,29,0
66448,552,295,257,67,49,70,30,295,158,137,42,34,38,14,0
66449,166,59,107,36,41,10,4,205,94,111,48,31,15,6,0
66450,146,75,71,13,32,15,11,72,34,38,8,2,3,12,0
66451,231,105,126,56,10,24,10,423,234,189,66,44,57,12,0
66452,603,311,292,102,71,66,23,671,321,350,95,87,75,34,0
66453,1189,653,536,152,118,109,56,452,231,221,74,53,56,20,0
66454,486,243,243,65,48,63,22,405,181,224,71,57,31,12,0
66455,204,103,101,16,32,22,8,548,273,275,84,81,64,30,0
66456,422,196,226,52,35,33,20,715,348,367,109,84,68,30,0
66457,407,230,177,44,39,34,19,265,134,131,48,34,33,15,0
66458,1030,438,592,184,104,108,30,180,95,85,22,21,17,8,0
66459,261,137,124,34,23,13,8,403,185,218,67,62,63,19,0
66460,1058,497,561,194,142,87,63,232,111,121,23,29,17,9,0
66461,1276,607,669,192,178,136,63,633,311,322,94,82,45,20,0
66462,1099,491,608,163,141,107,62,228,130,98,35,29,30,10,0
66463,331,169,162,40,28,22,14,520,244,276,91,60,68,20,0
66464,1208,575,633,187,204,117,41,173,94,79,18,24,12,7,0
66465,350,212,138,32,26,40,13,405,195,210,57,74,24,17,0
66466,488,237,251,79,78,65,27,1061,543,518,146,123,109,67,0
66467,71,28,43,15,9,5,2,367,218,149,45,43,42,16,0
66468,743,366,377,41,37,26,14,169,84,85,29,19,21,7,0
66469,450,227,223,53,36,48,12,326,169,157,51,41,41,12,0
66470,520,261,259,74,52,49,22,481,223,258,71,70,49,26,0
66471,349,131,218,66,76,22,9,98,49,49,14,15,9,2,0
66472,433,188,245,63,45,26,14,227,130,97,32,25,22,12,0
66473,502,250,252,70,47,57,15,274,142,132,33,34,18,14,0
66474,585,277,308,92,73,61,32,414,203,211,58,56,48,14,0
66475,332,173,159,48,42,42,9,374,174,200,54,52,42,21,0
66476,1759,838,921,269,212,191,92,322,180,142,45,38,28,7,0
66477,536,237,299,116,87,42,17,391,189,202,55,56,56,12,0
66478,745,402,343,95,71,69,40,245,131,114,30,27,18,13,0
66479,684,353,331,95,98,77,38,339,180,159,36,29,16,16,0
66480,684,353,331,95,98,77,38,518,292,226,60,60,52,21,0
66481,595,339,256,64,36,54,24,283,160,123,25,20,37,9,0
66482,328,195,133,36,23,35,9,65,32,33,16,4,8,3,0
66483,658,349,309,77,70,73,35,975,475,500,139,140,119,28,0
66484,502,274,228,64,49,75,17,147,74,73,28,20,24,4,0
66485,411,202,209,60,67,57,24,583,280,303,95,66,76,25,0
66486,250,123,127,40,28,29,8,975,400,575,160,162,62,31,0
66487,425,198,227,57,69,59,13,866,397,469,117,153,95,48,0
66488,828,368,460,118,98,59,38,222,122,100,39,32,24,9,0
66489,200,103,97,17,16,10,10,492,278,214,65,58,32,11,0
66490,522,302,220,61,49,75,19,127,58,69,18,17,10,5,0
66491,869,489,380,110,77,79,29,748,359,389,125,113,86,31,0
66492,129,70,59,29,9,7,2,621,310,311,100,106,77,27,0
66493,1143,574,569,176,151,123,59,2547,1280,1267,331,335,293,118,0
66494,389,176,213,81,59,24,7,583,280,303,95,66,76,25,0
66495,753,361,392,99,94,66,16,351,166,185,48,61,24,15,0
66496,508,251,257,74,53,51,18,445,202,243,70,73,51,15,0
66497,755,271,484,113,226,61,20,555,292,263,75,63,67,27,0
66498,139,81,58,17,14,24,9,247,128,119,34,14,16,14,0
66499,447,225,222,76,35,75,21,132,61,71,19,20,14,6,0
66500,414,216,198,51,32,42,28,508,261,247,65,53,58,23,0
66501,911,445,466,154,121,108,48,173,94,79,18,24,12,7,0
66502,441,218,223,69,55,50,27,792,398,394,109,96,90,39,0
66503,666,204,462,110,194,42,14,106,54,52,12,9,7,6,0
66504,267,146,121,40,24,25,7,662,373,289,89,80,77,29,0
66505,333,171,162,50,34,19,8,439,227,212,60,55,58,8,0
66506,238,158,80,28,15,31,7,811,361,450,124,107,80,31,0
66507,241,122,119,27,34,17,16,247,128,119,34,14,16,14,0
66508,794,322,472,122,108,79,34,397,223,174,50,39,29,17,0
66509,454,214,240,56,71,35,16,748,359,389,125,113,86,31,0
66510,607,305,302,92,89,74,23,598,333,265,79,66,54,33,0
66511,312,173,139,43,47,28,6,437,224,213,40,29,42,25,0
66512,1365,590,775,257,168,136,93,169,85,84,21,14,9,9,0
66513,504,222,282,71,64,53,29,147,74,73,28,20,24,4,0
66514,351,166,185,48,61,24,15,391,165,226,67,64,36,27,0
66515,1249,543,706,187,164,125,52,293,142,151,49,40,42,17,0
66516,269,124,145,36,24,32,11,1262,653,609,169,165,152,50,0
66517,432,190,242,85,82,28,11,169,74,95,33,26,22,3,0
66518,520,261,259,74,52,49,22,396,199,197,54,50,45,14,0
66519,458,226,232,77,59,61,14,130,67,63,24,10,12,4,0
66520,1058,497,561,194,142,87,63,396,213,183,68,44,47,18,0
66521,552,285,267,74,51,69,24,748,355,393,121,91,95,26,0
66522,900,434,466,134,97,86,36,766,386,380,101,81,78,31,0
66523,478,220,258,47,70,41,10,103,44,59,16,17,9,5,0
66524,202,113,89,16,27,21,11,622,344,278,80,77,68,36,0
66525,983,449,534,95,77,55,36,132,61,71,22,21,15,3,0
66526,959,496,463,144,132,75,35,335,170,165,52,36,47,11,0
66527,359,167,192,49,37,27,19,640,364,276,84,68,69,33,0
66528,425,198,227,57,69,59,13,106,54,52,12,9,7,6,0
66529,351,166,185,48,61,24,15,447,232,215,55,65,50,25,0
66530,364,168,196,64,61,27,6,297,175,122,46,30,31,6,0
66531,579,246,333,102,79,41,19,381,196,185,55,57,43,16,0
66532,739,389,350,129,61,69,25,246,107,139,55,33,27,11,0
66533,107,53,54,15,15,13,4,106,46,60,29,13,14,5,0
66534,598,322,276,67,57,63,26,132,61,71,22,21,15,3,0
66535,911,489,422,121,98,97,36,583,280,303,95,66,76,25,0
66536,232,134,98,28,20,20,5,261,148,113,31,28,14,10,0
66537,433,188,245,63,45,26,14,317,161,156,50,36,47,12,0
66538,407,207,200,53,36,38,8,704,355,349,113,94,71,24,0
66539,384,198,186,58,48,37,12,297,175,122,46,30,31,6,0
66540,188,84,104,35,36,18,9,858,398,460,126,138,75,39,0
66541,341,183,158,36,34,36,15,843,391,452,139,104,91,35,0
66542,963,477,486,134,143,123,38,862,409,453,149,125,86,29,0
66543,282,163,119,40,23,25,17,72,32,40,8,2,2,13,0
66544,392,221,171,53,30,25,8,163,79,84,22,24,13,5,0
66545,109,42,67,25,13,1,1,135,65,70,21,25,15,9,0
66546,285,148,137,31,42,42,16,601,278,323,124,87,65,21,0
66547,447,225,222,76,35,75,21,926,425,501,159,147,77,35,0
66548,269,127,142,43,24,34,26,1248,584,664,184,164,155,67,0
66549,961,465,496,139,156,62,34,245,131,114,30,27,18,13,0
66550,508,251,257,74,53,51,18,132,61,71,19,20,14,6,0
66551,695,343,352,96,78,62,22,337,170,167,59,33,47,17,0
66552,207,89,118,56,8,4,3,602,310,292,87,66,70,36,0
66553,427,191,236,67,60,41,34,374,202,172,50,39,31,24,0
66554,505,282,223,60,57,66,23,627,323,304,81,90,53,27,0
66555,666,204,462,110,194,42,14,384,204,180,53,47,49,17,0
66556,391,204,187,47,48,38,18,583,321,262,73,67,45,25,0
66557,445,231,214,45,64,53,23,376,183,193,50,50,43,21,0
66558,202,103,99,28,20,12,8,478,254,224,67,74,56,28,0
66559,264,122,142,46,24,35,10,418,223,195,51,45,49,14,0
66560,207,128,79,26,17,19,9,565,237,328,75,88,32,11,0
66561,500,257,243,60,55,27,22,690,345,345,96,83,73,42,0
66562,347,212,135,35,32,17,6,160,60,100,23,40,19,11,0
66563,2414,1189,1225,277,178,170,169,154,78,76,23,21,13,5,0
66564,178,74,104,31,28,9,4,445,264,181,35,35,34,14,0
66565,235,100,135,36,25,30,8,1425,670,755,153,189,122,85,0
66566,828,355,473,126,134,77,37,583,321,262,73,67,45,25,0
66567,434,221,213,58,47,54,15,780,337,443,112,116,77,28,0
66568,629,374,255,74,53,87,27,701,380,321,94,84,96,34,0
66569,127,62,65,13,33,7,6,171,94,77,24,28,30,11,0
66570,904,436,468,138,146,82,39,296,159,137,49,28,38,13,0
66571,803,358,445,135,117,80,43,201,117,83,22,21,19,9,0
66572,181,75,106,35,26,11,9,462,229,233,63,49,42,18,0
66573,1047,443,604,162,156,78,52,198,110,88,27,27,24,4,0
66574,414,206,208,56,68,35,19,551,226,325,96,103,43,11,0
66575,227,109,118,42,35,29,8,403,225,178,56,38,33,25,0
66576,136,66,70,33,11,9,4,501,257,244,75,57,48,29,0
66577,624,222,402,92,81,39,15,246,107,139,55,33,27,11,0
66578,126,57,69,31,10,10,3,300,148,152,45,43,40,8,0
66579,203,80,123,40,37,20,3,354,188,166,46,40,34,10,0
66580,288,140,148,59,33,27,12,403,225,178,56,38,33,25,0
66581,598,322,276,67,57,63,26,763,418,345,113,84,59,32,0
66582,766,336,430,133,97,79,21,439,227,212,60,55,58,8,0
66583,4640,2231,2409,660,549,437,245,630,321,309,86,90,57,26,0
66584,760,405,355,112,95,92,29,978,536,442,132,107,67,32,0
66585,463,250,213,56,45,73,25,516,245,271,82,84,70,26,0
66586,457,261,196,55,27,57,34,792,398,394,109,96,90,39,0
66587,911,489,422,121,98,97,36,373,189,184,54,46,50,23,0
66588,793,355,438,134,117,77,43,385,188,197,57,42,36,16,0
66589,135,64,71,31,11,8,4,187,89,98,36,24,20,6,0
66590,594,279,315,93,68,68,26,289,140,149,33,42,30,15,0
66591,743,366,377,41,37,26,14,332,155,177,55,51,44,13,0
66592,456,223,233,77,54,47,20,132,61,71,19,20,14,6,0
66593,160,53,107,31,29,13,3,348,212,136,53,31,25,18,0
66594,667,366,301,96,55,84,25,385,212,173,57,40,39,21,0
66595,357,182,175,49,36,39,15,601,278,323,124,87,65,21,0
66596,2414,1189,1225,277,178,170,169,305,161,144,39,40,44,17,0
66597,305,124,181,27,25,32,21,413,223,190,52,45,53,10,0
66598,283,172,111,39,31,29,8,244,143,101,31,29,26,8,0
66599,979,534,445,83,77,80,24,373,213,160,44,33,26,17,0
66600,476,276,200,57,34,43,16,710,375,335,95,94,110,28,0
66601,904,436,468,138,146,82,39,240,141,99,34,28,29,8,0
66602,235,100,135,36,25,30,8,858,461,397,125,114,79,45,0
66603,242,111,131,35,35,17,13,773,389,384,119,91,79,26,0
66604,1064,495,569,157,159,124,58,294,146,148,50,45,51,15,0
66605,1112,457,655,180,164,99,39,780,337,443,112,116,77,28,0
66606,820,333,487,202,152,59,23,244,143,101,31,29,26,8,0
66607,432,233,199,52,28,47,18,862,426,436,113,115,84,37,0
66608,510,288,222,44,36,24,7,207,113,94,33,18,30,9,0
66609,335,183,152,40,26,54,22,341,170,171,41,66,27,10,0
66610,395,219,176,47,41,50,18,370,173,197,65,57,42,10,0
66611,726,312,414,121,73,82,23,65,32,33,16,4,8,3,0
66612,553,276,277,88,61,45,27,607,293,314,98,71,62,32,0
66613,745,402,343,95,71,69,40,198,110,88,27,27,24,4,0
66614,331,144,187,57,46,33,19,295,160,135,44,36,46,16,0
66615,55,16,39,24,2,5,2,336,200,136,34,29,25,24,0
66616,627,237,390,137,57,108,44,363,180,183,60,34,10,6,0
66617,431,216,215,46,40,33,9,417,232,185,58,50,29,21,0
66618,164,77,87,33,19,6,7,270,130,140,48,44,37,12,0
66619,552,285,267,74,51,69,24,401,204,197,49,33,29,17,0
66620,733,382,351,126,92,93,27,1248,584,664,184,164,155,67,0
66621,109,50,59,12,12,9,3,1378,692,686,194,174,105,56,0
66622,482,231,251,76,81,64,26,188,93,95,33,18,16,10,0
66623,3859,2011,1848,535,391,422,207,509,267,242,79,81,38,20,0
66624,279,127,152,50,36,28,8,1425,670,755,153,189,122,85,0
66625,520,240,280,87,63,67,16,267,141,126,53,27,23,7,0
66626,328,195,133,36,23,35,9,173,90,83,21,36,12,15,0
66627,714,260,454,140,97,120,54,1323,690,633,132,178,112,61,0
66628,583,279,304,99,71,59,31,135,57,78,21,20,9,11,0
66629,1087,523,564,146,177,103,33,470,205,265,71,80,33,11,0
66630,480,232,248,73,40,44,30,134,72,62,14,28,8,4,0
66631,1441,504,937,264,329,69,46,679,338,341,96,95,40,23,0
66632,162,73,89,32,19,4,4,201,98,103,28,25,19,13,0
66633,479,227,252,69,48,46,18,515,276,239,62,59,43,31,0
66634,270,147,123,34,17,39,21,737,397,340,87,104,90,14,0
66635,1171,542,629,170,146,114,64,447,212,235,86,55,58,21,0
66636,517,196,321,103,98,33,12,267,141,126,53,27,23,7,0
66637,132,66,66,21,18,11,7,2542,1245,1297,285,287,170,84,0
66638,494,233,261,87,57,46,18,390,190,200,66,50,43,12,0
66639,805,338,467,153,138,99,55,370,190,180,60,52,37,13,0
66640,953,421,532,131,131,70,37,773,389,384,119,91,79,26,0
66641,510,288,222,44,36,24,7,166,88,78,23,18,13,7,0
66642,320,183,137,51,18,38,8,445,264,181,35,35,34,14,0
66643,603,311,292,102,71,66,23,818,357,461,122,136,54,25,0
66644,684,353,331,95,98,77,38,234,129,105,31,22,19,17,0
66645,447,236,211,56,52,49,14,693,360,333,100,88,62,26,0
66646,589,282,307,68,67,70,23,127,58,69,18,17,10,5,0
66647,1555,702,853,250,199,139,31,397,223,174,50,39,29,17,0
66648,130,72,58,28,9,7,1,166,102,64,19,14,17,2,0
66649,640,308,332,91,102,49,21,328,199,129,39,29,27,14,0
66650,310,141,169,36,38,20,8,2202,1121,1081,338,274,269,81,0
66651,687,351,336,106,67,70,41,413,223,190,52,45,53,10,0
66652,346,173,173,50,56,31,14,205,94,111,48,31,15,6,0
66653,136,66,70,33,11,9,3,457,253,204,67,51,48,13,0
66654,270,147,123,34,17,39,21,536,267,269,60,70,41,22,0
66655,1007,353,654,277,147,70,26,846,425,421,125,97,98,38,0
66656,327,174,153,42,35,16,12,89,38,51,14,6,3,9,0
66657,458,226,232,77,59,61,14,846,425,421,125,97,98,38,0
66658,585,277,308,92,73,61,32,344,190,154,34,31,36,10,0
66659,275,155,120,37,31,16,14,958,451,507,165,135,97,41,0
66660,126,57,69,31,10,10,3,526,266,260,76,75,53,22,0
66661,772,417,355,118,92,80,23,621,273,348,104,102,48,19,0
66662,71,28,43,15,9,5,2,517,295,222,69,62,40,28,0
66663,1336,724,612,209,141,133,60,65,32,33,16,4,8,3,0
66664,480,267,213,49,44,70,21,1873,935,938,233,225,203,79,0
66665,378,202,176,34,32,44,13,102,51,51,12,15,12,3,0
66666,413,169,244,66,94,28,19,393,210,183,58,37,34,20,0
66667,361,183,178,50,54,51,22,189,95,94,25,33,16,8,0
66668,341,175,166,48,43,35,18,425,177,248,60,62,33,16,0
66669,793,355,438,134,117,77,43,375,211,164,50,36,31,23,0
66670,154,74,80,18,19,7,2,427,251,176,51,39,25,22,0
66671,629,338,291,92,57,64,22,142,65,77,30,17,22,9,0
66672,856,429,427,113,105,96,24,756,348,408,101,103,60,40,0
66673,206,100,106,34,26,11,7,180,89,91,28,27,18,7,0
66674,207,128,79,26,17,19,9,292,143,149,38,42,36,16,0
66675,1441,504,937,264,329,69,46,1323,690,633,132,178,112,61,0
66676,470,163,307,99,68,73,30,457,253,204,67,51,48,13,0
66677,139,64,75,18,17,18,4,348,194,154,57,31,43,12,0
66678,2220,1085,1135,312,304,202,91,404,190,214,55,55,35,27,0
66679,164,77,87,33,19,6,7,360,180,180,57,48,39,12,0
66680,860,349,511,166,166,58,19,154,78,76,23,21,13,5,0
66681,2335,1200,1135,374,268,340,83,499,239,260,73,75,34,19,0
66682,439,241,198,67,40,40,13,661,325,336,81,75,65,28,0
66683,398,186,212,76,70,18,13,2202,1121,1081,338,274,269,81,0
66684,331,169,162,40,28,22,14,441,189,252,73,50,47,23,0
66685,301,157,144,31,28,34,9,530,287,243,79,70,33,26,0
66686,282,160,122,36,28,27,7,1248,584,664,184,164,155,67,0
66687,615,308,307,83,75,58,32,498,244,254,81,67,58,19,0
66688,1872,837,1035,280,338,169,80,463,268,195,59,46,46,21,0
66689,1143,574,569,176,151,123,59,294,146,148,50,45,51,15,0
66690,565,264,301,101,73,72,15,209,119,90,28,24,27,9,0
66691,126,56,70,31,10,10,3,520,244,276,91,60,68,20,0
66692,280,128,152,39,37,38,18,562,273,289,76,92,45,24,0
66693,399,220,179,48,37,68,18,128,63,65,30,11,13,8,0
66694,465,220,245,88,34,61,23,338,169,169,53,44,39,21,0
66695,315,111,204,82,66,46,11,359,171,188,49,74,45,11,0
66696,347,212,135,35,32,17,6,572,305,267,74,72,58,21,0
66697,619,289,330,67,77,36,19,547,295,252,81,65,57,23,0
66698,594,279,315,93,68,68,26,661,325,336,81,75,65,28,0
66699,1221,597,624,201,152,83,31,524,300,223,70,54,51,25,0
66700,415,133,282,114,65,27,7,354,183,171,54,43,49,8,0
66701,1001,422,579,185,180,51,32,380,211,169,47,37,33,21,0
66702,170,82,88,32,23,22,8,106,46,60,27,18,12,3,0
66703,507,314,193,49,45,59,25,297,175,122,46,30,31,6,0
66704,772,332,440,136,104,72,28,467,240,227,65,65,51,23,0
66705,272,136,136,32,34,12,12,362,156,206,74,42,36,22,0
66706,215,80,135,54,56,21,9,662,373,289,89,80,77,29,0
66707,456,214,242,76,62,52,22,137,85,52,15,11,11,2,0
66708,1835,904,931,192,144,135,63,514,262,252,78,58,54,26,0
66709,860,348,512,121,136,75,35,423,234,189,66,44,57,12,0
66710,1647,794,853,279,235,128,65,107,77,30,7,2,9,5,0
66711,517,245,272,92,77,46,24,223,113,110,31,33,22,12,0
66712,426,213,213,60,56,46,24,132,61,71,22,21,15,3,0
66713,4128,2104,2024,581,505,453,205,555,282,273,82,69,65,21,0
66714,476,199,277,82,80,49,24,261,162,99,24,21,14,10,0
66715,567,256,311,91,81,53,17,421,222,199,69,50,60,18,0
66716,92,46,46,14,9,8,6,175,82,93,33,26,17,5,0
66717,711,330,381,111,86,86,34,900,441,459,125,127,110,32,0
66718,401,204,197,49,33,29,17,947,482,465,143,107,89,37,0
66719,349,131,218,66,76,22,9,464,236,228,64,56,53,28,0
66720,250,123,127,40,28,29,8,165,90,75,36,18,20,6,0
66721,802,430,372,65,102,87,23,223,113,110,31,33,22,12,0
66722,240,98,142,49,42,23,17,663,354,309,91,84,79,31,0
66723,432,233,199,52,28,47,18,536,251,285,75,79,60,23,0
66724,895,388,507,130,84,90,31,173,90,83,21,36,12,15,0
66725,465,240,225,50,54,24,14,846,425,421,125,97,98,38,0
66726,356,199,157,36,43,28,12,283,142,141,41,33,26,18,0
66727,708,344,364,106,98,66,33,245,121,124,37,35,36,12,0
66728,167,70,97,32,20,15,7,798,385,413,120,115,79,30,0
66729,640,271,369,111,79,57,17,265,134,131,48,34,33,15,0
66730,483,236,247,82,60,43,18,198,86,112,36,27,23,9,0
66731,129,70,59,29,9,7,2,54,26,28,11,4,3,3,0
66732,446,283,163,51,26,33,19,292,143,149,38,42,36,16,0
66733,119,67,52,15,15,7,7,483,215,268,66,70,30,16,0
66734,154,74,80,18,19,7,2,292,143,149,38,42,36,16,0
66735,755,271,484,113,226,61,20,660,332,328,84,73,47,19,0
66736,243,70,173,54,65,8,6,376,183,193,50,50,43,21,0
66737,587,318,269,76,50,38,21,858,461,397,125,114,79,45,0
66738,230,114,116,30,33,29,8,514,262,252,78,58,54,26,0
66739,1835,904,931,192,144,135,63,86,40,46,16,13,9,7,0
66740,414,206,208,56,68,35,19,329,194,135,45,32,33,9,0
66741,752,313,439,121,106,68,27,139,68,71,14,26,14,9,0
66742,99,35,64,25,18,0,1,293,142,151,49,40,42,17,0
66743,560,279,281,113,64,58,15,541,279,262,79,82,31,32,0
66744,241,122,119,27,34,17,16,423,234,189,66,44,57,12,0
66745,206,100,106,34,26,11,7,363,180,183,60,34,10,6,0
66746,798,287,511,126,125,77,26,332,180,152,44,36,27,13,0
66747,130,70,60,30,9,8,1,375,209,166,50,37,29,23,0
66748,1208,575,633,187,204,117,41,312,165,147,41,39,29,16,0
66749,207,93,114,20,33,19,10,234,129,105,31,22,19,17,0
66750,886,440,446,116,140,95,45,1166,514,652,150,159,107,70,0
66751,331,144,187,57,46,33,19,261,127,134,36,27,36,4,0
66752,373,164,209,51,45,44,21,1352,602,750,166,185,81,70,0
66753,233,110,123,34,22,34,9,278,154,124,42,32,38,7,0
66754,1001,422,579,185,180,51,32,756,348,408,101,103,60,40,0
66755,550,304,246,60,64,77,16,406,234,172,63,35,43,10,0
66756,297,161,136,36,35,24,9,107,77,30,7,2,9,5,0
66757,2174,1057,1117,241,241,214,117,348,194,154,57,31,43,12,0
66758,736,320,416,113,97,61,36,403,185,218,67,62,63,19,0
66759,473,217,256,59,44,34,21,926,425,501,159,147,77,35,0
66760,346,208,138,46,39,51,18,501,274,227,63,58,53,20,0
66761,1594,660,934,251,272,117,77,1378,692,686,194,174,105,56,0
66762,261,130,131,27,41,19,16,137,85,52,15,11,11,2,0
66763,452,217,235,59,47,60,20,403,192,211,102,39,49,15,0
66764,1121,458,663,158,210,76,47,1314,693,621,174,155,140,58,0
66765,583,279,304,99,71,59,31,729,358,371,116,99,89,33,0
66766,317,167,150,45,21,30,26,166,102,64,19,14,17,2,0
66767,413,206,207,38,55,19,10,778,391,387,94,77,41,33,0
66768,340,145,195,46,38,26,23,375,176,199,48,61,40,12,0
66769,1217,647,570,142,160,129,45,323,171,152,48,41,40,16,0
66770,533,300,233,74,50,74,17,1182,591,591,155,139,83,46,0
66771,328,195,133,36,23,35,9,218,115,103,37,33,33,9,0
66772,4640,2231,2409,660,549,437,245,1004,457,547,150,150,74,52,0
66773,346,174,172,36,43,21,9,98,49,49,14,15,9,2,0
66774,688,310,378,130,82,78,47,904,436,468,143,118,108,32,0
66775,546,285,261,71,49,47,24,374,191,183,40,52,40,16,0
66776,186,56,130,46,50,16,7,427,251,176,51,39,25,22,0
66777,425,220,205,60,55,45,18,664,350,314,86,90,82,36,0
66778,2696,1169,1527,432,347,193,146,106,46,60,27,18,12,3,0
66779,688,310,378,130,82,78,47,270,162,108,26,26,16,11,0
66780,2000,965,1035,357,313,198,75,135,65,70,21,25,15,9,0
66781,522,302,220,61,49,75,19,166,78,88,27,25,19,7,0
66782,456,223,233,77,54,47,20,123,61,62,17,18,17,7,0
66783,1120,436,684,208,120,101,115,169,74,95,33,26,22,3,0
66784,269,124,145,36,24,32,11,418,223,195,53,43,49,15,0
66785,126,56,70,31,10,10,3,419,233,186,54,53,55,17,0
66786,246,123,123,40,31,27,7,158,71,87,23,21,17,12,0
66787,496,272,224,70,58,42,18,328,195,133,39,40,27,13,0
66788,347,181,166,27,20,12,12,748,359,389,125,113,86,31,0
66789,361,177,184,59,51,24,15,507,270,237,89,59,57,22,0
66790,219,100,119,40,29,21,3,866,478,388,121,101,101,26,0
66791,301,156,145,32,25,15,5,178,99,79,31,19,26,8,0
66792,76,30,46,7,15,1,5,136,65,71,26,11,7,5,0
66793,1447,698,749,214,180,116,46,207,113,94,33,18,30,9,0
66794,688,310,378,130,82,78,47,368,204,164,43,35,30,24,0
66795,539,283,256,75,73,53,26,903,436,467,128,116,83,33,0
66796,852,461,391,109,102,72,24,107,77,30,7,2,9,5,0
66797,446,265,181,51,35,27,17,152,71,81,41,16,14,2,0
66798,203,80,123,40,37,20,3,633,311,322,94,82,45,20,0
66799,736,353,383,117,83,71,18,165,90,75,36,18,20,6,0
66800,380,185,195,68,54,32,16,265,134,131,48,34,33,15,0
66801,398,186,212,76,70,18,13,467,231,236,71,65,58,18,0
66802,452,202,250,83,60,56,19,600,254,346,104,100,44,17,0
66803,128,67,61,29,9,9,1,583,321,262,73,67,45,25,0
66804,496,210,286,111,55,74,13,295,156,139,41,40,42,15,0
66805,465,305,160,40,47,34,9,381,186,195,69,55,46,15,0
66806,538,263,275,71,85,44,18,265,134,131,48,34,33,15,0
66807,161,94,67,23,13,8,10,780,337,443,112,116,77,28,0
66808,480,257,223,74,26,60,27,305,161,144,39,40,44,17,0
66809,260,136,124,24,41,19,4,127,66,61,13,14,19,8,0
66810,318,164,154,52,43,34,10,520,272,248,60,65,58,22,0
66811,1759,838,921,269,212,191,92,2547,1280,1267,331,335,293,118,0
66812,291,142,149,50,29,35,7,198,113,85,19,20,26,12,0
66813,852,461,391,109,102,72,24,164,79,85,28,28,16,7,0
66814,215,104,111,61,7,2,1,975,400,575,160,162,62,31,0
66815,86,50,36,9,14,8,7,843,391,452,139,104,91,35,0
66816,438,185,253,71,64,52,28,471,238,233,66,63,62,19,0
66817,124,58,66,20,28,11,7,105,51,54,13,17,12,8,0
66818,442,254,188,46,22,40,19,536,251,285,75,79,60,23,0
66819,282,135,147,27,37,30,19,535,288,247,79,72,35,21,0
66820,615,308,307,83,75,58,32,898,469,429,125,125,134,35,0
66821,329,171,158,49,41,31,10,325,159,166,59,46,30,12,0
66822,496,210,286,111,55,74,13,452,254,198,72,57,38,18,0
66823,546,265,281,101,64,38,16,397,234,163,44,38,23,21,0
66824,297,161,136,36,35,24,9,620,324,296,81,68,66,31,0
66825,1360,644,716,213,194,136,62,163,79,84,22,24,13,5,0
66826,1341,481,860,275,264,57,21,408,221,187,55,51,57,14,0
66827,961,465,496,139,156,62,34,166,102,64,19,14,17,2,0
66828,320,183,137,51,18,38,8,390,190,200,66,50,43,12,0
66829,577,342,235,63,57,23,37,419,233,186,54,53,55,17,0
66830,193,110,83,18,20,15,12,898,469,429,125,125,134,35,0
66831,256,152,104,18,23,23,8,565,237,328,75,88,32,11,0
66832,484,192,292,118,68,83,22,360,185,175,51,43,36,16,0
66833,297,161,136,36,35,24,9,629,317,312,80,87,51,22,0
66834,510,288,222,44,36,24,7,469,225,244,64,68,25,11,0
66835,199,107,92,41,15,14,8,459,260,199,56,42,47,21,0
66836,784,353,431,56,47,26,18,408,221,187,55,51,57,14,0
66837,338,164,174,45,32,37,13,775,407,368,122,100,97,32,0
66838,493,281,212,56,61,30,13,403,233,170,38,29,21,14,0
66839,616,304,312,75,71,55,25,766,386,380,101,81,78,31,0
66840,540,252,288,73,67,57,20,339,180,159,36,29,16,16,0
66841,650,330,320,97,77,65,28,188,88,100,53,12,15,6,0
66842,412,193,219,69,57,43,14,375,209,166,50,37,29,23,0
66843,610,249,361,107,69,72,33,572,305,267,74,72,58,21,0
66844,375,201,174,52,56,39,15,359,171,188,49,74,45,11,0
66845,343,162,181,65,38,29,12,647,350,297,95,79,77,29,0
66846,196,107,89,20,31,17,4,368,200,168,54,49,43,9,0
66847,2446,1099,1347,363,294,233,100,378,154,224,74,84,35,22,0
66848,90,54,36,20,4,14,5,526,266,260,76,75,53,22,0
66849,1085,646,439,108,65,36,19,405,214,191,53,42,49,20,0
66850,411,236,175,39,45,50,30,780,337,443,112,116,77,28,0
66851,423,247,176,58,55,29,20,1700,731,969,198,233,110,87,0
66852,2663,1073,1590,548,499,192,64,98,49,49,14,15,9,2,0
66853,454,230,224,63,56,38,33,329,196,133,41,36,31,15,0
66854,583,279,304,99,71,59,31,452,254,198,72,57,38,18,0
66855,643,284,359,129,71,84,43,395,169,226,73,55,38,9,0
66856,517,196,321,103,98,33,12,274,157,117,40,29,40,8,0
66857,2236,1195,1041,227,187,186,118,461,223,238,45,62,18,35,0
66858,813,412,401,114,93,112,26,199,92,107,34,30,18,9,0
66859,798,287,511,126,125,77,26,620,324,296,81,68,66,31,0
66860,126,58,68,31,10,10,3,209,119,90,28,24,27,9,0
66861,538,263,275,71,85,44,18,520,272,248,60,65,58,22,0
66862,734,339,395,135,89,78,36,204,80,124,29,51,10,5,0
66863,399,196,203,62,45,38,19,256,141,115,32,22,32,8,0
66864,312,164,148,54,29,25,15,188,101,87,20,18,20,14,0
66865,1121,458,663,158,210,76,47,963,455,508,127,130,115,48,0
66866,594,321,273,98,59,57,23,299,140,159,49,44,26,11,0
66867,313,148,165,45,33,36,11,339,175,164,51,49,37,9,0
66868,422,207,215,79,38,53,23,218,114,104,32,31,33,11,0
66869,336,134,202,51,64,27,12,91,44,47,9,12,4,7,0
66870,2414,1189,1225,277,178,170,169,925,439,486,141,134,105,46,0
66871,1143,574,569,176,151,123,59,267,141,126,53,27,23,7,0
66872,431,199,232,59,54,40,17,773,389,384,119,91,79,26,0
66873,407,207,200,53,36,38,8,386,181,205,55,51,57,31,0
66874,130,72,58,28,9,7,1,601,279,322,81,65,27,12,0
66875,2525,1232,1293,398,317,186,61,164,79,85,28,28,16,7,0
66876,359,204,155,39,36,34,13,429,187,242,79,72,28,19,0
66877,393,223,170,44,36,32,14,201,93,108,34,39,21,6,0
66878,641,349,292,92,60,39,24,285,146,139,41,41,48,13,0
66879,763,354,409,101,90,63,26,509,267,242,79,81,38,20,0
66880,179,78,101,29,22,10,8,756,348,408,101,103,60,40,0
66881,631,304,327,98,75,52,23,501,257,244,75,57,48,29,0
66882,714,260,454,140,97,120,54,323,168,155,51,41,38,12,0
66883,347,198,149,45,29,29,8,1378,692,686,194,174,105,56,0
66884,853,400,453,137,109,88,42,1248,584,664,184,164,155,67,0
66885,330,77,253,86,52,20,12,396,199,197,54,50,45,14,0
66886,361,171,190,44,40,18,13,462,251,211,74,53,41,18,0
66887,579,281,298,91,78,74,27,142,73,69,27,9,15,11,0
66888,371,209,162,46,17,36,19,1214,475,739,177,250,89,49,0
66889,526,228,298,69,64,32,30,344,190,154,34,31,36,10,0
66890,292,102,190,71,27,51,21,461,223,238,45,62,18,35,0
66891,103,56,47,27,7,8,2,334,181,153,41,40,25,15,0
66892,758,363,395,114,102,34,13,420,216,204,57,41,45,14,0
66893,446,174,272,84,61,57,23,528,188,340,130,58,77,41,0
66894,710,352,358,104,86,84,41,172,88,84,24,31,20,12,0
66895,502,229,273,63,66,40,31,501,257,244,75,57,48,29,0
66896,149,68,81,15,38,11,10,528,188,340,130,58,77,41,0
66897,478,177,301,109,66,59,25,375,176,199,48,61,40,12,0
66898,420,202,218,67,43,51,15,201,99,102,34,26,23,6,0
66899,545,221,324,101,72,55,30,445,192,253,86,58,53,18,0
66900,1098,519,579,182,159,79,42,87,38,49,23,10,10,9,0
66901,199,113,86,27,17,10,7,457,242,215,39,46,53,10,0
66902,498,274,224,58,59,50,18,397,234,163,44,38,23,21,0
66903,178,74,104,31,28,9,4,457,245,212,62,58,57,21,0
66904,339,170,169,32,17,24,13,344,190,154,34,31,36,10,0
66905,126,56,70,31,10,10,3,775,407,368,122,100,97,32,0
66906,103,56,47,27,7,8,2,267,141,126,53,27,23,7,0
66907,503,260,243,46,56,33,16,309,159,150,47,43,43,13,0
66908,317,140,177,43,26,31,16,131,55,76,28,9,14,12,0
66909,745,402,343,95,71,69,40,374,191,183,40,52,40,16,0
66910,436,201,235,54,37,35,18,241,127,114,34,33,29,12,0
66911,1542,682,860,290,158,120,47,264,138,126,33,34,29,12,0
66912,349,131,218,66,76,22,9,341,170,171,41,66,27,10,0
66913,1590,726,864,270,237,126,59,295,158,137,42,34,38,14,0
66914,329,168,161,48,34,41,16,469,225,244,64,68,25,11,0
66915,1186,495,691,182,208,88,32,583,280,303,95,66,76,25,0
66916,490,224,266,80,70,39,32,2547,1280,1267,331,335,293,118,0
66917,411,202,209,60,67,57,24,1698,875,823,222,219,173,64,0
66918,535,315,220,57,55,71,19,715,348,367,109,84,68,30,0
66919,482,245,237,69,64,66,24,418,246,172,52,39,57,10,0
66920,224,108,116,33,26,32,10,295,158,137,42,34,38,14,0
66921,595,316,279,86,60,65,40,403,233,170,38,29,21,14,0
66922,306,172,134,35,31,37,18,1239,659,580,169,148,131,54,0
66923,458,210,248,39,38,25,16,496,285,211,62,54,46,22,0
66924,756,362,394,102,104,73,25,329,194,135,45,32,33,9,0
66925,1120,436,684,208,120,101,115,385,212,173,57,40,39,21,0
66926,401,236,165,53,38,34,9,385,212,173,57,40,39,21,0
66927,513,276,237,73,43,57,24,480,255,225,67,64,50,22,0
66928,125,53,72,18,21,18,12,385,188,197,57,42,36,16,0
66929,262,133,129,44,38,31,12,339,175,164,51,49,37,9,0
66930,361,171,190,44,40,18,13,325,172,153,44,34,27,14,0
66931,1054,453,601,183,183,107,35,514,248,266,86,82,52,22,0
66932,146,73,73,18,24,17,9,320,168,152,38,42,24,18,0
66933,224,101,123,45,32,21,3,391,189,202,55,56,56,12,0
66934,302,178,124,34,29,50,13,201,104,97,36,32,24,7,0
66935,607,305,302,92,89,74,23,153,80,73,26,18,19,4,0
66936,326,176,150,35,22,29,11,207,86,121,34,39,11,13,0
66937,444,250,194,58,21,60,23,339,180,159,36,29,16,16,0
66938,356,199,157,36,43,28,12,198,110,88,27,27,24,4,0
66939,1342,640,702,187,163,123,57,457,245,212,62,58,57,21,0
66940,126,56,70,31,10,10,3,904,436,468,143,118,108,32,0
66941,180,57,123,39,22,10,8,445,264,181,35,35,34,14,0
66942,501,230,271,63,90,50,18,266,150,116,28,28,24,12,0
66943,707,250,457,171,84,117,61,72,32,40,8,2,2,13,0
66944,548,250,298,85,64,56,21,160,76,84,19,24,8,5,0
66945,908,324,584,181,162,81,29,303,137,166,54,54,31,15,0
66946,155,85,70,17,16,4,8,671,321,350,95,87,75,34,0
66947,1849,931,918,245,220,158,90,541,279,262,79,82,31,32,0
66948,736,353,383,117,83,71,18,375,176,199,48,61,40,12,0
66949,209,75,134,53,48,20,9,1323,690,633,132,178,112,61,0
66950,431,199,232,59,54,40,17,392,155,237,68,61,34,16,0
66951,531,259,272,75,81,39,13,482,232,250,77,81,44,13,0
66952,667,366,301,96,55,84,25,561,279,282,85,81,88,24,0
66953,130,71,59,30,9,8,1,172,79,93,34,27,23,10,0
66954,463,250,213,56,45,73,25,858,398,460,126,138,75,39,0
66955,411,171,240,61,81,30,15,548,273,275,84,81,64,30,0
66956,281,125,156,44,47,17,7,376,189,187,47,53,44,26,0
66957,1390,705,685,219,164,129,74,858,461,397,125,114,79,45,0
66958,563,255,308,91,111,42,30,144,67,77,28,14,9,8,0
66959,407,230,177,44,39,34,19,166,88,78,23,18,13,7,0
66960,531,284,247,66,42,49,15,128,63,65,30,11,13,8,0
66961,1505,680,825,202,204,73,32,173,86,87,30,22,19,12,0
66962,375,167,208,55,83,44,9,630,321,309,86,90,57,26,0
66963,332,172,160,50,33,35,9,478,254,224,67,74,56,28,0
66964,233,110,123,34,22,34,9,103,59,44,25,2,13,6,0
66965,736,320,416,113,97,61,36,360,185,175,51,43,36,16,0
66966,736,353,383,117,83,71,18,763,418,345,113,84,59,32,0
66967,2663,1073,1590,548,499,192,64,555,292,263,75,63,67,27,0
66968,346,191,155,52,38,40,13,2202,1121,1081,338,274,269,81,0
66969,2048,855,1193,297,287,191,93,276,149,127,34,31,32,10,0
66970,1462,711,751,219,222,148,65,601,278,323,124,87,65,21,0
66971,261,137,124,34,23,13,8,153,65,88,28,21,20,8,0
66972,347,198,149,45,29,29,8,662,312,350,103,104,59,20,0
66973,828,368,460,118,98,59,38,173,86,87,30,22,19,12,0
66974,727,426,301,79,71,64,32,975,400,575,160,162,62,31,0
66975,146,73,73,18,24,17,9,106,41,65,36,6,11,7,0
66976,3703,1708,1995,456,428,305,162,422,202,220,80,52,57,18,0
66977,346,208,138,46,39,51,18,498,244,254,81,67,58,19,0
66978,1336,724,612,209,141,133,60,332,180,152,46,36,28,14,0
66979,384,198,186,58,48,37,12,260,131,129,42,31,40,9,0
66980,431,245,186,50,23,46,17,780,337,443,112,116,77,28,0
66981,329,168,161,48,34,41,16,843,391,452,139,104,91,35,0
66982,130,70,60,30,9,8,1,418,223,195,51,45,49,14,0
66983,435,225,210,58,46,50,14,427,251,176,51,39,25,22,0
66984,746,312,434,129,115,77,47,662,312,350,103,104,59,20,0
66985,167,70,97,32,20,15,7,404,190,214,55,55,35,27,0
66986,347,198,149,45,29,29,8,547,295,252,81,65,57,23,0
66987,119,67,52,15,15,7,7,495,217,278,79,64,44,22,0
66988,342,150,192,52,43,31,17,329,194,135,45,32,33,9,0
66989,272,94,178,76,33,19,4,296,151,145,45,42,32,11,0
66990,280,156,124,36,19,20,13,644,343,301,96,69,59,28,0
66991,334,190,144,42,42,16,5,286,152,134,38,38,32,11,0
66992,732,355,377,108,109,79,27,649,304,345,99,80,67,40,0
66993,535,217,318,87,106,41,14,145,77,68,26,7,15,8,0
66994,410,211,199,55,42,34,27,346,178,168,58,41,33,12,0
66995,401,204,197,49,33,29,17,467,231,236,71,65,58,18,0
66996,575,290,285,67,70,28,9,166,102,64,19,14,17,2,0
66997,193,110,83,18,20,15,12,1382,508,874,334,320,98,36,0
66998,90,54,36,20,4,14,5,339,175,164,51,49,37,9,0
66999,531,260,271,97,68,47,11,963,525,438,119,102,102,34,0
67000,953,421,532,131,131,70,37,277,124,153,44,40,35,18,0
67001,334,190,144,42,42,16,5,2346,1231,1115,316,292,266,105,0
67002,682,260,422,98,83,42,31,199,92,107,34,30,18,9,0
67003,170,82,88,32,23,22,8,72,34,38,8,2,3,12,0
67004,199,107,92,41,15,14,8,1425,670,755,153,189,122,85,0
67005,1711,865,846,204,176,105,60,621,310,311,100,106,77,27,0
67006,1105,544,561,165,167,99,40,504,272,232,75,57,53,19,0
67007,282,105,177,77,28,39,6,246,107,139,55,33,27,11,0
67008,1339,494,845,216,298,92,37,296,140,156,49,40,42,19,0
67009,531,259,272,75,81,39,13,87,51,35,15,9,9,4,0
67010,260,138,122,44,30,28,6,287,151,136,51,42,36,7,0
67011,144,57,87,38,26,10,4,662,373,289,89,80,77,29,0
67012,798,364,434,133,88,74,35,548,273,275,84,81,64,30,0
67013,306,172,134,35,31,37,18,148,84,64,30,7,17,4,0
67014,465,220,245,88,34,61,23,584,249,335,80,96,22,13,0
67015,421,237,184,47,54,45,10,295,160,135,44,36,46,16,0
67016,276,149,127,45,34,39,9,201,99,102,34,26,23,6,0
67017,279,127,152,50,36,28,8,378,154,224,74,84,35,22,0
67018,474,250,224,58,47,37,12,169,74,95,33,26,22,3,0
67019,246,123,123,40,31,27,7,470,205,265,71,80,33,11,0
67020,317,167,150,45,21,30,26,198,86,112,36,27,23,9,0
67021,273,126,147,54,49,25,18,132,61,71,22,21,15,3,0
67022,165,66,99,28,32,16,3,373,181,192,54,35,44,20,0
67023,260,133,127,43,29,34,11,290,142,148,41,37,43,11,0
67024,429,227,202,49,51,46,26,222,127,95,23,28,22,7,0
67025,284,128,156,48,29,34,8,693,360,333,100,88,62,26,0
67026,687,351,336,106,67,70,41,415,203,212,77,44,49,18,0
67027,763,354,409,101,90,63,26,744,385,359,105,96,57,31,0
67028,404,197,207,60,48,47,20,758,319,439,101,123,78,25,0
67029,364,172,192,55,57,32,15,1249,638,611,166,153,141,45,0
67030,325,186,139,49,36,20,5,295,156,139,41,40,42,15,0
67031,82,36,46,17,10,5,1,704,355,349,113,94,71,24,0
67032,472,222,250,46,61,33,23,406,223,183,61,53,46,17,0
67033,960,409,551,166,134,77,44,96,46,50,16,12,7,5,0
67034,801,331,470,151,139,99,55,561,279,282,85,81,88,24,0
67035,271,110,161,33,27,11,8,617,314,303,96,68,68,37,0
67036,610,249,361,107,69,72,33,903,436,467,128,116,83,33,0
67037,862,384,478,127,110,75,42,395,169,226,73,55,38,9,0
67038,388,209,179,46,24,31,28,756,348,408,101,103,60,40,0
67039,600,324,276,89,73,45,39,72,32,40,8,2,1,14,0
67040,118,56,62,24,12,6,9,230,113,117,31,40,28,10,0
67041,837,443,394,129,89,87,38,792,398,394,109,96,90,39,0
67042,911,441,470,123,108,60,21,328,199,129,39,29,27,14,0
67043,161,75,86,24,20,10,7,131,55,76,28,9,14,12,0
67044,130,71,59,30,9,8,1,2542,1245,1297,285,287,170,84,0
67045,71,39,32,7,11,6,4,163,79,84,22,24,13,5,0
67046,2624,999,1625,415,495,109,84,463,259,204,62,55,34,22,0
67047,207,89,118,56,8,4,3,337,170,167,59,33,47,17,0
67048,651,357,294,81,67,103,18,496,251,245,78,62,61,23,0
67049,348,198,150,57,25,37,18,437,221,216,62,64,47,13,0
67050,594,279,315,93,68,68,26,127,58,69,18,17,10,5,0
67051,467,233,234,83,37,77,22,720,361,359,98,98,70,37,0
67052,852,472,380,99,79,70,27,663,354,309,91,84,79,31,0
67053,398,186,212,76,70,18,13,405,195,210,57,74,24,17,0
67054,496,210,286,112,55,71,14,111,60,51,17,23,10,7,0
67055,1174,594,580,175,155,126,66,329,194,135,45,32,33,9,0
67056,422,196,226,52,35,33,20,189,105,84,25,26,21,9,0
67057,2063,1024,1039,175,117,80,97,2517,1275,1242,304,324,245,135,0
67058,1590,726,864,270,237,126,59,135,65,70,21,25,15,9,0
67059,419,210,209,54,44,31,23,386,207,179,43,48,44,19,0
67060,158,85,73,24,18,18,8,514,248,266,86,82,52,22,0
67061,766,336,430,133,97,79,21,1279,669,610,164,162,104,55,0
67062,346,173,173,50,56,31,14,396,213,183,68,44,47,18,0
67063,567,256,311,91,81,53,17,538,274,264,84,67,52,35,0
67064,550,304,246,60,64,77,16,4646,2328,2318,674,639,475,170,0
67065,1208,575,633,187,204,117,41,386,207,179,43,48,44,19,0
67066,199,107,92,41,15,14,8,277,124,153,44,40,35,18,0
67067,181,75,106,35,26,11,9,720,357,363,113,85,62,39,0
67068,575,305,270,74,87,73,25,1922,923,999,267,275,215,90,0
67069,262,133,129,44,38,31,12,756,348,408,101,103,60,40,0
67070,559,217,342,105,86,42,16,299,140,159,49,44,26,11,0
67071,130,71,59,30,9,8,1,190,93,97,35,27,23,2,0
67072,407,164,243,88,42,40,22,531,277,254,82,75,33,22,0
67073,279,129,150,43,34,17,13,180,108,72,22,22,15,5,0
67074,961,465,496,139,156,62,34,312,165,147,41,39,29,16,0
67075,230,114,116,30,33,29,8,337,152,185,49,54,42,21,0
67076,594,321,273,98,59,57,23,375,209,166,50,37,29,23,0
67077,1341,481,860,275,264,57,21,564,264,300,79,84,65,26,0
67078,436,209,227,66,47,52,22,218,114,104,32,31,33,11,0
67079,856,429,427,113,105,96,24,555,282,273,82,69,65,21,0
67080,213,88,125,21,54,14,15,261,148,113,31,28,14,10,0
67081,404,197,207,60,48,47,20,276,149,127,34,31,32,10,0
67082,207,128,79,26,17,19,9,496,285,211,62,54,46,22,0
67083,356,199,157,36,43,28,12,453,247,206,58,53,45,20,0
67084,264,122,142,46,24,35,10,368,204,164,43,35,30,24,0
67085,687,351,336,106,67,70,41,397,234,163,44,38,23,21,0
67086,136,66,70,33,11,9,4,240,141,99,34,28,29,8,0
67087,575,290,285,67,70,28,9,123,61,62,17,18,17,7,0
67088,401,236,165,53,38,34,9,509,267,242,79,81,38,20,0
67089,446,195,251,56,53,31,15,903,436,467,128,116,83,33,0
67090,933,456,477,123,108,83,29,649,307,342,71,134,45,17,0
67091,895,388,507,130,84,90,31,663,354,309,91,84,79,31,0
67092,395,219,176,47,41,50,18,218,115,103,37,33,33,9,0
67093,733,438,295,95,79,67,32,332,180,152,44,36,27,13,0
67094,469,221,248,49,60,55,21,103,50,53,19,10,7,5,0
67095,674,268,406,118,96,70,21,160,76,84,19,24,8,5,0
67096,1220,575,645,208,179,99,56,593,289,304,85,69,48,19,0
67097,510,269,241,66,67,71,26,301,168,133,49,37,34,11,0
67098,673,317,356,101,85,76,49,434,213,221,77,62,53,12,0
67099,1395,595,800,223,206,113,61,1425,670,755,153,189,122,85,0
67100,346,205,141,47,34,30,7,482,232,250,77,81,44,13,0
67101,960,409,551,166,134,77,44,647,324,323,101,80,76,43,0
67102,1030,567,463,118,106,94,49,1700,731,969,198,233,110,87,0
67103,426,231,195,51,52,45,24,169,85,84,21,14,9,9,0
67104,372,171,201,47,53,39,18,270,162,108,26,26,16,11,0
67105,374,202,172,58,40,41,7,348,194,154,57,31,43,12,0
67106,103,56,47,27,7,8,2,72,32,40,8,2,1,14,0
67107,243,114,129,37,30,32,8,600,254,346,104,100,44,17,0
67108,501,230,271,63,90,50,18,594,312,282,72,67,73,31,0
67109,629,338,291,92,57,64,22,384,212,172,44,43,34,14,0
67110,359,204,155,39,36,34,13,611,314,297,79,75,78,22,0
67111,586,298,288,80,75,64,37,1265,689,576,169,177,128,60,0
67112,158,85,73,24,18,18,8,1248,584,664,184,164,155,67,0
67113,319,153,166,61,52,26,12,530,287,243,79,70,33,26,0
67114,500,245,255,66,57,52,27,843,391,452,139,104,91,35,0
67115,4640,2231,2409,660,549,437,245,165,87,78,24,19,22,9,0
67116,1023,449,574,141,174,76,43,439,231,208,65,51,55,17,0
67117,280,128,152,39,37,38,18,1154,489,665,200,196,95,54,0
67118,915,336,579,185,199,56,29,360,180,180,57,48,39,12,0
67119,1107,601,506,155,138,103,49,497,257,240,71,63,62,16,0
67120,361,183,178,50,54,51,22,374,212,162,48,40,32,23,0
67121,1235,584,651,140,226,82,52,501,274,227,63,58,53,20,0
67122,478,177,301,109,66,59,25,145,77,68,26,7,15,8,0
67123,2649,1431,1218,377,299,266,102,137,85,52,15,11,11,2,0
67124,833,295,538,146,139,65,34,415,189,226,68,54,50,21,0
67125,911,441,470,123,108,60,21,274,157,117,40,29,40,8,0
67126,833,295,538,146,139,65,34,601,279,322,81,65,27,12,0
67127,622,354,268,89,60,64,18,481,223,258,71,70,49,26,0
67128,567,256,311,91,81,53,17,348,212,136,53,31,25,18,0
67129,801,331,470,151,139,99,55,323,168,155,51,41,38,12,0
67130,624,222,402,92,81,39,15,434,213,221,77,62,53,12,0
67131,126,57,69,31,10,10,3,963,525,438,119,102,102,34,0
67132,361,177,184,59,51,24,15,198,86,112,36,27,23,9,0
67133,457,261,196,55,27,57,34,644,343,301,96,69,59,28,0
67134,242,104,138,41,33,37,8,457,245,212,62,58,57,21,0
67135,465,240,225,50,54,24,14,1065,581,484,134,97,76,46,0
67136,636,288,348,94,77,65,30,250,119,131,58,26,29,7,0
67137,626,300,326,91,82,68,26,260,133,127,43,32,39,3,0
67138,512,254,258,70,48,37,32,274,157,117,40,29,40,8,0
67139,204,93,111,35,35,16,11,245,121,124,37,35,36,12,0
67140,785,351,434,136,93,71,37,266,146,120,41,28,31,7,0
67141,860,349,511,166,166,58,19,188,90,98,44,7,21,7,0
67142,339,118,221,77,68,33,13,418,246,172,52,39,57,10,0
67143,524,361,163,41,8,28,16,209,119,90,28,24,27,9,0
67144,570,238,332,112,95,39,23,535,301,234,63,48,47,27,0
67145,915,336,579,185,199,56,29,679,338,341,96,95,40,23,0
67146,653,379,274,89,56,86,13,277,124,153,44,40,35,18,0
67147,502,236,266,66,66,58,17,810,310,500,164,162,42,26,0
67148,496,209,287,112,55,71,14,278,154,124,42,32,38,7,0
67149,99,35,64,25,18,0,1,257,139,118,64,17,24,7,0
67150,143,81,62,28,9,8,1,474,268,206,66,42,45,24,0
67151,200,103,97,17,16,10,10,418,246,172,52,39,57,10,0
67152,714,260,454,140,97,120,54,332,180,152,44,36,27,13,0
67153,593,325,268,84,66,73,24,423,192,231,60,45,32,35,0
67154,493,281,212,56,61,30,13,354,183,171,54,43,49,8,0
67155,241,122,119,27,34,17,16,928,440,488,111,157,82,35,0
67156,318,164,154,52,43,34,10,386,181,205,55,51,57,31,0
67157,102,22,80,48,8,18,6,629,317,312,80,87,51,22,0
67158,291,120,171,63,39,26,6,418,246,172,52,39,57,10,0
67159,479,227,252,69,48,46,18,1025,549,476,118,109,88,61,0
67160,395,219,176,47,41,50,18,135,65,70,21,25,15,9,0
67161,755,271,484,113,226,61,20,1241,619,622,183,169,155,59,0
67162,1030,438,592,184,104,108,30,286,160,126,37,27,23,10,0
67163,1220,575,645,208,179,99,56,701,380,321,94,84,96,34,0
67164,577,251,326,92,84,60,11,818,357,461,122,136,54,25,0
67165,482,245,237,69,64,66,24,943,463,480,91,144,70,30,0
67166,531,259,272,75,81,39,13,286,152,134,38,38,32,11,0
67167,325,177,148,40,24,23,13,2517,1275,1242,304,324,245,135,0
67168,734,366,368,121,99,63,39,423,234,189,66,44,57,12,0
67169,1462,711,751,219,222,148,65,963,455,508,127,130,115,48,0
67170,574,269,305,91,63,54,27,520,272,248,60,65,58,22,0
67171,1365,590,775,257,168,136,93,260,133,127,43,32,39,3,0
67172,471,221,250,87,68,42,25,744,385,359,105,96,57,31,0
67173,227,109,118,42,35,29,8,132,61,71,22,21,15,3,0
67174,394,207,187,52,42,37,24,400,187,213,56,59,42,20,0
67175,758,378,380,89,64,37,31,400,187,213,56,59,42,20,0
67176,734,339,395,135,89,78,36,649,307,342,71,134,45,17,0
67177,1105,544,561,165,167,99,40,422,202,220,80,52,57,18,0
67178,753,395,358,93,72,71,16,463,268,195,59,46,46,21,0
67179,496,210,286,111,55,74,13,528,276,252,86,78,49,17,0
67180,1835,904,931,192,144,135,63,137,63,74,20,22,14,6,0
67181,1284,511,773,227,166,169,107,756,348,408,101,103,60,40,0
67182,142,76,66,21,21,22,11,479,215,264,67,80,46,28,0
67183,172,82,90,21,35,21,5,479,215,264,67,80,46,28,0
67184,297,182,115,41,22,23,8,374,212,162,48,40,32,23,0
67185,1214,612,602,169,173,98,35,384,204,180,53,47,49,17,0
67186,111,29,82,10,54,0,1,1922,923,999,267,275,215,90,0
67187,111,29,82,10,54,0,1,198,115,83,30,22,8,8,0
67188,529,290,239,54,63,85,15,496,285,211,62,54,46,22,0
67189,346,208,138,46,39,51,18,449,252,197,61,52,36,18,0
67190,385,179,206,58,56,38,19,373,189,184,54,46,50,23,0
67191,760,322,438,81,130,57,19,250,116,134,41,30,33,19,0
67192,217,109,108,30,23,28,10,862,409,453,149,125,86,29,0
67193,265,165,100,32,19,27,5,196,105,91,40,13,19,10,0
67194,125,57,68,31,10,10,3,501,274,227,63,58,53,20,0
67195,1759,838,921,269,212,191,92,194,106,88,33,10,15,6,0
67196,520,231,289,89,59,58,26,178,99,79,31,19,26,8,0
67197,454,230,224,63,56,38,33,462,229,233,63,49,42,18,0
67198,210,101,109,33,33,19,9,396,223,173,57,37,44,19,0
67199,86,50,36,9,14,8,7,288,156,132,36,36,24,15,0
67200,1130,614,516,129,138,98,42,482,232,250,77,81,44,13,0
67201,1023,449,574,141,174,76,43,903,436,467,128,116,83,33,0
67202,234,108,126,42,40,15,9,247,128,119,34,14,16,14,0
67203,157,62,95,41,18,10,11,413,223,190,52,45,53,10,0
67204,556,306,250,69,60,80,18,286,160,126,37,27,23,10,0
67205,301,150,151,45,47,33,13,564,264,300,79,84,65,26,0
67206,685,393,292,75,66,113,16,360,185,175,51,43,36,16,0
67207,373,194,179,42,54,26,13,384,212,172,44,43,34,14,0
67208,157,62,95,41,18,10,11,144,67,77,28,14,9,8,0
67209,516,210,306,113,53,81,33,518,292,226,60,60,52,21,0
67210,126,58,68,31,10,10,3,225,114,111,32,29,26,6,0
67211,436,201,235,54,37,35,18,132,77,55,20,9,13,10,0
67212,55,16,39,24,2,5,2,378,154,224,74,84,35,22,0
67213,2285,1219,1066,207,180,178,106,334,181,153,41,40,25,15,0
67214,394,207,187,52,42,37,24,380,178,202,69,53,37,10,0
67215,2174,1057,1117,241,241,214,117,222,122,100,39,32,24,9,0
67216,71,39,32,7,11,6,4,619,305,314,85,93,71,29,0
67217,949,467,482,126,127,102,51,166,102,64,19,14,17,2,0
67218,415,133,282,114,65,27,7,549,273,276,74,68,72,24,0
67219,1556,718,838,280,182,161,49,276,149,127,34,31,32,10,0
67220,280,156,124,36,19,20,13,2382,1162,1220,237,220,140,49,0
67221,622,354,268,89,60,64,18,535,311,224,66,52,49,24,0
67222,5890,3314,2576,970,956,293,265,463,268,195,59,46,46,21,0
67223,329,165,164,61,44,29,17,277,124,153,44,40,35,18,0
67224,613,303,310,70,28,28,18,514,262,252,78,58,54,26,0
67225,451,278,173,71,35,58,12,415,203,212,77,44,49,18,0
67226,478,220,258,47,70,41,10,188,90,98,44,7,21,7,0
67227,218,133,85,20,19,13,6,509,267,242,79,81,38,20,0
67228,680,308,372,82,72,71,40,374,174,200,54,52,42,21,0
67229,126,56,70,31,10,10,3,303,138,165,47,46,35,18,0
67230,139,81,58,17,14,24,9,261,127,134,36,27,36,4,0
67231,301,156,145,32,25,15,5,862,409,453,149,125,86,29,0
67232,258,130,128,44,37,29,10,1047,562,485,141,127,114,41,0
67233,426,213,213,60,56,46,24,663,360,303,87,82,80,35,0
67234,475,208,267,84,67,50,20,207,113,94,33,18,30,9,0
67235,224,108,116,33,26,32,10,132,77,55,20,9,13,10,0
67236,308,163,145,38,33,30,20,467,240,227,65,65,51,23,0
67237,1542,682,860,290,158,120,47,545,269,276,80,76,27,32,0
67238,241,122,119,27,34,17,16,261,127,134,36,27,36,4,0
67239,490,224,266,80,70,39,32,332,180,152,46,36,28,14,0
67240,67,40,27,10,8,7,6,309,164,145,35,47,30,11,0
67241,949,466,483,125,126,101,50,266,146,120,41,28,31,7,0
67242,1390,585,805,241,230,118,46,147,74,73,28,20,24,4,0
67243,1867,973,894,256,222,194,65,561,279,282,85,81,88,24,0
67244,941,459,482,167,140,82,38,352,207,145,40,33,25,21,0
67245,341,154,187,34,36,11,11,222,119,103,37,32,24,8,0
67246,879,457,422,93,98,143,32,889,505,384,107,97,99,30,0
67247,493,281,212,56,61,30,13,621,310,311,100,106,77,27,0
67248,520,300,220,66,36,57,23,211,88,123,38,28,26,10,0
67249,230,114,116,30,33,29,8,1101,626,475,145,122,120,50,0
67250,305,124,181,27,25,32,21,1321,653,668,186,195,70,35,0
67251,813,412,401,114,93,112,26,1154,489,665,200,196,95,54,0
67252,677,361,316,81,61,42,22,561,279,282,85,81,88,24,0
67253,853,400,453,137,109,88,42,647,350,297,95,79,77,29,0
67254,376,176,200,31,53,27,8,387,193,194,60,53,57,15,0
67255,213,88,125,21,54,14,15,301,168,133,49,37,34,11,0
67256,1590,726,864,270,237,126,59,375,210,165,49,37,29,27,0
67257,385,203,182,47,43,51,21,196,105,91,40,13,19,10,0
67258,474,243,231,66,54,41,29,160,76,84,19,24,8,5,0
67259,338,164,174,45,32,37,13,1020,538,482,145,115,111,58,0
67260,666,204,462,110,194,42,14,317,161,156,50,36,47,12,0
67261,424,170,254,69,56,47,28,130,67,63,24,10,12,4,0
67262,584,340,244,77,60,47,25,270,130,140,48,44,37,12,0
67263,820,333,487,202,152,59,23,780,337,443,112,116,77,28,0
67264,204,93,111,35,35,16,11,332,180,152,46,36,28,14,0
67265,243,114,129,37,30,32,8,1265,689,576,169,177,128,60,0
67266,172,98,74,20,21,22,8,204,96,108,31,37,20,5,0
67267,330,182,148,47,27,40,11,741,383,358,92,63,79,36,0
67268,1121,458,663,158,210,76,47,381,196,185,55,57,43,16,0
67269,509,251,258,69,49,55,17,288,156,132,36,36,24,15,0
67270,123,58,65,22,14,13,3,663,354,309,91,84,79,31,0
67271,1498,731,767,220,175,148,68,384,212,172,44,43,34,14,0
67272,579,281,298,91,78,74,27,501,240,261,80,62,49,42,0
67273,200,94,106,33,22,18,8,250,116,134,41,30,33,19,0
67274,786,378,408,106,98,77,39,465,252,213,73,58,60,18,0
67275,276,149,127,45,34,39,9,135,65,70,21,25,15,9,0
67276,311,154,157,47,29,34,13,218,111,107,45,29,24,6,0
67277,269,156,113,37,32,17,7,602,310,292,87,66,70,36,0
67278,484,264,220,59,62,68,15,172,79,93,34,27,23,10,0
67279,565,264,301,101,73,72,15,499,239,260,73,75,34,19,0
67280,496,209,287,112,55,71,14,285,143,142,45,32,21,17,0
67281,222,108,114,37,20,25,12,89,42,47,16,12,15,6,0
67282,928,442,486,139,118,91,43,270,162,108,26,26,16,11,0
67283,457,272,185,49,34,69,27,119,57,62,18,16,17,4,0
67284,315,111,204,82,66,46,11,220,107,113,36,35,28,9,0
67285,164,61,103,47,19,14,5,127,54,73,11,33,15,6,0
67286,127,62,65,13,33,7,6,103,59,44,25,2,13,6,0
67287,158,85,73,24,18,18,8,579,285,294,78,72,64,32,0
67288,220,113,107,37,24,16,7,821,394,427,122,117,109,38,0
67289,169,64,105,23,37,11,3,471,238,233,66,63,62,19,0
67290,1011,559,452,121,97,132,33,583,321,262,73,67,45,25,0
67291,1249,543,706,187,164,125,52,102,51,51,12,15,12,3,0
67292,626,300,326,91,82,68,26,256,141,115,32,22,32,8,0
67293,462,228,234,59,47,37,32,234,129,105,31,22,19,17,0
67294,301,150,151,45,47,33,13,319,185,134,42,31,22,13,0
67295,330,141,189,65,29,51,19,408,221,187,55,51,57,14,0
67296,221,80,141,48,37,14,10,701,380,321,94,84,96,34,0
67297,584,340,244,77,60,47,25,225,111,114,32,34,32,16,0
67298,700,305,395,111,99,54,18,68,23,45,12,9,3,9,0
67299,440,267,173,52,29,42,12,292,155,137,50,34,29,13,0
67300,618,289,329,97,86,70,17,339,180,159,36,29,16,16,0
67301,282,163,119,40,23,25,17,180,89,91,28,27,18,7,0
67302,376,176,200,31,53,27,8,602,310,292,87,66,70,36,0
67303,784,351,433,118,87,73,41,133,61,72,21,19,13,4,0
67304,312,164,148,54,29,25,15,103,44,59,16,17,9,5,0
67305,425,199,226,54,71,56,11,303,138,165,47,46,35,18,0
67306,941,459,482,167,140,82,38,975,475,500,139,140,119,28,0
67307,575,295,280,89,68,54,18,339,180,159,36,29,16,16,0
67308,313,178,135,43,18,35,6,600,254,346,104,100,44,17,0
67309,1531,649,882,108,122,93,72,410,197,213,67,43,56,18,0
67310,403,176,227,71,56,51,11,135,57,78,21,20,9,11,0
67311,172,98,74,20,21,22,8,373,181,192,54,35,44,20,0
67312,203,97,106,30,22,18,10,1230,644,586,198,125,123,61,0
67313,76,30,46,7,15,1,5,332,180,152,46,36,28,14,0
67314,299,128,171,57,40,13,25,690,345,345,96,83,73,42,0
67315,454,214,240,56,71,35,16,1338,720,618,179,145,141,85,0
67316,2063,1024,1039,175,117,80,97,128,63,65,30,11,13,8,0
67317,376,249,127,47,23,43,16,189,105,84,25,26,21,9,0
67318,276,149,127,45,34,39,9,531,261,270,73,80,68,26,0
67319,1531,649,882,108,122,93,72,303,137,166,54,54,31,15,0
67320,473,212,261,72,64,45,28,230,113,117,31,40,28,10,0
67321,575,290,285,67,70,28,9,207,86,121,34,39,11,13,0
67322,2663,1073,1590,548,499,192,64,708,328,380,113,100,82,34,0
67323,640,308,332,91,102,49,21,142,73,69,27,9,15,11,0
67324,595,316,279,86,60,65,40,445,192,253,86,58,53,18,0
67325,240,99,141,53,38,29,15,504,272,232,75,57,53,19,0
67326,484,264,220,59,62,68,15,501,274,227,63,58,53,20,0
67327,357,182,175,49,36,39,15,391,189,202,55,56,56,12,0
67328,640,308,332,91,102,49,21,403,184,219,75,51,47,20,0
67329,2799,1324,1475,369,371,215,124,147,74,73,28,20,24,4,0
67330,444,250,194,58,21,60,23,1062,522,540,151,147,105,66,0
67331,361,171,190,44,40,18,13,218,118,100,33,30,25,11,0
67332,1439,713,726,195,180,110,34,720,361,359,98,98,70,37,0
67333,631,316,315,64,57,49,15,222,127,95,23,28,22,7,0
67334,502,229,273,63,66,40,31,661,325,336,81,75,65,28,0
67335,233,107,126,40,40,20,16,609,335,274,79,57,45,22,0
67336,325,186,139,49,36,20,5,72,34,38,8,2,3,12,0
67337,766,336,430,133,97,79,21,671,306,365,114,76,49,19,0
67338,170,82,88,32,23,22,8,889,505,384,107,97,99,30,0
67339,2442,1193,1249,278,183,170,145,621,273,348,104,102,48,19,0
67340,128,69,59,29,9,8,1,127,64,63,26,8,12,8,0
67341,172,98,74,20,21,22,8,290,142,148,41,37,43,11,0
67342,654,344,310,80,69,57,15,866,397,469,117,153,95,48,0
67343,328,195,133,36,23,35,9,265,134,131,48,34,33,15,0
67344,420,189,231,79,67,33,17,906,455,451,116,105,87,46,0
67345,881,492,389,87,97,59,51,285,143,142,45,32,21,17,0
67346,125,53,72,18,21,18,12,222,122,100,39,32,24,9,0
67347,130,72,58,28,9,7,1,392,214,178,48,40,53,22,0
67348,329,171,158,49,41,31,10,415,226,189,51,40,40,29,0
67349,365,210,155,46,30,24,12,418,246,172,52,39,57,10,0
67350,648,262,386,113,108,78,29,222,124,98,37,29,22,9,0
67351,680,308,372,82,72,71,40,230,125,105,29,40,20,6,0
67352,411,171,240,61,81,30,15,926,425,501,159,147,77,35,0
67353,361,183,178,50,54,51,22,207,114,93,33,20,31,13,0
67354,449,179,270,80,77,49,29,213,129,84,32,14,21,15,0
67355,325,186,139,49,36,20,5,775,407,368,122,100,97,32,0
67356,329,168,161,48,34,41,16,756,348,408,101,103,60,40,0
67357,225,111,114,38,22,25,10,395,169,226,73,55,38,9,0
67358,129,70,59,29,9,7,2,732,402,330,81,86,87,33,0
67359,118,51,67,25,13,6,7,230,113,117,31,40,28,10,0
67360,464,237,227,64,66,33,12,286,160,126,37,27,23,10,0
67361,579,246,333,102,79,41,19,360,185,175,51,43,36,16,0
67362,346,208,138,46,39,51,18,925,439,486,141,134,105,46,0
67363,552,295,257,67,49,70,30,322,180,142,45,38,28,7,0
67364,463,225,238,76,36,59,26,277,138,139,40,39,20,14,0
67365,585,277,308,92,73,61,32,963,525,438,119,102,102,34,0
67366,452,217,235,59,47,60,20,274,142,132,33,34,18,14,0
67367,1004,464,540,143,104,78,55,375,211,164,50,36,31,23,0
67368,465,240,225,50,54,24,14,422,202,220,80,52,57,18,0
67369,193,90,103,44,9,19,13,862,426,436,113,115,84,37,0
67370,160,67,93,32,37,15,9,195,100,95,27,20,17,11,0
67371,86,50,36,9,14,8,7,902,499,403,118,117,92,35,0
67372,648,376,272,70,60,73,24,277,144,133,42,30,41,8,0
67373,335,171,164,51,38,38,10,350,196,154,52,37,21,14,0
67374,452,217,235,59,47,60,20,403,233,170,38,29,21,14,0
67375,340,169,171,40,39,36,22,520,240,280,67,72,42,14,0
67376,270,147,123,34,17,39,21,2346,1231,1115,316,292,266,105,0
67377,246,123,123,40,31,27,7,346,178,168,58,41,33,12,0
67378,438,185,253,71,64,52,28,1065,581,484,134,97,76,46,0
67379,1464,693,771,153,136,91,86,283,160,123,25,20,37,9,0
67380,2286,1154,1132,338,314,278,103,138,69,69,28,7,10,10,0
67381,160,53,107,31,29,13,3,504,272,232,75,57,53,19,0
67382,207,89,118,56,8,4,3,274,157,117,40,29,40,8,0
67383,546,285,261,71,49,47,24,368,200,168,54,49,43,9,0
67384,1970,978,992,245,206,198,80,180,115,65,17,12,9,9,0
67385,1171,542,629,170,146,114,64,72,32,40,8,2,2,13,0
67386,107,53,54,15,15,13,4,439,231,208,65,51,55,17,0
67387,469,221,248,49,60,55,21,385,188,197,57,42,36,16,0
67388,338,173,165,31,42,22,10,234,116,118,34,35,23,9,0
67389,328,195,133,36,23,35,9,123,61,62,17,18,17,7,0
67390,102,22,80,48,8,18,6,260,131,129,42,31,40,9,0
67391,436,201,235,54,37,35,18,173,94,79,18,24,12,7,0
67392,348,198,150,57,25,37,18,179,101,78,25,15,13,13,0
67393,2136,1063,1073,317,308,223,90,758,319,439,101,123,78,25,0
67394,1098,519,579,182,159,79,42,103,44,59,16,17,9,5,0
67395,261,137,124,34,23,13,8,378,154,224,74,84,35,22,0
67396,338,139,199,54,54,18,11,178,69,109,29,25,21,13,0
67397,119,67,52,15,15,7,7,437,224,213,40,29,42,25,0
67398,425,199,226,54,71,56,11,295,156,139,41,40,42,15,0
67399,303,147,156,49,49,20,8,715,345,370,110,97,64,25,0
67400,119,59,60,29,10,6,4,4646,2328,2318,674,639,475,170,0
67401,399,196,203,62,45,38,19,296,159,137,49,28,38,13,0
67402,220,121,99,28,26,17,6,727,388,339,102,87,70,29,0
67403,482,231,251,76,81,64,26,201,98,103,28,25,19,13,0
67404,388,244,144,46,25,42,16,413,223,190,52,45,53,10,0
67405,953,421,532,131,131,70,37,105,51,54,13,17,12,8,0
67406,414,195,219,51,60,40,17,385,212,173,57,40,39,21,0
67407,164,61,103,47,19,14,5,741,383,358,92,63,79,36,0
67408,388,209,179,46,24,31,28,437,221,216,62,64,47,13,0
67409,136,65,71,33,11,9,6,392,186,206,62,56,29,15,0
67410,631,304,327,98,75,52,23,163,79,84,22,24,13,5,0
67411,1395,595,800,223,206,113,61,1061,543,518,146,123,109,67,0
67412,1755,849,906,245,226,148,56,96,45,51,13,12,6,4,0
67413,407,230,177,44,39,34,19,1382,508,874,334,320,98,36,0
67414,334,155,179,47,34,38,11,873,411,462,132,107,84,40,0
67415,658,349,309,77,70,73,35,204,80,124,29,51,10,5,0
67416,346,168,178,36,43,20,9,1113,480,633,170,173,81,34,0
67417,1417,598,819,223,188,135,58,1040,564,476,134,110,114,51,0
67418,516,224,292,79,29,45,33,366,204,162,47,41,31,23,0
67419,436,201,235,54,37,35,18,107,77,30,7,2,9,5,0
67420,262,133,129,44,38,31,12,535,288,247,79,72,35,21,0
67421,2414,1189,1225,277,178,170,169,1249,638,611,166,153,141,45,0
67422,425,210,215,56,43,52,25,437,228,209,47,61,26,11,0
67423,828,355,473,126,134,77,37,367,199,168,62,44,34,8,0
67424,431,202,229,57,50,50,25,132,77,55,20,9,13,10,0
67425,1199,589,610,189,128,167,65,225,114,111,32,29,26,6,0
67426,305,124,181,27,25,31,21,530,287,243,79,70,33,26,0
67427,743,366,377,41,37,26,14,873,411,462,132,107,84,40,0
67428,332,173,159,48,42,42,9,445,202,243,70,73,51,15,0
67429,338,172,166,59,30,39,18,1241,619,622,183,169,155,59,0
67430,677,361,316,81,61,42,22,94,45,49,11,20,10,4,0
67431,1501,679,822,251,196,174,67,349,200,149,41,39,30,20,0
67432,1709,650,1059,338,286,185,46,292,155,137,50,34,29,13,0
67433,334,155,179,47,34,38,11,396,199,197,54,50,45,14,0
67434,651,357,294,81,67,103,18,192,91,101,29,28,17,7,0
67435,552,295,257,67,49,70,30,469,225,244,64,68,25,11,0
67436,275,160,115,40,31,34,17,475,251,224,67,49,48,23,0
67437,257,122,135,44,19,21,16,370,190,180,60,52,37,13,0
67438,193,107,86,13,20,13,6,232,111,121,23,29,17,9,0
67439,533,297,236,74,57,39,28,242,124,118,39,32,28,22,0
67440,520,231,289,89,59,58,26,338,169,169,53,44,39,21,0
67441,282,105,177,77,28,39,6,662,312,350,103,104,59,20,0
67442,2488,1085,1403,346,253,162,76,483,287,196,71,50,54,17,0
67443,362,174,188,46,55,35,23,204,80,124,29,51,10,5,0
67444,579,246,333,102,79,41,19,1214,475,739,177,250,89,49,0
67445,325,186,139,49,36,20,5,661,325,336,81,75,65,28,0
67446,468,233,235,65,61,49,34,376,183,193,50,50,43,21,0
67447,852,472,380,99,79,70,27,551,226,325,96,103,43,11,0
67448,3969,1703,2266,619,432,259,144,332,155,177,55,51,44,13,0
67449,794,322,472,122,108,79,34,68,23,45,12,9,3,9,0
67450,109,50,59,12,12,9,3,89,38,51,14,6,3,9,0
67451,1498,731,767,220,175,148,68,483,215,268,66,70,30,16,0
67452,83,45,38,11,8,8,3,462,251,211,74,53,41,18,0
67453,451,225,226,69,57,64,22,1062,522,540,151,147,105,66,0
67454,577,251,326,92,84,60,11,889,505,384,107,97,99,30,0
67455,204,93,111,35,35,16,11,588,286,302,78,99,53,25,0
67456,813,412,401,114,93,112,26,972,471,501,152,138,112,40,0
67457,2109,999,1110,332,294,187,89,199,92,107,34,30,18,9,0
67458,707,250,457,171,84,117,61,164,79,85,28,28,16,7,0
67459,323,156,167,52,45,39,18,175,82,93,33,26,17,5,0
67460,302,178,124,34,29,50,13,323,162,161,52,41,39,13,0
67461,603,311,292,102,71,66,23,312,165,147,41,39,29,16,0
67462,361,183,178,50,54,51,22,741,383,358,92,63,79,36,0
67463,130,70,60,30,9,8,1,198,86,112,36,27,23,9,0
67464,224,108,116,33,26,32,10,271,150,121,39,36,37,5,0
67465,233,110,123,34,22,34,9,732,366,366,108,86,74,41,0
67466,338,164,174,45,32,37,13,1208,565,643,182,162,120,57,0
67467,204,109,95,21,35,27,7,736,388,348,88,85,67,28,0
67468,795,384,411,133,109,85,38,399,190,209,61,41,39,18,0
67469,320,183,137,51,18,38,8,285,146,139,41,41,48,13,0
67470,260,136,124,24,41,19,4,601,279,322,81,65,27,12,0
67471,465,240,225,50,54,24,14,139,68,71,14,26,14,9,0
67472,452,217,235,59,47,60,20,68,23,45,12,9,3,9,0
67473,941,459,482,167,140,82,38,124,69,55,14,7,9,4,0
67474,683,304,379,140,101,48,19,2136,1063,1073,317,308,223,90,0
67475,463,225,238,76,36,59,26,296,140,156,49,40,42,19,0
67476,1555,702,853,250,199,139,31,673,313,360,102,101,46,17,0
67477,631,316,315,64,57,49,15,508,253,255,73,60,50,13,0
67478,71,28,43,15,9,5,2,904,436,468,143,118,108,32,0
67479,291,131,160,49,35,32,15,387,193,194,60,53,57,15,0
67480,341,177,164,57,42,40,18,160,76,84,19,24,8,5,0
67481,441,216,225,57,66,57,19,72,32,40,8,2,1,14,0
67482,1139,537,602,162,139,109,50,354,183,171,54,43,49,8,0
67483,396,150,246,103,64,38,3,258,129,129,45,24,31,10,0
67484,458,210,248,39,38,25,16,530,287,243,79,70,33,26,0
67485,505,201,304,116,58,75,31,339,175,164,51,49,37,9,0
67486,2414,1189,1225,277,178,170,169,390,190,200,66,50,43,12,0
67487,432,190,242,85,82,28,11,390,190,200,66,50,43,12,0
67488,180,57,123,39,22,10,8,296,151,145,45,42,32,11,0
67489,303,147,156,49,49,20,8,279,142,137,43,39,28,7,0
67490,852,472,380,99,79,70,27,418,223,195,53,43,49,15,0
67491,730,298,432,128,69,86,26,724,353,371,94,95,71,31,0
67492,447,236,211,56,52,49,14,332,173,159,48,40,31,11,0
67493,419,210,209,54,44,31,23,245,121,124,37,35,36,12,0
67494,406,207,199,56,46,68,19,160,76,84,19,24,8,5,0
67495,335,155,180,64,48,36,10,497,257,240,71,63,62,16,0
67496,419,210,209,54,44,31,23,96,46,50,16,12,7,5,0
67497,332,170,162,44,38,39,10,319,185,134,42,31,22,13,0
67498,474,243,231,66,54,41,29,328,195,133,39,40,27,13,0
67499,249,104,145,47,41,24,17,205,94,111,48,31,15,6,0
67500,283,172,111,39,31,29,8,906,455,451,116,105,87,46,0
67501,446,265,181,51,35,27,17,132,61,71,22,21,15,3,0
67502,115,62,53,13,10,9,7,751,394,357,107,96,73,35,0
67503,372,171,201,47,53,39,18,207,86,121,34,39,11,13,0
67504,228,105,123,34,43,20,10,149,52,97,36,36,7,4,0
67505,496,210,286,112,55,72,13,592,249,343,91,90,50,42,0
67506,234,110,124,39,29,23,2,1507,737,770,188,228,147,71,0
67507,325,181,144,46,31,48,9,406,202,204,54,51,63,21,0
67508,527,276,251,64,60,70,20,415,226,189,51,40,40,29,0
67509,203,80,123,40,37,20,3,148,69,79,26,18,16,3,0
67510,1360,644,716,213,194,136,62,1696,771,925,257,225,149,63,0
67511,710,352,358,104,86,84,41,367,199,168,62,44,34,8,0
67512,833,295,538,146,139,65,34,96,46,50,16,12,7,5,0
67513,329,171,158,49,41,31,10,72,33,39,8,2,3,12,0
67514,347,212,135,35,32,17,6,729,358,371,116,99,89,33,0
67515,465,220,245,88,34,61,23,583,280,303,95,66,76,25,0
67516,338,139,199,54,54,18,11,452,254,198,72,57,38,18,0
67517,629,374,255,74,53,87,27,947,482,465,143,107,89,37,0
67518,125,57,68,31,10,10,3,972,471,501,152,138,112,40,0
67519,412,193,219,69,57,43,14,317,161,156,50,36,47,12,0
67520,134,60,74,19,13,10,7,137,78,59,22,16,17,4,0
67521,391,203,188,49,34,36,9,617,314,303,96,68,68,37,0
67522,361,167,194,55,35,41,11,4646,2328,2318,674,639,475,170,0
67523,142,60,82,20,28,13,5,330,166,164,55,51,36,16,0
67524,426,196,230,76,65,54,20,381,187,194,37,49,36,17,0
67525,178,87,91,20,32,13,10,556,290,266,75,74,29,24,0
67526,128,67,61,29,9,9,1,375,210,165,49,37,29,27,0
67527,627,237,390,137,57,108,44,344,190,154,34,31,36,10,0
67528,249,114,135,47,33,25,4,307,132,175,48,53,26,10,0
67529,766,336,430,133,97,79,21,579,285,294,78,72,64,32,0
67530,203,80,123,40,37,20,3,346,178,168,58,41,33,12,0
67531,237,127,110,34,30,16,9,201,93,108,34,39,21,6,0
67532,385,179,206,58,56,38,19,201,98,103,28,25,19,13,0
67533,325,152,173,43,47,28,17,136,65,71,26,11,7,5,0
67534,127,54,73,31,10,11,3,73,35,38,14,10,9,4,0
67535,90,54,36,20,4,14,5,154,78,76,23,21,13,5,0
67536,420,189,231,79,67,33,17,536,222,314,101,100,34,22,0
67537,527,254,273,67,66,70,31,349,200,149,41,39,30,20,0
67538,505,201,304,116,58,75,31,471,238,233,66,63,62,19,0
67539,528,273,255,67,53,29,20,403,233,170,38,29,21,14,0
67540,385,203,182,47,43,51,21,1249,638,611,166,153,141,45,0
67541,736,320,416,113,97,61,36,1113,480,633,170,173,81,34,0
67542,156,64,92,31,19,5,4,508,262,246,66,67,51,20,0
67543,315,174,141,46,38,47,16,175,91,84,19,21,21,10,0
67544,539,283,256,75,73,53,26,367,218,149,45,43,42,16,0
67545,308,163,145,38,33,30,20,368,200,168,54,49,43,9,0
67546,210,101,109,33,33,19,9,1061,543,518,146,123,109,67,0
67547,733,382,351,126,92,93,27,963,455,508,127,130,115,48,0
67548,802,430,372,65,102,87,23,54,26,28,11,4,3,3,0
67549,579,281,298,91,78,74,27,679,338,341,96,95,40,23,0
67550,480,257,223,74,26,60,27,165,90,75,36,18,20,6,0
67551,579,246,333,102,79,41,19,387,193,194,60,53,57,15,0
67552,312,173,139,43,47,28,6,418,223,195,53,43,49,15,0
67553,763,354,409,101,90,63,26,892,475,417,130,108,68,38,0
67554,548,250,298,85,64,56,21,501,274,227,63,58,53,20,0
67555,341,177,164,57,42,40,18,367,199,168,62,44,34,8,0
67556,230,114,116,30,33,29,8,332,173,159,48,40,31,11,0
67557,802,430,372,65,102,87,23,213,129,84,32,14,21,15,0
67558,746,312,434,129,115,77,47,715,345,370,110,97,64,25,0
67559,301,156,145,32,25,15,5,189,105,84,25,26,21,9,0
67560,2649,1431,1218,377,299,266,102,437,224,213,40,29,42,25,0
67561,246,111,135,64,47,27,3,406,202,204,54,51,63,21,0
67562,1580,742,838,208,146,144,71,132,67,65,24,21,8,10,0
67563,485,237,248,83,35,52,24,906,455,451,116,105,87,46,0
67564,202,113,89,16,27,21,11,418,246,172,52,39,57,10,0
67565,548,250,298,85,64,56,21,501,249,252,77,70,55,22,0
67566,301,119,182,53,47,14,20,732,402,330,81,86,87,33,0
67567,193,90,103,44,9,19,13,274,157,117,40,29,40,8,0
67568,154,74,80,18,19,7,2,163,79,84,22,24,13,5,0
67569,427,191,236,67,60,41,34,427,251,176,51,39,25,22,0
67570,516,210,306,113,53,81,33,246,107,139,55,33,27,11,0
67571,238,91,147,68,19,22,7,462,251,211,74,53,41,18,0
67572,535,217,318,87,106,41,14,132,61,71,22,21,15,3,0
67573,371,143,228,77,48,29,26,196,105,91,40,13,19,10,0
67574,2048,855,1193,297,287,191,93,972,471,501,152,138,112,40,0
67575,193,95,98,33,17,25,17,302,150,152,56,40,52,15,0
67576,270,131,139,47,37,41,11,627,323,304,81,90,53,27,0
67577,413,169,244,66,94,28,19,180,89,91,28,27,18,7,0
67578,139,64,75,18,17,18,4,602,310,292,87,66,70,36,0
67579,283,112,171,48,39,34,15,201,99,102,34,26,23,6,0
67580,260,120,140,34,39,36,12,376,183,193,50,50,43,21,0
67581,441,216,225,57,66,57,19,173,90,83,21,36,12,15,0
67582,231,105,126,56,10,24,10,154,78,76,23,21,13,5,0
67583,126,57,69,31,10,10,3,363,180,183,60,34,10,6,0
67584,440,267,173,52,29,42,12,178,99,79,31,19,26,8,0
67585,256,152,104,18,23,23,8,156,90,66,17,22,11,10,0
67586,501,230,271,63,90,50,18,422,237,185,53,47,62,20,0
67587,773,383,390,108,76,79,30,261,148,113,31,28,14,10,0
67588,616,323,293,98,71,31,15,715,345,370,110,97,64,25,0
67589,615,308,307,83,75,58,32,497,257,240,71,63,62,16,0
67590,428,226,202,52,60,75,20,124,69,55,14,7,9,4,0
67591,1249,543,706,187,164,125,52,715,348,367,109,84,68,30,0
67592,1235,584,651,140,226,82,52,597,300,297,96,89,68,29,0
67593,1226,513,713,184,147,87,43,514,248,266,86,82,52,22,0
67594,543,265,278,52,37,54,19,392,186,206,62,56,29,15,0
67595,275,160,115,40,31,34,17,279,142,137,43,39,28,7,0
67596,328,156,172,44,37,44,15,124,69,55,14,7,9,4,0
67597,1001,422,579,185,180,51,32,673,313,360,102,101,46,17,0
67598,82,36,46,17,10,5,1,231,126,105,37,26,29,6,0
67599,180,57,123,39,22,10,8,605,283,322,94,72,64,39,0
67600,443,226,217,67,34,53,10,392,155,237,68,61,34,16,0
67601,291,131,160,49,35,32,15,294,146,148,50,45,51,15,0
67602,961,465,496,139,156,62,34,354,188,166,46,40,34,10,0
67603,364,204,160,65,35,15,13,715,348,367,109,84,68,30,0
67604,1214,612,602,169,173,98,35,215,115,100,27,19,16,7,0
67605,416,207,209,63,47,56,15,482,232,250,77,81,44,13,0
67606,932,575,357,94,69,76,40,497,227,270,70,63,66,30,0
67607,410,209,201,72,30,48,22,492,278,214,65,58,32,11,0
67608,339,118,221,77,68,33,13,245,121,124,37,35,36,12,0
67609,407,207,200,53,36,38,8,582,264,318,84,60,58,23,0
67610,840,411,429,122,101,79,34,408,221,187,55,51,57,14,0
67611,240,167,73,32,12,8,21,374,174,200,54,52,42,21,0
67612,2799,1324,1475,369,371,215,124,427,251,176,51,39,25,22,0
67613,447,225,222,76,35,75,21,135,65,70,21,25,15,9,0
67614,121,69,52,15,18,14,8,73,35,38,14,10,9,4,0
67615,199,113,86,27,17,10,7,1040,564,476,134,110,114,51,0
67616,437,228,209,47,61,26,11,2202,1121,1081,338,274,269,81,0
67617,236,141,95,36,32,14,6,397,223,174,50,39,29,17,0
67618,1087,523,564,146,177,103,33,344,190,154,34,31,36,10,0
67619,1130,614,516,129,138,98,42,245,131,114,30,27,18,13,0
67620,1171,542,629,170,146,114,64,1182,591,591,155,139,83,46,0
67621,130,70,60,30,9,8,1,662,373,289,89,80,77,29,0
67622,315,170,145,48,56,22,11,154,78,76,23,21,13,5,0
67623,272,136,136,32,34,12,12,751,394,357,107,96,73,35,0
67624,956,450,506,122,117,82,36,508,262,246,66,67,51,20,0
67625,651,357,294,81,67,103,18,341,170,171,41,66,27,10,0
67626,1867,973,894,256,222,194,65,400,187,213,56,59,42,20,0
67627,929,410,519,187,146,53,30,906,455,451,116,105,87,46,0
67628,531,260,271,97,68,47,11,384,204,180,53,47,49,17,0
67629,281,125,156,44,47,17,7,302,150,152,56,40,52,15,0
67630,485,183,302,79,81,73,33,192,110,82,33,21,10,3,0
67631,651,357,294,81,67,103,18,257,139,118,64,17,24,7,0
67632,103,56,47,27,7,8,2,617,314,303,96,68,68,37,0
67633,242,111,131,35,35,17,13,462,251,211,74,53,41,18,0
67634,365,222,143,44,24,35,11,180,89,91,28,27,18,7,0
67635,904,436,468,138,146,82,39,673,313,360,102,101,46,17,0
67636,463,250,213,56,45,73,25,279,142,137,43,39,28,7,0
67637,452,217,235,59,47,60,20,649,307,342,71,134,45,17,0
67638,345,208,137,44,27,33,8,375,210,165,49,37,29,27,0
67639,457,228,229,64,36,52,21,201,117,83,22,21,19,9,0
67640,184,88,96,15,40,17,8,535,311,224,66,52,49,24,0
67641,1068,434,634,173,160,61,29,821,394,427,122,117,109,38,0
67642,580,281,299,95,60,74,29,2542,1245,1297,285,287,170,84,0
67643,1542,682,860,290,158,120,47,132,77,55,20,9,13,10,0
67644,234,108,126,42,40,15,9,439,231,208,65,51,55,17,0
67645,451,278,173,71,35,58,12,385,188,197,57,42,36,16,0
67646,297,182,115,41,22,23,8,87,51,35,15,9,9,4,0
67647,364,168,196,64,61,27,6,274,142,132,33,34,18,14,0
67648,1336,724,612,209,141,133,60,478,254,224,67,74,56,28,0
67649,359,167,192,49,37,27,19,660,332,328,84,73,47,19,0
67650,364,168,196,64,61,27,6,96,45,51,13,12,6,4,0
67651,233,107,126,40,40,20,16,374,174,200,54,52,42,21,0
67652,557,211,346,129,125,48,19,741,383,358,92,63,79,36,0
67653,594,279,315,93,68,68,26,1025,549,476,118,109,88,61,0
67654,325,181,144,46,31,48,9,218,115,103,32,32,34,11,0
67655,429,238,191,47,49,56,29,199,105,94,27,27,28,9,0
67656,609,292,317,102,96,64,21,137,78,59,22,16,17,4,0
67657,500,257,243,60,55,27,22,142,73,69,27,9,15,11,0
67658,1276,607,669,192,178,136,63,225,114,111,32,29,26,6,0
67659,531,259,272,75,81,39,13,497,257,240,71,63,62,16,0
67660,282,163,119,40,23,25,17,192,110,82,33,21,10,3,0
67661,466,199,267,86,59,32,17,496,251,245,78,62,61,23,0
67662,282,135,147,27,37,30,19,86,40,46,16,13,9,7,0
67663,221,114,107,65,7,2,1,453,255,198,62,49,29,19,0
67664,437,228,209,47,61,26,11,487,252,235,79,58,55,26,0
67665,2799,1324,1475,369,371,215,124,225,129,96,32,33,20,8,0
67666,755,271,484,113,226,61,20,445,192,253,86,58,53,18,0
67667,146,75,71,13,32,15,11,278,154,124,42,32,38,7,0
67668,618,289,329,97,86,70,17,393,210,183,58,37,34,20,0
67669,475,208,267,84,67,50,20,862,426,436,113,115,84,37,0
67670,437,230,207,41,55,27,13,250,119,131,58,26,29,7,0
67671,222,110,112,43,30,14,6,329,194,135,45,32,33,9,0
67672,711,330,381,111,86,86,34,858,461,397,125,114,79,45,0
67673,305,124,181,27,25,31,21,166,102,64,19,14,17,2,0
67674,392,205,187,83,49,38,10,545,269,276,80,76,27,32,0
67675,2236,1195,1041,227,187,186,118,2346,1231,1115,316,292,266,105,0
67676,1970,978,992,245,206,198,80,166,102,64,19,14,17,2,0
67677,388,209,179,46,24,31,28,290,147,143,34,34,39,13,0
67678,437,225,212,61,57,66,12,650,330,320,93,93,51,28,0
67679,836,370,466,126,96,72,30,172,79,93,34,27,23,10,0
67680,1556,718,838,280,182,161,49,1001,417,584,186,147,96,47,0
67681,388,244,144,46,25,42,16,137,78,59,22,16,17,4,0
67682,282,96,186,80,21,28,7,106,46,60,29,13,14,5,0
67683,109,42,67,25,13,1,1,378,154,224,74,84,35,22,0
67684,222,110,112,43,30,14,6,445,264,181,35,35,34,14,0
67685,550,304,246,60,64,77,16,457,245,212,62,58,57,21,0
67686,237,127,110,34,30,16,9,94,45,49,11,20,10,4,0
67687,587,318,269,76,50,38,21,457,245,212,62,58,57,21,0
67688,1501,679,822,251,196,174,67,380,178,202,69,53,37,10,0
67689,242,104,138,41,33,37,8,519,287,232,68,58,45,21,0
67690,658,349,309,77,70,73,35,111,60,51,17,23,10,7,0
67691,232,108,124,33,27,19,16,463,170,293,115,54,75,32,0
67692,341,183,158,36,34,36,15,266,150,116,28,28,24,12,0
67693,1052,492,560,184,163,103,44,903,436,467,128,116,83,33,0
67694,184,88,96,15,40,17,8,405,214,191,53,42,49,20,0
67695,388,209,179,46,24,31,28,107,77,30,7,2,9,5,0
67696,636,288,348,94,77,65,30,137,63,74,20,22,14,6,0
67697,261,148,113,23,29,26,21,427,251,176,51,39,25,22,0
67698,527,254,273,67,66,70,31,106,46,60,27,18,12,3,0
67699,412,208,204,54,47,42,17,389,207,182,53,58,52,18,0
67700,736,353,383,117,83,71,18,926,425,501,159,147,77,35,0
67701,315,170,145,48,56,22,11,2346,1231,1115,316,292,266,105,0
67702,242,111,131,35,35,17,13,336,200,136,34,29,25,24,0
67703,711,330,381,111,86,86,34,103,44,59,16,17,9,5,0
67704,763,354,409,101,90,63,26,403,225,178,56,38,33,25,0
67705,245,111,134,36,27,18,6,445,264,181,35,35,34,14,0
67706,343,189,154,44,24,39,12,337,152,185,49,54,42,21,0
67707,437,228,209,47,61,26,11,483,215,268,66,70,30,16,0
67708,281,154,127,45,31,24,9,153,80,73,26,18,19,4,0
67709,163,70,93,28,21,17,6,127,58,69,18,17,10,5,0
67710,317,167,150,45,21,30,26,172,79,93,34,27,23,10,0
67711,177,92,85,19,20,23,6,119,57,62,18,16,17,4,0
67712,622,354,268,89,60,64,18,240,141,99,34,28,29,8,0
67713,301,119,182,53,47,14,20,386,207,179,43,48,44,19,0
67714,508,267,241,43,35,25,17,1755,905,850,214,196,183,79,0
67715,304,149,155,46,32,39,14,455,229,226,66,62,63,29,0
67716,600,324,276,89,73,45,39,201,104,97,36,32,24,7,0
67717,524,270,254,84,72,70,23,375,176,199,48,61,40,12,0
67718,1560,778,782,224,235,132,78,405,195,210,57,74,24,17,0
67719,465,305,160,40,47,34,9,748,359,389,125,113,86,31,0
67720,343,162,181,65,38,29,12,295,156,139,41,40,42,15,0
67721,426,231,195,51,52,45,24,247,128,119,34,14,16,14,0
67722,422,196,226,52,35,33,20,866,397,469,117,153,95,48,0
67723,338,139,199,54,54,18,11,1047,562,485,141,127,114,41,0
67724,399,220,179,48,37,68,18,385,188,197,57,42,36,16,0
67725,1051,429,622,179,148,125,54,392,155,237,68,61,34,16,0
67726,520,261,259,74,52,49,22,690,345,345,96,83,73,42,0
67727,326,176,150,35,22,29,11,403,192,211,102,39,49,15,0
67728,963,477,486,134,143,123,38,1698,875,823,222,219,173,64,0
67729,346,191,155,52,38,40,13,520,244,276,91,60,68,20,0
67730,313,148,165,45,33,36,11,1314,693,621,174,155,140,58,0
67731,502,274,228,64,49,75,17,222,127,95,23,28,22,7,0
67732,745,402,343,95,71,69,40,943,463,480,91,144,70,30,0
67733,346,208,138,46,39,51,18,579,285,294,78,72,64,32,0
67734,595,208,387,157,60,91,48,153,80,73,26,18,19,4,0
67735,786,378,408,106,98,77,39,334,182,152,45,41,27,13,0
67736,367,167,200,63,42,60,17,483,287,196,71,50,54,17,0
67737,753,395,358,93,72,71,16,188,90,98,44,7,21,7,0
67738,220,121,99,28,26,17,6,541,279,262,79,82,31,32,0
67739,528,273,255,67,53,29,20,1265,689,576,169,177,128,60,0
67740,159,105,54,22,9,14,25,1425,670,755,153,189,122,85,0
67741,210,101,109,33,33,19,9,207,86,121,34,39,11,13,0
67742,2799,1324,1475,369,371,215,124,422,202,220,80,52,57,18,0
67743,280,128,152,39,37,38,18,478,254,224,67,74,56,28,0
67744,358,206,152,45,38,67,16,231,126,105,37,26,29,6,0
67745,1499,864,635,141,99,76,110,295,160,135,44,36,46,16,0
67746,462,233,229,66,49,43,30,1696,771,925,257,225,149,63,0
67747,480,232,248,73,40,44,30,171,94,77,24,28,30,11,0
67748,646,304,342,104,93,58,26,926,425,501,159,147,77,35,0
67749,264,122,142,33,29,13,13,654,295,359,99,88,71,25,0
67750,472,222,250,46,61,33,23,715,348,367,109,84,68,30,0
67751,270,131,139,47,37,41,11,445,202,243,70,73,51,15,0
67752,496,210,286,112,55,71,14,134,72,62,14,28,8,4,0
67753,484,261,223,59,48,49,24,147,74,73,28,20,24,4,0
67754,325,186,139,49,36,20,5,729,358,371,116,99,89,33,0
67755,465,240,225,50,54,24,14,337,152,185,49,54,42,21,0
67756,380,187,193,38,51,30,18,72,32,40,8,2,1,14,0
67757,411,202,209,60,67,57,24,528,276,252,86,78,49,17,0
67758,476,254,222,58,33,46,23,283,160,123,25,20,37,9,0
67759,658,349,309,77,70,73,35,535,288,247,79,72,35,21,0
67760,330,151,179,68,36,56,9,396,197,199,75,49,49,16,0
67761,919,444,475,141,148,62,20,900,441,459,125,127,110,32,0
67762,437,167,270,126,95,34,10,348,194,154,57,31,43,12,0
67763,157,62,95,41,18,10,11,326,169,157,51,41,41,12,0
67764,166,59,107,36,41,10,4,1378,692,686,194,174,105,56,0
67765,463,250,213,56,45,73,25,139,68,71,14,26,14,9,0
67766,815,356,459,128,125,82,26,406,234,172,63,35,43,10,0
67767,292,102,190,71,27,51,21,395,198,197,55,55,36,10,0
67768,333,171,162,41,44,48,23,234,116,118,34,35,23,9,0
67769,258,144,114,33,22,19,9,283,142,141,41,33,26,18,0
67770,220,121,99,28,26,17,6,756,348,408,101,103,60,40,0
67771,828,355,473,126,134,77,37,188,101,87,20,18,20,14,0
67772,131,69,62,29,9,9,1,429,187,242,79,72,28,19,0
67773,756,362,394,102,104,73,25,903,436,467,128,116,83,33,0
67774,886,440,446,116,140,95,45,662,373,289,89,80,77,29,0
67775,785,325,460,114,123,61,28,348,194,154,57,31,43,12,0
67776,1208,575,633,187,204,117,41,201,93,108,34,39,21,6,0
67777,700,305,395,111,99,54,18,778,391,387,94,77,41,33,0
67778,431,245,186,50,23,46,17,334,182,152,45,41,27,13,0
67779,1189,653,536,152,118,109,56,137,72,65,27,13,15,8,0
67780,250,123,127,40,28,29,8,434,213,221,77,62,53,12,0
67781,325,181,144,46,31,48,9,295,160,135,44,36,46,16,0
67782,650,330,320,97,77,65,28,169,74,95,33,26,22,3,0
67783,297,182,115,41,22,23,8,481,223,258,71,70,49,26,0
67784,522,302,220,61,49,75,19,359,171,188,49,74,45,11,0
67785,439,205,234,64,88,41,21,119,61,58,17,12,10,6,0
67786,546,285,261,71,49,47,24,201,104,97,36,32,24,7,0
67787,681,367,314,83,74,78,31,904,436,468,143,118,108,32,0
67788,496,209,287,113,55,72,14,649,307,342,71,134,45,17,0
67789,730,298,432,128,69,86,26,354,188,166,46,40,34,10,0
67790,425,220,205,60,55,45,18,459,260,199,56,42,47,21,0
67791,435,222,213,67,49,67,12,277,152,125,31,35,22,19,0
67792,129,70,59,29,9,7,2,265,134,131,48,34,33,15,0
67793,188,84,104,35,36,18,9,475,251,224,67,49,48,23,0
67794,437,228,209,47,61,26,11,467,226,241,55,48,54,23,0
67795,119,59,60,29,10,6,4,536,267,269,60,70,41,22,0
67796,288,104,184,80,30,39,6,903,436,467,128,116,83,33,0
67797,610,249,361,107,69,72,33,526,266,260,76,75,53,22,0
67798,178,87,91,20,32,13,10,422,237,185,53,47,62,20,0
67799,125,46,79,24,16,12,2,480,255,225,67,64,50,22,0
67800,447,232,215,55,65,50,25,520,240,280,67,72,42,14,0
67801,589,282,307,68,67,70,23,418,223,195,53,43,49,15,0
67802,479,228,251,71,57,60,14,225,129,96,32,33,20,8,0
67803,763,354,409,101,90,63,26,368,200,168,54,49,43,9,0
67804,627,237,390,137,57,108,44,96,46,50,16,12,7,5,0
67805,362,181,181,67,46,43,8,404,190,214,55,55,35,27,0
67806,126,57,69,31,10,10,3,1062,522,540,151,147,105,66,0
67807,526,268,258,54,37,55,12,597,269,328,102,84,69,24,0
67808,480,257,223,74,26,60,27,349,200,149,41,39,30,20,0
67809,428,226,202,52,60,75,20,1113,480,633,170,173,81,34,0
67810,249,114,135,47,33,25,4,2202,1121,1081,338,274,269,81,0
67811,532,291,241,83,36,79,25,1606,753,853,215,227,182,48,0
67812,496,210,286,111,55,74,13,541,279,262,79,82,31,32,0
67813,200,94,106,33,22,18,8,175,82,93,33,26,17,5,0
67814,344,109,235,100,39,26,5,188,105,83,25,17,24,7,0
67815,76,30,46,7,15,1,5,858,398,460,126,138,75,39,0
67816,803,358,445,135,117,80,43,373,213,160,44,33,26,17,0
67817,756,362,394,102,104,73,25,562,273,289,76,92,45,24,0
67818,341,183,158,36,34,36,15,98,49,49,14,15,9,2,0
67819,784,353,431,56,47,26,18,346,178,168,58,41,33,12,0
67820,146,73,73,18,24,17,9,332,155,177,55,51,44,13,0
67821,264,122,142,33,29,13,13,111,60,51,17,23,10,7,0
67822,1970,978,992,245,206,198,80,286,160,126,37,27,23,10,0
67823,546,278,268,94,60,32,22,335,170,165,52,36,47,11,0
67824,584,340,244,77,60,47,25,1047,562,485,141,127,114,41,0
67825,854,435,419,118,91,95,42,127,66,61,13,14,19,8,0
67826,312,164,148,54,29,25,15,296,159,137,49,28,38,13,0
67827,860,349,511,166,166,58,19,127,64,63,26,8,12,8,0
67828,588,300,288,100,57,65,27,627,323,304,81,90,53,27,0
67829,204,103,101,16,32,22,8,504,272,232,75,57,53,19,0
67830,728,358,370,118,100,55,29,736,388,348,88,85,67,28,0
67831,385,203,182,47,43,51,21,119,61,58,17,12,10,6,0
67832,284,160,124,37,23,32,11,410,197,213,67,43,56,18,0
67833,500,257,243,60,55,27,22,144,67,77,28,14,9,8,0
67834,837,381,456,123,109,65,25,1114,539,575,145,131,94,56,0
67835,136,66,70,33,11,9,4,1755,905,850,214,196,183,79,0
67836,979,534,445,83,77,80,24,821,394,427,122,117,109,38,0
67837,441,218,223,69,55,50,27,671,306,365,114,76,49,19,0
67838,179,78,101,29,22,10,8,414,203,211,58,56,48,14,0
67839,305,124,181,27,25,31,21,289,140,149,33,42,30,15,0
67840,102,22,80,48,8,18,6,290,142,148,41,37,43,11,0
67841,428,248,180,44,39,28,9,514,248,266,86,82,52,22,0
67842,444,250,194,58,21,60,23,178,99,79,31,19,26,8,0
67843,517,196,321,103,98,33,12,105,51,54,13,17,12,8,0
67844,553,319,234,56,37,54,18,1507,737,770,188,228,147,71,0
67845,269,156,113,37,32,17,7,320,168,152,38,42,24,18,0
67846,199,107,92,41,15,14,8,209,119,90,28,24,27,9,0
67847,349,167,182,54,38,30,28,94,45,49,11,20,10,4,0
67848,484,261,223,59,48,49,24,1507,737,770,188,228,147,71,0
67849,341,195,146,42,21,36,9,535,301,234,63,48,47,27,0
67850,350,190,160,48,25,27,18,1040,564,476,134,110,114,51,0
67851,417,176,241,75,61,51,20,551,226,325,96,103,43,11,0
67852,860,348,512,121,136,75,35,516,245,271,82,84,70,26,0
67853,507,242,265,53,44,31,22,65,32,33,16,4,8,3,0
67854,594,279,315,93,68,68,26,665,361,304,87,91,84,31,0
67855,1051,429,622,179,148,125,54,966,478,488,108,144,74,43,0
67856,654,344,310,80,69,57,15,538,274,264,84,67,52,35,0
67857,493,281,212,56,61,30,13,290,142,148,41,37,43,11,0
67858,532,291,241,83,36,79,25,517,295,222,69,62,40,28,0
67859,476,276,200,57,34,43,16,158,71,87,23,21,17,12,0
67860,297,161,136,36,35,24,9,290,147,143,34,34,39,13,0
67861,339,170,169,32,17,24,13,308,146,162,42,39,24,12,0
67862,157,62,95,41,18,10,11,507,270,237,89,59,57,22,0
67863,1647,794,853,279,235,128,65,501,274,227,63,58,53,20,0
67864,861,393,468,150,101,69,35,619,305,314,85,93,71,29,0
67865,1365,590,775,257,168,136,93,320,168,152,38,42,24,18,0
67866,478,220,258,47,70,41,10,256,141,115,32,22,32,8,0
67867,257,148,109,28,20,21,14,260,133,127,43,32,39,3,0
67868,625,283,342,93,89,67,25,368,200,168,54,49,43,9,0
67869,399,196,203,62,45,38,19,583,321,262,73,67,45,25,0
67870,1139,537,602,162,139,109,50,136,65,71,26,11,7,5,0
67871,126,58,68,31,10,10,3,1700,731,969,198,233,110,87,0
67872,429,238,191,47,49,56,29,375,176,199,48,61,40,12,0
67873,739,323,416,127,89,76,33,811,361,450,124,107,80,31,0
67874,466,259,207,59,50,83,12,374,174,200,54,52,42,21,0
67875,1171,542,629,170,146,114,64,335,170,165,52,36,47,11,0
67876,1208,575,633,187,204,117,41,164,79,85,28,28,16,7,0
67877,242,104,138,41,33,37,8,396,199,197,54,50,45,14,0
67878,758,378,380,89,64,37,31,385,212,173,57,40,39,21,0
67879,401,204,197,49,33,29,17,148,69,79,26,18,16,3,0
67880,119,67,52,15,15,7,7,821,394,427,122,117,109,38,0
67881,415,217,198,50,31,42,17,225,129,96,32,33,20,8,0
67882,640,271,369,111,79,57,17,370,173,197,65,57,42,10,0
67883,136,66,70,33,11,9,4,736,388,348,88,85,67,28,0
67884,728,358,370,118,100,55,29,137,72,65,27,13,15,8,0
67885,331,144,187,57,46,33,19,737,397,340,87,104,90,14,0
67886,338,208,130,39,30,35,12,732,366,366,108,86,74,41,0
67887,813,412,401,114,93,112,26,974,457,517,133,117,69,26,0
67888,1447,698,749,214,180,116,46,228,130,98,35,29,30,10,0
67889,786,378,408,106,98,77,39,330,166,164,55,51,36,16,0
67890,1124,442,682,148,189,72,43,508,261,247,65,53,58,23,0
67891,301,119,182,53,47,14,20,1507,737,770,188,228,147,71,0
67892,529,290,239,54,63,85,15,1698,875,823,222,219,173,64,0
67893,126,57,69,31,10,10,3,978,536,442,132,107,67,32,0
67894,2220,1085,1135,312,304,202,91,278,154,124,42,32,38,7,0
67895,1276,607,669,192,178,136,63,332,180,152,44,36,27,13,0
67896,270,166,104,30,26,28,14,286,160,126,37,27,23,10,0
67897,282,135,147,27,37,30,19,201,98,103,28,25,19,13,0
67898,1594,660,934,251,272,117,77,305,163,142,38,27,47,11,0
67899,2174,1057,1117,241,241,214,117,293,142,151,49,40,42,17,0
67900,346,191,155,52,38,40,13,1249,638,611,166,153,141,45,0
67901,548,310,238,72,62,54,13,481,223,258,71,70,49,26,0
67902,309,137,172,51,50,28,14,561,279,282,85,81,88,24,0
67903,2136,1063,1073,317,308,223,90,611,314,297,79,75,78,22,0
67904,496,209,287,112,55,71,14,462,229,233,63,49,42,18,0
67905,221,80,141,48,37,14,10,406,223,183,61,53,46,17,0
67906,584,340,244,77,60,47,25,246,125,121,38,36,30,11,0
67907,631,316,315,64,57,49,15,261,127,134,36,27,36,4,0
67908,886,440,446,116,140,95,45,295,156,139,41,40,42,15,0
67909,524,262,262,62,72,39,49,1001,417,584,186,147,96,47,0
67910,747,469,278,60,41,53,23,403,192,211,102,39,49,15,0
67911,736,320,416,113,97,61,36,180,89,91,28,27,18,7,0
67912,359,167,192,49,37,27,19,175,82,93,33,26,17,5,0
67913,344,109,235,100,39,26,5,704,355,349,113,94,71,24,0
67914,109,42,67,25,13,1,1,1241,619,622,183,169,155,59,0
67915,255,136,119,39,20,32,10,935,515,420,126,107,73,32,0
67916,325,181,144,46,31,48,9,297,175,122,46,30,31,6,0
67917,789,362,427,90,82,70,35,194,94,100,33,28,14,7,0
67918,301,156,145,32,25,15,5,455,191,264,68,86,21,19,0
67919,365,210,155,46,30,24,12,307,132,175,48,53,26,10,0
67920,664,269,395,117,107,36,15,629,317,312,80,87,51,22,0
67921,3230,1724,1506,361,358,157,75,308,146,162,42,39,24,12,0
67922,454,230,224,63,56,38,33,392,155,237,68,61,34,16,0
67923,359,167,192,49,37,27,19,1101,626,475,145,122,120,50,0
67924,586,309,277,81,64,76,25,1336,599,737,246,184,122,74,0
67925,785,374,411,56,42,38,25,975,400,575,160,162,62,31,0
67926,338,172,166,59,30,39,18,200,89,111,26,25,17,7,0
67927,529,290,239,54,63,85,15,724,353,371,94,95,71,31,0
67928,752,313,439,121,106,68,27,307,132,175,48,53,26,10,0
67929,57,24,33,11,3,5,3,180,89,91,28,27,18,7,0
67930,763,354,409,101,90,63,26,381,186,195,69,55,46,15,0
67931,203,80,123,40,37,20,3,437,221,216,62,64,47,13,0
67932,489,253,236,73,36,62,17,475,251,224,67,49,48,23,0
67933,1004,498,506,94,59,46,33,87,38,49,23,10,10,9,0
67934,172,98,74,20,21,22,8,389,210,179,51,37,43,9,0
67935,339,118,221,77,68,33,13,270,130,140,48,44,37,12,0
67936,421,237,184,47,54,45,10,389,207,182,53,58,52,18,0
67937,273,126,147,54,49,25,18,469,225,244,64,68,25,11,0
67938,126,56,70,31,10,10,3,164,79,85,28,28,16,7,0
67939,781,316,465,130,129,65,23,457,242,215,39,46,53,10,0
67940,278,104,174,46,34,23,14,434,213,221,77,62,53,12,0
67941,977,462,515,185,119,76,12,302,150,152,56,40,52,15,0
67942,364,172,192,55,57,32,15,362,156,206,74,42,36,22,0
67943,828,355,473,126,134,77,37,496,251,245,78,62,61,23,0
67944,342,185,157,42,27,31,14,447,212,235,86,55,58,21,0
67945,138,35,103,38,2,15,9,207,113,94,33,18,30,9,0
67946,361,171,190,44,40,18,13,660,332,328,84,73,47,19,0
67947,1004,498,506,94,59,46,33,89,42,47,16,12,15,6,0
67948,1112,457,655,180,164,99,39,403,225,178,56,38,33,25,0
67949,627,237,390,137,57,108,44,925,439,486,141,134,105,46,0
67950,301,150,151,45,47,33,13,415,189,226,68,54,50,21,0
67951,76,42,34,12,8,5,7,360,180,180,57,48,39,12,0
67952,155,85,70,17,16,4,8,761,351,410,117,73,103,45,0
67953,764,277,487,158,162,64,31,160,76,84,19,24,8,5,0
67954,333,171,162,50,34,19,8,583,280,303,95,66,76,25,0
67955,325,181,144,46,31,48,9,1062,522,540,151,147,105,66,0
67956,1001,422,579,185,180,51,32,627,323,304,81,90,53,27,0
67957,401,236,165,53,38,34,9,508,253,255,73,60,50,13,0
67958,496,210,286,112,55,72,13,198,110,88,27,27,24,4,0
67959,125,53,72,18,21,18,12,627,323,304,81,90,53,27,0
67960,574,269,305,91,63,54,27,462,251,211,74,53,41,18,0
67961,360,175,185,73,36,27,7,517,295,222,69,62,40,28,0
67962,282,96,186,80,21,28,7,316,159,157,38,48,30,11,0
67963,685,393,292,75,66,113,16,180,108,72,22,22,15,5,0
67964,374,187,187,51,52,40,27,607,293,314,98,71,62,32,0
67965,887,439,448,137,99,91,38,445,264,181,35,35,34,14,0
67966,372,171,201,47,53,39,18,289,140,149,33,42,30,15,0
67967,579,281,298,91,78,74,27,536,222,314,101,100,34,22,0
67968,959,496,463,144,132,75,35,194,94,100,33,28,14,7,0
67969,99,35,64,25,18,0,1,2517,1275,1242,304,324,245,135,0
67970,184,93,91,26,25,14,11,260,131,129,42,31,40,9,0
67971,204,93,111,35,35,16,11,1922,923,999,267,275,215,90,0
67972,346,186,160,50,33,27,12,280,128,152,39,37,38,18,0
67973,401,204,197,49,33,29,17,180,95,85,22,21,17,8,0
67974,413,169,244,66,94,28,19,597,269,328,102,84,69,24,0
67975,218,133,85,20,19,13,6,903,436,467,128,116,83,33,0
67976,136,66,70,33,11,9,4,535,311,224,66,52,49,24,0
67977,895,388,507,130,84,90,31,277,152,125,31,35,22,19,0
67978,86,50,36,9,14,8,7,389,210,179,51,37,43,9,0
67979,158,85,73,24,18,18,8,147,74,73,28,20,24,4,0
67980,469,253,216,49,51,48,18,374,202,172,50,39,31,24,0
67981,434,221,213,58,47,54,15,415,205,210,77,52,55,17,0
67982,500,297,203,66,33,53,15,556,290,266,75,74,29,24,0
67983,525,302,223,56,48,67,19,187,89,98,36,24,20,6,0
67984,752,313,439,121,106,68,27,339,175,164,51,49,37,9,0
67985,67,40,27,10,8,7,6,72,34,38,8,2,3,12,0
67986,260,120,140,34,39,36,12,926,340,586,133,119,60,40,0
67987,505,247,258,72,71,60,27,373,181,192,54,35,44,20,0
67988,360,175,185,73,36,27,7,192,91,101,29,28,17,7,0
67989,2488,1085,1403,346,253,162,76,274,142,132,33,34,18,14,0
67990,677,361,316,81,61,42,22,1182,591,591,155,139,83,46,0
67991,1163,417,746,209,145,87,28,261,127,134,36,27,36,4,0
67992,519,259,260,86,78,59,22,873,411,462,132,107,84,40,0
67993,2062,706,1356,414,368,158,63,169,85,84,21,14,9,9,0
67994,1124,442,682,148,189,72,43,386,207,179,43,48,44,19,0
67995,785,351,434,136,93,71,37,469,225,244,64,68,25,11,0
67996,305,124,181,27,25,32,21,598,333,265,79,66,54,33,0
67997,126,57,69,31,10,10,3,508,262,246,66,67,51,20,0
67998,789,362,427,90,82,70,35,127,64,63,26,8,12,8,0
67999,193,90,103,44,9,19,13,2038,1059,979,262,237,208,100,0
68000,227,120,107,31,28,28,13,605,283,322,94,72,64,39,0
68001,1161,514,647,159,138,122,37,301,168,133,49,37,34,11,0
68002,299,128,171,57,40,13,25,530,287,243,79,70,33,26,0
68003,528,188,340,130,58,77,41,585,277,308,92,73,61,32,0
68004,224,108,116,31,32,22,8,531,261,270,73,80,68,26,0
68005,380,148,232,81,69,24,8,375,210,165,49,37,29,27,0
68006,221,114,107,65,7,2,1,89,37,52,13,6,2,9,0
68007,919,493,426,100,92,88,49,479,215,264,67,80,46,28,0
68008,879,457,422,93,98,143,32,325,172,153,44,34,27,14,0
68009,488,237,251,79,78,65,27,478,254,224,67,74,56,28,0
68010,164,81,83,37,8,14,10,180,95,85,22,21,17,8,0
68011,414,206,208,56,68,35,19,362,156,206,74,42,36,22,0
68012,677,361,316,81,61,42,22,622,344,278,80,77,68,36,0
68013,580,265,315,97,89,79,17,403,225,178,56,38,33,25,0
68014,326,148,178,55,42,31,12,1154,489,665,200,196,95,54,0
68015,130,70,60,30,9,8,1,234,116,118,34,35,23,9,0
68016,1047,443,604,162,156,78,52,222,127,95,23,28,22,7,0
68017,1395,595,800,223,206,113,61,501,257,244,75,57,48,29,0
68018,677,361,316,81,61,42,22,720,361,359,98,98,70,37,0
68019,372,189,183,60,44,41,18,621,310,311,100,106,77,27,0
68020,579,246,333,102,79,41,19,424,179,245,65,67,29,11,0
68021,279,127,152,50,36,28,8,335,186,149,40,28,29,13,0
68022,963,477,486,134,143,123,38,1047,562,485,141,127,114,41,0
68023,135,64,71,31,11,8,4,926,340,586,133,119,60,40,0
68024,200,94,106,33,22,18,8,396,197,199,75,49,49,16,0
68025,180,57,123,39,22,10,8,627,289,338,101,73,62,43,0
68026,284,160,124,37,23,32,11,751,394,357,107,96,73,35,0
68027,795,384,411,133,109,85,38,469,225,244,64,68,25,11,0
68028,346,209,137,46,37,44,10,389,207,182,53,58,52,18,0
68029,588,267,321,99,79,87,28,267,141,126,53,27,23,7,0
68030,1390,705,685,219,164,129,74,947,482,465,143,107,89,37,0
68031,215,80,135,54,56,21,9,178,69,109,29,25,21,13,0
68032,2136,1063,1073,317,308,223,90,526,266,260,76,75,53,22,0
68033,299,128,171,57,40,13,25,480,255,225,67,64,50,22,0
68034,478,220,258,47,70,41,10,630,321,309,86,90,57,26,0
68035,227,120,107,31,28,28,13,106,46,60,27,18,12,3,0
68036,545,221,324,101,72,55,30,699,334,365,108,80,70,20,0
68037,167,70,97,32,20,15,7,370,190,180,60,52,37,13,0
68038,103,56,47,27,7,8,2,866,478,388,121,101,101,26,0
68039,338,208,130,39,30,35,12,73,35,38,14,10,9,4,0
68040,746,312,434,129,115,77,47,664,350,314,86,90,82,36,0
68041,472,222,250,46,61,33,23,123,61,62,17,18,17,7,0
68042,410,211,199,55,42,34,27,463,259,204,62,55,34,22,0
68043,389,176,213,81,59,24,7,374,191,183,40,52,40,16,0
68044,334,155,179,47,34,38,11,129,60,69,21,15,8,5,0
68045,290,156,134,44,29,39,9,538,274,264,84,67,52,35,0
68046,107,36,71,27,15,0,1,277,145,132,41,32,22,10,0
68047,180,92,88,29,20,26,8,218,114,104,32,31,33,11,0
68048,135,64,71,31,11,8,4,445,192,253,86,58,53,18,0
68049,595,339,256,64,36,54,24,761,351,410,117,73,103,45,0
68050,373,164,209,51,45,44,21,898,469,429,125,125,134,35,0
68051,432,190,242,85,82,28,11,483,287,196,71,50,54,17,0
68052,109,42,67,25,13,1,1,892,475,417,130,108,68,38,0
68053,393,223,170,44,36,32,14,744,385,359,105,96,57,31,0
68054,616,323,293,98,71,31,15,316,159,157,38,48,30,11,0
68055,130,71,59,30,9,8,1,621,273,348,104,102,48,19,0
68056,1030,567,463,118,106,94,49,142,73,69,27,9,15,11,0
68057,154,74,80,18,19,7,2,660,332,328,84,73,47,19,0
68058,932,575,357,94,69,76,40,457,242,215,39,46,53,10,0
68059,389,176,213,81,59,24,7,370,190,180,60,52,37,13,0
68060,467,233,234,83,37,77,22,414,203,211,58,56,48,14,0
68061,125,46,79,24,16,12,2,316,159,157,38,48,30,11,0
68062,580,281,299,95,60,74,29,756,348,408,101,103,60,40,0
68063,574,269,305,91,63,54,27,1101,626,475,145,122,120,50,0
68064,426,196,230,76,65,54,20,509,267,242,79,81,38,20,0
68065,488,237,251,79,78,65,27,780,337,443,112,116,77,28,0
68066,1143,574,569,176,151,123,59,169,84,85,29,19,21,7,0
68067,1087,523,564,146,177,103,33,134,55,79,22,24,16,6,0
68068,260,138,122,44,30,28,6,410,197,213,67,43,56,18,0
68069,747,469,278,60,41,53,23,314,177,137,34,40,29,9,0
68070,854,435,419,118,91,95,42,135,65,70,21,25,15,9,0
68071,364,172,192,55,57,32,15,266,150,116,28,28,24,12,0
68072,271,110,161,33,27,11,8,348,194,154,57,31,43,12,0
68073,473,265,208,47,26,50,30,900,441,459,125,127,110,32,0
68074,288,142,146,52,32,26,8,1922,923,999,267,275,215,90,0
68075,707,250,457,171,84,117,61,520,244,276,91,60,68,20,0
68076,326,148,178,55,42,31,12,449,252,197,61,52,36,18,0
68077,502,229,273,63,66,40,31,430,212,218,88,43,40,20,0
68078,368,201,167,61,38,38,12,429,187,242,79,72,28,19,0
68079,484,192,292,118,68,83,22,350,196,154,52,37,21,14,0
68080,318,164,154,52,43,34,10,449,252,197,61,52,36,18,0
68081,598,300,298,68,77,59,21,732,402,330,81,86,87,33,0
68082,413,236,177,41,25,35,19,1314,693,621,174,155,140,58,0
68083,1186,495,691,182,208,88,32,277,138,139,40,39,20,14,0
68084,365,148,217,86,37,51,28,220,107,113,36,35,28,9,0
68085,574,284,290,64,50,65,20,354,183,171,54,43,49,8,0
68086,983,449,534,95,77,55,36,421,222,199,69,50,60,18,0
68087,531,260,271,97,68,47,11,171,94,77,24,28,30,11,0
68088,346,173,173,50,56,31,14,323,168,155,51,41,38,12,0
68089,521,289,232,71,58,49,16,422,237,185,53,47,62,20,0
68090,193,107,86,13,20,13,6,242,124,118,39,32,28,22,0
68091,1214,498,716,197,180,121,65,251,143,108,47,25,29,11,0
68092,346,205,141,47,34,30,7,453,255,198,62,49,29,19,0
68093,411,211,200,61,46,35,18,536,251,285,75,79,60,23,0
68094,1531,649,882,108,122,93,72,892,475,417,130,108,68,38,0
68095,764,277,487,158,162,64,31,175,91,84,19,21,21,10,0
68096,269,156,113,37,32,17,7,381,186,195,69,55,46,15,0
68097,859,411,448,118,100,95,49,662,312,350,103,104,59,20,0
68098,260,133,127,43,29,34,11,314,151,163,42,61,39,16,0
68099,1711,865,846,204,176,105,60,335,170,165,52,36,47,11,0
68100,594,279,315,93,68,68,26,295,158,137,42,34,38,14,0
68101,437,212,225,66,44,44,11,583,321,262,73,67,45,25,0
68102,785,325,460,114,123,61,28,385,212,173,57,40,39,21,0
68103,313,178,135,43,18,35,6,555,292,263,75,63,67,27,0
68104,83,45,38,11,8,8,3,198,115,83,30,22,8,8,0
68105,1068,434,634,173,160,61,29,169,74,95,33,26,22,3,0
68106,122,56,66,26,13,11,5,317,161,156,40,49,41,11,0
68107,269,124,145,36,24,32,11,309,164,145,35,47,30,11,0
68108,651,357,294,81,67,103,18,1698,875,823,222,219,173,64,0
68109,224,108,116,33,26,32,10,405,181,224,71,57,31,12,0
68110,928,442,486,139,118,91,43,1062,522,540,151,147,105,66,0
68111,1960,875,1085,287,189,162,66,508,261,247,65,53,58,23,0
68112,416,222,194,58,38,38,20,497,257,240,71,63,62,16,0
68113,130,70,60,30,9,8,1,662,312,350,103,104,59,20,0
68114,1556,718,838,280,182,161,49,601,278,323,124,87,65,21,0
68115,164,77,87,33,19,6,7,504,272,232,75,57,53,19,0
68116,103,56,47,27,7,8,2,418,223,195,51,45,49,14,0
68117,313,158,155,43,35,43,16,749,384,365,108,105,86,31,0
68118,584,297,287,89,80,65,17,366,204,162,47,41,31,23,0
68119,406,208,198,41,26,43,21,600,254,346,104,100,44,17,0
68120,344,109,235,100,39,26,5,222,127,95,23,28,22,7,0
68121,371,209,162,46,17,36,19,736,388,348,88,85,67,28,0
68122,593,282,311,75,70,29,25,437,221,216,62,64,47,13,0
68123,362,174,188,46,55,35,23,925,439,486,141,134,105,46,0
68124,580,240,340,108,81,59,22,562,273,289,76,92,45,24,0
68125,854,435,419,118,91,95,42,1698,875,823,222,219,173,64,0
68126,2174,1057,1117,241,241,214,117,422,237,185,53,47,62,20,0
68127,466,199,267,86,59,32,17,975,475,500,139,140,119,28,0
68128,308,129,179,44,60,19,8,517,295,222,69,62,40,28,0
68129,784,353,431,56,47,26,18,751,394,357,107,96,73,35,0
68130,257,132,125,39,27,26,10,286,160,126,37,27,23,10,0
68131,402,169,233,70,36,34,18,164,79,85,28,28,16,7,0
68132,773,383,390,108,76,79,30,256,141,115,32,22,32,8,0
68133,475,208,267,84,67,50,20,387,193,194,60,53,57,15,0
68134,692,305,387,100,97,78,30,418,246,172,52,39,57,10,0
68135,764,277,487,158,162,64,31,1537,701,836,209,187,129,58,0
68136,107,53,54,15,15,13,4,601,279,322,81,65,27,12,0
68137,399,196,203,62,45,38,19,245,121,124,37,35,36,12,0
68138,412,203,209,65,47,37,18,602,310,292,87,66,70,36,0
68139,144,57,87,38,26,10,4,2346,1231,1115,316,292,266,105,0
68140,486,243,243,65,48,63,22,673,313,360,102,101,46,17,0
68141,267,146,121,40,24,25,7,225,129,96,32,33,20,8,0
68142,348,198,150,57,25,37,18,621,310,311,100,106,77,27,0
68143,251,139,112,41,18,27,11,483,287,196,71,50,54,17,0
68144,643,284,359,129,71,84,43,173,94,79,18,24,12,7,0
68145,704,342,362,113,91,85,33,137,63,74,20,22,14,6,0
68146,508,267,241,43,35,25,17,288,156,132,36,36,24,15,0
68147,340,145,195,46,38,26,23,445,264,181,35,35,34,14,0
68148,1120,436,684,208,120,101,115,274,157,117,40,29,40,8,0
68149,579,281,298,91,78,74,27,963,525,438,119,102,102,34,0
68150,305,124,181,27,25,31,21,515,276,239,62,59,43,31,0
68151,548,250,298,85,64,56,21,727,362,365,123,107,63,23,0
68152,507,314,193,49,45,59,25,198,115,83,30,22,8,8,0
68153,350,190,160,48,25,27,18,395,198,197,55,55,36,10,0
68154,446,265,181,51,35,27,17,277,152,125,31,35,22,19,0
68155,465,220,245,88,34,61,23,381,186,195,69,55,46,15,0
68156,1058,497,561,194,142,87,63,381,186,195,69,55,46,15,0
68157,643,284,359,129,71,84,43,328,195,133,39,40,27,13,0
68158,567,256,311,91,81,53,17,270,162,108,26,26,16,11,0
68159,2696,1169,1527,432,347,193,146,241,127,114,34,33,29,12,0
68160,331,144,187,57,46,33,19,723,353,370,120,109,96,33,0
68161,308,129,179,44,60,19,8,535,311,224,66,52,49,24,0
68162,178,74,104,31,28,9,4,457,242,215,39,46,53,10,0
68163,828,368,460,118,98,59,38,518,292,226,60,60,52,21,0
68164,561,282,279,68,62,36,14,354,188,166,46,40,34,10,0
68165,331,169,162,40,28,22,14,601,278,323,124,87,65,21,0
68166,117,57,60,17,14,11,10,929,459,470,140,120,94,45,0
68167,210,84,126,44,43,9,4,501,257,244,75,57,48,29,0
68168,503,260,243,46,56,33,16,68,36,32,11,8,9,2,0
68169,444,250,194,58,21,60,23,264,138,126,33,34,29,12,0
68170,366,190,176,39,62,55,14,749,384,365,108,105,86,31,0
68171,504,222,282,71,64,53,29,862,426,436,113,115,84,37,0
68172,246,123,123,40,31,27,7,418,223,195,53,43,49,15,0
68173,2063,1024,1039,175,117,80,97,434,213,221,77,62,53,12,0
68174,1148,472,676,229,164,86,37,106,41,65,36,6,11,7,0
68175,338,173,165,31,42,22,10,387,193,194,60,53,57,15,0
68176,217,98,119,38,35,18,9,270,162,108,26,26,16,11,0
68177,172,82,90,21,35,21,5,548,273,275,84,81,64,30,0
68178,270,131,139,47,37,41,11,415,203,212,77,44,49,18,0
68179,983,449,534,95,77,55,36,1239,659,580,169,148,131,54,0
68180,1030,438,592,184,104,108,30,2547,1280,1267,331,335,293,118,0
68181,103,56,47,27,7,8,2,455,229,226,66,62,63,29,0
68182,225,111,114,38,22,25,10,452,252,200,55,49,61,16,0
68183,435,222,213,67,49,67,12,2225,1244,981,271,243,217,93,0
68184,426,213,213,60,56,46,24,132,77,55,20,9,13,10,0
68185,437,230,207,41,55,27,13,480,255,225,67,64,50,22,0
68186,535,315,220,57,55,71,19,463,268,195,59,46,46,21,0
68187,1544,738,806,239,217,145,91,261,148,113,31,28,14,10,0
68188,374,202,172,58,40,41,7,457,242,215,39,46,53,10,0
68189,538,263,275,71,85,44,18,288,156,132,36,36,24,15,0
68190,138,35,103,38,2,15,9,548,296,252,71,74,43,28,0
68191,257,132,125,39,27,26,10,201,98,103,28,25,19,13,0
68192,508,267,241,43,35,25,17,234,129,105,31,22,19,17,0
68193,565,264,301,101,73,72,15,88,50,38,13,8,16,4,0
68194,781,367,414,60,67,43,17,729,358,371,116,99,89,33,0
68195,688,310,378,130,82,78,47,406,223,183,61,53,46,17,0
68196,1096,563,533,158,136,120,53,487,252,235,79,58,55,26,0
68197,57,24,33,11,3,5,3,131,55,76,28,9,14,12,0
68198,132,66,66,21,18,11,7,381,196,185,55,57,43,16,0
68199,234,108,126,42,40,15,9,225,129,96,32,33,20,8,0
68200,548,250,298,85,64,56,21,1113,480,633,170,173,81,34,0
68201,525,302,223,56,48,67,19,349,200,149,41,39,30,20,0
68202,255,136,119,39,20,32,10,381,187,194,37,49,36,17,0
68203,224,108,116,31,32,22,8,349,200,149,41,39,30,20,0
68204,240,166,74,32,12,8,15,127,66,61,13,14,19,8,0
68205,745,402,343,95,71,69,40,127,64,63,26,8,12,8,0
68206,186,56,130,46,50,16,7,367,218,149,45,43,42,16,0
68207,1112,457,655,180,164,99,39,600,254,346,104,100,44,17,0
68208,278,110,168,58,49,29,5,783,406,377,102,91,57,29,0
68209,439,211,228,65,73,26,21,293,153,140,45,38,22,15,0
68210,445,231,214,45,64,53,23,354,188,166,46,40,34,10,0
68211,232,134,98,28,20,20,5,430,212,218,88,43,40,20,0
68212,347,181,166,27,20,12,12,1352,602,750,166,185,81,70,0
68213,593,282,311,75,70,29,25,619,305,314,85,93,71,29,0
68214,164,81,83,37,8,14,10,338,169,169,53,44,39,21,0
68215,714,260,454,140,97,120,54,729,358,371,116,99,89,33,0
68216,338,139,199,54,54,18,11,204,96,108,31,37,20,5,0
68217,593,282,311,75,70,29,25,377,184,193,50,43,33,17,0
68218,117,58,59,17,17,12,2,1113,480,633,170,173,81,34,0
68219,412,203,209,65,47,37,18,86,40,46,16,13,9,7,0
68220,496,209,287,112,55,71,14,557,281,276,80,59,43,21,0
68221,482,231,251,76,81,64,26,207,113,94,33,18,30,9,0
68222,514,226,288,71,66,63,32,732,366,366,108,86,74,41,0
68223,269,156,113,37,32,17,7,744,385,359,105,96,57,31,0
68224,346,168,178,36,43,20,9,723,363,360,107,106,52,14,0
68225,136,65,71,33,11,9,6,773,389,384,119,91,79,26,0
68226,582,328,254,78,48,35,9,215,115,100,27,19,16,7,0
68227,157,62,95,41,18,10,11,196,105,91,40,13,19,10,0
68228,90,54,36,20,4,14,5,180,90,90,31,19,20,8,0
68229,123,58,65,22,14,13,3,339,175,164,51,49,37,9,0
68230,1087,523,564,146,177,103,33,130,67,63,24,10,12,4,0
68231,1556,718,838,280,182,161,49,549,273,276,74,68,72,24,0
68232,300,136,164,45,35,45,14,370,190,180,60,52,37,13,0
68233,318,161,157,53,51,32,13,906,455,451,116,105,87,46,0
68234,426,213,213,60,56,46,24,87,51,35,15,9,9,4,0
68235,258,126,132,38,22,29,8,271,150,121,39,36,37,5,0
68236,758,378,380,89,64,37,31,245,131,114,30,27,18,13,0
68237,245,111,134,36,27,18,6,148,69,79,26,18,16,3,0
68238,5890,3314,2576,970,956,293,265,536,251,285,75,79,60,23,0
68239,437,228,209,47,61,26,11,204,96,108,31,37,20,5,0
68240,361,171,190,44,40,18,13,334,181,153,56,31,28,18,0
68241,454,214,240,56,71,35,16,1262,653,609,169,165,152,50,0
68242,1556,718,838,280,182,161,49,337,170,167,59,33,47,17,0
68243,682,260,422,98,83,42,31,107,77,30,7,2,9,5,0
68244,579,321,258,74,70,47,22,134,55,79,22,24,16,6,0
68245,708,344,364,106,98,66,33,662,373,289,89,80,77,29,0
68246,188,84,104,35,36,18,9,144,67,77,28,14,9,8,0
68247,1463,521,942,252,204,105,52,496,285,211,62,54,46,22,0
68248,786,378,408,106,98,77,39,741,383,358,92,63,79,36,0
68249,160,53,107,31,29,13,3,89,37,52,13,6,2,9,0
68250,784,351,433,118,87,73,41,1500,804,696,190,172,144,60,0
68251,291,131,160,49,35,32,15,457,253,204,67,51,48,13,0
68252,648,262,386,113,108,78,29,89,51,38,15,15,5,4,0
68253,184,93,91,26,25,14,11,374,181,193,55,58,48,23,0
68254,1755,849,906,245,226,148,56,220,107,113,36,35,28,9,0
68255,1121,458,663,158,210,76,47,548,296,252,71,74,43,28,0
68256,314,158,156,39,28,30,17,72,32,40,8,2,1,14,0
68257,840,411,429,122,101,79,34,780,337,443,112,116,77,28,0
68258,919,444,475,141,148,62,20,501,240,261,80,62,49,42,0
68259,329,168,161,48,34,41,16,288,156,132,36,36,24,15,0
68260,639,368,271,72,51,38,38,260,133,127,43,32,39,3,0
68261,255,136,119,39,20,32,10,212,127,85,28,21,26,6,0
68262,215,117,98,28,19,15,8,287,151,136,51,42,36,7,0
68263,445,231,214,45,64,53,23,296,140,156,49,40,42,19,0
68264,275,125,150,37,48,27,7,664,350,314,86,90,82,36,0
68265,282,105,177,77,28,39,6,175,91,84,19,21,21,10,0
68266,717,381,336,118,103,85,29,376,183,193,50,50,43,21,0
68267,292,102,190,71,27,51,21,600,254,346,104,100,44,17,0
68268,1463,521,942,252,204,105,52,204,80,124,29,51,10,5,0
68269,563,255,308,91,111,42,30,335,186,149,40,28,29,13,0
68270,508,251,257,74,53,51,18,172,88,84,24,31,20,12,0
68271,746,312,434,129,115,77,47,102,51,51,12,15,12,3,0
68272,468,233,235,65,61,49,34,163,79,84,22,24,13,5,0
68273,207,89,118,56,8,4,3,397,223,174,50,39,29,17,0
68274,1395,595,800,223,206,113,61,252,130,122,45,23,32,11,0
68275,440,267,173,52,29,42,12,229,120,109,31,30,22,9,0
68276,516,210,306,113,53,81,33,715,345,370,110,97,64,25,0
68277,154,74,80,18,19,7,2,127,66,61,13,14,19,8,0
68278,218,133,85,20,19,13,6,306,157,149,52,35,39,16,0
68279,380,187,193,38,51,30,18,139,68,71,14,26,14,9,0
68280,421,237,184,47,54,45,10,309,159,150,47,43,43,13,0
68281,674,268,406,118,96,70,21,222,119,103,37,32,24,8,0
68282,895,388,507,130,84,90,31,662,312,350,103,104,59,20,0
68283,178,89,89,40,12,18,7,737,397,340,87,104,90,14,0
68284,772,383,389,105,76,82,33,2547,1280,1267,331,335,293,118,0
68285,281,154,127,45,31,24,9,396,223,173,57,37,44,19,0
68286,269,156,113,37,32,17,7,406,223,183,61,53,46,17,0
68287,1064,495,569,157,159,124,58,101,59,42,11,17,10,1,0
68288,588,317,271,78,49,54,17,322,180,142,45,38,28,7,0
68289,593,282,311,75,70,29,25,199,105,94,27,27,28,9,0
68290,347,198,149,45,29,29,8,172,88,84,24,31,20,12,0
68291,347,212,135,35,32,17,6,180,90,90,31,19,20,8,0
68292,232,134,98,28,20,20,5,1001,417,584,186,147,96,47,0
68293,303,161,142,38,31,42,17,292,155,137,50,34,29,13,0
68294,302,178,124,34,29,50,13,536,251,285,75,79,60,23,0
68295,474,250,224,58,47,37,12,729,358,371,116,99,89,33,0
68296,162,73,89,32,19,4,4,929,459,470,140,120,94,45,0
68297,282,96,186,80,21,28,7,390,223,167,58,36,45,18,0
68298,276,149,127,45,34,39,9,332,180,152,44,36,27,13,0
68299,234,108,126,42,40,15,9,517,295,222,69,62,40,28,0
68300,932,575,357,94,69,76,40,261,148,113,31,28,14,10,0
68301,339,118,221,77,68,33,13,305,163,142,38,27,47,11,0
68302,500,297,203,66,33,53,15,106,46,60,29,13,14,5,0
68303,619,289,330,67,77,36,19,621,310,311,100,106,77,27,0
68304,240,98,142,49,42,23,17,597,300,297,96,89,68,29,0
68305,413,206,207,38,55,19,10,165,87,78,24,19,22,9,0
68306,474,250,224,58,47,37,12,763,418,345,113,84,59,32,0
68307,489,253,236,73,36,62,17,222,122,100,39,32,24,9,0
68308,435,230,205,51,37,55,18,289,140,149,33,42,30,15,0
68309,275,160,115,40,31,34,17,1873,935,938,233,225,203,79,0
68310,181,92,89,34,22,17,9,198,86,112,36,27,23,9,0
68311,1327,520,807,241,174,141,60,164,79,85,28,28,16,7,0
68312,291,142,149,50,29,35,7,406,223,183,61,53,46,17,0
68313,169,64,105,23,37,11,3,373,189,184,54,46,50,23,0
68314,234,110,124,39,29,23,2,305,163,142,38,27,47,11,0
68315,1555,702,853,250,199,139,31,180,90,90,31,19,20,8,0
68316,320,163,157,44,44,26,15,337,152,185,49,54,42,21,0
68317,128,70,58,29,9,8,1,148,84,64,30,7,17,4,0
68318,136,66,70,33,11,9,5,405,195,210,57,74,24,17,0
68319,413,236,177,41,25,35,19,621,273,348,104,102,48,19,0
68320,445,231,214,45,64,53,23,262,129,133,40,41,31,10,0
68321,556,306,250,69,60,80,18,234,116,118,34,35,23,9,0
68322,284,160,124,37,23,32,11,137,85,52,15,11,11,2,0
68323,1009,478,531,166,126,96,42,584,249,335,80,96,22,13,0
68324,55,16,39,24,2,5,2,520,272,248,60,65,58,22,0
68325,388,244,144,46,25,42,16,621,273,348,104,102,48,19,0
68326,399,196,203,62,45,38,19,1047,562,485,141,127,114,41,0
68327,867,415,452,123,87,62,27,264,138,126,33,34,29,12,0
68328,1030,438,592,184,104,108,30,609,335,274,79,57,45,22,0
68329,773,383,390,108,76,79,30,792,398,394,109,96,90,39,0
68330,344,109,235,100,39,26,5,660,332,328,84,73,47,19,0
68331,435,230,205,51,37,55,18,465,252,213,73,58,60,18,0
68332,793,355,438,134,117,77,43,467,231,236,71,65,58,18,0
68333,772,417,355,118,92,80,23,483,215,268,66,70,30,16,0
68334,1105,544,561,165,167,99,40,1040,564,476,134,110,114,51,0
68335,604,239,365,124,63,84,37,975,475,500,139,140,119,28,0
68336,406,208,198,41,26,43,21,660,333,327,102,95,69,31,0
68337,463,250,213,56,45,73,25,732,402,330,81,86,87,33,0
68338,434,221,213,58,47,54,15,418,223,195,51,45,49,14,0
68339,257,122,135,44,19,21,16,199,105,94,27,27,28,9,0
68340,442,254,188,46,22,40,19,1352,602,750,166,185,81,70,0
68341,342,150,192,52,43,31,17,295,160,135,42,37,46,16,0
68342,326,154,172,45,39,20,10,241,127,114,34,33,29,12,0
68343,598,300,298,68,77,59,21,296,140,156,49,40,42,19,0
68344,125,53,72,18,21,18,12,169,85,84,21,14,9,9,0
68345,1009,487,522,177,121,103,51,300,148,152,45,43,40,8,0
68346,326,154,172,45,39,20,10,423,234,189,66,44,57,12,0
68347,290,156,134,44,29,39,9,1338,720,618,179,145,141,85,0
68348,331,165,166,52,34,48,22,665,361,304,87,91,84,31,0
68349,692,305,387,100,97,78,30,125,66,59,24,16,11,5,0
68350,169,64,105,23,37,11,3,617,314,303,96,68,68,37,0
68351,261,148,113,23,29,26,21,395,169,226,73,55,38,9,0
68352,128,67,61,29,9,9,1,354,188,166,46,40,34,10,0
68353,359,204,155,39,36,34,13,373,213,160,44,33,26,17,0
68354,739,323,416,127,89,76,33,430,212,218,88,43,40,20,0
68355,167,70,97,32,20,15,7,415,189,226,68,54,50,21,0
68356,484,192,292,118,68,83,22,518,292,226,60,60,52,21,0
68357,306,172,134,35,31,37,18,661,325,336,81,75,65,28,0
68358,462,258,204,59,41,56,15,239,113,126,36,49,20,8,0
68359,202,113,89,16,27,21,11,247,128,119,34,14,16,14,0
68360,128,69,59,29,9,8,1,471,238,233,66,63,62,19,0
68361,260,138,122,44,30,28,6,1113,480,633,170,173,81,34,0
68362,536,237,299,116,87,42,17,127,58,69,18,17,10,5,0
68363,483,236,247,82,60,43,18,189,105,84,25,26,21,9,0
68364,196,107,89,20,31,17,4,1004,457,547,150,150,74,52,0
68365,2063,1024,1039,175,117,80,97,334,182,152,45,41,27,13,0
68366,760,322,438,81,130,57,19,228,130,98,35,29,30,10,0
68367,134,60,74,19,13,10,7,457,253,204,67,51,48,13,0
68368,736,353,383,117,83,71,18,453,247,206,58,53,45,20,0
68369,372,171,201,47,53,39,18,974,457,517,133,117,69,26,0
68370,464,237,227,64,66,33,12,607,293,314,98,71,62,32,0
68371,253,133,120,44,31,22,8,349,200,149,41,39,30,20,0
68372,328,195,133,36,23,35,9,432,244,188,51,51,27,14,0
68373,2136,1063,1073,317,308,223,90,201,117,83,22,21,19,9,0
68374,130,72,58,28,9,7,1,432,244,188,51,51,27,14,0
68375,953,421,532,131,131,70,37,415,203,212,77,44,49,18,0
68376,410,211,199,55,42,34,27,751,394,357,107,96,73,35,0
68377,257,122,135,44,19,21,16,368,200,168,54,49,43,9,0
68378,193,83,110,26,20,16,9,119,57,62,18,16,17,4,0
68379,380,148,232,81,69,24,8,541,279,262,79,82,31,32,0
68380,840,411,429,122,101,79,34,370,173,197,65,57,42,10,0
68381,435,225,210,58,46,50,14,455,191,264,68,86,21,19,0
68382,213,88,125,21,54,14,15,535,311,224,66,52,49,24,0
68383,258,144,114,33,22,19,9,601,278,323,124,87,65,21,0
68384,458,226,232,77,59,61,14,350,196,154,52,37,21,14,0
68385,594,279,315,93,68,68,26,339,175,164,51,49,37,9,0
68386,413,169,244,66,94,28,19,261,162,99,24,21,14,10,0
68387,207,93,114,20,33,19,10,583,280,303,95,66,76,25,0
68388,527,276,251,64,60,70,20,463,259,204,62,55,34,22,0
68389,562,214,348,120,86,69,42,283,142,141,41,33,26,18,0
68390,373,164,209,51,45,44,21,96,46,50,16,12,7,5,0
68391,407,164,243,88,42,40,22,376,189,187,47,53,44,26,0
68392,123,58,65,22,14,13,3,127,66,61,13,14,19,8,0
68393,795,384,411,133,109,85,38,723,353,370,120,109,96,33,0
68394,1395,595,800,223,206,113,61,520,272,248,60,65,58,22,0
68395,86,50,36,9,14,8,7,517,295,222,69,62,40,28,0
68396,71,39,32,7,11,6,4,279,161,118,37,32,7,7,0
68397,365,148,217,86,37,51,28,106,54,52,12,9,7,6,0
68398,1009,487,522,177,121,103,51,373,189,184,54,46,50,23,0
68399,308,163,145,38,33,30,20,54,26,28,11,4,3,3,0
68400,207,93,114,20,33,19,10,2346,1231,1115,316,292,266,105,0
68401,734,339,395,135,89,78,36,285,143,142,45,32,21,17,0
68402,1143,574,569,176,151,123,59,301,168,133,49,37,34,11,0
68403,2286,1154,1132,338,314,278,103,452,254,198,72,57,38,18,0
68404,319,222,97,36,23,28,8,373,189,184,54,46,50,23,0
68405,255,126,129,41,37,13,5,261,148,113,31,28,14,10,0
68406,496,209,287,112,55,71,14,370,190,180,60,52,37,13,0
68407,484,192,292,118,68,83,22,103,50,53,19,10,7,5,0
68408,900,434,466,134,97,86,36,246,107,139,55,33,27,11,0
68409,225,111,114,38,22,25,10,1113,480,633,170,173,81,34,0
68410,508,267,241,43,35,25,17,453,255,198,62,49,29,19,0
68411,82,36,46,17,10,5,1,461,223,238,45,62,18,35,0
68412,502,274,228,64,49,75,17,395,198,197,55,55,36,10,0
68413,311,154,157,47,29,34,13,317,161,156,50,36,47,12,0
68414,473,265,208,47,26,50,30,723,353,370,120,109,96,33,0
68415,429,227,202,49,51,46,26,549,273,276,74,68,72,24,0
68416,579,246,333,102,79,41,19,277,144,133,42,30,41,8,0
68417,126,57,69,31,10,10,3,582,264,318,84,60,58,23,0
68418,1085,646,439,108,65,36,19,2547,1280,1267,331,335,293,118,0
68419,413,206,207,38,55,19,10,792,398,394,109,96,90,39,0
68420,125,57,68,31,10,10,3,1020,538,482,145,115,111,58,0
68421,232,134,98,28,20,20,5,334,181,153,56,31,28,18,0
68422,867,415,452,123,87,62,27,124,69,55,14,7,9,4,0
68423,631,316,315,64,57,49,15,640,364,276,84,68,69,33,0
68424,471,221,250,87,68,42,25,471,238,233,66,63,62,19,0
68425,230,114,116,30,33,29,8,381,187,194,37,49,36,17,0
68426,150,64,86,22,12,29,12,415,203,212,77,44,49,18,0
68427,432,233,199,52,28,47,18,775,407,368,122,100,97,32,0
68428,431,216,215,46,40,33,9,2547,1280,1267,331,335,293,118,0
68429,406,208,198,41,26,43,21,766,386,380,101,81,78,31,0
68430,928,442,486,139,118,91,43,391,189,202,55,56,56,12,0
68431,138,35,103,38,2,15,9,671,306,365,114,76,49,19,0
68432,856,429,427,113,105,96,24,732,366,366,108,86,74,41,0
68433,303,161,142,38,31,42,17,265,134,131,48,34,33,15,0
68434,71,39,32,7,11,6,4,723,363,360,107,106,52,14,0
68435,682,260,422,98,83,42,31,1113,480,633,170,173,81,34,0
68436,326,176,150,35,22,29,11,601,279,322,81,65,27,12,0
68437,227,109,118,42,35,29,8,213,129,84,32,14,21,15,0
68438,833,295,538,146,139,65,34,862,426,436,113,115,84,37,0
68439,142,76,66,21,21,22,11,903,436,467,128,116,83,33,0
68440,646,304,342,104,93,58,26,194,109,85,23,24,21,9,0
68441,479,227,252,69,48,46,18,89,37,52,13,6,2,9,0
68442,219,100,119,40,29,21,3,180,95,85,22,21,17,8,0
68443,385,203,182,47,43,51,21,128,63,65,30,11,13,8,0
68444,468,233,235,65,61,49,34,328,199,129,39,29,27,14,0
68445,362,181,181,67,46,43,8,276,149,127,34,31,32,10,0
68446,124,58,66,20,28,11,7,133,61,72,21,19,13,4,0
68447,411,211,200,61,46,35,18,317,161,156,50,36,47,12,0
68448,733,382,351,126,92,93,27,68,23,45,12,9,3,9,0
68449,708,344,364,106,98,66,33,943,463,480,91,144,70,30,0
68450,932,575,357,94,69,76,40,515,276,239,62,59,43,31,0
68451,275,160,115,40,31,34,17,621,273,348,104,102,48,19,0
68452,193,107,86,13,20,13,6,1034,495,539,150,134,114,71,0
68453,158,85,73,24,18,18,8,727,362,365,123,107,63,23,0
68454,1342,640,702,187,163,123,57,278,154,124,42,32,38,7,0
68455,330,77,253,86,52,20,12,422,202,220,80,52,57,18,0
68456,192,91,101,28,21,18,8,285,146,139,41,41,48,13,0
68457,402,169,233,70,36,34,18,1040,564,476,134,110,114,51,0
68458,328,156,172,44,37,44,15,198,113,85,19,20,26,12,0
68459,1835,904,931,192,144,135,63,295,160,135,42,37,46,16,0
68460,424,170,254,69,56,47,28,251,143,108,47,25,29,11,0
68461,207,89,118,56,8,4,3,244,143,101,31,29,26,8,0
68462,508,251,257,74,53,51,18,54,26,28,11,4,3,3,0
68463,461,207,254,82,66,55,33,1873,935,938,233,225,203,79,0
68464,478,177,301,109,66,59,25,1500,804,696,190,172,144,60,0
68465,595,316,279,86,60,65,40,732,402,330,81,86,87,33,0
68466,347,154,193,48,51,25,11,584,249,335,80,96,22,13,0
68467,435,187,248,62,51,51,21,341,170,171,41,66,27,10,0
68468,124,58,66,20,28,11,7,391,189,202,55,56,56,12,0
68469,886,440,446,116,140,95,45,972,471,501,152,138,112,40,0
68470,313,158,155,43,35,43,16,661,325,336,81,75,65,28,0
68471,371,209,162,46,17,36,19,406,202,204,54,51,63,21,0
68472,391,203,188,49,34,36,9,316,166,150,45,38,37,13,0
68473,615,308,307,83,75,58,32,679,338,341,96,95,40,23,0
68474,1130,614,516,129,138,98,42,627,323,304,81,90,53,27,0
68475,532,291,241,83,36,79,25,396,197,199,75,49,49,16,0
68476,789,362,427,90,82,70,35,455,191,264,68,86,21,19,0
68477,908,324,584,181,162,81,29,179,101,78,25,15,13,13,0
68478,496,210,286,112,55,72,13,297,164,133,45,39,40,9,0
68479,1970,978,992,245,206,198,80,600,254,346,104,100,44,17,0
68480,682,260,422,153,78,109,46,1230,644,586,198,125,123,61,0
68481,343,189,154,44,24,39,12,399,190,209,61,41,39,18,0
68482,420,189,231,79,67,33,17,250,119,131,58,26,29,7,0
68483,165,66,99,28,32,16,3,673,313,360,102,101,46,17,0
68484,181,92,89,34,22,17,9,317,161,156,40,49,41,11,0
68485,1139,537,602,162,139,109,50,448,217,231,56,63,29,10,0
68486,483,236,247,82,60,43,18,509,267,242,79,81,38,20,0
68487,708,344,364,106,98,66,33,508,253,255,73,60,50,13,0
68488,432,190,242,85,82,28,11,98,49,49,14,15,9,2,0
68489,210,84,126,44,43,9,4,180,90,90,31,19,20,8,0
68490,543,265,278,52,37,54,19,579,285,294,78,72,64,32,0
68491,852,461,391,109,102,72,24,289,140,149,33,42,30,15,0
68492,117,57,60,17,14,11,10,104,46,58,15,17,9,5,0
68493,805,338,467,153,138,99,55,136,65,71,26,11,7,5,0
68494,243,70,173,54,65,8,6,222,122,100,39,32,24,9,0
68495,375,201,174,52,56,39,15,207,113,94,33,18,30,9,0
68496,389,176,213,81,59,24,7,418,223,195,51,45,49,14,0
68497,215,117,98,28,19,15,8,464,236,228,64,56,53,28,0
68498,237,127,110,34,30,16,9,403,184,219,75,51,47,20,0
68499,461,207,254,82,66,55,33,222,119,103,37,32,24,8,0
68500,685,393,292,75,66,113,16,286,160,126,37,27,23,10,0
68501,399,220,179,48,37,68,18,736,388,348,88,85,67,28,0
68502,238,91,147,68,19,22,7,662,312,350,103,104,59,20,0
68503,136,66,70,33,11,9,4,124,69,55,14,7,9,4,0
68504,1058,497,561,194,142,87,63,96,46,50,16,12,7,5,0
68505,240,167,73,32,12,8,21,975,475,500,139,140,119,28,0
68506,979,534,445,83,77,80,24,557,281,276,80,59,43,21,0
68507,600,324,276,89,73,45,39,517,295,222,69,62,40,28,0
68508,193,105,88,33,16,9,4,617,314,303,96,68,68,37,0
68509,341,183,158,36,34,36,15,600,254,346,104,100,44,17,0
68510,553,276,277,88,61,45,27,245,121,124,37,35,36,12,0
68511,323,156,167,52,45,39,18,335,170,165,52,36,47,11,0
68512,313,148,165,45,33,36,11,467,240,227,65,65,51,23,0
68513,161,94,67,23,13,8,10,279,142,137,43,39,28,7,0
68514,580,240,340,108,81,59,22,326,169,157,51,41,41,12,0
68515,692,305,387,100,97,78,30,405,181,224,71,57,31,12,0
68516,435,230,205,51,37,55,18,218,118,100,33,30,25,11,0
68517,957,381,576,184,158,86,48,1117,422,695,182,134,88,32,0
68518,496,210,286,111,55,74,13,621,273,348,104,102,48,19,0
68519,743,366,377,41,37,26,14,309,164,145,35,47,30,11,0
68520,1052,492,560,184,163,103,44,274,157,117,40,29,40,8,0
68521,979,534,445,83,77,80,24,647,350,297,95,79,77,29,0
68522,474,243,231,66,54,41,29,387,193,194,60,53,57,15,0
68523,1014,488,526,178,137,94,39,123,61,62,17,18,17,7,0
68524,343,162,181,65,38,29,12,374,191,183,40,52,40,16,0
68525,504,222,282,71,64,53,29,295,158,137,42,34,38,14,0
68526,218,133,85,20,19,13,6,429,187,242,79,72,28,19,0
68527,142,60,82,20,28,13,5,173,94,79,18,24,12,7,0
68528,575,290,285,67,70,28,9,403,192,211,102,39,49,15,0
68529,346,173,173,50,56,31,14,241,127,114,34,33,29,12,0
68530,325,181,144,46,31,48,9,783,406,377,102,91,57,29,0
68531,2236,1195,1041,227,187,186,118,156,90,66,17,22,11,10,0
68532,115,62,53,13,10,9,7,276,149,127,34,31,32,10,0
68533,532,291,241,83,36,79,25,445,202,243,70,73,51,15,0
68534,282,105,177,77,28,39,6,96,46,50,16,12,7,5,0
68535,641,349,292,92,60,39,24,1230,644,586,198,125,123,61,0
68536,1711,865,846,204,176,105,60,397,223,174,50,39,29,17,0
68537,584,297,287,89,80,65,17,763,418,345,113,84,59,32,0
68538,475,235,240,77,58,43,22,212,127,85,28,21,26,6,0
68539,677,361,316,81,61,42,22,396,199,197,54,50,45,14,0
68540,375,201,174,52,56,39,15,1279,669,610,164,162,104,55,0
68541,789,362,427,90,82,70,35,213,129,84,32,14,21,15,0
68542,128,69,59,29,9,8,1,86,40,46,16,13,9,7,0
68543,528,273,255,67,53,29,20,660,303,357,97,89,85,33,0
68544,235,100,135,36,25,30,8,68,36,32,11,8,9,2,0
68545,1912,880,1032,331,334,180,84,516,245,271,82,84,70,26,0
68546,482,231,251,76,81,64,26,332,155,177,55,51,44,13,0
68547,282,163,119,40,23,25,17,362,156,206,74,42,36,22,0
68548,269,127,142,43,24,34,26,723,363,360,107,106,52,14,0
68549,261,137,124,34,23,13,8,396,213,183,68,44,47,18,0
68550,3859,2011,1848,535,391,422,207,395,169,226,73,55,38,9,0
68551,496,209,287,113,55,72,14,1113,480,633,170,173,81,34,0
68552,489,253,236,73,36,62,17,1382,508,874,334,320,98,36,0
68553,424,170,254,69,56,47,28,600,254,346,104,100,44,17,0
68554,439,183,256,60,64,36,14,381,186,195,69,55,46,15,0
68555,961,465,496,139,156,62,34,963,455,508,127,130,115,48,0
68556,524,262,262,62,72,39,49,68,36,32,11,8,9,2,0
68557,496,210,286,111,55,74,13,377,184,193,50,43,33,17,0
68558,579,321,258,74,70,47,22,187,89,98,36,24,20,6,0
68559,860,348,512,121,136,75,35,723,363,360,107,106,52,14,0
68560,164,77,87,33,19,6,7,200,89,111,26,25,17,7,0
68561,118,56,62,24,12,6,9,430,212,218,88,43,40,20,0
68562,210,84,126,44,43,9,4,319,185,134,42,31,22,13,0
68563,172,82,90,21,35,21,5,408,221,187,55,51,57,14,0
68564,350,172,178,61,45,32,13,173,86,87,30,22,19,12,0
68565,2799,1324,1475,369,371,215,124,103,44,59,16,17,9,5,0
68566,508,251,257,74,53,51,18,96,45,51,13,12,6,4,0
68567,526,228,298,69,64,32,30,335,186,149,40,28,29,13,0
68568,255,126,129,41,37,13,5,387,193,194,60,53,57,15,0
68569,619,289,330,67,77,36,19,175,82,93,33,26,17,5,0
68570,313,134,179,58,37,43,19,245,121,124,37,35,36,12,0
68571,228,82,146,45,37,18,8,579,285,294,78,72,64,32,0
68572,745,402,343,95,71,69,40,627,323,304,81,90,53,27,0
68573,1463,521,942,252,204,105,52,2202,1121,1081,338,274,269,81,0
68574,328,179,149,35,34,16,14,1471,709,762,198,184,154,62,0
68575,521,289,232,71,58,49,16,287,151,136,51,42,36,7,0
68576,234,108,126,42,40,15,9,153,65,88,28,21,20,8,0
68577,1970,978,992,245,206,198,80,452,254,198,72,57,38,18,0
68578,452,202,250,83,60,56,19,2542,1245,1297,285,287,170,84,0
68579,464,237,227,64,66,33,12,619,305,314,85,93,71,29,0
68580,1718,735,983,266,225,130,68,132,67,65,24,21,8,10,0
68581,508,251,257,74,53,51,18,605,283,322,94,72,64,39,0
68582,1054,497,557,190,168,107,45,892,475,417,130,108,68,38,0
68583,879,457,422,93,98,143,32,673,313,360,102,101,46,17,0
68584,431,216,215,46,40,33,9,198,86,112,36,27,23,9,0
68585,367,167,200,63,42,60,17,1262,653,609,169,165,152,50,0
68586,346,168,178,36,43,20,9,316,166,150,45,38,37,13,0
68587,684,353,331,95,98,77,38,671,306,365,114,76,49,19,0
68588,288,142,146,52,32,26,8,242,124,118,39,32,28,22,0
68589,794,322,472,122,108,79,34,699,334,365,108,80,70,20,0
68590,475,208,267,84,67,50,20,621,273,348,104,102,48,19,0
68591,365,210,155,46,30,24,12,528,276,252,86,78,49,17,0
68592,342,150,192,52,43,31,17,101,59,42,11,17,10,1,0
68593,496,210,286,112,55,72,13,926,340,586,133,119,60,40,0
68594,869,489,380,110,77,79,29,1382,508,874,334,320,98,36,0
68595,259,119,140,48,28,29,19,160,60,100,23,40,19,11,0
68596,220,121,99,28,26,17,6,1395,627,768,172,263,141,59,0
68597,1970,978,992,245,206,198,80,810,310,500,164,162,42,26,0
68598,334,155,179,47,34,38,11,373,213,160,44,33,26,17,0
68599,1107,601,506,155,138,103,49,133,61,72,21,19,13,4,0
68600,673,317,356,101,85,76,49,660,303,357,97,89,85,33,0
68601,504,222,282,71,64,53,29,199,92,107,34,30,18,9,0
68602,347,198,149,45,29,29,8,338,169,169,53,44,39,21,0
68603,784,351,433,118,87,73,41,171,94,77,24,28,30,11,0
68604,111,29,82,10,54,0,1,541,279,262,79,82,31,32,0
68605,361,177,184,59,51,24,15,873,411,462,132,107,84,40,0
68606,640,308,332,91,102,49,21,288,156,132,36,36,24,15,0
68607,126,58,68,31,10,10,3,188,101,87,20,18,20,14,0
68608,329,165,164,61,44,29,17,392,214,178,48,40,53,22,0
68609,71,28,43,15,9,5,2,978,536,442,132,107,67,32,0
68610,1560,778,782,224,235,132,78,406,234,172,63,35,43,10,0
68611,107,56,51,18,16,12,5,277,124,153,44,40,35,18,0
68612,513,276,237,73,43,57,24,96,46,50,16,12,7,5,0
68613,160,53,107,31,29,13,3,821,394,427,122,117,109,38,0
68614,756,265,491,129,127,51,17,145,77,68,26,7,15,8,0
68615,150,60,90,27,16,6,3,464,236,228,64,56,53,28,0
68616,122,56,66,26,13,11,5,403,185,218,67,62,63,19,0
68617,580,240,340,108,81,59,22,508,253,255,73,60,50,13,0
68618,413,206,207,38,55,19,10,621,310,311,100,106,77,27,0
68619,480,232,248,73,40,44,30,399,190,209,61,41,39,18,0
68620,341,177,164,57,42,40,18,501,257,244,75,57,48,29,0
68621,166,59,107,36,41,10,4,649,307,342,71,134,45,17,0
68622,580,281,299,95,60,74,29,1279,669,610,164,162,104,55,0
68623,526,228,298,69,64,32,30,2038,1059,979,262,237,208,100,0
68624,204,109,95,21,35,27,7,283,142,141,41,33,26,18,0
68625,335,148,187,52,26,51,12,929,459,470,140,120,94,45,0
68626,261,148,113,23,29,26,21,368,183,185,40,42,40,15,0
68627,249,104,145,47,41,24,17,452,254,198,72,57,38,18,0
68628,1011,559,452,121,97,132,33,531,277,254,82,75,33,22,0
68629,473,217,256,59,44,34,21,266,150,116,28,28,24,12,0
68630,498,274,224,58,59,50,18,497,227,270,70,63,66,30,0
68631,953,421,532,131,131,70,37,314,177,137,34,40,29,9,0
68632,677,361,316,81,61,42,22,180,95,85,22,21,17,8,0
68633,325,152,173,43,47,28,17,1182,591,591,155,139,83,46,0
68634,404,197,207,60,48,47,20,487,252,235,79,58,55,26,0
68635,412,203,209,65,47,37,18,346,178,168,58,41,33,12,0
68636,362,174,188,46,55,35,23,467,231,236,71,65,58,18,0
68637,343,162,181,65,38,29,12,619,305,314,85,93,71,29,0
68638,574,284,290,64,50,65,20,286,152,134,38,38,32,11,0
68639,493,208,285,75,77,70,40,188,90,98,44,7,21,7,0
68640,226,120,106,68,8,2,1,209,119,90,28,24,27,9,0
68641,729,351,378,111,98,58,18,106,46,60,29,13,14,5,0
68642,76,30,46,7,15,1,5,295,158,137,42,34,38,14,0
68643,249,104,145,47,41,24,17,1696,771,925,257,225,149,63,0
68644,314,178,136,42,32,30,17,482,232,250,77,81,44,13,0
68645,291,142,149,50,29,35,7,326,149,177,51,51,28,10,0
68646,326,176,150,35,22,29,11,374,174,200,54,52,42,21,0
68647,282,96,186,80,21,28,7,247,128,119,34,14,16,14,0
68648,465,220,245,88,34,61,23,415,205,210,77,52,55,17,0
68649,895,388,507,130,84,90,31,166,78,88,27,25,19,7,0
68650,504,222,282,71,64,53,29,329,194,135,45,32,33,9,0
68651,107,36,71,27,15,0,1,1025,549,476,118,109,88,61,0
68652,300,136,164,45,35,45,14,422,202,220,80,52,57,18,0
68653,471,221,250,87,68,42,25,308,146,162,42,39,24,12,0
68654,390,199,191,72,42,35,12,54,26,28,11,4,3,3,0
68655,336,199,137,46,22,51,13,621,310,311,100,106,77,27,0
68656,86,50,36,9,14,8,7,137,78,59,22,16,17,4,0
68657,526,268,258,54,37,55,12,68,23,45,12,9,3,9,0
68658,347,198,149,45,29,29,8,218,115,103,32,32,34,11,0
68659,561,282,279,68,62,36,14,1230,644,586,198,125,123,61,0
68660,316,157,159,45,38,22,19,583,280,303,95,66,76,25,0
68661,625,283,342,93,89,67,25,2724,1157,1567,269,518,239,77,0
68662,1208,575,633,187,204,117,41,106,46,60,27,18,12,3,0
68663,358,212,146,51,36,33,9,218,111,107,45,29,24,6,0
68664,284,160,124,37,23,32,11,424,179,245,65,67,29,11,0
68665,238,91,147,68,19,22,7,474,268,206,66,42,45,24,0
68666,732,355,377,108,109,79,27,482,232,250,77,81,44,13,0
68667,283,172,111,39,31,29,8,250,116,134,41,30,33,19,0
68668,291,131,160,49,35,32,15,180,115,65,17,12,9,9,0
68669,362,181,181,67,46,43,8,584,249,335,80,96,22,13,0
68670,509,246,263,84,71,56,22,145,77,68,26,7,15,8,0
68671,395,189,206,63,50,49,28,188,105,83,25,17,24,7,0
68672,1960,875,1085,287,189,162,66,1323,690,633,132,178,112,61,0
68673,505,201,304,116,58,75,31,1004,457,547,150,150,74,52,0
68674,714,260,454,140,97,120,54,187,89,98,36,24,20,6,0
68675,1555,702,853,250,199,139,31,943,463,480,91,144,70,30,0
68676,376,176,200,31,53,27,8,396,199,197,54,50,45,14,0
68677,373,164,209,51,45,44,21,265,134,131,48,34,33,15,0
68678,269,127,142,43,24,34,26,763,418,345,113,84,59,32,0
68679,928,442,486,139,118,91,43,149,77,72,37,10,20,5,0
68680,707,250,457,171,84,117,61,483,287,196,71,50,54,17,0
68681,150,64,86,22,12,29,12,588,286,302,78,99,53,25,0
68682,373,164,209,51,45,44,21,455,191,264,68,86,21,19,0
68683,349,153,196,54,47,28,13,204,80,124,29,51,10,5,0
68684,340,145,195,46,38,26,23,309,159,150,47,43,43,13,0
68685,258,144,114,33,22,19,9,972,471,501,152,138,112,40,0
68686,2109,999,1110,332,294,187,89,729,358,371,116,99,89,33,0
68687,219,98,121,43,19,11,7,915,336,579,185,199,56,29,0
68688,371,209,162,46,17,36,19,148,69,79,26,18,16,3,0
68689,785,374,411,56,42,38,25,198,113,85,19,20,26,12,0
68690,772,417,355,118,92,80,23,862,426,436,113,115,84,37,0
68691,470,163,307,99,68,73,30,393,210,183,58,37,34,20,0
68692,146,73,73,18,24,17,9,415,189,226,68,54,50,21,0
68693,372,171,201,47,53,39,18,715,345,370,110,97,64,25,0
68694,213,104,109,56,14,9,2,299,140,159,49,44,26,11,0
68695,502,229,273,63,66,40,31,1065,581,484,134,97,76,46,0
68696,144,57,87,38,26,10,4,106,46,60,29,13,14,5,0
68697,412,208,204,54,47,42,17,2382,1162,1220,237,220,140,49,0
68698,727,426,301,79,71,64,32,133,61,72,21,19,13,4,0
68699,136,66,70,33,11,9,3,292,143,149,38,42,36,16,0
68700,1171,542,629,170,146,114,64,215,115,100,27,19,16,7,0
68701,565,264,301,101,73,72,15,947,482,465,143,107,89,37,0
68702,267,146,121,40,24,25,7,396,223,173,57,37,44,19,0
68703,469,221,248,49,60,55,21,627,323,304,81,90,53,27,0
68704,437,228,209,47,61,26,11,515,276,239,62,59,43,31,0
68705,288,142,146,52,32,26,8,508,261,247,65,53,58,23,0
68706,526,228,298,69,64,32,30,715,348,367,109,84,68,30,0
68707,257,148,109,28,20,21,14,748,359,389,125,113,86,31,0
68708,255,110,145,34,32,23,17,169,85,84,21,14,9,9,0
68709,580,265,315,97,89,79,17,758,319,439,101,123,78,25,0
68710,3969,1703,2266,619,432,259,144,334,181,153,41,40,25,15,0
68711,333,171,162,41,44,48,23,178,69,109,29,25,21,13,0
68712,795,384,411,133,109,85,38,514,248,266,86,82,52,22,0
68713,535,315,220,57,55,71,19,1352,602,750,166,185,81,70,0
68714,1058,497,561,194,142,87,63,376,189,187,47,53,44,26,0
68715,83,45,38,11,8,8,3,417,232,185,58,50,29,21,0
68716,401,204,197,49,33,29,17,199,92,107,34,30,18,9,0
68717,361,167,194,55,35,41,11,520,244,276,91,60,68,20,0
68718,1257,464,793,221,264,75,37,397,234,163,44,38,23,21,0
68719,1849,931,918,245,220,158,90,135,57,78,21,20,9,11,0
68720,837,381,456,123,109,65,25,396,197,199,75,49,49,16,0
68721,308,129,179,44,60,19,8,165,87,78,24,19,22,9,0
68722,161,99,62,15,22,9,7,179,101,78,25,15,13,13,0
68723,577,251,326,92,84,60,11,166,88,78,23,18,13,7,0
68724,411,202,209,60,67,57,24,2038,1059,979,262,237,208,100,0
68725,313,158,155,43,35,43,16,306,157,149,52,35,39,16,0
68726,677,361,316,81,61,42,22,329,196,133,41,36,31,15,0
68727,559,217,342,105,86,42,16,72,32,40,8,2,1,14,0
68728,1096,563,533,158,136,120,53,89,38,51,14,6,3,9,0
68729,717,281,436,165,81,112,49,207,114,93,33,20,31,13,0
68730,1186,495,691,182,208,88,32,297,164,133,45,39,40,9,0
68731,475,208,267,84,67,50,20,430,212,218,88,43,40,20,0
68732,76,42,34,12,8,5,7,180,89,91,28,27,18,7,0
68733,436,201,235,54,37,35,18,375,210,165,49,37,29,27,0
68734,260,133,127,43,29,34,11,729,358,371,116,99,89,33,0
68735,594,321,273,98,59,57,23,72,34,38,8,2,3,12,0
68736,313,148,165,45,33,36,11,723,363,360,107,106,52,14,0
68737,609,292,317,102,96,64,21,1323,690,633,132,178,112,61,0
68738,372,171,201,47,53,39,18,134,55,79,22,24,16,6,0
68739,165,66,99,28,32,16,3,1262,653,609,169,165,152,50,0
68740,359,204,155,39,36,34,13,1182,591,591,155,139,83,46,0
68741,482,231,251,76,81,64,26,135,57,78,21,20,9,11,0
68742,376,249,127,47,23,43,16,501,274,227,63,58,53,20,0
68743,425,199,226,54,71,56,11,2346,1231,1115,316,292,266,105,0
68744,532,269,263,72,59,59,39,512,269,243,69,70,62,29,0
68745,496,209,287,112,55,71,14,231,126,105,28,26,34,9,0
68746,1505,680,825,202,204,73,32,158,71,87,23,21,17,12,0
68747,1257,464,793,221,264,75,37,496,285,211,62,54,46,22,0
68748,414,216,198,51,32,42,28,245,121,124,37,35,36,12,0
68749,733,438,295,95,79,67,32,188,88,100,53,12,15,6,0
68750,1505,680,825,202,204,73,32,386,181,205,55,51,57,31,0
68751,391,203,188,49,34,36,9,519,287,232,68,58,45,21,0
68752,392,221,171,53,30,25,8,330,166,164,55,51,36,16,0
68753,126,66,60,24,10,7,9,196,105,91,40,13,19,10,0
68754,335,183,152,40,26,54,22,270,162,108,26,26,16,11,0
68755,330,182,148,47,27,40,11,465,252,213,73,58,60,18,0
68756,513,276,237,73,43,57,24,810,310,500,164,162,42,26,0
68757,125,57,68,31,10,10,3,630,321,309,86,90,57,26,0
68758,613,303,310,70,28,28,18,453,255,198,62,49,29,19,0
68759,911,441,470,123,108,60,21,262,129,133,40,41,31,10,0
68760,505,201,304,116,58,75,31,169,84,85,29,19,21,7,0
68761,347,212,135,35,32,17,6,620,324,296,81,68,66,31,0
68762,496,272,224,70,58,42,18,1425,670,755,153,189,122,85,0
68763,1120,436,684,208,120,101,115,457,253,204,67,51,48,13,0
68764,739,389,350,129,61,69,25,381,186,195,69,55,46,15,0
68765,1047,443,604,162,156,78,52,621,273,348,104,102,48,19,0
68766,553,319,234,56,37,54,18,225,129,96,32,33,20,8,0
68767,2649,1431,1218,377,299,266,102,397,234,163,44,38,23,21,0
68768,483,236,247,82,60,43,18,225,129,96,32,33,20,8,0
68769,2488,1085,1403,346,253,162,76,142,65,77,30,17,22,9,0
68770,326,176,150,35,22,29,11,413,223,190,52,45,53,10,0
68771,125,46,79,24,16,12,2,457,253,204,67,51,48,13,0
68772,465,305,160,40,47,34,9,354,183,171,54,43,49,8,0
68773,961,465,496,139,156,62,34,1321,653,668,186,195,70,35,0
68774,781,367,414,60,67,43,17,514,262,252,78,58,54,26,0
68775,399,196,203,62,45,38,19,322,180,142,45,38,28,7,0
68776,401,204,197,49,33,29,17,748,359,389,125,113,86,31,0
68777,376,249,127,47,23,43,16,528,276,252,86,78,49,17,0
68778,264,122,142,33,29,13,13,439,231,208,65,51,55,17,0
68779,494,233,261,87,57,46,18,661,325,336,81,75,65,28,0
68780,853,400,453,137,109,88,42,127,64,63,26,8,12,8,0
68781,687,351,336,106,67,70,41,346,178,168,58,41,33,12,0
68782,126,57,69,31,10,10,3,597,300,297,96,89,68,29,0
68783,485,183,302,79,81,73,33,926,340,586,133,119,60,40,0
68784,157,62,95,41,18,10,11,246,107,139,55,33,27,11,0
68785,389,176,213,81,59,24,7,86,40,46,16,13,9,7,0
68786,123,58,65,22,14,13,3,406,234,172,63,35,43,10,0
68787,505,282,223,60,57,66,23,1321,653,668,186,195,70,35,0
68788,450,241,209,67,58,54,23,340,169,171,40,39,36,22,0
68789,241,122,119,27,34,17,16,218,115,103,37,33,33,9,0
68790,509,246,263,84,71,56,22,218,114,104,32,31,33,11,0
68791,507,242,265,53,44,31,22,2225,1244,981,271,243,217,93,0
68792,425,198,227,57,69,59,13,1698,875,823,222,219,173,64,0
68793,836,370,466,126,96,72,30,663,354,309,91,84,79,31,0
68794,164,61,103,47,19,14,5,244,143,101,31,29,26,8,0
68795,609,292,317,102,96,64,21,292,155,137,50,34,29,13,0
68796,959,496,463,144,132,75,35,240,141,99,34,28,29,8,0
68797,2525,1232,1293,398,317,186,61,1248,584,664,184,164,155,67,0
68798,588,300,288,100,57,65,27,403,233,170,38,29,21,14,0
68799,949,466,483,125,126,101,50,305,163,142,38,27,47,11,0
68800,285,148,137,31,42,42,16,147,74,73,28,20,24,4,0
68801,123,58,65,22,14,13,3,188,90,98,44,7,21,7,0
68802,538,263,275,71,85,44,18,467,231,236,71,65,58,18,0
68803,772,383,389,105,76,82,33,1323,690,633,132,178,112,61,0
68804,281,125,156,44,47,17,7,344,190,154,34,31,36,10,0
68805,329,165,164,61,44,29,17,241,127,114,34,33,29,12,0
68806,329,165,164,61,44,29,17,134,55,79,22,24,16,6,0
68807,221,75,146,68,21,16,5,339,180,159,36,29,16,16,0
68808,521,289,232,71,58,49,16,402,186,216,64,47,38,20,0
68809,414,206,208,56,68,35,19,763,418,345,113,84,59,32,0
68810,598,300,298,68,77,59,21,601,279,322,81,65,27,12,0
68811,410,211,199,55,42,34,27,549,273,276,74,68,72,24,0
68812,422,196,226,52,35,33,20,1114,539,575,145,131,94,56,0
68813,574,284,290,64,50,65,20,337,170,167,59,33,47,17,0
68814,416,222,194,58,38,38,20,517,295,222,69,62,40,28,0
68815,525,254,271,60,76,46,13,866,397,469,117,153,95,48,0
68816,1867,973,894,256,222,194,65,332,180,152,46,36,28,14,0
68817,364,168,196,64,61,27,6,346,178,168,58,41,33,12,0
68818,502,274,228,64,49,75,17,189,95,94,25,33,16,8,0
68819,1960,875,1085,287,189,162,66,266,150,116,28,28,24,12,0
68820,480,232,248,73,40,44,30,778,391,387,94,77,41,33,0
68821,3859,2011,1848,535,391,422,207,557,281,276,80,59,43,21,0
68822,453,240,213,53,33,44,16,504,272,232,75,57,53,19,0
68823,130,71,59,30,9,8,2,104,46,58,15,17,9,5,0
68824,209,75,134,53,48,20,9,1922,923,999,267,275,215,90,0
68825,580,308,272,82,79,58,25,375,211,164,50,36,31,23,0
68826,538,263,275,71,85,44,18,354,188,166,46,40,34,10,0
68827,299,128,171,57,40,13,25,947,482,465,143,107,89,37,0
68828,302,160,142,35,35,37,10,520,244,276,91,60,68,20,0
68829,264,122,142,46,24,35,10,124,69,55,14,7,9,4,0
68830,798,364,434,133,88,74,35,405,181,224,71,57,31,12,0
68831,461,257,204,63,49,50,29,179,101,78,25,15,13,13,0
68832,221,80,141,48,37,14,10,497,257,240,71,63,62,16,0
68833,588,317,271,78,49,54,17,222,125,97,34,27,27,7,0
68834,330,151,179,68,36,56,9,548,273,275,84,81,64,30,0
68835,557,250,307,70,47,51,22,1040,564,476,134,110,114,51,0
68836,364,168,196,64,61,27,6,422,237,185,53,47,62,20,0
68837,650,330,320,97,77,65,28,125,66,59,24,16,11,5,0
68838,238,158,80,28,15,31,7,478,254,224,67,74,56,28,0
68839,756,265,491,129,127,51,17,102,51,51,12,15,12,3,0
68840,533,297,236,74,57,39,28,73,35,38,14,10,9,4,0
68841,3230,1724,1506,361,358,157,75,256,141,115,32,22,32,8,0
68842,350,178,172,49,62,29,16,148,84,64,30,7,17,4,0
68843,431,202,229,57,50,50,25,395,169,226,73,55,38,9,0
68844,505,226,279,68,51,30,15,727,362,365,123,107,63,23,0
68845,666,204,462,110,194,42,14,300,148,152,45,43,40,8,0
68846,1189,653,536,152,118,109,56,424,179,245,65,67,29,11,0
68847,413,169,244,66,94,28,19,598,333,265,79,66,54,33,0
68848,852,472,380,99,79,70,27,350,196,154,52,37,21,14,0
68849,71,39,32,7,11,6,4,597,300,297,96,89,68,29,0
68850,1098,519,579,182,159,79,42,168,67,101,37,17,13,13,0
68851,1023,449,574,141,174,76,43,403,225,178,56,38,33,25,0
68852,500,257,243,60,55,27,22,290,142,148,41,37,43,11,0
68853,1276,607,669,192,178,136,63,430,212,218,88,43,40,20,0
68854,279,129,150,43,34,17,13,593,289,304,85,69,48,19,0
68855,466,199,267,86,59,32,17,89,51,38,15,15,5,4,0
68856,260,133,127,43,29,34,11,469,225,244,64,68,25,11,0
68857,313,148,165,45,33,36,11,320,168,152,38,42,24,18,0
68858,579,246,333,102,79,41,19,292,143,149,38,42,36,16,0
68859,1249,543,706,187,164,125,52,384,212,172,44,43,34,14,0
68860,359,167,192,49,37,27,19,73,35,38,14,10,9,4,0
68861,222,108,114,37,20,25,12,134,72,62,14,28,8,4,0
68862,286,111,175,51,47,21,12,415,189,226,68,54,50,21,0
68863,1647,794,853,279,235,128,65,152,71,81,41,16,14,2,0
68864,545,221,324,101,72,55,30,180,95,85,22,21,17,8,0
68865,557,250,307,70,47,51,22,384,212,172,44,43,34,14,0
68866,349,167,182,54,38,30,28,660,332,328,84,73,47,19,0
68867,575,305,270,74,87,73,25,180,95,85,22,21,17,8,0
68868,338,172,166,59,30,39,18,545,269,276,80,76,27,32,0
68869,730,298,432,128,69,86,26,165,87,78,24,19,22,9,0
68870,900,434,466,134,97,86,36,403,225,178,56,38,33,25,0
68871,256,152,104,18,23,23,8,708,328,380,113,100,82,34,0
68872,240,99,141,53,38,29,15,384,204,180,53,47,49,17,0
68873,833,295,538,146,139,65,34,201,104,97,36,32,24,7,0
68874,474,250,224,58,47,37,12,673,313,360,102,101,46,17,0
68875,933,456,477,123,108,83,29,103,50,53,19,10,7,5,0
68876,556,306,250,69,60,80,18,89,38,51,14,6,3,9,0
68877,136,66,70,33,11,9,5,391,189,202,55,56,56,12,0
68878,161,99,62,15,22,9,7,843,391,452,139,104,91,35,0
68879,609,292,317,102,96,64,21,701,380,321,94,84,96,34,0
68880,629,374,255,74,53,87,27,106,54,52,12,9,7,6,0
68881,278,110,168,58,49,29,5,974,457,517,133,117,69,26,0
68882,822,416,406,111,97,88,42,621,273,348,104,102,48,19,0
68883,379,217,162,47,20,50,23,579,285,294,78,72,64,32,0
68884,480,232,248,73,40,44,30,457,245,212,62,58,57,21,0
68885,221,75,146,68,21,16,5,175,91,84,19,21,21,10,0
68886,439,241,198,67,40,40,13,583,321,262,73,67,45,25,0
68887,653,379,274,89,56,86,13,136,65,71,26,11,7,5,0
68888,417,176,241,75,61,51,20,387,193,194,60,53,57,15,0
68889,399,220,179,48,37,68,18,127,64,63,26,8,12,8,0
68890,554,217,337,112,72,90,38,376,183,193,50,50,43,21,0
68891,627,237,390,137,57,108,44,378,154,224,74,84,35,22,0
68892,1099,491,608,163,141,107,62,376,183,193,50,50,43,21,0
68893,527,276,251,64,60,70,20,128,63,65,30,11,13,8,0
68894,416,222,194,58,38,38,20,374,191,183,40,52,40,16,0
68895,107,36,71,27,15,0,1,1248,584,664,184,164,155,67,0
68896,513,276,237,73,43,57,24,421,222,199,69,50,60,18,0
68897,86,50,36,9,14,8,7,244,143,101,31,29,26,8,0
68898,202,103,99,28,20,12,8,483,287,196,71,50,54,17,0
68899,313,148,165,45,33,36,11,536,251,285,75,79,60,23,0
68900,861,393,468,150,101,69,35,548,273,275,84,81,64,30,0
68901,280,128,152,39,37,38,18,360,185,175,51,43,36,16,0
68902,305,164,141,43,23,47,18,403,221,182,47,41,47,8,0
68903,71,28,43,15,9,5,2,647,324,323,101,80,76,43,0
68904,631,304,327,98,75,52,23,617,314,303,96,68,68,37,0
68905,118,56,62,24,12,6,9,222,119,103,37,32,24,8,0
68906,595,339,256,64,36,54,24,246,107,139,55,33,27,11,0
68907,781,367,414,60,67,43,17,106,41,65,36,6,11,7,0
68908,915,336,579,185,199,56,29,507,270,237,89,59,57,22,0
68909,646,304,342,104,93,58,26,424,179,245,65,67,29,11,0
68910,281,125,156,44,47,17,7,621,273,348,104,102,48,19,0
68911,130,71,59,30,9,8,1,213,129,84,32,14,21,15,0
68912,234,110,124,39,29,23,2,627,323,304,81,90,53,27,0
68913,426,213,213,60,56,46,24,148,69,79,26,18,16,3,0
68914,342,185,157,42,27,31,14,660,333,327,102,95,69,31,0
68915,412,193,219,69,57,43,14,165,87,78,24,19,22,9,0
68916,475,235,240,77,58,43,22,404,190,214,55,55,35,27,0
68917,215,117,98,28,19,15,8,339,175,164,51,49,37,9,0
68918,493,281,212,56,61,30,13,432,244,188,51,51,27,14,0
68919,785,374,411,56,42,38,25,352,207,145,40,33,25,21,0
68920,392,221,171,53,30,25,8,1065,581,484,134,97,76,46,0
68921,1395,595,800,223,206,113,61,483,287,196,71,50,54,17,0
68922,347,181,166,27,20,12,12,584,249,335,80,96,22,13,0
68923,545,221,324,101,72,55,30,602,310,292,87,66,70,36,0
68924,280,156,124,36,19,20,13,289,140,149,33,42,30,15,0
68925,766,336,430,133,97,79,21,736,388,348,88,85,67,28,0
68926,305,124,181,27,25,31,21,434,213,221,77,62,53,12,0
68927,202,103,99,28,20,12,8,1543,794,749,182,152,132,55,0
68928,600,324,276,89,73,45,39,439,231,208,65,51,55,17,0
68929,380,187,193,38,51,30,18,862,426,436,113,115,84,37,0
68930,396,150,246,103,64,38,3,180,89,91,28,27,18,7,0
68931,219,100,119,40,29,21,3,783,406,377,102,91,57,29,0
68932,206,100,106,34,26,11,7,481,223,258,71,70,49,26,0
68933,687,351,336,106,67,70,41,903,436,467,128,116,83,33,0
68934,588,300,288,100,57,65,27,198,110,88,27,27,24,4,0
68935,350,212,138,32,26,40,13,630,321,309,86,90,57,26,0
68936,520,231,289,89,59,58,26,103,44,59,16,17,9,5,0
68937,514,226,288,71,66,63,32,218,118,100,33,30,25,11,0
68938,102,22,80,48,8,18,6,201,93,108,34,39,21,6,0
68939,126,56,70,31,10,10,3,405,214,191,53,42,49,20,0
68940,364,172,192,55,57,32,15,213,129,84,32,14,21,15,0
68941,524,270,254,84,72,70,23,201,104,97,36,32,24,7,0
68942,301,150,151,45,47,33,13,339,175,164,51,49,37,9,0
68943,371,143,228,77,48,29,26,296,151,145,45,42,32,11,0
68944,297,161,136,36,35,24,9,375,176,199,48,61,40,12,0
68945,142,76,66,21,21,22,11,134,55,79,22,24,16,6,0
68946,1755,849,906,245,226,148,56,710,375,335,95,94,110,28,0
68947,443,212,231,74,24,60,24,207,114,93,33,20,31,13,0
68948,302,160,142,35,35,37,10,715,345,370,110,97,64,25,0
68949,869,489,380,110,77,79,29,375,176,199,48,61,40,12,0
68950,828,368,460,118,98,59,38,660,333,327,102,95,69,31,0
68951,270,147,123,34,17,39,21,189,105,84,25,26,21,9,0
68952,453,240,213,53,33,44,16,455,191,264,68,86,21,19,0
68953,782,372,410,127,111,89,36,4646,2328,2318,674,639,475,170,0
68954,236,141,95,36,32,14,6,821,394,427,122,117,109,38,0
68955,350,178,172,49,62,29,16,866,397,469,117,153,95,48,0
68956,161,99,62,15,22,9,7,403,185,218,67,62,63,19,0
68957,525,254,271,60,76,46,13,194,109,85,23,24,21,9,0
68958,1284,511,773,227,166,169,107,148,84,64,30,7,17,4,0
68959,435,222,213,67,49,67,12,374,174,200,54,52,42,21,0
68960,443,206,237,76,68,52,28,348,212,136,53,31,25,18,0
68961,144,57,87,38,26,10,4,137,63,74,20,22,14,6,0
68962,548,310,238,72,62,54,13,367,218,149,45,43,42,16,0
68963,347,181,166,27,20,12,12,421,222,199,69,50,60,18,0
68964,422,207,215,79,38,53,23,65,32,33,16,4,8,3,0
68965,341,177,164,57,42,40,18,414,203,211,58,56,48,14,0
68966,242,111,131,35,35,17,13,142,73,69,27,9,15,11,0
68967,1105,544,561,165,167,99,40,381,187,194,37,49,36,17,0
68968,557,211,346,129,125,48,19,203,98,105,34,29,19,10,0
68969,463,250,213,56,45,73,25,348,212,136,53,31,25,18,0
68970,196,107,89,20,31,17,4,72,33,39,8,2,3,12,0
68971,560,279,281,113,64,58,15,926,425,501,159,147,77,35,0
68972,156,64,92,31,19,5,4,147,74,73,28,20,24,4,0
68973,338,173,165,31,42,22,10,455,191,264,68,86,21,19,0
68974,280,156,124,36,19,20,13,104,46,58,15,17,9,5,0
68975,323,171,152,36,36,47,15,336,190,146,52,30,41,6,0
68976,616,323,293,98,71,31,15,780,337,443,112,116,77,28,0
68977,492,253,239,73,67,77,29,54,26,28,11,4,3,3,0
68978,911,441,470,123,108,60,21,1922,923,999,267,275,215,90,0
68979,570,238,332,112,95,39,23,1101,626,475,145,122,120,50,0
68980,1970,978,992,245,206,198,80,515,276,239,62,59,43,31,0
68981,340,145,195,46,38,26,23,381,187,194,37,49,36,17,0
68982,1004,464,540,143,104,78,55,171,94,77,24,28,30,11,0
68983,257,132,125,39,27,26,10,403,221,182,62,50,42,12,0
68984,234,110,124,39,29,23,2,397,223,174,50,39,29,17,0
68985,297,161,136,36,35,24,9,380,178,202,69,53,37,10,0
68986,126,58,68,31,10,10,3,132,61,71,19,20,14,6,0
68987,314,158,156,39,28,30,17,926,340,586,133,119,60,40,0
68988,505,201,304,116,58,75,31,131,55,76,28,9,14,12,0
68989,260,138,122,44,30,28,6,283,160,123,25,20,37,9,0
68990,418,163,255,57,54,38,24,228,130,98,35,29,30,10,0
68991,221,80,141,48,37,14,10,1395,627,768,172,263,141,59,0
68992,520,240,280,87,63,67,16,432,244,188,51,51,27,14,0
68993,1221,597,624,201,152,83,31,1279,669,610,164,162,104,55,0
68994,553,319,234,56,37,54,18,551,226,325,96,103,43,11,0
68995,371,209,162,46,17,36,19,584,249,335,80,96,22,13,0
68996,502,274,228,64,49,75,17,339,180,159,36,29,16,16,0
68997,342,150,192,52,43,31,17,368,200,168,54,49,43,9,0
68998,640,279,361,102,83,69,21,427,251,176,51,39,25,22,0
68999,579,281,298,91,78,74,27,620,324,296,81,68,66,31,0
69000,1835,904,931,192,144,135,63,457,253,204,67,51,48,13,0
69001,586,298,288,80,75,64,37,245,121,124,37,35,36,12,0
69002,802,430,372,65,102,87,23,663,360,303,87,82,80,35,0
69003,184,88,96,15,40,17,8,200,89,111,26,25,17,7,0
69004,795,384,411,133,109,85,38,339,180,159,36,29,16,16,0
69005,344,168,176,50,39,30,20,153,80,73,26,18,19,4,0
69006,82,36,46,17,10,5,1,265,134,131,48,34,33,15,0
69007,334,155,179,47,34,38,11,295,160,135,42,37,46,16,0
69008,316,157,159,45,38,22,19,374,202,172,50,39,31,24,0
69009,640,308,332,91,102,49,21,384,204,180,53,47,49,17,0
69010,178,74,104,31,28,9,4,470,205,265,71,80,33,11,0
69011,313,178,135,43,18,35,6,535,311,224,66,52,49,24,0
69012,510,269,241,66,67,71,26,873,411,462,132,107,84,40,0
69013,517,196,321,103,98,33,12,741,383,358,92,63,79,36,0
69014,758,378,380,89,64,37,31,244,143,101,31,29,26,8,0
69015,565,264,301,101,73,72,15,187,89,98,36,24,20,6,0
69016,336,134,202,51,64,27,12,198,86,112,36,27,23,9,0
69017,1759,838,921,269,212,191,92,602,310,292,87,66,70,36,0
69018,1360,644,716,213,194,136,62,661,325,336,81,75,65,28,0
69019,325,177,148,40,24,23,13,349,200,149,41,39,30,20,0
69020,500,257,243,60,55,27,22,866,478,388,121,101,101,26,0
69021,1542,682,860,290,158,120,47,4646,2328,2318,674,639,475,170,0
69022,332,173,159,48,42,42,9,457,242,215,39,46,53,10,0
69023,179,78,101,29,22,10,8,225,114,111,32,29,26,6,0
69024,269,156,113,37,32,17,7,727,388,339,102,87,70,29,0
69025,364,204,160,65,35,15,13,303,137,166,54,54,31,15,0
69026,2279,996,1283,375,328,158,60,200,89,111,26,25,17,7,0
69027,616,304,312,75,71,55,25,198,110,88,27,27,24,4,0
69028,417,222,195,53,39,43,10,1323,690,633,132,178,112,61,0
69029,595,208,387,157,60,91,48,303,137,166,54,54,31,15,0
69030,315,174,141,46,38,47,16,119,61,58,17,12,10,6,0
69031,1544,738,806,239,217,145,91,497,227,270,70,63,66,30,0
69032,463,250,213,56,45,73,25,1061,543,518,146,123,109,67,0
69033,255,110,145,34,32,23,17,296,151,145,45,42,32,11,0
69034,451,278,173,71,35,58,12,135,65,70,21,25,15,9,0
69035,4128,2104,2024,581,505,453,205,346,178,168,58,41,33,12,0
69036,379,217,162,47,20,50,23,124,69,55,14,7,9,4,0
69037,111,29,82,10,54,0,1,704,355,349,113,94,71,24,0
69038,193,110,83,18,20,15,12,220,107,113,36,35,28,9,0
69039,692,305,387,100,97,78,30,862,426,436,113,115,84,37,0
69040,789,362,427,90,82,70,35,381,186,195,69,55,46,15,0
69041,204,103,101,16,32,22,8,207,114,93,33,20,31,13,0
69042,298,141,157,51,33,21,22,104,46,58,15,17,9,5,0
69043,228,105,123,34,43,20,10,199,92,107,34,30,18,9,0
69044,126,57,69,31,10,10,3,173,90,83,21,36,12,15,0
69045,244,104,140,52,31,30,14,564,264,300,79,84,65,26,0
69046,221,80,141,48,37,14,10,463,268,195,59,46,46,21,0
69047,548,250,298,85,64,56,21,509,267,242,79,81,38,20,0
69048,471,221,250,87,68,42,25,290,142,148,41,37,43,11,0
69049,747,469,278,60,41,53,23,508,261,247,65,53,58,23,0
69050,435,187,248,62,51,51,21,588,286,302,78,99,53,25,0
69051,103,44,59,16,17,9,5,873,366,507,127,125,75,21,0
69052,255,136,119,39,20,32,10,173,94,79,18,24,12,7,0
69053,1365,590,775,257,168,136,93,744,385,359,105,96,57,31,0
69054,714,260,454,140,97,120,54,866,397,469,117,153,95,48,0
69055,513,276,237,73,43,57,24,1248,584,664,184,164,155,67,0
69056,1647,794,853,279,235,128,65,196,105,91,40,13,19,10,0
69057,261,126,135,41,36,24,11,766,386,380,101,81,78,31,0
69058,407,230,177,44,39,34,19,963,455,508,127,130,115,48,0
69059,493,281,212,56,61,30,13,204,80,124,29,51,10,5,0
69060,667,366,301,96,55,84,25,350,196,154,52,37,21,14,0
69061,434,221,213,58,47,54,15,102,51,51,12,15,12,3,0
69062,224,108,116,31,32,22,8,256,141,115,32,22,32,8,0
69063,557,211,346,129,125,48,19,339,180,159,36,29,16,16,0
69064,911,445,466,154,121,108,48,87,51,35,15,9,9,4,0
69065,1276,607,669,192,178,136,63,708,328,380,113,100,82,34,0
69066,446,195,251,56,53,31,15,729,358,371,116,99,89,33,0
69067,412,146,266,106,38,67,35,188,105,83,25,17,24,7,0
69068,342,185,157,42,27,31,14,430,212,218,88,43,40,20,0
69069,1711,865,846,204,176,105,60,138,69,69,28,7,10,10,0
69070,1189,653,536,152,118,109,56,200,99,101,31,24,26,6,0
69071,500,297,203,66,33,53,15,403,184,219,75,51,47,20,0
69072,3230,1724,1506,361,358,157,75,1214,475,739,177,250,89,49,0
69073,911,489,422,121,98,97,36,471,238,233,66,63,62,19,0
69074,313,148,165,45,33,36,11,132,77,55,20,9,13,10,0
69075,465,305,160,40,47,34,9,188,105,83,25,17,24,7,0
69076,580,308,272,82,79,58,25,188,90,98,44,7,21,7,0
69077,2136,1063,1073,317,308,223,90,142,76,66,21,21,22,11,0
69078,188,84,104,35,36,18,9,504,272,232,75,57,53,19,0
69079,179,78,101,29,22,10,8,518,292,226,60,60,52,21,0
69080,102,22,80,48,8,18,6,137,78,59,22,16,17,4,0
69081,119,67,52,15,15,7,7,68,23,45,12,9,3,9,0
69082,418,163,255,57,54,38,24,231,126,105,28,26,34,9,0
69083,221,114,107,65,7,2,1,617,314,303,96,68,68,37,0
69084,631,304,327,98,75,52,23,2038,1059,979,262,237,208,100,0
69085,567,256,311,91,81,53,17,354,183,171,54,43,49,8,0
69086,681,367,314,83,74,78,31,410,197,213,67,43,56,18,0
69087,852,472,380,99,79,70,27,344,190,154,34,31,36,10,0
69088,648,376,272,70,60,73,24,947,482,465,143,107,89,37,0
69089,391,204,187,47,48,38,18,261,127,134,36,27,36,4,0
69090,245,111,134,36,27,18,6,166,102,64,19,14,17,2,0
69091,410,200,210,60,54,46,19,406,202,204,54,51,63,21,0
69092,340,181,159,44,39,35,21,530,287,243,79,70,33,26,0
69093,577,251,326,92,84,60,11,535,301,234,63,48,47,27,0
69094,502,250,252,70,47,57,15,780,337,443,112,116,77,28,0
69095,763,371,392,104,88,52,23,250,116,134,41,30,33,19,0
69096,729,351,378,111,98,58,18,166,90,76,27,18,21,5,0
69097,667,366,301,96,55,84,25,1922,923,999,267,275,215,90,0
69098,126,58,68,31,10,10,3,222,127,95,23,28,22,7,0
69099,1220,575,645,208,179,99,56,297,175,122,46,30,31,6,0
69100,451,278,173,71,35,58,12,530,287,243,79,70,33,26,0
69101,522,302,220,61,49,75,19,381,186,195,69,55,46,15,0
69102,371,209,162,46,17,36,19,1001,417,584,186,147,96,47,0
69103,949,467,482,126,127,102,51,1262,653,609,169,165,152,50,0
69104,493,208,285,75,77,70,40,449,252,197,61,52,36,18,0
69105,452,217,235,59,47,60,20,1323,690,633,132,178,112,61,0
69106,795,384,411,133,109,85,38,194,106,88,33,10,15,6,0
69107,529,290,239,54,63,85,15,165,87,78,24,19,22,9,0
69108,206,100,106,34,26,11,7,1004,457,547,150,150,74,52,0
69109,1462,711,751,219,222,148,65,240,141,99,34,28,29,8,0
69110,167,70,97,32,20,15,7,260,133,127,43,32,39,3,0
69111,117,57,60,17,14,11,10,462,251,211,74,53,41,18,0
69112,255,110,145,34,32,23,17,1262,653,609,169,165,152,50,0
69113,557,211,346,129,125,48,19,459,260,199,56,42,47,21,0
69114,217,109,108,30,23,28,10,492,278,214,65,58,32,11,0
69115,1047,443,604,162,156,78,52,974,457,517,133,117,69,26,0
69116,586,298,288,80,75,64,37,818,357,461,122,136,54,25,0
69117,1390,585,805,241,230,118,46,166,78,88,27,25,19,7,0
69118,474,250,224,58,47,37,12,198,113,85,19,20,26,12,0
69119,727,426,301,79,71,64,32,368,200,168,54,49,43,9,0
69120,395,195,200,41,55,23,10,200,99,101,31,24,26,6,0
69121,1214,612,602,169,173,98,35,478,254,224,67,74,56,28,0
69122,257,148,109,28,20,21,14,218,115,103,37,33,33,9,0
69123,743,366,377,41,37,26,14,415,205,210,77,52,55,17,0
69124,519,259,260,86,78,59,22,306,157,149,52,35,39,16,0
69125,215,80,135,54,56,21,9,660,332,328,84,73,47,19,0
69126,346,173,173,50,56,31,14,1114,539,575,145,131,94,56,0
69127,557,211,346,129,125,48,19,260,133,127,43,32,39,3,0
69128,111,29,82,10,54,0,1,1154,489,665,200,196,95,54,0
69129,133,66,67,21,24,9,2,96,50,46,8,15,6,2,0
69130,372,189,183,60,44,41,18,376,183,193,50,50,43,21,0
69131,184,93,91,26,25,14,11,609,335,274,79,57,45,22,0
69132,396,150,246,103,64,38,3,810,310,500,164,162,42,26,0
69133,505,282,223,60,57,66,23,205,94,111,48,31,15,6,0
69134,904,436,468,138,146,82,39,457,242,215,39,46,53,10,0
69135,673,317,356,101,85,76,49,1543,794,749,182,152,132,55,0
69136,312,173,139,43,47,28,6,531,261,270,73,80,68,26,0
69137,218,133,85,20,19,13,6,375,210,165,49,37,29,27,0
69138,270,130,140,43,24,36,10,1265,689,576,169,177,128,60,0
69139,129,70,59,29,9,7,2,225,111,114,32,34,32,16,0
69140,135,64,71,31,11,8,4,572,305,267,74,72,58,21,0
69141,1689,821,868,277,250,177,78,457,253,204,67,51,48,13,0
69142,1107,601,506,155,138,103,49,424,179,245,65,67,29,11,0
69143,579,281,298,91,78,74,27,601,279,322,81,65,27,12,0
69144,117,57,60,17,14,11,10,611,314,297,79,75,78,22,0
69145,911,445,466,154,121,108,48,222,122,100,39,32,24,9,0
69146,426,196,230,76,65,54,20,368,200,168,54,49,43,9,0
69147,3703,1708,1995,456,428,305,162,430,212,218,88,43,40,20,0
69148,758,378,380,89,64,37,31,86,40,46,16,13,9,7,0
69149,275,125,150,37,48,27,7,846,425,421,125,97,98,38,0
69150,161,94,67,23,13,8,10,250,119,131,58,26,29,7,0
69151,412,203,209,65,47,37,18,374,212,162,48,40,32,23,0
69152,466,259,207,59,50,83,12,381,186,195,69,55,46,15,0
69153,244,104,140,52,31,30,14,338,169,169,53,44,39,21,0
69154,213,88,125,21,54,14,15,405,214,191,53,42,49,20,0
69155,451,278,173,71,35,58,12,693,360,333,100,88,62,26,0
69156,625,283,342,93,89,67,25,2547,1280,1267,331,335,293,118,0
69157,730,298,432,128,69,86,26,640,364,276,84,68,69,33,0
69158,475,235,240,77,58,43,22,392,214,178,48,40,53,22,0
69159,336,199,137,46,22,51,13,142,65,77,30,17,22,9,0
69160,794,322,472,122,108,79,34,86,40,46,16,13,9,7,0
69161,233,107,126,40,40,20,16,449,252,197,61,52,36,18,0
69162,977,462,515,185,119,76,12,1323,690,633,132,178,112,61,0
69163,1107,601,506,155,138,103,49,516,245,271,82,84,70,26,0
69164,785,374,411,56,42,38,25,1698,875,823,222,219,173,64,0
69165,580,265,315,97,89,79,17,424,179,245,65,67,29,11,0
69166,929,410,519,187,146,53,30,173,94,79,18,24,12,7,0
69167,332,172,160,50,33,35,9,325,159,166,59,46,30,12,0
69168,365,222,143,44,24,35,11,145,77,68,26,7,15,8,0
69169,261,148,113,23,29,26,21,209,119,90,28,24,27,9,0
69170,2174,1057,1117,241,241,214,117,866,478,388,121,101,101,26,0
69171,332,172,160,50,33,35,9,518,292,226,60,60,52,21,0
69172,126,56,70,31,10,10,3,664,350,314,86,90,82,36,0
69173,2220,1085,1135,312,304,202,91,508,262,246,66,67,51,20,0
69174,571,298,273,81,72,57,25,149,77,72,37,10,20,5,0
69175,510,269,241,66,67,71,26,222,122,100,39,32,24,9,0
69176,546,278,268,94,60,32,22,1249,638,611,166,153,141,45,0
69177,350,212,138,32,26,40,13,1537,701,836,209,187,129,58,0
69178,335,183,152,40,26,54,22,457,245,212,62,58,57,21,0
69179,260,133,127,43,29,34,11,72,34,38,8,2,3,12,0
69180,443,212,231,74,24,60,24,212,127,85,28,21,26,6,0
69181,543,221,322,78,122,37,12,1117,422,695,182,134,88,32,0
69182,252,121,131,42,34,12,16,244,143,101,31,29,26,8,0
69183,288,142,146,52,32,26,8,294,146,148,50,45,51,15,0
69184,1001,422,579,185,180,51,32,963,455,508,127,130,115,48,0
69185,243,70,173,54,65,8,6,1425,670,755,153,189,122,85,0
69186,1130,614,516,129,138,98,42,1182,591,591,155,139,83,46,0
69187,535,217,318,87,106,41,14,209,119,90,28,24,27,9,0
69188,221,75,146,68,21,16,5,457,242,215,39,46,53,10,0
69189,176,74,102,20,29,7,7,810,310,500,164,162,42,26,0
69190,221,80,141,48,37,14,10,422,202,220,80,52,57,18,0
69191,1200,602,598,145,116,110,50,926,425,501,159,147,77,35,0
69192,861,393,468,150,101,69,35,422,202,220,80,52,57,18,0
69193,1052,492,560,184,163,103,44,1314,693,621,174,155,140,58,0
69194,929,410,519,187,146,53,30,481,223,258,71,70,49,26,0
69195,150,60,90,27,16,6,3,309,159,150,47,43,43,13,0
69196,331,169,162,40,28,22,14,91,42,49,21,9,8,3,0
69197,1590,726,864,270,237,126,59,148,84,64,30,7,17,4,0
69198,451,278,173,71,35,58,12,715,345,370,110,97,64,25,0
69199,4128,2104,2024,581,505,453,205,260,133,127,43,32,39,3,0
69200,284,128,156,48,29,34,8,274,157,117,40,29,40,8,0
69201,1647,794,853,279,235,128,65,463,268,195,59,46,46,21,0
69202,435,187,248,62,51,51,21,953,489,464,126,104,111,44,0
69203,107,53,54,15,15,13,4,188,101,87,20,18,20,14,0
69204,131,69,62,29,9,9,1,751,394,357,107,96,73,35,0
69205,309,137,172,51,50,28,14,862,409,453,149,125,86,29,0
69206,512,254,258,70,48,37,32,346,178,168,58,41,33,12,0
69207,514,226,288,71,66,63,32,377,184,193,50,43,33,17,0
69208,1755,849,906,245,226,148,56,457,253,204,67,51,48,13,0
69209,915,336,579,185,199,56,29,189,105,84,25,26,21,9,0
69210,513,276,237,73,43,57,24,452,231,221,74,53,56,20,0
69211,649,304,345,99,80,67,40,699,334,365,108,80,70,20,0
69212,391,204,187,47,48,38,18,392,214,178,48,40,53,22,0
69213,325,152,173,43,47,28,17,138,69,69,28,7,10,10,0
69214,840,411,429,122,101,79,34,270,130,140,48,44,37,12,0
69215,1186,495,691,182,208,88,32,389,210,179,51,37,43,9,0
69216,1047,443,604,162,156,78,52,173,86,87,30,22,19,12,0
69217,257,132,125,39,27,26,10,314,151,163,42,61,39,16,0
69218,554,217,337,112,72,90,38,103,44,59,16,17,9,5,0
69219,303,161,142,38,31,42,17,1001,417,584,186,147,96,47,0
69220,1087,523,564,146,177,103,33,385,212,173,57,40,39,21,0
69221,361,167,194,55,35,41,11,374,174,200,54,52,42,21,0
69222,562,214,348,120,86,69,42,518,292,226,60,60,52,21,0
69223,398,186,212,76,70,18,13,1323,690,633,132,178,112,61,0
69224,150,64,86,22,12,29,12,339,175,164,51,49,37,9,0
69225,425,198,227,57,69,59,13,270,130,140,48,44,37,12,0
69226,336,134,202,51,64,27,12,124,69,55,14,7,9,4,0
69227,130,72,58,28,9,7,1,130,67,63,24,10,12,4,0
69228,1189,653,536,152,118,109,56,405,195,210,57,74,24,17,0
69229,763,371,392,104,88,52,23,316,159,157,38,48,30,11,0
69230,156,64,92,31,19,5,4,107,77,30,7,2,9,5,0
69231,836,370,466,126,96,72,30,334,182,152,45,41,27,13,0
69232,220,113,107,37,24,16,7,482,232,250,77,81,44,13,0
69233,861,393,468,150,101,69,35,389,210,179,51,37,43,9,0
69234,1360,644,716,213,194,136,62,663,354,309,91,84,79,31,0
69235,484,264,220,59,62,68,15,729,358,371,116,99,89,33,0
69236,482,231,251,76,81,64,26,127,66,61,13,14,19,8,0
69237,313,148,165,45,33,36,11,385,188,197,57,42,36,16,0
69238,548,250,298,85,64,56,21,89,38,51,14,6,3,9,0
69239,217,109,108,30,23,28,10,350,196,154,52,37,21,14,0
69240,146,75,71,13,32,15,11,598,333,265,79,66,54,33,0
69241,711,330,381,111,86,86,34,106,46,60,29,13,14,5,0
69242,275,125,150,37,48,27,7,798,385,413,120,115,79,30,0
69243,288,142,146,52,32,26,8,498,244,254,81,67,58,19,0
69244,528,188,340,130,58,77,41,463,170,293,115,54,75,32,0
69245,664,269,395,117,107,36,15,323,171,152,48,41,40,16,0
69246,279,129,150,43,34,17,13,419,233,186,54,53,55,17,0
69247,631,316,315,64,57,49,15,346,178,168,58,41,33,12,0
69248,1689,821,868,277,250,177,78,309,164,145,35,47,30,11,0
69249,403,176,227,71,56,51,11,124,69,55,14,7,9,4,0
69250,478,220,258,47,70,41,10,297,164,133,45,39,40,9,0
69251,516,224,292,79,29,45,33,87,51,35,15,9,9,4,0
69252,425,220,205,60,55,45,18,334,181,153,41,40,25,15,0
69253,2062,706,1356,414,368,158,63,403,221,182,62,50,42,12,0
69254,473,265,208,47,26,50,30,319,185,134,42,31,22,13,0
69255,434,221,213,58,47,54,15,132,61,71,19,20,14,6,0
69256,580,308,272,82,79,58,25,368,200,168,54,49,43,9,0
69257,231,105,126,56,10,24,10,457,253,204,67,51,48,13,0
69258,256,152,104,18,23,23,8,748,359,389,125,113,86,31,0
69259,565,264,301,101,73,72,15,2724,1157,1567,269,518,239,77,0
69260,127,48,79,27,20,6,5,222,124,98,37,29,22,9,0
69261,425,220,205,60,55,45,18,328,199,129,39,29,27,14,0
69262,1001,422,579,185,180,51,32,457,242,215,39,46,53,10,0
69263,413,169,244,66,94,28,19,375,176,199,48,61,40,12,0
69264,1544,738,806,239,217,145,91,1208,565,643,182,162,120,57,0
69265,1709,650,1059,338,286,185,46,699,334,365,108,80,70,20,0
69266,577,251,326,92,84,60,11,207,114,93,33,20,31,13,0
69267,531,260,271,97,68,47,11,1323,690,633,132,178,112,61,0
69268,505,226,279,68,51,30,15,381,196,185,55,57,43,16,0
69269,473,212,261,72,64,45,28,866,478,388,121,101,101,26,0
69270,607,294,313,94,95,62,14,463,170,293,115,54,75,32,0
69271,579,246,333,102,79,41,19,101,59,42,11,17,10,1,0
69272,3703,1708,1995,456,428,305,162,377,184,193,50,43,33,17,0
69273,641,349,292,92,60,39,24,234,116,118,34,35,23,9,0
69274,203,80,123,40,37,20,3,160,60,100,23,40,19,11,0
69275,730,298,432,128,69,86,26,1248,584,664,184,164,155,67,0
69276,150,64,86,22,12,29,12,975,400,575,160,162,62,31,0
69277,437,230,207,41,55,27,13,323,162,161,52,41,39,13,0
69278,132,66,66,21,18,11,7,415,203,212,77,44,49,18,0
69279,192,91,101,28,21,18,8,218,117,101,35,32,34,12,0
69280,580,240,340,108,81,59,22,180,89,91,28,27,18,7,0
69281,963,477,486,134,143,123,38,792,398,394,109,96,90,39,0
69282,557,211,346,129,125,48,19,744,385,359,105,96,57,31,0
69283,224,108,116,31,32,22,8,188,101,87,20,18,20,14,0
69284,443,212,231,74,24,60,24,508,262,246,66,67,51,20,0
69285,106,43,63,28,13,8,1,374,191,183,40,52,40,16,0
69286,480,267,213,49,44,70,21,1922,923,999,267,275,215,90,0
69287,496,209,287,112,55,71,14,583,321,262,73,67,45,25,0
69288,150,60,90,27,16,6,3,2542,1245,1297,285,287,170,84,0
69289,269,127,142,43,24,34,26,459,260,199,56,42,47,21,0
69290,583,248,335,115,111,52,16,1865,919,946,300,256,217,76,0
69291,1009,487,522,177,121,103,51,478,254,224,67,74,56,28,0
69292,752,313,439,121,106,68,27,744,385,359,105,96,57,31,0
69293,1339,494,845,216,298,92,37,517,295,222,69,62,40,28,0
69294,71,39,32,7,11,6,4,737,397,340,87,104,90,14,0
69295,301,157,144,31,28,34,9,222,124,98,37,29,22,9,0
69296,373,164,209,51,45,44,21,96,45,51,13,12,6,4,0
69297,301,157,144,31,28,34,9,662,373,289,89,80,77,29,0
69298,374,202,172,58,40,41,7,331,180,151,46,35,47,17,0
69299,465,240,225,50,54,24,14,314,151,163,42,61,39,16,0
69300,423,247,176,58,55,29,20,463,259,204,62,55,34,22,0
69301,781,316,465,130,129,65,23,194,109,85,23,24,21,9,0
69302,330,141,189,65,29,51,19,89,37,52,13,6,2,9,0
69303,593,282,311,75,70,29,25,732,366,366,108,86,74,41,0
69304,319,153,166,61,52,26,12,373,189,184,54,46,50,23,0
69305,373,194,179,42,54,26,13,396,213,183,68,44,47,18,0
69306,979,534,445,83,77,80,24,724,353,371,94,95,71,31,0
69307,272,136,136,32,34,12,12,188,101,87,20,18,20,14,0
69308,594,248,346,104,109,53,5,583,321,262,73,67,45,25,0
69309,412,193,219,69,57,43,14,530,287,243,79,70,33,26,0
69310,619,289,330,67,77,36,19,180,115,65,17,12,9,9,0
69311,443,250,193,52,23,49,13,619,305,314,85,93,71,29,0
69312,758,378,380,89,64,37,31,843,391,452,139,104,91,35,0
69313,406,207,199,56,46,68,19,1230,644,586,198,125,123,61,0
69314,142,76,66,21,21,22,11,375,210,165,49,37,29,27,0
69315,1030,567,463,118,106,94,49,392,155,237,68,61,34,16,0
69316,730,298,432,128,69,86,26,445,192,253,86,58,53,18,0
69317,1054,453,601,183,183,107,35,319,185,134,42,31,22,13,0
69318,130,70,60,30,9,8,1,89,37,52,13,6,2,9,0
69319,389,176,213,81,59,24,7,234,129,105,31,22,19,17,0
69320,928,442,486,139,118,91,43,598,333,265,79,66,54,33,0
69321,332,173,159,48,42,42,9,290,142,148,41,37,43,11,0
69322,1464,693,771,153,136,91,86,370,173,197,65,57,42,10,0
69323,1501,679,822,251,196,174,67,1248,584,664,184,164,155,67,0
69324,500,297,203,66,33,53,15,434,213,221,77,62,53,12,0
69325,451,278,173,71,35,58,12,247,128,119,34,14,16,14,0
69326,739,389,350,129,61,69,25,133,61,72,21,19,13,4,0
69327,900,434,466,134,97,86,36,194,106,88,33,10,15,6,0
69328,126,58,68,31,10,10,3,396,199,197,54,50,45,14,0
69329,636,288,348,94,77,65,30,106,46,60,27,18,12,3,0
69330,781,367,414,60,67,43,17,288,156,132,36,36,24,15,0
69331,1054,497,557,190,168,107,45,286,152,134,38,38,32,11,0
69332,361,171,190,44,40,18,13,375,176,199,48,61,40,12,0
69333,484,264,220,59,62,68,15,348,212,136,53,31,25,18,0
69334,1616,735,881,285,248,153,72,1065,581,484,134,97,76,46,0
69335,1555,702,853,250,199,139,31,325,172,153,44,34,27,14,0
69336,165,66,99,28,32,16,3,455,191,264,68,86,21,19,0
69337,451,225,226,69,57,64,22,699,334,365,108,80,70,20,0
69338,1365,590,775,257,168,136,93,178,99,79,31,19,26,8,0
69339,346,209,137,46,37,44,10,465,252,213,73,58,60,18,0
69340,415,133,282,114,65,27,7,561,279,282,85,81,88,24,0
69341,553,319,234,56,37,54,18,904,436,468,143,118,108,32,0
69342,798,364,434,133,88,74,35,396,197,199,75,49,49,16,0
69343,126,66,60,24,10,7,9,323,162,161,52,41,39,13,0
69344,867,415,452,123,87,62,27,1040,564,476,134,110,114,51,0
69345,1872,837,1035,280,338,169,80,689,343,346,105,102,81,35,0
69346,291,142,149,50,29,35,7,175,82,93,33,26,17,5,0
69347,257,122,135,44,19,21,16,225,114,111,32,29,26,6,0
69348,414,206,208,56,68,35,19,1047,562,485,141,127,114,41,0
69349,763,371,392,104,88,52,23,858,461,397,125,114,79,45,0
69350,412,208,204,54,47,42,17,2225,1244,981,271,243,217,93,0
69351,117,57,60,17,14,11,10,132,61,71,22,21,15,3,0
69352,365,148,217,86,37,51,28,508,262,246,66,67,51,20,0
69353,824,391,433,106,90,88,32,601,278,323,124,87,65,21,0
69354,134,60,74,19,13,10,7,204,96,108,31,37,20,5,0
69355,654,344,310,80,69,57,15,260,133,127,43,32,39,3,0
69356,345,208,137,44,27,33,8,305,161,144,39,40,44,17,0
69357,227,120,107,31,28,28,13,963,525,438,119,102,102,34,0
69358,278,104,174,46,34,23,14,474,268,206,66,42,45,24,0
69359,219,98,121,43,19,11,7,221,75,146,68,21,16,5,0
69360,565,264,301,101,73,72,15,261,127,134,36,27,36,4,0
69361,707,250,457,171,84,117,61,501,274,227,63,58,53,20,0
69362,710,352,358,104,86,84,41,213,129,84,32,14,21,15,0
69363,450,227,223,53,36,48,12,661,325,336,81,75,65,28,0
69364,282,84,198,60,102,1,6,336,200,136,34,29,25,24,0
69365,420,189,231,79,67,33,17,673,313,360,102,101,46,17,0
69366,416,222,194,58,38,38,20,531,261,270,73,80,68,26,0
69367,1759,838,921,269,212,191,92,198,86,112,36,27,23,9,0
69368,126,58,68,31,10,10,3,338,169,169,53,44,39,21,0
69369,580,265,315,97,89,79,17,663,360,303,87,82,80,35,0
69370,575,305,270,74,87,73,25,128,63,65,30,11,13,8,0
69371,509,246,263,84,71,56,22,165,87,78,24,19,22,9,0
69372,801,331,470,151,139,99,55,89,51,38,15,15,5,4,0
69373,402,169,233,70,36,34,18,630,321,309,86,90,57,26,0
69374,2799,1324,1475,369,371,215,124,328,195,133,39,40,27,13,0
69375,162,73,89,32,19,4,4,763,418,345,113,84,59,32,0
69376,365,148,217,86,37,51,28,821,394,427,122,117,109,38,0
69377,729,351,378,111,98,58,18,2517,1275,1242,304,324,245,135,0
69378,412,193,219,69,57,43,14,137,85,52,15,11,11,2,0
69379,170,82,88,32,23,22,8,201,93,108,34,39,21,6,0
69380,125,57,68,31,10,10,3,148,69,79,26,18,16,3,0
69381,840,411,429,122,101,79,34,169,85,84,21,14,9,9,0
69382,303,147,156,49,49,20,8,370,173,197,65,57,42,10,0
69383,249,114,135,47,33,25,4,337,152,185,49,54,42,21,0
69384,444,228,216,47,62,53,25,1014,488,526,178,137,94,39,0
69385,130,70,60,30,9,8,1,367,218,149,45,43,42,16,0
69386,1464,693,771,153,136,91,86,301,168,133,49,37,34,11,0
69387,1124,442,682,148,189,72,43,203,98,105,34,29,19,10,0
69388,798,287,511,126,125,77,26,375,209,166,50,37,29,23,0
69389,346,209,137,46,37,44,10,293,142,151,49,40,42,17,0
69390,325,177,148,40,24,23,13,710,375,335,95,94,110,28,0
69391,640,308,332,91,102,49,21,1338,720,618,179,145,141,85,0
69392,1220,575,645,208,179,99,56,749,384,365,108,105,86,31,0
69393,458,210,248,39,38,25,16,417,232,185,58,50,29,21,0
69394,667,366,301,96,55,84,25,325,172,153,44,34,27,14,0
69395,911,441,470,123,108,60,21,507,270,237,89,59,57,22,0
69396,520,231,289,89,59,58,26,376,189,187,47,53,44,26,0
69397,452,202,250,83,60,56,19,447,212,235,86,55,58,21,0
69398,618,289,329,97,86,70,17,335,186,149,40,28,29,13,0
69399,554,217,337,112,72,90,38,689,343,346,105,102,81,35,0
69400,156,64,92,31,19,5,4,309,164,145,35,47,30,11,0
69401,2446,1099,1347,363,294,233,100,123,61,62,17,18,17,7,0
69402,204,93,111,35,35,16,11,148,69,79,26,18,16,3,0
69403,1360,644,716,213,194,136,62,323,162,161,52,41,39,13,0
69404,276,149,127,45,34,39,9,391,189,202,55,56,56,12,0
69405,517,245,272,92,77,46,24,400,187,213,56,59,42,20,0
69406,126,56,70,31,10,10,3,483,215,268,66,70,30,16,0
69407,2624,999,1625,415,495,109,84,96,46,50,16,12,7,5,0
69408,803,358,445,135,117,80,43,142,65,77,30,17,22,9,0
69409,429,238,191,47,49,56,29,352,207,145,40,33,25,21,0
69410,2220,1085,1135,312,304,202,91,1338,720,618,179,145,141,85,0
69411,312,164,148,54,29,25,15,300,148,152,45,43,40,8,0
69412,530,259,271,83,50,54,41,572,305,267,74,72,58,21,0
69413,1058,497,561,194,142,87,63,485,244,241,80,55,59,20,0
69414,236,141,95,36,32,14,6,299,140,159,49,44,26,11,0
69415,333,171,162,41,44,48,23,380,178,202,69,53,37,10,0
69416,553,319,234,56,37,54,18,398,200,198,68,43,51,14,0
69417,588,300,288,100,57,65,27,200,99,101,31,24,26,6,0
69418,255,136,119,39,20,32,10,332,173,159,48,40,31,11,0
69419,609,292,317,102,96,64,21,528,276,252,86,78,49,17,0
69420,2220,1085,1135,312,304,202,91,314,177,137,34,40,29,9,0
69421,71,28,43,15,9,5,2,250,116,134,41,30,33,19,0
69422,130,71,59,30,9,8,1,497,227,270,70,63,66,30,0
69423,714,260,454,140,97,120,54,320,168,152,38,42,24,18,0
69424,588,300,288,100,57,65,27,1537,701,836,209,187,129,58,0
69425,314,158,156,39,28,30,17,194,106,88,33,10,15,6,0
69426,411,236,175,39,45,50,30,166,90,76,27,18,21,5,0
69427,1124,442,682,148,189,72,43,295,158,137,42,34,38,14,0
69428,1594,660,934,251,272,117,77,180,89,91,28,27,18,7,0
69429,319,222,97,36,23,28,8,312,165,147,41,39,29,16,0
69430,557,250,307,70,47,51,22,662,373,289,89,80,77,29,0
69431,246,111,135,64,47,27,3,106,46,60,29,13,14,5,0
69432,134,60,74,19,13,10,7,277,144,133,42,30,41,8,0
69433,341,177,164,57,42,40,18,601,279,322,81,65,27,12,0
69434,753,361,392,99,94,66,16,495,217,278,79,64,44,22,0
69435,502,236,266,66,66,58,17,96,46,50,16,12,7,5,0
69436,418,163,255,57,54,38,24,137,85,52,15,11,11,2,0
69437,397,180,217,61,59,39,13,482,232,250,77,81,44,13,0
69438,1043,479,564,200,131,123,62,1507,737,770,188,228,147,71,0
69439,132,66,66,21,18,11,7,175,91,84,19,21,21,10,0
69440,350,212,138,32,26,40,13,452,254,198,72,57,38,18,0
69441,347,181,166,27,20,12,12,132,61,71,19,20,14,6,0
69442,447,225,222,76,35,75,21,400,187,213,56,59,42,20,0
69443,1043,479,564,200,131,123,62,322,180,142,45,38,28,7,0
69444,227,109,118,42,35,29,8,152,71,81,41,16,14,2,0
69445,244,104,140,52,31,30,14,439,231,208,65,51,55,17,0
69446,118,51,67,25,13,6,7,180,115,65,17,12,9,9,0
69447,210,84,126,44,43,9,4,380,178,202,69,53,37,10,0
69448,346,205,141,47,34,30,7,190,93,97,35,27,23,2,0
69449,181,75,106,35,26,11,9,496,285,211,62,54,46,22,0
69450,1464,693,771,153,136,91,86,1323,690,633,132,178,112,61,0
69451,379,217,162,47,20,50,23,749,384,365,108,105,86,31,0
69452,227,120,107,31,28,28,13,671,306,365,114,76,49,19,0
69453,396,150,246,103,64,38,3,633,311,322,94,82,45,20,0
69454,654,344,310,80,69,57,15,715,348,367,109,84,68,30,0
69455,286,111,175,51,47,21,12,679,338,341,96,95,40,23,0
69456,288,140,148,59,33,27,12,246,107,139,55,33,27,11,0
69457,579,281,298,91,78,74,27,925,439,486,141,134,105,46,0
69458,256,152,104,18,23,23,8,308,146,162,42,39,24,12,0
69459,406,208,198,41,26,43,21,297,175,122,46,30,31,6,0
69460,505,201,304,116,58,75,31,1062,522,540,151,147,105,66,0
69461,619,289,330,67,77,36,19,415,189,226,68,54,50,21,0
69462,853,400,453,137,109,88,42,232,111,121,23,29,17,9,0
69463,496,210,286,112,55,72,13,452,254,198,72,57,38,18,0
69464,2286,1154,1132,338,314,278,103,201,98,103,28,25,19,13,0
69465,285,148,137,31,42,42,16,405,181,224,71,57,31,12,0
69466,1755,849,906,245,226,148,56,286,160,126,37,27,23,10,0
69467,1390,585,805,241,230,118,46,397,223,174,50,39,29,17,0
69468,450,227,223,53,36,48,12,601,279,322,81,65,27,12,0
69469,563,255,308,91,111,42,30,330,166,164,55,51,36,16,0
69470,213,104,109,56,14,9,2,127,54,73,11,33,15,6,0
69471,302,160,142,35,35,37,10,334,182,152,45,41,27,13,0
69472,588,267,321,99,79,87,28,810,310,500,164,162,42,26,0
69473,297,182,115,41,22,23,8,461,223,238,45,62,18,35,0
69474,379,217,162,47,20,50,23,508,261,247,65,53,58,23,0
69475,215,80,135,54,56,21,9,531,277,254,82,75,33,22,0
69476,210,101,109,33,33,19,9,227,130,97,32,25,22,12,0
69477,426,213,213,60,56,46,24,239,113,126,36,49,20,8,0
69478,234,110,124,39,29,23,2,374,174,200,54,52,42,21,0
69479,462,258,204,59,41,56,15,798,385,413,120,115,79,30,0
69480,710,352,358,104,86,84,41,975,475,500,139,140,119,28,0
69481,618,289,329,97,86,70,17,101,59,42,11,17,10,1,0
69482,241,122,119,27,34,17,16,1004,457,547,150,150,74,52,0
69483,805,338,467,153,138,99,55,72,34,38,8,2,3,12,0
69484,251,131,120,49,35,25,5,487,252,235,79,58,55,26,0
69485,142,60,82,20,28,13,5,164,79,85,28,28,16,7,0
69486,545,221,324,101,72,55,30,720,361,359,98,98,70,37,0
69487,879,457,422,93,98,143,32,474,268,206,66,42,45,24,0
69488,1755,849,906,245,226,148,56,277,144,133,42,30,41,8,0
69489,243,100,143,58,50,24,5,317,161,156,50,36,47,12,0
69490,240,166,74,32,12,8,15,974,457,517,133,117,69,26,0
69491,407,207,200,53,36,38,8,564,264,300,79,84,65,26,0
69492,431,245,186,50,23,46,17,305,163,142,38,27,47,11,0
69493,301,119,182,53,47,14,20,223,113,110,31,33,22,12,0
69494,490,198,292,65,81,39,27,395,169,226,73,55,38,9,0
69495,207,128,79,26,17,19,9,627,323,304,81,90,53,27,0
69496,785,325,460,114,123,61,28,673,313,360,102,101,46,17,0
69497,624,337,287,78,58,118,21,126,53,73,23,19,8,4,0
69498,269,156,113,37,32,17,7,373,181,192,54,35,44,20,0
69499,308,163,145,38,33,30,20,138,69,69,28,7,10,10,0
69500,242,111,131,35,35,17,13,437,221,216,62,64,47,13,0
69501,284,128,156,48,29,34,8,403,233,170,38,29,21,14,0
69502,648,262,386,113,108,78,29,756,348,408,101,103,60,40,0
69503,535,217,318,87,106,41,14,701,380,321,94,84,96,34,0
69504,329,171,158,49,41,31,10,693,360,333,100,88,62,26,0
69505,361,183,178,50,54,51,22,724,353,371,94,95,71,31,0
69506,915,336,579,185,199,56,29,125,66,59,24,16,11,5,0
69507,469,253,216,49,51,48,18,73,35,38,14,10,9,4,0
69508,260,138,122,44,30,28,6,198,110,88,27,27,24,4,0
69509,360,205,155,35,24,52,14,463,268,195,59,46,46,21,0
69510,379,217,162,47,20,50,23,106,54,52,12,9,7,6,0
69511,329,171,158,49,41,31,10,487,252,235,79,58,55,26,0
69512,284,128,156,48,29,34,8,222,122,100,39,32,24,9,0
69513,142,76,66,21,21,22,11,462,251,211,74,53,41,18,0
69514,250,123,127,40,28,29,8,295,156,139,41,40,42,15,0
69515,575,295,280,89,68,54,18,1040,564,476,134,110,114,51,0
69516,1052,492,560,184,163,103,44,277,163,114,33,24,21,16,0
69517,1441,504,937,264,329,69,46,103,44,59,16,17,9,5,0
69518,516,224,292,79,29,45,33,928,440,488,111,157,82,35,0
69519,879,457,422,93,98,143,32,441,189,252,73,50,47,23,0
69520,476,199,277,82,80,49,24,286,160,126,37,27,23,10,0
69521,915,336,579,185,199,56,29,457,242,215,39,46,53,10,0
69522,470,163,307,99,68,73,30,234,129,105,31,22,19,17,0
69523,784,353,431,56,47,26,18,1279,669,610,164,162,104,55,0
69524,92,46,46,14,9,8,6,723,363,360,107,106,52,14,0
69525,225,111,114,38,22,25,10,403,185,218,67,62,63,19,0
69526,911,441,470,123,108,60,21,1382,508,874,334,320,98,36,0
69527,392,205,187,83,49,38,10,415,203,212,77,44,49,18,0
69528,509,251,258,69,49,55,17,220,107,113,36,35,28,9,0
69529,607,305,302,92,89,74,23,679,338,341,96,95,40,23,0
69530,395,189,206,63,50,49,28,395,169,226,73,55,38,9,0
69531,222,110,112,43,30,14,6,152,71,81,41,16,14,2,0
69532,859,411,448,118,100,95,49,605,283,322,94,72,64,39,0
69533,392,205,187,83,49,38,10,289,140,149,33,42,30,15,0
69534,494,242,252,67,47,25,21,145,77,68,26,7,15,8,0
69535,193,90,103,44,9,19,13,492,278,214,65,58,32,11,0
69536,403,176,227,71,56,51,11,87,38,49,23,10,10,9,0
69537,350,178,172,49,62,29,16,384,204,180,53,47,49,17,0
69538,1143,574,569,176,151,123,59,1040,564,476,134,110,114,51,0
69539,517,245,272,92,77,46,24,474,268,206,66,42,45,24,0
69540,172,98,74,20,21,22,8,65,32,33,16,4,8,3,0
69541,3230,1724,1506,361,358,157,75,504,272,232,75,57,53,19,0
69542,1849,931,918,245,220,158,90,244,143,101,31,29,26,8,0
69543,391,203,188,49,34,36,9,783,406,377,102,91,57,29,0
69544,643,284,359,129,71,84,43,548,273,275,84,81,64,30,0
69545,502,236,266,66,66,58,17,334,181,153,41,40,25,15,0
69546,2236,1195,1041,227,187,186,118,647,350,297,95,79,77,29,0
69547,193,90,103,44,9,19,13,135,65,70,21,25,15,9,0
69548,350,178,172,49,62,29,16,660,332,328,84,73,47,19,0
69549,476,276,200,57,34,43,16,188,93,95,33,18,16,10,0
69550,1009,478,531,166,126,96,42,346,178,168,58,41,33,12,0
69551,785,325,460,114,123,61,28,260,133,127,43,32,39,3,0
69552,1447,698,749,214,180,116,46,501,257,244,75,57,48,29,0
69553,464,237,227,64,66,33,12,396,199,197,54,50,45,14,0
69554,109,42,67,25,13,1,1,178,99,79,31,19,26,8,0
69555,437,230,207,41,55,27,13,654,295,359,99,88,71,25,0
69556,165,66,99,28,32,16,3,748,359,389,125,113,86,31,0
69557,604,239,365,124,63,84,37,439,231,208,65,51,55,17,0
69558,111,29,82,10,54,0,1,277,124,153,44,40,35,18,0
69559,1174,594,580,175,155,126,66,475,251,224,67,49,48,23,0
69560,300,136,164,45,35,45,14,194,109,85,23,24,21,9,0
69561,530,259,271,83,50,54,41,132,61,71,22,21,15,3,0
69562,504,222,282,71,64,53,29,402,186,216,64,47,38,20,0
69563,392,205,187,83,49,38,10,415,205,210,77,52,55,17,0
69564,507,242,265,53,44,31,22,189,105,84,25,26,21,9,0
69565,443,250,193,52,23,49,13,821,394,427,122,117,109,38,0
69566,126,57,69,31,10,10,3,257,139,118,64,17,24,7,0
69567,446,174,272,84,61,57,23,607,294,313,94,95,62,14,0
69568,510,269,241,66,67,71,26,415,203,212,77,44,49,18,0
69569,346,174,172,36,43,21,9,403,184,219,75,51,47,20,0
69570,446,195,251,56,53,31,15,376,189,187,47,53,44,26,0
69571,1441,504,937,264,329,69,46,562,273,289,76,92,45,24,0
69572,828,355,473,126,134,77,37,783,406,377,102,91,57,29,0
69573,480,267,213,49,44,70,21,395,169,226,73,55,38,9,0
69574,125,53,72,18,21,18,12,180,95,85,22,21,17,8,0
69575,801,331,470,151,139,99,55,565,237,328,75,88,32,11,0
69576,343,189,154,44,24,39,12,106,54,52,12,9,7,6,0
69577,260,133,127,43,29,34,11,209,119,90,28,24,27,9,0
69578,308,129,179,44,60,19,8,447,212,235,86,55,58,21,0
69579,416,207,209,63,47,56,15,111,60,51,17,23,10,7,0
69580,887,439,448,137,99,91,38,889,505,384,107,97,99,30,0
69581,492,253,239,73,67,77,29,132,77,55,20,9,13,10,0
69582,680,308,372,82,72,71,40,139,68,71,14,26,14,9,0
69583,760,322,438,81,130,57,19,267,141,126,53,27,23,7,0
69584,438,185,253,71,64,52,28,1025,549,476,118,109,88,61,0
69585,457,261,196,55,27,57,34,478,254,224,67,74,56,28,0
69586,388,209,179,46,24,31,28,889,505,384,107,97,99,30,0
69587,301,119,182,53,47,14,20,344,190,154,34,31,36,10,0
69588,808,366,442,130,133,66,31,368,204,164,43,35,30,24,0
69589,346,168,178,36,43,20,9,218,114,104,32,31,33,11,0
69590,482,245,237,69,64,66,24,153,80,73,26,18,19,4,0
69591,242,111,131,35,35,17,13,323,171,152,48,41,40,16,0
69592,193,105,88,33,16,9,4,309,159,150,47,43,43,13,0
69593,732,355,377,108,109,79,27,266,150,116,28,28,24,12,0
69594,1689,821,868,277,250,177,78,478,254,224,67,74,56,28,0
69595,658,349,309,77,70,73,35,417,232,185,58,50,29,21,0
69596,102,22,80,48,8,18,6,415,226,189,51,40,40,29,0
69597,519,245,274,58,61,34,22,278,154,124,42,32,38,7,0
69598,553,319,234,56,37,54,18,758,319,439,101,123,78,25,0
69599,717,281,436,165,81,112,49,376,189,187,47,53,44,26,0
69600,138,35,103,38,2,15,9,274,157,117,40,29,40,8,0
69601,134,60,74,19,13,10,7,405,195,210,57,74,24,17,0
69602,1124,442,682,148,189,72,43,597,300,297,96,89,68,29,0
69603,103,56,47,27,7,8,2,103,50,53,19,10,7,5,0
69604,403,176,227,71,56,51,11,390,223,167,58,36,45,18,0
69605,251,139,112,41,18,27,11,926,340,586,133,119,60,40,0
69606,369,166,203,59,55,41,14,729,358,371,116,99,89,33,0
69607,484,192,292,118,68,83,22,231,126,105,37,26,29,6,0
69608,431,202,229,57,50,50,25,173,90,83,21,36,12,15,0
69609,480,267,213,49,44,70,21,132,61,71,19,20,14,6,0
69610,1276,607,669,192,178,136,63,900,441,459,125,127,110,32,0
69611,249,104,145,47,41,24,17,673,313,360,102,101,46,17,0
69612,785,374,411,56,42,38,25,283,160,123,25,20,37,9,0
69613,301,119,182,53,47,14,20,283,160,123,25,20,37,9,0
69614,146,75,71,13,32,15,11,396,197,199,75,49,49,16,0
69615,1531,649,882,108,122,93,72,594,312,282,72,67,73,31,0
69616,224,101,123,45,32,21,3,152,71,81,41,16,14,2,0
69617,682,260,422,153,78,109,46,1249,638,611,166,153,141,45,0
69618,2799,1324,1475,369,371,215,124,496,251,245,78,62,61,23,0
69619,125,57,68,31,10,10,3,621,273,348,104,102,48,19,0
69620,570,238,332,112,95,39,23,457,253,204,67,51,48,13,0
69621,525,254,271,60,76,46,13,508,262,246,66,67,51,20,0
69622,521,249,272,53,36,50,18,972,471,501,152,138,112,40,0
69623,471,221,250,87,68,42,25,72,32,40,8,2,2,13,0
69624,412,193,219,69,57,43,14,1020,538,482,145,115,111,58,0
69625,594,248,346,104,109,53,5,536,251,285,75,79,60,23,0
69626,1226,513,713,184,147,87,43,180,95,85,22,21,17,8,0
69627,736,353,383,117,83,71,18,173,94,79,18,24,12,7,0
69628,339,170,169,32,17,24,13,68,23,45,12,9,3,9,0
69629,1054,497,557,190,168,107,45,483,215,268,66,70,30,16,0
69630,57,24,33,11,3,5,3,169,85,84,21,14,9,9,0
69631,1042,529,513,161,151,103,52,439,211,228,65,73,26,21,0
69632,341,175,166,48,43,35,18,270,162,108,26,26,16,11,0
69633,524,270,254,84,72,70,23,629,317,312,80,87,51,22,0
69634,282,135,147,27,37,30,19,1061,543,518,146,123,109,67,0
69635,222,108,114,37,20,25,12,778,391,387,94,77,41,33,0
69636,472,222,250,46,61,33,23,518,292,226,60,60,52,21,0
69637,419,210,209,54,44,31,23,348,212,136,53,31,25,18,0
69638,128,69,59,29,9,8,1,904,436,468,143,118,108,32,0
69639,1023,449,574,141,174,76,43,1382,508,874,334,320,98,36,0
69640,493,281,212,56,61,30,13,328,199,129,39,29,27,14,0
69641,900,434,466,134,97,86,36,390,190,200,66,50,43,12,0
69642,435,222,213,67,49,67,12,1378,692,686,194,174,105,56,0
69643,1208,575,633,187,204,117,41,1338,720,618,179,145,141,85,0
69644,380,185,195,68,54,32,16,792,398,394,109,96,90,39,0
69645,949,467,482,126,127,102,51,198,86,112,36,27,23,9,0
69646,126,57,69,31,10,10,3,180,115,65,17,12,9,9,0
69647,800,416,384,102,105,83,22,374,174,200,54,52,42,21,0
69648,395,219,176,47,41,50,18,660,332,328,84,73,47,19,0
69649,184,93,91,26,25,14,11,775,407,368,122,100,97,32,0
69650,211,92,119,33,44,11,7,164,79,85,28,28,16,7,0
69651,349,153,196,54,47,28,13,598,333,265,79,66,54,33,0
69652,301,156,145,32,25,15,5,152,71,81,41,16,14,2,0
69653,233,110,123,34,22,34,9,149,52,97,36,36,7,4,0
69654,1689,821,868,277,250,177,78,102,51,51,12,15,12,3,0
69655,772,417,355,118,92,80,23,380,211,169,47,37,33,21,0
69656,854,435,419,118,91,95,42,370,190,180,60,52,37,13,0
69657,413,236,177,41,25,35,19,374,191,183,40,52,40,16,0
69658,1007,353,654,277,147,70,26,165,90,75,36,18,20,6,0
69659,1001,422,579,185,180,51,32,107,77,30,7,2,9,5,0
69660,533,300,233,74,50,74,17,531,261,270,73,80,68,26,0
69661,384,198,186,58,48,37,12,134,72,62,14,28,8,4,0
69662,2442,1193,1249,278,183,170,145,1062,522,540,151,147,105,66,0
69663,820,333,487,202,152,59,23,508,253,255,73,60,50,13,0
69664,117,57,60,17,14,11,10,374,174,200,54,52,42,21,0
69665,473,217,256,59,44,34,21,188,101,87,20,18,20,14,0
69666,309,137,172,51,50,28,14,147,74,73,28,20,24,4,0
69667,524,262,262,62,72,39,49,783,406,377,102,91,57,29,0
69668,1241,650,591,161,151,106,49,245,111,134,31,44,20,11,0
69669,457,228,229,64,36,52,21,1755,905,850,214,196,183,79,0
69670,519,259,260,86,78,59,22,673,313,360,102,101,46,17,0
69671,532,291,241,83,36,79,25,86,40,46,16,13,9,7,0
69672,331,169,162,40,28,22,14,87,38,49,23,10,10,9,0
69673,1054,453,601,183,183,107,35,501,257,244,75,57,48,29,0
69674,136,66,70,33,11,9,4,498,244,254,81,67,58,19,0
69675,329,171,158,49,41,31,10,892,475,417,130,108,68,38,0
69676,1759,838,921,269,212,191,92,376,183,193,50,50,43,21,0
69677,3230,1724,1506,361,358,157,75,204,80,124,29,51,10,5,0
69678,782,372,410,127,111,89,36,564,264,300,79,84,65,26,0
69679,736,353,383,117,83,71,18,549,273,276,74,68,72,24,0
69680,528,273,255,67,53,29,20,376,183,193,50,50,43,21,0
69681,302,160,142,35,35,37,10,526,266,260,76,75,53,22,0
69682,282,84,198,60,102,1,6,192,91,101,29,28,17,7,0
69683,407,164,243,88,42,40,22,737,397,340,87,104,90,14,0
69684,426,213,213,60,56,46,24,660,303,357,97,89,85,33,0
69685,2442,1193,1249,278,183,170,145,858,398,460,126,138,75,39,0
69686,963,477,486,134,143,123,38,729,358,371,116,99,89,33,0
69687,136,66,70,33,11,9,4,160,60,100,23,40,19,11,0
69688,1148,472,676,229,164,86,37,629,317,312,80,87,51,22,0
69689,501,230,271,63,90,50,18,96,45,51,13,12,6,4,0
69690,366,190,176,39,62,55,14,277,163,114,33,24,21,16,0
69691,391,204,187,47,48,38,18,348,194,154,57,31,43,12,0
69692,1014,488,526,178,137,94,39,583,280,303,95,66,76,25,0
69693,288,142,146,52,32,26,8,374,212,162,48,40,32,23,0
69694,126,56,70,31,10,10,3,405,181,224,71,57,31,12,0
69695,302,160,142,35,35,37,10,715,348,367,109,84,68,30,0
69696,360,175,185,73,36,27,7,364,189,175,58,41,35,17,0
69697,433,188,245,63,45,26,14,396,213,183,68,44,47,18,0
69698,641,349,292,92,60,39,24,260,131,129,42,31,40,9,0
69699,426,231,195,51,52,45,24,334,181,153,41,40,25,15,0
69700,714,260,454,140,97,120,54,410,197,213,67,43,56,18,0
69701,1501,679,822,251,196,174,67,201,93,108,34,39,21,6,0
69702,288,140,148,59,33,27,12,1001,417,584,186,147,96,47,0
69703,456,223,233,77,54,47,20,724,353,371,94,95,71,31,0
69704,351,166,185,48,61,24,15,585,277,308,92,73,61,32,0
69705,465,305,160,40,47,34,9,622,344,278,80,77,68,36,0
69706,1004,498,506,94,59,46,33,584,249,335,80,96,22,13,0
69707,422,196,226,52,35,33,20,508,262,246,66,67,51,20,0
69708,443,226,217,67,34,53,10,89,51,38,15,15,5,4,0
69709,553,276,277,88,61,45,27,312,165,147,41,39,29,16,0
69710,772,383,389,105,76,82,33,277,145,132,41,32,22,10,0
69711,442,254,188,46,22,40,19,397,234,163,44,38,23,21,0
69712,172,82,90,21,35,21,5,389,210,179,51,37,43,9,0
69713,692,305,387,100,97,78,30,509,267,242,79,81,38,20,0
69714,224,108,116,31,32,22,8,292,143,149,38,42,36,16,0
69715,436,201,235,54,37,35,18,605,283,322,94,72,64,39,0
69716,240,167,73,32,12,8,21,858,461,397,125,114,79,45,0
69717,364,172,192,55,57,32,15,317,161,156,40,49,41,11,0
69718,961,465,496,139,156,62,34,1755,905,850,214,196,183,79,0
69719,485,246,239,74,48,47,22,715,348,367,109,84,68,30,0
69720,380,148,232,81,69,24,8,465,252,213,73,58,60,18,0
69721,594,248,346,104,109,53,5,531,277,254,82,75,33,22,0
69722,1054,497,557,190,168,107,45,1395,627,768,172,263,141,59,0
69723,769,329,440,116,66,55,22,632,360,272,75,65,36,19,0
69724,1047,443,604,162,156,78,52,194,106,88,33,10,15,6,0
69725,394,207,187,52,42,37,24,305,163,142,38,27,47,11,0
69726,358,206,152,45,38,67,16,732,366,366,108,86,74,41,0
69727,193,90,103,44,9,19,13,392,214,178,48,40,53,22,0
69728,240,166,74,32,12,8,15,485,244,241,80,55,59,20,0
69729,264,122,142,33,29,13,13,396,213,183,68,44,47,18,0
69730,4640,2231,2409,660,549,437,245,665,361,304,87,91,84,31,0
69731,343,189,154,44,24,39,12,148,69,79,26,18,16,3,0
69732,594,321,273,98,59,57,23,498,244,254,81,67,58,19,0
69733,2663,1073,1590,548,499,192,64,1025,549,476,118,109,88,61,0
69734,500,257,243,60,55,27,22,384,204,180,53,47,49,17,0
69735,800,416,384,102,105,83,22,397,234,163,44,38,23,21,0
69736,335,148,187,52,26,51,12,134,72,62,14,28,8,4,0
69737,250,123,127,40,28,29,8,1040,564,476,134,110,114,51,0
69738,334,155,179,47,34,38,11,349,200,149,41,39,30,20,0
69739,580,240,340,108,81,59,22,189,95,94,25,33,16,8,0
69740,1849,931,918,245,220,158,90,166,78,88,27,25,19,7,0
69741,339,170,169,32,17,24,13,607,293,314,98,71,62,32,0
69742,332,172,160,50,33,35,9,375,209,166,50,37,29,23,0
69743,423,247,176,58,55,29,20,405,214,191,53,42,49,20,0
69744,539,283,256,75,73,53,26,671,321,350,95,87,75,34,0
69745,122,56,66,26,13,11,5,457,242,215,39,46,53,10,0
69746,371,209,162,46,17,36,19,758,319,439,101,123,78,25,0
69747,522,302,220,61,49,75,19,966,478,488,108,144,74,43,0
69748,126,58,68,31,10,10,3,572,305,267,74,72,58,21,0
69749,624,222,402,92,81,39,15,387,193,194,60,53,57,15,0
69750,126,56,70,31,10,10,3,222,119,103,37,32,24,8,0
69751,461,207,254,82,66,55,33,928,440,488,111,157,82,35,0
69752,949,467,482,126,127,102,51,232,111,121,23,29,17,9,0
69753,275,160,115,40,31,34,17,649,307,342,71,134,45,17,0
69754,478,220,258,47,70,41,10,209,119,90,28,24,27,9,0
69755,664,269,395,117,107,36,15,492,278,214,65,58,32,11,0
69756,2663,1073,1590,548,499,192,64,283,142,141,41,33,26,18,0
69757,119,67,52,15,15,7,7,240,141,99,34,28,29,8,0
69758,2136,1063,1073,317,308,223,90,974,457,517,133,117,69,26,0
69759,535,315,220,57,55,71,19,194,106,88,33,10,15,6,0
69760,429,238,191,47,49,56,29,780,337,443,112,116,77,28,0
69761,179,96,83,24,8,26,4,531,277,254,82,75,33,22,0
69762,389,176,213,81,59,24,7,154,78,76,23,21,13,5,0
69763,346,186,160,40,37,34,21,434,213,221,77,62,53,12,0
69764,1087,523,564,146,177,103,33,900,441,459,125,127,110,32,0
69765,805,338,467,153,138,99,55,240,141,99,34,28,29,8,0
69766,1498,731,767,220,175,148,68,137,72,65,27,13,15,8,0
69767,531,259,272,75,81,39,13,187,89,98,36,24,20,6,0
69768,424,170,254,69,56,47,28,363,180,183,60,34,10,6,0
69769,646,304,342,104,93,58,26,172,88,84,24,31,20,12,0
69770,119,67,52,15,15,7,7,761,351,410,117,73,103,45,0
69771,200,103,97,17,16,10,10,169,74,95,33,26,22,3,0
69772,234,108,126,42,40,15,9,545,269,276,80,76,27,32,0
69773,584,340,244,77,60,47,25,504,272,232,75,57,53,19,0
69774,435,222,213,67,49,67,12,87,51,35,15,9,9,4,0
69775,681,367,314,83,74,78,31,389,210,179,51,37,43,9,0
69776,213,104,109,56,14,9,2,975,400,575,160,162,62,31,0
69777,396,150,246,103,64,38,3,354,183,171,54,43,49,8,0
69778,434,221,213,58,47,54,15,1025,549,476,118,109,88,61,0
69779,2136,1063,1073,317,308,223,90,622,344,278,80,77,68,36,0
69780,260,136,124,24,41,19,4,368,183,185,40,42,40,15,0
69781,452,217,235,59,47,60,20,127,58,69,18,17,10,5,0
69782,1970,978,992,245,206,198,80,811,361,450,124,107,80,31,0
69783,142,76,66,21,21,22,11,334,181,153,41,40,25,15,0
69784,717,381,336,118,103,85,29,780,337,443,112,116,77,28,0
69785,622,354,268,89,60,64,18,316,166,150,45,38,37,13,0
69786,160,53,107,31,29,13,3,240,141,99,34,28,29,8,0
69787,648,262,386,113,108,78,29,296,151,145,45,42,32,11,0
69788,243,100,143,58,50,24,5,145,77,68,26,7,15,8,0
69789,577,277,300,71,59,64,24,770,390,380,104,76,78,32,0
69790,313,178,135,43,18,35,6,748,359,389,125,113,86,31,0
69791,1189,653,536,152,118,109,56,329,196,133,41,36,31,15,0
69792,139,64,75,18,17,18,4,336,200,136,34,29,25,24,0
69793,961,465,496,139,156,62,34,142,73,69,27,9,15,11,0
69794,156,64,92,31,19,5,4,664,350,314,86,90,82,36,0
69795,485,237,248,83,35,52,24,363,180,183,60,34,10,6,0
69796,919,493,426,100,92,88,49,584,249,335,80,96,22,13,0
69797,837,443,394,129,89,87,38,415,226,189,51,40,40,29,0
69798,230,114,116,30,33,29,8,89,42,47,16,12,15,6,0
69799,126,58,68,31,10,10,3,301,168,133,49,37,34,11,0
69800,629,338,291,92,57,64,22,390,223,167,58,36,45,18,0
69801,2136,1063,1073,317,308,223,90,142,73,69,27,9,15,11,0
69802,242,104,138,41,33,37,8,200,89,111,26,25,17,7,0
69803,800,328,472,159,159,41,15,177,100,77,22,17,20,11,0
69804,908,324,584,181,162,81,29,169,84,85,29,19,21,7,0
69805,624,222,402,92,81,39,15,583,321,262,73,67,45,25,0
69806,132,66,66,21,18,11,7,180,115,65,17,12,9,9,0
69807,536,237,299,116,87,42,17,166,90,76,27,18,21,5,0
69808,505,282,223,60,57,66,23,314,177,137,34,40,29,9,0
69809,260,120,140,34,39,36,12,133,61,72,21,19,13,4,0
69810,180,92,88,29,20,26,8,953,489,464,126,104,111,44,0
69811,3230,1724,1506,361,358,157,75,422,202,220,80,52,57,18,0
69812,932,575,357,94,69,76,40,72,33,39,8,2,3,12,0
69813,1143,574,569,176,151,123,59,588,286,302,78,99,53,25,0
69814,496,210,286,111,55,74,13,101,59,42,11,17,10,1,0
69815,869,489,380,110,77,79,29,866,478,388,121,101,101,26,0
69816,275,125,150,37,48,27,7,188,101,87,20,18,20,14,0
69817,260,120,140,34,39,36,12,328,195,133,39,40,27,13,0
69818,554,217,337,112,72,90,38,125,66,59,24,16,11,5,0
69819,509,246,263,84,71,56,22,164,79,85,28,28,16,7,0
69820,233,107,126,40,40,20,16,536,251,285,75,79,60,23,0
69821,680,308,372,82,72,71,40,153,80,73,26,18,19,4,0
69822,556,306,250,69,60,80,18,501,249,252,77,70,55,22,0
69823,736,320,416,113,97,61,36,301,168,133,49,37,34,11,0
69824,3703,1708,1995,456,428,305,162,400,187,213,56,59,42,20,0
69825,158,85,73,24,18,18,8,300,148,152,45,43,40,8,0
69826,241,122,119,27,34,17,16,1265,689,576,169,177,128,60,0
69827,665,341,324,109,79,38,22,295,160,135,42,37,46,16,0
69828,575,305,270,74,87,73,25,727,362,365,123,107,63,23,0
69829,1208,575,633,187,204,117,41,370,190,180,60,52,37,13,0
69830,342,185,157,42,27,31,14,98,49,49,14,15,9,2,0
69831,501,230,271,63,90,50,18,180,108,72,22,22,15,5,0
69832,432,190,242,85,82,28,11,103,50,53,19,10,7,5,0
69833,345,208,137,44,27,33,8,188,90,98,44,7,21,7,0
69834,979,534,445,83,77,80,24,504,272,232,75,57,53,19,0
69835,128,67,61,29,9,9,1,445,192,253,86,58,53,18,0
69836,502,236,266,66,66,58,17,605,283,322,94,72,64,39,0
69837,371,143,228,77,48,29,26,516,245,271,82,84,70,26,0
69838,2220,1085,1135,312,304,202,91,892,475,417,130,108,68,38,0
69839,1004,498,506,94,59,46,33,335,170,165,52,36,47,11,0
69840,1199,589,610,189,128,167,65,963,525,438,119,102,102,34,0
69841,577,342,235,63,57,23,37,201,98,103,28,25,19,13,0
69842,1199,589,610,189,128,167,65,194,109,85,23,24,21,9,0
69843,272,141,131,45,29,36,9,605,283,322,94,72,64,39,0
69844,1047,443,604,162,156,78,52,846,425,421,125,97,98,38,0
69845,119,67,52,15,15,7,7,381,187,194,37,49,36,17,0
69846,345,208,137,44,27,33,8,375,176,199,48,61,40,12,0
69847,432,190,242,85,82,28,11,598,333,265,79,66,54,33,0
69848,452,202,250,83,60,56,19,464,236,228,64,56,53,28,0
69849,163,70,93,28,21,17,6,405,195,210,57,74,24,17,0
69850,466,199,267,86,59,32,17,810,310,500,164,162,42,26,0
69851,281,125,156,44,47,17,7,297,164,133,45,39,40,9,0
69852,462,228,234,59,47,37,32,279,161,118,37,32,7,7,0
69853,143,81,62,28,9,8,1,307,132,175,48,53,26,10,0
69854,526,228,298,69,64,32,30,597,269,328,102,84,69,24,0
69855,956,450,506,122,117,82,36,1208,565,643,182,162,120,57,0
69856,126,57,69,31,10,10,3,583,321,262,73,67,45,25,0
69857,362,174,188,46,55,35,23,729,358,371,116,99,89,33,0
69858,588,317,271,78,49,54,17,926,340,586,133,119,60,40,0
69859,313,148,165,45,33,36,11,326,149,177,51,51,28,10,0
69860,86,50,36,9,14,8,7,455,229,226,66,62,63,29,0
69861,433,188,245,63,45,26,14,203,98,105,34,29,19,10,0
69862,677,361,316,81,61,42,22,130,67,63,24,10,12,4,0
69863,179,78,101,29,22,10,8,163,79,84,22,24,13,5,0
69864,341,177,164,57,42,40,18,294,146,148,50,45,51,15,0
69865,496,209,287,113,55,72,14,507,270,237,89,59,57,22,0
69866,588,267,321,99,79,87,28,218,114,104,32,31,33,11,0
69867,763,371,392,104,88,52,23,723,353,370,120,109,96,33,0
69868,1161,514,647,159,138,122,37,538,274,264,84,67,52,35,0
69869,753,395,358,93,72,71,16,336,200,136,34,29,25,24,0
69870,4128,2104,2024,581,505,453,205,160,60,100,23,40,19,11,0
69871,335,183,152,40,26,54,22,508,253,255,73,60,50,13,0
69872,350,190,160,48,25,27,18,597,300,297,96,89,68,29,0
69873,291,120,171,63,39,26,6,547,295,252,81,65,57,23,0
69874,535,315,220,57,55,71,19,2542,1245,1297,285,287,170,84,0
69875,270,130,140,43,24,36,10,375,176,199,48,61,40,12,0
69876,368,201,167,61,38,38,12,390,190,200,66,50,43,12,0
69877,109,50,59,12,12,9,3,300,148,152,45,43,40,8,0
69878,789,362,427,90,82,70,35,469,225,244,64,68,25,11,0
69879,451,278,173,71,35,58,12,288,156,132,36,36,24,15,0
69880,627,237,390,137,57,108,44,929,459,470,140,120,94,45,0
69881,203,97,106,30,22,18,10,337,152,185,49,54,42,21,0
69882,2442,1193,1249,278,183,170,145,166,102,64,19,14,17,2,0
69883,456,223,233,77,54,47,20,137,85,52,15,11,11,2,0
69884,478,177,301,109,66,59,25,583,321,262,73,67,45,25,0
69885,242,111,131,35,35,17,13,137,72,65,27,13,15,8,0
69886,484,192,292,118,68,83,22,368,204,164,43,35,30,24,0
69887,127,55,72,25,18,5,7,322,180,142,45,38,28,7,0
69888,413,169,244,66,94,28,19,222,124,98,37,29,22,9,0
69889,210,84,126,44,43,9,4,225,111,114,32,34,32,16,0
69890,126,57,69,31,10,10,3,124,69,55,14,7,9,4,0
69891,501,230,271,63,90,50,18,403,184,219,75,51,47,20,0
69892,127,55,72,25,18,5,7,274,157,117,40,29,40,8,0
69893,1030,438,592,184,104,108,30,414,203,211,58,56,48,14,0
69894,532,291,241,83,36,79,25,198,110,88,27,27,24,4,0
69895,426,214,212,63,47,53,20,334,181,153,56,31,28,18,0
69896,1560,778,782,224,235,132,78,73,35,38,14,10,9,4,0
69897,571,298,273,81,72,57,25,481,223,258,71,70,49,26,0
69898,473,212,261,72,64,45,28,2517,1275,1242,304,324,245,135,0
69899,253,133,120,44,31,22,8,225,114,111,32,29,26,6,0
69900,524,262,262,62,72,39,49,485,244,241,80,55,59,20,0
69901,805,338,467,153,138,99,55,98,49,49,14,15,9,2,0
69902,451,278,173,71,35,58,12,1698,875,823,222,219,173,64,0
69903,786,378,408,106,98,77,39,229,120,109,31,30,22,9,0
69904,732,355,377,108,109,79,27,325,172,153,44,34,27,14,0
69905,468,233,235,65,61,49,34,975,475,500,139,140,119,28,0
69906,334,190,144,42,42,16,5,1755,905,850,214,196,183,79,0
69907,192,91,101,28,21,18,8,457,253,204,67,51,48,13,0
69908,283,112,171,48,39,34,15,602,310,292,87,66,70,36,0
69909,505,247,258,72,71,60,27,172,79,93,34,27,23,10,0
69910,125,46,79,24,16,12,2,341,170,171,41,66,27,10,0
69911,396,150,246,103,64,38,3,498,244,254,81,67,58,19,0
69912,235,100,135,36,25,30,8,180,95,85,22,21,17,8,0
69913,240,166,74,32,12,8,15,462,251,211,74,53,41,18,0
69914,213,114,99,62,7,2,1,418,246,172,52,39,57,10,0
69915,2236,1195,1041,227,187,186,118,405,181,224,71,57,31,12,0
69916,1336,724,612,209,141,133,60,622,344,278,80,77,68,36,0
69917,437,225,212,61,57,66,12,219,105,114,36,29,19,8,0
69918,539,283,256,75,73,53,26,1922,923,999,267,275,215,90,0
69919,412,203,209,65,47,37,18,242,124,118,39,32,28,22,0
69920,215,104,111,61,7,2,1,900,441,459,125,127,110,32,0
69921,700,305,395,111,99,54,18,775,407,368,122,100,97,32,0
69922,302,160,142,35,35,37,10,953,489,464,126,104,111,44,0
69923,230,114,116,30,33,29,8,778,391,387,94,77,41,33,0
69924,636,288,348,94,77,65,30,966,478,488,108,144,74,43,0
69925,435,230,205,51,37,55,18,453,247,206,58,53,45,20,0
69926,393,223,170,44,36,32,14,165,90,75,36,18,20,6,0
69927,356,199,157,36,43,28,12,727,388,339,102,87,70,29,0
69928,439,183,256,60,64,36,14,821,394,427,122,117,109,38,0
69929,339,170,169,32,17,24,13,180,90,90,31,19,20,8,0
69930,646,304,342,104,93,58,26,264,138,126,33,34,29,12,0
69931,1276,607,669,192,178,136,63,378,154,224,74,84,35,22,0
69932,580,308,272,82,79,58,25,396,213,183,68,44,47,18,0
69933,347,154,193,48,51,25,11,415,189,226,68,54,50,21,0
69934,334,190,144,42,42,16,5,323,162,161,52,41,39,13,0
69935,3859,2011,1848,535,391,422,207,903,436,467,128,116,83,33,0
69936,445,231,214,45,64,53,23,166,88,78,23,18,13,7,0
69937,280,156,124,36,19,20,13,556,290,266,75,74,29,24,0
69938,1220,575,645,208,179,99,56,169,84,85,29,19,21,7,0
69939,285,148,137,31,42,42,16,334,182,152,45,41,27,13,0
69940,270,130,140,43,24,36,10,395,198,197,55,55,36,10,0
69941,561,282,279,68,62,36,14,106,54,52,12,9,7,6,0
69942,264,122,142,33,29,13,13,370,173,197,65,57,42,10,0
69943,310,141,169,36,38,20,8,303,137,166,54,54,31,15,0
69944,234,110,124,39,29,23,2,229,120,109,31,30,22,9,0
69945,376,171,205,45,45,34,12,463,259,204,62,55,34,22,0
69946,211,92,119,33,44,11,7,154,78,76,23,21,13,5,0
69947,784,351,433,118,87,73,41,1214,475,739,177,250,89,49,0
69948,604,239,365,124,63,84,37,935,515,420,126,107,73,32,0
69949,1647,794,853,279,235,128,65,564,264,300,79,84,65,26,0
69950,630,231,399,150,83,84,50,748,359,389,125,113,86,31,0
69951,1835,904,931,192,144,135,63,811,361,450,124,107,80,31,0
69952,1214,498,716,197,180,121,65,278,154,124,42,32,38,7,0
69953,361,177,184,59,51,24,15,1606,753,853,215,227,182,48,0
69954,159,105,54,22,9,14,25,180,108,72,22,22,15,5,0
69955,224,101,123,45,32,21,3,535,301,234,63,48,47,27,0
69956,192,91,101,28,21,18,8,413,223,190,52,45,53,10,0
69957,1112,457,655,180,164,99,39,227,130,97,32,25,22,12,0
69958,381,146,235,74,48,47,34,266,150,116,28,28,24,12,0
69959,291,142,149,50,29,35,7,288,156,132,36,36,24,15,0
69960,373,194,179,42,54,26,13,455,191,264,68,86,21,19,0
69961,2236,1195,1041,227,187,186,118,531,261,270,73,80,68,26,0
69962,886,440,446,116,140,95,45,105,51,54,13,17,12,8,0
69963,347,154,193,48,51,25,11,320,168,152,38,42,24,18,0
69964,158,85,73,24,18,18,8,373,189,184,54,46,50,23,0
69965,402,169,233,70,36,34,18,1698,875,823,222,219,173,64,0
69966,533,300,233,74,50,74,17,496,251,245,78,62,61,23,0
69967,561,282,279,68,62,36,14,250,119,131,58,26,29,7,0
69968,446,283,163,51,26,33,19,1262,653,609,169,165,152,50,0
69969,360,175,185,73,36,27,7,452,252,200,55,49,61,16,0
69970,414,216,198,51,32,42,28,96,45,51,13,12,6,4,0
69971,579,321,258,74,70,47,22,405,195,210,57,74,24,17,0
69972,763,354,409,101,90,63,26,377,184,193,50,43,33,17,0
69973,361,183,178,50,54,51,22,279,142,137,43,39,28,7,0
69974,232,108,124,33,27,19,16,298,129,169,51,40,29,8,0
69975,193,95,98,33,17,25,17,218,111,107,45,29,24,6,0
69976,2220,1085,1135,312,304,202,91,699,334,365,108,80,70,20,0
69977,207,89,118,56,8,4,3,98,49,49,14,15,9,2,0
69978,953,421,532,131,131,70,37,239,113,126,36,49,20,8,0
69979,245,111,134,36,27,18,6,400,187,213,56,59,42,20,0
69980,451,278,173,71,35,58,12,419,233,186,54,53,55,17,0
69981,394,207,187,52,42,37,24,517,295,222,69,62,40,28,0
69982,456,223,233,77,54,47,20,727,388,339,102,87,70,29,0
69983,119,59,60,29,10,6,4,385,188,197,57,42,36,16,0
69984,1004,464,540,143,104,78,55,201,104,97,36,32,24,7,0
69985,161,94,67,23,13,8,10,200,99,101,31,24,26,6,0
69986,505,226,279,68,51,30,15,127,54,73,11,33,15,6,0
69987,2063,1024,1039,175,117,80,97,535,311,224,66,52,49,24,0
69988,126,57,69,31,10,10,3,234,129,105,31,22,19,17,0
69989,1200,602,598,145,116,110,50,452,231,221,74,53,56,20,0
69990,275,125,150,37,48,27,7,124,69,55,14,7,9,4,0
69991,1011,559,452,121,97,132,33,215,115,100,27,19,16,7,0
69992,347,181,166,27,20,12,12,164,79,85,28,28,16,7,0
69993,127,48,79,27,20,6,5,647,324,323,101,80,76,43,0
69994,342,150,192,52,43,31,17,663,360,303,87,82,80,35,0
69995,627,237,390,137,57,108,44,350,196,154,52,37,21,14,0
69996,502,274,228,64,49,75,17,163,79,84,22,24,13,5,0
69997,237,127,110,34,30,16,9,124,69,55,14,7,9,4,0
69998,1054,497,557,190,168,107,45,459,260,199,56,42,47,21,0
69999,526,268,258,54,37,55,12,720,361,359,98,98,70,37,0
70000,484,261,223,59,48,49,24,198,115,83,30,22,8,8,0
70001,553,276,277,88,61,45,27,627,289,338,101,73,62,43,0
70002,332,173,159,48,42,42,9,245,131,114,30,27,18,13,0
70003,109,50,59,12,12,9,3,258,129,129,45,24,31,10,0
70004,746,312,434,129,115,77,47,547,295,252,81,65,57,23,0
70005,385,203,182,47,43,51,21,390,223,167,58,36,45,18,0
70006,649,304,345,99,80,67,40,107,77,30,7,2,9,5,0
70007,258,144,114,33,22,19,9,467,240,227,65,65,51,23,0
70008,1068,434,634,173,160,61,29,199,105,94,27,27,28,9,0
70009,545,221,324,101,72,55,30,455,191,264,68,86,21,19,0
70010,209,75,134,53,48,20,9,390,223,167,58,36,45,18,0
70011,57,24,33,11,3,5,3,661,325,336,81,75,65,28,0
70012,326,148,178,55,42,31,12,2547,1280,1267,331,335,293,118,0
70013,326,176,150,35,22,29,11,621,310,311,100,106,77,27,0
70014,1030,438,592,184,104,108,30,139,68,71,14,26,14,9,0
70015,728,358,370,118,100,55,29,430,212,218,88,43,40,20,0
70016,1257,464,793,221,264,75,37,303,137,166,54,54,31,15,0
70017,677,361,316,81,61,42,22,295,160,135,42,37,46,16,0
70018,447,236,211,56,52,49,14,390,223,167,58,36,45,18,0
70019,270,131,139,47,37,41,11,225,111,114,32,34,32,16,0
70020,425,210,215,56,43,52,25,1127,527,600,147,128,83,58,0
70021,604,239,365,124,63,84,37,661,325,336,81,75,65,28,0
70022,129,70,59,29,9,7,2,410,197,213,67,43,56,18,0
70023,428,248,180,44,39,28,9,188,88,100,53,12,15,6,0
70024,2442,1193,1249,278,183,170,145,741,383,358,92,63,79,36,0
70025,121,69,52,15,18,14,8,403,225,178,56,38,33,25,0
70026,237,127,110,34,30,16,9,514,248,266,86,82,52,22,0
70027,199,113,86,27,17,10,7,98,49,49,14,15,9,2,0
70028,571,298,273,81,72,57,25,389,207,182,53,58,52,18,0
70029,480,267,213,49,44,70,21,386,181,205,55,51,57,31,0
70030,380,148,232,81,69,24,8,335,170,165,52,36,47,11,0
70031,426,231,195,51,52,45,24,245,121,124,37,35,36,12,0
70032,338,172,166,59,30,39,18,98,49,49,14,15,9,2,0
70033,126,66,60,24,10,7,9,215,115,100,27,19,16,7,0
70034,1099,491,608,163,141,107,62,278,154,124,42,32,38,7,0
70035,431,202,229,57,50,50,25,179,101,78,25,15,13,13,0
70036,419,210,209,54,44,31,23,218,114,104,32,31,33,11,0
70037,782,372,410,127,111,89,36,293,142,151,49,40,42,17,0
70038,886,440,446,116,140,95,45,509,267,242,79,81,38,20,0
70039,567,256,311,91,81,53,17,227,130,97,32,25,22,12,0
70040,204,109,95,21,35,27,7,457,253,204,67,51,48,13,0
70041,1023,449,574,141,174,76,43,457,242,215,39,46,53,10,0
70042,1463,521,942,252,204,105,52,201,98,103,28,25,19,13,0
70043,508,136,372,157,91,22,9,222,124,98,37,29,22,9,0
70044,164,77,87,33,19,6,7,94,45,49,11,20,10,4,0
70045,560,279,281,113,64,58,15,1262,653,609,169,165,152,50,0
70046,527,254,273,67,66,70,31,91,42,49,21,9,8,3,0
70047,207,89,118,56,8,4,3,514,248,266,86,82,52,22,0
70048,1647,794,853,279,235,128,65,898,469,429,125,125,134,35,0
70049,380,148,232,81,69,24,8,374,181,193,55,58,48,23,0
70050,425,199,226,54,71,56,11,741,383,358,92,63,79,36,0
70051,319,153,166,61,52,26,12,415,189,226,68,54,50,21,0
70052,539,283,256,75,73,53,26,966,478,488,108,144,74,43,0
70053,667,366,301,96,55,84,25,810,310,500,164,162,42,26,0
70054,531,284,247,66,42,49,15,457,253,204,67,51,48,13,0
70055,546,285,261,71,49,47,24,334,182,152,45,41,27,13,0
70056,961,465,496,139,156,62,34,1700,731,969,198,233,110,87,0
70057,431,202,229,57,50,50,25,582,264,318,84,60,58,23,0
70058,756,265,491,129,127,51,17,673,313,360,102,101,46,17,0
70059,271,110,161,33,27,11,8,1378,692,686,194,174,105,56,0
70060,218,133,85,20,19,13,6,423,234,189,66,44,57,12,0
70061,758,378,380,89,64,37,31,425,177,248,60,62,33,16,0
70062,232,108,124,33,27,19,16,585,277,308,92,73,61,32,0
70063,3703,1708,1995,456,428,305,162,724,353,371,94,95,71,31,0
70064,465,220,245,88,34,61,23,194,106,88,33,10,15,6,0
70065,126,56,70,31,10,10,3,389,207,182,53,58,52,18,0
70066,554,217,337,112,72,90,38,1314,693,621,174,155,140,58,0
70067,2663,1073,1590,548,499,192,64,240,141,99,34,28,29,8,0
70068,350,178,172,49,62,29,16,325,172,153,44,34,27,14,0
70069,362,181,181,67,46,43,8,516,245,271,82,84,70,26,0
70070,707,250,457,171,84,117,61,132,77,55,20,9,13,10,0
70071,125,53,72,18,21,18,12,139,68,71,14,26,14,9,0
70072,317,153,164,34,52,30,14,450,241,209,67,58,54,23,0
70073,436,209,227,66,47,52,22,295,160,135,42,37,46,16,0
70074,325,152,173,43,47,28,17,403,233,170,38,29,21,14,0
70075,571,298,273,81,72,57,25,1047,562,485,141,127,114,41,0
70076,1130,614,516,129,138,98,42,866,397,469,117,153,95,48,0
70077,384,198,186,58,48,37,12,297,164,133,45,39,40,9,0
70078,425,220,205,60,55,45,18,1922,923,999,267,275,215,90,0
70079,242,104,138,41,33,37,8,462,229,233,63,49,42,18,0
70080,341,175,166,48,43,35,18,1507,737,770,188,228,147,71,0
70081,595,316,279,86,60,65,40,627,289,338,101,73,62,43,0
70082,376,249,127,47,23,43,16,430,212,218,88,43,40,20,0
70083,490,224,266,80,70,39,32,737,320,417,112,94,73,34,0
70084,231,105,126,56,10,24,10,198,115,83,30,22,8,8,0
70085,128,69,59,29,9,8,1,715,348,367,109,84,68,30,0
70086,198,80,118,35,31,14,7,163,71,92,22,38,11,7,0
70087,210,84,126,44,43,9,4,373,213,160,44,33,26,17,0
70088,651,357,294,81,67,103,18,344,190,154,34,31,36,10,0
70089,315,174,141,46,38,47,16,160,76,84,19,24,8,5,0
70090,126,56,70,31,10,10,3,250,116,134,41,30,33,19,0
70091,320,183,137,51,18,38,8,374,202,172,50,39,31,24,0
70092,680,308,372,82,72,71,40,778,391,387,94,77,41,33,0
70093,616,304,312,75,71,55,25,1873,935,938,233,225,203,79,0
70094,260,120,140,34,39,36,12,127,64,63,26,8,12,8,0
70095,130,72,58,28,9,7,1,445,264,181,35,35,34,14,0
70096,281,125,156,44,47,17,7,187,89,98,36,24,20,6,0
70097,837,381,456,123,109,65,25,139,68,71,14,26,14,9,0
70098,496,210,286,112,55,71,14,748,359,389,125,113,86,31,0
70099,349,131,218,66,76,22,9,609,335,274,79,57,45,22,0
70100,330,182,148,47,27,40,11,234,116,118,34,35,23,9,0
70101,630,231,399,150,83,84,50,664,350,314,86,90,82,36,0
70102,338,172,166,59,30,39,18,292,155,137,50,34,29,13,0
70103,446,265,181,51,35,27,17,1047,562,485,141,127,114,41,0
70104,1043,479,564,200,131,123,62,572,305,267,74,72,58,21,0
70105,480,257,223,74,26,60,27,462,229,233,63,49,42,18,0
70106,603,311,292,102,71,66,23,105,51,54,13,17,12,8,0
70107,380,187,193,38,51,30,18,549,273,276,74,68,72,24,0
70108,600,324,276,89,73,45,39,548,296,252,71,74,43,28,0
70109,1139,537,602,162,139,109,50,180,108,72,22,22,15,5,0
70110,562,214,348,120,86,69,42,1755,905,850,214,196,183,79,0
70111,1447,698,749,214,180,116,46,378,154,224,74,84,35,22,0
70112,609,292,317,102,96,64,21,296,151,145,45,42,32,11,0
70113,317,140,177,43,26,31,16,1065,581,484,134,97,76,46,0
70114,314,158,156,39,28,30,17,89,38,51,14,6,3,9,0
70115,561,282,279,68,62,36,14,227,130,97,32,25,22,12,0
70116,464,237,227,64,66,33,12,425,177,248,60,62,33,16,0
70117,594,321,273,98,59,57,23,160,60,100,23,40,19,11,0
70118,1555,702,853,250,199,139,31,295,158,137,42,34,38,14,0
70119,1011,559,452,121,97,132,33,1208,565,643,182,162,120,57,0
70120,389,176,213,81,59,24,7,528,276,252,86,78,49,17,0
70121,949,466,483,125,126,101,50,496,285,211,62,54,46,22,0
70122,404,197,207,60,48,47,20,748,359,389,125,113,86,31,0
70123,284,128,156,48,29,34,8,584,249,335,80,96,22,13,0
70124,210,84,126,44,43,9,4,644,343,301,96,69,59,28,0
70125,531,260,271,97,68,47,11,1314,693,621,174,155,140,58,0
70126,221,114,107,65,7,2,1,406,202,204,54,51,63,21,0
70127,381,187,194,37,49,36,17,559,317,242,58,65,37,23,0
70128,350,212,138,32,26,40,13,475,251,224,67,49,48,23,0
70129,125,46,79,24,16,12,2,108,59,49,17,13,12,5,0
70130,598,322,276,67,57,63,26,189,105,84,25,26,21,9,0
70131,2136,1063,1073,317,308,223,90,385,212,173,57,40,39,21,0
70132,399,196,203,62,45,38,19,354,183,171,54,43,49,8,0
70133,722,390,332,125,69,67,25,756,348,408,101,103,60,40,0
70134,136,66,70,33,11,9,5,1425,670,755,153,189,122,85,0
70135,251,131,120,49,35,25,5,188,105,83,25,17,24,7,0
70136,83,45,38,11,8,8,3,462,229,233,63,49,42,18,0
70137,1004,498,506,94,59,46,33,415,203,212,77,44,49,18,0
70138,535,315,220,57,55,71,19,873,411,462,132,107,84,40,0
70139,146,75,71,13,32,15,11,467,231,236,71,65,58,18,0
70140,282,105,177,77,28,39,6,441,189,252,73,50,47,23,0
70141,479,228,251,71,57,60,14,188,93,95,33,18,16,10,0
70142,1014,488,526,178,137,94,39,257,126,131,61,24,22,8,0
70143,192,91,101,28,21,18,8,188,88,100,53,12,15,6,0
70144,454,230,224,63,56,38,33,395,198,197,55,55,36,10,0
70145,315,111,204,82,66,46,11,222,127,95,23,28,22,7,0
70146,144,57,87,38,26,10,4,866,478,388,121,101,101,26,0
70147,330,182,148,47,27,40,11,106,54,52,12,9,7,6,0
70148,862,384,478,127,110,75,42,222,125,97,34,27,27,7,0
70149,429,227,202,49,51,46,26,1154,489,665,200,196,95,54,0
70150,681,367,314,83,74,78,31,103,50,53,19,10,7,5,0
70151,588,300,288,100,57,65,27,277,163,114,33,24,21,16,0
70152,540,252,288,73,67,57,20,322,180,142,45,38,28,7,0
70153,766,336,430,133,97,79,21,323,171,152,48,41,40,16,0
70154,135,64,71,31,11,8,4,453,255,198,62,49,29,19,0
70155,5890,3314,2576,970,956,293,265,389,207,182,53,58,52,18,0
70156,332,172,160,50,33,35,9,89,38,51,14,6,3,9,0
70157,616,304,312,75,71,55,25,91,44,47,9,12,4,7,0
70158,368,154,214,80,52,41,16,395,169,226,73,55,38,9,0
70159,1085,646,439,108,65,36,19,101,59,42,11,17,10,1,0
70160,365,210,155,46,30,24,12,572,305,267,74,72,58,21,0
70161,504,222,282,71,64,53,29,445,192,253,86,58,53,18,0
70162,308,163,145,38,33,30,20,673,313,360,102,101,46,17,0
70163,600,324,276,89,73,45,39,179,101,78,25,15,13,13,0
70164,282,105,177,77,28,39,6,549,273,276,74,68,72,24,0
70165,798,364,434,133,88,74,35,518,292,226,60,60,52,21,0
70166,451,225,226,69,57,64,22,723,363,360,107,106,52,14,0
70167,274,157,117,40,29,40,8,491,183,308,61,92,38,27,0
70168,610,249,361,107,69,72,33,727,362,365,123,107,63,23,0
70169,410,209,201,72,30,48,22,1537,701,836,209,187,129,58,0
70170,554,217,337,112,72,90,38,207,113,94,33,18,30,9,0
70171,446,265,181,51,35,27,17,231,126,105,28,26,34,9,0
70172,380,187,193,38,51,30,18,270,130,140,48,44,37,12,0
70173,249,104,145,47,41,24,17,306,157,149,52,35,39,16,0
70174,83,45,38,11,8,8,3,154,78,76,23,21,13,5,0
70175,753,395,358,93,72,71,16,403,185,218,67,62,63,19,0
70176,545,221,324,101,72,55,30,392,186,206,62,56,29,15,0
70177,505,282,223,60,57,66,23,471,238,233,66,63,62,19,0
70178,513,276,237,73,43,57,24,972,471,501,152,138,112,40,0
70179,415,217,198,50,31,42,17,630,321,309,86,90,57,26,0
70180,543,265,278,52,37,54,19,72,32,40,8,2,2,13,0
70181,249,114,135,47,33,25,4,332,180,152,44,36,27,13,0
70182,336,134,202,51,64,27,12,629,317,312,80,87,51,22,0
70183,127,48,79,27,20,6,5,526,266,260,76,75,53,22,0
70184,129,70,59,29,9,7,2,535,311,224,66,52,49,24,0
70185,149,78,71,20,20,19,5,106,54,52,12,9,7,6,0
70186,928,442,486,139,118,91,43,152,71,81,41,16,14,2,0
70187,755,271,484,113,226,61,20,125,66,59,24,16,11,5,0
70188,734,366,368,121,99,63,39,250,116,134,41,30,33,19,0
70189,221,114,107,65,7,2,1,277,145,132,41,32,22,10,0
70190,786,378,408,106,98,77,39,2038,1059,979,262,237,208,100,0
70191,271,136,135,37,30,18,10,508,261,247,65,53,58,23,0
70192,580,281,299,95,60,74,29,898,469,429,125,125,134,35,0
70193,331,169,162,40,28,22,14,415,205,210,77,52,55,17,0
70194,126,66,60,24,10,7,9,270,130,140,48,44,37,12,0
70195,157,62,95,41,18,10,11,375,211,164,50,36,31,23,0
70196,443,212,231,74,24,60,24,296,140,156,49,40,42,19,0
70197,325,181,144,46,31,48,9,374,212,162,48,40,32,23,0
70198,500,257,243,60,55,27,22,96,46,50,16,12,7,5,0
70199,480,232,248,73,40,44,30,405,195,210,57,74,24,17,0
70200,626,308,318,105,89,77,25,380,211,169,47,37,33,21,0
70201,203,97,106,30,22,18,10,953,489,464,126,104,111,44,0
70202,83,45,38,11,8,8,3,404,190,214,55,55,35,27,0
70203,607,305,302,92,89,74,23,1061,543,518,146,123,109,67,0
70204,3859,2011,1848,535,391,422,207,218,114,104,32,31,33,11,0
70205,531,259,272,75,81,39,13,188,90,98,44,7,21,7,0
70206,1390,585,805,241,230,118,46,406,234,172,63,35,43,10,0
70207,131,69,62,29,9,9,1,555,282,273,82,69,65,21,0
70208,420,189,231,79,67,33,17,72,33,39,8,2,3,12,0
70209,350,172,178,61,45,32,13,279,142,137,43,39,28,7,0
70210,483,236,247,82,60,43,18,594,312,282,72,67,73,31,0
70211,161,75,86,24,20,10,7,430,212,218,88,43,40,20,0
70212,425,199,226,54,71,56,11,1249,638,611,166,153,141,45,0
70213,730,298,432,128,69,86,26,374,174,200,54,52,42,21,0
70214,447,236,211,56,52,49,14,127,58,69,18,17,10,5,0
70215,308,129,179,44,60,19,8,761,351,410,117,73,103,45,0
70216,261,126,135,41,36,24,11,1922,923,999,267,275,215,90,0
70217,485,237,248,83,35,52,24,926,340,586,133,119,60,40,0
70218,447,232,215,55,65,50,25,232,108,124,33,27,19,16,0
70219,333,171,162,50,34,19,8,222,124,98,37,29,22,9,0
70220,643,284,359,129,71,84,43,1241,619,622,183,169,155,59,0
70221,90,54,36,20,4,14,5,975,400,575,160,162,62,31,0
70222,798,364,434,133,88,74,35,953,489,464,126,104,111,44,0
70223,512,254,258,70,48,37,32,898,469,429,125,125,134,35,0
70224,651,357,294,81,67,103,18,455,229,226,66,62,63,29,0
70225,325,181,144,46,31,48,9,396,199,197,54,50,45,14,0
70226,1336,724,612,209,141,133,60,464,236,228,64,56,53,28,0
70227,380,185,195,68,54,32,16,91,44,47,9,12,4,7,0
70228,485,246,239,74,48,47,22,898,469,429,125,125,134,35,0
70229,800,416,384,102,105,83,22,302,150,152,56,40,52,15,0
70230,128,69,59,29,9,8,1,200,89,111,26,25,17,7,0
70231,904,436,468,138,146,82,39,205,94,111,48,31,15,6,0
70232,341,154,187,34,36,11,11,453,255,198,62,49,29,19,0
70233,1689,821,868,277,250,177,78,222,124,98,37,29,22,9,0
70234,371,143,228,77,48,29,26,222,125,97,34,27,27,7,0
70235,1139,537,602,162,139,109,50,172,79,93,34,27,23,10,0
70236,413,169,244,66,94,28,19,508,262,246,66,67,51,20,0
70237,729,351,378,111,98,58,18,274,142,132,33,34,18,14,0
70238,297,182,115,41,22,23,8,463,268,195,59,46,46,21,0
70239,961,465,496,139,156,62,34,286,160,126,37,27,23,10,0
70240,2174,1057,1117,241,241,214,117,173,86,87,30,22,19,12,0
70241,410,209,201,72,30,48,22,329,194,135,45,32,33,9,0
70242,162,73,89,32,19,4,4,467,231,236,71,65,58,18,0
70243,1689,821,868,277,250,177,78,373,213,160,44,33,26,17,0
70244,879,457,422,93,98,143,32,137,85,52,15,11,11,2,0
70245,346,205,141,47,34,30,7,360,180,180,57,48,39,12,0
70246,1342,640,702,187,163,123,57,758,319,439,101,123,78,25,0
70247,800,416,384,102,105,83,22,947,482,465,143,107,89,37,0
70248,463,225,238,76,36,59,26,218,114,104,32,31,33,11,0
70249,378,202,176,34,32,44,13,145,77,68,26,7,15,8,0
70250,1226,513,713,184,147,87,43,427,251,176,51,39,25,22,0
70251,618,289,329,97,86,70,17,660,303,357,97,89,85,33,0
70252,164,77,87,33,19,6,7,250,116,134,41,30,33,19,0
70253,509,262,247,64,70,64,20,1445,704,741,196,178,171,56,0
70254,163,70,93,28,21,17,6,545,269,276,80,76,27,32,0
70255,911,441,470,123,108,60,21,346,178,168,58,41,33,12,0
70256,1098,519,579,182,159,79,42,234,116,118,34,35,23,9,0
70257,580,265,315,97,89,79,17,392,214,178,48,40,53,22,0
70258,458,226,232,77,59,61,14,405,195,210,57,74,24,17,0
70259,346,173,173,50,56,31,14,457,253,204,67,51,48,13,0
70260,138,35,103,38,2,15,9,904,436,468,143,118,108,32,0
70261,484,194,290,70,93,47,16,974,457,517,133,117,69,26,0
70262,553,319,234,56,37,54,18,322,180,142,45,38,28,7,0
70263,528,273,255,67,53,29,20,309,159,150,47,43,43,13,0
70264,381,146,235,74,48,47,34,414,203,211,58,56,48,14,0
70265,127,62,65,13,33,7,6,974,457,517,133,117,69,26,0
70266,813,412,401,114,93,112,26,277,138,139,40,39,20,14,0
70267,366,190,176,39,62,55,14,926,425,501,159,147,77,35,0
70268,1004,498,506,94,59,46,33,1154,489,665,200,196,95,54,0
70269,331,177,154,54,38,27,11,166,78,88,27,25,19,7,0
70270,329,168,161,48,34,41,16,295,160,135,42,37,46,16,0
70271,374,187,187,51,52,40,27,515,276,239,62,59,43,31,0
70272,2279,996,1283,375,328,158,60,406,234,172,63,35,43,10,0
70273,272,141,131,45,29,36,9,1034,495,539,150,134,114,71,0
70274,279,127,152,50,36,28,8,1214,475,739,177,250,89,49,0
70275,184,93,91,26,25,14,11,1034,495,539,150,134,114,71,0
70276,102,22,80,48,8,18,6,627,289,338,101,73,62,43,0
70277,224,108,116,31,32,22,8,189,95,94,25,33,16,8,0
70278,322,164,158,46,44,29,7,200,99,101,31,24,26,6,0
70279,345,203,142,47,35,31,11,274,157,117,40,29,40,8,0
70280,349,131,218,66,76,22,9,337,152,185,49,54,42,21,0
70281,199,107,92,41,15,14,8,1873,935,938,233,225,203,79,0
70282,426,196,230,76,65,54,20,447,212,235,86,55,58,21,0
70283,226,120,106,68,8,2,1,282,134,148,38,45,29,10,0
70284,1417,598,819,223,188,135,58,461,223,238,45,62,18,35,0
70285,773,383,390,108,76,79,30,396,213,183,68,44,47,18,0
70286,493,208,285,75,77,70,40,4646,2328,2318,674,639,475,170,0
70287,126,56,70,31,10,10,3,858,461,397,125,114,79,45,0
70288,475,235,240,77,58,43,22,287,151,136,51,42,36,7,0
70289,328,156,172,44,37,44,15,1248,584,664,184,164,155,67,0
70290,420,189,231,79,67,33,17,508,261,247,65,53,58,23,0
70291,512,254,258,70,48,37,32,166,78,88,27,25,19,7,0
70292,346,186,160,40,37,34,21,403,192,211,102,39,49,15,0
70293,332,170,162,44,38,39,10,978,536,442,132,107,67,32,0
70294,342,185,157,42,27,31,14,169,84,85,29,19,21,7,0
70295,362,181,181,67,46,43,8,1230,644,586,198,125,123,61,0
70296,1030,438,592,184,104,108,30,133,61,72,21,19,13,4,0
70297,330,151,179,68,36,56,9,2517,1275,1242,304,324,245,135,0
70298,450,231,219,77,50,76,16,1323,690,633,132,178,112,61,0
70299,579,321,258,74,70,47,22,480,255,225,67,64,50,22,0
70300,435,187,248,62,51,51,21,106,46,60,29,13,14,5,0
70301,1447,698,749,214,180,116,46,904,436,468,143,118,108,32,0
70302,1276,607,669,192,178,136,63,201,117,83,22,21,19,9,0
70303,665,341,324,109,79,38,22,296,159,137,49,28,38,13,0
70304,505,201,304,116,58,75,31,862,426,436,113,115,84,37,0
70305,795,384,411,133,109,85,38,246,107,139,55,33,27,11,0
70306,1226,513,713,184,147,87,43,374,181,193,55,58,48,23,0
70307,2414,1189,1225,277,178,170,169,536,251,285,75,79,60,23,0
70308,128,70,58,29,9,8,1,277,145,132,41,32,22,10,0
70309,359,204,155,39,36,34,13,360,180,180,57,48,39,12,0
70310,469,221,248,49,60,55,21,478,254,224,67,74,56,28,0
70311,949,467,482,126,127,102,51,258,129,129,45,24,31,10,0
70312,196,107,89,20,31,17,4,332,180,152,46,36,28,14,0
70313,341,175,166,48,43,35,18,699,334,365,108,80,70,20,0
70314,419,210,209,54,44,31,23,175,82,93,33,26,17,5,0
70315,338,173,165,31,42,22,10,303,138,165,47,46,35,18,0
70316,204,103,101,16,32,22,8,134,55,79,22,24,16,6,0
70317,484,261,223,59,48,49,24,180,89,91,28,27,18,7,0
70318,130,72,58,28,9,7,1,766,386,380,101,81,78,31,0
70319,465,305,160,40,47,34,9,415,189,226,68,54,50,21,0
70320,1912,880,1032,331,334,180,84,260,131,129,42,31,40,9,0
70321,166,59,107,36,41,10,4,199,105,94,27,27,28,9,0
70322,368,154,214,80,52,41,16,149,52,97,36,36,7,4,0
70323,123,58,65,22,14,13,3,405,214,191,53,42,49,20,0
70324,772,417,355,118,92,80,23,198,115,83,30,22,8,8,0
70325,3969,1703,2266,619,432,259,144,266,146,120,41,28,31,7,0
70326,1711,865,846,204,176,105,60,439,227,212,60,55,58,8,0
70327,860,349,511,166,166,58,19,131,55,76,28,9,14,12,0
70328,781,367,414,60,67,43,17,501,257,244,75,57,48,29,0
70329,1718,735,983,266,225,130,68,1114,539,575,145,131,94,56,0
70330,55,16,39,24,2,5,2,180,95,85,22,21,17,8,0
70331,221,114,107,65,7,2,1,487,252,235,79,58,55,26,0
70332,431,199,232,59,54,40,17,376,189,187,47,53,44,26,0
70333,960,409,551,166,134,77,44,367,199,168,62,44,34,8,0
70334,161,99,62,15,22,9,7,385,212,173,57,40,39,21,0
70335,203,97,106,30,22,18,10,277,152,125,31,35,22,19,0
70336,206,100,106,34,26,11,7,690,345,345,96,83,73,42,0
70337,963,477,486,134,143,123,38,119,61,58,17,12,10,6,0
70338,339,170,169,32,17,24,13,597,269,328,102,84,69,24,0
70339,420,248,172,64,30,43,17,386,181,205,55,51,57,31,0
70340,154,74,80,18,19,7,2,222,119,103,37,32,24,8,0
70341,126,57,69,31,10,10,3,201,98,103,28,25,19,13,0
70342,431,202,229,57,50,50,25,452,252,200,55,49,61,16,0
70343,71,28,43,15,9,5,2,244,143,101,31,29,26,8,0
70344,388,244,144,46,25,42,16,1314,693,621,174,155,140,58,0
70345,446,195,251,56,53,31,15,234,116,118,34,35,23,9,0
70346,385,179,206,58,56,38,19,561,279,282,85,81,88,24,0
70347,949,466,483,125,126,101,50,729,358,371,116,99,89,33,0
70348,130,71,59,30,9,8,1,453,255,198,62,49,29,19,0
70349,860,349,511,166,166,58,19,515,276,239,62,59,43,31,0
70350,501,230,271,63,90,50,18,579,285,294,78,72,64,32,0
70351,462,233,229,66,49,43,30,620,324,296,81,68,66,31,0
70352,1217,647,570,142,160,129,45,663,354,309,91,84,79,31,0
70353,496,210,286,112,55,72,13,335,186,149,40,28,29,13,0
70354,240,99,141,53,38,29,15,261,148,113,31,28,14,10,0
70355,314,158,156,39,28,30,17,1500,804,696,190,172,144,60,0
70356,166,59,107,36,41,10,4,483,215,268,66,70,30,16,0
70357,327,174,153,42,35,16,12,778,391,387,94,77,41,33,0
70358,500,245,255,66,57,52,27,406,212,194,50,52,24,18,0
70359,157,62,95,41,18,10,11,1352,602,750,166,185,81,70,0
70360,436,209,227,66,47,52,22,1034,495,539,150,134,114,71,0
70361,745,366,379,110,93,79,45,1148,592,556,152,133,133,41,0
70362,420,202,218,67,43,51,15,213,129,84,32,14,21,15,0
70363,372,171,201,47,53,39,18,86,40,46,16,13,9,7,0
70364,261,148,113,23,29,26,21,483,258,225,70,53,54,20,0
70365,193,95,98,33,17,25,17,399,190,209,61,41,39,18,0
70366,431,202,229,57,50,50,25,330,166,164,55,51,36,16,0
70367,417,222,195,53,39,43,10,445,264,181,35,35,34,14,0
70368,394,207,187,52,42,37,24,260,131,129,42,31,40,9,0
70369,520,261,259,74,52,49,22,187,89,98,36,24,20,6,0
70370,253,133,120,44,31,22,8,279,142,137,43,39,28,7,0
70371,527,276,251,64,60,70,20,708,328,380,113,100,82,34,0
70372,1107,601,506,155,138,103,49,218,111,107,45,29,24,6,0
70373,319,153,166,61,52,26,12,338,169,169,53,44,39,21,0
70374,401,183,218,72,73,28,10,188,93,95,33,18,16,10,0
70375,269,124,145,36,24,32,11,415,189,226,68,54,50,21,0
70376,822,416,406,111,97,88,42,974,457,517,133,117,69,26,0
70377,543,265,278,52,37,54,19,218,118,100,33,30,25,11,0
70378,310,141,169,36,38,20,8,300,148,152,45,43,40,8,0
70379,419,210,209,54,44,31,23,492,278,214,65,58,32,11,0
70380,311,154,157,47,29,34,13,261,162,99,24,21,14,10,0
70381,1235,584,651,140,226,82,52,295,156,139,41,40,42,15,0
70382,861,393,468,150,101,69,35,316,166,150,45,38,37,13,0
70383,1041,497,544,180,167,98,34,508,262,246,66,67,51,20,0
70384,467,233,234,83,37,77,22,220,107,113,36,35,28,9,0
70385,207,93,114,20,33,19,10,555,282,273,82,69,65,21,0
70386,253,133,120,44,31,22,8,180,115,65,17,12,9,9,0
70387,301,157,144,31,28,34,9,421,222,199,69,50,60,18,0
70388,692,305,387,100,97,78,30,346,178,168,58,41,33,12,0
70389,941,459,482,167,140,82,38,602,310,292,87,66,70,36,0
70390,1030,567,463,118,106,94,49,89,38,51,14,6,3,9,0
70391,574,269,305,91,63,54,27,402,186,216,64,47,38,20,0
70392,202,113,89,16,27,21,11,225,111,114,32,34,32,16,0
70393,526,268,258,54,37,55,12,72,32,40,8,2,2,13,0
70394,822,416,406,111,97,88,42,293,142,151,49,40,42,17,0
70395,308,129,179,44,60,19,8,455,191,264,68,86,21,19,0
70396,350,178,172,49,62,29,16,234,129,105,31,22,19,17,0
70397,146,73,73,18,24,17,9,337,152,185,49,54,42,21,0
70398,411,202,209,60,67,57,24,452,254,198,72,57,38,18,0
70399,432,233,199,52,28,47,18,483,287,196,71,50,54,17,0
70400,267,146,121,40,24,25,7,201,117,83,22,21,19,9,0
70401,911,445,466,154,121,108,48,196,105,91,40,13,19,10,0
70402,125,46,79,24,16,12,2,166,78,88,27,25,19,7,0
70403,785,374,411,56,42,38,25,289,140,149,33,42,30,15,0
70404,473,217,256,59,44,34,21,727,388,339,102,87,70,29,0
70405,410,209,201,72,30,48,22,374,174,200,54,52,42,21,0
70406,1441,504,937,264,329,69,46,689,343,346,105,102,81,35,0
70407,1462,711,751,219,222,148,65,439,231,208,65,51,55,17,0
70408,284,160,124,37,23,32,11,175,82,93,33,26,17,5,0
70409,341,183,158,36,34,36,15,373,189,184,54,46,50,23,0
70410,364,204,160,65,35,15,13,323,171,152,48,41,40,16,0
70411,132,66,66,21,18,11,7,218,115,103,37,33,33,9,0
70412,301,156,145,32,25,15,5,375,211,164,50,36,31,23,0
70413,859,411,448,118,100,95,49,332,155,177,55,51,44,13,0
70414,447,232,215,55,65,50,25,279,106,173,48,35,41,39,0
70415,251,139,112,41,18,27,11,166,78,88,27,25,19,7,0
70416,458,226,232,77,59,61,14,222,124,98,37,29,22,9,0
70417,736,353,383,117,83,71,18,107,77,30,7,2,9,5,0
70418,371,143,228,77,48,29,26,452,254,198,72,57,38,18,0
70419,435,222,213,67,49,67,12,278,154,124,42,32,38,7,0
70420,517,245,272,92,77,46,24,72,33,39,8,2,3,12,0
70421,717,381,336,118,103,85,29,317,161,156,40,49,41,11,0
70422,436,209,227,66,47,52,22,462,229,233,63,49,42,18,0
70423,559,217,342,105,86,42,16,975,400,575,160,162,62,31,0
70424,130,70,60,30,9,8,1,1378,692,686,194,174,105,56,0
70425,332,170,162,44,38,39,10,266,146,120,41,28,31,7,0
70426,476,254,222,58,33,46,23,690,345,345,96,83,73,42,0
70427,1098,519,579,182,159,79,42,390,190,200,66,50,43,12,0
70428,234,108,126,42,40,15,9,127,64,63,26,8,12,8,0
70429,452,202,250,83,60,56,19,312,165,147,41,39,29,16,0
70430,246,111,135,64,47,27,3,204,96,108,31,37,20,5,0
70431,2062,706,1356,414,368,158,63,425,177,248,60,62,33,16,0
70432,688,310,378,130,82,78,47,299,140,159,49,44,26,11,0
70433,588,317,271,78,49,54,17,545,269,276,80,76,27,32,0
70434,203,97,106,30,22,18,10,633,311,322,94,82,45,20,0
70435,471,221,250,87,68,42,25,180,89,91,28,27,18,7,0
70436,316,157,159,45,38,22,19,194,109,85,23,24,21,9,0
70437,837,443,394,129,89,87,38,756,348,408,101,103,60,40,0
70438,384,198,186,58,48,37,12,215,115,100,27,19,16,7,0
70439,747,469,278,60,41,53,23,928,440,488,111,157,82,35,0
70440,240,166,74,32,12,8,15,295,160,135,44,36,46,16,0
70441,385,179,206,58,56,38,19,862,409,453,149,125,86,29,0
70442,123,58,65,22,14,13,3,287,151,136,51,42,36,7,0
70443,593,282,311,75,70,29,25,222,127,95,23,28,22,7,0
70444,484,261,223,59,48,49,24,452,254,198,72,57,38,18,0
70445,1054,497,557,190,168,107,45,389,210,179,51,37,43,9,0
70446,257,148,109,28,20,21,14,708,328,380,113,100,82,34,0
70447,2649,1431,1218,377,299,266,102,1395,627,768,172,263,141,59,0
70448,240,167,73,32,12,8,21,147,74,73,28,20,24,4,0
70449,331,165,166,52,34,48,22,91,44,47,9,12,4,7,0
70450,859,411,448,118,100,95,49,536,222,314,101,100,34,22,0
70451,1085,646,439,108,65,36,19,142,65,77,30,17,22,9,0
70452,335,148,187,52,26,51,12,164,79,85,28,28,16,7,0
70453,435,230,205,51,37,55,18,673,313,360,102,101,46,17,0
70454,172,82,90,21,35,21,5,660,332,328,84,73,47,19,0
70455,510,269,241,66,67,71,26,180,115,65,17,12,9,9,0
70456,376,176,200,31,53,27,8,536,267,269,60,70,41,22,0
70457,793,355,438,134,117,77,43,297,164,133,45,39,40,9,0
70458,210,84,126,44,43,9,4,142,65,77,30,17,22,9,0
70459,291,142,149,50,29,35,7,598,333,265,79,66,54,33,0
70460,559,217,342,105,86,42,16,194,109,85,23,24,21,9,0
70461,199,107,92,41,15,14,8,2517,1275,1242,304,324,245,135,0
70462,496,209,287,112,55,71,14,305,161,144,39,40,44,17,0
70463,476,276,200,57,34,43,16,207,86,121,34,39,11,13,0
70464,361,167,194,55,35,41,11,758,319,439,101,123,78,25,0
70465,304,149,155,46,32,39,14,535,311,224,66,52,49,24,0
70466,743,366,377,41,37,26,14,403,221,182,62,50,42,12,0
70467,333,171,162,41,44,48,23,1004,457,547,150,150,74,52,0
70468,346,173,173,50,56,31,14,463,259,204,62,55,34,22,0
70469,586,309,277,81,64,76,25,605,283,322,94,72,64,39,0
70470,2488,1085,1403,346,253,162,76,283,142,141,41,33,26,18,0
70471,238,158,80,28,15,31,7,1279,669,610,164,162,104,55,0
70472,143,81,62,28,9,8,1,594,312,282,72,67,73,31,0
70473,260,138,122,44,30,28,6,547,295,252,81,65,57,23,0
70474,803,358,445,135,117,80,43,597,300,297,96,89,68,29,0
70475,575,290,285,67,70,28,9,336,200,136,34,29,25,24,0
70476,360,175,185,73,36,27,7,171,94,77,24,28,30,11,0
70477,393,185,208,59,50,36,22,212,120,92,29,27,24,10,0
70478,1051,429,622,179,148,125,54,452,252,200,55,49,61,16,0
70479,410,188,222,53,52,31,14,729,358,371,116,99,89,33,0
70480,1030,438,592,184,104,108,30,241,127,114,34,33,29,12,0
70481,338,139,199,54,54,18,11,302,150,152,56,40,52,15,0
70482,309,137,172,51,50,28,14,175,82,93,33,26,17,5,0
70483,332,173,159,48,42,42,9,391,189,202,55,56,56,12,0
70484,297,161,136,36,35,24,9,149,77,72,37,10,20,5,0
70485,126,56,70,31,10,10,3,194,106,88,33,10,15,6,0
70486,733,438,295,95,79,67,32,548,296,252,71,74,43,28,0
70487,837,443,394,129,89,87,38,307,132,175,48,53,26,10,0
70488,126,58,68,31,10,10,3,671,321,350,95,87,75,34,0
70489,339,118,221,77,68,33,13,609,335,274,79,57,45,22,0
70490,496,274,222,57,43,75,22,565,237,328,75,88,32,11,0
70491,837,443,394,129,89,87,38,617,314,303,96,68,68,37,0
70492,560,279,281,113,64,58,15,660,332,328,84,73,47,19,0
70493,1052,492,560,184,163,103,44,597,300,297,96,89,68,29,0
70494,554,217,337,112,72,90,38,231,126,105,37,26,29,6,0
70495,282,135,147,27,37,30,19,283,142,141,41,33,26,18,0
70496,654,344,310,80,69,57,15,89,51,38,15,15,5,4,0
70497,364,168,196,64,61,27,6,308,146,162,42,39,24,12,0
70498,376,171,205,45,45,34,12,2038,1059,979,262,237,208,100,0
70499,734,339,395,135,89,78,36,421,222,199,69,50,60,18,0
70500,556,306,250,69,60,80,18,481,223,258,71,70,49,26,0
70501,376,171,205,45,45,34,12,588,286,302,78,99,53,25,0
70502,813,412,401,114,93,112,26,148,84,64,30,7,17,4,0
70503,1171,542,629,170,146,114,64,264,138,126,33,34,29,12,0
70504,401,204,197,49,33,29,17,481,223,258,71,70,49,26,0
70505,507,314,193,49,45,59,25,103,44,59,16,17,9,5,0
70506,270,166,104,30,26,28,14,373,213,160,44,33,26,17,0
70507,1171,542,629,170,146,114,64,229,120,109,31,30,22,9,0
70508,503,260,243,46,56,33,16,154,78,76,23,21,13,5,0
70509,1499,864,635,141,99,76,110,1922,923,999,267,275,215,90,0
70510,900,434,466,134,97,86,36,160,60,100,23,40,19,11,0
70511,178,74,104,31,28,9,4,166,102,64,19,14,17,2,0
70512,733,382,351,126,92,93,27,519,287,232,68,58,45,21,0
70513,338,139,199,54,54,18,11,230,113,117,31,40,28,10,0
70514,158,85,73,24,18,18,8,225,129,96,32,33,20,8,0
70515,526,268,258,54,37,55,12,483,258,225,70,53,54,20,0
70516,130,71,59,30,9,8,1,335,186,149,40,28,29,13,0
70517,613,303,310,70,28,28,18,124,69,55,14,7,9,4,0
70518,500,297,203,66,33,53,15,336,200,136,34,29,25,24,0
70519,155,85,70,17,16,4,8,292,155,137,50,34,29,13,0
70520,1594,660,934,251,272,117,77,673,313,360,102,101,46,17,0
70521,366,190,176,39,62,55,14,391,189,202,55,56,56,12,0
70522,126,56,70,31,10,10,3,295,160,135,44,36,46,16,0
70523,1023,449,574,141,174,76,43,207,86,121,34,39,11,13,0
70524,362,174,188,46,55,35,23,172,79,93,34,27,23,10,0
70525,329,168,161,48,34,41,16,1873,935,938,233,225,203,79,0
70526,178,89,89,40,12,18,7,220,107,113,36,35,28,9,0
70527,616,323,293,98,71,31,15,415,226,189,51,40,40,29,0
70528,331,169,162,40,28,22,14,309,159,150,47,43,43,13,0
70529,1341,481,860,275,264,57,21,222,119,103,37,32,24,8,0
70530,305,124,181,27,25,32,21,1182,591,591,155,139,83,46,0
70531,887,439,448,137,99,91,38,403,184,219,75,51,47,20,0
70532,369,166,203,59,55,41,14,732,366,366,108,86,74,41,0
70533,301,157,144,31,28,34,9,346,196,150,43,26,27,14,0
70534,142,60,82,20,28,13,5,222,125,97,34,27,27,7,0
70535,204,93,111,35,35,16,11,295,158,137,42,34,38,14,0
70536,610,249,361,107,69,72,33,250,116,134,41,30,33,19,0
70537,128,70,58,29,9,8,1,425,177,248,60,62,33,16,0
70538,126,57,69,31,10,10,3,91,42,49,21,9,8,3,0
70539,667,366,301,96,55,84,25,91,42,49,21,9,8,3,0
70540,469,253,216,49,51,48,18,904,436,468,143,118,108,32,0
70541,271,110,161,33,27,11,8,153,80,73,26,18,19,4,0
70542,315,111,204,82,66,46,11,1101,626,475,145,122,120,50,0
70543,301,119,182,53,47,14,20,312,165,147,41,39,29,16,0
70544,301,119,182,53,47,14,20,1114,539,575,145,131,94,56,0
70545,531,260,271,97,68,47,11,531,277,254,82,75,33,22,0
70546,288,142,146,52,32,26,8,2038,1059,979,262,237,208,100,0
70547,349,131,218,66,76,22,9,633,311,322,94,82,45,20,0
70548,900,434,466,134,97,86,36,380,178,202,69,53,37,10,0
70549,2446,1099,1347,363,294,233,100,611,314,297,79,75,78,22,0
70550,76,42,34,12,8,5,7,165,87,78,24,19,22,9,0
70551,795,384,411,133,109,85,38,421,222,199,69,50,60,18,0
70552,941,459,482,167,140,82,38,160,76,84,19,24,8,5,0
70553,707,250,457,171,84,117,61,134,72,62,14,28,8,4,0
70554,181,92,89,34,22,17,9,704,355,349,113,94,71,24,0
70555,344,109,235,100,39,26,5,332,180,152,46,36,28,14,0
70556,852,461,391,109,102,72,24,671,306,365,114,76,49,19,0
70557,150,60,90,27,16,6,3,276,149,127,34,31,32,10,0
70558,219,98,121,43,19,11,7,240,166,74,32,12,8,15,0
70559,837,381,456,123,109,65,25,487,252,235,79,58,55,26,0
70560,299,151,148,35,34,26,16,332,180,152,46,36,28,14,0
70561,579,321,258,74,70,47,22,405,181,224,71,57,31,12,0
70562,428,248,180,44,39,28,9,377,184,193,50,43,33,17,0
70563,282,160,122,36,28,27,7,1166,514,652,150,159,107,70,0
70564,269,127,142,43,24,34,26,452,254,198,72,57,38,18,0
70565,509,246,263,84,71,56,22,1214,475,739,177,250,89,49,0
70566,1835,904,931,192,144,135,63,229,120,109,31,30,22,9,0
70567,361,177,184,59,51,24,15,194,94,100,33,28,14,7,0
70568,234,108,126,42,40,15,9,234,116,118,34,35,23,9,0
70569,330,182,148,47,27,40,11,792,398,394,109,96,90,39,0
70570,1004,498,506,94,59,46,33,101,59,42,11,17,10,1,0
70571,532,291,241,83,36,79,25,704,355,349,113,94,71,24,0
70572,753,361,392,99,94,66,16,381,187,194,37,49,36,17,0
70573,164,81,83,37,8,14,10,406,223,183,61,53,46,17,0
70574,1096,563,533,158,136,120,53,710,375,335,95,94,110,28,0
70575,224,101,123,45,32,21,3,225,129,96,32,33,20,8,0
70576,1186,495,691,182,208,88,32,925,439,486,141,134,105,46,0
70577,641,349,292,92,60,39,24,2346,1231,1115,316,292,266,105,0
70578,51,10,41,25,0,5,8,180,90,90,31,19,20,8,0
70579,431,216,215,46,40,33,9,392,186,206,62,56,29,15,0
70580,380,148,232,81,69,24,8,260,133,127,43,32,39,3,0
70581,136,66,70,33,11,9,4,103,59,44,25,2,13,6,0
70582,462,258,204,59,41,56,15,821,394,427,122,117,109,38,0
70583,532,254,278,91,48,23,17,198,86,112,36,27,23,9,0
70584,490,224,266,80,70,39,32,751,394,357,107,96,73,35,0
70585,1339,494,845,216,298,92,37,1537,701,836,209,187,129,58,0
70586,1009,478,531,166,126,96,42,279,142,137,43,39,28,7,0
70587,340,145,195,46,38,26,23,649,307,342,71,134,45,17,0
70588,136,65,71,33,11,9,6,1543,794,749,182,152,132,55,0
70589,220,113,107,37,24,16,7,331,180,151,46,35,47,17,0
70590,204,109,95,21,35,27,7,843,391,452,139,104,91,35,0
70591,250,123,127,40,28,29,8,737,397,340,87,104,90,14,0
70592,360,205,155,35,24,52,14,393,210,183,58,37,34,20,0
70593,255,126,129,41,37,13,5,341,170,171,41,66,27,10,0
70594,259,119,140,48,28,29,19,1062,522,540,151,147,105,66,0
70595,358,212,146,51,36,33,9,98,49,49,14,15,9,2,0
70596,420,248,172,64,30,43,17,328,195,133,39,40,27,13,0
70597,416,222,194,58,38,38,20,689,343,346,105,102,81,35,0
70598,681,367,314,83,74,78,31,289,140,149,33,42,30,15,0
70599,685,393,292,75,66,113,16,391,189,202,55,56,56,12,0
70600,465,240,225,50,54,24,14,199,105,94,27,27,28,9,0
70601,119,67,52,15,15,7,7,1378,692,686,194,174,105,56,0
70602,527,276,251,64,60,70,20,329,194,135,45,32,33,9,0
70603,320,163,157,44,44,26,15,375,211,164,50,36,31,23,0
70604,484,192,292,118,68,83,22,277,152,125,31,35,22,19,0
70605,1464,693,771,153,136,91,86,346,196,150,43,26,27,14,0
70606,238,91,147,68,19,22,7,1382,508,874,334,320,98,36,0
70607,126,57,69,31,10,10,3,378,154,224,74,84,35,22,0
70608,209,75,134,53,48,20,9,329,194,135,45,32,33,9,0
70609,479,227,252,69,48,46,18,501,240,261,80,62,49,42,0
70610,338,172,166,59,30,39,18,447,212,235,86,55,58,21,0
70611,126,56,70,31,10,10,3,201,99,102,34,26,23,6,0
70612,1647,794,853,279,235,128,65,858,398,460,126,138,75,39,0
70613,517,196,321,103,98,33,12,188,101,87,20,18,20,14,0
70614,1054,497,557,190,168,107,45,497,257,240,71,63,62,16,0
70615,260,136,124,24,41,19,4,308,146,162,42,39,24,12,0
70616,474,243,231,66,54,41,29,326,169,157,51,41,41,12,0
70617,498,274,224,58,59,50,18,173,90,83,21,36,12,15,0
70618,753,395,358,93,72,71,16,359,171,188,49,74,45,11,0
70619,429,238,191,47,49,56,29,72,32,40,8,2,1,14,0
70620,1120,436,684,208,120,101,115,526,266,260,76,75,53,22,0
70621,130,70,60,30,9,8,1,811,361,450,124,107,80,31,0
70622,126,56,70,31,10,10,3,418,246,172,52,39,57,10,0
70623,180,92,88,29,20,26,8,207,86,121,34,39,11,13,0
70624,421,237,184,47,54,45,10,1001,417,584,186,147,96,47,0
70625,388,244,144,46,25,42,16,307,132,175,48,53,26,10,0
70626,781,367,414,60,67,43,17,207,114,93,33,20,31,13,0
70627,456,223,233,77,54,47,20,106,46,60,29,13,14,5,0
70628,1139,537,602,162,139,109,50,323,162,161,52,41,39,13,0
70629,484,264,220,59,62,68,15,2346,1231,1115,316,292,266,105,0
70630,682,260,422,153,78,109,46,593,289,304,85,69,48,19,0
70631,800,416,384,102,105,83,22,350,196,154,52,37,21,14,0
70632,1214,498,716,197,180,121,65,364,189,175,58,41,35,17,0
70633,2220,1085,1135,312,304,202,91,541,279,262,79,82,31,32,0
70634,828,355,473,126,134,77,37,2542,1245,1297,285,287,170,84,0
70635,346,186,160,40,37,34,21,232,111,121,23,29,17,9,0
70636,1498,731,767,220,175,148,68,462,229,233,63,49,42,18,0
70637,350,212,138,32,26,40,13,620,324,296,81,68,66,31,0
70638,911,445,466,154,121,108,48,1382,508,874,334,320,98,36,0
70639,425,198,227,57,69,59,13,346,196,150,43,26,27,14,0
70640,207,128,79,26,17,19,9,418,223,195,53,43,49,15,0
70641,496,210,286,112,55,71,14,492,278,214,65,58,32,11,0
70642,802,375,427,133,103,81,41,317,161,156,40,49,41,11,0
70643,358,206,152,45,38,67,16,810,310,500,164,162,42,26,0
70644,498,274,224,58,59,50,18,240,141,99,34,28,29,8,0
70645,446,283,163,51,26,33,19,889,505,384,107,97,99,30,0
70646,2799,1324,1475,369,371,215,124,556,290,266,75,74,29,24,0
70647,407,230,177,44,39,34,19,289,140,149,33,42,30,15,0
70648,225,111,114,38,22,25,10,792,398,394,109,96,90,39,0
70649,640,279,361,102,83,69,21,1113,480,633,170,173,81,34,0
70650,545,221,324,101,72,55,30,104,46,58,15,17,9,5,0
70651,504,222,282,71,64,53,29,320,168,152,38,42,24,18,0
70652,452,217,235,59,47,60,20,866,397,469,117,153,95,48,0
70653,161,75,86,24,20,10,7,274,142,132,33,34,18,14,0
70654,130,71,59,30,9,8,1,323,162,161,52,41,39,13,0
70655,887,439,448,137,99,91,38,132,77,55,20,9,13,10,0
70656,1342,640,702,187,163,123,57,492,278,214,65,58,32,11,0
70657,346,209,137,46,37,44,10,102,51,51,12,15,12,3,0
70658,717,281,436,165,81,112,49,561,279,282,85,81,88,24,0
70659,898,397,501,102,98,54,37,160,76,84,19,24,8,5,0
70660,546,265,281,101,64,38,16,445,192,253,86,58,53,18,0
70661,261,130,131,27,41,19,16,455,229,226,66,62,63,29,0
70662,318,164,154,52,43,34,10,360,180,180,57,48,39,12,0
70663,1171,542,629,170,146,114,64,398,200,198,68,43,51,14,0
70664,184,93,91,26,25,14,11,1154,489,665,200,196,95,54,0
70665,808,366,442,130,133,66,31,390,223,167,58,36,45,18,0
70666,489,253,236,73,36,62,17,299,140,159,49,44,26,11,0
70667,734,339,395,135,89,78,36,330,166,164,55,51,36,16,0
70668,636,288,348,94,77,65,30,597,269,328,102,84,69,24,0
70669,653,379,274,89,56,86,13,647,324,323,101,80,76,43,0
70670,257,148,109,28,20,21,14,2724,1157,1567,269,518,239,77,0
70671,119,59,60,29,10,6,4,173,86,87,30,22,19,12,0
70672,406,207,199,56,46,68,19,200,89,111,26,25,17,7,0
70673,743,366,377,41,37,26,14,166,102,64,19,14,17,2,0
70674,2663,1073,1590,548,499,192,64,329,194,135,45,32,33,9,0
70675,376,171,205,45,45,34,12,134,72,62,14,28,8,4,0
70676,422,196,226,52,35,33,20,257,139,118,64,17,24,7,0
70677,794,322,472,122,108,79,34,1061,543,518,146,123,109,67,0
70678,391,204,187,47,48,38,18,381,187,194,37,49,36,17,0
70679,1711,865,846,204,176,105,60,309,164,145,35,47,30,11,0
70680,366,190,176,39,62,55,14,701,380,321,94,84,96,34,0
70681,399,196,203,62,45,38,19,234,116,118,34,35,23,9,0
70682,734,366,368,121,99,63,39,464,236,228,64,56,53,28,0
70683,1718,735,983,266,225,130,68,561,279,282,85,81,88,24,0
70684,486,243,243,65,48,63,22,187,89,98,36,24,20,6,0
70685,575,295,280,89,68,54,18,68,23,45,12,9,3,9,0
70686,476,199,277,82,80,49,24,325,172,153,44,34,27,14,0
70687,1499,864,635,141,99,76,110,132,67,65,24,21,8,10,0
70688,462,233,229,66,49,43,30,106,54,52,12,9,7,6,0
70689,494,242,252,67,47,25,21,180,108,72,22,22,15,5,0
70690,1171,542,629,170,146,114,64,457,253,204,67,51,48,13,0
70691,496,210,286,111,55,74,13,519,287,232,68,58,45,21,0
70692,179,78,101,29,22,10,8,89,38,51,14,6,3,9,0
70693,290,156,134,44,29,39,9,408,221,187,55,51,57,14,0
70694,613,303,310,70,28,28,18,309,159,150,47,43,43,13,0
70695,346,208,138,46,39,51,18,89,38,51,14,6,3,9,0
70696,126,56,70,31,10,10,3,261,127,134,36,27,36,4,0
70697,622,354,268,89,60,64,18,594,312,282,72,67,73,31,0
70698,305,124,181,27,25,32,21,149,52,97,36,36,7,4,0
70699,181,75,106,35,26,11,9,351,166,185,48,61,24,15,0
70700,585,277,308,92,73,61,32,277,163,114,33,24,21,16,0
70701,977,462,515,185,119,76,12,644,343,301,96,69,59,28,0
70702,284,160,124,37,23,32,11,375,209,166,50,37,29,23,0
70703,479,227,252,69,48,46,18,535,311,224,66,52,49,24,0
70704,5890,3314,2576,970,956,293,265,403,192,211,102,39,49,15,0
70705,240,99,141,53,38,29,15,295,156,139,41,40,42,15,0
70706,505,201,304,116,58,75,31,1182,591,591,155,139,83,46,0
70707,431,216,215,46,40,33,9,953,489,464,126,104,111,44,0
70708,411,202,209,60,67,57,24,129,60,69,21,15,8,5,0
70709,640,279,361,102,83,69,21,316,166,150,45,38,37,13,0
70710,219,100,119,40,29,21,3,761,351,410,117,73,103,45,0
70711,529,290,239,54,63,85,15,179,101,78,25,15,13,13,0
70712,543,265,278,52,37,54,19,390,190,200,66,50,43,12,0
70713,648,262,386,113,108,78,29,239,113,126,36,49,20,8,0
70714,618,289,329,97,86,70,17,724,353,371,94,95,71,31,0
70715,579,281,298,91,78,74,27,778,391,387,94,77,41,33,0
70716,249,114,135,47,33,25,4,305,163,142,38,27,47,11,0
70717,316,157,159,45,38,22,19,277,152,125,31,35,22,19,0
70718,492,253,239,73,67,77,29,926,340,586,133,119,60,40,0
70719,333,171,162,50,34,19,8,293,142,151,49,40,42,17,0
70720,486,243,243,65,48,63,22,470,205,265,71,80,33,11,0
70721,908,324,584,181,162,81,29,332,180,152,44,36,27,13,0
70722,760,322,438,81,130,57,19,277,144,133,42,30,41,8,0
70723,681,367,314,83,74,78,31,866,397,469,117,153,95,48,0
70724,1085,646,439,108,65,36,19,334,181,153,56,31,28,18,0
70725,653,379,274,89,56,86,13,1425,670,755,153,189,122,85,0
70726,421,237,184,47,54,45,10,609,335,274,79,57,45,22,0
70727,1189,653,536,152,118,109,56,375,210,165,49,37,29,27,0
70728,271,110,161,33,27,11,8,609,335,274,79,57,45,22,0
70729,257,132,125,39,27,26,10,328,195,133,39,40,27,13,0
70730,734,366,368,121,99,63,39,213,129,84,32,14,21,15,0
70731,273,126,147,54,49,25,18,198,115,83,30,22,8,8,0
70732,453,238,215,59,28,61,26,117,65,52,15,16,10,4,0
70733,425,198,227,57,69,59,13,2542,1245,1297,285,287,170,84,0
70734,462,233,229,66,49,43,30,111,60,51,17,23,10,7,0
70735,425,198,227,57,69,59,13,322,180,142,45,38,28,7,0
70736,301,150,151,45,47,33,13,127,64,63,26,8,12,8,0
70737,758,378,380,89,64,37,31,196,105,91,40,13,19,10,0
70738,616,323,293,98,71,31,15,292,155,137,50,34,29,13,0
70739,219,116,103,66,7,2,1,296,151,145,45,42,32,11,0
70740,126,58,68,31,10,10,3,1020,538,482,145,115,111,58,0
70741,510,288,222,44,36,24,7,518,292,226,60,60,52,21,0
70742,240,167,73,32,12,8,21,501,274,227,63,58,53,20,0
70743,338,173,165,31,42,22,10,744,385,359,105,96,57,31,0
70744,224,108,116,33,26,32,10,91,42,49,21,9,8,3,0
70745,388,209,179,46,24,31,28,332,180,152,44,36,27,13,0
70746,461,257,204,63,49,50,29,665,361,304,87,91,84,31,0
70747,115,62,53,13,10,9,7,359,171,188,49,74,45,11,0
70748,752,313,439,121,106,68,27,156,90,66,17,22,11,10,0
70749,407,207,200,53,36,38,8,218,118,100,33,30,25,11,0
70750,224,108,116,33,26,32,10,278,154,124,42,32,38,7,0
70751,121,69,52,15,18,14,8,773,389,384,119,91,79,26,0
70752,126,56,70,31,10,10,3,305,163,142,38,27,47,11,0
70753,316,157,159,45,38,22,19,904,436,468,143,118,108,32,0
70754,432,233,199,52,28,47,18,175,82,93,33,26,17,5,0
70755,595,339,256,64,36,54,24,821,394,427,122,117,109,38,0
70756,165,66,99,28,32,16,3,601,278,323,124,87,65,21,0
70757,380,187,193,38,51,30,18,152,71,81,41,16,14,2,0
70758,1221,597,624,201,152,83,31,732,366,366,108,86,74,41,0
70759,179,78,101,29,22,10,8,54,26,28,11,4,3,3,0
70760,280,128,152,39,37,38,18,661,325,336,81,75,65,28,0
70761,467,233,234,83,37,77,22,180,90,90,31,19,20,8,0
70762,550,304,246,60,64,77,16,843,391,452,139,104,91,35,0
70763,1121,458,663,158,210,76,47,397,223,174,50,39,29,17,0
70764,949,467,482,126,127,102,51,1025,549,476,118,109,88,61,0
70765,169,64,105,23,37,11,3,873,411,462,132,107,84,40,0
70766,588,267,321,99,79,87,28,693,360,333,100,88,62,26,0
70767,126,57,69,31,10,10,3,524,300,223,70,54,51,25,0
70768,339,118,221,77,68,33,13,1395,627,768,172,263,141,59,0
70769,2063,1024,1039,175,117,80,97,660,333,327,102,95,69,31,0
70770,505,282,223,60,57,66,23,749,384,365,108,105,86,31,0
70771,71,39,32,7,11,6,4,103,59,44,25,2,13,6,0
70772,552,295,257,67,49,70,30,377,184,193,50,43,33,17,0
70773,587,318,269,76,50,38,21,538,274,264,84,67,52,35,0
70774,837,443,394,129,89,87,38,172,79,93,34,27,23,10,0
70775,2279,996,1283,375,328,158,60,354,183,171,54,43,49,8,0
70776,135,64,71,31,11,8,4,199,105,94,27,27,28,9,0
70777,527,254,273,67,66,70,31,1700,731,969,198,233,110,87,0
70778,325,177,148,40,24,23,13,373,189,184,54,46,50,23,0
70779,476,254,222,58,33,46,23,132,77,55,20,9,13,10,0
70780,252,121,131,42,34,12,16,314,177,137,34,40,29,9,0
70781,126,56,70,31,10,10,3,1249,638,611,166,153,141,45,0
70782,230,114,116,30,33,29,8,375,209,166,50,37,29,23,0
70783,331,169,162,40,28,22,14,2517,1275,1242,304,324,245,135,0
70784,496,210,286,111,55,74,13,148,84,64,30,7,17,4,0
70785,228,82,146,45,37,18,8,96,45,51,13,12,6,4,0
70786,302,160,142,35,35,37,10,194,109,85,23,24,21,9,0
70787,301,119,182,53,47,14,20,403,192,211,102,39,49,15,0
70788,146,75,71,13,32,15,11,218,115,103,37,33,33,9,0
70789,150,64,86,22,12,29,12,1352,602,750,166,185,81,70,0
70790,629,374,255,74,53,87,27,549,273,276,74,68,72,24,0
70791,1560,778,782,224,235,132,78,230,113,117,31,40,28,10,0
70792,1867,973,894,256,222,194,65,241,127,114,34,33,29,12,0
70793,746,312,434,129,115,77,47,172,88,84,24,31,20,12,0
70794,1199,589,610,189,128,167,65,201,117,83,22,21,19,9,0
70795,556,279,277,83,69,71,19,128,68,60,18,15,17,4,0
70796,103,56,47,27,7,8,2,362,156,206,74,42,36,22,0
70797,653,379,274,89,56,86,13,332,180,152,44,36,27,13,0
70798,1718,735,983,266,225,130,68,172,88,84,24,31,20,12,0
70799,1336,724,612,209,141,133,60,1352,602,750,166,185,81,70,0
70800,90,54,36,20,4,14,5,508,253,255,73,60,50,13,0
70801,1007,353,654,277,147,70,26,127,66,61,13,14,19,8,0
70802,1200,602,598,145,116,110,50,194,94,100,33,28,14,7,0
70803,747,360,387,125,92,69,32,501,240,261,80,62,49,42,0
70804,567,266,301,139,46,76,37,588,286,302,78,99,53,25,0
70805,550,304,246,60,64,77,16,203,98,105,34,29,19,10,0
70806,784,353,431,56,47,26,18,303,138,165,47,46,35,18,0
70807,496,210,286,112,55,72,13,348,212,136,53,31,25,18,0
70808,586,298,288,80,75,64,37,277,152,125,31,35,22,19,0
70809,2488,1085,1403,346,253,162,76,519,287,232,68,58,45,21,0
70810,411,202,209,60,67,57,24,106,46,60,27,18,12,3,0
70811,743,377,366,87,74,68,30,978,536,442,132,107,67,32,0
70812,381,146,235,74,48,47,34,317,161,156,50,36,47,12,0
70813,213,114,99,62,7,2,1,758,319,439,101,123,78,25,0
70814,1004,498,506,94,59,46,33,629,317,312,80,87,51,22,0
70815,854,435,419,118,91,95,42,557,281,276,80,59,43,21,0
70816,588,317,271,78,49,54,17,535,311,224,66,52,49,24,0
70817,781,316,465,130,129,65,23,283,160,123,25,20,37,9,0
70818,411,236,175,39,45,50,30,270,130,140,48,44,37,12,0
70819,157,62,95,41,18,10,11,108,59,49,17,13,12,5,0
70820,320,183,137,51,18,38,8,282,134,148,38,45,29,10,0
70821,264,122,142,33,29,13,13,201,117,83,22,21,19,9,0
70822,246,123,123,40,31,27,7,192,110,82,33,21,10,3,0
70823,1759,838,921,269,212,191,92,947,482,465,143,107,89,37,0
70824,128,70,58,29,9,8,1,222,125,97,34,27,27,7,0
70825,626,300,326,91,82,68,26,627,323,304,81,90,53,27,0
70826,349,167,182,54,38,30,28,935,515,420,126,107,73,32,0
70827,682,292,390,89,69,58,20,68,23,45,12,9,3,9,0
70828,1174,594,580,175,155,126,66,445,264,181,35,35,34,14,0
70829,1043,479,564,200,131,123,62,247,128,119,34,14,16,14,0
70830,390,199,191,72,42,35,12,344,190,154,34,31,36,10,0
70831,126,56,70,31,10,10,3,166,78,88,27,25,19,7,0
70832,374,187,187,51,52,40,27,106,46,60,29,13,14,5,0
70833,127,54,73,31,10,11,3,332,173,159,48,40,31,11,0
70834,276,149,127,45,34,39,9,188,88,100,53,12,15,6,0
70835,571,298,273,81,72,57,25,437,224,213,40,29,42,25,0
70836,340,181,159,44,39,35,21,548,296,252,71,74,43,28,0
70837,1043,479,564,200,131,123,62,276,149,127,34,31,32,10,0
70838,1365,590,775,257,168,136,93,2225,1244,981,271,243,217,93,0
70839,626,308,318,105,89,77,25,319,185,134,42,31,22,13,0
70840,798,287,511,126,125,77,26,1352,602,750,166,185,81,70,0
70841,507,314,193,49,45,59,25,452,252,200,55,49,61,16,0
70842,1030,438,592,184,104,108,30,461,223,238,45,62,18,35,0
70843,273,126,147,54,49,25,18,898,469,429,125,125,134,35,0
70844,550,304,246,60,64,77,16,165,87,78,24,19,22,9,0
70845,1054,453,601,183,183,107,35,172,88,84,24,31,20,12,0
70846,346,173,173,50,56,31,14,2542,1245,1297,285,287,170,84,0
70847,941,459,482,167,140,82,38,2335,1200,1135,374,268,340,83,0
70848,805,338,467,153,138,99,55,403,185,218,67,62,63,19,0
70849,323,156,167,52,45,39,18,173,86,87,30,22,19,12,0
70850,1208,575,633,187,204,117,41,627,323,304,81,90,53,27,0
70851,425,198,227,57,69,59,13,501,257,244,75,57,48,29,0
70852,146,73,73,18,24,17,9,213,129,84,32,14,21,15,0
70853,258,126,132,38,22,29,8,929,459,470,140,120,94,45,0
70854,1616,735,881,285,248,153,72,536,222,314,101,100,34,22,0
70855,395,195,200,41,55,23,10,445,192,253,86,58,53,18,0
70856,258,126,132,38,22,29,8,724,353,371,94,95,71,31,0
70857,181,75,106,35,26,11,9,963,525,438,119,102,102,34,0
70858,1365,590,775,257,168,136,93,295,156,139,41,40,42,15,0
70859,2236,1195,1041,227,187,186,118,270,162,108,26,26,16,11,0
70860,911,489,422,121,98,97,36,1500,804,696,190,172,144,60,0
70861,1105,544,561,165,167,99,40,207,114,93,33,20,31,13,0
70862,1047,443,604,162,156,78,52,518,292,226,60,60,52,21,0
70863,264,122,142,33,29,13,13,866,478,388,121,101,101,26,0
70864,739,323,416,127,89,76,33,449,252,197,61,52,36,18,0
70865,136,66,70,33,11,9,3,323,168,155,51,41,38,12,0
70866,574,284,290,64,50,65,20,439,227,212,60,55,58,8,0
70867,335,155,180,64,48,36,10,391,189,202,55,56,56,12,0
70868,228,82,146,45,37,18,8,425,177,248,60,62,33,16,0
70869,953,421,532,131,131,70,37,2724,1157,1567,269,518,239,77,0
70870,1041,497,544,180,167,98,34,166,90,76,27,18,21,5,0
70871,233,107,126,40,40,20,16,180,90,90,31,19,20,8,0
70872,1120,436,684,208,120,101,115,222,119,103,37,32,24,8,0
70873,520,240,280,67,72,42,14,391,165,226,67,64,36,27,0
70874,949,466,483,125,126,101,50,207,113,94,33,18,30,9,0
70875,309,137,172,51,50,28,14,514,262,252,78,58,54,26,0
70876,420,248,172,64,30,43,17,299,140,159,49,44,26,11,0
70877,431,199,232,59,54,40,17,245,121,124,37,35,36,12,0
70878,167,70,97,32,20,15,7,732,402,330,81,86,87,33,0
70879,462,228,234,59,47,37,32,430,212,218,88,43,40,20,0
70880,873,366,507,127,125,75,21,531,277,254,82,75,33,22,0
70881,567,266,301,139,46,76,37,873,411,462,132,107,84,40,0
70882,1174,594,580,175,155,126,66,123,61,62,17,18,17,7,0
70883,301,156,145,32,25,15,5,627,289,338,101,73,62,43,0
70884,781,367,414,60,67,43,17,592,249,343,91,90,50,42,0
70885,346,168,178,36,43,20,9,410,197,213,67,43,56,18,0
70886,130,70,60,30,9,8,1,363,180,183,60,34,10,6,0
70887,344,168,176,50,39,30,20,457,245,212,62,58,57,21,0
70888,639,368,271,72,51,38,38,538,274,264,84,67,52,35,0
70889,1214,498,716,197,180,121,65,165,90,75,36,18,20,6,0
70890,136,65,71,33,11,9,6,119,61,58,17,12,10,6,0
70891,820,333,487,202,152,59,23,225,129,96,32,33,20,8,0
70892,282,105,177,77,28,39,6,277,124,153,44,40,35,18,0
70893,428,226,202,52,60,75,20,189,105,84,25,26,21,9,0
70894,204,109,95,21,35,27,7,218,114,104,32,31,33,11,0
70895,244,104,140,52,31,30,14,147,74,73,28,20,24,4,0
70896,643,284,359,129,71,84,43,274,142,132,33,34,18,14,0
70897,587,318,269,76,50,38,21,286,160,126,37,27,23,10,0
70898,224,108,116,33,26,32,10,1606,753,853,215,227,182,48,0
70899,434,221,213,58,47,54,15,127,66,61,13,14,19,8,0
70900,233,110,123,34,22,34,9,928,440,488,111,157,82,35,0
70901,233,107,126,40,40,20,16,376,189,187,47,53,44,26,0
70902,203,80,123,40,37,20,3,766,386,380,101,81,78,31,0
70903,207,89,118,56,8,4,3,415,205,210,77,52,55,17,0
70904,330,141,189,65,29,51,19,582,264,318,84,60,58,23,0
70905,127,54,73,31,10,11,3,429,187,242,79,72,28,19,0
70906,196,107,89,20,31,17,4,966,478,488,108,144,74,43,0
70907,220,113,107,37,24,16,7,487,252,235,79,58,55,26,0
70908,270,128,142,36,43,15,11,139,68,71,14,26,14,9,0
70909,1163,417,746,209,145,87,28,309,164,145,35,47,30,11,0
70910,1417,598,819,223,188,135,58,302,150,152,56,40,52,15,0
70911,554,217,337,112,72,90,38,598,333,265,79,66,54,33,0
70912,895,388,507,130,84,90,31,654,295,359,99,88,71,25,0
70913,1594,660,934,251,272,117,77,609,335,274,79,57,45,22,0
70914,508,136,372,157,91,22,9,406,223,183,61,53,46,17,0
70915,763,354,409,101,90,63,26,1101,626,475,145,122,120,50,0
70916,432,190,242,85,82,28,11,1004,457,547,150,150,74,52,0
70917,364,172,192,55,57,32,15,1001,417,584,186,147,96,47,0
70918,221,114,107,65,7,2,1,104,46,58,15,17,9,5,0
70919,435,230,205,51,37,55,18,464,236,228,64,56,53,28,0
70920,489,253,236,73,36,62,17,862,409,453,149,125,86,29,0
70921,461,257,204,63,49,50,29,276,149,127,34,31,32,10,0
70922,211,92,119,33,44,11,7,892,475,417,130,108,68,38,0
70923,583,279,304,99,71,59,31,201,117,83,22,21,19,9,0
70924,554,217,337,112,72,90,38,132,61,71,22,21,15,3,0
70925,272,136,136,32,34,12,12,377,184,193,50,43,33,17,0
70926,474,243,231,66,54,41,29,279,142,137,43,39,28,7,0
70927,130,71,59,30,9,8,2,132,67,65,24,21,8,10,0
70928,493,281,212,56,61,30,13,192,91,101,29,28,17,7,0
70929,431,202,229,57,50,50,25,935,515,420,126,107,73,32,0
70930,126,66,60,24,10,7,9,201,93,108,34,39,21,6,0
70931,879,457,422,93,98,143,32,403,221,182,62,50,42,12,0
70932,1284,511,773,227,166,169,107,461,223,238,45,62,18,35,0
70933,1556,718,838,280,182,161,49,242,124,118,39,32,28,22,0
70934,540,252,288,73,67,57,20,902,499,403,118,117,92,35,0
70935,685,393,292,75,66,113,16,277,152,125,31,35,22,19,0
70936,181,75,106,35,26,11,9,173,90,83,30,19,19,11,0
70937,474,243,231,66,54,41,29,485,244,241,80,55,59,20,0
70938,360,175,185,73,36,27,7,339,175,164,51,49,37,9,0
70939,118,51,67,25,13,6,7,285,146,139,41,41,48,13,0
70940,373,194,179,42,54,26,13,1922,923,999,267,275,215,90,0
70941,540,252,288,73,67,57,20,935,515,420,126,107,73,32,0
70942,446,174,272,84,61,57,23,317,153,164,34,52,30,14,0
70943,164,81,83,37,8,14,10,156,90,66,17,22,11,10,0
70944,557,240,317,97,74,68,37,691,241,450,151,139,24,20,0
70945,161,99,62,15,22,9,7,286,160,126,37,27,23,10,0
70946,413,169,244,66,94,28,19,108,59,49,17,13,12,5,0
70947,557,211,346,129,125,48,19,132,67,65,24,21,8,10,0
70948,598,322,276,67,57,63,26,2542,1245,1297,285,287,170,84,0
70949,798,287,511,126,125,77,26,199,92,107,34,30,18,9,0
70950,548,250,298,85,64,56,21,201,117,83,22,21,19,9,0
70951,127,62,65,13,33,7,6,536,267,269,60,70,41,22,0
70952,607,294,313,94,95,62,14,364,192,172,49,36,39,14,0
70953,714,260,454,140,97,120,54,483,287,196,71,50,54,17,0
70954,476,254,222,58,33,46,23,633,311,322,94,82,45,20,0
70955,502,236,266,66,66,58,17,410,197,213,67,43,56,18,0
70956,196,107,89,20,31,17,4,374,191,183,40,52,40,16,0
70957,1139,537,602,162,139,109,50,660,303,357,97,89,85,33,0
70958,1447,698,749,214,180,116,46,465,252,213,73,58,60,18,0
70959,282,160,122,36,28,27,7,230,125,105,29,40,20,6,0
70960,4128,2104,2024,581,505,453,205,1114,539,575,145,131,94,56,0
70961,361,177,184,59,51,24,15,723,353,370,120,109,96,33,0
70962,579,321,258,74,70,47,22,399,190,209,61,41,39,18,0
70963,270,131,139,47,37,41,11,326,149,177,51,51,28,10,0
70964,813,412,401,114,93,112,26,545,269,276,80,76,27,32,0
70965,500,257,243,60,55,27,22,415,189,226,68,54,50,21,0
70966,682,292,390,89,69,58,20,72,33,39,8,2,3,12,0
70967,456,223,233,77,54,47,20,1062,522,540,151,147,105,66,0
70968,350,172,178,61,45,32,13,1507,737,770,188,228,147,71,0
70969,805,338,467,153,138,99,55,424,179,245,65,67,29,11,0
70970,493,208,285,75,77,70,40,139,68,71,14,26,14,9,0
70971,364,204,160,65,35,15,13,132,61,71,22,21,15,3,0
70972,480,267,213,49,44,70,21,89,38,51,14,6,3,9,0
70973,808,366,442,130,133,66,31,261,148,113,31,28,14,10,0
70974,456,223,233,77,54,47,20,145,77,68,26,7,15,8,0
70975,170,82,88,32,23,22,8,1755,905,850,214,196,183,79,0
70976,219,116,103,66,7,2,1,245,121,124,37,35,36,12,0
70977,533,297,236,74,57,39,28,303,138,165,47,46,35,18,0
70978,536,287,249,64,73,21,27,1922,923,999,267,275,215,90,0
70979,125,46,79,24,16,12,2,903,436,467,128,116,83,33,0
70980,376,176,200,31,53,27,8,524,300,223,70,54,51,25,0
70981,1439,713,726,195,180,110,34,535,301,234,63,48,47,27,0
70982,2286,1154,1132,338,314,278,103,96,45,51,13,12,6,4,0
70983,115,62,53,13,10,9,7,124,69,55,14,7,9,4,0
70984,5890,3314,2576,970,956,293,265,368,200,168,54,49,43,9,0
70985,265,165,100,32,19,27,5,296,140,156,49,40,42,19,0
70986,271,110,161,33,27,11,8,267,141,126,53,27,23,7,0
70987,220,113,107,37,24,16,7,665,361,304,87,91,84,31,0
70988,165,66,99,28,32,16,3,396,223,173,57,37,44,19,0
70989,546,278,268,94,60,32,22,1001,417,584,186,147,96,47,0
70990,626,300,326,91,82,68,26,978,536,442,132,107,67,32,0
70991,852,472,380,99,79,70,27,309,164,145,35,47,30,11,0
70992,953,421,532,131,131,70,37,277,163,114,33,24,21,16,0
70993,368,154,214,80,52,41,16,309,164,145,35,47,30,11,0
70994,665,341,324,109,79,38,22,166,102,64,19,14,17,2,0
70995,258,144,114,33,22,19,9,381,187,194,37,49,36,17,0
70996,643,284,359,129,71,84,43,972,471,501,152,138,112,40,0
70997,682,292,390,89,69,58,20,414,203,211,58,56,48,14,0
70998,220,121,99,28,26,17,6,1230,644,586,198,125,123,61,0
70999,717,381,336,118,103,85,29,103,59,44,25,2,13,6,0
71000,396,150,246,103,64,38,3,299,140,159,49,44,26,11,0
71001,301,157,144,31,28,34,9,72,32,40,8,2,1,14,0
71002,949,466,483,125,126,101,50,335,186,149,40,28,29,13,0
71003,426,214,212,63,47,53,20,68,23,45,12,9,3,9,0
71004,1130,614,516,129,138,98,42,276,149,127,34,31,32,10,0
71005,283,112,171,48,39,34,15,346,196,150,43,26,27,14,0
71006,440,267,173,52,29,42,12,105,51,54,13,17,12,8,0
71007,1226,513,713,184,147,87,43,375,211,164,50,36,31,23,0
71008,625,283,342,93,89,67,25,218,117,101,35,32,34,12,0
71009,313,134,179,58,37,43,19,437,221,216,62,64,47,13,0
71010,126,57,69,31,10,10,3,2517,1275,1242,304,324,245,135,0
71011,485,183,302,79,81,73,33,169,85,84,21,14,9,9,0
71012,410,208,202,59,58,43,26,1020,538,482,145,115,111,58,0
71013,704,342,362,113,91,85,33,89,42,47,16,12,15,6,0
71014,346,205,141,47,34,30,7,449,252,197,61,52,36,18,0
71015,1505,680,825,202,204,73,32,264,138,126,33,34,29,12,0
71016,128,69,59,29,9,8,1,145,77,68,26,7,15,8,0
71017,795,384,411,133,109,85,38,724,353,371,94,95,71,31,0
71018,314,175,139,29,48,35,10,119,57,62,18,16,17,4,0
71019,361,177,184,59,51,24,15,124,69,55,14,7,9,4,0
71020,456,214,242,76,62,52,22,763,418,345,113,84,59,32,0
71021,583,279,304,99,71,59,31,756,348,408,101,103,60,40,0
71022,414,195,219,51,60,40,17,129,60,69,21,15,8,5,0
71023,109,50,59,12,12,9,3,415,205,210,77,52,55,17,0
71024,240,167,73,32,12,8,21,402,186,216,64,47,38,20,0
71025,349,167,182,54,38,30,28,218,115,103,32,32,34,11,0
71026,319,153,166,61,52,26,12,858,461,397,125,114,79,45,0
71027,461,207,254,82,66,55,33,229,120,109,31,30,22,9,0
71028,505,282,223,60,57,66,23,385,188,197,57,42,36,16,0
71029,403,176,227,71,56,51,11,622,344,278,80,77,68,36,0
71030,359,204,155,39,36,34,13,594,312,282,72,67,73,31,0
71031,619,289,330,67,77,36,19,524,300,223,70,54,51,25,0
71032,594,321,273,98,59,57,23,1382,508,874,334,320,98,36,0
71033,747,360,387,125,92,69,32,507,270,237,89,59,57,22,0
71034,496,272,224,70,58,42,18,509,267,242,79,81,38,20,0
71035,522,251,271,87,68,60,21,2335,1200,1135,374,268,340,83,0
71036,381,187,194,37,49,36,17,715,345,370,110,97,64,25,0
71037,577,342,235,63,57,23,37,102,51,51,12,15,12,3,0
71038,310,141,169,36,38,20,8,439,227,212,60,55,58,8,0
71039,361,167,194,55,35,41,11,169,85,84,21,14,9,9,0
71040,260,138,122,44,30,28,6,751,394,357,107,96,73,35,0
71041,732,355,377,108,109,79,27,360,185,175,51,43,36,16,0
71042,1214,498,716,197,180,121,65,627,289,338,101,73,62,43,0
71043,704,342,362,113,91,85,33,207,113,94,33,18,30,9,0
71044,828,355,473,126,134,77,37,375,209,166,50,37,29,23,0
71045,357,182,175,49,36,39,15,283,142,141,41,33,26,18,0
71046,161,99,62,15,22,9,7,198,110,88,27,27,24,4,0
71047,1849,931,918,245,220,158,90,457,242,215,39,46,53,10,0
71048,269,156,113,37,32,17,7,331,180,151,46,35,47,17,0
71049,488,237,251,79,78,65,27,270,162,108,26,26,16,11,0
71050,502,236,266,66,66,58,17,413,223,190,52,45,53,10,0
71051,346,191,155,52,38,40,13,142,73,69,27,9,15,11,0
71052,1112,457,655,180,164,99,39,166,78,88,27,25,19,7,0
71053,210,84,126,44,43,9,4,843,391,452,139,104,91,35,0
71054,374,202,172,58,40,41,7,701,380,321,94,84,96,34,0
71055,126,57,69,31,10,10,3,225,111,114,32,34,32,16,0
71056,919,493,426,100,92,88,49,708,328,380,113,100,82,34,0
71057,385,203,182,47,43,51,21,295,158,137,42,34,38,14,0
71058,392,221,171,53,30,25,8,530,287,243,79,70,33,26,0
71059,278,110,168,58,49,29,5,903,436,467,128,116,83,33,0
71060,522,302,220,61,49,75,19,761,351,410,117,73,103,45,0
71061,784,351,433,118,87,73,41,305,163,142,38,27,47,11,0
71062,299,128,171,57,40,13,25,485,244,241,80,55,59,20,0
71063,2220,1085,1135,312,304,202,91,267,141,126,53,27,23,7,0
71064,567,256,311,91,81,53,17,72,32,40,8,2,2,13,0
71065,398,186,212,76,70,18,13,557,281,276,80,59,43,21,0
71066,3703,1708,1995,456,428,305,162,549,273,276,74,68,72,24,0
71067,1257,464,793,221,264,75,37,390,223,167,58,36,45,18,0
71068,303,147,156,49,49,20,8,549,273,276,74,68,72,24,0
71069,512,254,258,70,48,37,32,445,264,181,35,35,34,14,0
71070,314,178,136,42,32,30,17,524,300,223,70,54,51,25,0
71071,532,291,241,83,36,79,25,231,126,105,37,26,29,6,0
71072,346,209,137,46,37,44,10,352,207,145,40,33,25,21,0
71073,326,154,172,45,39,20,10,866,478,388,121,101,101,26,0
71074,3703,1708,1995,456,428,305,162,396,199,197,54,50,45,14,0
71075,349,131,218,66,76,22,9,1382,508,874,334,320,98,36,0
71076,331,169,162,40,28,22,14,399,190,209,61,41,39,18,0
71077,1058,497,561,194,142,87,63,332,180,152,46,36,28,14,0
71078,378,202,176,34,32,44,13,701,380,321,94,84,96,34,0
71079,526,228,298,69,64,32,30,598,333,265,79,66,54,33,0
71080,388,244,144,46,25,42,16,105,51,54,13,17,12,8,0
71081,508,136,372,157,91,22,9,380,211,169,47,37,33,21,0
71082,271,110,161,33,27,11,8,1873,935,938,233,225,203,79,0
71083,492,253,239,73,67,77,29,374,181,193,55,58,48,23,0
71084,526,268,258,54,37,55,12,727,362,365,123,107,63,23,0
71085,244,104,140,52,31,30,14,926,340,586,133,119,60,40,0
71086,475,235,240,77,58,43,22,386,181,205,55,51,57,31,0
71087,439,241,198,67,40,40,13,215,115,100,27,19,16,7,0
71088,380,187,193,38,51,30,18,180,89,91,28,27,18,7,0
71089,315,174,141,46,38,47,16,207,86,121,34,39,11,13,0
71090,221,114,107,65,7,2,1,898,469,429,125,125,134,35,0
71091,443,206,237,76,68,52,28,594,312,282,72,67,73,31,0
71092,338,172,166,59,30,39,18,220,107,113,36,35,28,9,0
71093,822,416,406,111,97,88,42,508,261,247,65,53,58,23,0
71094,595,316,279,86,60,65,40,557,281,276,80,59,43,21,0
71095,616,323,293,98,71,31,15,621,310,311,100,106,77,27,0
71096,240,166,74,32,12,8,15,565,237,328,75,88,32,11,0
71097,283,112,171,48,39,34,15,654,295,359,99,88,71,25,0
71098,213,106,107,28,28,22,9,1283,596,687,171,184,67,35,0
71099,332,170,162,44,38,39,10,457,242,215,39,46,53,10,0
71100,399,220,179,48,37,68,18,201,98,103,28,25,19,13,0
71101,1163,417,746,209,145,87,28,723,363,360,107,106,52,14,0
71102,346,208,138,46,39,51,18,429,187,242,79,72,28,19,0
71103,800,416,384,102,105,83,22,963,525,438,119,102,102,34,0
71104,282,163,119,40,23,25,17,889,505,384,107,97,99,30,0
71105,238,91,147,68,19,22,7,963,455,508,127,130,115,48,0
71106,313,158,155,43,35,43,16,627,323,304,81,90,53,27,0
71107,756,265,491,129,127,51,17,601,279,322,81,65,27,12,0
71108,267,146,121,40,24,25,7,198,110,88,27,27,24,4,0
71109,535,217,318,87,106,41,14,261,162,99,24,21,14,10,0
71110,911,489,422,121,98,97,36,234,129,105,31,22,19,17,0
71111,773,383,390,108,76,79,30,134,72,62,14,28,8,4,0
71112,571,298,273,81,72,57,25,283,142,141,41,33,26,18,0
71113,1007,353,654,277,147,70,26,445,202,243,70,73,51,15,0
71114,317,167,150,45,21,30,26,368,200,168,54,49,43,9,0
71115,282,135,147,27,37,30,19,531,277,254,82,75,33,22,0
71116,755,271,484,113,226,61,20,900,441,459,125,127,110,32,0
71117,364,204,160,65,35,15,13,144,67,77,28,14,9,8,0
71118,2663,1073,1590,548,499,192,64,858,398,460,126,138,75,39,0
71119,1009,487,522,177,121,103,51,349,200,149,41,39,30,20,0
71120,128,67,61,29,9,9,1,414,203,211,58,56,48,14,0
71121,895,388,507,130,84,90,31,258,129,129,45,24,31,10,0
71122,475,235,240,77,58,43,22,367,199,168,62,44,34,8,0
71123,753,395,358,93,72,71,16,142,65,77,30,17,22,9,0
71124,234,108,126,42,40,15,9,1279,669,610,164,162,104,55,0
71125,346,209,137,46,37,44,10,123,61,62,17,18,17,7,0
71126,454,214,240,56,71,35,16,862,409,453,149,125,86,29,0
71127,347,154,193,48,51,25,11,187,89,98,36,24,20,6,0
71128,329,171,158,49,41,31,10,1755,905,850,214,196,183,79,0
71129,199,113,86,27,17,10,7,928,440,488,111,157,82,35,0
71130,393,223,170,44,36,32,14,293,142,151,49,40,42,17,0
71131,297,161,136,36,35,24,9,601,279,322,81,65,27,12,0
71132,209,75,134,53,48,20,9,427,251,176,51,39,25,22,0
71133,126,57,69,31,10,10,3,252,130,122,45,23,32,11,0
71134,557,250,307,70,47,51,22,68,23,45,12,9,3,9,0
71135,207,128,79,26,17,19,9,260,131,129,42,31,40,9,0
71136,135,64,71,31,11,8,4,309,164,145,35,47,30,11,0
71137,270,130,140,43,24,36,10,306,157,149,52,35,39,16,0
71138,928,442,486,139,118,91,43,729,358,371,116,99,89,33,0
71139,463,225,238,76,36,59,26,601,278,323,124,87,65,21,0
71140,798,287,511,126,125,77,26,392,155,237,68,61,34,16,0
71141,364,172,192,55,57,32,15,252,130,122,45,23,32,11,0
71142,622,354,268,89,60,64,18,663,360,303,87,82,80,35,0
71143,283,112,171,48,39,34,15,262,129,133,40,41,31,10,0
71144,530,259,271,83,50,54,41,283,142,141,41,33,26,18,0
71145,156,64,92,31,19,5,4,480,255,225,67,64,50,22,0
71146,520,231,289,89,59,58,26,180,115,65,17,12,9,9,0
71147,473,217,256,59,44,34,21,1537,701,836,209,187,129,58,0
71148,524,361,163,41,8,28,16,222,124,98,37,29,22,9,0
71149,1439,713,726,195,180,110,34,775,407,368,122,100,97,32,0
71150,516,224,292,79,29,45,33,385,188,197,57,42,36,16,0
71151,476,276,200,57,34,43,16,583,321,262,73,67,45,25,0
71152,224,101,123,45,32,21,3,360,180,180,57,48,39,12,0
71153,305,124,181,27,25,31,21,418,223,195,51,45,49,14,0
71154,895,388,507,130,84,90,31,295,156,139,41,40,42,15,0
71155,575,305,270,74,87,73,25,395,198,197,55,55,36,10,0
71156,437,167,270,126,95,34,10,397,223,174,50,39,29,17,0
71157,457,261,196,55,27,57,34,843,391,452,139,104,91,35,0
71158,752,313,439,121,106,68,27,387,193,194,60,53,57,15,0
71159,425,198,227,57,69,59,13,588,286,302,78,99,53,25,0
71160,651,357,294,81,67,103,18,873,411,462,132,107,84,40,0
71161,306,172,134,35,31,37,18,660,333,327,102,95,69,31,0
71162,338,164,174,45,32,37,13,172,88,84,24,31,20,12,0
71163,616,304,312,75,71,55,25,149,77,72,37,10,20,5,0
71164,90,54,36,20,4,14,5,1040,564,476,134,110,114,51,0
71165,309,137,172,51,50,28,14,467,231,236,71,65,58,18,0
71166,188,84,104,35,36,18,9,337,152,185,49,54,42,21,0
71167,1148,472,676,229,164,86,37,283,160,123,25,20,37,9,0
71168,447,225,222,76,35,75,21,307,132,175,48,53,26,10,0
71169,753,395,358,93,72,71,16,245,121,124,37,35,36,12,0
71170,782,372,410,127,111,89,36,135,57,78,21,20,9,11,0
71171,1590,726,864,270,237,126,59,640,364,276,84,68,69,33,0
71172,1064,495,569,157,159,124,58,551,226,325,96,103,43,11,0
71173,270,158,112,35,20,23,7,1395,627,768,172,263,141,59,0
71174,67,40,27,10,8,7,6,188,101,87,20,18,20,14,0
71175,437,212,225,66,44,44,11,373,189,184,54,46,50,23,0
71176,722,390,332,125,69,67,25,609,335,274,79,57,45,22,0
71177,126,57,69,31,10,10,3,583,280,303,95,66,76,25,0
71178,1007,353,654,277,147,70,26,368,183,185,40,42,40,15,0
71179,338,208,130,39,30,35,12,335,186,149,40,28,29,13,0
71180,629,338,291,92,57,64,22,399,190,209,61,41,39,18,0
71181,373,164,209,51,45,44,21,715,348,367,109,84,68,30,0
71182,527,276,251,64,60,70,20,277,163,114,33,24,21,16,0
71183,207,89,118,56,8,4,3,234,116,118,34,35,23,9,0
71184,436,209,227,66,47,52,22,1698,875,823,222,219,173,64,0
71185,852,472,380,99,79,70,27,561,279,282,85,81,88,24,0
71186,441,218,223,69,55,50,27,247,128,119,34,14,16,14,0
71187,1560,778,782,224,235,132,78,467,240,227,65,65,51,23,0
71188,126,58,68,31,10,10,3,352,207,145,40,33,25,21,0
71189,159,105,54,22,9,14,25,374,181,193,55,58,48,23,0
71190,1064,495,569,157,159,124,58,406,223,183,61,53,46,17,0
71191,833,295,538,146,139,65,34,132,67,65,24,21,8,10,0
71192,911,445,466,154,121,108,48,316,166,150,45,38,37,13,0
71193,554,217,337,112,72,90,38,188,105,83,25,17,24,7,0
71194,1064,495,569,157,159,124,58,188,88,100,53,12,15,6,0
71195,1867,973,894,256,222,194,65,798,385,413,120,115,79,30,0
71196,380,185,195,68,54,32,16,445,202,243,70,73,51,15,0
71197,303,161,142,38,31,42,17,279,161,118,37,32,7,7,0
71198,463,250,213,56,45,73,25,225,111,114,32,34,32,16,0
71199,435,230,205,51,37,55,18,2547,1280,1267,331,335,293,118,0
71200,285,148,137,31,42,42,16,252,130,122,45,23,32,11,0
71201,485,183,302,79,81,73,33,480,255,225,67,64,50,22,0
71202,1161,514,647,159,138,122,37,572,305,267,74,72,58,21,0
71203,1439,713,726,195,180,110,34,422,237,185,53,47,62,20,0
71204,461,207,254,82,66,55,33,319,185,134,42,31,22,13,0
71205,130,70,60,30,9,8,1,374,181,193,55,58,48,23,0
71206,1186,495,691,182,208,88,32,2346,1231,1115,316,292,266,105,0
71207,99,35,64,25,18,0,1,338,169,169,53,44,39,21,0
71208,334,190,144,42,42,16,5,811,361,450,124,107,80,31,0
71209,504,222,282,71,64,53,29,292,143,149,38,42,36,16,0
71210,284,160,124,37,23,32,11,904,436,468,143,118,108,32,0
71211,150,64,86,22,12,29,12,277,144,133,42,30,41,8,0
71212,432,190,242,85,82,28,11,200,99,101,31,24,26,6,0
71213,545,221,324,101,72,55,30,390,190,200,66,50,43,12,0
71214,401,204,197,49,33,29,17,1500,804,696,190,172,144,60,0
71215,376,176,200,31,53,27,8,154,78,76,23,21,13,5,0
71216,500,245,255,66,57,52,27,252,130,122,45,23,32,11,0
71217,496,209,287,113,55,72,14,205,94,111,48,31,15,6,0
71218,213,88,125,21,54,14,15,199,92,107,34,30,18,9,0
71219,585,277,308,92,73,61,32,495,217,278,79,64,44,22,0
71220,200,103,97,17,16,10,10,285,143,142,45,32,21,17,0
71221,898,397,501,102,98,54,37,378,154,224,74,84,35,22,0
71222,420,202,218,67,43,51,15,729,358,371,116,99,89,33,0
71223,272,136,136,32,34,12,12,1114,539,575,145,131,94,56,0
71224,1970,978,992,245,206,198,80,367,199,168,62,44,34,8,0
71225,219,116,103,66,7,2,1,410,197,213,67,43,56,18,0
71226,82,36,46,17,10,5,1,621,273,348,104,102,48,19,0
71227,860,349,511,166,166,58,19,660,333,327,102,95,69,31,0
71228,1531,649,882,108,122,93,72,375,210,165,49,37,29,27,0
71229,249,114,135,47,33,25,4,445,192,253,86,58,53,18,0
71230,270,130,140,43,24,36,10,2382,1162,1220,237,220,140,49,0
71231,366,190,176,39,62,55,14,337,170,167,59,33,47,17,0
71232,873,366,507,127,125,75,21,338,169,169,53,44,39,21,0
71233,350,190,160,48,25,27,18,323,162,161,52,41,39,13,0
71234,1023,449,574,141,174,76,43,673,313,360,102,101,46,17,0
71235,586,298,288,80,75,64,37,86,40,46,16,13,9,7,0
71236,2488,1085,1403,346,253,162,76,179,101,78,25,15,13,13,0
71237,315,170,145,48,56,22,11,584,249,335,80,96,22,13,0
71238,316,157,159,45,38,22,19,392,214,178,48,40,53,22,0
71239,417,176,241,75,61,51,20,601,278,323,124,87,65,21,0
71240,673,317,356,101,85,76,49,334,181,153,56,31,28,18,0
71241,361,171,190,44,40,18,13,1001,417,584,186,147,96,47,0
71242,447,232,215,55,65,50,25,391,165,226,67,64,36,27,0
71243,473,265,208,47,26,50,30,459,260,199,56,42,47,21,0
71244,359,204,155,39,36,34,13,102,51,51,12,15,12,3,0
71245,338,139,199,54,54,18,11,647,324,323,101,80,76,43,0
71246,164,77,87,33,19,6,7,180,115,65,17,12,9,9,0
71247,128,70,58,29,9,8,1,482,232,250,77,81,44,13,0
71248,162,73,89,32,19,4,4,660,332,328,84,73,47,19,0
71249,128,67,61,29,9,9,1,584,249,335,80,96,22,13,0
71250,437,212,225,66,44,44,11,302,150,152,56,40,52,15,0
71251,915,336,579,185,199,56,29,295,160,135,42,37,46,16,0
71252,484,194,290,70,93,47,16,457,242,215,39,46,53,10,0
71253,154,74,80,18,19,7,2,204,96,108,31,37,20,5,0
71254,401,236,165,53,38,34,9,452,252,200,55,49,61,16,0
71255,529,290,239,54,63,85,15,307,132,175,48,53,26,10,0
71256,577,251,326,92,84,60,11,810,310,500,164,162,42,26,0
71257,708,344,364,106,98,66,33,748,359,389,125,113,86,31,0
71258,333,171,162,50,34,19,8,818,357,461,122,136,54,25,0
71259,172,98,74,20,21,22,8,261,148,113,31,28,14,10,0
71260,1050,482,568,137,154,101,41,152,79,73,18,13,11,6,0
71261,598,300,298,68,77,59,21,415,226,189,51,40,40,29,0
71262,260,133,127,43,29,34,11,94,45,49,11,20,10,4,0
71263,373,194,179,42,54,26,13,156,90,66,17,22,11,10,0
71264,496,272,224,70,58,42,18,72,32,40,8,2,1,14,0
71265,291,120,171,63,39,26,6,609,335,274,79,57,45,22,0
71266,199,107,92,41,15,14,8,285,143,142,45,32,21,17,0
71267,425,198,227,57,69,59,13,127,66,61,13,14,19,8,0
71268,548,310,238,72,62,54,13,1755,905,850,214,196,183,79,0
71269,529,290,239,54,63,85,15,619,305,314,85,93,71,29,0
71270,2063,1024,1039,175,117,80,97,137,63,74,20,22,14,6,0
71271,380,187,193,38,51,30,18,54,26,28,11,4,3,3,0
71272,1365,590,775,257,168,136,93,303,138,165,47,46,35,18,0
71273,381,187,194,37,49,36,17,421,219,202,68,57,56,13,0
71274,164,77,87,33,19,6,7,396,199,197,54,50,45,14,0
71275,554,217,337,112,72,90,38,663,360,303,87,82,80,35,0
71276,500,257,243,60,55,27,22,509,267,242,79,81,38,20,0
71277,654,344,310,80,69,57,15,413,223,190,52,45,53,10,0
71278,527,254,273,67,66,70,31,134,72,62,14,28,8,4,0
71279,335,148,187,52,26,51,12,778,391,387,94,77,41,33,0
71280,879,457,422,93,98,143,32,528,276,252,86,78,49,17,0
71281,184,88,96,15,40,17,8,464,236,228,64,56,53,28,0
71282,230,114,116,30,33,29,8,111,60,51,17,23,10,7,0
71283,331,165,166,52,34,48,22,309,159,150,47,43,43,13,0
71284,380,185,195,68,54,32,16,1265,689,576,169,177,128,60,0
71285,165,66,99,28,32,16,3,222,122,100,39,32,24,9,0
71286,206,96,110,33,25,8,6,898,469,429,125,125,134,35,0
71287,585,277,308,92,73,61,32,415,203,212,77,44,49,18,0
71288,207,93,114,20,33,19,10,152,71,81,41,16,14,2,0
71289,312,173,139,43,47,28,6,203,98,105,34,29,19,10,0
71290,340,169,171,40,39,36,22,559,317,242,58,65,37,23,0
71291,406,207,199,56,46,68,19,720,361,359,98,98,70,37,0
71292,257,132,125,39,27,26,10,898,469,429,125,125,134,35,0
71293,329,168,161,48,34,41,16,445,192,253,86,58,53,18,0
71294,927,457,470,130,99,118,42,391,189,202,55,56,56,12,0
71295,2286,1154,1132,338,314,278,103,289,140,149,33,42,30,15,0
71296,758,378,380,89,64,37,31,349,200,149,41,39,30,20,0
71297,76,30,46,7,15,1,5,96,46,50,16,12,7,5,0
71298,374,187,187,51,52,40,27,86,40,46,16,13,9,7,0
71299,426,214,212,63,47,53,20,556,290,266,75,74,29,24,0
71300,476,199,277,82,80,49,24,368,183,185,40,42,40,15,0
71301,329,168,161,48,34,41,16,137,72,65,27,13,15,8,0
71302,837,381,456,123,109,65,25,1922,923,999,267,275,215,90,0
71303,380,148,232,81,69,24,8,250,119,131,58,26,29,7,0
71304,1912,880,1032,331,334,180,84,679,338,341,96,95,40,23,0
71305,1498,731,767,220,175,148,68,561,279,282,85,81,88,24,0
71306,480,257,223,74,26,60,27,192,110,82,33,21,10,3,0
71307,478,220,258,47,70,41,10,305,163,142,38,27,47,11,0
71308,575,295,280,89,68,54,18,535,301,234,63,48,47,27,0
71309,630,231,399,150,83,84,50,551,226,325,96,103,43,11,0
71310,90,54,36,20,4,14,5,620,324,296,81,68,66,31,0
71311,520,240,280,67,72,42,14,308,129,179,44,60,19,8,0
71312,397,180,217,61,59,39,13,1065,581,484,134,97,76,46,0
71313,440,267,173,52,29,42,12,127,64,63,26,8,12,8,0
71314,485,246,239,74,48,47,22,153,65,88,28,21,20,8,0
71315,365,210,155,46,30,24,12,1113,480,633,170,173,81,34,0
71316,380,187,193,38,51,30,18,783,406,377,102,91,57,29,0
71317,102,22,80,48,8,18,6,690,345,345,96,83,73,42,0
71318,784,351,433,118,87,73,41,627,289,338,101,73,62,43,0
71319,1755,849,906,245,226,148,56,775,407,368,122,100,97,32,0
71320,1417,598,819,223,188,135,58,1543,794,749,182,152,132,55,0
71321,118,56,62,13,14,6,6,975,518,457,141,122,75,26,0
71322,1217,647,570,142,160,129,45,485,244,241,80,55,59,20,0
71323,574,347,227,61,55,46,34,365,170,195,85,43,18,8,0
71324,211,92,119,33,44,11,7,432,244,188,51,51,27,14,0
71325,269,124,145,36,24,32,11,422,237,185,53,47,62,20,0
71326,284,128,156,48,29,34,8,662,373,289,89,80,77,29,0
71327,364,192,172,49,36,39,14,421,219,202,68,57,56,13,0
71328,1217,647,570,142,160,129,45,289,140,149,33,42,30,15,0
71329,772,332,440,136,104,72,28,200,89,111,26,25,17,7,0
71330,170,82,88,32,23,22,8,465,252,213,73,58,60,18,0
71331,726,312,414,121,73,82,23,662,312,350,103,104,59,20,0
71332,484,264,220,59,62,68,15,239,113,126,36,49,20,8,0
71333,852,461,391,109,102,72,24,250,119,131,58,26,29,7,0
71334,585,277,308,92,73,61,32,245,131,114,30,27,18,13,0
71335,664,269,395,117,107,36,15,106,41,65,36,6,11,7,0
71336,138,35,103,38,2,15,9,231,126,105,37,26,29,6,0
71337,361,167,194,55,35,41,11,818,357,461,122,136,54,25,0
71338,372,171,201,47,53,39,18,492,278,214,65,58,32,11,0
71339,4640,2231,2409,660,549,437,245,98,49,49,14,15,9,2,0
71340,333,171,162,50,34,19,8,2542,1245,1297,285,287,170,84,0
71341,125,46,79,24,16,12,2,123,61,62,17,18,17,7,0
71342,784,353,431,56,47,26,18,548,296,252,71,74,43,28,0
71343,302,178,124,34,29,50,13,198,113,85,19,20,26,12,0
71344,1390,705,685,219,164,129,74,724,353,371,94,95,71,31,0
71345,451,278,173,71,35,58,12,266,150,116,28,28,24,12,0
71346,1148,472,676,229,164,86,37,334,181,153,56,31,28,18,0
71347,333,171,162,41,44,48,23,328,195,133,39,40,27,13,0
71348,525,254,271,60,76,46,13,925,439,486,141,134,105,46,0
71349,524,262,262,62,72,39,49,737,397,340,87,104,90,14,0
71350,376,171,205,45,45,34,12,152,71,81,41,16,14,2,0
71351,600,324,276,89,73,45,39,622,344,278,80,77,68,36,0
71352,717,381,336,118,103,85,29,137,78,59,22,16,17,4,0
71353,240,98,142,49,42,23,17,348,194,154,57,31,43,12,0
71354,390,199,191,72,42,35,12,530,287,243,79,70,33,26,0
71355,649,304,345,99,80,67,40,207,86,121,34,39,11,13,0
71356,605,277,328,99,54,63,43,180,115,65,17,12,9,9,0
71357,395,189,206,63,50,49,28,384,212,172,44,43,34,14,0
71358,395,219,176,47,41,50,18,295,158,137,42,34,38,14,0
71359,436,209,227,66,47,52,22,218,117,101,35,32,34,12,0
71360,426,231,195,51,52,45,24,160,60,100,23,40,19,11,0
71361,301,157,144,31,28,34,9,2038,1059,979,262,237,208,100,0
71362,1099,491,608,163,141,107,62,198,110,88,27,27,24,4,0
71363,852,461,391,109,102,72,24,180,90,90,31,19,20,8,0
71364,1064,495,569,157,159,124,58,649,307,342,71,134,45,17,0
71365,626,300,326,91,82,68,26,127,54,73,11,33,15,6,0
71366,520,261,259,74,52,49,22,132,61,71,19,20,14,6,0
71367,2663,1073,1590,548,499,192,64,373,181,192,54,35,44,20,0
71368,257,148,109,28,20,21,14,297,175,122,46,30,31,6,0
71369,446,283,163,51,26,33,19,278,154,124,42,32,38,7,0
71370,1009,487,522,177,121,103,51,230,113,117,31,40,28,10,0
71371,616,304,312,75,71,55,25,403,225,178,56,38,33,25,0
71372,960,409,551,166,134,77,44,295,158,137,42,34,38,14,0
71373,225,111,114,38,22,25,10,756,348,408,101,103,60,40,0
71374,193,105,88,33,16,9,4,756,348,408,101,103,60,40,0
71375,443,206,237,76,68,52,28,300,148,152,45,43,40,8,0
71376,310,141,169,36,38,20,8,386,207,179,43,48,44,19,0
71377,911,489,422,121,98,97,36,154,78,76,23,21,13,5,0
71378,512,254,258,70,48,37,32,136,65,71,26,11,7,5,0
71379,381,146,235,74,48,47,34,319,185,134,42,31,22,13,0
71380,89,42,47,16,12,15,6,609,299,310,95,69,71,29,0
71381,313,158,155,43,35,43,16,2346,1231,1115,316,292,266,105,0
71382,443,206,237,76,68,52,28,562,273,289,76,92,45,24,0
71383,894,448,446,123,100,82,30,385,188,197,57,42,36,16,0
71384,859,411,448,118,100,95,49,620,324,296,81,68,66,31,0
71385,312,173,139,43,47,28,6,341,170,171,41,66,27,10,0
71386,139,64,75,18,17,18,4,555,282,273,82,69,65,21,0
71387,126,56,70,31,10,10,3,1314,693,621,174,155,140,58,0
71388,368,201,167,61,38,38,12,125,66,59,24,16,11,5,0
71389,302,178,124,34,29,50,13,736,388,348,88,85,67,28,0
71390,316,157,159,45,38,22,19,1154,489,665,200,196,95,54,0
71391,217,98,119,38,35,18,9,732,366,366,108,86,74,41,0
71392,220,113,107,37,24,16,7,326,149,177,51,51,28,10,0
71393,2414,1189,1225,277,178,170,169,196,105,91,40,13,19,10,0
71394,928,442,486,139,118,91,43,189,105,84,25,26,21,9,0
71395,231,105,126,56,10,24,10,1025,549,476,118,109,88,61,0
71396,589,282,307,68,67,70,23,378,154,224,74,84,35,22,0
71397,585,277,308,92,73,61,32,633,311,322,94,82,45,20,0
71398,480,267,213,49,44,70,21,225,129,96,32,33,20,8,0
71399,536,237,299,116,87,42,17,257,126,131,61,24,22,8,0
71400,202,103,99,28,20,12,8,2225,1244,981,271,243,217,93,0
71401,1009,487,522,177,121,103,51,727,362,365,123,107,63,23,0
71402,607,305,302,92,89,74,23,260,131,129,42,31,40,9,0
71403,301,156,145,32,25,15,5,127,58,69,18,17,10,5,0
71404,236,120,116,32,28,21,11,621,273,348,104,102,48,19,0
71405,482,231,251,76,81,64,26,414,203,211,58,56,48,14,0
71406,510,269,241,66,67,71,26,445,264,181,35,35,34,14,0
71407,240,99,141,53,38,29,15,723,363,360,107,106,52,14,0
71408,188,84,104,35,36,18,9,1214,475,739,177,250,89,49,0
71409,451,225,226,69,57,64,22,437,224,213,40,29,42,25,0
71410,519,245,274,58,61,34,22,422,202,220,80,52,57,18,0
71411,130,71,59,30,9,8,2,545,269,276,80,76,27,32,0
71412,99,35,64,25,18,0,1,1696,771,925,257,225,149,63,0
71413,86,50,36,9,14,8,7,230,113,117,31,40,28,10,0
71414,346,168,178,36,43,20,9,257,139,118,64,17,24,7,0
71415,434,221,213,58,47,54,15,312,165,147,41,39,29,16,0
71416,272,136,136,32,34,12,12,1425,670,755,153,189,122,85,0
71417,156,64,92,31,19,5,4,1543,794,749,182,152,132,55,0
71418,1009,478,531,166,126,96,42,406,223,183,61,53,46,17,0
71419,557,211,346,129,125,48,19,447,212,235,86,55,58,21,0
71420,472,222,250,46,61,33,23,375,209,166,50,37,29,23,0
71421,501,230,271,63,90,50,18,381,187,194,37,49,36,17,0
71422,399,220,179,48,37,68,18,453,247,206,58,53,45,20,0
71423,257,132,125,39,27,26,10,565,237,328,75,88,32,11,0
71424,275,160,115,40,31,34,17,108,59,49,17,13,12,5,0
71425,233,110,123,34,22,34,9,125,66,59,24,16,11,5,0
71426,1052,492,560,184,163,103,44,160,60,100,23,40,19,11,0
71427,798,364,434,133,88,74,35,400,187,213,56,59,42,20,0
71428,270,166,104,30,26,28,14,396,199,197,54,50,45,14,0
71429,327,174,153,42,35,16,12,457,253,204,67,51,48,13,0
71430,610,249,361,107,69,72,33,689,343,346,105,102,81,35,0
71431,510,269,241,66,67,71,26,101,59,42,11,17,10,1,0
71432,234,110,124,39,29,23,2,261,127,134,36,27,36,4,0
71433,553,319,234,56,37,54,18,462,251,211,74,53,41,18,0
71434,206,96,110,33,25,8,6,422,202,220,80,52,57,18,0
71435,853,400,453,137,109,88,42,296,151,145,45,42,32,11,0
71436,163,70,93,28,21,17,6,250,116,134,41,30,33,19,0
71437,433,188,245,63,45,26,14,102,51,51,12,15,12,3,0
71438,178,87,91,20,32,13,10,737,397,340,87,104,90,14,0
71439,1542,682,860,290,158,120,47,68,36,32,11,8,9,2,0
71440,682,292,390,89,69,58,20,708,328,380,113,100,82,34,0
71441,416,207,209,63,47,56,15,279,161,118,37,32,7,7,0
71442,251,131,120,49,35,25,5,320,168,152,38,42,24,18,0
71443,329,171,158,49,41,31,10,89,42,47,16,12,15,6,0
71444,318,164,154,52,43,34,10,258,129,129,45,24,31,10,0
71445,1064,495,569,157,159,124,58,86,40,46,16,13,9,7,0
71446,496,209,287,112,55,71,14,541,279,262,79,82,31,32,0
71447,161,99,62,15,22,9,7,975,400,575,160,162,62,31,0
71448,424,170,254,69,56,47,28,367,199,168,62,44,34,8,0
71449,359,204,155,39,36,34,13,758,319,439,101,123,78,25,0
71450,456,214,242,76,62,52,22,251,143,108,47,25,29,11,0
71451,305,124,181,27,25,32,21,445,202,243,70,73,51,15,0
71452,193,110,83,18,20,15,12,972,471,501,152,138,112,40,0
71453,431,199,232,59,54,40,17,205,94,111,48,31,15,6,0
71454,298,141,157,51,33,21,22,403,185,218,67,62,63,19,0
71455,496,210,286,112,55,72,13,285,146,139,41,41,48,13,0
71456,813,412,401,114,93,112,26,926,425,501,159,147,77,35,0
71457,411,211,200,61,46,35,18,516,245,271,82,84,70,26,0
71458,1395,595,800,223,206,113,61,334,181,153,56,31,28,18,0
71459,692,305,387,100,97,78,30,598,333,265,79,66,54,33,0
71460,532,254,278,91,48,23,17,671,306,365,114,76,49,19,0
71461,927,457,470,130,99,118,42,270,162,108,26,26,16,11,0
71462,1560,778,782,224,235,132,78,218,118,100,33,30,25,11,0
71463,1054,453,601,183,183,107,35,427,251,176,51,39,25,22,0
71464,629,338,291,92,57,64,22,247,128,119,34,14,16,14,0
71465,496,210,286,112,55,72,13,192,91,101,29,28,17,7,0
71466,575,290,285,67,70,28,9,87,38,49,23,10,10,9,0
71467,484,261,223,59,48,49,24,153,65,88,28,21,20,8,0
71468,331,144,187,57,46,33,19,125,66,59,24,16,11,5,0
71469,372,189,183,60,44,41,18,452,231,221,74,53,56,20,0
71470,180,57,123,39,22,10,8,649,307,342,71,134,45,17,0
71471,1499,864,635,141,99,76,110,889,505,384,107,97,99,30,0
71472,1163,417,746,209,145,87,28,89,42,47,16,12,15,6,0
71473,360,205,155,35,24,52,14,475,251,224,67,49,48,23,0
71474,949,466,483,125,126,101,50,387,193,194,60,53,57,15,0
71475,820,333,487,202,152,59,23,295,160,135,44,36,46,16,0
71476,1011,559,452,121,97,132,33,701,380,321,94,84,96,34,0
71477,609,292,317,102,96,64,21,316,166,150,45,38,37,13,0
71478,297,161,136,36,35,24,9,478,254,224,67,74,56,28,0
71479,881,492,389,87,97,59,51,524,300,223,70,54,51,25,0
71480,1912,880,1032,331,334,180,84,1040,564,476,134,110,114,51,0
71481,412,146,266,106,38,67,35,758,319,439,101,123,78,25,0
71482,435,225,210,58,46,50,14,699,334,365,108,80,70,20,0
71483,553,276,277,88,61,45,27,374,212,162,48,40,32,23,0
71484,268,113,155,50,22,39,18,440,246,194,62,49,41,16,0
71485,272,141,131,45,29,36,9,381,196,185,55,57,43,16,0
71486,482,245,237,69,64,66,24,286,160,126,37,27,23,10,0
71487,139,81,58,17,14,24,9,127,66,61,13,14,19,8,0
71488,210,101,109,33,33,19,9,549,273,276,74,68,72,24,0
71489,526,228,298,69,64,32,30,260,131,129,42,31,40,9,0
71490,271,136,135,37,30,18,10,258,129,129,45,24,31,10,0
71491,685,393,292,75,66,113,16,222,122,100,39,32,24,9,0
71492,184,88,96,15,40,17,8,627,289,338,101,73,62,43,0
71493,346,208,138,46,39,51,18,1265,689,576,169,177,128,60,0
71494,446,265,181,51,35,27,17,103,44,59,16,17,9,5,0
71495,365,222,143,44,24,35,11,242,124,118,39,32,28,22,0
71496,502,274,228,64,49,75,17,693,360,333,100,88,62,26,0
71497,326,176,150,35,22,29,11,303,137,166,54,54,31,15,0
71498,385,203,182,47,43,51,21,227,130,97,32,25,22,12,0
71499,257,148,109,28,20,21,14,766,386,380,101,81,78,31,0
71500,400,190,210,65,70,42,16,462,228,234,59,47,37,32,0
71501,2062,706,1356,414,368,158,63,296,140,156,49,40,42,19,0
71502,531,259,272,75,81,39,13,408,221,187,55,51,57,14,0
71503,299,151,148,35,34,26,16,373,181,192,54,35,44,20,0
71504,664,269,395,117,107,36,15,212,127,85,28,21,26,6,0
71505,261,148,113,23,29,26,21,403,185,218,67,62,63,19,0
71506,375,201,174,52,56,39,15,267,141,126,53,27,23,7,0
71507,439,205,234,64,88,41,21,818,357,461,122,136,54,25,0
71508,240,166,74,32,12,8,15,199,92,107,34,30,18,9,0
71509,242,104,138,41,33,37,8,296,140,156,49,40,42,19,0
71510,437,230,207,41,55,27,13,289,140,149,33,42,30,15,0
71511,772,417,355,118,92,80,23,127,66,61,13,14,19,8,0
71512,437,230,207,41,55,27,13,564,264,300,79,84,65,26,0
71513,193,107,86,13,20,13,6,194,106,88,33,10,15,6,0
71514,755,271,484,113,226,61,20,375,176,199,48,61,40,12,0
71515,1105,544,561,165,167,99,40,385,212,173,57,40,39,21,0
71516,1054,453,601,183,183,107,35,630,321,309,86,90,57,26,0
71517,815,356,459,128,125,82,26,736,388,348,88,85,67,28,0
71518,256,152,104,18,23,23,8,524,300,223,70,54,51,25,0
71519,785,325,460,114,123,61,28,218,115,103,37,33,33,9,0
71520,161,75,86,24,20,10,7,203,98,105,34,29,19,10,0
71521,1441,504,937,264,329,69,46,798,385,413,120,115,79,30,0
71522,288,140,148,59,33,27,12,335,186,149,40,28,29,13,0
71523,521,249,272,53,36,50,18,222,125,97,34,27,27,7,0
71524,204,103,101,16,32,22,8,370,173,197,65,57,42,10,0
71525,106,43,63,28,13,8,1,474,268,206,66,42,45,24,0
71526,226,120,106,68,8,2,1,479,215,264,67,80,46,28,0
71527,1220,575,645,208,179,99,56,330,166,164,55,51,36,16,0
71528,2236,1195,1041,227,187,186,118,225,129,96,32,33,20,8,0
71529,476,199,277,82,80,49,24,198,86,112,36,27,23,9,0
71530,228,105,123,34,43,20,10,334,182,152,45,41,27,13,0
71531,579,246,333,102,79,41,19,690,345,345,96,83,73,42,0
71532,130,70,60,30,9,8,1,715,345,370,110,97,64,25,0
71533,178,74,104,31,28,9,4,294,146,148,50,45,51,15,0
71534,729,351,378,111,98,58,18,1040,564,476,134,110,114,51,0
71535,1014,488,526,178,137,94,39,464,236,228,64,56,53,28,0
71536,435,187,248,62,51,51,21,447,212,235,86,55,58,21,0
71537,220,121,99,28,26,17,6,260,131,129,42,31,40,9,0
71538,385,179,206,58,56,38,19,479,215,264,67,80,46,28,0
71539,428,248,180,44,39,28,9,902,499,403,118,117,92,35,0
71540,220,121,99,28,26,17,6,514,248,266,86,82,52,22,0
71541,257,122,135,44,19,21,16,1101,626,475,145,122,120,50,0
71542,824,391,433,106,90,88,32,1034,495,539,150,134,114,71,0
71543,136,66,70,33,11,9,5,198,115,83,30,22,8,8,0
71544,285,148,137,31,42,42,16,480,255,225,67,64,50,22,0
71545,1186,495,691,182,208,88,32,103,50,53,19,10,7,5,0
71546,315,170,145,48,56,22,11,175,91,84,19,21,21,10,0
71547,837,443,394,129,89,87,38,972,471,501,152,138,112,40,0
71548,132,66,66,21,18,11,7,427,251,176,51,39,25,22,0
71549,710,352,358,104,86,84,41,536,222,314,101,100,34,22,0
71550,631,304,327,98,75,52,23,187,89,98,36,24,20,6,0
71551,1912,880,1032,331,334,180,84,222,124,98,37,29,22,9,0
71552,67,40,27,10,8,7,6,330,166,164,55,51,36,16,0
71553,1120,436,684,208,120,101,115,153,65,88,28,21,20,8,0
71554,284,128,156,48,29,34,8,592,249,343,91,90,50,42,0
71555,595,339,256,64,36,54,24,292,143,149,38,42,36,16,0
71556,456,214,242,76,62,52,22,227,130,97,32,25,22,12,0
71557,359,204,155,39,36,34,13,381,196,185,55,57,43,16,0
71558,594,279,315,93,68,68,26,621,310,311,100,106,77,27,0
71559,374,187,187,51,52,40,27,290,142,148,41,37,43,11,0
71560,346,209,137,46,37,44,10,758,319,439,101,123,78,25,0
71561,314,158,156,39,28,30,17,137,85,52,15,11,11,2,0
71562,1004,498,506,94,59,46,33,153,80,73,26,18,19,4,0
71563,465,305,160,40,47,34,9,609,335,274,79,57,45,22,0
71564,820,333,487,202,152,59,23,102,51,51,12,15,12,3,0
71565,238,91,147,68,19,22,7,308,146,162,42,39,24,12,0
71566,331,144,187,57,46,33,19,935,515,420,126,107,73,32,0
71567,420,202,218,67,43,51,15,178,99,79,31,19,26,8,0
71568,338,139,199,54,54,18,11,72,32,40,8,2,1,14,0
71569,1226,513,713,184,147,87,43,627,323,304,81,90,53,27,0
71570,131,69,62,29,9,9,1,261,162,99,24,21,14,10,0
71571,563,255,308,91,111,42,30,464,236,228,64,56,53,28,0
71572,692,305,387,100,97,78,30,317,161,156,40,49,41,11,0
71573,411,211,200,61,46,35,18,508,253,255,73,60,50,13,0
71574,427,191,236,67,60,41,34,715,345,370,110,97,64,25,0
71575,928,442,486,139,118,91,43,419,233,186,54,53,55,17,0
71576,960,409,551,166,134,77,44,215,115,100,27,19,16,7,0
71577,505,247,258,72,71,60,27,463,268,195,59,46,46,21,0
71578,338,208,130,39,30,35,12,557,281,276,80,59,43,21,0
71579,820,333,487,202,152,59,23,1323,690,633,132,178,112,61,0
71580,179,96,83,24,8,26,4,338,169,169,53,44,39,21,0
71581,840,411,429,122,101,79,34,328,199,129,39,29,27,14,0
71582,2525,1232,1293,398,317,186,61,335,186,149,40,28,29,13,0
71583,231,105,126,56,10,24,10,1314,693,621,174,155,140,58,0
71584,318,161,157,53,51,32,13,246,125,121,38,36,30,11,0
71585,1052,492,560,184,163,103,44,520,244,276,91,60,68,20,0
71586,71,39,32,7,11,6,4,192,91,101,29,28,17,7,0
71587,395,189,206,63,50,49,28,1004,457,547,150,150,74,52,0
71588,519,259,260,86,78,59,22,720,361,359,98,98,70,37,0
71589,280,156,124,36,19,20,13,535,311,224,66,52,49,24,0
71590,346,208,138,46,39,51,18,222,125,97,34,27,27,7,0
71591,278,110,168,58,49,29,5,153,65,88,28,21,20,8,0
71592,1960,875,1085,287,189,162,66,1755,905,850,214,196,183,79,0
71593,102,22,80,48,8,18,6,196,105,91,40,13,19,10,0
71594,312,173,139,43,47,28,6,239,113,126,36,49,20,8,0
71595,525,302,223,56,48,67,19,598,333,265,79,66,54,33,0
71596,1099,491,608,163,141,107,62,479,215,264,67,80,46,28,0
71597,338,208,130,39,30,35,12,935,515,420,126,107,73,32,0
71598,258,144,114,33,22,19,9,359,171,188,49,74,45,11,0
71599,1360,644,716,213,194,136,62,336,200,136,34,29,25,24,0
71600,421,219,202,68,57,56,13,715,345,370,110,97,64,25,0
71601,548,310,238,72,62,54,13,1034,495,539,150,134,114,71,0
71602,520,231,289,89,59,58,26,437,221,216,62,64,47,13,0
71603,125,53,72,18,21,18,12,374,191,183,40,52,40,16,0
71604,325,177,148,40,24,23,13,198,86,112,36,27,23,9,0
71605,451,278,173,71,35,58,12,978,536,442,132,107,67,32,0
71606,1214,612,602,169,173,98,35,437,224,213,40,29,42,25,0
71607,376,249,127,47,23,43,16,223,113,110,31,33,22,12,0
71608,371,143,228,77,48,29,26,417,232,185,58,50,29,21,0
71609,2663,1073,1590,548,499,192,64,194,106,88,33,10,15,6,0
71610,427,191,236,67,60,41,34,1065,581,484,134,97,76,46,0
71611,510,288,222,44,36,24,7,344,190,154,34,31,36,10,0
71612,144,67,77,28,14,9,8,136,65,71,26,11,7,5,0
71613,411,211,200,61,46,35,18,375,211,164,50,36,31,23,0
71614,313,178,135,43,18,35,6,597,269,328,102,84,69,24,0
71615,170,82,88,32,23,22,8,303,138,165,47,46,35,18,0
71616,92,46,46,14,9,8,6,271,150,121,39,36,37,5,0
71617,219,116,103,66,7,2,1,925,439,486,141,134,105,46,0
71618,224,101,123,45,32,21,3,145,77,68,26,7,15,8,0
71619,317,167,150,45,21,30,26,337,170,167,59,33,47,17,0
71620,335,155,180,64,48,36,10,2517,1275,1242,304,324,245,135,0
71621,366,190,176,39,62,55,14,260,131,129,42,31,40,9,0
71622,341,175,166,48,43,35,18,362,156,206,74,42,36,22,0
71623,156,64,92,31,19,5,4,737,397,340,87,104,90,14,0
71624,514,226,288,71,66,63,32,701,380,321,94,84,96,34,0
71625,301,150,151,45,47,33,13,218,117,101,35,32,34,12,0
71626,230,114,116,30,33,29,8,723,353,370,120,109,96,33,0
71627,595,316,279,86,60,65,40,375,210,165,49,37,29,27,0
71628,285,148,137,31,42,42,16,194,106,88,33,10,15,6,0
71629,1009,478,531,166,126,96,42,660,332,328,84,73,47,19,0
71630,2062,706,1356,414,368,158,63,172,79,93,34,27,23,10,0
71631,200,94,106,33,22,18,8,303,138,165,47,46,35,18,0
71632,283,172,111,39,31,29,8,792,398,394,109,96,90,39,0
71633,361,167,194,55,35,41,11,497,257,240,71,63,62,16,0
71634,179,78,101,29,22,10,8,418,223,195,51,45,49,14,0
71635,824,391,433,106,90,88,32,135,57,78,21,20,9,11,0
71636,524,361,163,41,8,28,16,673,313,360,102,101,46,17,0
71637,651,357,294,81,67,103,18,2202,1121,1081,338,274,269,81,0
71638,615,308,307,83,75,58,32,2542,1245,1297,285,287,170,84,0
71639,338,208,130,39,30,35,12,337,152,185,49,54,42,21,0
71640,420,248,172,64,30,43,17,145,77,68,26,7,15,8,0
71641,130,71,59,30,9,8,2,583,280,303,95,66,76,25,0
71642,380,187,193,38,51,30,18,289,140,149,33,42,30,15,0
71643,570,238,332,112,95,39,23,437,224,213,40,29,42,25,0
71644,280,156,124,36,19,20,13,413,223,190,52,45,53,10,0
71645,494,233,261,87,57,46,18,194,106,88,33,10,15,6,0
71646,546,285,261,71,49,47,24,592,249,343,91,90,50,42,0
71647,593,282,311,75,70,29,25,136,65,71,26,11,7,5,0
71648,2285,1219,1066,207,180,178,106,404,190,214,55,55,35,27,0
71649,513,276,237,73,43,57,24,437,221,216,62,64,47,13,0
71650,306,172,134,35,31,37,18,1314,693,621,174,155,140,58,0
71651,733,382,351,126,92,93,27,406,202,204,54,51,63,21,0
71652,242,111,131,35,35,17,13,205,94,111,48,31,15,6,0
71653,344,109,235,100,39,26,5,810,310,500,164,162,42,26,0
71654,442,254,188,46,22,40,19,288,156,132,36,36,24,15,0
71655,577,251,326,92,84,60,11,501,257,244,75,57,48,29,0
71656,331,177,154,54,38,27,11,660,332,328,84,73,47,19,0
71657,234,110,124,39,29,23,2,169,74,95,33,26,22,3,0
71658,284,128,156,48,29,34,8,1543,794,749,182,152,132,55,0
71659,630,231,399,150,83,84,50,127,54,73,11,33,15,6,0
71660,193,95,98,33,17,25,17,704,355,349,113,94,71,24,0
71661,275,125,150,37,48,27,7,584,249,335,80,96,22,13,0
71662,308,129,179,44,60,19,8,582,264,318,84,60,58,23,0
71663,330,141,189,65,29,51,19,142,73,69,27,9,15,11,0
71664,853,400,453,137,109,88,42,260,131,129,42,31,40,9,0
71665,350,178,172,49,62,29,16,148,69,79,26,18,16,3,0
71666,468,233,235,65,61,49,34,292,143,149,38,42,36,16,0
71667,278,104,174,46,34,23,14,536,267,269,60,70,41,22,0
71668,736,320,416,113,97,61,36,445,264,181,35,35,34,14,0
71669,580,308,272,82,79,58,25,380,211,169,47,37,33,21,0
71670,126,57,69,31,10,10,3,727,388,339,102,87,70,29,0
71671,728,358,370,118,100,55,29,127,54,73,11,33,15,6,0
71672,281,125,156,44,47,17,7,266,150,116,28,28,24,12,0
71673,1220,575,645,208,179,99,56,244,143,101,31,29,26,8,0
71674,258,130,128,44,37,29,10,497,227,270,70,63,66,30,0
71675,240,167,73,32,12,8,21,231,126,105,37,26,29,6,0
71676,525,302,223,56,48,67,19,727,388,339,102,87,70,29,0
71677,577,342,235,63,57,23,37,601,279,322,81,65,27,12,0
71678,509,251,258,69,49,55,17,749,384,365,108,105,86,31,0
71679,441,216,225,57,66,57,19,1425,670,755,153,189,122,85,0
71680,636,288,348,94,77,65,30,169,74,95,33,26,22,3,0
71681,583,279,304,99,71,59,31,1507,737,770,188,228,147,71,0
71682,215,104,111,61,7,2,1,664,350,314,86,90,82,36,0
71683,399,220,179,48,37,68,18,374,181,193,55,58,48,23,0
71684,335,155,180,64,48,36,10,346,196,150,43,26,27,14,0
71685,224,108,116,31,32,22,8,462,229,233,63,49,42,18,0
71686,579,321,258,74,70,47,22,328,199,129,39,29,27,14,0
71687,207,93,114,20,33,19,10,303,138,165,47,46,35,18,0
71688,128,70,58,29,9,8,1,660,333,327,102,95,69,31,0
71689,322,164,158,46,44,29,7,496,285,211,62,54,46,22,0
71690,521,249,272,53,36,50,18,323,168,155,51,41,38,12,0
71691,485,183,302,79,81,73,33,335,170,165,52,36,47,11,0
71692,169,64,105,23,37,11,3,147,74,73,28,20,24,4,0
71693,2696,1169,1527,432,347,193,146,699,334,365,108,80,70,20,0
71694,552,295,257,67,49,70,30,390,190,200,66,50,43,12,0
71695,126,56,70,31,10,10,3,295,158,137,42,34,38,14,0
71696,483,236,247,82,60,43,18,723,353,370,120,109,96,33,0
71697,2136,1063,1073,317,308,223,90,941,459,482,167,140,82,38,0
71698,1872,837,1035,280,338,169,80,277,152,125,31,35,22,19,0
71699,336,199,137,46,22,51,13,474,268,206,66,42,45,24,0
71700,507,314,193,49,45,59,25,1101,626,475,145,122,120,50,0
71701,338,139,199,54,54,18,11,798,385,413,120,115,79,30,0
71702,859,411,448,118,100,95,49,403,221,182,62,50,42,12,0
71703,350,172,178,61,45,32,13,198,113,85,19,20,26,12,0
71704,261,126,135,41,36,24,11,392,214,178,48,40,53,22,0
71705,282,135,147,27,37,30,19,282,134,148,38,45,29,10,0
71706,772,383,389,105,76,82,33,498,244,254,81,67,58,19,0
71707,270,131,139,47,37,41,11,404,190,214,55,55,35,27,0
71708,516,210,306,113,53,81,33,250,119,131,58,26,29,7,0
71709,496,272,224,70,58,42,18,775,407,368,122,100,97,32,0
71710,616,304,312,75,71,55,25,415,189,226,68,54,50,21,0
71711,898,397,501,102,98,54,37,359,171,188,49,74,45,11,0
71712,207,93,114,20,33,19,10,475,251,224,67,49,48,23,0
71713,1058,497,561,194,142,87,63,101,59,42,11,17,10,1,0
71714,2174,1057,1117,241,241,214,117,218,111,107,45,29,24,6,0
71715,520,261,259,74,52,49,22,457,245,212,62,58,57,21,0
71716,338,164,174,45,32,37,13,437,221,216,62,64,47,13,0
71717,365,148,217,86,37,51,28,1873,935,938,233,225,203,79,0
71718,418,163,255,57,54,38,24,250,116,134,41,30,33,19,0
71719,520,240,280,87,63,67,16,744,385,359,105,96,57,31,0
71720,674,318,356,86,139,50,11,175,91,84,19,21,21,10,0
71721,361,171,190,44,40,18,13,204,80,124,29,51,10,5,0
71722,415,133,282,114,65,27,7,715,345,370,110,97,64,25,0
71723,407,164,243,88,42,40,22,198,113,85,19,20,26,12,0
71724,478,220,258,47,70,41,10,220,107,113,36,35,28,9,0
71725,200,94,106,33,22,18,8,461,223,238,45,62,18,35,0
71726,605,277,328,99,54,63,43,405,214,191,53,42,49,20,0
71727,107,56,51,18,16,12,5,368,200,168,54,49,43,9,0
71728,861,393,468,150,101,69,35,471,238,233,66,63,62,19,0
71729,785,351,434,136,93,71,37,699,334,365,108,80,70,20,0
71730,434,216,218,72,58,40,20,846,425,421,125,97,98,38,0
71731,336,199,137,46,22,51,13,723,353,370,120,109,96,33,0
71732,437,228,209,47,61,26,11,98,49,49,14,15,9,2,0
71733,270,131,139,47,37,41,11,203,98,105,34,29,19,10,0
71734,465,220,245,88,34,61,23,309,164,145,35,47,30,11,0
71735,585,277,308,92,73,61,32,218,115,103,37,33,33,9,0
71736,126,56,70,31,10,10,3,508,253,255,73,60,50,13,0
71737,531,259,272,75,81,39,13,452,231,221,74,53,56,20,0
71738,692,305,387,100,97,78,30,384,212,172,44,43,34,14,0
71739,559,217,342,105,86,42,16,229,120,109,31,30,22,9,0
71740,1327,520,807,241,174,141,60,1262,653,609,169,165,152,50,0
71741,207,128,79,26,17,19,9,296,159,137,49,28,38,13,0
71742,717,381,336,118,103,85,29,194,94,100,33,28,14,7,0
71743,508,251,257,74,53,51,18,277,144,133,42,30,41,8,0
71744,961,465,496,139,156,62,34,723,353,370,120,109,96,33,0
71745,588,300,288,100,57,65,27,469,225,244,64,68,25,11,0
71746,172,82,90,21,35,21,5,230,113,117,31,40,28,10,0
71747,234,110,124,39,29,23,2,279,142,137,43,39,28,7,0
71748,330,77,253,86,52,20,12,811,361,450,124,107,80,31,0
71749,144,57,87,38,26,10,4,2382,1162,1220,237,220,140,49,0
71750,960,409,551,166,134,77,44,134,55,79,22,24,16,6,0
71751,161,94,67,23,13,8,10,699,334,365,108,80,70,20,0
71752,127,48,79,27,20,6,5,693,360,333,100,88,62,26,0
71753,269,156,113,37,32,17,7,947,482,465,143,107,89,37,0
71754,193,110,83,18,20,15,12,630,321,309,86,90,57,26,0
71755,92,46,46,14,9,8,6,583,321,262,73,67,45,25,0
71756,435,230,205,51,37,55,18,165,87,78,24,19,22,9,0
71757,490,224,266,80,70,39,32,622,344,278,80,77,68,36,0
71758,340,145,195,46,38,26,23,524,300,223,70,54,51,25,0
71759,743,377,366,87,74,68,30,144,67,77,28,14,9,8,0
71760,76,30,46,7,15,1,5,370,190,180,60,52,37,13,0
71761,546,278,268,94,60,32,22,132,77,55,20,9,13,10,0
71762,163,70,93,28,21,17,6,1425,670,755,153,189,122,85,0
71763,297,182,115,41,22,23,8,1395,627,768,172,263,141,59,0
71764,1174,594,580,175,155,126,66,1395,627,768,172,263,141,59,0
71765,2488,1085,1403,346,253,162,76,188,101,87,20,18,20,14,0
71766,280,156,124,36,19,20,13,925,439,486,141,134,105,46,0
71767,468,233,235,65,61,49,34,149,52,97,36,36,7,4,0
71768,374,187,187,51,52,40,27,354,188,166,46,40,34,10,0
71769,181,75,106,35,26,11,9,953,489,464,126,104,111,44,0
71770,329,168,161,48,34,41,16,166,102,64,19,14,17,2,0
71771,785,374,411,56,42,38,25,258,129,129,45,24,31,10,0
71772,331,169,162,40,28,22,14,179,101,78,25,15,13,13,0
71773,413,206,207,38,55,19,10,376,183,193,50,50,43,21,0
71774,482,231,251,76,81,64,26,192,110,82,33,21,10,3,0
71775,399,220,179,48,37,68,18,514,248,266,86,82,52,22,0
71776,422,207,215,79,38,53,23,279,142,137,43,39,28,7,0
71777,309,137,172,51,50,28,14,2038,1059,979,262,237,208,100,0
71778,422,207,215,79,38,53,23,328,195,133,39,40,27,13,0
71779,1009,478,531,166,126,96,42,373,189,184,54,46,50,23,0
71780,626,308,318,105,89,77,25,332,173,159,48,40,31,11,0
71781,535,315,220,57,55,71,19,602,310,292,87,66,70,36,0
71782,251,139,112,41,18,27,11,267,141,126,53,27,23,7,0
71783,55,16,39,24,2,5,2,180,89,91,28,27,18,7,0
71784,178,87,91,20,32,13,10,149,52,97,36,36,7,4,0
71785,433,188,245,63,45,26,14,385,188,197,57,42,36,16,0
71786,109,42,67,25,13,1,1,467,240,227,65,65,51,23,0
71787,589,282,307,68,67,70,23,149,52,97,36,36,7,4,0
71788,496,274,222,57,43,75,22,479,215,264,67,80,46,28,0
71789,1121,458,663,158,210,76,47,501,274,227,63,58,53,20,0
71790,269,156,113,37,32,17,7,640,364,276,84,68,69,33,0
71791,502,236,266,66,66,58,17,701,380,321,94,84,96,34,0
71792,164,81,83,37,8,14,10,455,191,264,68,86,21,19,0
71793,505,282,223,60,57,66,23,2547,1280,1267,331,335,293,118,0
71794,1542,682,860,290,158,120,47,295,156,139,41,40,42,15,0
71795,575,305,270,74,87,73,25,292,143,149,38,42,36,16,0
71796,260,138,122,44,30,28,6,1239,659,580,169,148,131,54,0
71797,465,240,225,50,54,24,14,415,205,210,77,52,55,17,0
71798,714,260,454,140,97,120,54,611,314,297,79,75,78,22,0
71799,519,245,274,58,61,34,22,145,77,68,26,7,15,8,0
71800,900,434,466,134,97,86,36,602,310,292,87,66,70,36,0
71801,227,109,118,42,35,29,8,536,267,269,60,70,41,22,0
71802,281,125,156,44,47,17,7,1395,627,768,172,263,141,59,0
71803,299,151,148,35,34,26,16,405,214,191,53,42,49,20,0
71804,233,110,123,34,22,34,9,381,186,195,69,55,46,15,0
71805,468,233,235,65,61,49,34,415,205,210,77,52,55,17,0
71806,240,99,141,53,38,29,15,303,138,165,47,46,35,18,0
71807,1085,646,439,108,65,36,19,453,247,206,58,53,45,20,0
71808,129,70,59,29,9,7,2,218,118,100,33,30,25,11,0
71809,828,368,460,118,98,59,38,241,127,114,34,33,29,12,0
71810,356,199,157,36,43,28,12,535,288,247,79,72,35,21,0
71811,553,276,277,88,61,45,27,270,130,140,48,44,37,12,0
71812,680,308,372,82,72,71,40,403,192,211,102,39,49,15,0
71813,782,372,410,127,111,89,36,188,93,95,33,18,16,10,0
71814,318,161,157,53,51,32,13,647,350,297,95,79,77,29,0
71815,580,265,315,97,89,79,17,160,76,84,19,24,8,5,0
71816,860,348,512,121,136,75,35,926,425,501,159,147,77,35,0
71817,1047,443,604,162,156,78,52,485,244,241,80,55,59,20,0
71818,188,84,104,35,36,18,9,339,175,164,51,49,37,9,0
71819,473,212,261,72,64,45,28,485,244,241,80,55,59,20,0
71820,1505,680,825,202,204,73,32,180,108,72,22,22,15,5,0
71821,808,366,442,130,133,66,31,846,425,421,125,97,98,38,0
71822,373,194,179,42,54,26,13,627,289,338,101,73,62,43,0
71823,203,80,123,40,37,20,3,142,73,69,27,9,15,11,0
71824,1105,544,561,165,167,99,40,166,88,78,23,18,13,7,0
71825,521,289,232,71,58,49,16,322,180,142,45,38,28,7,0
71826,251,139,112,41,18,27,11,547,295,252,81,65,57,23,0
71827,256,152,104,18,23,23,8,403,221,182,62,50,42,12,0
71828,271,110,161,33,27,11,8,201,93,108,34,39,21,6,0
71829,648,376,272,70,60,73,24,314,151,163,42,61,39,16,0
71830,357,182,175,49,36,39,15,583,321,262,73,67,45,25,0
71831,326,154,172,45,39,20,10,1265,689,576,169,177,128,60,0
71832,524,262,262,62,72,39,49,373,189,184,54,46,50,23,0
71833,493,208,285,75,77,70,40,252,130,122,45,23,32,11,0
71834,586,298,288,80,75,64,37,127,54,73,11,33,15,6,0
71835,828,355,473,126,134,77,37,862,409,453,149,125,86,29,0
71836,291,131,160,49,35,32,15,898,469,429,125,125,134,35,0
71837,595,316,279,86,60,65,40,222,124,98,37,29,22,9,0
71838,224,108,116,31,32,22,8,403,184,219,75,51,47,20,0
71839,365,222,143,44,24,35,11,729,358,371,116,99,89,33,0
71840,553,276,277,88,61,45,27,218,111,107,45,29,24,6,0
71841,2062,706,1356,414,368,158,63,627,289,338,101,73,62,43,0
71842,119,67,52,15,15,7,7,198,113,85,19,20,26,12,0
71843,2174,1057,1117,241,241,214,117,1696,771,925,257,225,149,63,0
71844,1200,602,598,145,116,110,50,242,121,121,39,30,29,10,0
71845,516,224,292,79,29,45,33,1922,923,999,267,275,215,90,0
71846,496,209,287,113,55,72,14,404,190,214,55,55,35,27,0
71847,199,113,86,27,17,10,7,277,124,153,44,40,35,18,0
71848,710,352,358,104,86,84,41,862,426,436,113,115,84,37,0
71849,594,279,315,93,68,68,26,1062,522,540,151,147,105,66,0
71850,894,448,446,123,100,82,30,413,223,190,52,45,53,10,0
71851,109,50,59,12,12,9,3,189,95,94,25,33,16,8,0
71852,860,349,511,166,166,58,19,165,87,78,24,19,22,9,0
71853,357,182,175,49,36,39,15,336,200,136,34,29,25,24,0
71854,156,64,92,31,19,5,4,517,295,222,69,62,40,28,0
71855,473,212,261,72,64,45,28,89,51,38,15,15,5,4,0
71856,207,128,79,26,17,19,9,360,180,180,57,48,39,12,0
71857,393,223,170,44,36,32,14,386,207,179,43,48,44,19,0
71858,919,493,426,100,92,88,49,229,120,109,31,30,22,9,0
71859,364,204,160,65,35,15,13,843,391,452,139,104,91,35,0
71860,331,165,166,52,34,48,22,410,197,213,67,43,56,18,0
71861,282,96,186,80,21,28,7,204,80,124,29,51,10,5,0
71862,220,121,99,28,26,17,6,160,76,84,19,24,8,5,0
71863,959,496,463,144,132,75,35,445,192,253,86,58,53,18,0
71864,213,114,99,62,7,2,1,207,114,93,33,20,31,13,0
71865,1531,649,882,108,122,93,72,467,240,227,65,65,51,23,0
71866,345,208,137,44,27,33,8,192,91,101,29,28,17,7,0
71867,1064,495,569,157,159,124,58,535,301,234,63,48,47,27,0
71868,361,171,190,44,40,18,13,222,127,95,23,28,22,7,0
71869,317,167,150,45,21,30,26,1249,638,611,166,153,141,45,0
71870,149,78,71,20,20,19,5,386,181,205,55,51,57,31,0
71871,1960,875,1085,287,189,162,66,375,210,165,49,37,29,27,0
71872,682,260,422,153,78,109,46,445,192,253,86,58,53,18,0
71873,126,57,69,31,10,10,3,396,213,183,68,44,47,18,0
71874,1417,598,819,223,188,135,58,106,41,65,36,6,11,7,0
71875,149,78,71,20,20,19,5,89,51,38,15,15,5,4,0
71876,235,100,135,36,25,30,8,514,248,266,86,82,52,22,0
71877,161,99,62,15,22,9,7,693,360,333,100,88,62,26,0
71878,2525,1232,1293,398,317,186,61,1395,627,768,172,263,141,59,0
71879,172,82,90,21,35,21,5,385,212,173,57,40,39,21,0
71880,420,189,231,79,67,33,17,519,287,232,68,58,45,21,0
71881,546,285,261,71,49,47,24,810,310,500,164,162,42,26,0
71882,535,217,318,87,106,41,14,1248,584,664,184,164,155,67,0
71883,563,255,308,91,111,42,30,432,244,188,51,51,27,14,0
71884,317,153,164,34,52,30,14,421,219,202,68,57,56,13,0
71885,271,136,135,37,30,18,10,350,196,154,52,37,21,14,0
71886,329,168,161,48,34,41,16,225,129,96,32,33,20,8,0
71887,280,128,152,39,37,38,18,1101,626,475,145,122,120,50,0
71888,436,201,235,54,37,35,18,601,278,323,124,87,65,21,0
71889,127,54,73,31,10,11,3,218,111,107,45,29,24,6,0
71890,181,75,106,35,26,11,9,389,210,179,51,37,43,9,0
71891,480,267,213,49,44,70,21,858,398,460,126,138,75,39,0
71892,224,108,116,31,32,22,8,373,189,184,54,46,50,23,0
71893,252,121,131,42,34,12,16,260,131,129,42,31,40,9,0
71894,331,165,166,52,34,48,22,1314,693,621,174,155,140,58,0
71895,745,402,343,95,71,69,40,360,185,175,51,43,36,16,0
71896,685,393,292,75,66,113,16,1507,737,770,188,228,147,71,0
71897,572,307,265,70,55,44,17,559,317,242,58,65,37,23,0
71898,439,241,198,67,40,40,13,862,426,436,113,115,84,37,0
71899,399,196,203,62,45,38,19,212,127,85,28,21,26,6,0
71900,1054,453,601,183,183,107,35,541,279,262,79,82,31,32,0
71901,450,227,223,53,36,48,12,2038,1059,979,262,237,208,100,0
71902,346,174,172,36,43,21,9,516,245,271,82,84,70,26,0
71903,665,341,324,109,79,38,22,261,162,99,24,21,14,10,0
71904,206,96,110,33,25,8,6,218,115,103,37,33,33,9,0
71905,203,80,123,40,37,20,3,285,146,139,41,41,48,13,0
71906,442,254,188,46,22,40,19,373,189,184,54,46,50,23,0
71907,496,274,222,57,43,75,22,323,171,152,48,41,40,16,0
71908,1068,434,634,173,160,61,29,925,439,486,141,134,105,46,0
71909,330,77,253,86,52,20,12,137,72,65,27,13,15,8,0
71910,169,64,105,23,37,11,3,330,166,164,55,51,36,16,0
71911,496,209,287,112,55,71,14,947,482,465,143,107,89,37,0
71912,426,213,213,60,56,46,24,749,384,365,108,105,86,31,0
71913,1199,589,610,189,128,167,65,465,252,213,73,58,60,18,0
71914,496,210,286,112,55,71,14,1101,626,475,145,122,120,50,0
71915,291,131,160,49,35,32,15,198,86,112,36,27,23,9,0
71916,125,46,79,24,16,12,2,332,180,152,44,36,27,13,0
71917,949,466,483,125,126,101,50,346,196,150,43,26,27,14,0
71918,1342,640,702,187,163,123,57,524,300,223,70,54,51,25,0
71919,421,237,184,47,54,45,10,103,59,44,25,2,13,6,0
71920,161,99,62,15,22,9,7,180,95,85,22,21,17,8,0
71921,374,202,172,58,40,41,7,354,183,171,54,43,49,8,0
71922,385,203,182,47,43,51,21,978,536,442,132,107,67,32,0
71923,733,438,295,95,79,67,32,744,385,359,105,96,57,31,0
71924,881,492,389,87,97,59,51,132,61,71,22,21,15,3,0
71925,1099,491,608,163,141,107,62,137,85,52,15,11,11,2,0
71926,1531,649,882,108,122,93,72,325,172,153,44,34,27,14,0
71927,473,212,261,72,64,45,28,497,257,240,71,63,62,16,0
71928,431,202,229,57,50,50,25,756,348,408,101,103,60,40,0
71929,530,259,271,83,50,54,41,1248,584,664,184,164,155,67,0
71930,437,212,225,66,44,44,11,338,169,169,53,44,39,21,0
71931,653,379,274,89,56,86,13,251,143,108,47,25,29,11,0
71932,160,53,107,31,29,13,3,392,155,237,68,61,34,16,0
71933,362,181,181,67,46,43,8,323,168,155,51,41,38,12,0
71934,502,236,266,66,66,58,17,384,212,172,44,43,34,14,0
71935,287,124,163,52,48,24,16,279,106,173,48,35,41,39,0
71936,346,168,178,36,43,20,9,1755,905,850,214,196,183,79,0
71937,519,259,260,86,78,59,22,72,34,38,8,2,3,12,0
71938,667,366,301,96,55,84,25,975,400,575,160,162,62,31,0
71939,175,91,84,22,18,11,20,353,200,153,43,18,49,27,0
71940,410,188,222,53,52,31,14,373,181,192,54,35,44,20,0
71941,207,93,114,20,33,19,10,378,154,224,74,84,35,22,0
71942,127,54,73,31,10,11,3,360,180,180,57,48,39,12,0
71943,526,228,298,69,64,32,30,89,38,51,14,6,3,9,0
71944,1849,931,918,245,220,158,90,89,42,47,16,12,15,6,0
71945,795,384,411,133,109,85,38,220,107,113,36,35,28,9,0
71946,312,173,139,43,47,28,6,424,179,245,65,67,29,11,0
71947,431,199,232,59,54,40,17,127,64,63,26,8,12,8,0
71948,416,207,209,63,47,56,15,469,225,244,64,68,25,11,0
71949,242,104,138,41,33,37,8,660,332,328,84,73,47,19,0
71950,900,434,466,134,97,86,36,1262,653,609,169,165,152,50,0
71951,733,438,295,95,79,67,32,270,130,140,48,44,37,12,0
71952,255,126,129,41,37,13,5,501,257,244,75,57,48,29,0
71953,881,492,389,87,97,59,51,339,175,164,51,49,37,9,0
71954,873,366,507,127,125,75,21,199,105,94,27,27,28,9,0
71955,480,267,213,49,44,70,21,139,68,71,14,26,14,9,0
71956,502,274,228,64,49,75,17,334,182,152,45,41,27,13,0
71957,221,111,110,42,35,33,6,238,91,147,68,19,22,7,0
71958,685,393,292,75,66,113,16,245,131,114,30,27,18,13,0
71959,483,236,247,82,60,43,18,792,398,394,109,96,90,39,0
71960,543,265,278,52,37,54,19,188,101,87,20,18,20,14,0
71961,71,28,43,15,9,5,2,373,189,184,54,46,50,23,0
71962,532,291,241,83,36,79,25,335,170,165,52,36,47,11,0
71963,603,311,292,102,71,66,23,194,94,100,33,28,14,7,0
71964,376,171,205,45,45,34,12,198,86,112,36,27,23,9,0
71965,376,249,127,47,23,43,16,858,461,397,125,114,79,45,0
71966,357,182,175,49,36,39,15,98,49,49,14,15,9,2,0
71967,772,417,355,118,92,80,23,535,301,234,63,48,47,27,0
71968,464,237,227,64,66,33,12,592,249,343,91,90,50,42,0
71969,574,284,290,64,50,65,20,1241,619,622,183,169,155,59,0
71970,1867,973,894,256,222,194,65,673,313,360,102,101,46,17,0
71971,627,237,390,137,57,108,44,715,345,370,110,97,64,25,0
71972,1759,838,921,269,212,191,92,1182,591,591,155,139,83,46,0
71973,142,60,82,20,28,13,5,386,207,179,43,48,44,19,0
71974,887,439,448,137,99,91,38,671,321,350,95,87,75,34,0
71975,524,361,163,41,8,28,16,509,267,242,79,81,38,20,0
71976,193,110,83,18,20,15,12,663,360,303,87,82,80,35,0
71977,853,400,453,137,109,88,42,1698,875,823,222,219,173,64,0
71978,313,158,155,43,35,43,16,467,240,227,65,65,51,23,0
71979,580,281,299,95,60,74,29,598,333,265,79,66,54,33,0
71980,496,209,287,113,55,72,14,266,146,120,41,28,31,7,0
71981,332,172,160,50,33,35,9,156,90,66,17,22,11,10,0
71982,417,176,241,75,61,51,20,663,360,303,87,82,80,35,0
71983,297,182,115,41,22,23,8,137,78,59,22,16,17,4,0
71984,584,340,244,77,60,47,25,1922,923,999,267,275,215,90,0
71985,202,113,89,16,27,21,11,102,51,51,12,15,12,3,0
71986,371,209,162,46,17,36,19,160,76,84,19,24,8,5,0
71987,465,305,160,40,47,34,9,317,161,156,40,49,41,11,0
71988,615,308,307,83,75,58,32,134,72,62,14,28,8,4,0
71989,310,141,169,36,38,20,8,134,72,62,14,28,8,4,0
71990,128,67,61,29,9,9,1,858,398,460,126,138,75,39,0
71991,594,321,273,98,59,57,23,551,226,325,96,103,43,11,0
71992,334,155,179,47,34,38,11,285,143,142,45,32,21,17,0
71993,425,199,226,54,71,56,11,317,161,156,40,49,41,11,0
71994,733,382,351,126,92,93,27,414,203,211,58,56,48,14,0
71995,395,189,206,63,50,49,28,662,312,350,103,104,59,20,0
71996,350,172,178,61,45,32,13,169,84,85,29,19,21,7,0
71997,798,287,511,126,125,77,26,153,80,73,26,18,19,4,0
71998,2062,706,1356,414,368,158,63,514,262,252,78,58,54,26,0
71999,106,43,63,28,13,8,1,331,180,151,46,35,47,17,0
72000,546,278,268,94,60,32,22,548,273,275,84,81,64,30,0
72001,933,456,477,123,108,83,29,601,278,323,124,87,65,21,0
72002,270,131,139,47,37,41,11,403,184,219,75,51,47,20,0
72003,530,259,271,83,50,54,41,943,463,480,91,144,70,30,0
72004,437,212,225,66,44,44,11,661,325,336,81,75,65,28,0
72005,2063,1024,1039,175,117,80,97,332,180,152,46,36,28,14,0
72006,335,148,187,52,26,51,12,583,321,262,73,67,45,25,0
72007,407,164,243,88,42,40,22,555,282,273,82,69,65,21,0
72008,1217,647,570,142,160,129,45,630,321,309,86,90,57,26,0
72009,410,200,210,60,54,46,19,1265,689,576,169,177,128,60,0
72010,1007,353,654,277,147,70,26,597,300,297,96,89,68,29,0
72011,1121,458,663,158,210,76,47,478,254,224,67,74,56,28,0
72012,331,169,162,40,28,22,14,377,184,193,50,43,33,17,0
72013,959,496,463,144,132,75,35,565,237,328,75,88,32,11,0
72014,251,139,112,41,18,27,11,504,272,232,75,57,53,19,0
72015,226,120,106,68,8,2,1,165,90,75,36,18,20,6,0
72016,575,305,270,74,87,73,25,889,505,384,107,97,99,30,0
72017,520,240,280,87,63,67,16,344,190,154,34,31,36,10,0
72018,127,62,65,13,33,7,6,103,44,59,16,17,9,5,0
72019,1117,422,695,182,134,88,32,873,366,507,127,125,75,21,0
72020,820,333,487,202,152,59,23,132,67,65,24,21,8,10,0
72021,867,415,452,123,87,62,27,531,277,254,82,75,33,22,0
72022,1759,838,921,269,212,191,92,225,114,111,32,29,26,6,0
72023,332,170,162,44,38,39,10,220,107,113,36,35,28,9,0
72024,422,207,215,79,38,53,23,483,287,196,71,50,54,17,0
72025,443,212,231,74,24,60,24,246,125,121,38,36,30,11,0
72026,480,232,248,73,40,44,30,145,77,68,26,7,15,8,0
72027,805,338,467,153,138,99,55,252,130,122,45,23,32,11,0
72028,291,131,160,49,35,32,15,300,148,152,45,43,40,8,0
72029,433,188,245,63,45,26,14,158,71,87,23,21,17,12,0
72030,313,148,165,45,33,36,11,308,146,162,42,39,24,12,0
72031,540,252,288,73,67,57,20,194,94,100,33,28,14,7,0
72032,1007,353,654,277,147,70,26,98,49,49,14,15,9,2,0
72033,339,170,169,32,17,24,13,479,215,264,67,80,46,28,0
72034,202,113,89,16,27,21,11,130,67,63,24,10,12,4,0
72035,2442,1193,1249,278,183,170,145,1065,581,484,134,97,76,46,0
72036,184,93,91,26,25,14,11,277,144,133,42,30,41,8,0
72037,272,94,178,76,33,19,4,336,200,136,34,29,25,24,0
72038,2799,1324,1475,369,371,215,124,487,252,235,79,58,55,26,0
72039,260,138,122,44,30,28,6,390,190,200,66,50,43,12,0
72040,372,189,183,60,44,41,18,283,160,123,25,20,37,9,0
72041,301,150,151,45,47,33,13,270,130,140,48,44,37,12,0
72042,193,107,86,13,20,13,6,350,196,154,52,37,21,14,0
72043,139,64,75,18,17,18,4,274,142,132,33,34,18,14,0
72044,1594,660,934,251,272,117,77,251,143,108,47,25,29,11,0
72045,584,297,287,89,80,65,17,515,276,239,62,59,43,31,0
72046,532,291,241,83,36,79,25,107,77,30,7,2,9,5,0
72047,243,100,143,58,50,24,5,374,212,162,48,40,32,23,0
72048,392,221,171,53,30,25,8,260,133,127,43,32,39,3,0
72049,503,260,243,46,56,33,16,188,88,100,53,12,15,6,0
72050,458,210,248,39,38,25,16,396,213,183,68,44,47,18,0
72051,956,450,506,122,117,82,36,89,42,47,16,12,15,6,0
72052,450,227,223,53,36,48,12,403,184,219,75,51,47,20,0
72053,760,405,355,112,95,92,29,419,233,186,54,53,55,17,0
72054,259,119,140,48,28,29,19,889,505,384,107,97,99,30,0
72055,134,60,74,19,13,10,7,294,146,148,50,45,51,15,0
72056,272,141,131,45,29,36,9,583,280,303,95,66,76,25,0
72057,1417,598,819,223,188,135,58,862,426,436,113,115,84,37,0
72058,548,310,238,72,62,54,13,91,42,49,21,9,8,3,0
72059,960,409,551,166,134,77,44,621,310,311,100,106,77,27,0
72060,375,167,208,55,83,44,9,597,269,328,102,84,69,24,0
72061,126,56,70,31,10,10,3,2542,1245,1297,285,287,170,84,0
72062,338,164,174,45,32,37,13,929,459,470,140,120,94,45,0
72063,615,308,307,83,75,58,32,332,173,159,48,40,31,11,0
72064,960,409,551,166,134,77,44,132,67,65,24,21,8,10,0
72065,1360,644,716,213,194,136,62,1507,737,770,188,228,147,71,0
72066,625,283,342,93,89,67,25,312,165,147,41,39,29,16,0
72067,395,189,206,63,50,49,28,555,282,273,82,69,65,21,0
72068,548,250,298,85,64,56,21,517,295,222,69,62,40,28,0
72069,502,250,252,70,47,57,15,329,194,135,45,32,33,9,0
72070,416,207,209,63,47,56,15,276,149,127,34,31,32,10,0
72071,441,218,223,69,55,50,27,132,61,71,22,21,15,3,0
72072,629,374,255,74,53,87,27,277,152,125,31,35,22,19,0
72073,126,57,69,31,10,10,3,73,35,38,14,10,9,4,0
72074,207,93,114,20,33,19,10,145,77,68,26,7,15,8,0
72075,368,201,167,61,38,38,12,545,269,276,80,76,27,32,0
72076,760,322,438,81,130,57,19,307,132,175,48,53,26,10,0
72077,178,74,104,31,28,9,4,425,177,248,60,62,33,16,0
72078,317,167,150,45,21,30,26,354,188,166,46,40,34,10,0
72079,161,75,86,24,20,10,7,447,212,235,86,55,58,21,0
72080,260,120,140,34,39,36,12,375,176,199,48,61,40,12,0
72081,478,220,258,47,70,41,10,380,211,169,47,37,33,21,0
72082,436,201,235,54,37,35,18,555,282,273,82,69,65,21,0
72083,1395,595,800,223,206,113,61,225,129,96,32,33,20,8,0
72084,126,57,69,31,10,10,3,1004,457,547,150,150,74,52,0
72085,176,74,102,20,29,7,7,520,244,276,91,60,68,20,0
72086,300,136,164,45,35,45,14,497,257,240,71,63,62,16,0
72087,320,163,157,44,44,26,15,175,82,93,33,26,17,5,0
72088,784,351,433,118,87,73,41,102,51,51,12,15,12,3,0
72089,733,438,295,95,79,67,32,163,79,84,22,24,13,5,0
72090,124,58,66,20,28,11,7,1698,875,823,222,219,173,64,0
72091,270,166,104,30,26,28,14,346,196,150,43,26,27,14,0
72092,498,274,224,58,59,50,18,104,46,58,15,17,9,5,0
72093,1447,698,749,214,180,116,46,403,184,219,75,51,47,20,0
72094,1068,434,634,173,160,61,29,295,158,137,42,34,38,14,0
72095,249,104,145,47,41,24,17,1154,489,665,200,196,95,54,0
72096,470,256,214,56,39,47,34,737,320,417,112,94,73,34,0
72097,361,183,178,50,54,51,22,397,234,163,44,38,23,21,0
72098,346,173,173,50,56,31,14,278,154,124,42,32,38,7,0
72099,1054,497,557,190,168,107,45,601,279,322,81,65,27,12,0
72100,561,282,279,68,62,36,14,449,252,197,61,52,36,18,0
72101,261,126,135,41,36,24,11,123,61,62,17,18,17,7,0
72102,480,267,213,49,44,70,21,108,59,49,17,13,12,5,0
72103,524,270,254,84,72,70,23,381,187,194,37,49,36,17,0
72104,129,70,59,29,9,7,2,727,362,365,123,107,63,23,0
72105,643,284,359,129,71,84,43,508,253,255,73,60,50,13,0
72106,440,267,173,52,29,42,12,520,272,248,60,65,58,22,0
72107,538,263,275,71,85,44,18,744,385,359,105,96,57,31,0
72108,265,165,100,32,19,27,5,297,164,133,45,39,40,9,0
72109,2236,1195,1041,227,187,186,118,671,306,365,114,76,49,19,0
72110,609,292,317,102,96,64,21,199,105,94,27,27,28,9,0
72111,1054,497,557,190,168,107,45,541,279,262,79,82,31,32,0
72112,743,377,366,87,74,68,30,843,391,452,139,104,91,35,0
72113,128,69,59,29,9,8,1,729,358,371,116,99,89,33,0
72114,172,98,74,20,21,22,8,584,249,335,80,96,22,13,0
72115,604,239,365,124,63,84,37,630,321,309,86,90,57,26,0
72116,1217,647,570,142,160,129,45,396,197,199,75,49,49,16,0
72117,764,277,487,158,162,64,31,462,251,211,74,53,41,18,0
72118,546,278,268,94,60,32,22,620,324,296,81,68,66,31,0
72119,557,211,346,129,125,48,19,515,276,239,62,59,43,31,0
72120,808,366,442,130,133,66,31,341,170,171,41,66,27,10,0
72121,306,172,134,35,31,37,18,192,110,82,33,21,10,3,0
72122,328,156,172,44,37,44,15,504,272,232,75,57,53,19,0
72123,682,260,422,98,83,42,31,557,281,276,80,59,43,21,0
72124,255,126,129,41,37,13,5,72,33,39,8,2,3,12,0
72125,346,186,160,40,37,34,21,406,202,204,54,51,63,21,0
72126,1214,498,716,197,180,121,65,549,273,276,74,68,72,24,0
72127,350,212,138,32,26,40,13,427,251,176,51,39,25,22,0
72128,704,342,362,113,91,85,33,260,131,129,42,31,40,9,0
72129,577,342,235,63,57,23,37,609,335,274,79,57,45,22,0
72130,127,54,73,31,10,11,3,535,301,234,63,48,47,27,0
72131,142,60,82,20,28,13,5,633,311,322,94,82,45,20,0
72132,161,94,67,23,13,8,10,1378,692,686,194,174,105,56,0
72133,351,166,185,48,61,24,15,173,90,83,30,19,19,11,0
72134,580,265,315,97,89,79,17,775,407,368,122,100,97,32,0
72135,500,257,243,60,55,27,22,710,375,335,95,94,110,28,0
72136,4640,2231,2409,660,549,437,245,293,142,151,49,40,42,17,0
72137,520,261,259,74,52,49,22,295,158,137,42,34,38,14,0
72138,1208,575,633,187,204,117,41,963,525,438,119,102,102,34,0
72139,714,260,454,140,97,120,54,103,50,53,19,10,7,5,0
72140,607,305,302,92,89,74,23,286,152,134,38,38,32,11,0
72141,580,240,340,108,81,59,22,508,261,247,65,53,58,23,0
72142,501,230,271,63,90,50,18,929,459,470,140,120,94,45,0
72143,224,108,116,33,26,32,10,54,26,28,11,4,3,3,0
72144,1327,520,807,241,174,141,60,285,143,142,45,32,21,17,0
72145,594,248,346,104,109,53,5,381,186,195,69,55,46,15,0
72146,466,199,267,86,59,32,17,367,199,168,62,44,34,8,0
72147,533,300,233,74,50,74,17,218,118,100,33,30,25,11,0
72148,255,126,129,41,37,13,5,87,51,35,15,9,9,4,0
72149,860,349,511,166,166,58,19,320,168,152,38,42,24,18,0
72150,412,146,266,106,38,67,35,135,57,78,21,20,9,11,0
72151,485,246,239,74,48,47,22,414,203,211,58,56,48,14,0
72152,1235,584,651,140,226,82,52,1698,875,823,222,219,173,64,0
72153,1709,650,1059,338,286,185,46,392,155,237,68,61,34,16,0
72154,1441,504,937,264,329,69,46,296,140,156,49,40,42,19,0
72155,312,164,148,54,29,25,15,296,140,156,49,40,42,19,0
72156,393,223,170,44,36,32,14,417,232,185,58,50,29,21,0
72157,450,241,209,67,58,54,23,308,129,179,44,60,19,8,0
72158,894,448,446,123,100,82,30,384,204,180,53,47,49,17,0
72159,302,160,142,35,35,37,10,545,269,276,80,76,27,32,0
72160,437,228,209,47,61,26,11,508,262,246,66,67,51,20,0
72161,479,227,252,69,48,46,18,673,313,360,102,101,46,17,0
72162,471,221,250,87,68,42,25,811,361,450,124,107,80,31,0
72163,335,155,180,64,48,36,10,415,203,212,77,44,49,18,0
72164,51,10,41,25,0,5,8,296,151,145,45,42,32,11,0
72165,1505,680,825,202,204,73,32,418,223,195,53,43,49,15,0
72166,504,222,282,71,64,53,29,391,189,202,55,56,56,12,0
72167,301,119,182,53,47,14,20,699,334,365,108,80,70,20,0
72168,453,240,213,53,33,44,16,283,142,141,41,33,26,18,0
72169,257,148,109,28,20,21,14,316,159,157,38,48,30,11,0
72170,952,547,405,95,90,127,35,607,293,314,98,71,62,32,0
72171,510,288,222,44,36,24,7,251,143,108,47,25,29,11,0
72172,161,99,62,15,22,9,7,1241,619,622,183,169,155,59,0
72173,126,57,69,31,10,10,3,1249,638,611,166,153,141,45,0
72174,546,278,268,94,60,32,22,583,321,262,73,67,45,25,0
72175,346,186,160,40,37,34,21,601,279,322,81,65,27,12,0
72176,385,203,182,47,43,51,21,336,200,136,34,29,25,24,0
72177,646,304,342,104,93,58,26,729,358,371,116,99,89,33,0
72178,407,164,243,88,42,40,22,1241,619,622,183,169,155,59,0
72179,257,122,135,44,19,21,16,136,65,71,26,11,7,5,0
72180,478,220,258,47,70,41,10,286,152,134,38,38,32,11,0
72181,526,228,298,69,64,32,30,811,361,450,124,107,80,31,0
72182,641,349,292,92,60,39,24,483,215,268,66,70,30,16,0
72183,673,317,356,101,85,76,49,572,305,267,74,72,58,21,0
72184,1755,849,906,245,226,148,56,389,207,182,53,58,52,18,0
72185,150,64,86,22,12,29,12,244,143,101,31,29,26,8,0
72186,840,411,429,122,101,79,34,271,150,121,39,36,37,5,0
72187,743,366,377,41,37,26,14,593,289,304,85,69,48,19,0
72188,249,104,145,47,41,24,17,715,345,370,110,97,64,25,0
72189,746,312,434,129,115,77,47,741,383,358,92,63,79,36,0
72190,150,60,90,27,16,6,3,374,202,172,50,39,31,24,0
72191,1556,718,838,280,182,161,49,279,161,118,37,32,7,7,0
72192,451,225,226,69,57,64,22,128,63,65,30,11,13,8,0
72193,894,448,446,123,100,82,30,293,142,151,49,40,42,17,0
72194,743,366,377,41,37,26,14,445,192,253,86,58,53,18,0
72195,142,76,66,21,21,22,11,508,262,246,66,67,51,20,0
72196,1023,449,574,141,174,76,43,582,264,318,84,60,58,23,0
72197,466,259,207,59,50,83,12,723,363,360,107,106,52,14,0
72198,682,292,390,89,69,58,20,286,160,126,37,27,23,10,0
72199,1148,472,676,229,164,86,37,1214,475,739,177,250,89,49,0
72200,1014,488,526,178,137,94,39,400,187,213,56,59,42,20,0
72201,299,128,171,57,40,13,25,309,159,150,47,43,43,13,0
72202,435,230,205,51,37,55,18,384,212,172,44,43,34,14,0
72203,840,411,429,122,101,79,34,531,261,270,73,80,68,26,0
72204,126,58,68,31,10,10,3,386,181,205,55,51,57,31,0
72205,271,110,161,33,27,11,8,350,196,154,52,37,21,14,0
72206,758,378,380,89,64,37,31,257,126,131,61,24,22,8,0
72207,508,136,372,157,91,22,9,359,171,188,49,74,45,11,0
72208,260,138,122,44,30,28,6,212,127,85,28,21,26,6,0
72209,407,230,177,44,39,34,19,654,295,359,99,88,71,25,0
72210,126,57,69,31,10,10,3,218,115,103,32,32,34,11,0
72211,146,75,71,13,32,15,11,132,61,71,19,20,14,6,0
72212,418,163,255,57,54,38,24,89,42,47,16,12,15,6,0
72213,126,57,69,31,10,10,3,229,120,109,31,30,22,9,0
72214,517,245,272,92,77,46,24,341,170,171,41,66,27,10,0
72215,446,265,181,51,35,27,17,627,289,338,101,73,62,43,0
72216,496,209,287,113,55,72,14,250,116,134,41,30,33,19,0
72217,193,105,88,33,16,9,4,518,292,226,60,60,52,21,0
72218,403,176,227,71,56,51,11,492,278,214,65,58,32,11,0
72219,556,306,250,69,60,80,18,144,67,77,28,14,9,8,0
72220,130,70,60,30,9,8,1,373,189,184,54,46,50,23,0
72221,1120,436,684,208,120,101,115,169,85,84,21,14,9,9,0
72222,227,120,107,31,28,28,13,292,143,149,38,42,36,16,0
72223,178,74,104,31,28,9,4,481,223,258,71,70,49,26,0
72224,126,56,70,31,10,10,3,720,361,359,98,98,70,37,0
72225,627,237,390,137,57,108,44,325,172,153,44,34,27,14,0
72226,181,92,89,34,22,17,9,385,212,173,57,40,39,21,0
72227,215,117,98,28,19,15,8,455,229,226,66,62,63,29,0
72228,432,190,242,85,82,28,11,305,161,144,39,40,44,17,0
72229,335,183,152,40,26,54,22,1248,584,664,184,164,155,67,0
72230,802,430,372,65,102,87,23,158,71,87,23,21,17,12,0
72231,885,424,461,143,114,92,32,275,155,120,37,31,16,14,0
72232,772,332,440,136,104,72,28,972,471,501,152,138,112,40,0
72233,498,274,224,58,59,50,18,978,536,442,132,107,67,32,0
72234,3230,1724,1506,361,358,157,75,665,361,304,87,91,84,31,0
72235,315,174,141,46,38,47,16,124,69,55,14,7,9,4,0
72236,960,409,551,166,134,77,44,334,182,152,45,41,27,13,0
72237,503,260,243,46,56,33,16,375,211,164,50,36,31,23,0
72238,538,263,275,71,85,44,18,366,204,162,47,41,31,23,0
72239,519,259,260,86,78,59,22,196,105,91,40,13,19,10,0
72240,129,70,59,29,9,7,2,548,273,275,84,81,64,30,0
72241,616,304,312,75,71,55,25,1321,653,668,186,195,70,35,0
72242,1755,849,906,245,226,148,56,390,223,167,58,36,45,18,0
72243,692,305,387,100,97,78,30,664,350,314,86,90,82,36,0
72244,385,179,206,58,56,38,19,332,173,159,48,40,31,11,0
72245,3703,1708,1995,456,428,305,162,1338,720,618,179,145,141,85,0
72246,594,321,273,98,59,57,23,403,184,219,75,51,47,20,0
72247,106,43,63,28,13,8,1,381,186,195,69,55,46,15,0
72248,1970,978,992,245,206,198,80,453,247,206,58,53,45,20,0
72249,575,295,280,89,68,54,18,400,187,213,56,59,42,20,0
72250,598,300,298,68,77,59,21,316,159,157,38,48,30,11,0
72251,346,208,138,46,39,51,18,773,389,384,119,91,79,26,0
72252,550,304,246,60,64,77,16,630,321,309,86,90,57,26,0
72253,413,206,207,38,55,19,10,188,93,95,33,18,16,10,0
72254,1098,519,579,182,159,79,42,873,366,507,127,125,75,21,0
72255,485,183,302,79,81,73,33,292,143,149,38,42,36,16,0
72256,164,77,87,33,19,6,7,2724,1157,1567,269,518,239,77,0
72257,505,282,223,60,57,66,23,403,225,178,56,38,33,25,0
72258,557,211,346,129,125,48,19,198,86,112,36,27,23,9,0
72259,648,376,272,70,60,73,24,334,182,152,45,41,27,13,0
72260,341,154,187,34,36,11,11,469,225,244,64,68,25,11,0
72261,429,227,202,49,51,46,26,360,180,180,57,48,39,12,0
72262,521,289,232,71,58,49,16,778,391,387,94,77,41,33,0
72263,308,163,145,38,33,30,20,556,290,266,75,74,29,24,0
72264,364,204,160,65,35,15,13,131,55,76,28,9,14,12,0
72265,704,342,362,113,91,85,33,562,273,289,76,92,45,24,0
72266,317,167,150,45,21,30,26,194,94,100,33,28,14,7,0
72267,674,268,406,118,96,70,21,548,296,252,71,74,43,28,0
72268,488,237,251,79,78,65,27,689,343,346,105,102,81,35,0
72269,441,216,225,57,66,57,19,1040,564,476,134,110,114,51,0
72270,653,379,274,89,56,86,13,783,406,377,102,91,57,29,0
72271,1759,838,921,269,212,191,92,295,160,135,42,37,46,16,0
72272,559,217,342,105,86,42,16,180,115,65,17,12,9,9,0
72273,410,208,202,59,58,43,26,561,279,282,85,81,88,24,0
72274,533,297,236,74,57,39,28,445,264,181,35,35,34,14,0
72275,215,80,135,54,56,21,9,900,441,459,125,127,110,32,0
72276,733,382,351,126,92,93,27,419,233,186,54,53,55,17,0
72277,232,134,98,28,20,20,5,277,145,132,41,32,22,10,0
72278,500,245,255,66,57,52,27,488,237,251,79,78,65,27,0
72279,543,265,278,52,37,54,19,366,204,162,47,41,31,23,0
72280,285,148,137,31,42,42,16,455,229,226,66,62,63,29,0
72281,83,45,38,11,8,8,3,2225,1244,981,271,243,217,93,0
72282,468,233,235,65,61,49,34,732,402,330,81,86,87,33,0
72283,501,230,271,63,90,50,18,953,489,464,126,104,111,44,0
72284,1130,614,516,129,138,98,42,231,126,105,28,26,34,9,0
72285,928,442,486,139,118,91,43,609,335,274,79,57,45,22,0
72286,837,381,456,123,109,65,25,374,181,193,55,58,48,23,0
72287,234,110,124,39,29,23,2,925,439,486,141,134,105,46,0
72288,1009,478,531,166,126,96,42,602,310,292,87,66,70,36,0
72289,786,378,408,106,98,77,39,710,375,335,95,94,110,28,0
72290,869,489,380,110,77,79,29,565,237,328,75,88,32,11,0
72291,1341,481,860,275,264,57,21,252,130,122,45,23,32,11,0
72292,221,75,146,68,21,16,5,889,505,384,107,97,99,30,0
72293,169,64,105,23,37,11,3,1500,804,696,190,172,144,60,0
72294,595,339,256,64,36,54,24,316,166,150,45,38,37,13,0
72295,1498,731,767,220,175,148,68,283,160,123,25,20,37,9,0
72296,366,190,176,39,62,55,14,621,310,311,100,106,77,27,0
72297,664,269,395,117,107,36,15,132,61,71,19,20,14,6,0
72298,1120,436,684,208,120,101,115,290,147,143,34,34,39,13,0
72299,260,133,127,43,29,34,11,403,192,211,102,39,49,15,0
72300,1163,417,746,209,145,87,28,194,94,100,33,28,14,7,0
72301,5890,3314,2576,970,956,293,265,1062,522,540,151,147,105,66,0
72302,1001,422,579,185,180,51,32,418,246,172,52,39,57,10,0
72303,249,104,145,47,41,24,17,180,89,91,28,27,18,7,0
72304,350,190,160,48,25,27,18,715,345,370,110,97,64,25,0
72305,357,182,175,49,36,39,15,285,146,139,41,41,48,13,0
72306,298,167,131,47,33,40,8,437,228,209,47,61,26,11,0
72307,429,227,202,49,51,46,26,1382,508,874,334,320,98,36,0
72308,1163,417,746,209,145,87,28,601,279,322,81,65,27,12,0
72309,346,208,138,46,39,51,18,262,129,133,40,41,31,10,0
72310,132,66,66,21,18,11,7,276,149,127,34,31,32,10,0
72311,1143,574,569,176,151,123,59,136,65,71,26,11,7,5,0
72312,664,269,395,117,107,36,15,250,119,131,58,26,29,7,0
72313,117,57,60,17,14,11,10,1698,875,823,222,219,173,64,0
72314,125,53,72,18,21,18,12,227,130,97,32,25,22,12,0
72315,1257,464,793,221,264,75,37,520,244,276,91,60,68,20,0
72316,320,183,137,51,18,38,8,378,154,224,74,84,35,22,0
72317,498,274,224,58,59,50,18,935,515,420,126,107,73,32,0
72318,462,258,204,59,41,56,15,480,255,225,67,64,50,22,0
72319,446,195,251,56,53,31,15,406,223,183,61,53,46,17,0
72320,503,260,243,46,56,33,16,551,226,325,96,103,43,11,0
72321,565,264,301,101,73,72,15,453,247,206,58,53,45,20,0
72322,146,73,73,18,24,17,9,862,426,436,113,115,84,37,0
72323,126,56,70,31,10,10,3,385,212,173,57,40,39,21,0
72324,362,174,188,46,55,35,23,866,478,388,121,101,101,26,0
72325,540,252,288,73,67,57,20,395,169,226,73,55,38,9,0
72326,311,154,157,47,29,34,13,479,215,264,67,80,46,28,0
72327,1439,713,726,195,180,110,34,346,178,168,58,41,33,12,0
72328,377,171,206,46,59,22,6,259,151,108,39,18,23,11,0
72329,375,167,208,55,83,44,9,551,226,325,96,103,43,11,0
72330,1257,464,793,221,264,75,37,598,333,265,79,66,54,33,0
72331,800,416,384,102,105,83,22,261,148,113,31,28,14,10,0
72332,1220,575,645,208,179,99,56,277,152,125,31,35,22,19,0
72333,329,171,158,49,41,31,10,329,196,133,41,36,31,15,0
72334,280,128,152,39,37,38,18,701,380,321,94,84,96,34,0
72335,427,191,236,67,60,41,34,374,181,193,55,58,48,23,0
72336,426,213,213,60,56,46,24,349,200,149,41,39,30,20,0
72337,464,237,227,64,66,33,12,397,234,163,44,38,23,21,0
72338,450,227,223,53,36,48,12,744,385,359,105,96,57,31,0
72339,398,186,212,76,70,18,13,963,525,438,119,102,102,34,0
72340,411,211,200,61,46,35,18,535,311,224,66,52,49,24,0
72341,524,262,262,62,72,39,49,966,478,488,108,144,74,43,0
72342,1463,521,942,252,204,105,52,172,79,93,34,27,23,10,0
72343,331,169,162,40,28,22,14,447,212,235,86,55,58,21,0
72344,598,300,298,68,77,59,21,701,380,321,94,84,96,34,0
72345,488,237,251,79,78,65,27,305,161,144,39,40,44,17,0
72346,220,113,107,37,24,16,7,2547,1280,1267,331,335,293,118,0
72347,729,351,378,111,98,58,18,380,178,202,69,53,37,10,0
72348,125,46,79,24,16,12,2,72,34,38,8,2,3,12,0
72349,708,344,364,106,98,66,33,375,176,199,48,61,40,12,0
72350,341,177,164,57,42,40,18,413,223,190,52,45,53,10,0
72351,368,154,214,80,52,41,16,403,192,211,102,39,49,15,0
72352,3230,1724,1506,361,358,157,75,232,111,121,23,29,17,9,0
72353,539,283,256,75,73,53,26,396,199,197,54,50,45,14,0
72354,347,198,149,45,29,29,8,198,86,112,36,27,23,9,0
72355,317,140,177,43,26,31,16,145,77,68,26,7,15,8,0
72356,227,109,118,42,35,29,8,87,51,35,15,9,9,4,0
72357,236,120,116,32,28,21,11,818,357,461,122,136,54,25,0
72358,172,98,74,20,21,22,8,583,280,303,95,66,76,25,0
72359,161,94,67,23,13,8,10,132,77,55,20,9,13,10,0
72360,525,254,271,60,76,46,13,497,257,240,71,63,62,16,0
72361,862,384,478,127,110,75,42,579,285,294,78,72,64,32,0
72362,449,179,270,80,77,49,29,619,305,314,85,93,71,29,0
72363,579,321,258,74,70,47,22,963,525,438,119,102,102,34,0
72364,320,163,157,44,44,26,15,279,142,137,43,39,28,7,0
72365,785,351,434,136,93,71,37,1214,475,739,177,250,89,49,0
72366,288,140,148,59,33,27,12,166,90,76,27,18,21,5,0
72367,869,489,380,110,77,79,29,250,119,131,58,26,29,7,0
72368,336,134,202,51,64,27,12,194,106,88,33,10,15,6,0
72369,345,203,142,47,35,31,11,403,184,219,75,51,47,20,0
72370,456,223,233,77,54,47,20,929,459,470,140,120,94,45,0
72371,471,221,250,87,68,42,25,153,65,88,28,21,20,8,0
72372,243,114,129,37,30,32,8,252,130,122,45,23,32,11,0
72373,434,216,218,72,58,40,20,200,99,101,31,24,26,6,0
72374,249,114,135,47,33,25,4,144,67,77,28,14,9,8,0
72375,949,467,482,126,127,102,51,704,355,349,113,94,71,24,0
72376,1342,640,702,187,163,123,57,727,388,339,102,87,70,29,0
72377,619,289,330,67,77,36,19,497,257,240,71,63,62,16,0
72378,752,313,439,121,106,68,27,111,60,51,17,23,10,7,0
72379,340,181,159,44,39,35,21,142,73,69,27,9,15,11,0
72380,394,207,187,52,42,37,24,1338,720,618,179,145,141,85,0
72381,416,207,209,63,47,56,15,325,159,166,59,46,30,12,0
72382,285,148,137,31,42,42,16,106,41,65,36,6,11,7,0
72383,193,95,98,33,17,25,17,328,195,133,39,40,27,13,0
72384,919,444,475,141,148,62,20,935,515,420,126,107,73,32,0
72385,127,48,79,27,20,6,5,1101,626,475,145,122,120,50,0
72386,347,181,166,27,20,12,12,339,175,164,51,49,37,9,0
72387,412,146,266,106,38,67,35,180,95,85,22,21,17,8,0
72388,496,210,286,112,55,72,13,282,134,148,38,45,29,10,0
72389,413,169,244,66,94,28,19,142,65,77,30,17,22,9,0
72390,126,57,69,31,10,10,3,132,61,71,19,20,14,6,0
72391,687,351,336,106,67,70,41,778,391,387,94,77,41,33,0
72392,415,133,282,114,65,27,7,633,311,322,94,82,45,20,0
72393,269,124,145,36,24,32,11,338,169,169,53,44,39,21,0
72394,588,300,288,100,57,65,27,427,251,176,51,39,25,22,0
72395,422,207,215,79,38,53,23,758,319,439,101,123,78,25,0
72396,1341,481,860,275,264,57,21,453,247,206,58,53,45,20,0
72397,426,231,195,51,52,45,24,900,441,459,125,127,110,32,0
72398,745,402,343,95,71,69,40,2225,1244,981,271,243,217,93,0
72399,626,300,326,91,82,68,26,520,272,248,60,65,58,22,0
72400,299,128,171,57,40,13,25,766,386,380,101,81,78,31,0
72401,209,75,134,53,48,20,9,220,107,113,36,35,28,9,0
72402,755,271,484,113,226,61,20,873,411,462,132,107,84,40,0
72403,595,316,279,86,60,65,40,204,96,108,31,37,20,5,0
72404,135,64,71,31,11,8,4,935,515,420,126,107,73,32,0
72405,2174,1057,1117,241,241,214,117,459,260,199,56,42,47,21,0
72406,485,246,239,74,48,47,22,520,244,276,91,60,68,20,0
72407,76,30,46,7,15,1,5,1114,539,575,145,131,94,56,0
72408,680,308,372,82,72,71,40,127,58,69,18,17,10,5,0
72409,300,136,164,45,35,45,14,96,46,50,16,12,7,5,0
72410,215,104,111,61,7,2,1,323,162,161,52,41,39,13,0
72411,136,66,70,33,11,9,5,292,155,137,50,34,29,13,0
72412,755,271,484,113,226,61,20,1500,804,696,190,172,144,60,0
72413,567,256,311,91,81,53,17,478,254,224,67,74,56,28,0
72414,929,410,519,187,146,53,30,405,195,210,57,74,24,17,0
72415,854,435,419,118,91,95,42,286,152,134,38,38,32,11,0
72416,808,366,442,130,133,66,31,173,94,79,18,24,12,7,0
72417,299,151,148,35,34,26,16,287,151,136,51,42,36,7,0
72418,332,173,159,48,42,42,9,292,143,149,38,42,36,16,0
72419,115,62,53,13,10,9,7,2382,1162,1220,237,220,140,49,0
72420,237,127,110,34,30,16,9,88,50,38,13,8,16,4,0
72421,640,279,361,102,83,69,21,328,199,129,39,29,27,14,0
72422,507,314,193,49,45,59,25,131,55,76,28,9,14,12,0
72423,125,46,79,24,16,12,2,975,400,575,160,162,62,31,0
72424,494,242,252,67,47,25,21,737,397,340,87,104,90,14,0
72425,325,177,148,40,24,23,13,375,209,166,50,37,29,23,0
72426,406,208,198,41,26,43,21,1922,923,999,267,275,215,90,0
72427,1755,849,906,245,226,148,56,317,161,156,40,49,41,11,0
72428,123,58,65,22,14,13,3,368,183,185,40,42,40,15,0
72429,613,303,310,70,28,28,18,947,482,465,143,107,89,37,0
72430,275,125,150,37,48,27,7,736,388,348,88,85,67,28,0
72431,594,248,346,104,109,53,5,732,402,330,81,86,87,33,0
72432,291,120,171,63,39,26,6,975,475,500,139,140,119,28,0
72433,350,212,138,32,26,40,13,230,125,105,29,40,20,6,0
72434,142,76,66,21,21,22,11,679,338,341,96,95,40,23,0
72435,1755,849,906,245,226,148,56,403,185,218,67,62,63,19,0
72436,473,217,256,59,44,34,21,699,334,365,108,80,70,20,0
72437,331,144,187,57,46,33,19,276,149,127,34,31,32,10,0
72438,484,264,220,59,62,68,15,437,221,216,62,64,47,13,0
72439,496,209,287,112,55,71,14,230,113,117,31,40,28,10,0
72440,793,355,438,134,117,77,43,317,161,156,40,49,41,11,0
72441,165,66,99,28,32,16,3,929,459,470,140,120,94,45,0
72442,500,245,255,66,57,52,27,429,187,242,79,72,28,19,0
72443,483,236,247,82,60,43,18,1378,692,686,194,174,105,56,0
72444,414,206,208,56,68,35,19,277,144,133,42,30,41,8,0
72445,178,89,89,40,12,18,7,166,102,64,19,14,17,2,0
72446,2414,1189,1225,277,178,170,169,373,213,160,44,33,26,17,0
72447,127,62,65,13,33,7,6,105,51,54,13,17,12,8,0
72448,129,70,59,29,9,7,2,149,52,97,36,36,7,4,0
72449,881,492,389,87,97,59,51,633,311,322,94,82,45,20,0
72450,240,166,74,32,12,8,15,538,274,264,84,67,52,35,0
72451,915,336,579,185,199,56,29,1262,653,609,169,165,152,50,0
72452,519,259,260,86,78,59,22,4646,2328,2318,674,639,475,170,0
72453,406,207,199,56,46,68,19,363,180,183,60,34,10,6,0
72454,553,319,234,56,37,54,18,947,482,465,143,107,89,37,0
72455,257,122,135,44,19,21,16,341,170,171,41,66,27,10,0
72456,411,236,175,39,45,50,30,317,161,156,50,36,47,12,0
72457,376,176,200,31,53,27,8,729,358,371,116,99,89,33,0
72458,494,233,261,87,57,46,18,198,113,85,19,20,26,12,0
72459,1087,523,564,146,177,103,33,400,187,213,56,59,42,20,0
72460,346,168,178,36,43,20,9,783,406,377,102,91,57,29,0
72461,117,57,60,17,14,11,10,392,186,206,62,56,29,15,0
72462,458,226,232,77,59,61,14,156,90,66,17,22,11,10,0
72463,233,107,126,40,40,20,16,188,93,95,33,18,16,10,0
72464,1970,978,992,245,206,198,80,209,119,90,28,24,27,9,0
72465,225,111,114,38,22,25,10,400,187,213,56,59,42,20,0
72466,157,62,95,41,18,10,11,399,190,209,61,41,39,18,0
72467,349,153,196,54,47,28,13,308,146,162,42,39,24,12,0
72468,303,147,156,49,49,20,8,218,115,103,37,33,33,9,0
72469,521,249,272,53,36,50,18,332,180,152,44,36,27,13,0
72470,302,160,142,35,35,37,10,481,223,258,71,70,49,26,0
72471,531,260,271,97,68,47,11,200,89,111,26,25,17,7,0
72472,222,110,112,43,30,14,6,314,177,137,34,40,29,9,0
72473,949,466,483,125,126,101,50,579,285,294,78,72,64,32,0
72474,126,58,68,31,10,10,3,194,109,85,23,24,21,9,0
72475,1556,718,838,280,182,161,49,222,127,95,23,28,22,7,0
72476,397,180,217,61,59,39,13,169,84,85,29,19,21,7,0
72477,362,174,188,46,55,35,23,621,310,311,100,106,77,27,0
72478,411,171,240,61,81,30,15,547,295,252,81,65,57,23,0
72479,67,40,27,10,8,7,6,418,223,195,51,45,49,14,0
72480,546,278,268,94,60,32,22,470,205,265,71,80,33,11,0
72481,136,65,71,33,11,9,6,277,163,114,33,24,21,16,0
72482,241,122,119,27,34,17,16,96,45,51,13,12,6,4,0
72483,472,222,250,46,61,33,23,189,105,84,25,26,21,9,0
72484,758,378,380,89,64,37,31,1314,693,621,174,155,140,58,0
72485,365,210,155,46,30,24,12,598,333,265,79,66,54,33,0
72486,159,105,54,22,9,14,25,188,88,100,53,12,15,6,0
72487,385,179,206,58,56,38,19,1314,693,621,174,155,140,58,0
72488,1647,794,853,279,235,128,65,583,321,262,73,67,45,25,0
72489,222,110,112,43,30,14,6,663,360,303,87,82,80,35,0
72490,432,233,199,52,28,47,18,1004,457,547,150,150,74,52,0
72491,463,170,293,115,54,75,32,559,317,242,58,65,37,23,0
72492,90,54,36,20,4,14,5,528,276,252,86,78,49,17,0
72493,334,190,144,42,42,16,5,748,359,389,125,113,86,31,0
72494,343,189,154,44,24,39,12,2547,1280,1267,331,335,293,118,0
72495,301,157,144,31,28,34,9,811,361,450,124,107,80,31,0
72496,398,186,212,76,70,18,13,975,400,575,160,162,62,31,0
72497,315,170,145,48,56,22,11,660,333,327,102,95,69,31,0
72498,720,357,363,113,85,62,39,298,129,169,51,40,29,8,0
72499,747,469,278,60,41,53,23,929,459,470,140,120,94,45,0
72500,331,144,187,57,46,33,19,376,183,193,50,50,43,21,0
72501,465,305,160,40,47,34,9,557,281,276,80,59,43,21,0
72502,391,203,188,49,34,36,9,647,350,297,95,79,77,29,0
72503,503,260,243,46,56,33,16,337,152,185,49,54,42,21,0
72504,782,372,410,127,111,89,36,1239,659,580,169,148,131,54,0
72505,336,134,202,51,64,27,12,410,197,213,67,43,56,18,0
72506,528,273,255,67,53,29,20,455,229,226,66,62,63,29,0
72507,496,209,287,112,55,71,14,556,290,266,75,74,29,24,0
72508,313,148,165,45,33,36,11,316,166,150,45,38,37,13,0
72509,466,259,207,59,50,83,12,134,72,62,14,28,8,4,0
72510,331,177,154,54,38,27,11,178,99,79,31,19,26,8,0
72511,103,56,47,27,7,8,2,158,71,87,23,21,17,12,0
72512,5890,3314,2576,970,956,293,265,303,138,165,47,46,35,18,0
72513,257,122,135,44,19,21,16,376,183,193,50,50,43,21,0
72514,563,255,308,91,111,42,30,597,300,297,96,89,68,29,0
72515,1121,458,663,158,210,76,47,390,223,167,58,36,45,18,0
72516,286,111,175,51,47,21,12,173,90,83,21,36,12,15,0
72517,413,236,177,41,25,35,19,549,273,276,74,68,72,24,0
72518,282,84,198,60,102,1,6,104,46,58,15,17,9,5,0
72519,206,96,110,33,25,8,6,549,273,276,74,68,72,24,0
72520,1189,653,536,152,118,109,56,1543,794,749,182,152,132,55,0
72521,802,375,427,133,103,81,41,323,171,152,48,41,40,16,0
72522,616,304,312,75,71,55,25,135,65,70,21,25,15,9,0
72523,438,185,253,71,64,52,28,295,160,135,42,37,46,16,0
72524,360,205,155,35,24,52,14,978,536,442,132,107,67,32,0
72525,968,452,516,150,144,79,28,734,340,394,108,99,52,32,0
72526,1544,738,806,239,217,145,91,165,90,75,36,18,20,6,0
72527,270,158,112,35,20,23,7,137,85,52,15,11,11,2,0
72528,349,167,182,54,38,30,28,398,200,198,68,43,51,14,0
72529,107,53,54,15,15,13,4,261,162,99,24,21,14,10,0
72530,257,148,109,28,20,21,14,470,205,265,71,80,33,11,0
72531,411,171,240,61,81,30,15,602,310,292,87,66,70,36,0
72532,867,415,452,123,87,62,27,496,251,245,78,62,61,23,0
72533,508,136,372,157,91,22,9,557,281,276,80,59,43,21,0
72534,461,257,204,63,49,50,29,531,261,270,73,80,68,26,0
72535,496,210,286,112,55,71,14,501,274,227,63,58,53,20,0
72536,211,92,119,33,44,11,7,406,223,183,61,53,46,17,0
72537,531,260,271,97,68,47,11,218,111,107,45,29,24,6,0
72538,238,158,80,28,15,31,7,325,172,153,44,34,27,14,0
72539,1214,612,602,169,173,98,35,198,86,112,36,27,23,9,0
72540,161,75,86,24,20,10,7,1154,489,665,200,196,95,54,0
72541,1872,837,1035,280,338,169,80,339,175,164,51,49,37,9,0
72542,360,205,155,35,24,52,14,218,111,107,45,29,24,6,0
72543,1171,542,629,170,146,114,64,455,191,264,68,86,21,19,0
72544,292,102,190,71,27,51,21,295,156,139,41,40,42,15,0
72545,381,187,194,37,49,36,17,364,192,172,49,36,39,14,0
72546,977,462,515,185,119,76,12,160,76,84,19,24,8,5,0
72547,493,281,212,56,61,30,13,286,152,134,38,38,32,11,0
72548,535,217,318,87,106,41,14,160,76,84,19,24,8,5,0
72549,255,136,119,39,20,32,10,199,92,107,34,30,18,9,0
72550,366,190,176,39,62,55,14,843,391,452,139,104,91,35,0
72551,71,28,43,15,9,5,2,736,388,348,88,85,67,28,0
72552,349,167,182,54,38,30,28,582,264,318,84,60,58,23,0
72553,193,110,83,18,20,15,12,516,245,271,82,84,70,26,0
72554,299,128,171,57,40,13,25,207,86,121,34,39,11,13,0
72555,343,162,181,65,38,29,12,335,170,165,52,36,47,11,0
72556,220,113,107,37,24,16,7,843,391,452,139,104,91,35,0
72557,272,94,178,76,33,19,4,485,244,241,80,55,59,20,0
72558,283,172,111,39,31,29,8,723,363,360,107,106,52,14,0
72559,2488,1085,1403,346,253,162,76,1606,753,853,215,227,182,48,0
72560,711,330,381,111,86,86,34,1065,581,484,134,97,76,46,0
72561,349,153,196,54,47,28,13,509,267,242,79,81,38,20,0
72562,284,128,156,48,29,34,8,339,175,164,51,49,37,9,0
72563,533,297,236,74,57,39,28,245,121,124,37,35,36,12,0
72564,341,195,146,42,21,36,9,376,189,187,47,53,44,26,0
72565,288,104,184,80,30,39,6,282,134,148,38,45,29,10,0
72566,428,226,202,52,60,75,20,536,222,314,101,100,34,22,0
72567,118,51,67,25,13,6,7,375,209,166,50,37,29,23,0
72568,879,457,422,93,98,143,32,464,236,228,64,56,53,28,0
72569,172,82,90,21,35,21,5,1922,923,999,267,275,215,90,0
72570,582,328,254,78,48,35,9,565,237,328,75,88,32,11,0
72571,536,237,299,116,87,42,17,274,142,132,33,34,18,14,0
72572,665,341,324,109,79,38,22,227,130,97,32,25,22,12,0
72573,412,203,209,65,47,37,18,277,144,133,42,30,41,8,0
72574,722,390,332,125,69,67,25,457,253,204,67,51,48,13,0
72575,291,131,160,49,35,32,15,334,182,152,45,41,27,13,0
72576,163,70,93,28,21,17,6,462,251,211,74,53,41,18,0
72577,2174,1057,1117,241,241,214,117,308,146,162,42,39,24,12,0
72578,728,358,370,118,100,55,29,139,68,71,14,26,14,9,0
72579,435,230,205,51,37,55,18,404,190,214,55,55,35,27,0
72580,228,82,146,45,37,18,8,1062,522,540,151,147,105,66,0
72581,227,109,118,42,35,29,8,2542,1245,1297,285,287,170,84,0
72582,1030,567,463,118,106,94,49,461,223,238,45,62,18,35,0
72583,225,111,114,38,22,25,10,453,247,206,58,53,45,20,0
72584,346,174,172,36,43,21,9,531,277,254,82,75,33,22,0
72585,180,57,123,39,22,10,8,903,436,467,128,116,83,33,0
72586,372,189,183,60,44,41,18,514,262,252,78,58,54,26,0
72587,433,188,245,63,45,26,14,261,127,134,36,27,36,4,0
72588,313,178,135,43,18,35,6,198,115,83,30,22,8,8,0
72589,492,253,239,73,67,77,29,225,129,96,32,33,20,8,0
72590,483,236,247,82,60,43,18,245,121,124,37,35,36,12,0
72591,219,116,103,66,7,2,1,660,303,357,97,89,85,33,0
72592,772,383,389,105,76,82,33,296,140,156,49,40,42,19,0
72593,449,179,270,80,77,49,29,430,212,218,88,43,40,20,0
72594,733,438,295,95,79,67,32,127,58,69,18,17,10,5,0
72595,485,246,239,74,48,47,22,422,202,220,80,52,57,18,0
72596,1186,495,691,182,208,88,32,425,177,248,60,62,33,16,0
72597,161,99,62,15,22,9,7,660,333,327,102,95,69,31,0
72598,640,271,369,111,79,57,17,305,163,142,38,27,47,11,0
72599,315,111,204,82,66,46,11,341,170,171,41,66,27,10,0
72600,490,198,292,65,81,39,27,338,169,169,53,44,39,21,0
72601,464,237,227,64,66,33,12,135,57,78,21,20,9,11,0
72602,71,28,43,15,9,5,2,396,213,183,68,44,47,18,0
72603,204,93,111,35,35,16,11,395,198,197,55,55,36,10,0
72604,323,156,167,52,45,39,18,308,146,162,42,39,24,12,0
72605,315,170,145,48,56,22,11,593,289,304,85,69,48,19,0
72606,456,223,233,77,54,47,20,166,90,76,27,18,21,5,0
72607,288,104,184,80,30,39,6,403,221,182,62,50,42,12,0
72608,373,164,209,51,45,44,21,296,159,137,49,28,38,13,0
72609,784,353,431,56,47,26,18,609,335,274,79,57,45,22,0
72610,2236,1195,1041,227,187,186,118,1352,602,750,166,185,81,70,0
72611,350,172,178,61,45,32,13,337,170,167,59,33,47,17,0
72612,854,435,419,118,91,95,42,165,87,78,24,19,22,9,0
72613,1276,607,669,192,178,136,63,119,61,58,17,12,10,6,0
72614,258,126,132,38,22,29,8,337,170,167,59,33,47,17,0
72615,919,444,475,141,148,62,20,331,180,151,46,35,47,17,0
72616,358,206,152,45,38,67,16,296,159,137,49,28,38,13,0
72617,952,547,405,95,90,127,35,134,55,79,22,24,16,6,0
72618,521,289,232,71,58,49,16,169,84,85,29,19,21,7,0
72619,374,202,172,58,40,41,7,858,461,397,125,114,79,45,0
72620,282,160,122,36,28,27,7,72,32,40,8,2,2,13,0
72621,330,77,253,86,52,20,12,274,142,132,33,34,18,14,0
72622,318,164,154,52,43,34,10,902,499,403,118,117,92,35,0
72623,107,36,71,27,15,0,1,397,223,174,50,39,29,17,0
72624,802,375,427,133,103,81,41,664,350,314,86,90,82,36,0
72625,1849,931,918,245,220,158,90,780,337,443,112,116,77,28,0
72626,308,163,145,38,33,30,20,660,333,327,102,95,69,31,0
72627,227,109,118,42,35,29,8,744,385,359,105,96,57,31,0
72628,164,81,83,37,8,14,10,1606,753,853,215,227,182,48,0
72629,128,67,61,29,9,9,1,283,160,123,25,20,37,9,0
72630,395,219,176,47,41,50,18,91,42,49,21,9,8,3,0
72631,503,260,243,46,56,33,16,180,115,65,17,12,9,9,0
72632,224,108,116,31,32,22,8,231,126,105,28,26,34,9,0
72633,331,165,166,52,34,48,22,647,324,323,101,80,76,43,0
72634,376,249,127,47,23,43,16,1047,562,485,141,127,114,41,0
72635,361,171,190,44,40,18,13,900,441,459,125,127,110,32,0
72636,261,130,131,27,41,19,16,148,69,79,26,18,16,3,0
72637,594,248,346,104,109,53,5,303,137,166,54,54,31,15,0
72638,463,250,213,56,45,73,25,418,223,195,53,43,49,15,0
72639,983,449,534,95,77,55,36,359,171,188,49,74,45,11,0
72640,127,55,72,25,18,5,7,293,142,151,49,40,42,17,0
72641,476,254,222,58,33,46,23,414,203,211,58,56,48,14,0
72642,375,167,208,55,83,44,9,2346,1231,1115,316,292,266,105,0
72643,338,172,166,59,30,39,18,137,72,65,27,13,15,8,0
72644,312,173,139,43,47,28,6,199,92,107,34,30,18,9,0
72645,743,377,366,87,74,68,30,128,63,65,30,11,13,8,0
72646,119,67,52,15,15,7,7,520,240,280,67,72,42,14,0
72647,559,217,342,105,86,42,16,2202,1121,1081,338,274,269,81,0
72648,391,203,188,49,34,36,9,198,86,112,36,27,23,9,0
72649,588,300,288,100,57,65,27,633,311,322,94,82,45,20,0
72650,784,351,433,118,87,73,41,329,196,133,41,36,31,15,0
72651,350,212,138,32,26,40,13,464,236,228,64,56,53,28,0
72652,338,164,174,45,32,37,13,514,262,252,78,58,54,26,0
72653,329,168,161,48,34,41,16,337,152,185,49,54,42,21,0
72654,508,267,241,43,35,25,17,218,114,104,32,31,33,11,0
72655,512,254,258,70,48,37,32,1001,417,584,186,147,96,47,0
72656,734,366,368,121,99,63,39,607,293,314,98,71,62,32,0
72657,451,278,173,71,35,58,12,462,251,211,74,53,41,18,0
72658,840,411,429,122,101,79,34,396,197,199,75,49,49,16,0
72659,483,236,247,82,60,43,18,966,478,488,108,144,74,43,0
72660,115,62,53,13,10,9,7,72,33,39,8,2,3,12,0
72661,325,177,148,40,24,23,13,142,65,77,30,17,22,9,0
72662,717,381,336,118,103,85,29,215,115,100,27,19,16,7,0
72663,170,82,88,32,23,22,8,222,125,97,34,27,27,7,0
72664,734,339,395,135,89,78,36,519,287,232,68,58,45,21,0
72665,346,205,141,47,34,30,7,312,165,147,41,39,29,16,0
72666,454,214,240,56,71,35,16,225,129,96,32,33,20,8,0
72667,255,136,119,39,20,32,10,376,183,193,50,50,43,21,0
72668,330,77,253,86,52,20,12,296,151,145,45,42,32,11,0
72669,258,144,114,33,22,19,9,1040,564,476,134,110,114,51,0
72670,840,411,429,122,101,79,34,732,402,330,81,86,87,33,0
72671,727,426,301,79,71,64,32,457,242,215,39,46,53,10,0
72672,193,90,103,44,9,19,13,462,229,233,63,49,42,18,0
72673,257,122,135,44,19,21,16,106,46,60,29,13,14,5,0
72674,521,249,272,53,36,50,18,192,91,101,29,28,17,7,0
72675,745,402,343,95,71,69,40,314,151,163,42,61,39,16,0
72676,1221,597,624,201,152,83,31,403,225,178,56,38,33,25,0
72677,126,56,70,31,10,10,3,220,107,113,36,35,28,9,0
72678,972,501,471,125,156,106,39,231,126,105,37,26,29,6,0
72679,222,110,112,43,30,14,6,963,525,438,119,102,102,34,0
72680,365,210,155,46,30,24,12,422,237,185,53,47,62,20,0
72681,346,173,173,50,56,31,14,188,93,95,33,18,16,10,0
72682,291,120,171,63,39,26,6,337,170,167,59,33,47,17,0
72683,781,367,414,60,67,43,17,898,469,429,125,125,134,35,0
72684,665,341,324,109,79,38,22,277,163,114,33,24,21,16,0
72685,535,217,318,87,106,41,14,158,71,87,23,21,17,12,0
72686,343,189,154,44,24,39,12,262,129,133,40,41,31,10,0
72687,881,492,389,87,97,59,51,334,181,153,56,31,28,18,0
72688,2286,1154,1132,338,314,278,103,303,138,165,47,46,35,18,0
72689,1047,443,604,162,156,78,52,133,61,72,21,19,13,4,0
72690,881,492,389,87,97,59,51,271,150,121,39,36,37,5,0
72691,139,81,58,17,14,24,9,163,79,84,22,24,13,5,0
72692,739,323,416,127,89,76,33,415,226,189,51,40,40,29,0
72693,793,410,383,108,86,102,45,977,500,477,139,115,121,31,0
72694,727,426,301,79,71,64,32,135,65,70,21,25,15,9,0
72695,288,104,184,80,30,39,6,222,119,103,37,32,24,8,0
72696,667,366,301,96,55,84,25,380,211,169,47,37,33,21,0
72697,1580,742,838,208,146,144,71,148,69,79,26,18,16,3,0
72698,437,228,209,47,61,26,11,1262,653,609,169,165,152,50,0
72699,461,257,204,63,49,50,29,516,245,271,82,84,70,26,0
72700,1365,590,775,257,168,136,93,341,170,171,41,66,27,10,0
72701,339,170,169,32,17,24,13,180,115,65,17,12,9,9,0
72702,1276,607,669,192,178,136,63,296,140,156,49,40,42,19,0
72703,589,282,307,68,67,70,23,483,215,268,66,70,30,16,0
72704,1689,821,868,277,250,177,78,271,150,121,39,36,37,5,0
72705,424,170,254,69,56,47,28,105,51,54,13,17,12,8,0
72706,240,166,74,32,12,8,15,583,280,303,95,66,76,25,0
72707,579,321,258,74,70,47,22,368,204,164,43,35,30,24,0
72708,1336,724,612,209,141,133,60,445,264,181,35,35,34,14,0
72709,107,53,54,15,15,13,4,432,244,188,51,51,27,14,0
72710,545,221,324,101,72,55,30,818,357,461,122,136,54,25,0
72711,220,113,107,37,24,16,7,701,380,321,94,84,96,34,0
72712,434,216,218,72,58,40,20,778,391,387,94,77,41,33,0
72713,394,207,187,52,42,37,24,671,306,365,114,76,49,19,0
72714,3230,1724,1506,361,358,157,75,536,251,285,75,79,60,23,0
72715,594,321,273,98,59,57,23,240,141,99,34,28,29,8,0
72716,326,176,150,35,22,29,11,555,282,273,82,69,65,21,0
72717,318,164,154,52,43,34,10,198,113,85,19,20,26,12,0
72718,189,90,99,26,29,17,11,360,192,168,55,45,48,16,0
72719,325,152,173,43,47,28,17,396,213,183,68,44,47,18,0
72720,2285,1219,1066,207,180,178,106,300,148,152,45,43,40,8,0
72721,331,144,187,57,46,33,19,601,279,322,81,65,27,12,0
72722,496,209,287,112,55,71,14,225,111,114,32,34,32,16,0
72723,873,366,507,127,125,75,21,547,295,252,81,65,57,23,0
72724,873,366,507,127,125,75,21,200,99,101,31,24,26,6,0
72725,230,114,116,30,33,29,8,620,324,296,81,68,66,31,0
72726,178,87,91,20,32,13,10,201,99,102,34,26,23,6,0
72727,766,336,430,133,97,79,21,501,240,261,80,62,49,42,0
72728,291,120,171,63,39,26,6,391,189,202,55,56,56,12,0
72729,126,58,68,31,10,10,3,276,149,127,34,31,32,10,0
72730,651,357,294,81,67,103,18,1395,627,768,172,263,141,59,0
72731,395,195,200,41,55,23,10,906,455,451,116,105,87,46,0
72732,1096,563,533,158,136,120,53,663,354,309,91,84,79,31,0
72733,328,195,133,36,23,35,9,188,93,95,33,18,16,10,0
72734,126,58,68,31,10,10,3,649,307,342,71,134,45,17,0
72735,1030,438,592,184,104,108,30,332,180,152,46,36,28,14,0
72736,1463,521,942,252,204,105,52,119,61,58,17,12,10,6,0
72737,413,169,244,66,94,28,19,189,105,84,25,26,21,9,0
72738,533,300,233,74,50,74,17,866,478,388,121,101,101,26,0
72739,739,389,350,129,61,69,25,1696,771,925,257,225,149,63,0
72740,1220,575,645,208,179,99,56,222,119,103,37,32,24,8,0
72741,258,130,128,44,37,29,10,453,255,198,62,49,29,19,0
72742,226,120,106,68,8,2,1,498,244,254,81,67,58,19,0
72743,269,127,142,43,24,34,26,312,165,147,41,39,29,16,0
72744,956,450,506,122,117,82,36,926,340,586,133,119,60,40,0
72745,331,169,162,40,28,22,14,204,80,124,29,51,10,5,0
72746,545,221,324,101,72,55,30,107,77,30,7,2,9,5,0
72747,733,438,295,95,79,67,32,395,198,197,55,55,36,10,0
72748,681,367,314,83,74,78,31,792,398,394,109,96,90,39,0
72749,150,64,86,22,12,29,12,902,499,403,118,117,92,35,0
72750,480,267,213,49,44,70,21,798,385,413,120,115,79,30,0
72751,264,122,142,46,24,35,10,94,45,49,11,20,10,4,0
72752,285,148,137,31,42,42,16,374,202,172,50,39,31,24,0
72753,164,81,83,37,8,14,10,306,157,149,52,35,39,16,0
72754,119,67,52,15,15,7,7,507,270,237,89,59,57,22,0
72755,1120,436,684,208,120,101,115,413,223,190,52,45,53,10,0
72756,539,283,256,75,73,53,26,389,207,182,53,58,52,18,0
72757,1341,481,860,275,264,57,21,469,225,244,64,68,25,11,0
72758,340,169,171,40,39,36,22,308,129,179,44,60,19,8,0
72759,86,50,36,9,14,8,7,453,255,198,62,49,29,19,0
72760,346,186,160,40,37,34,21,207,86,121,34,39,11,13,0
72761,245,111,134,36,27,18,6,732,366,366,108,86,74,41,0
72762,815,356,459,128,125,82,26,452,231,221,74,53,56,20,0
72763,496,272,224,70,58,42,18,415,189,226,68,54,50,21,0
72764,445,231,214,45,64,53,23,172,79,93,34,27,23,10,0
72765,364,172,192,55,57,32,15,134,55,79,22,24,16,6,0
72766,282,105,177,77,28,39,6,377,184,193,50,43,33,17,0
72767,219,116,103,66,7,2,1,260,131,129,42,31,40,9,0
72768,766,336,430,133,97,79,21,166,102,64,19,14,17,2,0
72769,803,358,445,135,117,80,43,339,175,164,51,49,37,9,0
72770,1235,584,651,140,226,82,52,234,116,118,34,35,23,9,0
72771,640,308,332,91,102,49,21,295,158,137,42,34,38,14,0
72772,1112,457,655,180,164,99,39,453,247,206,58,53,45,20,0
72773,1043,479,564,200,131,123,62,125,66,59,24,16,11,5,0
72774,607,305,302,92,89,74,23,507,270,237,89,59,57,22,0
72775,362,174,188,46,55,35,23,296,159,137,49,28,38,13,0
72776,270,158,112,35,20,23,7,778,391,387,94,77,41,33,0
72777,579,246,333,102,79,41,19,286,160,126,37,27,23,10,0
72778,1327,520,807,241,174,141,60,160,76,84,19,24,8,5,0
72779,949,467,482,126,127,102,51,627,289,338,101,73,62,43,0
72780,313,158,155,43,35,43,16,373,181,192,54,35,44,20,0
72781,1542,682,860,290,158,120,47,242,124,118,39,32,28,22,0
72782,364,168,196,64,61,27,6,72,32,40,8,2,2,13,0
72783,983,449,534,95,77,55,36,403,184,219,75,51,47,20,0
72784,486,243,243,65,48,63,22,360,185,175,51,43,36,16,0
72785,425,220,205,60,55,45,18,457,245,212,62,58,57,21,0
72786,476,199,277,82,80,49,24,277,144,133,42,30,41,8,0
72787,179,78,101,29,22,10,8,137,72,65,27,13,15,8,0
72788,260,138,122,44,30,28,6,260,131,129,42,31,40,9,0
72789,359,204,155,39,36,34,13,898,469,429,125,125,134,35,0
72790,2279,996,1283,375,328,158,60,925,439,486,141,134,105,46,0
72791,789,362,427,90,82,70,35,295,160,135,44,36,46,16,0
72792,379,217,162,47,20,50,23,906,455,451,116,105,87,46,0
72793,959,496,463,144,132,75,35,601,279,322,81,65,27,12,0
72794,1004,498,506,94,59,46,33,732,402,330,81,86,87,33,0
72795,2279,996,1283,375,328,158,60,480,255,225,67,64,50,22,0
72796,1365,590,775,257,168,136,93,395,169,226,73,55,38,9,0
72797,373,164,209,51,45,44,21,660,303,357,97,89,85,33,0
72798,533,300,233,74,50,74,17,152,71,81,41,16,14,2,0
72799,232,108,124,33,27,19,16,720,357,363,113,85,62,39,0
72800,412,146,266,106,38,67,35,385,212,173,57,40,39,21,0
72801,350,172,178,61,45,32,13,247,128,119,34,14,16,14,0
72802,1338,633,705,199,151,145,65,158,71,87,23,21,17,12,0
72803,206,100,106,34,26,11,7,1249,638,611,166,153,141,45,0
72804,318,161,157,53,51,32,13,132,77,55,20,9,13,10,0
72805,288,142,146,52,32,26,8,818,357,461,122,136,54,25,0
72806,329,168,161,48,34,41,16,531,277,254,82,75,33,22,0
72807,127,55,72,25,18,5,7,175,91,84,19,21,21,10,0
72808,232,134,98,28,20,20,5,360,180,180,57,48,39,12,0
72809,756,362,394,102,104,73,25,727,362,365,123,107,63,23,0
72810,526,228,298,69,64,32,30,1873,935,938,233,225,203,79,0
72811,410,200,210,60,54,46,19,199,105,94,27,27,28,9,0
72812,1051,429,622,179,148,125,54,497,227,270,70,63,66,30,0
72813,1051,429,622,179,148,125,54,1755,905,850,214,196,183,79,0
72814,184,93,91,26,25,14,11,693,360,333,100,88,62,26,0
72815,241,122,119,27,34,17,16,419,233,186,54,53,55,17,0
72816,824,391,433,106,90,88,32,173,90,83,21,36,12,15,0
72817,172,82,90,21,35,21,5,86,40,46,16,13,9,7,0
72818,4640,2231,2409,660,549,437,245,898,469,429,125,125,134,35,0
72819,419,210,209,54,44,31,23,1101,626,475,145,122,120,50,0
72820,475,208,267,84,67,50,20,142,73,69,27,9,15,11,0
72821,249,114,135,47,33,25,4,223,113,110,31,33,22,12,0
72822,121,69,52,15,18,14,8,337,152,185,49,54,42,21,0
72823,640,271,369,111,79,57,17,1755,905,850,214,196,183,79,0
72824,3230,1724,1506,361,358,157,75,89,38,51,14,6,3,9,0
72825,124,58,66,20,28,11,7,332,180,152,44,36,27,13,0
72826,683,304,379,140,101,48,19,941,459,482,167,140,82,38,0
72827,1161,514,647,159,138,122,37,396,223,173,57,37,44,19,0
72828,162,73,89,32,19,4,4,54,26,28,11,4,3,3,0
72829,349,131,218,66,76,22,9,330,166,164,55,51,36,16,0
72830,524,270,254,84,72,70,23,194,106,88,33,10,15,6,0
72831,158,85,73,24,18,18,8,295,160,135,42,37,46,16,0
72832,288,142,146,52,32,26,8,434,213,221,77,62,53,12,0
72833,5890,3314,2576,970,956,293,265,132,77,55,20,9,13,10,0
72834,454,214,240,56,71,35,16,732,366,366,108,86,74,41,0
72835,375,201,174,52,56,39,15,413,223,190,52,45,53,10,0
72836,178,87,91,20,32,13,10,1425,670,755,153,189,122,85,0
72837,450,241,209,67,58,54,23,421,219,202,68,57,56,13,0
72838,125,53,72,18,21,18,12,257,126,131,61,24,22,8,0
72839,2799,1324,1475,369,371,215,124,783,406,377,102,91,57,29,0
72840,130,70,60,30,9,8,1,72,34,38,8,2,3,12,0
72841,600,324,276,89,73,45,39,374,174,200,54,52,42,21,0
72842,627,237,390,137,57,108,44,119,61,58,17,12,10,6,0
72843,485,183,302,79,81,73,33,926,425,501,159,147,77,35,0
72844,217,98,119,38,35,18,9,724,353,371,94,95,71,31,0
72845,230,114,116,30,33,29,8,766,386,380,101,81,78,31,0
72846,414,216,198,51,32,42,28,732,402,330,81,86,87,33,0
72847,217,109,108,30,23,28,10,429,187,242,79,72,28,19,0
72848,297,182,115,41,22,23,8,975,400,575,160,162,62,31,0
72849,342,150,192,52,43,31,17,312,165,147,41,39,29,16,0
72850,510,288,222,44,36,24,7,277,138,139,40,39,20,14,0
72851,431,202,229,57,50,50,25,89,37,52,13,6,2,9,0
72852,747,469,278,60,41,53,23,323,171,152,48,41,40,16,0
72853,265,165,100,32,19,27,5,662,373,289,89,80,77,29,0
72854,343,162,181,65,38,29,12,200,89,111,26,25,17,7,0
72855,364,204,160,65,35,15,13,158,71,87,23,21,17,12,0
72856,4640,2231,2409,660,549,437,245,295,158,137,42,34,38,14,0
72857,439,211,228,65,73,26,21,235,119,116,31,26,15,13,0
72858,270,166,104,30,26,28,14,142,65,77,30,17,22,9,0
72859,684,353,331,95,98,77,38,218,117,101,35,32,34,12,0
72860,414,216,198,51,32,42,28,1025,549,476,118,109,88,61,0
72861,130,71,59,30,9,8,1,127,58,69,18,17,10,5,0
72862,452,217,235,59,47,60,20,147,74,73,28,20,24,4,0
72863,949,467,482,126,127,102,51,555,282,273,82,69,65,21,0
72864,415,133,282,114,65,27,7,145,77,68,26,7,15,8,0
72865,369,207,162,67,35,16,14,483,215,268,66,70,30,16,0
72866,345,208,137,44,27,33,8,798,385,413,120,115,79,30,0
72867,374,202,172,58,40,41,7,370,173,197,65,57,42,10,0
72868,603,311,292,102,71,66,23,925,439,486,141,134,105,46,0
72869,126,57,69,31,10,10,3,452,252,200,55,49,61,16,0
72870,118,56,62,24,12,6,9,348,194,154,57,31,43,12,0
72871,346,191,155,52,38,40,13,111,60,51,17,23,10,7,0
72872,320,183,137,51,18,38,8,898,469,429,125,125,134,35,0
72873,320,163,157,44,44,26,15,260,131,129,42,31,40,9,0
72874,207,89,118,56,8,4,3,307,132,175,48,53,26,10,0
72875,345,208,137,44,27,33,8,225,129,96,32,33,20,8,0
72876,434,221,213,58,47,54,15,96,45,51,13,12,6,4,0
72877,1505,680,825,202,204,73,32,72,33,39,8,2,3,12,0
72878,438,185,253,71,64,52,28,300,148,152,45,43,40,8,0
72879,636,288,348,94,77,65,30,729,358,371,116,99,89,33,0
72880,228,105,123,34,43,20,10,375,211,164,50,36,31,23,0
72881,519,245,274,58,61,34,22,374,174,200,54,52,42,21,0
72882,325,177,148,40,24,23,13,403,192,211,102,39,49,15,0
72883,561,282,279,68,62,36,14,370,190,180,60,52,37,13,0
72884,117,57,60,17,14,11,10,483,215,268,66,70,30,16,0
72885,335,148,187,52,26,51,12,188,105,83,25,17,24,7,0
72886,1542,682,860,290,158,120,47,222,125,97,34,27,27,7,0
72887,583,279,304,99,71,59,31,892,475,417,130,108,68,38,0
72888,563,255,308,91,111,42,30,128,63,65,30,11,13,8,0
72889,284,128,156,48,29,34,8,732,402,330,81,86,87,33,0
72890,186,103,83,29,20,26,7,393,185,208,59,50,36,22,0
72891,71,28,43,15,9,5,2,124,69,55,14,7,9,4,0
72892,574,284,290,64,50,65,20,475,251,224,67,49,48,23,0
72893,610,249,361,107,69,72,33,545,269,276,80,76,27,32,0
72894,532,254,278,91,48,23,17,142,73,69,27,9,15,11,0
72895,276,149,127,45,34,39,9,128,63,65,30,11,13,8,0
72896,567,256,311,91,81,53,17,453,255,198,62,49,29,19,0
72897,314,178,136,42,32,30,17,335,186,149,40,28,29,13,0
72898,435,187,248,62,51,51,21,1025,549,476,118,109,88,61,0
72899,1647,794,853,279,235,128,65,453,247,206,58,53,45,20,0
72900,509,246,263,84,71,56,22,724,353,371,94,95,71,31,0
72901,425,220,205,60,55,45,18,406,234,172,63,35,43,10,0
72902,118,56,62,24,12,6,9,169,84,85,29,19,21,7,0
72903,579,281,298,91,78,74,27,188,101,87,20,18,20,14,0
72904,879,457,422,93,98,143,32,296,140,156,49,40,42,19,0
72905,532,254,278,91,48,23,17,296,151,145,45,42,32,11,0
72906,416,222,194,58,38,38,20,180,89,91,28,27,18,7,0
72907,728,358,370,118,100,55,29,283,160,123,25,20,37,9,0
72908,407,207,200,53,36,38,8,481,223,258,71,70,49,26,0
72909,346,209,137,46,37,44,10,2225,1244,981,271,243,217,93,0
72910,1001,422,579,185,180,51,32,943,463,480,91,144,70,30,0
72911,664,269,395,117,107,36,15,200,89,111,26,25,17,7,0
72912,264,122,142,33,29,13,13,520,272,248,60,65,58,22,0
72913,221,75,146,68,21,16,5,156,90,66,17,22,11,10,0
72914,380,187,193,38,51,30,18,72,32,40,8,2,2,13,0
72915,285,148,137,31,42,42,16,180,89,91,28,27,18,7,0
72916,217,109,108,30,23,28,10,218,114,104,32,31,33,11,0
72917,338,208,130,39,30,35,12,334,181,153,41,40,25,15,0
72918,270,130,140,43,24,36,10,136,65,71,26,11,7,5,0
72919,456,214,242,76,62,52,22,492,278,214,65,58,32,11,0
72920,193,95,98,33,17,25,17,1230,644,586,198,125,123,61,0
72921,127,54,73,31,10,11,3,405,181,224,71,57,31,12,0
72922,474,250,224,58,47,37,12,671,306,365,114,76,49,19,0
72923,625,283,342,93,89,67,25,429,187,242,79,72,28,19,0
72924,130,70,60,30,9,8,1,396,197,199,75,49,49,16,0
72925,258,144,114,33,22,19,9,417,232,185,58,50,29,21,0
72926,126,56,70,31,10,10,3,1239,659,580,169,148,131,54,0
72927,249,104,145,47,41,24,17,245,121,124,37,35,36,12,0
72928,184,88,96,15,40,17,8,153,65,88,28,21,20,8,0
72929,505,282,223,60,57,66,23,364,189,175,58,41,35,17,0
72930,873,366,507,127,125,75,21,309,159,150,47,43,43,13,0
72931,300,136,164,45,35,45,14,188,101,87,20,18,20,14,0
72932,437,167,270,126,95,34,10,1279,669,610,164,162,104,55,0
72933,604,239,365,124,63,84,37,943,463,480,91,144,70,30,0
72934,904,436,468,138,146,82,39,408,221,187,55,51,57,14,0
72935,626,300,326,91,82,68,26,247,128,119,34,14,16,14,0
72936,161,99,62,15,22,9,7,1230,644,586,198,125,123,61,0
72937,349,153,196,54,47,28,13,374,202,172,50,39,31,24,0
72938,240,98,142,49,42,23,17,1101,626,475,145,122,120,50,0
72939,437,228,209,47,61,26,11,627,289,338,101,73,62,43,0
72940,764,277,487,158,162,64,31,710,375,335,95,94,110,28,0
72941,418,163,255,57,54,38,24,390,223,167,58,36,45,18,0
72942,366,190,176,39,62,55,14,303,137,166,54,54,31,15,0
72943,118,51,67,25,13,6,7,452,254,198,72,57,38,18,0
72944,629,374,255,74,53,87,27,418,223,195,53,43,49,15,0
72945,1068,434,634,173,160,61,29,592,249,343,91,90,50,42,0
72946,650,330,320,93,93,51,28,758,361,397,114,107,51,19,0
72947,331,144,187,57,46,33,19,189,105,84,25,26,21,9,0
72948,508,136,372,157,91,22,9,418,223,195,51,45,49,14,0
72949,394,207,187,52,42,37,24,250,119,131,58,26,29,7,0
72950,979,534,445,83,77,80,24,295,160,135,44,36,46,16,0
72951,338,172,166,59,30,39,18,660,332,328,84,73,47,19,0
72952,218,133,85,20,19,13,6,900,441,459,125,127,110,32,0
72953,746,312,434,129,115,77,47,286,160,126,37,27,23,10,0
72954,126,56,70,31,10,10,3,314,177,137,34,40,29,9,0
72955,435,225,210,58,46,50,14,198,113,85,19,20,26,12,0
72956,1058,497,561,194,142,87,63,647,324,323,101,80,76,43,0
72957,200,103,97,17,16,10,10,149,52,97,36,36,7,4,0
72958,490,224,266,80,70,39,32,218,118,100,33,30,25,11,0
72959,707,250,457,171,84,117,61,715,345,370,110,97,64,25,0
72960,227,109,118,42,35,29,8,163,79,84,22,24,13,5,0
72961,403,176,227,71,56,51,11,375,211,164,50,36,31,23,0
72962,349,167,182,54,38,30,28,277,163,114,33,24,21,16,0
72963,478,220,258,47,70,41,10,312,165,147,41,39,29,16,0
72964,616,304,312,75,71,55,25,222,125,97,34,27,27,7,0
72965,291,120,171,63,39,26,6,131,55,76,28,9,14,12,0
72966,963,477,486,134,143,123,38,662,373,289,89,80,77,29,0
72967,134,60,74,19,13,10,7,402,186,216,64,47,38,20,0
72968,135,64,71,31,11,8,4,378,154,224,74,84,35,22,0
72969,2285,1219,1066,207,180,178,106,866,397,469,117,153,95,48,0
72970,179,96,83,24,8,26,4,727,362,365,123,107,63,23,0
72971,474,243,231,66,54,41,29,96,46,50,16,12,7,5,0
72972,666,204,462,110,194,42,14,892,475,417,130,108,68,38,0
72973,319,222,97,36,23,28,8,406,234,172,63,35,43,10,0
72974,560,279,281,113,64,58,15,283,160,123,25,20,37,9,0
72975,813,412,401,114,93,112,26,135,57,78,21,20,9,11,0
72976,500,257,243,60,55,27,22,557,281,276,80,59,43,21,0
72977,184,88,96,15,40,17,8,163,79,84,22,24,13,5,0
72978,485,237,248,83,35,52,24,497,257,240,71,63,62,16,0
72979,279,127,152,50,36,28,8,188,101,87,20,18,20,14,0
72980,347,154,193,48,51,25,11,367,218,149,45,43,42,16,0
72981,492,253,239,73,67,77,29,391,189,202,55,56,56,12,0
72982,330,77,253,86,52,20,12,843,391,452,139,104,91,35,0
72983,509,251,258,69,49,55,17,483,258,225,70,53,54,20,0
72984,126,57,69,31,10,10,3,106,54,52,12,9,7,6,0
72985,407,230,177,44,39,34,19,337,152,185,49,54,42,21,0
72986,688,310,378,130,82,78,47,821,394,427,122,117,109,38,0
72987,341,154,187,34,36,11,11,293,142,151,49,40,42,17,0
72988,306,172,134,35,31,37,18,715,345,370,110,97,64,25,0
72989,507,314,193,49,45,59,25,457,245,212,62,58,57,21,0
72990,589,282,307,68,67,70,23,166,102,64,19,14,17,2,0
72991,785,374,411,56,42,38,25,290,147,143,34,34,39,13,0
72992,154,74,80,18,19,7,2,966,478,488,108,144,74,43,0
72993,1009,487,522,177,121,103,51,320,168,152,38,42,24,18,0
72994,347,154,193,48,51,25,11,517,295,222,69,62,40,28,0
72995,869,489,380,110,77,79,29,564,264,300,79,84,65,26,0
72996,260,138,122,44,30,28,6,2517,1275,1242,304,324,245,135,0
72997,297,182,115,41,22,23,8,622,344,278,80,77,68,36,0
72998,726,312,414,121,73,82,23,341,170,171,41,66,27,10,0
72999,464,237,227,64,66,33,12,391,189,202,55,56,56,12,0
73000,898,397,501,102,98,54,37,198,86,112,36,27,23,9,0
73001,933,456,477,123,108,83,29,530,287,243,79,70,33,26,0
73002,437,228,209,47,61,26,11,132,77,55,20,9,13,10,0
73003,795,384,411,133,109,85,38,452,252,200,55,49,61,16,0
73004,125,57,68,31,10,10,3,374,191,183,40,52,40,16,0
73005,261,130,131,27,41,19,16,483,287,196,71,50,54,17,0
73006,479,227,252,69,48,46,18,285,146,139,41,41,48,13,0
73007,331,165,166,52,34,48,22,374,181,193,55,58,48,23,0
73008,428,248,180,44,39,28,9,106,46,60,29,13,14,5,0
73009,285,148,137,31,42,42,16,218,115,103,32,32,34,11,0
73010,557,211,346,129,125,48,19,464,236,228,64,56,53,28,0
73011,338,172,166,59,30,39,18,314,177,137,34,40,29,9,0
73012,278,110,168,58,49,29,5,462,251,211,74,53,41,18,0
73013,372,189,183,60,44,41,18,360,185,175,51,43,36,16,0
73014,746,312,434,129,115,77,47,727,362,365,123,107,63,23,0
73015,260,133,127,43,29,34,11,189,105,84,25,26,21,9,0
73016,439,241,198,67,40,40,13,520,272,248,60,65,58,22,0
73017,334,190,144,42,42,16,5,727,362,365,123,107,63,23,0
73018,356,199,157,36,43,28,12,175,82,93,33,26,17,5,0
73019,1390,705,685,219,164,129,74,198,110,88,27,27,24,4,0
73020,284,128,156,48,29,34,8,278,154,124,42,32,38,7,0
73021,273,126,147,54,49,25,18,154,78,76,23,21,13,5,0
73022,586,298,288,80,75,64,37,285,143,142,45,32,21,17,0
73023,873,366,507,127,125,75,21,561,279,282,85,81,88,24,0
73024,288,104,184,80,30,39,6,660,332,328,84,73,47,19,0
73025,346,186,160,40,37,34,21,309,164,145,35,47,30,11,0
73026,280,128,152,39,37,38,18,1543,794,749,182,152,132,55,0
73027,853,400,453,137,109,88,42,720,361,359,98,98,70,37,0
73028,344,168,176,50,39,30,20,225,114,111,32,29,26,6,0
73029,521,249,272,53,36,50,18,531,261,270,73,80,68,26,0
73030,1755,849,906,245,226,148,56,547,295,252,81,65,57,23,0
73031,376,249,127,47,23,43,16,260,133,127,43,32,39,3,0
73032,206,100,106,34,26,11,7,296,159,137,49,28,38,13,0
73033,234,110,124,39,29,23,2,2382,1162,1220,237,220,140,49,0
73034,932,575,357,94,69,76,40,1755,905,850,214,196,183,79,0
73035,215,117,98,28,19,15,8,943,463,480,91,144,70,30,0
73036,76,30,46,7,15,1,5,376,189,187,47,53,44,26,0
73037,1221,597,624,201,152,83,31,406,223,183,61,53,46,17,0
73038,553,276,277,88,61,45,27,205,94,111,48,31,15,6,0
73039,554,217,337,112,72,90,38,925,439,486,141,134,105,46,0
73040,532,254,278,91,48,23,17,1114,539,575,145,131,94,56,0
73041,641,349,292,92,60,39,24,225,114,111,32,29,26,6,0
73042,1011,559,452,121,97,132,33,1154,489,665,200,196,95,54,0
73043,364,172,192,55,57,32,15,316,166,150,45,38,37,13,0
73044,347,154,193,48,51,25,11,2382,1162,1220,237,220,140,49,0
73045,726,312,414,121,73,82,23,348,212,136,53,31,25,18,0
73046,309,137,172,51,50,28,14,201,93,108,34,39,21,6,0
73047,203,97,106,30,22,18,10,375,176,199,48,61,40,12,0
73048,236,141,95,36,32,14,6,218,118,100,33,30,25,11,0
73049,434,216,218,72,58,40,20,415,203,212,77,44,49,18,0
73050,480,267,213,49,44,70,21,1382,508,874,334,320,98,36,0
73051,2488,1085,1403,346,253,162,76,536,251,285,75,79,60,23,0
73052,517,196,321,103,98,33,12,482,232,250,77,81,44,13,0
73053,2525,1232,1293,398,317,186,61,300,148,152,45,43,40,8,0
73054,1531,649,882,108,122,93,72,4646,2328,2318,674,639,475,170,0
73055,536,237,299,116,87,42,17,180,108,72,22,22,15,5,0
73056,107,56,51,18,16,12,5,775,407,368,122,100,97,32,0
73057,1711,865,846,204,176,105,60,736,388,348,88,85,67,28,0
73058,107,56,51,18,16,12,5,106,41,65,36,6,11,7,0
73059,450,227,223,53,36,48,12,330,166,164,55,51,36,16,0
73060,196,107,89,20,31,17,4,163,79,84,22,24,13,5,0
73061,350,178,172,49,62,29,16,514,262,252,78,58,54,26,0
73062,710,352,358,104,86,84,41,152,71,81,41,16,14,2,0
73063,577,251,326,92,84,60,11,538,274,264,84,67,52,35,0
73064,961,465,496,139,156,62,34,483,215,268,66,70,30,16,0
73065,739,323,416,127,89,76,33,391,189,202,55,56,56,12,0
73066,125,53,72,18,21,18,12,548,296,252,71,74,43,28,0
73067,154,74,80,18,19,7,2,295,158,137,42,34,38,14,0
73068,350,178,172,49,62,29,16,373,189,184,54,46,50,23,0
73069,437,228,209,47,61,26,11,72,34,38,8,2,3,12,0
73070,210,84,126,44,43,9,4,452,231,221,74,53,56,20,0
73071,860,348,512,121,136,75,35,137,63,74,20,22,14,6,0
73072,915,336,579,185,199,56,29,303,138,165,47,46,35,18,0
73073,125,57,68,31,10,10,3,415,226,189,51,40,40,29,0
73074,395,219,176,47,41,50,18,222,122,100,39,32,24,9,0
73075,410,211,199,55,42,34,27,142,65,77,30,17,22,9,0
73076,90,54,36,20,4,14,5,633,311,322,94,82,45,20,0
73077,138,35,103,38,2,15,9,536,251,285,75,79,60,23,0
73078,598,300,298,68,77,59,21,223,113,110,31,33,22,12,0
73079,1186,495,691,182,208,88,32,2724,1157,1567,269,518,239,77,0
73080,240,98,142,49,42,23,17,312,165,147,41,39,29,16,0
73081,906,460,446,117,131,108,33,809,362,447,115,120,81,32,0
73082,539,283,256,75,73,53,26,295,160,135,44,36,46,16,0
73083,213,104,109,56,14,9,2,974,457,517,133,117,69,26,0
73084,330,182,148,47,27,40,11,132,61,71,19,20,14,6,0
73085,221,80,141,48,37,14,10,203,98,105,34,29,19,10,0
73086,164,81,83,37,8,14,10,225,114,111,32,29,26,6,0
73087,226,120,106,68,8,2,1,188,90,98,44,7,21,7,0
73088,479,228,251,71,57,60,14,348,194,154,57,31,43,12,0
73089,708,344,364,106,98,66,33,660,333,327,102,95,69,31,0
73090,781,367,414,60,67,43,17,538,274,264,84,67,52,35,0
73091,1085,646,439,108,65,36,19,689,343,346,105,102,81,35,0
73092,756,362,394,102,104,73,25,328,195,133,39,40,27,13,0
73093,433,188,245,63,45,26,14,418,246,172,52,39,57,10,0
73094,447,236,211,56,52,49,14,373,189,184,54,46,50,23,0
73095,415,217,198,50,31,42,17,1606,753,853,215,227,182,48,0
73096,360,205,155,35,24,52,14,660,332,328,84,73,47,19,0
73097,360,175,185,73,36,27,7,593,289,304,85,69,48,19,0
73098,480,267,213,49,44,70,21,545,269,276,80,76,27,32,0
73099,2109,999,1110,332,294,187,89,2542,1245,1297,285,287,170,84,0
73100,358,206,152,45,38,67,16,230,125,105,29,40,20,6,0
73101,260,120,140,34,39,36,12,332,180,152,46,36,28,14,0
73102,441,218,223,69,55,50,27,1543,794,749,182,152,132,55,0
73103,730,298,432,128,69,86,26,732,366,366,108,86,74,41,0
73104,4128,2104,2024,581,505,453,205,548,296,252,71,74,43,28,0
73105,167,70,97,32,20,15,7,189,105,84,25,26,21,9,0
73106,1112,457,655,180,164,99,39,293,142,151,49,40,42,17,0
73107,168,67,101,37,17,13,13,219,105,114,36,29,19,8,0
73108,654,344,310,80,69,57,15,463,268,195,59,46,46,21,0
73109,260,133,127,43,29,34,11,536,222,314,101,100,34,22,0
